Status,Name,Adv,Date,Location,A,B,C,D,E
Tropical Storm,Alex,7,1998-07-29T03:00:00Z,15.0N  43.4W,43,1,0,0,44
Tropical Storm,Alex,7,1998-07-29T03:00:00Z,16.8N  48.2W,0,4,16,2,22
Tropical Storm,Alex,7,1998-07-29T03:00:00Z,15.8N  45.9W,1,26,1,0,28
Tropical Storm,Alex,8,1998-07-29T09:00:00Z,14.8N  45.0W,45,0,0,0,45
Tropical Storm,Alex,8,1998-07-29T09:00:00Z,16.5N  50.0W,0,3,17,2,22
Tropical Storm,Alex,8,1998-07-29T09:00:00Z,15.5N  47.5W,1,27,1,0,29
Tropical Storm,Alex,9,1998-07-29T15:00:00Z,15.1N  46.9W,43,0,0,1,44
Tropical Storm,Alex,9,1998-07-29T15:00:00Z,TFFF 146N 610W,0,0,0,3,3
Tropical Storm,Alex,9,1998-07-29T15:00:00Z,15.7N  49.4W,1,27,0,1,29
Tropical Storm,Alex,9,1998-07-29T15:00:00Z,TDPR 153N 614W,0,0,0,2,2
Tropical Storm,Alex,9,1998-07-29T15:00:00Z,16.5N  52.0W,0,4,17,1,22
Tropical Storm,Alex,9,1998-07-29T15:00:00Z,TFFR 163N 615W,0,0,0,3,3
Tropical Storm,Alex,9,1998-07-29T15:00:00Z,TBPB 131N 595W,0,0,0,4,4
Tropical Storm,Alex,9,1998-07-29T15:00:00Z,TAPA 171N 618W,0,0,0,3,3
Tropical Storm,Alex,9,1998-07-29T15:00:00Z,TLPL 138N 610W,0,0,0,2,2
Tropical Storm,Alex,9,1998-07-29T15:00:00Z,TKPK 173N 627W,0,0,0,2,2
Tropical Storm,Alex,10,1998-07-29T21:00:00Z,14.5N  47.1W,43,1,0,0,44
Tropical Storm,Alex,10,1998-07-29T21:00:00Z,TFFF 146N 610W,0,0,0,4,4
Tropical Storm,Alex,10,1998-07-29T21:00:00Z,15.3N  49.7W,1,27,1,0,29
Tropical Storm,Alex,10,1998-07-29T21:00:00Z,TDPR 153N 614W,0,0,0,4,4
Tropical Storm,Alex,10,1998-07-29T21:00:00Z,16.0N  52.0W,0,6,14,1,21
Tropical Storm,Alex,10,1998-07-29T21:00:00Z,TFFR 163N 615W,0,0,0,4,4
Tropical Storm,Alex,10,1998-07-29T21:00:00Z,TBPB 131N 595W,0,0,0,5,5
Tropical Storm,Alex,10,1998-07-29T21:00:00Z,TAPA 171N 618W,0,0,0,4,4
Tropical Storm,Alex,10,1998-07-29T21:00:00Z,TVSV 131N 612W,0,0,0,2,2
Tropical Storm,Alex,10,1998-07-29T21:00:00Z,TKPK 173N 627W,0,0,0,3,3
Tropical Storm,Alex,10,1998-07-29T21:00:00Z,TLPL 138N 610W,0,0,0,3,3
Tropical Storm,Alex,10,1998-07-29T21:00:00Z,TNCM 181N 631W,0,0,0,2,2
Tropical Storm,Alex,11,1998-07-30T03:00:00Z,15.0N  47.7W,44,0,0,0,44
Tropical Storm,Alex,11,1998-07-30T03:00:00Z,TDPR 153N 614W,0,0,0,7,7
Tropical Storm,Alex,11,1998-07-30T03:00:00Z,15.5N  50.6W,0,28,0,1,29
Tropical Storm,Alex,11,1998-07-30T03:00:00Z,TFFR 163N 615W,0,0,0,8,8
Tropical Storm,Alex,11,1998-07-30T03:00:00Z,16.5N  53.1W,0,3,17,2,22
Tropical Storm,Alex,11,1998-07-30T03:00:00Z,TAPA 171N 618W,0,0,0,8,8
Tropical Storm,Alex,11,1998-07-30T03:00:00Z,TTPT 112N 608W,0,0,0,3,3
Tropical Storm,Alex,11,1998-07-30T03:00:00Z,TKPK 173N 627W,0,0,0,6,6
Tropical Storm,Alex,11,1998-07-30T03:00:00Z,TGPY 120N 618W,0,0,0,2,2
Tropical Storm,Alex,11,1998-07-30T03:00:00Z,TNCM 181N 631W,0,0,0,5,5
Tropical Storm,Alex,11,1998-07-30T03:00:00Z,TBPB 131N 595W,0,0,0,8,8
Tropical Storm,Alex,11,1998-07-30T03:00:00Z,TISX 177N 648W,0,0,0,2,2
Tropical Storm,Alex,11,1998-07-30T03:00:00Z,TVSV 131N 612W,0,0,0,4,4
Tropical Storm,Alex,11,1998-07-30T03:00:00Z,TIST 183N 650W,0,0,0,2,2
Tropical Storm,Alex,11,1998-07-30T03:00:00Z,TLPL 138N 610W,0,0,0,6,6
Tropical Storm,Alex,11,1998-07-30T03:00:00Z,ST CROIX VI,0,0,0,2,2
Tropical Storm,Alex,11,1998-07-30T03:00:00Z,TFFF 146N 610W,0,0,0,7,7
Tropical Storm,Alex,11,1998-07-30T03:00:00Z,ST THOMAS VI,0,0,0,2,2
Tropical Storm,Alex,12,1998-07-30T09:00:00Z,15.3N  49.5W,42,1,0,0,43
Tropical Storm,Alex,12,1998-07-30T09:00:00Z,TFFR 163N 615W,0,0,0,11,11
Tropical Storm,Alex,12,1998-07-30T09:00:00Z,16.0N  52.0W,0,27,1,0,28
Tropical Storm,Alex,12,1998-07-30T09:00:00Z,TAPA 171N 618W,0,0,0,11,11
Tropical Storm,Alex,12,1998-07-30T09:00:00Z,16.8N  54.5W,0,3,17,2,22
Tropical Storm,Alex,12,1998-07-30T09:00:00Z,TKPK 173N 627W,0,0,0,9,9
Tropical Storm,Alex,12,1998-07-30T09:00:00Z,TTPP 106N 614W,0,0,0,3,3
Tropical Storm,Alex,12,1998-07-30T09:00:00Z,TNCM 181N 631W,0,0,0,9,9
Tropical Storm,Alex,12,1998-07-30T09:00:00Z,TTPT 112N 608W,0,0,0,4,4
Tropical Storm,Alex,12,1998-07-30T09:00:00Z,TISX 177N 648W,0,0,0,4,4
Tropical Storm,Alex,12,1998-07-30T09:00:00Z,TGPY 120N 618W,0,0,0,4,4
Tropical Storm,Alex,12,1998-07-30T09:00:00Z,TIST 183N 650W,0,0,0,4,4
Tropical Storm,Alex,12,1998-07-30T09:00:00Z,TBPB 131N 595W,0,0,0,10,10
Tropical Storm,Alex,12,1998-07-30T09:00:00Z,TJSJ 184N 661W,0,0,0,2,2
Tropical Storm,Alex,12,1998-07-30T09:00:00Z,TVSV 131N 612W,0,0,0,7,7
Tropical Storm,Alex,12,1998-07-30T09:00:00Z,ST CROIX VI,0,0,0,4,4
Tropical Storm,Alex,12,1998-07-30T09:00:00Z,TLPL 138N 610W,0,0,0,9,9
Tropical Storm,Alex,12,1998-07-30T09:00:00Z,ST THOMAS VI,0,0,0,4,4
Tropical Storm,Alex,12,1998-07-30T09:00:00Z,TFFF 146N 610W,0,0,0,10,10
Tropical Storm,Alex,12,1998-07-30T09:00:00Z,SAN JUAN PR,0,0,0,2,2
Tropical Storm,Alex,12,1998-07-30T09:00:00Z,TDPR 153N 614W,0,0,0,10,10
Tropical Storm,Alex,13,1998-07-30T15:00:00Z,15.8N  50.8W,55,0,0,0,55
Tropical Storm,Alex,13,1998-07-30T15:00:00Z,TKPK 173N 627W,0,0,0,12,12
Tropical Storm,Alex,13,1998-07-30T15:00:00Z,16.5N  53.5W,1,32,0,0,33
Tropical Storm,Alex,13,1998-07-30T15:00:00Z,TNCM 181N 631W,0,0,0,12,12
Tropical Storm,Alex,13,1998-07-30T15:00:00Z,17.0N  56.0W,0,10,13,1,24
Tropical Storm,Alex,13,1998-07-30T15:00:00Z,TISX 177N 648W,0,0,0,7,7
Tropical Storm,Alex,13,1998-07-30T15:00:00Z,TBPB 131N 595W,0,0,1,4,5
Tropical Storm,Alex,13,1998-07-30T15:00:00Z,TIST 183N 650W,0,0,0,7,7
Tropical Storm,Alex,13,1998-07-30T15:00:00Z,TVSV 131N 612W,0,0,0,3,3
Tropical Storm,Alex,13,1998-07-30T15:00:00Z,TJPS 180N 666W,0,0,0,3,3
Tropical Storm,Alex,13,1998-07-30T15:00:00Z,TLPL 138N 610W,0,0,1,4,5
Tropical Storm,Alex,13,1998-07-30T15:00:00Z,TJSJ 184N 661W,0,0,0,4,4
Tropical Storm,Alex,13,1998-07-30T15:00:00Z,TFFF 146N 610W,0,0,1,7,8
Tropical Storm,Alex,13,1998-07-30T15:00:00Z,ST CROIX VI,0,0,0,7,7
Tropical Storm,Alex,13,1998-07-30T15:00:00Z,TDPR 153N 614W,0,0,1,8,9
Tropical Storm,Alex,13,1998-07-30T15:00:00Z,ST THOMAS VI,0,0,0,7,7
Tropical Storm,Alex,13,1998-07-30T15:00:00Z,TFFR 163N 615W,0,0,1,11,12
Tropical Storm,Alex,13,1998-07-30T15:00:00Z,SAN JUAN PR,0,0,0,4,4
Tropical Storm,Alex,13,1998-07-30T15:00:00Z,TAPA 171N 618W,0,0,1,12,13
Tropical Storm,Alex,13,1998-07-30T15:00:00Z,PONCE PR,0,0,0,3,3
Tropical Storm,Alex,14,1998-07-30T21:00:00Z,16.2N  51.5W,54,0,0,0,54
Tropical Storm,Alex,14,1998-07-30T21:00:00Z,TNCM 181N 631W,0,0,0,11,11
Tropical Storm,Alex,14,1998-07-30T21:00:00Z,17.0N  54.0W,1,31,0,0,32
Tropical Storm,Alex,14,1998-07-30T21:00:00Z,TISX 177N 648W,0,0,0,6,6
Tropical Storm,Alex,14,1998-07-30T21:00:00Z,18.0N  56.0W,0,13,10,1,24
Tropical Storm,Alex,14,1998-07-30T21:00:00Z,TIST 183N 650W,0,0,0,7,7
Tropical Storm,Alex,14,1998-07-30T21:00:00Z,TBPB 131N 595W,0,0,0,2,2
Tropical Storm,Alex,14,1998-07-30T21:00:00Z,TJPS 180N 666W,0,0,0,3,3
Tropical Storm,Alex,14,1998-07-30T21:00:00Z,TLPL 138N 610W,0,0,0,2,2
Tropical Storm,Alex,14,1998-07-30T21:00:00Z,TJSJ 184N 661W,0,0,0,4,4
Tropical Storm,Alex,14,1998-07-30T21:00:00Z,TFFF 146N 610W,0,0,1,4,5
Tropical Storm,Alex,14,1998-07-30T21:00:00Z,ST CROIX VI,0,0,0,6,6
Tropical Storm,Alex,14,1998-07-30T21:00:00Z,TDPR 153N 614W,0,0,1,6,7
Tropical Storm,Alex,14,1998-07-30T21:00:00Z,ST THOMAS VI,0,0,0,7,7
Tropical Storm,Alex,14,1998-07-30T21:00:00Z,TFFR 163N 615W,0,0,1,9,10
Tropical Storm,Alex,14,1998-07-30T21:00:00Z,SAN JUAN PR,0,0,0,4,4
Tropical Storm,Alex,14,1998-07-30T21:00:00Z,TAPA 171N 618W,0,0,1,11,12
Tropical Storm,Alex,14,1998-07-30T21:00:00Z,PONCE PR,0,0,0,3,3
Tropical Storm,Alex,14,1998-07-30T21:00:00Z,TKPK 173N 627W,0,0,0,10,10
Tropical Storm,Alex,15,1998-07-31T03:00:00Z,17.3N  51.7W,54,0,0,0,54
Tropical Storm,Alex,15,1998-07-31T03:00:00Z,TNCM 181N 631W,0,0,0,6,6
Tropical Storm,Alex,15,1998-07-31T03:00:00Z,18.4N  53.9W,3,29,0,0,32
Tropical Storm,Alex,15,1998-07-31T03:00:00Z,TISX 177N 648W,0,0,0,2,2
Tropical Storm,Alex,15,1998-07-31T03:00:00Z,19.7N  56.3W,0,10,13,1,24
Tropical Storm,Alex,15,1998-07-31T03:00:00Z,TIST 183N 650W,0,0,0,2,2
Tropical Storm,Alex,15,1998-07-31T03:00:00Z,TFFR 163N 615W,0,0,1,3,4
Tropical Storm,Alex,15,1998-07-31T03:00:00Z,ST CROIX VI,0,0,0,2,2
Tropical Storm,Alex,15,1998-07-31T03:00:00Z,TAPA 171N 618W,0,0,1,4,5
Tropical Storm,Alex,15,1998-07-31T03:00:00Z,ST THOMAS VI,0,0,0,2,2
Tropical Storm,Alex,15,1998-07-31T03:00:00Z,TKPK 173N 627W,0,0,0,4,4
Tropical Storm,Alex,16,1998-07-31T09:00:00Z,17.5N  52.6W,43,0,0,0,43
Tropical Storm,Alex,16,1998-07-31T09:00:00Z,TNCM 181N 631W,0,0,1,6,7
Tropical Storm,Alex,16,1998-07-31T09:00:00Z,19.0N  54.8W,11,18,1,0,30
Tropical Storm,Alex,16,1998-07-31T09:00:00Z,TISX 177N 648W,0,0,0,3,3
Tropical Storm,Alex,16,1998-07-31T09:00:00Z,20.5N  57.0W,0,13,9,1,23
Tropical Storm,Alex,16,1998-07-31T09:00:00Z,TIST 183N 650W,0,0,0,4,4
Tropical Storm,Alex,16,1998-07-31T09:00:00Z,TFFF 146N 610W,0,0,1,1,2
Tropical Storm,Alex,16,1998-07-31T09:00:00Z,TJSJ 184N 661W,0,0,0,2,2
Tropical Storm,Alex,16,1998-07-31T09:00:00Z,TDPR 153N 614W,0,0,1,2,3
Tropical Storm,Alex,16,1998-07-31T09:00:00Z,ST CROIX VI,0,0,0,3,3
Tropical Storm,Alex,16,1998-07-31T09:00:00Z,TFFR 163N 615W,0,0,1,5,6
Tropical Storm,Alex,16,1998-07-31T09:00:00Z,ST THOMAS VI,0,0,0,4,4
Tropical Storm,Alex,16,1998-07-31T09:00:00Z,TAPA 171N 618W,0,0,2,5,7
Tropical Storm,Alex,16,1998-07-31T09:00:00Z,SAN JUAN PR,0,0,0,2,2
Tropical Storm,Alex,16,1998-07-31T09:00:00Z,TKPK 173N 627W,0,0,1,5,6
Tropical Storm,Alex,17,1998-07-31T15:00:00Z,16.5N  53.5W,53,0,0,0,53
Tropical Storm,Alex,17,1998-07-31T15:00:00Z,TISX 177N 648W,0,0,0,4,4
Tropical Storm,Alex,17,1998-07-31T15:00:00Z,17.5N  55.5W,4,27,0,1,32
Tropical Storm,Alex,17,1998-07-31T15:00:00Z,TIST 183N 650W,0,0,0,5,5
Tropical Storm,Alex,17,1998-07-31T15:00:00Z,19.0N  57.5W,0,10,13,1,24
Tropical Storm,Alex,17,1998-07-31T15:00:00Z,TJPS 180N 666W,0,0,0,2,2
Tropical Storm,Alex,17,1998-07-31T15:00:00Z,TFFF 146N 610W,0,0,1,1,2
Tropical Storm,Alex,17,1998-07-31T15:00:00Z,TJSJ 184N 661W,0,0,0,3,3
Tropical Storm,Alex,17,1998-07-31T15:00:00Z,TDPR 153N 614W,0,0,1,3,4
Tropical Storm,Alex,17,1998-07-31T15:00:00Z,ST CROIX VI,0,0,0,4,4
Tropical Storm,Alex,17,1998-07-31T15:00:00Z,TFFR 163N 615W,0,0,3,4,7
Tropical Storm,Alex,17,1998-07-31T15:00:00Z,ST THOMAS VI,0,0,0,5,5
Tropical Storm,Alex,17,1998-07-31T15:00:00Z,TAPA 171N 618W,0,0,3,6,9
Tropical Storm,Alex,17,1998-07-31T15:00:00Z,SAN JUAN PR,0,0,0,3,3
Tropical Storm,Alex,17,1998-07-31T15:00:00Z,TKPK 173N 627W,0,0,1,7,8
Tropical Storm,Alex,17,1998-07-31T15:00:00Z,PONCE PR,0,0,0,2,2
Tropical Storm,Alex,17,1998-07-31T15:00:00Z,TNCM 181N 631W,0,0,1,8,9
Tropical Storm,Alex,18,1998-07-31T21:00:00Z,17.0N  55.0W,56,0,0,1,57
Tropical Storm,Alex,18,1998-07-31T21:00:00Z,TISX 177N 648W,0,0,0,4,4
Tropical Storm,Alex,18,1998-07-31T21:00:00Z,19.5N  57.0W,2,35,0,0,37
Tropical Storm,Alex,18,1998-07-31T21:00:00Z,TIST 183N 650W,0,0,0,5,5
Tropical Storm,Alex,18,1998-07-31T21:00:00Z,20.5N  59.0W,0,15,10,0,25
Tropical Storm,Alex,18,1998-07-31T21:00:00Z,TJPS 180N 666W,0,0,0,2,2
Tropical Storm,Alex,18,1998-07-31T21:00:00Z,TDPR 153N 614W,0,0,1,1,2
Tropical Storm,Alex,18,1998-07-31T21:00:00Z,TJSJ 184N 661W,0,0,0,3,3
Tropical Storm,Alex,18,1998-07-31T21:00:00Z,TFFR 163N 615W,0,0,3,2,5
Tropical Storm,Alex,18,1998-07-31T21:00:00Z,ST CROIX VI,0,0,0,4,4
Tropical Storm,Alex,18,1998-07-31T21:00:00Z,TAPA 171N 618W,0,0,5,3,8
Tropical Storm,Alex,18,1998-07-31T21:00:00Z,ST THOMAS VI,0,0,0,5,5
Tropical Storm,Alex,18,1998-07-31T21:00:00Z,TKPK 173N 627W,0,0,2,5,7
Tropical Storm,Alex,18,1998-07-31T21:00:00Z,SAN JUAN PR,0,0,0,3,3
Tropical Storm,Alex,18,1998-07-31T21:00:00Z,TNCM 181N 631W,0,0,3,6,9
Tropical Storm,Alex,18,1998-07-31T21:00:00Z,PONCE PR,0,0,0,2,2
Tropical Storm,Alex,19,1998-08-01T03:00:00Z,16.9N  56.6W,56,0,0,0,56
Tropical Storm,Alex,19,1998-08-01T03:00:00Z,TIST 183N 650W,0,0,9,7,16
Tropical Storm,Alex,19,1998-08-01T03:00:00Z,17.9N  59.4W,1,32,1,0,34
Tropical Storm,Alex,19,1998-08-01T03:00:00Z,TJPS 180N 666W,0,0,2,9,11
Tropical Storm,Alex,19,1998-08-01T03:00:00Z,19.2N  61.6W,0,11,12,1,24
Tropical Storm,Alex,19,1998-08-01T03:00:00Z,MDSD 185N 697W,0,0,0,5,5
Tropical Storm,Alex,19,1998-08-01T03:00:00Z,TLPL 138N 610W,0,1,2,0,3
Tropical Storm,Alex,19,1998-08-01T03:00:00Z,TJSJ 184N 661W,0,0,4,9,13
Tropical Storm,Alex,19,1998-08-01T03:00:00Z,TFFF 146N 610W,0,4,4,0,8
Tropical Storm,Alex,19,1998-08-01T03:00:00Z,MDPP 198N 707W,0,0,0,5,5
Tropical Storm,Alex,19,1998-08-01T03:00:00Z,TDPR 153N 614W,0,7,5,0,12
Tropical Storm,Alex,19,1998-08-01T03:00:00Z,MBJT 215N 712W,0,0,0,5,5
Tropical Storm,Alex,19,1998-08-01T03:00:00Z,TFFR 163N 615W,0,12,6,0,18
Tropical Storm,Alex,19,1998-08-01T03:00:00Z,ST CROIX VI,0,0,9,5,14
Tropical Storm,Alex,19,1998-08-01T03:00:00Z,TAPA 171N 618W,0,12,8,1,21
Tropical Storm,Alex,19,1998-08-01T03:00:00Z,ST THOMAS VI,0,0,9,7,16
Tropical Storm,Alex,19,1998-08-01T03:00:00Z,TKPK 173N 627W,0,5,12,2,19
Tropical Storm,Alex,19,1998-08-01T03:00:00Z,SAN JUAN PR,0,0,4,9,13
Tropical Storm,Alex,19,1998-08-01T03:00:00Z,TNCM 181N 631W,0,3,15,2,20
Tropical Storm,Alex,19,1998-08-01T03:00:00Z,PONCE PR,0,0,2,9,11
Tropical Storm,Alex,19,1998-08-01T03:00:00Z,TISX 177N 648W,0,0,9,5,14
Tropical Storm,Alex,20,1998-08-01T09:00:00Z,17.2N  58.1W,56,0,0,0,56
Tropical Storm,Alex,20,1998-08-01T09:00:00Z,TIST 183N 650W,0,1,11,3,15
Tropical Storm,Alex,20,1998-08-01T09:00:00Z,18.4N  60.5W,1,32,0,0,33
Tropical Storm,Alex,20,1998-08-01T09:00:00Z,TJPS 180N 666W,0,0,4,5,9
Tropical Storm,Alex,20,1998-08-01T09:00:00Z,20.0N  62.5W,0,9,14,1,24
Tropical Storm,Alex,20,1998-08-01T09:00:00Z,MDSD 185N 697W,0,0,0,3,3
Tropical Storm,Alex,20,1998-08-01T09:00:00Z,TLPL 138N 610W,0,1,1,0,2
Tropical Storm,Alex,20,1998-08-01T09:00:00Z,TJSJ 184N 661W,0,0,6,6,12
Tropical Storm,Alex,20,1998-08-01T09:00:00Z,TFFF 146N 610W,0,4,2,0,6
Tropical Storm,Alex,20,1998-08-01T09:00:00Z,MDPP 198N 707W,0,0,0,4,4
Tropical Storm,Alex,20,1998-08-01T09:00:00Z,TDPR 153N 614W,0,8,3,0,11
Tropical Storm,Alex,20,1998-08-01T09:00:00Z,MBJT 215N 712W,0,0,0,5,5
Tropical Storm,Alex,20,1998-08-01T09:00:00Z,TFFR 163N 615W,0,17,2,0,19
Tropical Storm,Alex,20,1998-08-01T09:00:00Z,MYMM 224N 730W,0,0,0,2,2
Tropical Storm,Alex,20,1998-08-01T09:00:00Z,TAPA 171N 618W,0,20,3,0,23
Tropical Storm,Alex,20,1998-08-01T09:00:00Z,ST CROIX VI,0,1,10,3,14
Tropical Storm,Alex,20,1998-08-01T09:00:00Z,TKPK 173N 627W,0,12,7,1,20
Tropical Storm,Alex,20,1998-08-01T09:00:00Z,ST THOMAS VI,0,1,11,3,15
Tropical Storm,Alex,20,1998-08-01T09:00:00Z,TNCM 181N 631W,0,10,11,0,21
Tropical Storm,Alex,20,1998-08-01T09:00:00Z,SAN JUAN PR,0,0,6,6,12
Tropical Storm,Alex,20,1998-08-01T09:00:00Z,TISX 177N 648W,0,1,10,3,14
Tropical Storm,Alex,20,1998-08-01T09:00:00Z,PONCE PR,0,0,4,5,9
Tropical Storm,Alex,21,1998-08-01T15:00:00Z,19.0N  59.5W,54,0,0,1,55
Tropical Storm,Alex,21,1998-08-01T15:00:00Z,TJSJ 184N 661W,0,0,7,3,10
Tropical Storm,Alex,21,1998-08-01T15:00:00Z,20.0N  61.5W,5,27,1,0,33
Tropical Storm,Alex,21,1998-08-01T15:00:00Z,MDPP 198N 707W,0,0,0,6,6
Tropical Storm,Alex,21,1998-08-01T15:00:00Z,21.5N  63.5W,0,12,11,1,24
Tropical Storm,Alex,21,1998-08-01T15:00:00Z,MBJT 215N 712W,0,0,0,10,10
Tropical Storm,Alex,21,1998-08-01T15:00:00Z,TFFR 163N 615W,1,5,1,0,7
Tropical Storm,Alex,21,1998-08-01T15:00:00Z,MYMM 224N 730W,0,0,0,7,7
Tropical Storm,Alex,21,1998-08-01T15:00:00Z,TAPA 171N 618W,1,12,1,0,14
Tropical Storm,Alex,21,1998-08-01T15:00:00Z,MYSM 241N 745W,0,0,0,4,4
Tropical Storm,Alex,21,1998-08-01T15:00:00Z,TKPK 173N 627W,0,10,2,1,13
Tropical Storm,Alex,21,1998-08-01T15:00:00Z,MYEG 235N 758W,0,0,0,2,2
Tropical Storm,Alex,21,1998-08-01T15:00:00Z,TNCM 181N 631W,0,14,3,1,18
Tropical Storm,Alex,21,1998-08-01T15:00:00Z,ST CROIX VI,0,2,6,2,10
Tropical Storm,Alex,21,1998-08-01T15:00:00Z,TISX 177N 648W,0,2,6,2,10
Tropical Storm,Alex,21,1998-08-01T15:00:00Z,ST THOMAS VI,0,3,8,1,12
Tropical Storm,Alex,21,1998-08-01T15:00:00Z,TIST 183N 650W,0,3,8,1,12
Tropical Storm,Alex,21,1998-08-01T15:00:00Z,SAN JUAN PR,0,0,7,3,10
Tropical Storm,Alex,21,1998-08-01T15:00:00Z,TJPS 180N 666W,0,0,4,3,7
Tropical Storm,Alex,21,1998-08-01T15:00:00Z,PONCE PR,0,0,4,3,7
Tropical Storm,Alex,21,1998-08-01T15:00:00Z,MDSD 185N 697W,0,0,0,4,4
Tropical Storm,Alex,22,1998-08-01T21:00:00Z,21.0N  60.5W,49,0,0,0,49
Tropical Storm,Alex,22,1998-08-01T21:00:00Z,MBJT 215N 712W,0,0,1,7,8
Tropical Storm,Alex,22,1998-08-01T21:00:00Z,22.5N  63.5W,4,27,0,0,31
Tropical Storm,Alex,22,1998-08-01T21:00:00Z,MYMM 224N 730W,0,0,0,7,7
Tropical Storm,Alex,22,1998-08-01T21:00:00Z,24.0N  66.0W,0,13,9,1,23
Tropical Storm,Alex,22,1998-08-01T21:00:00Z,MYSM 241N 745W,0,0,0,7,7
Tropical Storm,Alex,22,1998-08-01T21:00:00Z,TKPK 173N 627W,0,1,1,0,2
Tropical Storm,Alex,22,1998-08-01T21:00:00Z,MYEG 235N 758W,0,0,0,4,4
Tropical Storm,Alex,22,1998-08-01T21:00:00Z,TNCM 181N 631W,0,4,2,0,6
Tropical Storm,Alex,22,1998-08-01T21:00:00Z,MYAK 241N 776W,0,0,0,2,2
Tropical Storm,Alex,22,1998-08-01T21:00:00Z,TISX 177N 648W,0,1,2,1,4
Tropical Storm,Alex,22,1998-08-01T21:00:00Z,MYNN 251N 775W,0,0,0,2,2
Tropical Storm,Alex,22,1998-08-01T21:00:00Z,TIST 183N 650W,0,2,3,1,6
Tropical Storm,Alex,22,1998-08-01T21:00:00Z,BERMUDA,0,0,0,3,3
Tropical Storm,Alex,22,1998-08-01T21:00:00Z,TJPS 180N 666W,0,0,3,1,4
Tropical Storm,Alex,22,1998-08-01T21:00:00Z,ST CROIX VI,0,1,2,1,4
Tropical Storm,Alex,22,1998-08-01T21:00:00Z,MDSD 185N 697W,0,0,1,2,3
Tropical Storm,Alex,22,1998-08-01T21:00:00Z,ST THOMAS VI,0,2,3,1,6
Tropical Storm,Alex,22,1998-08-01T21:00:00Z,TJSJ 184N 661W,0,1,4,1,6
Tropical Storm,Alex,22,1998-08-01T21:00:00Z,SAN JUAN PR,0,1,4,1,6
Tropical Storm,Alex,22,1998-08-01T21:00:00Z,MDPP 198N 707W,0,0,1,4,5
Tropical Storm,Alex,22,1998-08-01T21:00:00Z,PONCE PR,0,0,3,1,4
Tropical Storm,Alex,23,1998-08-02T03:00:00Z,21.7N  61.9W,50,0,0,0,50
Tropical Storm,Alex,23,1998-08-02T03:00:00Z,MBJT 215N 712W,0,0,1,2,3
Tropical Storm,Alex,23,1998-08-02T03:00:00Z,23.6N  64.2W,10,22,0,1,33
Tropical Storm,Alex,23,1998-08-02T03:00:00Z,MYMM 224N 730W,0,0,0,2,2
Tropical Storm,Alex,23,1998-08-02T03:00:00Z,25.5N  66.3W,0,13,11,1,25
Tropical Storm,Alex,23,1998-08-02T03:00:00Z,MYSM 241N 745W,0,0,0,2,2
Tropical Storm,Alex,23,1998-08-02T03:00:00Z,TNCM 181N 631W,1,1,0,0,2
Tropical Storm,Alex,23,1998-08-02T03:00:00Z,BERMUDA,0,0,0,6,6
Tropical Storm,Alex,25,1998-08-02T15:00:00Z,22.7N  62.2W,50,0,0,0,50
Tropical Storm,Alex,25,1998-08-02T15:00:00Z,MYMM 224N 730W,0,0,0,2,2
Tropical Storm,Alex,25,1998-08-02T15:00:00Z,24.5N  64.0W,20,9,1,0,30
Tropical Storm,Alex,25,1998-08-02T15:00:00Z,MYSM 241N 745W,0,0,0,2,2
Tropical Storm,Alex,25,1998-08-02T15:00:00Z,26.5N  65.5W,1,16,4,1,22
Tropical Storm,Alex,25,1998-08-02T15:00:00Z,BERMUDA,0,0,3,9,12
Tropical Storm,Alex,25,1998-08-02T15:00:00Z,MBJT 215N 712W,0,0,1,1,2
Tropical Depression,Two,1,1998-08-19T21:00:00Z,17.8N  56.7W,58,1,0,0,59
Tropical Depression,Two,1,1998-08-19T21:00:00Z,MTPP 186N 724W,0,0,0,8,8
Tropical Depression,Two,1,1998-08-19T21:00:00Z,18.5N  60.0W,0,36,1,0,37
Tropical Depression,Two,1,1998-08-19T21:00:00Z,MTCA 183N 738W,0,0,0,4,4
Tropical Depression,Two,1,1998-08-19T21:00:00Z,20.0N  63.5W,0,2,25,0,27
Tropical Depression,Two,1,1998-08-19T21:00:00Z,MUGM 200N 751W,0,0,0,4,4
Tropical Depression,Two,1,1998-08-19T21:00:00Z,TFFF 146N 610W,0,3,2,0,5
Tropical Depression,Two,1,1998-08-19T21:00:00Z,TJSJ 184N 661W,0,0,11,7,18
Tropical Depression,Two,1,1998-08-19T21:00:00Z,TDPR 153N 614W,0,5,5,0,10
Tropical Depression,Two,1,1998-08-19T21:00:00Z,MDPP 198N 707W,0,0,0,15,15
Tropical Depression,Two,1,1998-08-19T21:00:00Z,TFFR 163N 615W,0,12,7,0,19
Tropical Depression,Two,1,1998-08-19T21:00:00Z,MBJT 215N 712W,0,0,0,16,16
Tropical Depression,Two,1,1998-08-19T21:00:00Z,TAPA 171N 618W,0,15,9,1,25
Tropical Depression,Two,1,1998-08-19T21:00:00Z,MYMM 224N 730W,0,0,0,12,12
Tropical Depression,Two,1,1998-08-19T21:00:00Z,TKPK 173N 627W,0,7,15,0,22
Tropical Depression,Two,1,1998-08-19T21:00:00Z,MYSM 241N 745W,0,0,0,7,7
Tropical Depression,Two,1,1998-08-19T21:00:00Z,TNCM 181N 631W,0,6,19,0,25
Tropical Depression,Two,1,1998-08-19T21:00:00Z,MYEG 235N 758W,0,0,0,4,4
Tropical Depression,Two,1,1998-08-19T21:00:00Z,TISX 177N 648W,0,0,15,3,18
Tropical Depression,Two,1,1998-08-19T21:00:00Z,ST CROIX VI,0,0,15,3,18
Tropical Depression,Two,1,1998-08-19T21:00:00Z,TIST 183N 650W,0,0,17,3,20
Tropical Depression,Two,1,1998-08-19T21:00:00Z,ST THOMAS VI,0,0,17,3,20
Tropical Depression,Two,1,1998-08-19T21:00:00Z,TJPS 180N 666W,0,0,7,9,16
Tropical Depression,Two,1,1998-08-19T21:00:00Z,SAN JUAN PR,0,0,11,7,18
Tropical Depression,Two,1,1998-08-19T21:00:00Z,MDSD 185N 697W,0,0,0,13,13
Tropical Depression,Two,1,1998-08-19T21:00:00Z,PONCE PR,0,0,7,9,16
Tropical Depression,Two,1,1998-08-19T21:00:00Z,MDCB 176N 714W,0,0,0,7,7
Tropical Depression,Two,2,1998-08-20T03:00:00Z,18.9N  57.9W,44,0,0,0,44
Tropical Depression,Two,2,1998-08-20T03:00:00Z,MTCA 183N 738W,0,0,0,5,5
Tropical Depression,Two,2,1998-08-20T03:00:00Z,20.2N  61.1W,4,26,1,0,31
Tropical Depression,Two,2,1998-08-20T03:00:00Z,MUGM 200N 751W,0,0,0,6,6
Tropical Depression,Two,2,1998-08-20T03:00:00Z,21.4N  64.2W,0,8,15,1,24
Tropical Depression,Two,2,1998-08-20T03:00:00Z,MUCM 214N 779W,0,0,0,2,2
Tropical Depression,Two,2,1998-08-20T03:00:00Z,TFFF 146N 610W,0,2,0,0,2
Tropical Depression,Two,2,1998-08-20T03:00:00Z,TJSJ 184N 661W,0,1,11,3,15
Tropical Depression,Two,2,1998-08-20T03:00:00Z,TDPR 153N 614W,0,4,1,0,5
Tropical Depression,Two,2,1998-08-20T03:00:00Z,MDPP 198N 707W,0,0,0,14,14
Tropical Depression,Two,2,1998-08-20T03:00:00Z,TFFR 163N 615W,1,9,2,0,12
Tropical Depression,Two,2,1998-08-20T03:00:00Z,MBJT 215N 712W,0,0,0,17,17
Tropical Depression,Two,2,1998-08-20T03:00:00Z,TAPA 171N 618W,1,14,2,0,17
Tropical Depression,Two,2,1998-08-20T03:00:00Z,MYMM 224N 730W,0,0,0,15,15
Tropical Depression,Two,2,1998-08-20T03:00:00Z,TKPK 173N 627W,0,11,5,0,16
Tropical Depression,Two,2,1998-08-20T03:00:00Z,MYSM 241N 745W,0,0,0,12,12
Tropical Depression,Two,2,1998-08-20T03:00:00Z,TNCM 181N 631W,0,13,6,0,19
Tropical Depression,Two,2,1998-08-20T03:00:00Z,MYEG 235N 758W,0,0,0,8,8
Tropical Depression,Two,2,1998-08-20T03:00:00Z,TISX 177N 648W,0,3,10,1,14
Tropical Depression,Two,2,1998-08-20T03:00:00Z,MYAK 241N 776W,0,0,0,3,3
Tropical Depression,Two,2,1998-08-20T03:00:00Z,TIST 183N 650W,0,3,12,2,17
Tropical Depression,Two,2,1998-08-20T03:00:00Z,MYNN 251N 775W,0,0,0,3,3
Tropical Depression,Two,2,1998-08-20T03:00:00Z,TJPS 180N 666W,0,0,8,5,13
Tropical Depression,Two,2,1998-08-20T03:00:00Z,ST CROIX VI,0,3,10,1,14
Tropical Depression,Two,2,1998-08-20T03:00:00Z,MDSD 185N 697W,0,0,1,10,11
Tropical Depression,Two,2,1998-08-20T03:00:00Z,ST THOMAS VI,0,3,12,2,17
Tropical Depression,Two,2,1998-08-20T03:00:00Z,MDCB 176N 714W,0,0,0,7,7
Tropical Depression,Two,2,1998-08-20T03:00:00Z,SAN JUAN PR,0,1,11,3,15
Tropical Depression,Two,2,1998-08-20T03:00:00Z,MTPP 186N 724W,0,0,0,8,8
Tropical Depression,Two,2,1998-08-20T03:00:00Z,PONCE PR,0,0,8,5,13
Tropical Depression,Two,3,1998-08-20T09:00:00Z,18.7N  58.5W,49,0,0,1,50
Tropical Depression,Two,3,1998-08-20T09:00:00Z,MTPP 186N 724W,0,0,0,5,5
Tropical Depression,Two,3,1998-08-20T09:00:00Z,19.7N  61.1W,11,21,0,0,32
Tropical Depression,Two,3,1998-08-20T09:00:00Z,MTCA 183N 738W,0,0,0,2,2
Tropical Depression,Two,3,1998-08-20T09:00:00Z,20.9N  63.8W,0,12,12,1,25
Tropical Depression,Two,3,1998-08-20T09:00:00Z,MUGM 200N 751W,0,0,0,3,3
Tropical Depression,Two,3,1998-08-20T09:00:00Z,TFFF 146N 610W,0,1,1,0,2
Tropical Depression,Two,3,1998-08-20T09:00:00Z,TJSJ 184N 661W,0,1,10,4,15
Tropical Depression,Two,3,1998-08-20T09:00:00Z,TDPR 153N 614W,0,3,2,0,5
Tropical Depression,Two,3,1998-08-20T09:00:00Z,MDPP 198N 707W,0,0,0,11,11
Tropical Depression,Two,3,1998-08-20T09:00:00Z,TFFR 163N 615W,0,9,3,0,12
Tropical Depression,Two,3,1998-08-20T09:00:00Z,MBJT 215N 712W,0,0,0,14,14
Tropical Depression,Two,3,1998-08-20T09:00:00Z,TAPA 171N 618W,1,14,2,0,17
Tropical Depression,Two,3,1998-08-20T09:00:00Z,MYMM 224N 730W,0,0,0,12,12
Tropical Depression,Two,3,1998-08-20T09:00:00Z,TKPK 173N 627W,0,11,5,0,16
Tropical Depression,Two,3,1998-08-20T09:00:00Z,MYSM 241N 745W,0,0,0,8,8
Tropical Depression,Two,3,1998-08-20T09:00:00Z,TNCM 181N 631W,0,14,6,0,20
Tropical Depression,Two,3,1998-08-20T09:00:00Z,MYEG 235N 758W,0,0,0,4,4
Tropical Depression,Two,3,1998-08-20T09:00:00Z,TISX 177N 648W,0,2,11,1,14
Tropical Depression,Two,3,1998-08-20T09:00:00Z,ST CROIX VI,0,2,11,1,14
Tropical Depression,Two,3,1998-08-20T09:00:00Z,TIST 183N 650W,0,3,12,2,17
Tropical Depression,Two,3,1998-08-20T09:00:00Z,ST THOMAS VI,0,3,12,2,17
Tropical Depression,Two,3,1998-08-20T09:00:00Z,TJPS 180N 666W,0,0,7,5,12
Tropical Depression,Two,3,1998-08-20T09:00:00Z,SAN JUAN PR,0,1,10,4,15
Tropical Depression,Two,3,1998-08-20T09:00:00Z,MDSD 185N 697W,0,0,1,8,9
Tropical Depression,Two,3,1998-08-20T09:00:00Z,PONCE PR,0,0,7,5,12
Tropical Depression,Two,3,1998-08-20T09:00:00Z,MDCB 176N 714W,0,0,0,3,3
Tropical Depression,Two,4,1998-08-20T15:00:00Z,20.5N  64.0W,54,1,0,0,55
Tropical Depression,Two,4,1998-08-20T15:00:00Z,MYMM 224N 730W,0,0,11,6,17
Tropical Depression,Two,4,1998-08-20T15:00:00Z,21.7N  67.0W,0,33,0,0,33
Tropical Depression,Two,4,1998-08-20T15:00:00Z,MYSM 241N 745W,0,0,4,13,17
Tropical Depression,Two,4,1998-08-20T15:00:00Z,23.0N  70.0W,0,5,19,1,25
Tropical Depression,Two,4,1998-08-20T15:00:00Z,MYEG 235N 758W,0,0,1,12,13
Tropical Depression,Two,4,1998-08-20T15:00:00Z,TAPA 171N 618W,2,0,0,0,2
Tropical Depression,Two,4,1998-08-20T15:00:00Z,MYAK 241N 776W,0,0,0,10,10
Tropical Depression,Two,4,1998-08-20T15:00:00Z,TKPK 173N 627W,4,0,0,0,4
Tropical Depression,Two,4,1998-08-20T15:00:00Z,MYNN 251N 775W,0,0,0,11,11
Tropical Depression,Two,4,1998-08-20T15:00:00Z,TNCM 181N 631W,24,0,0,0,24
Tropical Depression,Two,4,1998-08-20T15:00:00Z,MYGF 266N 787W,0,0,0,7,7
Tropical Depression,Two,4,1998-08-20T15:00:00Z,TISX 177N 648W,4,2,0,0,6
Tropical Depression,Two,4,1998-08-20T15:00:00Z,ST CROIX VI,4,2,0,0,6
Tropical Depression,Two,4,1998-08-20T15:00:00Z,TIST 183N 650W,9,6,0,0,15
Tropical Depression,Two,4,1998-08-20T15:00:00Z,ST THOMAS VI,9,6,0,0,15
Tropical Depression,Two,4,1998-08-20T15:00:00Z,TJPS 180N 666W,0,5,1,0,6
Tropical Depression,Two,4,1998-08-20T15:00:00Z,SAN JUAN PR,2,9,1,0,12
Tropical Depression,Two,4,1998-08-20T15:00:00Z,MDSD 185N 697W,0,1,3,1,5
Tropical Depression,Two,4,1998-08-20T15:00:00Z,PONCE PR,0,5,1,0,6
Tropical Depression,Two,4,1998-08-20T15:00:00Z,MTPP 186N 724W,0,0,1,3,4
Tropical Depression,Two,4,1998-08-20T15:00:00Z,MARATHON FL,0,0,0,2,2
Tropical Depression,Two,4,1998-08-20T15:00:00Z,MTCA 183N 738W,0,0,0,2,2
Tropical Depression,Two,4,1998-08-20T15:00:00Z,MIAMI FL,0,0,0,4,4
Tropical Depression,Two,4,1998-08-20T15:00:00Z,MUGM 200N 751W,0,0,1,4,5
Tropical Depression,Two,4,1998-08-20T15:00:00Z,W PALM BEACH FL,0,0,0,4,4
Tropical Depression,Two,4,1998-08-20T15:00:00Z,MUCM 214N 779W,0,0,0,4,4
Tropical Depression,Two,4,1998-08-20T15:00:00Z,FT PIERCE FL,0,0,0,3,3
Tropical Depression,Two,4,1998-08-20T15:00:00Z,TJSJ 184N 661W,2,9,1,0,12
Tropical Depression,Two,4,1998-08-20T15:00:00Z,COCOA BEACH FL,0,0,0,2,2
Tropical Depression,Two,4,1998-08-20T15:00:00Z,MDPP 198N 707W,0,2,8,2,12
Tropical Depression,Two,4,1998-08-20T15:00:00Z,MARCO ISLAND FL,0,0,0,2,2
Tropical Depression,Two,4,1998-08-20T15:00:00Z,MBJT 215N 712W,0,2,15,2,19
Tropical Storm,Bonnie,5,1998-08-20T21:00:00Z,20.5N  67.0W,52,1,0,0,53
Tropical Storm,Bonnie,5,1998-08-20T21:00:00Z,MYMM 224N 730W,0,6,15,1,22
Tropical Storm,Bonnie,5,1998-08-20T21:00:00Z,22.0N  70.0W,0,31,0,0,31
Tropical Storm,Bonnie,5,1998-08-20T21:00:00Z,MYSM 241N 745W,0,0,15,5,20
Tropical Storm,Bonnie,5,1998-08-20T21:00:00Z,23.5N  72.5W,0,6,16,1,23
Tropical Storm,Bonnie,5,1998-08-20T21:00:00Z,MYEG 235N 758W,0,0,9,8,17
Tropical Storm,Bonnie,5,1998-08-20T21:00:00Z,TAPA 171N 618W,39,0,0,0,39
Tropical Storm,Bonnie,5,1998-08-20T21:00:00Z,MYAK 241N 776W,0,0,2,12,14
Tropical Storm,Bonnie,5,1998-08-20T21:00:00Z,TKPK 173N 627W,42,0,0,0,42
Tropical Storm,Bonnie,5,1998-08-20T21:00:00Z,MYNN 251N 775W,0,0,2,13,15
Tropical Storm,Bonnie,5,1998-08-20T21:00:00Z,TNCM 181N 631W,85,0,0,0,85
Tropical Storm,Bonnie,5,1998-08-20T21:00:00Z,MYGF 266N 787W,0,0,0,11,11
Tropical Storm,Bonnie,5,1998-08-20T21:00:00Z,TISX 177N 648W,35,0,0,0,35
Tropical Storm,Bonnie,5,1998-08-20T21:00:00Z,ST CROIX VI,35,0,0,0,35
Tropical Storm,Bonnie,5,1998-08-20T21:00:00Z,TIST 183N 650W,59,0,0,0,59
Tropical Storm,Bonnie,5,1998-08-20T21:00:00Z,ST THOMAS VI,59,0,0,0,59
Tropical Storm,Bonnie,5,1998-08-20T21:00:00Z,TJPS 180N 666W,25,1,0,0,26
Tropical Storm,Bonnie,5,1998-08-20T21:00:00Z,SAN JUAN PR,44,0,0,0,44
Tropical Storm,Bonnie,5,1998-08-20T21:00:00Z,MDSD 185N 697W,1,12,1,0,14
Tropical Storm,Bonnie,5,1998-08-20T21:00:00Z,PONCE PR,25,1,0,0,26
Tropical Storm,Bonnie,5,1998-08-20T21:00:00Z,MDCB 176N 714W,0,2,2,0,4
Tropical Storm,Bonnie,5,1998-08-20T21:00:00Z,MARATHON FL,0,0,0,5,5
Tropical Storm,Bonnie,5,1998-08-20T21:00:00Z,MTPP 186N 724W,0,3,5,0,8
Tropical Storm,Bonnie,5,1998-08-20T21:00:00Z,MIAMI FL,0,0,0,7,7
Tropical Storm,Bonnie,5,1998-08-20T21:00:00Z,MTCA 183N 738W,0,0,3,2,5
Tropical Storm,Bonnie,5,1998-08-20T21:00:00Z,W PALM BEACH FL,0,0,0,8,8
Tropical Storm,Bonnie,5,1998-08-20T21:00:00Z,MKJP 179N 768W,0,0,0,2,2
Tropical Storm,Bonnie,5,1998-08-20T21:00:00Z,FT PIERCE FL,0,0,0,7,7
Tropical Storm,Bonnie,5,1998-08-20T21:00:00Z,MKJS 185N 779W,0,0,0,2,2
Tropical Storm,Bonnie,5,1998-08-20T21:00:00Z,COCOA BEACH FL,0,0,0,6,6
Tropical Storm,Bonnie,5,1998-08-20T21:00:00Z,MUGM 200N 751W,0,0,6,4,10
Tropical Storm,Bonnie,5,1998-08-20T21:00:00Z,DAYTONA BEACH FL,0,0,0,4,4
Tropical Storm,Bonnie,5,1998-08-20T21:00:00Z,MUCM 214N 779W,0,0,1,8,9
Tropical Storm,Bonnie,5,1998-08-20T21:00:00Z,JACKSONVILLE FL,0,0,0,2,2
Tropical Storm,Bonnie,5,1998-08-20T21:00:00Z,MUCF 221N 805W,0,0,0,4,4
Tropical Storm,Bonnie,5,1998-08-20T21:00:00Z,KEY WEST FL,0,0,0,3,3
Tropical Storm,Bonnie,5,1998-08-20T21:00:00Z,MUHA 230N 824W,0,0,0,2,2
Tropical Storm,Bonnie,5,1998-08-20T21:00:00Z,MARCO ISLAND FL,0,0,0,4,4
Tropical Storm,Bonnie,5,1998-08-20T21:00:00Z,TJSJ 184N 661W,44,0,0,0,44
Tropical Storm,Bonnie,5,1998-08-20T21:00:00Z,FT MYERS FL,0,0,0,4,4
Tropical Storm,Bonnie,5,1998-08-20T21:00:00Z,MDPP 198N 707W,0,19,2,0,21
Tropical Storm,Bonnie,5,1998-08-20T21:00:00Z,VENICE FL,0,0,0,2,2
Tropical Storm,Bonnie,5,1998-08-20T21:00:00Z,MBJT 215N 712W,0,23,3,0,26
Tropical Storm,Bonnie,5,1998-08-20T21:00:00Z,TAMPA FL,0,0,0,2,2
Tropical Storm,Bonnie,6,1998-08-21T03:00:00Z,21.7N  68.8W,57,0,0,0,57
Tropical Storm,Bonnie,6,1998-08-21T03:00:00Z,MYAK 241N 776W,0,0,3,6,9
Tropical Storm,Bonnie,6,1998-08-21T03:00:00Z,23.4N  71.2W,1,31,1,0,33
Tropical Storm,Bonnie,6,1998-08-21T03:00:00Z,MYNN 251N 775W,0,0,4,7,11
Tropical Storm,Bonnie,6,1998-08-21T03:00:00Z,25.1N  72.7W,0,12,11,1,24
Tropical Storm,Bonnie,6,1998-08-21T03:00:00Z,MYGF 266N 787W,0,0,1,8,9
Tropical Storm,Bonnie,6,1998-08-21T03:00:00Z,TNCM 181N 631W,39,0,0,0,39
Tropical Storm,Bonnie,6,1998-08-21T03:00:00Z,ST THOMAS VI,14,0,0,0,14
Tropical Storm,Bonnie,6,1998-08-21T03:00:00Z,TIST 183N 650W,14,0,0,0,14
Tropical Storm,Bonnie,6,1998-08-21T03:00:00Z,SAN JUAN PR,8,0,0,0,8
Tropical Storm,Bonnie,6,1998-08-21T03:00:00Z,MDSD 185N 697W,1,1,0,0,2
Tropical Storm,Bonnie,6,1998-08-21T03:00:00Z,MARATHON FL,0,0,0,2,2
Tropical Storm,Bonnie,6,1998-08-21T03:00:00Z,MUGM 200N 751W,0,0,1,1,2
Tropical Storm,Bonnie,6,1998-08-21T03:00:00Z,MIAMI FL,0,0,0,4,4
Tropical Storm,Bonnie,6,1998-08-21T03:00:00Z,MUCM 214N 779W,0,0,1,1,2
Tropical Storm,Bonnie,6,1998-08-21T03:00:00Z,W PALM BEACH FL,0,0,0,5,5
Tropical Storm,Bonnie,6,1998-08-21T03:00:00Z,TJSJ 184N 661W,8,0,0,0,8
Tropical Storm,Bonnie,6,1998-08-21T03:00:00Z,FT PIERCE FL,0,0,0,5,5
Tropical Storm,Bonnie,6,1998-08-21T03:00:00Z,MDPP 198N 707W,4,8,0,1,13
Tropical Storm,Bonnie,6,1998-08-21T03:00:00Z,COCOA BEACH FL,0,0,0,4,4
Tropical Storm,Bonnie,6,1998-08-21T03:00:00Z,MBJT 215N 712W,4,24,0,0,28
Tropical Storm,Bonnie,6,1998-08-21T03:00:00Z,DAYTONA BEACH FL,0,0,0,3,3
Tropical Storm,Bonnie,6,1998-08-21T03:00:00Z,MYMM 224N 730W,0,17,4,0,21
Tropical Storm,Bonnie,6,1998-08-21T03:00:00Z,MARCO ISLAND FL,0,0,0,2,2
Tropical Storm,Bonnie,6,1998-08-21T03:00:00Z,MYSM 241N 745W,0,4,13,2,19
Tropical Storm,Bonnie,6,1998-08-21T03:00:00Z,FT MYERS FL,0,0,0,2,2
Tropical Storm,Bonnie,6,1998-08-21T03:00:00Z,MYEG 235N 758W,0,1,9,3,13
Tropical Storm,Bonnie,7,1998-08-21T09:00:00Z,22.0N  68.9W,42,0,0,0,42
Tropical Storm,Bonnie,7,1998-08-21T09:00:00Z,MYEG 235N 758W,0,2,8,4,14
Tropical Storm,Bonnie,7,1998-08-21T09:00:00Z,23.4N  71.4W,5,23,0,0,28
Tropical Storm,Bonnie,7,1998-08-21T09:00:00Z,MYAK 241N 776W,0,0,4,6,10
Tropical Storm,Bonnie,7,1998-08-21T09:00:00Z,24.9N  73.0W,0,13,7,2,22
Tropical Storm,Bonnie,7,1998-08-21T09:00:00Z,MYNN 251N 775W,0,0,4,8,12
Tropical Storm,Bonnie,7,1998-08-21T09:00:00Z,TKPK 173N 627W,47,0,0,0,47
Tropical Storm,Bonnie,7,1998-08-21T09:00:00Z,MYGF 266N 787W,0,0,1,8,9
Tropical Storm,Bonnie,7,1998-08-21T09:00:00Z,ST CROIX VI,14,0,0,0,14
Tropical Storm,Bonnie,7,1998-08-21T09:00:00Z,TISX 177N 648W,14,0,0,0,14
Tropical Storm,Bonnie,7,1998-08-21T09:00:00Z,ST THOMAS VI,43,0,0,0,43
Tropical Storm,Bonnie,7,1998-08-21T09:00:00Z,TIST 183N 650W,43,0,0,0,43
Tropical Storm,Bonnie,7,1998-08-21T09:00:00Z,SAN JUAN PR,20,0,0,0,20
Tropical Storm,Bonnie,7,1998-08-21T09:00:00Z,TJPS 180N 666W,4,0,0,0,4
Tropical Storm,Bonnie,7,1998-08-21T09:00:00Z,PONCE PR,4,0,0,0,4
Tropical Storm,Bonnie,7,1998-08-21T09:00:00Z,MDSD 185N 697W,2,1,0,0,3
Tropical Storm,Bonnie,7,1998-08-21T09:00:00Z,MARATHON FL,0,0,0,3,3
Tropical Storm,Bonnie,7,1998-08-21T09:00:00Z,MUGM 200N 751W,0,1,2,1,4
Tropical Storm,Bonnie,7,1998-08-21T09:00:00Z,MIAMI FL,0,0,0,5,5
Tropical Storm,Bonnie,7,1998-08-21T09:00:00Z,MUCM 214N 779W,0,0,1,3,4
Tropical Storm,Bonnie,7,1998-08-21T09:00:00Z,W PALM BEACH FL,0,0,0,5,5
Tropical Storm,Bonnie,7,1998-08-21T09:00:00Z,MUCF 221N 805W,0,0,0,2,2
Tropical Storm,Bonnie,7,1998-08-21T09:00:00Z,FT PIERCE FL,0,0,0,5,5
Tropical Storm,Bonnie,7,1998-08-21T09:00:00Z,TJSJ 184N 661W,20,0,0,0,20
Tropical Storm,Bonnie,7,1998-08-21T09:00:00Z,COCOA BEACH FL,0,0,0,4,4
Tropical Storm,Bonnie,7,1998-08-21T09:00:00Z,MDPP 198N 707W,6,6,0,0,12
Tropical Storm,Bonnie,7,1998-08-21T09:00:00Z,DAYTONA BEACH FL,0,0,0,3,3
Tropical Storm,Bonnie,7,1998-08-21T09:00:00Z,MBJT 215N 712W,11,14,0,0,25
Tropical Storm,Bonnie,7,1998-08-21T09:00:00Z,KEY WEST FL,0,0,0,2,2
Tropical Storm,Bonnie,7,1998-08-21T09:00:00Z,MYMM 224N 730W,1,17,2,0,20
Tropical Storm,Bonnie,7,1998-08-21T09:00:00Z,MARCO ISLAND FL,0,0,0,2,2
Tropical Storm,Bonnie,7,1998-08-21T09:00:00Z,MYSM 241N 745W,0,6,10,2,18
Tropical Storm,Bonnie,7,1998-08-21T09:00:00Z,FT MYERS FL,0,0,0,2,2
Tropical Storm,Bonnie,8,1998-08-21T15:00:00Z,21.0N  70.3W,52,0,0,0,52
Tropical Storm,Bonnie,8,1998-08-21T15:00:00Z,MYGF 266N 787W,0,0,1,15,16
Tropical Storm,Bonnie,8,1998-08-21T15:00:00Z,22.0N  72.5W,8,28,0,0,36
Tropical Storm,Bonnie,8,1998-08-21T15:00:00Z,ST THOMAS VI,19,0,0,0,19
Tropical Storm,Bonnie,8,1998-08-21T15:00:00Z,23.5N  74.5W,0,11,17,1,29
Tropical Storm,Bonnie,8,1998-08-21T15:00:00Z,SAN JUAN PR,21,0,0,0,21
Tropical Storm,Bonnie,8,1998-08-21T15:00:00Z,TIST 183N 650W,19,0,0,0,19
Tropical Storm,Bonnie,8,1998-08-21T15:00:00Z,PONCE PR,4,0,0,0,4
Tropical Storm,Bonnie,8,1998-08-21T15:00:00Z,TJPS 180N 666W,4,0,0,0,4
Tropical Storm,Bonnie,8,1998-08-21T15:00:00Z,MARATHON FL,0,0,0,8,8
Tropical Storm,Bonnie,8,1998-08-21T15:00:00Z,MDSD 185N 697W,12,2,0,0,14
Tropical Storm,Bonnie,8,1998-08-21T15:00:00Z,MIAMI FL,0,0,0,11,11
Tropical Storm,Bonnie,8,1998-08-21T15:00:00Z,MDCB 176N 714W,1,2,0,0,3
Tropical Storm,Bonnie,8,1998-08-21T15:00:00Z,W PALM BEACH FL,0,0,0,12,12
Tropical Storm,Bonnie,8,1998-08-21T15:00:00Z,MTPP 186N 724W,2,8,1,1,12
Tropical Storm,Bonnie,8,1998-08-21T15:00:00Z,FT PIERCE FL,0,0,0,11,11
Tropical Storm,Bonnie,8,1998-08-21T15:00:00Z,MTCA 183N 738W,0,3,2,1,6
Tropical Storm,Bonnie,8,1998-08-21T15:00:00Z,COCOA BEACH FL,0,0,0,10,10
Tropical Storm,Bonnie,8,1998-08-21T15:00:00Z,MUGM 200N 751W,0,5,8,1,14
Tropical Storm,Bonnie,8,1998-08-21T15:00:00Z,DAYTONA BEACH FL,0,0,0,8,8
Tropical Storm,Bonnie,8,1998-08-21T15:00:00Z,MUCM 214N 779W,0,0,4,6,10
Tropical Storm,Bonnie,8,1998-08-21T15:00:00Z,JACKSONVILLE FL,0,0,0,5,5
Tropical Storm,Bonnie,8,1998-08-21T15:00:00Z,MUCF 221N 805W,0,0,0,4,4
Tropical Storm,Bonnie,8,1998-08-21T15:00:00Z,SAVANNAH GA,0,0,0,3,3
Tropical Storm,Bonnie,8,1998-08-21T15:00:00Z,MUHA 230N 824W,0,0,0,2,2
Tropical Storm,Bonnie,8,1998-08-21T15:00:00Z,CHARLESTON SC,0,0,0,3,3
Tropical Storm,Bonnie,8,1998-08-21T15:00:00Z,TJSJ 184N 661W,21,0,0,0,21
Tropical Storm,Bonnie,8,1998-08-21T15:00:00Z,MYRTLE BEACH SC,0,0,0,2,2
Tropical Storm,Bonnie,8,1998-08-21T15:00:00Z,MDPP 198N 707W,33,2,0,0,35
Tropical Storm,Bonnie,8,1998-08-21T15:00:00Z,KEY WEST FL,0,0,0,5,5
Tropical Storm,Bonnie,8,1998-08-21T15:00:00Z,MBJT 215N 712W,38,6,0,0,44
Tropical Storm,Bonnie,8,1998-08-21T15:00:00Z,MARCO ISLAND FL,0,0,0,7,7
Tropical Storm,Bonnie,8,1998-08-21T15:00:00Z,MYMM 224N 730W,2,30,2,0,34
Tropical Storm,Bonnie,8,1998-08-21T15:00:00Z,FT MYERS FL,0,0,0,7,7
Tropical Storm,Bonnie,8,1998-08-21T15:00:00Z,MYSM 241N 745W,0,7,19,1,27
Tropical Storm,Bonnie,8,1998-08-21T15:00:00Z,VENICE FL,0,0,0,5,5
Tropical Storm,Bonnie,8,1998-08-21T15:00:00Z,MYEG 235N 758W,0,2,20,2,24
Tropical Storm,Bonnie,8,1998-08-21T15:00:00Z,TAMPA FL,0,0,0,6,6
Tropical Storm,Bonnie,8,1998-08-21T15:00:00Z,MYAK 241N 776W,0,0,9,9,18
Tropical Storm,Bonnie,8,1998-08-21T15:00:00Z,CEDAR KEY FL,0,0,0,4,4
Tropical Storm,Bonnie,8,1998-08-21T15:00:00Z,MYNN 251N 775W,0,0,8,11,19
Tropical Storm,Bonnie,8,1998-08-21T15:00:00Z,ST MARKS FL,0,0,0,2,2
Tropical Storm,Bonnie,9,1998-08-21T21:00:00Z,22.0N  71.3W,52,0,0,0,52
Tropical Storm,Bonnie,9,1998-08-21T21:00:00Z,MARATHON FL,0,0,0,8,8
Tropical Storm,Bonnie,9,1998-08-21T21:00:00Z,23.0N  73.5W,7,28,1,0,36
Tropical Storm,Bonnie,9,1998-08-21T21:00:00Z,MIAMI FL,0,0,1,11,12
Tropical Storm,Bonnie,9,1998-08-21T21:00:00Z,24.0N  75.0W,0,19,7,1,27
Tropical Storm,Bonnie,9,1998-08-21T21:00:00Z,W PALM BEACH FL,0,0,1,11,12
Tropical Storm,Bonnie,9,1998-08-21T21:00:00Z,MDSD 185N 697W,2,0,0,0,2
Tropical Storm,Bonnie,9,1998-08-21T21:00:00Z,FT PIERCE FL,0,0,0,12,12
Tropical Storm,Bonnie,9,1998-08-21T21:00:00Z,MTPP 186N 724W,1,2,1,0,4
Tropical Storm,Bonnie,9,1998-08-21T21:00:00Z,COCOA BEACH FL,0,0,0,10,10
Tropical Storm,Bonnie,9,1998-08-21T21:00:00Z,MTCA 183N 738W,0,1,1,1,3
Tropical Storm,Bonnie,9,1998-08-21T21:00:00Z,DAYTONA BEACH FL,0,0,0,8,8
Tropical Storm,Bonnie,9,1998-08-21T21:00:00Z,MUGM 200N 751W,0,6,4,1,11
Tropical Storm,Bonnie,9,1998-08-21T21:00:00Z,JACKSONVILLE FL,0,0,0,5,5
Tropical Storm,Bonnie,9,1998-08-21T21:00:00Z,MUCM 214N 779W,0,0,6,5,11
Tropical Storm,Bonnie,9,1998-08-21T21:00:00Z,SAVANNAH GA,0,0,0,3,3
Tropical Storm,Bonnie,9,1998-08-21T21:00:00Z,MUCF 221N 805W,0,0,0,5,5
Tropical Storm,Bonnie,9,1998-08-21T21:00:00Z,CHARLESTON SC,0,0,0,3,3
Tropical Storm,Bonnie,9,1998-08-21T21:00:00Z,MUHA 230N 824W,0,0,0,2,2
Tropical Storm,Bonnie,9,1998-08-21T21:00:00Z,MYRTLE BEACH SC,0,0,0,2,2
Tropical Storm,Bonnie,9,1998-08-21T21:00:00Z,MDPP 198N 707W,24,1,0,0,25
Tropical Storm,Bonnie,9,1998-08-21T21:00:00Z,KEY WEST FL,0,0,0,6,6
Tropical Storm,Bonnie,9,1998-08-21T21:00:00Z,MBJT 215N 712W,51,0,0,0,51
Tropical Storm,Bonnie,9,1998-08-21T21:00:00Z,MARCO ISLAND FL,0,0,0,7,7
Tropical Storm,Bonnie,9,1998-08-21T21:00:00Z,MYMM 224N 730W,20,19,0,0,39
Tropical Storm,Bonnie,9,1998-08-21T21:00:00Z,FT MYERS FL,0,0,0,7,7
Tropical Storm,Bonnie,9,1998-08-21T21:00:00Z,MYSM 241N 745W,0,24,4,1,29
Tropical Storm,Bonnie,9,1998-08-21T21:00:00Z,VENICE FL,0,0,0,6,6
Tropical Storm,Bonnie,9,1998-08-21T21:00:00Z,MYEG 235N 758W,0,12,10,2,24
Tropical Storm,Bonnie,9,1998-08-21T21:00:00Z,TAMPA FL,0,0,0,6,6
Tropical Storm,Bonnie,9,1998-08-21T21:00:00Z,MYAK 241N 776W,0,1,12,6,19
Tropical Storm,Bonnie,9,1998-08-21T21:00:00Z,CEDAR KEY FL,0,0,0,4,4
Tropical Storm,Bonnie,9,1998-08-21T21:00:00Z,MYNN 251N 775W,0,0,12,8,20
Tropical Storm,Bonnie,9,1998-08-21T21:00:00Z,ST MARKS FL,0,0,0,2,2
Tropical Storm,Bonnie,9,1998-08-21T21:00:00Z,MYGF 266N 787W,0,0,3,13,16
Tropical Storm,Bonnie,10,1998-08-22T03:00:00Z,23.3N  72.3W,52,0,0,0,52
Tropical Storm,Bonnie,10,1998-08-22T03:00:00Z,FT PIERCE FL,0,0,0,10,10
Tropical Storm,Bonnie,10,1998-08-22T03:00:00Z,24.3N  73.9W,18,17,0,1,36
Tropical Storm,Bonnie,10,1998-08-22T03:00:00Z,COCOA BEACH FL,0,0,0,9,9
Tropical Storm,Bonnie,10,1998-08-22T03:00:00Z,25.5N  75.0W,1,20,6,1,28
Tropical Storm,Bonnie,10,1998-08-22T03:00:00Z,DAYTONA BEACH FL,0,0,0,7,7
Tropical Storm,Bonnie,10,1998-08-22T03:00:00Z,MUGM 200N 751W,0,2,1,2,5
Tropical Storm,Bonnie,10,1998-08-22T03:00:00Z,JACKSONVILLE FL,0,0,0,6,6
Tropical Storm,Bonnie,10,1998-08-22T03:00:00Z,MUCM 214N 779W,0,0,2,2,4
Tropical Storm,Bonnie,10,1998-08-22T03:00:00Z,SAVANNAH GA,0,0,0,5,5
Tropical Storm,Bonnie,10,1998-08-22T03:00:00Z,MDPP 198N 707W,4,0,1,0,5
Tropical Storm,Bonnie,10,1998-08-22T03:00:00Z,CHARLESTON SC,0,0,0,6,6
Tropical Storm,Bonnie,10,1998-08-22T03:00:00Z,MBJT 215N 712W,50,0,0,0,50
Tropical Storm,Bonnie,10,1998-08-22T03:00:00Z,MYRTLE BEACH SC,0,0,0,5,5
Tropical Storm,Bonnie,10,1998-08-22T03:00:00Z,MYMM 224N 730W,37,1,0,0,38
Tropical Storm,Bonnie,10,1998-08-22T03:00:00Z,WILMINGTON NC,0,0,0,4,4
Tropical Storm,Bonnie,10,1998-08-22T03:00:00Z,MYSM 241N 745W,9,23,0,1,33
Tropical Storm,Bonnie,10,1998-08-22T03:00:00Z,MOREHEAD CITY NC,0,0,0,3,3
Tropical Storm,Bonnie,10,1998-08-22T03:00:00Z,MYEG 235N 758W,1,17,3,2,23
Tropical Storm,Bonnie,10,1998-08-22T03:00:00Z,CAPE HATTERAS NC,0,0,0,2,2
Tropical Storm,Bonnie,10,1998-08-22T03:00:00Z,MYAK 241N 776W,0,2,9,4,15
Tropical Storm,Bonnie,10,1998-08-22T03:00:00Z,KEY WEST FL,0,0,0,2,2
Tropical Storm,Bonnie,10,1998-08-22T03:00:00Z,MYNN 251N 775W,0,2,11,5,18
Tropical Storm,Bonnie,10,1998-08-22T03:00:00Z,MARCO ISLAND FL,0,0,0,4,4
Tropical Storm,Bonnie,10,1998-08-22T03:00:00Z,MYGF 266N 787W,0,0,5,10,15
Tropical Storm,Bonnie,10,1998-08-22T03:00:00Z,FT MYERS FL,0,0,0,4,4
Tropical Storm,Bonnie,10,1998-08-22T03:00:00Z,MARATHON FL,0,0,0,4,4
Tropical Storm,Bonnie,10,1998-08-22T03:00:00Z,VENICE FL,0,0,0,3,3
Tropical Storm,Bonnie,10,1998-08-22T03:00:00Z,MIAMI FL,0,0,1,7,8
Tropical Storm,Bonnie,10,1998-08-22T03:00:00Z,TAMPA FL,0,0,0,3,3
Tropical Storm,Bonnie,10,1998-08-22T03:00:00Z,W PALM BEACH FL,0,0,1,9,10
Tropical Storm,Bonnie,10,1998-08-22T03:00:00Z,CEDAR KEY FL,0,0,0,3,3
Hurricane,Bonnie,11,1998-08-22T09:00:00Z,24.1N  73.1W,53,0,0,0,53
Hurricane,Bonnie,11,1998-08-22T09:00:00Z,COCOA BEACH FL,0,0,0,8,8
Hurricane,Bonnie,11,1998-08-22T09:00:00Z,25.0N  74.2W,25,10,1,0,36
Hurricane,Bonnie,11,1998-08-22T09:00:00Z,DAYTONA BEACH FL,0,0,0,6,6
Hurricane,Bonnie,11,1998-08-22T09:00:00Z,26.0N  75.0W,2,21,3,2,28
Hurricane,Bonnie,11,1998-08-22T09:00:00Z,JACKSONVILLE FL,0,0,0,4,4
Hurricane,Bonnie,11,1998-08-22T09:00:00Z,MUGM 200N 751W,0,1,0,1,2
Hurricane,Bonnie,11,1998-08-22T09:00:00Z,SAVANNAH GA,0,0,0,4,4
Hurricane,Bonnie,11,1998-08-22T09:00:00Z,MUCM 214N 779W,0,0,1,3,4
Hurricane,Bonnie,11,1998-08-22T09:00:00Z,CHARLESTON SC,0,0,0,5,5
Hurricane,Bonnie,11,1998-08-22T09:00:00Z,MBJT 215N 712W,45,0,0,0,45
Hurricane,Bonnie,11,1998-08-22T09:00:00Z,MYRTLE BEACH SC,0,0,0,5,5
Hurricane,Bonnie,11,1998-08-22T09:00:00Z,MYMM 224N 730W,36,0,0,0,36
Hurricane,Bonnie,11,1998-08-22T09:00:00Z,WILMINGTON NC,0,0,0,4,4
Hurricane,Bonnie,11,1998-08-22T09:00:00Z,MYSM 241N 745W,23,9,0,1,33
Hurricane,Bonnie,11,1998-08-22T09:00:00Z,MOREHEAD CITY NC,0,0,0,4,4
Hurricane,Bonnie,11,1998-08-22T09:00:00Z,MYEG 235N 758W,3,13,3,1,20
Hurricane,Bonnie,11,1998-08-22T09:00:00Z,CAPE HATTERAS NC,0,0,0,2,2
Hurricane,Bonnie,11,1998-08-22T09:00:00Z,MYAK 241N 776W,0,3,7,4,14
Hurricane,Bonnie,11,1998-08-22T09:00:00Z,KEY WEST FL,0,0,0,2,2
Hurricane,Bonnie,11,1998-08-22T09:00:00Z,MYNN 251N 775W,0,3,9,5,17
Hurricane,Bonnie,11,1998-08-22T09:00:00Z,MARCO ISLAND FL,0,0,0,3,3
Hurricane,Bonnie,11,1998-08-22T09:00:00Z,MYGF 266N 787W,0,0,5,9,14
Hurricane,Bonnie,11,1998-08-22T09:00:00Z,FT MYERS FL,0,0,0,3,3
Hurricane,Bonnie,11,1998-08-22T09:00:00Z,MARATHON FL,0,0,0,3,3
Hurricane,Bonnie,11,1998-08-22T09:00:00Z,VENICE FL,0,0,0,2,2
Hurricane,Bonnie,11,1998-08-22T09:00:00Z,MIAMI FL,0,0,1,6,7
Hurricane,Bonnie,11,1998-08-22T09:00:00Z,TAMPA FL,0,0,0,3,3
Hurricane,Bonnie,11,1998-08-22T09:00:00Z,W PALM BEACH FL,0,0,1,8,9
Hurricane,Bonnie,11,1998-08-22T09:00:00Z,CEDAR KEY FL,0,0,0,2,2
Hurricane,Bonnie,11,1998-08-22T09:00:00Z,FT PIERCE FL,0,0,0,9,9
Hurricane,Bonnie,12,1998-08-22T15:00:00Z,25.0N  74.5W,52,0,0,0,52
Hurricane,Bonnie,12,1998-08-22T15:00:00Z,DAYTONA BEACH FL,0,0,1,9,10
Hurricane,Bonnie,12,1998-08-22T15:00:00Z,26.0N  75.5W,26,8,1,0,35
Hurricane,Bonnie,12,1998-08-22T15:00:00Z,JACKSONVILLE FL,0,0,0,8,8
Hurricane,Bonnie,12,1998-08-22T15:00:00Z,27.5N  76.0W,3,18,5,2,28
Hurricane,Bonnie,12,1998-08-22T15:00:00Z,SAVANNAH GA,0,0,0,9,9
Hurricane,Bonnie,12,1998-08-22T15:00:00Z,MUCM 214N 779W,0,0,1,1,2
Hurricane,Bonnie,12,1998-08-22T15:00:00Z,CHARLESTON SC,0,0,0,10,10
Hurricane,Bonnie,12,1998-08-22T15:00:00Z,MBJT 215N 712W,20,0,0,0,20
Hurricane,Bonnie,12,1998-08-22T15:00:00Z,MYRTLE BEACH SC,0,0,0,9,9
Hurricane,Bonnie,12,1998-08-22T15:00:00Z,MYMM 224N 730W,42,0,0,0,42
Hurricane,Bonnie,12,1998-08-22T15:00:00Z,WILMINGTON NC,0,0,0,8,8
Hurricane,Bonnie,12,1998-08-22T15:00:00Z,MYSM 241N 745W,47,1,0,0,48
Hurricane,Bonnie,12,1998-08-22T15:00:00Z,MOREHEAD CITY NC,0,0,0,7,7
Hurricane,Bonnie,12,1998-08-22T15:00:00Z,MYEG 235N 758W,16,4,0,1,21
Hurricane,Bonnie,12,1998-08-22T15:00:00Z,CAPE HATTERAS NC,0,0,0,4,4
Hurricane,Bonnie,12,1998-08-22T15:00:00Z,MYAK 241N 776W,1,10,3,1,15
Hurricane,Bonnie,12,1998-08-22T15:00:00Z,NORFOLK VA,0,0,0,2,2
Hurricane,Bonnie,12,1998-08-22T15:00:00Z,MYNN 251N 775W,2,14,2,2,20
Hurricane,Bonnie,12,1998-08-22T15:00:00Z,KEY WEST FL,0,0,0,2,2
Hurricane,Bonnie,12,1998-08-22T15:00:00Z,MYGF 266N 787W,0,5,9,3,17
Hurricane,Bonnie,12,1998-08-22T15:00:00Z,MARCO ISLAND FL,0,0,1,3,4
Hurricane,Bonnie,12,1998-08-22T15:00:00Z,MARATHON FL,0,0,1,3,4
Hurricane,Bonnie,12,1998-08-22T15:00:00Z,FT MYERS FL,0,0,0,5,5
Hurricane,Bonnie,12,1998-08-22T15:00:00Z,MIAMI FL,0,0,3,6,9
Hurricane,Bonnie,12,1998-08-22T15:00:00Z,VENICE FL,0,0,0,4,4
Hurricane,Bonnie,12,1998-08-22T15:00:00Z,W PALM BEACH FL,0,0,5,6,11
Hurricane,Bonnie,12,1998-08-22T15:00:00Z,TAMPA FL,0,0,0,5,5
Hurricane,Bonnie,12,1998-08-22T15:00:00Z,FT PIERCE FL,0,0,4,8,12
Hurricane,Bonnie,12,1998-08-22T15:00:00Z,CEDAR KEY FL,0,0,0,4,4
Hurricane,Bonnie,12,1998-08-22T15:00:00Z,COCOA BEACH FL,0,0,3,8,11
Hurricane,Bonnie,12,1998-08-22T15:00:00Z,ST MARKS FL,0,0,0,2,2
Hurricane,Bonnie,13,1998-08-22T21:00:00Z,25.3N  74.1W,52,0,0,0,52
Hurricane,Bonnie,13,1998-08-22T21:00:00Z,JACKSONVILLE FL,0,0,0,9,9
Hurricane,Bonnie,13,1998-08-22T21:00:00Z,26.5N  75.0W,23,10,1,0,34
Hurricane,Bonnie,13,1998-08-22T21:00:00Z,SAVANNAH GA,0,0,0,10,10
Hurricane,Bonnie,13,1998-08-22T21:00:00Z,28.0N  76.0W,0,19,8,1,28
Hurricane,Bonnie,13,1998-08-22T21:00:00Z,CHARLESTON SC,0,0,0,12,12
Hurricane,Bonnie,13,1998-08-22T21:00:00Z,MYMM 224N 730W,11,0,0,0,11
Hurricane,Bonnie,13,1998-08-22T21:00:00Z,MYRTLE BEACH SC,0,0,0,11,11
Hurricane,Bonnie,13,1998-08-22T21:00:00Z,MYSM 241N 745W,36,0,0,0,36
Hurricane,Bonnie,13,1998-08-22T21:00:00Z,WILMINGTON NC,0,0,0,10,10
Hurricane,Bonnie,13,1998-08-22T21:00:00Z,MYEG 235N 758W,9,6,0,1,16
Hurricane,Bonnie,13,1998-08-22T21:00:00Z,MOREHEAD CITY NC,0,0,0,8,8
Hurricane,Bonnie,13,1998-08-22T21:00:00Z,MYAK 241N 776W,1,5,3,3,12
Hurricane,Bonnie,13,1998-08-22T21:00:00Z,CAPE HATTERAS NC,0,0,0,5,5
Hurricane,Bonnie,13,1998-08-22T21:00:00Z,MYNN 251N 775W,1,10,4,2,17
Hurricane,Bonnie,13,1998-08-22T21:00:00Z,NORFOLK VA,0,0,0,2,2
Hurricane,Bonnie,13,1998-08-22T21:00:00Z,MYGF 266N 787W,0,2,10,4,16
Hurricane,Bonnie,13,1998-08-22T21:00:00Z,MARCO ISLAND FL,0,0,0,3,3
Hurricane,Bonnie,13,1998-08-22T21:00:00Z,MARATHON FL,0,0,0,2,2
Hurricane,Bonnie,13,1998-08-22T21:00:00Z,FT MYERS FL,0,0,0,3,3
Hurricane,Bonnie,13,1998-08-22T21:00:00Z,MIAMI FL,0,0,2,4,6
Hurricane,Bonnie,13,1998-08-22T21:00:00Z,VENICE FL,0,0,0,3,3
Hurricane,Bonnie,13,1998-08-22T21:00:00Z,W PALM BEACH FL,0,0,4,6,10
Hurricane,Bonnie,13,1998-08-22T21:00:00Z,TAMPA FL,0,0,0,4,4
Hurricane,Bonnie,13,1998-08-22T21:00:00Z,FT PIERCE FL,0,0,4,7,11
Hurricane,Bonnie,13,1998-08-22T21:00:00Z,CEDAR KEY FL,0,0,0,4,4
Hurricane,Bonnie,13,1998-08-22T21:00:00Z,COCOA BEACH FL,0,0,3,8,11
Hurricane,Bonnie,13,1998-08-22T21:00:00Z,ST MARKS FL,0,0,0,2,2
Hurricane,Bonnie,13,1998-08-22T21:00:00Z,DAYTONA BEACH FL,0,0,1,9,10
Hurricane,Bonnie,14,1998-08-23T03:00:00Z,25.6N  74.0W,56,0,0,0,56
Hurricane,Bonnie,14,1998-08-23T03:00:00Z,DAYTONA BEACH FL,0,0,1,5,6
Hurricane,Bonnie,14,1998-08-23T03:00:00Z,27.1N  74.8W,23,14,0,0,37
Hurricane,Bonnie,14,1998-08-23T03:00:00Z,JACKSONVILLE FL,0,0,0,6,6
Hurricane,Bonnie,14,1998-08-23T03:00:00Z,29.0N  75.4W,0,17,11,0,28
Hurricane,Bonnie,14,1998-08-23T03:00:00Z,SAVANNAH GA,0,0,0,9,9
Hurricane,Bonnie,14,1998-08-23T03:00:00Z,MYMM 224N 730W,36,0,0,0,36
Hurricane,Bonnie,14,1998-08-23T03:00:00Z,CHARLESTON SC,0,0,0,12,12
Hurricane,Bonnie,14,1998-08-23T03:00:00Z,MYSM 241N 745W,39,0,0,0,39
Hurricane,Bonnie,14,1998-08-23T03:00:00Z,MYRTLE BEACH SC,0,0,0,14,14
Hurricane,Bonnie,14,1998-08-23T03:00:00Z,MYEG 235N 758W,8,5,0,0,13
Hurricane,Bonnie,14,1998-08-23T03:00:00Z,WILMINGTON NC,0,0,0,14,14
Hurricane,Bonnie,14,1998-08-23T03:00:00Z,MYAK 241N 776W,0,2,2,0,4
Hurricane,Bonnie,14,1998-08-23T03:00:00Z,MOREHEAD CITY NC,0,0,0,13,13
Hurricane,Bonnie,14,1998-08-23T03:00:00Z,MYNN 251N 775W,0,6,3,1,10
Hurricane,Bonnie,14,1998-08-23T03:00:00Z,CAPE HATTERAS NC,0,0,0,11,11
Hurricane,Bonnie,14,1998-08-23T03:00:00Z,MYGF 266N 787W,0,1,5,2,8
Hurricane,Bonnie,14,1998-08-23T03:00:00Z,NORFOLK VA,0,0,0,7,7
Hurricane,Bonnie,14,1998-08-23T03:00:00Z,W PALM BEACH FL,0,0,1,3,4
Hurricane,Bonnie,14,1998-08-23T03:00:00Z,OCEAN CITY MD,0,0,0,3,3
Hurricane,Bonnie,14,1998-08-23T03:00:00Z,FT PIERCE FL,0,0,1,4,5
Hurricane,Bonnie,14,1998-08-23T03:00:00Z,CEDAR KEY FL,0,0,0,2,2
Hurricane,Bonnie,14,1998-08-23T03:00:00Z,COCOA BEACH FL,0,0,1,4,5
Hurricane,Bonnie,15,1998-08-23T09:00:00Z,25.3N  73.2W,60,0,0,0,60
Hurricane,Bonnie,15,1998-08-23T09:00:00Z,DAYTONA BEACH FL,0,0,0,6,6
Hurricane,Bonnie,15,1998-08-23T09:00:00Z,26.6N  74.2W,20,14,0,0,34
Hurricane,Bonnie,15,1998-08-23T09:00:00Z,JACKSONVILLE FL,0,0,0,6,6
Hurricane,Bonnie,15,1998-08-23T09:00:00Z,28.5N  75.0W,0,14,11,1,26
Hurricane,Bonnie,15,1998-08-23T09:00:00Z,SAVANNAH GA,0,0,0,9,9
Hurricane,Bonnie,15,1998-08-23T09:00:00Z,MYMM 224N 730W,25,0,0,0,25
Hurricane,Bonnie,15,1998-08-23T09:00:00Z,CHARLESTON SC,0,0,0,12,12
Hurricane,Bonnie,15,1998-08-23T09:00:00Z,MYSM 241N 745W,24,3,0,0,27
Hurricane,Bonnie,15,1998-08-23T09:00:00Z,MYRTLE BEACH SC,0,0,0,14,14
Hurricane,Bonnie,15,1998-08-23T09:00:00Z,MYEG 235N 758W,2,7,1,1,11
Hurricane,Bonnie,15,1998-08-23T09:00:00Z,WILMINGTON NC,0,0,0,14,14
Hurricane,Bonnie,15,1998-08-23T09:00:00Z,MYAK 241N 776W,0,1,3,0,4
Hurricane,Bonnie,15,1998-08-23T09:00:00Z,MOREHEAD CITY NC,0,0,0,14,14
Hurricane,Bonnie,15,1998-08-23T09:00:00Z,MYNN 251N 775W,0,3,5,1,9
Hurricane,Bonnie,15,1998-08-23T09:00:00Z,CAPE HATTERAS NC,0,0,0,13,13
Hurricane,Bonnie,15,1998-08-23T09:00:00Z,MYGF 266N 787W,0,0,6,3,9
Hurricane,Bonnie,15,1998-08-23T09:00:00Z,NORFOLK VA,0,0,0,9,9
Hurricane,Bonnie,15,1998-08-23T09:00:00Z,MIAMI FL,0,0,1,1,2
Hurricane,Bonnie,15,1998-08-23T09:00:00Z,OCEAN CITY MD,0,0,0,5,5
Hurricane,Bonnie,15,1998-08-23T09:00:00Z,W PALM BEACH FL,0,0,1,3,4
Hurricane,Bonnie,15,1998-08-23T09:00:00Z,ATLANTIC CITY NJ,0,0,0,2,2
Hurricane,Bonnie,15,1998-08-23T09:00:00Z,FT PIERCE FL,0,0,1,4,5
Hurricane,Bonnie,15,1998-08-23T09:00:00Z,CEDAR KEY FL,0,0,0,2,2
Hurricane,Bonnie,15,1998-08-23T09:00:00Z,COCOA BEACH FL,0,0,1,5,6
Hurricane,Bonnie,16,1998-08-23T15:00:00Z,26.5N  73.5W,50,0,0,0,50
Hurricane,Bonnie,16,1998-08-23T15:00:00Z,JACKSONVILLE FL,0,0,0,7,7
Hurricane,Bonnie,16,1998-08-23T15:00:00Z,28.1N  74.3W,21,13,0,0,34
Hurricane,Bonnie,16,1998-08-23T15:00:00Z,SAVANNAH GA,0,0,0,10,10
Hurricane,Bonnie,16,1998-08-23T15:00:00Z,29.8N  75.2W,1,17,7,1,26
Hurricane,Bonnie,16,1998-08-23T15:00:00Z,CHARLESTON SC,0,0,1,12,13
Hurricane,Bonnie,16,1998-08-23T15:00:00Z,MYMM 224N 730W,2,0,0,0,2
Hurricane,Bonnie,16,1998-08-23T15:00:00Z,MYRTLE BEACH SC,0,0,1,13,14
Hurricane,Bonnie,16,1998-08-23T15:00:00Z,MYSM 241N 745W,17,0,0,0,17
Hurricane,Bonnie,16,1998-08-23T15:00:00Z,WILMINGTON NC,0,0,1,13,14
Hurricane,Bonnie,16,1998-08-23T15:00:00Z,MYEG 235N 758W,1,1,0,1,3
Hurricane,Bonnie,16,1998-08-23T15:00:00Z,MOREHEAD CITY NC,0,0,1,13,14
Hurricane,Bonnie,16,1998-08-23T15:00:00Z,MYAK 241N 776W,0,1,0,1,2
Hurricane,Bonnie,16,1998-08-23T15:00:00Z,CAPE HATTERAS NC,0,0,0,12,12
Hurricane,Bonnie,16,1998-08-23T15:00:00Z,MYNN 251N 775W,0,3,1,1,5
Hurricane,Bonnie,16,1998-08-23T15:00:00Z,NORFOLK VA,0,0,0,10,10
Hurricane,Bonnie,16,1998-08-23T15:00:00Z,MYGF 266N 787W,0,1,4,3,8
Hurricane,Bonnie,16,1998-08-23T15:00:00Z,OCEAN CITY MD,0,0,0,6,6
Hurricane,Bonnie,16,1998-08-23T15:00:00Z,MIAMI FL,0,0,0,2,2
Hurricane,Bonnie,16,1998-08-23T15:00:00Z,ATLANTIC CITY NJ,0,0,0,3,3
Hurricane,Bonnie,16,1998-08-23T15:00:00Z,W PALM BEACH FL,0,0,1,3,4
Hurricane,Bonnie,16,1998-08-23T15:00:00Z,TAMPA FL,0,0,0,2,2
Hurricane,Bonnie,16,1998-08-23T15:00:00Z,FT PIERCE FL,0,0,2,3,5
Hurricane,Bonnie,16,1998-08-23T15:00:00Z,CEDAR KEY FL,0,0,0,3,3
Hurricane,Bonnie,16,1998-08-23T15:00:00Z,COCOA BEACH FL,0,0,1,5,6
Hurricane,Bonnie,16,1998-08-23T15:00:00Z,ST MARKS FL,0,0,0,2,2
Hurricane,Bonnie,16,1998-08-23T15:00:00Z,DAYTONA BEACH FL,0,0,1,6,7
Hurricane,Bonnie,17,1998-08-23T21:00:00Z,26.3N  73.0W,57,0,0,0,57
Hurricane,Bonnie,17,1998-08-23T21:00:00Z,CHARLESTON SC,0,0,1,13,14
Hurricane,Bonnie,17,1998-08-23T21:00:00Z,27.6N  74.0W,21,11,1,0,33
Hurricane,Bonnie,17,1998-08-23T21:00:00Z,MYRTLE BEACH SC,0,0,1,14,15
Hurricane,Bonnie,17,1998-08-23T21:00:00Z,29.4N  75.4W,0,13,11,1,25
Hurricane,Bonnie,17,1998-08-23T21:00:00Z,WILMINGTON NC,0,0,0,14,14
Hurricane,Bonnie,17,1998-08-23T21:00:00Z,MYSM 241N 745W,12,2,0,0,14
Hurricane,Bonnie,17,1998-08-23T21:00:00Z,MOREHEAD CITY NC,0,0,0,12,12
Hurricane,Bonnie,17,1998-08-23T21:00:00Z,MYEG 235N 758W,1,1,0,1,3
Hurricane,Bonnie,17,1998-08-23T21:00:00Z,CAPE HATTERAS NC,0,0,0,10,10
Hurricane,Bonnie,17,1998-08-23T21:00:00Z,MYAK 241N 776W,0,0,1,1,2
Hurricane,Bonnie,17,1998-08-23T21:00:00Z,NORFOLK VA,0,0,0,7,7
Hurricane,Bonnie,17,1998-08-23T21:00:00Z,MYNN 251N 775W,0,2,2,2,6
Hurricane,Bonnie,17,1998-08-23T21:00:00Z,OCEAN CITY MD,0,0,0,3,3
Hurricane,Bonnie,17,1998-08-23T21:00:00Z,MYGF 266N 787W,0,1,5,3,9
Hurricane,Bonnie,17,1998-08-23T21:00:00Z,MARCO ISLAND FL,0,0,0,2,2
Hurricane,Bonnie,17,1998-08-23T21:00:00Z,MIAMI FL,0,0,1,2,3
Hurricane,Bonnie,17,1998-08-23T21:00:00Z,FT MYERS FL,0,0,0,2,2
Hurricane,Bonnie,17,1998-08-23T21:00:00Z,W PALM BEACH FL,0,0,2,3,5
Hurricane,Bonnie,17,1998-08-23T21:00:00Z,VENICE FL,0,0,0,2,2
Hurricane,Bonnie,17,1998-08-23T21:00:00Z,FT PIERCE FL,0,0,2,5,7
Hurricane,Bonnie,17,1998-08-23T21:00:00Z,TAMPA FL,0,0,0,4,4
Hurricane,Bonnie,17,1998-08-23T21:00:00Z,COCOA BEACH FL,0,0,2,6,8
Hurricane,Bonnie,17,1998-08-23T21:00:00Z,CEDAR KEY FL,0,0,0,4,4
Hurricane,Bonnie,17,1998-08-23T21:00:00Z,DAYTONA BEACH FL,0,0,2,7,9
Hurricane,Bonnie,17,1998-08-23T21:00:00Z,ST MARKS FL,0,0,0,4,4
Hurricane,Bonnie,17,1998-08-23T21:00:00Z,JACKSONVILLE FL,0,0,1,9,10
Hurricane,Bonnie,17,1998-08-23T21:00:00Z,APALACHICOLA FL,0,0,0,2,2
Hurricane,Bonnie,17,1998-08-23T21:00:00Z,SAVANNAH GA,0,0,1,11,12
Hurricane,Bonnie,18,1998-08-24T03:00:00Z,27.0N  73.4W,44,0,0,0,44
Hurricane,Bonnie,18,1998-08-24T03:00:00Z,WILMINGTON NC,0,0,4,11,15
Hurricane,Bonnie,18,1998-08-24T03:00:00Z,28.4N  74.8W,20,10,0,0,30
Hurricane,Bonnie,18,1998-08-24T03:00:00Z,MOREHEAD CITY NC,0,0,3,9,12
Hurricane,Bonnie,18,1998-08-24T03:00:00Z,30.0N  76.5W,0,16,8,1,25
Hurricane,Bonnie,18,1998-08-24T03:00:00Z,CAPE HATTERAS NC,0,0,1,8,9
Hurricane,Bonnie,18,1998-08-24T03:00:00Z,MYSM 241N 745W,8,1,1,0,10
Hurricane,Bonnie,18,1998-08-24T03:00:00Z,NORFOLK VA,0,0,0,7,7
Hurricane,Bonnie,18,1998-08-24T03:00:00Z,MYEG 235N 758W,0,1,1,1,3
Hurricane,Bonnie,18,1998-08-24T03:00:00Z,OCEAN CITY MD,0,0,0,3,3
Hurricane,Bonnie,18,1998-08-24T03:00:00Z,MYAK 241N 776W,0,0,1,3,4
Hurricane,Bonnie,18,1998-08-24T03:00:00Z,KEY WEST FL,0,0,0,3,3
Hurricane,Bonnie,18,1998-08-24T03:00:00Z,MYNN 251N 775W,0,2,2,4,8
Hurricane,Bonnie,18,1998-08-24T03:00:00Z,MARCO ISLAND FL,0,0,0,5,5
Hurricane,Bonnie,18,1998-08-24T03:00:00Z,MYGF 266N 787W,0,2,5,4,11
Hurricane,Bonnie,18,1998-08-24T03:00:00Z,FT MYERS FL,0,0,0,6,6
Hurricane,Bonnie,18,1998-08-24T03:00:00Z,MARATHON FL,0,0,0,3,3
Hurricane,Bonnie,18,1998-08-24T03:00:00Z,VENICE FL,0,0,0,6,6
Hurricane,Bonnie,18,1998-08-24T03:00:00Z,MIAMI FL,0,0,1,5,6
Hurricane,Bonnie,18,1998-08-24T03:00:00Z,TAMPA FL,0,0,0,8,8
Hurricane,Bonnie,18,1998-08-24T03:00:00Z,W PALM BEACH FL,0,0,2,7,9
Hurricane,Bonnie,18,1998-08-24T03:00:00Z,CEDAR KEY FL,0,0,0,9,9
Hurricane,Bonnie,18,1998-08-24T03:00:00Z,FT PIERCE FL,0,0,3,8,11
Hurricane,Bonnie,18,1998-08-24T03:00:00Z,ST MARKS FL,0,0,0,8,8
Hurricane,Bonnie,18,1998-08-24T03:00:00Z,COCOA BEACH FL,0,0,4,8,12
Hurricane,Bonnie,18,1998-08-24T03:00:00Z,APALACHICOLA FL,0,0,0,5,5
Hurricane,Bonnie,18,1998-08-24T03:00:00Z,DAYTONA BEACH FL,0,0,4,9,13
Hurricane,Bonnie,18,1998-08-24T03:00:00Z,PANAMA CITY FL,0,0,0,5,5
Hurricane,Bonnie,18,1998-08-24T03:00:00Z,JACKSONVILLE FL,0,0,3,10,13
Hurricane,Bonnie,18,1998-08-24T03:00:00Z,PENSACOLA FL,0,0,0,2,2
Hurricane,Bonnie,18,1998-08-24T03:00:00Z,SAVANNAH GA,0,0,4,11,15
Hurricane,Bonnie,18,1998-08-24T03:00:00Z,GULF 29N 85W,0,0,0,5,5
Hurricane,Bonnie,18,1998-08-24T03:00:00Z,CHARLESTON SC,0,0,6,11,17
Hurricane,Bonnie,18,1998-08-24T03:00:00Z,GULF 29N 87W,0,0,0,2,2
Hurricane,Bonnie,18,1998-08-24T03:00:00Z,MYRTLE BEACH SC,0,0,6,10,16
Hurricane,Bonnie,19,1998-08-24T09:00:00Z,27.2N  74.0W,50,0,0,0,50
Hurricane,Bonnie,19,1998-08-24T09:00:00Z,MYRTLE BEACH SC,0,0,6,11,17
Hurricane,Bonnie,19,1998-08-24T09:00:00Z,28.8N  75.2W,23,10,0,0,33
Hurricane,Bonnie,19,1998-08-24T09:00:00Z,WILMINGTON NC,0,0,5,11,16
Hurricane,Bonnie,19,1998-08-24T09:00:00Z,30.5N  76.5W,0,18,7,1,26
Hurricane,Bonnie,19,1998-08-24T09:00:00Z,MOREHEAD CITY NC,0,0,3,12,15
Hurricane,Bonnie,19,1998-08-24T09:00:00Z,MYSM 241N 745W,7,1,0,0,8
Hurricane,Bonnie,19,1998-08-24T09:00:00Z,CAPE HATTERAS NC,0,0,1,11,12
Hurricane,Bonnie,19,1998-08-24T09:00:00Z,MYNN 251N 775W,0,1,1,2,4
Hurricane,Bonnie,19,1998-08-24T09:00:00Z,NORFOLK VA,0,0,0,10,10
Hurricane,Bonnie,19,1998-08-24T09:00:00Z,MYGF 266N 787W,0,2,3,2,7
Hurricane,Bonnie,19,1998-08-24T09:00:00Z,OCEAN CITY MD,0,0,0,6,6
Hurricane,Bonnie,19,1998-08-24T09:00:00Z,MIAMI FL,0,0,0,2,2
Hurricane,Bonnie,19,1998-08-24T09:00:00Z,ATLANTIC CITY NJ,0,0,0,3,3
Hurricane,Bonnie,19,1998-08-24T09:00:00Z,W PALM BEACH FL,0,0,1,3,4
Hurricane,Bonnie,19,1998-08-24T09:00:00Z,FT MYERS FL,0,0,0,2,2
Hurricane,Bonnie,19,1998-08-24T09:00:00Z,FT PIERCE FL,0,0,2,4,6
Hurricane,Bonnie,19,1998-08-24T09:00:00Z,VENICE FL,0,0,0,2,2
Hurricane,Bonnie,19,1998-08-24T09:00:00Z,COCOA BEACH FL,0,0,3,5,8
Hurricane,Bonnie,19,1998-08-24T09:00:00Z,TAMPA FL,0,0,0,3,3
Hurricane,Bonnie,19,1998-08-24T09:00:00Z,DAYTONA BEACH FL,0,0,4,5,9
Hurricane,Bonnie,19,1998-08-24T09:00:00Z,CEDAR KEY FL,0,0,0,4,4
Hurricane,Bonnie,19,1998-08-24T09:00:00Z,JACKSONVILLE FL,0,0,3,7,10
Hurricane,Bonnie,19,1998-08-24T09:00:00Z,ST MARKS FL,0,0,0,4,4
Hurricane,Bonnie,19,1998-08-24T09:00:00Z,SAVANNAH GA,0,0,5,9,14
Hurricane,Bonnie,19,1998-08-24T09:00:00Z,APALACHICOLA FL,0,0,0,2,2
Hurricane,Bonnie,19,1998-08-24T09:00:00Z,CHARLESTON SC,0,0,7,10,17
Hurricane,Bonnie,20,1998-08-24T15:00:00Z,28.0N  74.1W,47,0,0,0,47
Hurricane,Bonnie,20,1998-08-24T15:00:00Z,CHARLESTON SC,0,0,6,8,14
Hurricane,Bonnie,20,1998-08-24T15:00:00Z,29.7N  74.8W,21,10,1,0,32
Hurricane,Bonnie,20,1998-08-24T15:00:00Z,MYRTLE BEACH SC,0,0,8,8,16
Hurricane,Bonnie,20,1998-08-24T15:00:00Z,31.5N  75.5W,1,17,5,2,25
Hurricane,Bonnie,20,1998-08-24T15:00:00Z,WILMINGTON NC,0,0,8,9,17
Hurricane,Bonnie,20,1998-08-24T15:00:00Z,MYSM 241N 745W,6,0,0,0,6
Hurricane,Bonnie,20,1998-08-24T15:00:00Z,MOREHEAD CITY NC,0,0,7,10,17
Hurricane,Bonnie,20,1998-08-24T15:00:00Z,MYNN 251N 775W,0,1,0,1,2
Hurricane,Bonnie,20,1998-08-24T15:00:00Z,CAPE HATTERAS NC,0,0,4,12,16
Hurricane,Bonnie,20,1998-08-24T15:00:00Z,MYGF 266N 787W,0,1,0,3,4
Hurricane,Bonnie,20,1998-08-24T15:00:00Z,NORFOLK VA,0,0,1,12,13
Hurricane,Bonnie,20,1998-08-24T15:00:00Z,W PALM BEACH FL,0,0,0,2,2
Hurricane,Bonnie,20,1998-08-24T15:00:00Z,OCEAN CITY MD,0,0,0,9,9
Hurricane,Bonnie,20,1998-08-24T15:00:00Z,FT PIERCE FL,0,0,1,2,3
Hurricane,Bonnie,20,1998-08-24T15:00:00Z,ATLANTIC CITY NJ,0,0,0,7,7
Hurricane,Bonnie,20,1998-08-24T15:00:00Z,COCOA BEACH FL,0,0,1,3,4
Hurricane,Bonnie,20,1998-08-24T15:00:00Z,NEW YORK CITY NY,0,0,0,4,4
Hurricane,Bonnie,20,1998-08-24T15:00:00Z,DAYTONA BEACH FL,0,0,1,4,5
Hurricane,Bonnie,20,1998-08-24T15:00:00Z,MONTAUK POINT NY,0,0,0,2,2
Hurricane,Bonnie,20,1998-08-24T15:00:00Z,JACKSONVILLE FL,0,0,1,5,6
Hurricane,Bonnie,20,1998-08-24T15:00:00Z,CEDAR KEY FL,0,0,0,2,2
Hurricane,Bonnie,20,1998-08-24T15:00:00Z,SAVANNAH GA,0,0,2,8,10
Hurricane,Bonnie,21,1998-08-24T21:00:00Z,28.9N  74.5W,44,0,0,0,44
Hurricane,Bonnie,21,1998-08-24T21:00:00Z,MYRTLE BEACH SC,0,1,11,5,17
Hurricane,Bonnie,21,1998-08-24T21:00:00Z,30.7N  75.3W,17,14,1,0,32
Hurricane,Bonnie,21,1998-08-24T21:00:00Z,WILMINGTON NC,0,1,12,5,18
Hurricane,Bonnie,21,1998-08-24T21:00:00Z,32.5N  76.0W,0,16,6,1,23
Hurricane,Bonnie,21,1998-08-24T21:00:00Z,MOREHEAD CITY NC,0,1,11,6,18
Hurricane,Bonnie,21,1998-08-24T21:00:00Z,MYNN 251N 775W,0,0,0,2,2
Hurricane,Bonnie,21,1998-08-24T21:00:00Z,CAPE HATTERAS NC,0,0,8,9,17
Hurricane,Bonnie,21,1998-08-24T21:00:00Z,MYGF 266N 787W,0,0,1,2,3
Hurricane,Bonnie,21,1998-08-24T21:00:00Z,NORFOLK VA,0,0,2,13,15
Hurricane,Bonnie,21,1998-08-24T21:00:00Z,W PALM BEACH FL,0,0,0,2,2
Hurricane,Bonnie,21,1998-08-24T21:00:00Z,OCEAN CITY MD,0,0,0,11,11
Hurricane,Bonnie,21,1998-08-24T21:00:00Z,FT PIERCE FL,0,0,0,3,3
Hurricane,Bonnie,21,1998-08-24T21:00:00Z,ATLANTIC CITY NJ,0,0,0,9,9
Hurricane,Bonnie,21,1998-08-24T21:00:00Z,COCOA BEACH FL,0,0,1,3,4
Hurricane,Bonnie,21,1998-08-24T21:00:00Z,NEW YORK CITY NY,0,0,0,6,6
Hurricane,Bonnie,21,1998-08-24T21:00:00Z,DAYTONA BEACH FL,0,0,1,3,4
Hurricane,Bonnie,21,1998-08-24T21:00:00Z,MONTAUK POINT NY,0,0,0,3,3
Hurricane,Bonnie,21,1998-08-24T21:00:00Z,JACKSONVILLE FL,0,0,1,4,5
Hurricane,Bonnie,21,1998-08-24T21:00:00Z,PROVIDENCE RI,0,0,0,2,2
Hurricane,Bonnie,21,1998-08-24T21:00:00Z,SAVANNAH GA,0,0,4,6,10
Hurricane,Bonnie,21,1998-08-24T21:00:00Z,BOSTON MA,0,0,0,2,2
Hurricane,Bonnie,21,1998-08-24T21:00:00Z,CHARLESTON SC,0,1,8,5,14
Hurricane,Bonnie,22,1998-08-25T03:00:00Z,30.0N  75.0W,43,0,0,0,43
Hurricane,Bonnie,22,1998-08-25T03:00:00Z,OCEAN CITY MD,0,0,2,13,15
Hurricane,Bonnie,22,1998-08-25T03:00:00Z,32.0N  75.8W,15,15,0,1,31
Hurricane,Bonnie,22,1998-08-25T03:00:00Z,ATLANTIC CITY NJ,0,0,0,13,13
Hurricane,Bonnie,22,1998-08-25T03:00:00Z,34.5N  76.0W,0,9,12,2,23
Hurricane,Bonnie,22,1998-08-25T03:00:00Z,NEW YORK CITY NY,0,0,0,11,11
Hurricane,Bonnie,22,1998-08-25T03:00:00Z,SAVANNAH GA,0,1,3,1,5
Hurricane,Bonnie,22,1998-08-25T03:00:00Z,MONTAUK POINT NY,0,0,0,9,9
Hurricane,Bonnie,22,1998-08-25T03:00:00Z,CHARLESTON SC,0,4,7,2,13
Hurricane,Bonnie,22,1998-08-25T03:00:00Z,PROVIDENCE RI,0,0,0,7,7
Hurricane,Bonnie,22,1998-08-25T03:00:00Z,MYRTLE BEACH SC,0,7,10,2,19
Hurricane,Bonnie,22,1998-08-25T03:00:00Z,NANTUCKET MA,0,0,0,6,6
Hurricane,Bonnie,22,1998-08-25T03:00:00Z,WILMINGTON NC,0,8,12,1,21
Hurricane,Bonnie,22,1998-08-25T03:00:00Z,HYANNIS MA,0,0,0,6,6
Hurricane,Bonnie,22,1998-08-25T03:00:00Z,MOREHEAD CITY NC,0,7,13,2,22
Hurricane,Bonnie,22,1998-08-25T03:00:00Z,BOSTON MA,0,0,0,6,6
Hurricane,Bonnie,22,1998-08-25T03:00:00Z,CAPE HATTERAS NC,0,3,13,4,20
Hurricane,Bonnie,22,1998-08-25T03:00:00Z,PORTLAND ME,0,0,0,3,3
Hurricane,Bonnie,22,1998-08-25T03:00:00Z,NORFOLK VA,0,0,8,9,17
Hurricane,Bonnie,23,1998-08-25T09:00:00Z,31.6N  75.6W,45,0,0,0,45
Hurricane,Bonnie,23,1998-08-25T09:00:00Z,ATLANTIC CITY NJ,0,0,5,12,17
Hurricane,Bonnie,23,1998-08-25T09:00:00Z,33.8N  76.0W,16,14,0,0,30
Hurricane,Bonnie,23,1998-08-25T09:00:00Z,NEW YORK CITY NY,0,0,2,13,15
Hurricane,Bonnie,23,1998-08-25T09:00:00Z,36.5N  75.5W,0,8,13,2,23
Hurricane,Bonnie,23,1998-08-25T09:00:00Z,MONTAUK POINT NY,0,0,0,14,14
Hurricane,Bonnie,23,1998-08-25T09:00:00Z,BERMUDA,0,0,0,2,2
Hurricane,Bonnie,23,1998-08-25T09:00:00Z,PROVIDENCE RI,0,0,0,13,13
Hurricane,Bonnie,23,1998-08-25T09:00:00Z,SAVANNAH GA,0,1,2,0,3
Hurricane,Bonnie,23,1998-08-25T09:00:00Z,NANTUCKET MA,0,0,0,12,12
Hurricane,Bonnie,23,1998-08-25T09:00:00Z,CHARLESTON SC,0,8,3,1,12
Hurricane,Bonnie,23,1998-08-25T09:00:00Z,HYANNIS MA,0,0,0,12,12
Hurricane,Bonnie,23,1998-08-25T09:00:00Z,MYRTLE BEACH SC,1,15,3,1,20
Hurricane,Bonnie,23,1998-08-25T09:00:00Z,BOSTON MA,0,0,0,12,12
Hurricane,Bonnie,23,1998-08-25T09:00:00Z,WILMINGTON NC,2,19,3,1,25
Hurricane,Bonnie,23,1998-08-25T09:00:00Z,PORTLAND ME,0,0,0,9,9
Hurricane,Bonnie,23,1998-08-25T09:00:00Z,MOREHEAD CITY NC,3,20,4,0,27
Hurricane,Bonnie,23,1998-08-25T09:00:00Z,BAR HARBOR ME,0,0,0,6,6
Hurricane,Bonnie,23,1998-08-25T09:00:00Z,CAPE HATTERAS NC,1,17,7,1,26
Hurricane,Bonnie,23,1998-08-25T09:00:00Z,EASTPORT ME,0,0,0,3,3
Hurricane,Bonnie,23,1998-08-25T09:00:00Z,NORFOLK VA,0,5,15,2,22
Hurricane,Bonnie,23,1998-08-25T09:00:00Z,ST JOHN NB,0,0,0,2,2
Hurricane,Bonnie,23,1998-08-25T09:00:00Z,OCEAN CITY MD,0,0,12,6,18
Hurricane,Bonnie,23,1998-08-25T09:00:00Z,YARMOUTH NS,0,0,0,3,3
Hurricane,Bonnie,25,1998-08-25T15:00:00Z,33.8N  77.0W,36,1,0,0,37
Hurricane,Bonnie,25,1998-08-25T15:00:00Z,MONTAUK POINT NY,0,0,3,13,16
Hurricane,Bonnie,25,1998-08-25T15:00:00Z,36.4N  76.3W,0,23,2,0,25
Hurricane,Bonnie,25,1998-08-25T15:00:00Z,PROVIDENCE RI,0,0,1,14,15
Hurricane,Bonnie,25,1998-08-25T15:00:00Z,38.3N  74.0W,0,3,14,3,20
Hurricane,Bonnie,25,1998-08-25T15:00:00Z,NANTUCKET MA,0,0,1,14,15
Hurricane,Bonnie,25,1998-08-25T15:00:00Z,BERMUDA,0,0,0,3,3
Hurricane,Bonnie,25,1998-08-25T15:00:00Z,HYANNIS MA,0,0,1,13,14
Hurricane,Bonnie,25,1998-08-25T15:00:00Z,SAVANNAH GA,2,0,0,0,2
Hurricane,Bonnie,25,1998-08-25T15:00:00Z,BOSTON MA,0,0,1,13,14
Hurricane,Bonnie,25,1998-08-25T15:00:00Z,CHARLESTON SC,13,3,0,0,16
Hurricane,Bonnie,25,1998-08-25T15:00:00Z,PORTLAND ME,0,0,0,12,12
Hurricane,Bonnie,25,1998-08-25T15:00:00Z,MYRTLE BEACH SC,25,3,0,0,28
Hurricane,Bonnie,25,1998-08-25T15:00:00Z,BAR HARBOR ME,0,0,0,10,10
Hurricane,Bonnie,25,1998-08-25T15:00:00Z,WILMINGTON NC,25,7,0,0,32
Hurricane,Bonnie,25,1998-08-25T15:00:00Z,EASTPORT ME,0,0,0,9,9
Hurricane,Bonnie,25,1998-08-25T15:00:00Z,MOREHEAD CITY NC,18,13,1,0,32
Hurricane,Bonnie,25,1998-08-25T15:00:00Z,ST JOHN NB,0,0,0,7,7
Hurricane,Bonnie,25,1998-08-25T15:00:00Z,CAPE HATTERAS NC,5,20,1,0,26
Hurricane,Bonnie,25,1998-08-25T15:00:00Z,MONCTON NB,0,0,0,5,5
Hurricane,Bonnie,25,1998-08-25T15:00:00Z,NORFOLK VA,0,20,4,0,24
Hurricane,Bonnie,25,1998-08-25T15:00:00Z,YARMOUTH NS,0,0,0,9,9
Hurricane,Bonnie,25,1998-08-25T15:00:00Z,OCEAN CITY MD,0,6,13,2,21
Hurricane,Bonnie,25,1998-08-25T15:00:00Z,HALIFAX NS,0,0,0,5,5
Hurricane,Bonnie,25,1998-08-25T15:00:00Z,ATLANTIC CITY NJ,0,1,14,4,19
Hurricane,Bonnie,25,1998-08-25T15:00:00Z,SABLE ISLAND NS,0,0,0,2,2
Hurricane,Bonnie,25,1998-08-25T15:00:00Z,NEW YORK CITY NY,0,0,8,9,17
Hurricane,Bonnie,25,1998-08-25T15:00:00Z,EDDY POINT NS,0,0,0,2,2
Hurricane,Bonnie,27,1998-08-25T21:00:00Z,34.5N  76.7W,35,1,0,0,36
Hurricane,Bonnie,27,1998-08-25T21:00:00Z,HYANNIS MA,0,0,3,13,16
Hurricane,Bonnie,27,1998-08-25T21:00:00Z,36.7N  74.9W,1,21,3,0,25
Hurricane,Bonnie,27,1998-08-25T21:00:00Z,BOSTON MA,0,0,3,12,15
Hurricane,Bonnie,27,1998-08-25T21:00:00Z,38.8N  71.5W,0,1,14,4,19
Hurricane,Bonnie,27,1998-08-25T21:00:00Z,PORTLAND ME,0,0,1,12,13
Hurricane,Bonnie,27,1998-08-25T21:00:00Z,BERMUDA,0,0,0,5,5
Hurricane,Bonnie,27,1998-08-25T21:00:00Z,BAR HARBOR ME,0,0,0,12,12
Hurricane,Bonnie,27,1998-08-25T21:00:00Z,CHARLESTON SC,12,1,0,0,13
Hurricane,Bonnie,27,1998-08-25T21:00:00Z,EASTPORT ME,0,0,0,11,11
Hurricane,Bonnie,27,1998-08-25T21:00:00Z,MYRTLE BEACH SC,31,1,0,0,32
Hurricane,Bonnie,27,1998-08-25T21:00:00Z,ST JOHN NB,0,0,0,11,11
Hurricane,Bonnie,27,1998-08-25T21:00:00Z,WILMINGTON NC,36,0,0,1,37
Hurricane,Bonnie,27,1998-08-25T21:00:00Z,MONCTON NB,0,0,0,10,10
Hurricane,Bonnie,27,1998-08-25T21:00:00Z,MOREHEAD CITY NC,33,2,0,0,35
Hurricane,Bonnie,27,1998-08-25T21:00:00Z,YARMOUTH NS,0,0,0,12,12
Hurricane,Bonnie,27,1998-08-25T21:00:00Z,CAPE HATTERAS NC,18,11,0,0,29
Hurricane,Bonnie,27,1998-08-25T21:00:00Z,HALIFAX NS,0,0,0,11,11
Hurricane,Bonnie,27,1998-08-25T21:00:00Z,NORFOLK VA,2,22,1,1,26
Hurricane,Bonnie,27,1998-08-25T21:00:00Z,SABLE ISLAND NS,0,0,0,9,9
Hurricane,Bonnie,27,1998-08-25T21:00:00Z,OCEAN CITY MD,0,12,9,1,22
Hurricane,Bonnie,27,1998-08-25T21:00:00Z,SYDNEY NS,0,0,0,7,7
Hurricane,Bonnie,27,1998-08-25T21:00:00Z,ATLANTIC CITY NJ,0,3,15,1,19
Hurricane,Bonnie,27,1998-08-25T21:00:00Z,EDDY POINT NS,0,0,0,9,9
Hurricane,Bonnie,27,1998-08-25T21:00:00Z,NEW YORK CITY NY,0,0,13,4,17
Hurricane,Bonnie,27,1998-08-25T21:00:00Z,PTX BASQUES NFLD,0,0,0,5,5
Hurricane,Bonnie,27,1998-08-25T21:00:00Z,MONTAUK POINT NY,0,0,8,8,16
Hurricane,Bonnie,27,1998-08-25T21:00:00Z,BURGEO NFLD,0,0,0,4,4
Hurricane,Bonnie,27,1998-08-25T21:00:00Z,PROVIDENCE RI,0,0,5,11,16
Hurricane,Bonnie,27,1998-08-25T21:00:00Z,ILE ST PIERRE,0,0,0,3,3
Hurricane,Bonnie,27,1998-08-25T21:00:00Z,NANTUCKET MA,0,0,4,12,16
Hurricane,Bonnie,27,1998-08-25T21:00:00Z,CAPE RACE NFLD,0,0,0,2,2
Hurricane,Bonnie,28,1998-08-26T03:00:00Z,35.9N  76.2W,37,5,0,0,42
Hurricane,Bonnie,28,1998-08-26T03:00:00Z,BOSTON MA,0,0,13,4,17
Hurricane,Bonnie,28,1998-08-26T03:00:00Z,38.2N  73.1W,0,24,8,1,33
Hurricane,Bonnie,28,1998-08-26T03:00:00Z,PORTLAND ME,0,0,7,6,13
Hurricane,Bonnie,28,1998-08-26T03:00:00Z,41.0N  67.0W,0,0,15,7,22
Hurricane,Bonnie,28,1998-08-26T03:00:00Z,BAR HARBOR ME,0,0,4,10,14
Hurricane,Bonnie,28,1998-08-26T03:00:00Z,CHARLESTON SC,27,0,0,0,27
Hurricane,Bonnie,28,1998-08-26T03:00:00Z,EASTPORT ME,0,0,3,11,14
Hurricane,Bonnie,28,1998-08-26T03:00:00Z,MYRTLE BEACH SC,51,0,0,0,51
Hurricane,Bonnie,28,1998-08-26T03:00:00Z,ST JOHN NB,0,0,2,12,14
Hurricane,Bonnie,28,1998-08-26T03:00:00Z,WILMINGTON NC,56,0,0,0,56
Hurricane,Bonnie,28,1998-08-26T03:00:00Z,MONCTON NB,0,0,1,12,13
Hurricane,Bonnie,28,1998-08-26T03:00:00Z,MOREHEAD CITY NC,52,0,0,0,52
Hurricane,Bonnie,28,1998-08-26T03:00:00Z,YARMOUTH NS,0,0,5,13,18
Hurricane,Bonnie,28,1998-08-26T03:00:00Z,CAPE HATTERAS NC,38,3,0,0,41
Hurricane,Bonnie,28,1998-08-26T03:00:00Z,HALIFAX NS,0,0,1,16,17
Hurricane,Bonnie,28,1998-08-26T03:00:00Z,NORFOLK VA,20,18,0,0,38
Hurricane,Bonnie,28,1998-08-26T03:00:00Z,SABLE ISLAND NS,0,0,0,18,18
Hurricane,Bonnie,28,1998-08-26T03:00:00Z,OCEAN CITY MD,1,28,4,0,33
Hurricane,Bonnie,28,1998-08-26T03:00:00Z,SYDNEY NS,0,0,0,16,16
Hurricane,Bonnie,28,1998-08-26T03:00:00Z,ATLANTIC CITY NJ,0,16,11,0,27
Hurricane,Bonnie,28,1998-08-26T03:00:00Z,EDDY POINT NS,0,0,0,16,16
Hurricane,Bonnie,28,1998-08-26T03:00:00Z,NEW YORK CITY NY,0,5,16,0,21
Hurricane,Bonnie,28,1998-08-26T03:00:00Z,PTX BASQUES NFLD,0,0,0,14,14
Hurricane,Bonnie,28,1998-08-26T03:00:00Z,MONTAUK POINT NY,0,1,20,1,22
Hurricane,Bonnie,28,1998-08-26T03:00:00Z,BURGEO NFLD,0,0,0,14,14
Hurricane,Bonnie,28,1998-08-26T03:00:00Z,PROVIDENCE RI,0,0,17,2,19
Hurricane,Bonnie,28,1998-08-26T03:00:00Z,ILE ST PIERRE,0,0,0,15,15
Hurricane,Bonnie,28,1998-08-26T03:00:00Z,NANTUCKET MA,0,0,20,2,22
Hurricane,Bonnie,28,1998-08-26T03:00:00Z,CAPE RACE NFLD,0,0,0,15,15
Hurricane,Bonnie,28,1998-08-26T03:00:00Z,HYANNIS MA,0,0,18,3,21
Hurricane,Bonnie,28,1998-08-26T03:00:00Z,HIBERNIA OILFLD,0,0,0,10,10
Hurricane,Bonnie,29,1998-08-26T06:00:00Z,35.2N  78.6W,43,1,0,0,44
Hurricane,Bonnie,29,1998-08-26T06:00:00Z,BOSTON MA,0,0,16,3,19
Hurricane,Bonnie,29,1998-08-26T06:00:00Z,37.5N  75.5W,2,28,10,0,40
Hurricane,Bonnie,29,1998-08-26T06:00:00Z,PORTLAND ME,0,0,9,6,15
Hurricane,Bonnie,29,1998-08-26T06:00:00Z,41.0N  67.0W,0,0,17,9,26
Hurricane,Bonnie,29,1998-08-26T06:00:00Z,BAR HARBOR ME,0,0,5,11,16
Hurricane,Bonnie,29,1998-08-26T06:00:00Z,SAVANNAH GA,6,1,0,0,7
Hurricane,Bonnie,29,1998-08-26T06:00:00Z,EASTPORT ME,0,0,2,14,16
Hurricane,Bonnie,29,1998-08-26T06:00:00Z,CHARLESTON SC,38,0,0,0,38
Hurricane,Bonnie,29,1998-08-26T06:00:00Z,ST JOHN NB,0,0,1,15,16
Hurricane,Bonnie,29,1998-08-26T06:00:00Z,MYRTLE BEACH SC,55,0,0,0,55
Hurricane,Bonnie,29,1998-08-26T06:00:00Z,MONCTON NB,0,0,0,15,15
Hurricane,Bonnie,29,1998-08-26T06:00:00Z,WILMINGTON NC,51,0,0,0,51
Hurricane,Bonnie,29,1998-08-26T06:00:00Z,YARMOUTH NS,0,0,4,17,21
Hurricane,Bonnie,29,1998-08-26T06:00:00Z,MOREHEAD CITY NC,33,3,1,0,37
Hurricane,Bonnie,29,1998-08-26T06:00:00Z,HALIFAX NS,0,0,0,20,20
Hurricane,Bonnie,29,1998-08-26T06:00:00Z,CAPE HATTERAS NC,11,17,3,0,31
Hurricane,Bonnie,29,1998-08-26T06:00:00Z,SABLE ISLAND NS,0,0,0,20,20
Hurricane,Bonnie,29,1998-08-26T06:00:00Z,NORFOLK VA,7,29,4,0,40
Hurricane,Bonnie,29,1998-08-26T06:00:00Z,SYDNEY NS,0,0,0,17,17
Hurricane,Bonnie,29,1998-08-26T06:00:00Z,OCEAN CITY MD,0,22,16,0,38
Hurricane,Bonnie,29,1998-08-26T06:00:00Z,EDDY POINT NS,0,0,0,18,18
Hurricane,Bonnie,29,1998-08-26T06:00:00Z,ATLANTIC CITY NJ,0,8,23,0,31
Hurricane,Bonnie,29,1998-08-26T06:00:00Z,PTX BASQUES NFLD,0,0,0,15,15
Hurricane,Bonnie,29,1998-08-26T06:00:00Z,NEW YORK CITY NY,0,1,21,0,22
Hurricane,Bonnie,29,1998-08-26T06:00:00Z,BURGEO NFLD,0,0,0,15,15
Hurricane,Bonnie,29,1998-08-26T06:00:00Z,MONTAUK POINT NY,0,0,21,1,22
Hurricane,Bonnie,29,1998-08-26T06:00:00Z,ILE ST PIERRE,0,0,0,16,16
Hurricane,Bonnie,29,1998-08-26T06:00:00Z,PROVIDENCE RI,0,0,19,2,21
Hurricane,Bonnie,29,1998-08-26T06:00:00Z,CAPE RACE NFLD,0,0,0,14,14
Hurricane,Bonnie,29,1998-08-26T06:00:00Z,NANTUCKET MA,0,0,21,3,24
Hurricane,Bonnie,29,1998-08-26T06:00:00Z,HIBERNIA OILFLD,0,0,0,8,8
Hurricane,Bonnie,29,1998-08-26T06:00:00Z,HYANNIS MA,0,0,20,3,23
Hurricane,Bonnie,30,1998-08-26T09:00:00Z,36.0N  76.0W,35,2,0,0,37
Hurricane,Bonnie,30,1998-08-26T09:00:00Z,BOSTON MA,0,3,11,2,16
Hurricane,Bonnie,30,1998-08-26T09:00:00Z,38.5N  72.0W,0,16,5,0,21
Hurricane,Bonnie,30,1998-08-26T09:00:00Z,PORTLAND ME,0,1,10,3,14
Hurricane,Bonnie,30,1998-08-26T09:00:00Z,40.5N  66.5W,0,0,13,5,18
Hurricane,Bonnie,30,1998-08-26T09:00:00Z,BAR HARBOR ME,0,0,8,6,14
Hurricane,Bonnie,30,1998-08-26T09:00:00Z,BERMUDA,0,0,1,2,3
Hurricane,Bonnie,30,1998-08-26T09:00:00Z,EASTPORT ME,0,0,6,8,14
Hurricane,Bonnie,30,1998-08-26T09:00:00Z,CHARLESTON SC,40,0,0,0,40
Hurricane,Bonnie,30,1998-08-26T09:00:00Z,ST JOHN NB,0,0,4,10,14
Hurricane,Bonnie,30,1998-08-26T09:00:00Z,MYRTLE BEACH SC,78,0,0,0,78
Hurricane,Bonnie,30,1998-08-26T09:00:00Z,MONCTON NB,0,0,2,11,13
Hurricane,Bonnie,30,1998-08-26T09:00:00Z,WILMINGTON NC,78,0,0,0,78
Hurricane,Bonnie,30,1998-08-26T09:00:00Z,YARMOUTH NS,0,0,7,9,16
Hurricane,Bonnie,30,1998-08-26T09:00:00Z,MOREHEAD CITY NC,52,0,0,0,52
Hurricane,Bonnie,30,1998-08-26T09:00:00Z,HALIFAX NS,0,0,3,13,16
Hurricane,Bonnie,30,1998-08-26T09:00:00Z,CAPE HATTERAS NC,35,2,0,0,37
Hurricane,Bonnie,30,1998-08-26T09:00:00Z,SABLE ISLAND NS,0,0,1,16,17
Hurricane,Bonnie,30,1998-08-26T09:00:00Z,NORFOLK VA,23,8,0,0,31
Hurricane,Bonnie,30,1998-08-26T09:00:00Z,SYDNEY NS,0,0,0,15,15
Hurricane,Bonnie,30,1998-08-26T09:00:00Z,OCEAN CITY MD,2,21,0,0,23
Hurricane,Bonnie,30,1998-08-26T09:00:00Z,EDDY POINT NS,0,0,1,14,15
Hurricane,Bonnie,30,1998-08-26T09:00:00Z,ATLANTIC CITY NJ,0,18,2,0,20
Hurricane,Bonnie,30,1998-08-26T09:00:00Z,PTX BASQUES NFLD,0,0,0,13,13
Hurricane,Bonnie,30,1998-08-26T09:00:00Z,NEW YORK CITY NY,0,12,5,0,17
Hurricane,Bonnie,30,1998-08-26T09:00:00Z,BURGEO NFLD,0,0,0,13,13
Hurricane,Bonnie,30,1998-08-26T09:00:00Z,MONTAUK POINT NY,0,8,9,1,18
Hurricane,Bonnie,30,1998-08-26T09:00:00Z,ILE ST PIERRE,0,0,0,15,15
Hurricane,Bonnie,30,1998-08-26T09:00:00Z,PROVIDENCE RI,0,5,11,1,17
Hurricane,Bonnie,30,1998-08-26T09:00:00Z,CAPE RACE NFLD,0,0,0,14,14
Hurricane,Bonnie,30,1998-08-26T09:00:00Z,NANTUCKET MA,0,4,13,1,18
Hurricane,Bonnie,30,1998-08-26T09:00:00Z,HIBERNIA OILFLD,0,0,0,9,9
Hurricane,Bonnie,30,1998-08-26T09:00:00Z,HYANNIS MA,0,3,13,1,17
Hurricane,Bonnie,31,1998-08-26T15:00:00Z,36.2N  76.0W,26,3,0,0,29
Hurricane,Bonnie,31,1998-08-26T15:00:00Z,BOSTON MA,0,0,8,2,10
Hurricane,Bonnie,31,1998-08-26T15:00:00Z,38.2N  72.4W,0,14,6,1,21
Hurricane,Bonnie,31,1998-08-26T15:00:00Z,PORTLAND ME,0,0,5,3,8
Hurricane,Bonnie,31,1998-08-26T15:00:00Z,40.2N  66.7W,0,0,10,3,13
Hurricane,Bonnie,31,1998-08-26T15:00:00Z,BAR HARBOR ME,0,0,3,4,7
Hurricane,Bonnie,31,1998-08-26T15:00:00Z,BERMUDA,0,0,2,2,4
Hurricane,Bonnie,31,1998-08-26T15:00:00Z,EASTPORT ME,0,0,2,5,7
Hurricane,Bonnie,31,1998-08-26T15:00:00Z,CHARLESTON SC,8,0,0,0,8
Hurricane,Bonnie,31,1998-08-26T15:00:00Z,ST JOHN NB,0,0,1,6,7
Hurricane,Bonnie,31,1998-08-26T15:00:00Z,MYRTLE BEACH SC,99,0,0,0,99
Hurricane,Bonnie,31,1998-08-26T15:00:00Z,MONCTON NB,0,0,0,6,6
Hurricane,Bonnie,31,1998-08-26T15:00:00Z,WILMINGTON NC,81,0,0,0,81
Hurricane,Bonnie,31,1998-08-26T15:00:00Z,YARMOUTH NS,0,0,3,6,9
Hurricane,Bonnie,31,1998-08-26T15:00:00Z,MOREHEAD CITY NC,52,0,1,0,53
Hurricane,Bonnie,31,1998-08-26T15:00:00Z,HALIFAX NS,0,0,1,7,8
Hurricane,Bonnie,31,1998-08-26T15:00:00Z,CAPE HATTERAS NC,29,2,0,0,31
Hurricane,Bonnie,31,1998-08-26T15:00:00Z,SABLE ISLAND NS,0,0,0,9,9
Hurricane,Bonnie,31,1998-08-26T15:00:00Z,NORFOLK VA,19,7,0,0,26
Hurricane,Bonnie,31,1998-08-26T15:00:00Z,SYDNEY NS,0,0,0,6,6
Hurricane,Bonnie,31,1998-08-26T15:00:00Z,OCEAN CITY MD,2,17,2,0,21
Hurricane,Bonnie,31,1998-08-26T15:00:00Z,EDDY POINT NS,0,0,0,7,7
Hurricane,Bonnie,31,1998-08-26T15:00:00Z,ATLANTIC CITY NJ,0,13,4,0,17
Hurricane,Bonnie,31,1998-08-26T15:00:00Z,PTX BASQUES NFLD,0,0,0,5,5
Hurricane,Bonnie,31,1998-08-26T15:00:00Z,NEW YORK CITY NY,0,6,7,1,14
Hurricane,Bonnie,31,1998-08-26T15:00:00Z,BURGEO NFLD,0,0,0,5,5
Hurricane,Bonnie,31,1998-08-26T15:00:00Z,MONTAUK POINT NY,0,2,10,1,13
Hurricane,Bonnie,31,1998-08-26T15:00:00Z,ILE ST PIERRE,0,0,0,6,6
Hurricane,Bonnie,31,1998-08-26T15:00:00Z,PROVIDENCE RI,0,1,10,1,12
Hurricane,Bonnie,31,1998-08-26T15:00:00Z,CAPE RACE NFLD,0,0,0,5,5
Hurricane,Bonnie,31,1998-08-26T15:00:00Z,NANTUCKET MA,0,1,10,2,13
Hurricane,Bonnie,31,1998-08-26T15:00:00Z,HIBERNIA OILFLD,0,0,0,3,3
Hurricane,Bonnie,31,1998-08-26T15:00:00Z,HYANNIS MA,0,0,10,2,12
Hurricane,Bonnie,32,1998-08-26T21:00:00Z,35.6N  77.3W,44,0,0,0,44
Hurricane,Bonnie,32,1998-08-26T21:00:00Z,NANTUCKET MA,0,0,2,8,10
Hurricane,Bonnie,32,1998-08-26T21:00:00Z,36.4N  76.3W,15,3,2,0,20
Hurricane,Bonnie,32,1998-08-26T21:00:00Z,HYANNIS MA,0,0,2,8,10
Hurricane,Bonnie,32,1998-08-26T21:00:00Z,38.1N  73.2W,0,2,10,3,15
Hurricane,Bonnie,32,1998-08-26T21:00:00Z,BOSTON MA,0,0,2,7,9
Hurricane,Bonnie,32,1998-08-26T21:00:00Z,BERMUDA,0,0,0,5,5
Hurricane,Bonnie,32,1998-08-26T21:00:00Z,PORTLAND ME,0,0,1,6,7
Hurricane,Bonnie,32,1998-08-26T21:00:00Z,SAVANNAH GA,1,2,1,1,5
Hurricane,Bonnie,32,1998-08-26T21:00:00Z,BAR HARBOR ME,0,0,0,7,7
Hurricane,Bonnie,32,1998-08-26T21:00:00Z,CHARLESTON SC,8,3,1,1,13
Hurricane,Bonnie,32,1998-08-26T21:00:00Z,EASTPORT ME,0,0,0,6,6
Hurricane,Bonnie,32,1998-08-26T21:00:00Z,MYRTLE BEACH SC,99,0,0,0,99
Hurricane,Bonnie,32,1998-08-26T21:00:00Z,ST JOHN NB,0,0,0,5,5
Hurricane,Bonnie,32,1998-08-26T21:00:00Z,WILMINGTON NC,99,0,0,0,99
Hurricane,Bonnie,32,1998-08-26T21:00:00Z,MONCTON NB,0,0,0,4,4
Hurricane,Bonnie,32,1998-08-26T21:00:00Z,MOREHEAD CITY NC,59,0,0,0,59
Hurricane,Bonnie,32,1998-08-26T21:00:00Z,YARMOUTH NS,0,0,0,7,7
Hurricane,Bonnie,32,1998-08-26T21:00:00Z,CAPE HATTERAS NC,16,3,1,1,21
Hurricane,Bonnie,32,1998-08-26T21:00:00Z,HALIFAX NS,0,0,0,6,6
Hurricane,Bonnie,32,1998-08-26T21:00:00Z,NORFOLK VA,9,6,3,1,19
Hurricane,Bonnie,32,1998-08-26T21:00:00Z,SABLE ISLAND NS,0,0,0,5,5
Hurricane,Bonnie,32,1998-08-26T21:00:00Z,OCEAN CITY MD,0,7,7,2,16
Hurricane,Bonnie,32,1998-08-26T21:00:00Z,SYDNEY NS,0,0,0,3,3
Hurricane,Bonnie,32,1998-08-26T21:00:00Z,ATLANTIC CITY NJ,0,2,9,2,13
Hurricane,Bonnie,32,1998-08-26T21:00:00Z,EDDY POINT NS,0,0,0,4,4
Hurricane,Bonnie,32,1998-08-26T21:00:00Z,NEW YORK CITY NY,0,0,7,4,11
Hurricane,Bonnie,32,1998-08-26T21:00:00Z,PTX BASQUES NFLD,0,0,0,2,2
Hurricane,Bonnie,32,1998-08-26T21:00:00Z,MONTAUK POINT NY,0,0,4,7,11
Hurricane,Bonnie,32,1998-08-26T21:00:00Z,BURGEO NFLD,0,0,0,2,2
Hurricane,Bonnie,32,1998-08-26T21:00:00Z,PROVIDENCE RI,0,0,3,7,10
Hurricane,Bonnie,32,1998-08-26T21:00:00Z,ILE ST PIERRE,0,0,0,2,2
Hurricane,Bonnie,33,1998-08-27T03:00:00Z,36.0N  76.6W,32,0,0,0,32
Hurricane,Bonnie,33,1998-08-27T03:00:00Z,HYANNIS MA,0,0,6,6,12
Hurricane,Bonnie,33,1998-08-27T03:00:00Z,37.2N  75.0W,7,10,4,0,21
Hurricane,Bonnie,33,1998-08-27T03:00:00Z,BOSTON MA,0,0,5,6,11
Hurricane,Bonnie,33,1998-08-27T03:00:00Z,39.5N  71.0W,0,1,11,3,15
Hurricane,Bonnie,33,1998-08-27T03:00:00Z,PORTLAND ME,0,0,3,6,9
Hurricane,Bonnie,33,1998-08-27T03:00:00Z,BERMUDA,0,0,0,5,5
Hurricane,Bonnie,33,1998-08-27T03:00:00Z,BAR HARBOR ME,0,0,1,7,8
Hurricane,Bonnie,33,1998-08-27T03:00:00Z,CHARLESTON SC,4,2,1,0,7
Hurricane,Bonnie,33,1998-08-27T03:00:00Z,EASTPORT ME,0,0,0,7,7
Hurricane,Bonnie,33,1998-08-27T03:00:00Z,MYRTLE BEACH SC,99,0,0,0,99
Hurricane,Bonnie,33,1998-08-27T03:00:00Z,ST JOHN NB,0,0,0,7,7
Hurricane,Bonnie,33,1998-08-27T03:00:00Z,WILMINGTON NC,99,0,0,0,99
Hurricane,Bonnie,33,1998-08-27T03:00:00Z,MONCTON NB,0,0,0,6,6
Hurricane,Bonnie,33,1998-08-27T03:00:00Z,MOREHEAD CITY NC,76,0,0,0,76
Hurricane,Bonnie,33,1998-08-27T03:00:00Z,YARMOUTH NS,0,0,1,8,9
Hurricane,Bonnie,33,1998-08-27T03:00:00Z,CAPE HATTERAS NC,24,2,0,0,26
Hurricane,Bonnie,33,1998-08-27T03:00:00Z,HALIFAX NS,0,0,0,7,7
Hurricane,Bonnie,33,1998-08-27T03:00:00Z,NORFOLK VA,18,3,1,0,22
Hurricane,Bonnie,33,1998-08-27T03:00:00Z,SABLE ISLAND NS,0,0,0,7,7
Hurricane,Bonnie,33,1998-08-27T03:00:00Z,OCEAN CITY MD,2,11,6,0,19
Hurricane,Bonnie,33,1998-08-27T03:00:00Z,SYDNEY NS,0,0,0,5,5
Hurricane,Bonnie,33,1998-08-27T03:00:00Z,ATLANTIC CITY NJ,0,6,10,1,17
Hurricane,Bonnie,33,1998-08-27T03:00:00Z,EDDY POINT NS,0,0,0,6,6
Hurricane,Bonnie,33,1998-08-27T03:00:00Z,NEW YORK CITY NY,0,2,10,2,14
Hurricane,Bonnie,33,1998-08-27T03:00:00Z,PTX BASQUES NFLD,0,0,0,3,3
Hurricane,Bonnie,33,1998-08-27T03:00:00Z,MONTAUK POINT NY,0,0,9,4,13
Hurricane,Bonnie,33,1998-08-27T03:00:00Z,BURGEO NFLD,0,0,0,3,3
Hurricane,Bonnie,33,1998-08-27T03:00:00Z,PROVIDENCE RI,0,0,7,5,12
Hurricane,Bonnie,33,1998-08-27T03:00:00Z,ILE ST PIERRE,0,0,0,3,3
Hurricane,Bonnie,33,1998-08-27T03:00:00Z,NANTUCKET MA,0,0,7,5,12
Hurricane,Bonnie,33,1998-08-27T03:00:00Z,CAPE RACE NFLD,0,0,0,2,2
Hurricane,Bonnie,34,1998-08-27T09:00:00Z,36.2N  76.6W,35,1,0,0,36
Hurricane,Bonnie,34,1998-08-27T09:00:00Z,HYANNIS MA,0,0,4,9,13
Hurricane,Bonnie,34,1998-08-27T09:00:00Z,37.5N  75.5W,14,4,2,0,20
Hurricane,Bonnie,34,1998-08-27T09:00:00Z,BOSTON MA,0,0,4,8,12
Hurricane,Bonnie,34,1998-08-27T09:00:00Z,39.3N  73.7W,0,7,7,2,16
Hurricane,Bonnie,34,1998-08-27T09:00:00Z,PORTLAND ME,0,0,1,9,10
Hurricane,Bonnie,34,1998-08-27T09:00:00Z,BERMUDA,0,0,0,3,3
Hurricane,Bonnie,34,1998-08-27T09:00:00Z,BAR HARBOR ME,0,0,0,10,10
Hurricane,Bonnie,34,1998-08-27T09:00:00Z,SAVANNAH GA,0,1,1,0,2
Hurricane,Bonnie,34,1998-08-27T09:00:00Z,EASTPORT ME,0,0,0,9,9
Hurricane,Bonnie,34,1998-08-27T09:00:00Z,CHARLESTON SC,2,3,1,1,7
Hurricane,Bonnie,34,1998-08-27T09:00:00Z,ST JOHN NB,0,0,0,9,9
Hurricane,Bonnie,34,1998-08-27T09:00:00Z,MYRTLE BEACH SC,15,2,0,0,17
Hurricane,Bonnie,34,1998-08-27T09:00:00Z,MONCTON NB,0,0,0,8,8
Hurricane,Bonnie,34,1998-08-27T09:00:00Z,WILMINGTON NC,99,0,0,0,99
Hurricane,Bonnie,34,1998-08-27T09:00:00Z,YARMOUTH NS,0,0,0,10,10
Hurricane,Bonnie,34,1998-08-27T09:00:00Z,MOREHEAD CITY NC,99,0,0,0,99
Hurricane,Bonnie,34,1998-08-27T09:00:00Z,HALIFAX NS,0,0,0,9,9
Hurricane,Bonnie,34,1998-08-27T09:00:00Z,CAPE HATTERAS NC,30,0,1,0,31
Hurricane,Bonnie,34,1998-08-27T09:00:00Z,SABLE ISLAND NS,0,0,0,8,8
Hurricane,Bonnie,34,1998-08-27T09:00:00Z,NORFOLK VA,23,1,1,0,25
Hurricane,Bonnie,34,1998-08-27T09:00:00Z,SYDNEY NS,0,0,0,6,6
Hurricane,Bonnie,34,1998-08-27T09:00:00Z,OCEAN CITY MD,6,8,3,1,18
Hurricane,Bonnie,34,1998-08-27T09:00:00Z,EDDY POINT NS,0,0,0,8,8
Hurricane,Bonnie,34,1998-08-27T09:00:00Z,ATLANTIC CITY NJ,1,8,5,2,16
Hurricane,Bonnie,34,1998-08-27T09:00:00Z,PTX BASQUES NFLD,0,0,0,5,5
Hurricane,Bonnie,34,1998-08-27T09:00:00Z,NEW YORK CITY NY,0,3,8,3,14
Hurricane,Bonnie,34,1998-08-27T09:00:00Z,BURGEO NFLD,0,0,0,4,4
Hurricane,Bonnie,34,1998-08-27T09:00:00Z,MONTAUK POINT NY,0,1,6,7,14
Hurricane,Bonnie,34,1998-08-27T09:00:00Z,ILE ST PIERRE,0,0,0,4,4
Hurricane,Bonnie,34,1998-08-27T09:00:00Z,PROVIDENCE RI,0,0,5,8,13
Hurricane,Bonnie,34,1998-08-27T09:00:00Z,CAPE RACE NFLD,0,0,0,3,3
Hurricane,Bonnie,34,1998-08-27T09:00:00Z,NANTUCKET MA,0,0,4,9,13
Tropical Storm,Bonnie,35,1998-08-27T15:00:00Z,37.7N  74.8W,25,0,1,0,26
Tropical Storm,Bonnie,35,1998-08-27T15:00:00Z,BOSTON MA,0,4,7,1,12
Tropical Storm,Bonnie,35,1998-08-27T15:00:00Z,39.5N  72.7W,3,12,2,0,17
Tropical Storm,Bonnie,35,1998-08-27T15:00:00Z,PORTLAND ME,0,1,7,3,11
Tropical Storm,Bonnie,35,1998-08-27T15:00:00Z,41.0N  69.0W,0,2,9,2,13
Tropical Storm,Bonnie,35,1998-08-27T15:00:00Z,BAR HARBOR ME,0,0,5,5,10
Tropical Storm,Bonnie,35,1998-08-27T15:00:00Z,BERMUDA,0,0,0,3,3
Tropical Storm,Bonnie,35,1998-08-27T15:00:00Z,EASTPORT ME,0,0,3,7,10
Tropical Storm,Bonnie,35,1998-08-27T15:00:00Z,MYRTLE BEACH SC,1,1,0,0,2
Tropical Storm,Bonnie,35,1998-08-27T15:00:00Z,ST JOHN NB,0,0,2,7,9
Tropical Storm,Bonnie,35,1998-08-27T15:00:00Z,WILMINGTON NC,99,0,0,0,99
Tropical Storm,Bonnie,35,1998-08-27T15:00:00Z,MONCTON NB,0,0,1,7,8
Tropical Storm,Bonnie,35,1998-08-27T15:00:00Z,MOREHEAD CITY NC,99,0,0,0,99
Tropical Storm,Bonnie,35,1998-08-27T15:00:00Z,YARMOUTH NS,0,0,4,7,11
Tropical Storm,Bonnie,35,1998-08-27T15:00:00Z,CAPE HATTERAS NC,66,0,0,0,66
Tropical Storm,Bonnie,35,1998-08-27T15:00:00Z,HALIFAX NS,0,0,1,9,10
Tropical Storm,Bonnie,35,1998-08-27T15:00:00Z,NORFOLK VA,39,1,0,0,40
Tropical Storm,Bonnie,35,1998-08-27T15:00:00Z,SABLE ISLAND NS,0,0,0,10,10
Tropical Storm,Bonnie,35,1998-08-27T15:00:00Z,OCEAN CITY MD,21,2,0,0,23
Tropical Storm,Bonnie,35,1998-08-27T15:00:00Z,SYDNEY NS,0,0,0,8,8
Tropical Storm,Bonnie,35,1998-08-27T15:00:00Z,ATLANTIC CITY NJ,10,7,1,1,19
Tropical Storm,Bonnie,35,1998-08-27T15:00:00Z,EDDY POINT NS,0,0,0,9,9
Tropical Storm,Bonnie,35,1998-08-27T15:00:00Z,NEW YORK CITY NY,3,11,1,1,16
Tropical Storm,Bonnie,35,1998-08-27T15:00:00Z,PTX BASQUES NFLD,0,0,0,7,7
Tropical Storm,Bonnie,35,1998-08-27T15:00:00Z,MONTAUK POINT NY,0,9,5,0,14
Tropical Storm,Bonnie,35,1998-08-27T15:00:00Z,BURGEO NFLD,0,0,0,7,7
Tropical Storm,Bonnie,35,1998-08-27T15:00:00Z,PROVIDENCE RI,0,7,5,1,13
Tropical Storm,Bonnie,35,1998-08-27T15:00:00Z,ILE ST PIERRE,0,0,0,7,7
Tropical Storm,Bonnie,35,1998-08-27T15:00:00Z,NANTUCKET MA,0,4,8,1,13
Tropical Storm,Bonnie,35,1998-08-27T15:00:00Z,CAPE RACE NFLD,0,0,0,6,6
Tropical Storm,Bonnie,35,1998-08-27T15:00:00Z,HYANNIS MA,0,4,7,2,13
Tropical Storm,Bonnie,35,1998-08-27T15:00:00Z,HIBERNIA OILFLD,0,0,0,4,4
Tropical Storm,Bonnie,36,1998-08-27T21:00:00Z,38.6N  73.1W,27,3,0,0,30
Tropical Storm,Bonnie,36,1998-08-27T21:00:00Z,PORTLAND ME,0,4,7,0,11
Tropical Storm,Bonnie,36,1998-08-27T21:00:00Z,40.7N  69.7W,0,13,4,0,17
Tropical Storm,Bonnie,36,1998-08-27T21:00:00Z,BAR HARBOR ME,0,1,8,1,10
Tropical Storm,Bonnie,36,1998-08-27T21:00:00Z,42.3N  64.1W,0,0,10,2,12
Tropical Storm,Bonnie,36,1998-08-27T21:00:00Z,EASTPORT ME,0,1,7,2,10
Tropical Storm,Bonnie,36,1998-08-27T21:00:00Z,BERMUDA,0,0,1,1,2
Tropical Storm,Bonnie,36,1998-08-27T21:00:00Z,ST JOHN NB,0,0,6,3,9
Tropical Storm,Bonnie,36,1998-08-27T21:00:00Z,MOREHEAD CITY NC,99,0,0,0,99
Tropical Storm,Bonnie,36,1998-08-27T21:00:00Z,MONCTON NB,0,0,4,4,8
Tropical Storm,Bonnie,36,1998-08-27T21:00:00Z,CAPE HATTERAS NC,99,0,0,0,99
Tropical Storm,Bonnie,36,1998-08-27T21:00:00Z,YARMOUTH NS,0,1,8,2,11
Tropical Storm,Bonnie,36,1998-08-27T21:00:00Z,NORFOLK VA,58,0,0,0,58
Tropical Storm,Bonnie,36,1998-08-27T21:00:00Z,HALIFAX NS,0,0,6,4,10
Tropical Storm,Bonnie,36,1998-08-27T21:00:00Z,OCEAN CITY MD,34,1,0,0,35
Tropical Storm,Bonnie,36,1998-08-27T21:00:00Z,SABLE ISLAND NS,0,0,3,8,11
Tropical Storm,Bonnie,36,1998-08-27T21:00:00Z,ATLANTIC CITY NJ,19,5,0,0,24
Tropical Storm,Bonnie,36,1998-08-27T21:00:00Z,SYDNEY NS,0,0,1,8,9
Tropical Storm,Bonnie,36,1998-08-27T21:00:00Z,NEW YORK CITY NY,5,13,0,0,18
Tropical Storm,Bonnie,36,1998-08-27T21:00:00Z,EDDY POINT NS,0,0,2,7,9
Tropical Storm,Bonnie,36,1998-08-27T21:00:00Z,MONTAUK POINT NY,1,15,1,0,17
Tropical Storm,Bonnie,36,1998-08-27T21:00:00Z,PTX BASQUES NFLD,0,0,1,6,7
Tropical Storm,Bonnie,36,1998-08-27T21:00:00Z,PROVIDENCE RI,0,13,3,0,16
Tropical Storm,Bonnie,36,1998-08-27T21:00:00Z,BURGEO NFLD,0,0,0,7,7
Tropical Storm,Bonnie,36,1998-08-27T21:00:00Z,NANTUCKET MA,0,12,4,1,17
Tropical Storm,Bonnie,36,1998-08-27T21:00:00Z,ILE ST PIERRE,0,0,0,8,8
Tropical Storm,Bonnie,36,1998-08-27T21:00:00Z,HYANNIS MA,0,11,4,1,16
Tropical Storm,Bonnie,36,1998-08-27T21:00:00Z,CAPE RACE NFLD,0,0,0,8,8
Tropical Storm,Bonnie,36,1998-08-27T21:00:00Z,BOSTON MA,0,10,4,0,14
Tropical Storm,Bonnie,36,1998-08-27T21:00:00Z,HIBERNIA OILFLD,0,0,0,6,6
Hurricane,Bonnie,37,1998-08-28T03:00:00Z,39.5N  71.5W,26,6,0,0,32
Hurricane,Bonnie,37,1998-08-28T03:00:00Z,BAR HARBOR ME,0,4,7,0,11
Hurricane,Bonnie,37,1998-08-28T03:00:00Z,41.5N  67.0W,0,14,5,0,19
Hurricane,Bonnie,37,1998-08-28T03:00:00Z,EASTPORT ME,0,2,8,1,11
Hurricane,Bonnie,37,1998-08-28T03:00:00Z,43.0N  60.0W,0,0,10,3,13
Hurricane,Bonnie,37,1998-08-28T03:00:00Z,ST JOHN NB,0,1,8,1,10
Hurricane,Bonnie,37,1998-08-28T03:00:00Z,MOREHEAD CITY NC,11,0,0,0,11
Hurricane,Bonnie,37,1998-08-28T03:00:00Z,MONCTON NB,0,0,7,2,9
Hurricane,Bonnie,37,1998-08-28T03:00:00Z,CAPE HATTERAS NC,99,0,0,0,99
Hurricane,Bonnie,37,1998-08-28T03:00:00Z,YARMOUTH NS,0,4,9,1,14
Hurricane,Bonnie,37,1998-08-28T03:00:00Z,NORFOLK VA,99,0,0,0,99
Hurricane,Bonnie,37,1998-08-28T03:00:00Z,HALIFAX NS,0,1,9,2,12
Hurricane,Bonnie,37,1998-08-28T03:00:00Z,OCEAN CITY MD,45,1,0,0,46
Hurricane,Bonnie,37,1998-08-28T03:00:00Z,SABLE ISLAND NS,0,0,8,4,12
Hurricane,Bonnie,37,1998-08-28T03:00:00Z,ATLANTIC CITY NJ,26,1,0,0,27
Hurricane,Bonnie,37,1998-08-28T03:00:00Z,SYDNEY NS,0,0,4,5,9
Hurricane,Bonnie,37,1998-08-28T03:00:00Z,NEW YORK CITY NY,13,7,0,0,20
Hurricane,Bonnie,37,1998-08-28T03:00:00Z,EDDY POINT NS,0,0,7,3,10
Hurricane,Bonnie,37,1998-08-28T03:00:00Z,MONTAUK POINT NY,6,15,0,0,21
Hurricane,Bonnie,37,1998-08-28T03:00:00Z,PTX BASQUES NFLD,0,0,2,5,7
Hurricane,Bonnie,37,1998-08-28T03:00:00Z,PROVIDENCE RI,2,16,0,0,18
Hurricane,Bonnie,37,1998-08-28T03:00:00Z,BURGEO NFLD,0,0,1,7,8
Hurricane,Bonnie,37,1998-08-28T03:00:00Z,NANTUCKET MA,1,19,1,0,21
Hurricane,Bonnie,37,1998-08-28T03:00:00Z,ILE ST PIERRE,0,0,1,8,9
Hurricane,Bonnie,37,1998-08-28T03:00:00Z,HYANNIS MA,1,17,1,0,19
Hurricane,Bonnie,37,1998-08-28T03:00:00Z,CAPE RACE NFLD,0,0,1,8,9
Hurricane,Bonnie,37,1998-08-28T03:00:00Z,BOSTON MA,0,14,2,0,16
Hurricane,Bonnie,37,1998-08-28T03:00:00Z,HIBERNIA OILFLD,0,0,0,8,8
Hurricane,Bonnie,37,1998-08-28T03:00:00Z,PORTLAND ME,0,8,4,0,12
Hurricane,Bonnie,38,1998-08-28T09:00:00Z,40.2N  71.5W,29,1,0,1,31
Hurricane,Bonnie,38,1998-08-28T09:00:00Z,BAR HARBOR ME,0,9,4,1,14
Hurricane,Bonnie,38,1998-08-28T09:00:00Z,42.0N  66.5W,1,14,3,1,19
Hurricane,Bonnie,38,1998-08-28T09:00:00Z,EASTPORT ME,0,6,6,1,13
Hurricane,Bonnie,38,1998-08-28T09:00:00Z,44.0N  60.0W,0,1,9,2,12
Hurricane,Bonnie,38,1998-08-28T09:00:00Z,ST JOHN NB,0,4,7,1,12
Hurricane,Bonnie,38,1998-08-28T09:00:00Z,MOREHEAD CITY NC,5,0,0,0,5
Hurricane,Bonnie,38,1998-08-28T09:00:00Z,MONCTON NB,0,2,7,1,10
Hurricane,Bonnie,38,1998-08-28T09:00:00Z,CAPE HATTERAS NC,99,0,0,0,99
Hurricane,Bonnie,38,1998-08-28T09:00:00Z,YARMOUTH NS,0,9,6,0,15
Hurricane,Bonnie,38,1998-08-28T09:00:00Z,NORFOLK VA,99,0,0,0,99
Hurricane,Bonnie,38,1998-08-28T09:00:00Z,HALIFAX NS,0,3,9,1,13
Hurricane,Bonnie,38,1998-08-28T09:00:00Z,OCEAN CITY MD,42,0,0,0,42
Hurricane,Bonnie,38,1998-08-28T09:00:00Z,SABLE ISLAND NS,0,1,9,2,12
Hurricane,Bonnie,38,1998-08-28T09:00:00Z,ATLANTIC CITY NJ,28,0,0,0,28
Hurricane,Bonnie,38,1998-08-28T09:00:00Z,SYDNEY NS,0,0,7,3,10
Hurricane,Bonnie,38,1998-08-28T09:00:00Z,NEW YORK CITY NY,21,2,0,0,23
Hurricane,Bonnie,38,1998-08-28T09:00:00Z,EDDY POINT NS,0,1,8,2,11
Hurricane,Bonnie,38,1998-08-28T09:00:00Z,MONTAUK POINT NY,20,5,0,0,25
Hurricane,Bonnie,38,1998-08-28T09:00:00Z,PTX BASQUES NFLD,0,0,4,5,9
Hurricane,Bonnie,38,1998-08-28T09:00:00Z,PROVIDENCE RI,14,8,0,0,22
Hurricane,Bonnie,38,1998-08-28T09:00:00Z,BURGEO NFLD,0,0,3,6,9
Hurricane,Bonnie,38,1998-08-28T09:00:00Z,NANTUCKET MA,14,10,0,0,24
Hurricane,Bonnie,38,1998-08-28T09:00:00Z,ILE ST PIERRE,0,0,3,7,10
Hurricane,Bonnie,38,1998-08-28T09:00:00Z,HYANNIS MA,11,11,0,0,22
Hurricane,Bonnie,38,1998-08-28T09:00:00Z,CAPE RACE NFLD,0,0,1,8,9
Hurricane,Bonnie,38,1998-08-28T09:00:00Z,BOSTON MA,7,12,0,0,19
Hurricane,Bonnie,38,1998-08-28T09:00:00Z,HIBERNIA OILFLD,0,0,0,8,8
Hurricane,Bonnie,38,1998-08-28T09:00:00Z,PORTLAND ME,1,12,1,0,14
Hurricane,Bonnie,39,1998-08-28T15:00:00Z,40.0N  70.4W,24,2,0,0,26
Hurricane,Bonnie,39,1998-08-28T15:00:00Z,BAR HARBOR ME,0,9,4,0,13
Hurricane,Bonnie,39,1998-08-28T15:00:00Z,42.0N  66.6W,1,13,3,1,18
Hurricane,Bonnie,39,1998-08-28T15:00:00Z,EASTPORT ME,0,6,6,1,13
Hurricane,Bonnie,39,1998-08-28T15:00:00Z,44.4N  60.0W,0,0,9,3,12
Hurricane,Bonnie,39,1998-08-28T15:00:00Z,ST JOHN NB,0,4,8,0,12
Hurricane,Bonnie,39,1998-08-28T15:00:00Z,CAPE HATTERAS NC,2,0,0,0,2
Hurricane,Bonnie,39,1998-08-28T15:00:00Z,MONCTON NB,0,1,9,1,11
Hurricane,Bonnie,39,1998-08-28T15:00:00Z,NORFOLK VA,13,0,0,0,13
Hurricane,Bonnie,39,1998-08-28T15:00:00Z,YARMOUTH NS,0,8,7,0,15
Hurricane,Bonnie,39,1998-08-28T15:00:00Z,OCEAN CITY MD,23,0,0,0,23
Hurricane,Bonnie,39,1998-08-28T15:00:00Z,HALIFAX NS,0,2,10,1,13
Hurricane,Bonnie,39,1998-08-28T15:00:00Z,ATLANTIC CITY NJ,16,0,0,0,16
Hurricane,Bonnie,39,1998-08-28T15:00:00Z,SABLE ISLAND NS,0,0,9,3,12
Hurricane,Bonnie,39,1998-08-28T15:00:00Z,NEW YORK CITY NY,14,2,0,0,16
Hurricane,Bonnie,39,1998-08-28T15:00:00Z,SYDNEY NS,0,0,7,4,11
Hurricane,Bonnie,39,1998-08-28T15:00:00Z,MONTAUK POINT NY,17,3,0,0,20
Hurricane,Bonnie,39,1998-08-28T15:00:00Z,EDDY POINT NS,0,0,9,2,11
Hurricane,Bonnie,39,1998-08-28T15:00:00Z,PROVIDENCE RI,13,5,0,0,18
Hurricane,Bonnie,39,1998-08-28T15:00:00Z,PTX BASQUES NFLD,0,0,4,5,9
Hurricane,Bonnie,39,1998-08-28T15:00:00Z,NANTUCKET MA,15,5,0,1,21
Hurricane,Bonnie,39,1998-08-28T15:00:00Z,BURGEO NFLD,0,0,3,6,9
Hurricane,Bonnie,39,1998-08-28T15:00:00Z,HYANNIS MA,12,7,0,0,19
Hurricane,Bonnie,39,1998-08-28T15:00:00Z,ILE ST PIERRE,0,0,2,8,10
Hurricane,Bonnie,39,1998-08-28T15:00:00Z,BOSTON MA,7,9,0,0,16
Hurricane,Bonnie,39,1998-08-28T15:00:00Z,CAPE RACE NFLD,0,0,1,9,10
Hurricane,Bonnie,39,1998-08-28T15:00:00Z,PORTLAND ME,1,10,2,1,14
Hurricane,Bonnie,39,1998-08-28T15:00:00Z,HIBERNIA OILFLD,0,0,0,9,9
Tropical Storm,Bonnie,40,1998-08-28T21:00:00Z,41.0N  68.0W,24,5,0,0,29
Tropical Storm,Bonnie,40,1998-08-28T21:00:00Z,EASTPORT ME,0,11,4,0,15
Tropical Storm,Bonnie,40,1998-08-28T21:00:00Z,43.0N  63.5W,0,15,5,0,20
Tropical Storm,Bonnie,40,1998-08-28T21:00:00Z,ST JOHN NB,0,9,6,0,15
Tropical Storm,Bonnie,40,1998-08-28T21:00:00Z,45.0N  56.0W,0,0,11,4,15
Tropical Storm,Bonnie,40,1998-08-28T21:00:00Z,MONCTON NB,0,5,8,0,13
Tropical Storm,Bonnie,40,1998-08-28T21:00:00Z,OCEAN CITY MD,2,0,0,0,2
Tropical Storm,Bonnie,40,1998-08-28T21:00:00Z,YARMOUTH NS,1,15,3,0,19
Tropical Storm,Bonnie,40,1998-08-28T21:00:00Z,ATLANTIC CITY NJ,2,0,0,0,2
Tropical Storm,Bonnie,40,1998-08-28T21:00:00Z,HALIFAX NS,0,9,8,0,17
Tropical Storm,Bonnie,40,1998-08-28T21:00:00Z,NEW YORK CITY NY,5,1,0,0,6
Tropical Storm,Bonnie,40,1998-08-28T21:00:00Z,SABLE ISLAND NS,0,4,13,0,17
Tropical Storm,Bonnie,40,1998-08-28T21:00:00Z,MONTAUK POINT NY,23,0,0,0,23
Tropical Storm,Bonnie,40,1998-08-28T21:00:00Z,SYDNEY NS,0,1,11,2,14
Tropical Storm,Bonnie,40,1998-08-28T21:00:00Z,PROVIDENCE RI,19,2,1,0,22
Tropical Storm,Bonnie,40,1998-08-28T21:00:00Z,EDDY POINT NS,0,3,12,0,15
Tropical Storm,Bonnie,40,1998-08-28T21:00:00Z,NANTUCKET MA,28,2,0,0,30
Tropical Storm,Bonnie,40,1998-08-28T21:00:00Z,PTX BASQUES NFLD,0,0,8,4,12
Tropical Storm,Bonnie,40,1998-08-28T21:00:00Z,HYANNIS MA,24,2,0,0,26
Tropical Storm,Bonnie,40,1998-08-28T21:00:00Z,BURGEO NFLD,0,0,7,5,12
Tropical Storm,Bonnie,40,1998-08-28T21:00:00Z,BOSTON MA,14,5,0,0,19
Tropical Storm,Bonnie,40,1998-08-28T21:00:00Z,ILE ST PIERRE,0,0,8,5,13
Tropical Storm,Bonnie,40,1998-08-28T21:00:00Z,PORTLAND ME,4,10,1,0,15
Tropical Storm,Bonnie,40,1998-08-28T21:00:00Z,CAPE RACE NFLD,0,0,5,8,13
Tropical Storm,Bonnie,40,1998-08-28T21:00:00Z,BAR HARBOR ME,1,12,2,0,15
Tropical Storm,Bonnie,40,1998-08-28T21:00:00Z,HIBERNIA OILFLD,0,0,1,10,11
Tropical Storm,Bonnie,41,1998-08-29T03:00:00Z,41.3N  64.3W,22,3,0,0,25
Tropical Storm,Bonnie,41,1998-08-29T03:00:00Z,HALIFAX NS,3,11,1,0,15
Tropical Storm,Bonnie,41,1998-08-29T03:00:00Z,43.0N  58.9W,0,12,3,1,16
Tropical Storm,Bonnie,41,1998-08-29T03:00:00Z,SABLE ISLAND NS,0,13,2,1,16
Tropical Storm,Bonnie,41,1998-08-29T03:00:00Z,44.1N  51.9W,0,1,8,3,12
Tropical Storm,Bonnie,41,1998-08-29T03:00:00Z,SYDNEY NS,0,8,4,0,12
Tropical Storm,Bonnie,41,1998-08-29T03:00:00Z,NANTUCKET MA,5,0,0,0,5
Tropical Storm,Bonnie,41,1998-08-29T03:00:00Z,EDDY POINT NS,0,11,2,0,13
Tropical Storm,Bonnie,41,1998-08-29T03:00:00Z,HYANNIS MA,2,1,0,0,3
Tropical Storm,Bonnie,41,1998-08-29T03:00:00Z,PTX BASQUES NFLD,0,4,5,1,10
Tropical Storm,Bonnie,41,1998-08-29T03:00:00Z,BAR HARBOR ME,2,3,0,0,5
Tropical Storm,Bonnie,41,1998-08-29T03:00:00Z,BURGEO NFLD,0,3,6,1,10
Tropical Storm,Bonnie,41,1998-08-29T03:00:00Z,EASTPORT ME,3,5,0,1,9
Tropical Storm,Bonnie,41,1998-08-29T03:00:00Z,ILE ST PIERRE,0,2,8,1,11
Tropical Storm,Bonnie,41,1998-08-29T03:00:00Z,ST JOHN NB,3,6,1,0,10
Tropical Storm,Bonnie,41,1998-08-29T03:00:00Z,CAPE RACE NFLD,0,1,7,3,11
Tropical Storm,Bonnie,41,1998-08-29T03:00:00Z,MONCTON NB,1,7,1,1,10
Tropical Storm,Bonnie,41,1998-08-29T03:00:00Z,HIBERNIA OILFLD,0,0,3,7,10
Tropical Storm,Bonnie,41,1998-08-29T03:00:00Z,YARMOUTH NS,9,6,0,0,15
Tropical Storm,Bonnie,42,1998-08-29T09:00:00Z,43.2N  61.8W,15,5,0,0,20
Tropical Storm,Bonnie,42,1998-08-29T09:00:00Z,YARMOUTH NS,18,0,0,0,18
Tropical Storm,Bonnie,42,1998-08-29T09:00:00Z,44.6N  55.0W,0,11,3,0,14
Tropical Storm,Bonnie,42,1998-08-29T09:00:00Z,HALIFAX NS,14,3,0,0,17
Tropical Storm,Bonnie,42,1998-08-29T09:00:00Z,44.4N  46.9W,0,0,8,3,11
Tropical Storm,Bonnie,42,1998-08-29T09:00:00Z,SABLE ISLAND NS,7,10,1,0,18
Tropical Storm,Bonnie,42,1998-08-29T09:00:00Z,NANTUCKET MA,16,0,0,0,16
Tropical Storm,Bonnie,42,1998-08-29T09:00:00Z,SYDNEY NS,2,12,0,0,14
Tropical Storm,Bonnie,42,1998-08-29T09:00:00Z,HYANNIS MA,8,0,0,0,8
Tropical Storm,Bonnie,42,1998-08-29T09:00:00Z,EDDY POINT NS,6,9,0,0,15
Tropical Storm,Bonnie,42,1998-08-29T09:00:00Z,BOSTON MA,2,0,0,0,2
Tropical Storm,Bonnie,42,1998-08-29T09:00:00Z,PTX BASQUES NFLD,0,10,1,1,12
Tropical Storm,Bonnie,42,1998-08-29T09:00:00Z,PORTLAND ME,2,0,0,0,2
Tropical Storm,Bonnie,42,1998-08-29T09:00:00Z,BURGEO NFLD,0,10,2,0,12
Tropical Storm,Bonnie,42,1998-08-29T09:00:00Z,BAR HARBOR ME,6,0,0,0,6
Tropical Storm,Bonnie,42,1998-08-29T09:00:00Z,ILE ST PIERRE,0,10,3,0,13
Tropical Storm,Bonnie,42,1998-08-29T09:00:00Z,EASTPORT ME,8,2,0,0,10
Tropical Storm,Bonnie,42,1998-08-29T09:00:00Z,CAPE RACE NFLD,0,6,6,1,13
Tropical Storm,Bonnie,42,1998-08-29T09:00:00Z,ST JOHN NB,9,2,0,0,11
Tropical Storm,Bonnie,42,1998-08-29T09:00:00Z,HIBERNIA OILFLD,0,1,7,3,11
Tropical Storm,Bonnie,42,1998-08-29T09:00:00Z,MONCTON NB,6,5,0,0,11
Tropical Storm,Bonnie,43,1998-08-29T15:00:00Z,45.0N  54.5W,18,7,0,0,25
Tropical Storm,Bonnie,43,1998-08-29T15:00:00Z,SABLE ISLAND NS,36,1,0,0,37
Tropical Storm,Bonnie,43,1998-08-29T15:00:00Z,46.0N  43.0W,0,9,0,0,9
Tropical Storm,Bonnie,43,1998-08-29T15:00:00Z,SYDNEY NS,17,1,0,0,18
Tropical Storm,Bonnie,43,1998-08-29T15:00:00Z,NANTUCKET MA,3,0,0,0,3
Tropical Storm,Bonnie,43,1998-08-29T15:00:00Z,EDDY POINT NS,22,0,0,0,22
Tropical Storm,Bonnie,43,1998-08-29T15:00:00Z,EASTPORT ME,2,0,0,0,2
Tropical Storm,Bonnie,43,1998-08-29T15:00:00Z,PTX BASQUES NFLD,9,1,0,0,10
Tropical Storm,Bonnie,43,1998-08-29T15:00:00Z,ST JOHN NB,4,0,0,0,4
Tropical Storm,Bonnie,43,1998-08-29T15:00:00Z,BURGEO NFLD,10,2,0,0,12
Tropical Storm,Bonnie,43,1998-08-29T15:00:00Z,MONCTON NB,4,0,0,0,4
Tropical Storm,Bonnie,43,1998-08-29T15:00:00Z,ILE ST PIERRE,14,5,0,0,19
Tropical Storm,Bonnie,43,1998-08-29T15:00:00Z,YARMOUTH NS,18,0,0,0,18
Tropical Storm,Bonnie,43,1998-08-29T15:00:00Z,CAPE RACE NFLD,6,13,0,0,19
Tropical Storm,Bonnie,43,1998-08-29T15:00:00Z,HALIFAX NS,24,0,0,0,24
Tropical Storm,Bonnie,43,1998-08-29T15:00:00Z,HIBERNIA OILFLD,0,15,0,0,15
Tropical Storm,Bonnie,44,1998-08-29T21:00:00Z,HALIFAX NS,10,0,0,0,10
Tropical Storm,Bonnie,44,1998-08-29T21:00:00Z,SYDNEY NS,7,0,0,0,7
Tropical Storm,Bonnie,44,1998-08-29T21:00:00Z,SABLE ISLAND NS,45,0,0,0,45
Tropical Storm,Bonnie,44,1998-08-29T21:00:00Z,EDDY POINT NS,13,0,0,0,13
Tropical Storm,Bonnie,45,1998-08-30T03:00:00Z,45.4N  45.3W,18,0,0,0,18
Tropical Storm,Bonnie,45,1998-08-30T03:00:00Z,CAPE RACE NFLD,5,0,0,0,5
Tropical Storm,Bonnie,45,1998-08-30T03:00:00Z,SABLE ISLAND NS,99,0,0,0,99
Tropical Storm,Bonnie,45,1998-08-30T03:00:00Z,HIBERNIA OILFLD,15,0,0,0,15
Tropical Storm,Bonnie,46,1998-08-30T09:00:00Z,45.0N  39.0W,19,6,0,0,25
Tropical Storm,Bonnie,46,1998-08-30T09:00:00Z,43.0N  22.0W,0,1,12,0,13
Tropical Storm,Bonnie,46,1998-08-30T09:00:00Z,44.0N  30.0W,0,15,4,0,19
Tropical Storm,Bonnie,46,1998-08-30T09:00:00Z,HIBERNIA OILFLD,2,0,0,0,2
Tropical Depression,Three,1,1998-08-21T15:00:00Z,27.0N  98.3W,44,0,0,0,44
Tropical Depression,Three,1,1998-08-21T15:00:00Z,CORPUSCHRISTI TX,40,0,0,0,40
Tropical Depression,Three,1,1998-08-21T15:00:00Z,27.5N 100.5W,14,19,0,0,33
Tropical Depression,Three,1,1998-08-21T15:00:00Z,BROWNSVILLE TX,45,0,0,0,45
Tropical Depression,Three,1,1998-08-21T15:00:00Z,28.2N 102.8W,0,23,5,0,28
Tropical Depression,Three,1,1998-08-21T15:00:00Z,GULF 28N 95W,15,1,0,0,16
Tropical Depression,Three,1,1998-08-21T15:00:00Z,MMSO 238N 982W,0,1,2,0,3
Tropical Depression,Three,1,1998-08-21T15:00:00Z,GULF 27N 96W,66,0,0,0,66
Tropical Depression,Three,1,1998-08-21T15:00:00Z,FREEPORT TX,3,2,1,0,6
Tropical Depression,Three,1,1998-08-21T15:00:00Z,GULF 25N 96W,40,0,0,0,40
Tropical Depression,Three,1,1998-08-21T15:00:00Z,PORT O CONNOR TX,21,1,0,0,22
Tropical Storm,Charley,2,1998-08-21T21:00:00Z,27.5N  98.6W,44,0,0,0,44
Tropical Storm,Charley,2,1998-08-21T21:00:00Z,CORPUSCHRISTI TX,50,0,0,0,50
Tropical Storm,Charley,2,1998-08-21T21:00:00Z,28.0N 100.8W,13,21,0,0,34
Tropical Storm,Charley,2,1998-08-21T21:00:00Z,BROWNSVILLE TX,36,0,0,0,36
Tropical Storm,Charley,2,1998-08-21T21:00:00Z,28.5N 103.0W,0,24,4,0,28
Tropical Storm,Charley,2,1998-08-21T21:00:00Z,GULF 28N 95W,34,0,0,0,34
Tropical Storm,Charley,2,1998-08-21T21:00:00Z,GALVESTON TX,2,1,0,0,3
Tropical Storm,Charley,2,1998-08-21T21:00:00Z,GULF 27N 96W,89,0,0,0,89
Tropical Storm,Charley,2,1998-08-21T21:00:00Z,FREEPORT TX,8,2,0,0,10
Tropical Storm,Charley,2,1998-08-21T21:00:00Z,GULF 25N 96W,13,0,0,0,13
Tropical Storm,Charley,2,1998-08-21T21:00:00Z,PORT O CONNOR TX,32,0,0,0,32
Tropical Storm,Charley,3,1998-08-22T03:00:00Z,29.0N 100.0W,42,0,0,0,42
Tropical Storm,Charley,3,1998-08-22T03:00:00Z,CORPUSCHRISTI TX,83,0,0,0,83
Tropical Storm,Charley,3,1998-08-22T03:00:00Z,29.6N 102.6W,9,23,0,0,32
Tropical Storm,Charley,3,1998-08-22T03:00:00Z,BROWNSVILLE TX,3,1,0,0,4
Tropical Storm,Charley,3,1998-08-22T03:00:00Z,0.0N   0.0W,99,0,0,0,99
Tropical Storm,Charley,3,1998-08-22T03:00:00Z,GULF 28N 95W,73,0,0,0,73
Tropical Storm,Charley,3,1998-08-22T03:00:00Z,FREEPORT TX,18,0,0,0,18
Tropical Storm,Charley,3,1998-08-22T03:00:00Z,GULF 27N 96W,99,0,0,0,99
Tropical Storm,Charley,3,1998-08-22T03:00:00Z,PORT O CONNOR TX,80,0,0,0,80
Tropical Storm,Charley,4,1998-08-22T09:00:00Z,29.1N  99.8W,43,0,0,0,43
Tropical Storm,Charley,4,1998-08-22T09:00:00Z,PORT O CONNOR TX,99,0,0,0,99
Tropical Storm,Charley,4,1998-08-22T09:00:00Z,29.5N 101.5W,20,8,0,0,28
Tropical Storm,Charley,4,1998-08-22T09:00:00Z,CORPUSCHRISTI TX,99,0,0,0,99
Tropical Storm,Charley,4,1998-08-22T09:00:00Z,30.0N 103.5W,2,16,4,0,22
Tropical Storm,Charley,4,1998-08-22T09:00:00Z,BROWNSVILLE TX,1,1,1,0,3
Tropical Storm,Charley,4,1998-08-22T09:00:00Z,GALVESTON TX,3,1,0,0,4
Tropical Storm,Charley,4,1998-08-22T09:00:00Z,GULF 28N 95W,23,0,0,0,23
Tropical Storm,Charley,4,1998-08-22T09:00:00Z,FREEPORT TX,55,0,0,0,55
Tropical Storm,Charley,4,1998-08-22T09:00:00Z,GULF 27N 96W,99,0,0,0,99
Tropical Depression,Four,1,1998-08-24T15:30:00Z,15.6N  42.9W,44,2,0,0,46
Tropical Depression,Four,1,1998-08-24T15:30:00Z,TFFF 146N 610W,0,0,0,2,2
Tropical Depression,Four,1,1998-08-24T15:30:00Z,16.5N  46.2W,0,29,1,0,30
Tropical Depression,Four,1,1998-08-24T15:30:00Z,TDPR 153N 614W,0,0,0,2,2
Tropical Depression,Four,1,1998-08-24T15:30:00Z,17.4N  49.4W,0,1,20,1,22
Tropical Depression,Four,1,1998-08-24T15:30:00Z,TFFR 163N 615W,0,0,0,2,2
Tropical Depression,Four,1,1998-08-24T15:30:00Z,TBPB 131N 595W,0,0,0,3,3
Tropical Depression,Four,1,1998-08-24T15:30:00Z,TAPA 171N 618W,0,0,0,2,2
Tropical Storm,Danielle,2,1998-08-24T21:00:00Z,15.9N  45.1W,48,1,0,0,49
Tropical Storm,Danielle,2,1998-08-24T21:00:00Z,TAPA 171N 618W,0,0,0,13,13
Tropical Storm,Danielle,2,1998-08-24T21:00:00Z,16.8N  48.8W,0,31,1,0,32
Tropical Storm,Danielle,2,1998-08-24T21:00:00Z,TKPK 173N 627W,0,0,0,11,11
Tropical Storm,Danielle,2,1998-08-24T21:00:00Z,17.5N  52.6W,0,0,22,1,23
Tropical Storm,Danielle,2,1998-08-24T21:00:00Z,TNCM 181N 631W,0,0,0,10,10
Tropical Storm,Danielle,2,1998-08-24T21:00:00Z,TTPP 106N 614W,0,0,0,3,3
Tropical Storm,Danielle,2,1998-08-24T21:00:00Z,TISX 177N 648W,0,0,0,5,5
Tropical Storm,Danielle,2,1998-08-24T21:00:00Z,TTPT 112N 608W,0,0,0,5,5
Tropical Storm,Danielle,2,1998-08-24T21:00:00Z,TIST 183N 650W,0,0,0,5,5
Tropical Storm,Danielle,2,1998-08-24T21:00:00Z,TGPY 120N 618W,0,0,0,5,5
Tropical Storm,Danielle,2,1998-08-24T21:00:00Z,TJPS 180N 666W,0,0,0,2,2
Tropical Storm,Danielle,2,1998-08-24T21:00:00Z,TBPB 131N 595W,0,0,0,10,10
Tropical Storm,Danielle,2,1998-08-24T21:00:00Z,TJSJ 184N 661W,0,0,0,3,3
Tropical Storm,Danielle,2,1998-08-24T21:00:00Z,TVSV 131N 612W,0,0,0,8,8
Tropical Storm,Danielle,2,1998-08-24T21:00:00Z,ST CROIX VI,0,0,0,5,5
Tropical Storm,Danielle,2,1998-08-24T21:00:00Z,TLPL 138N 610W,0,0,0,10,10
Tropical Storm,Danielle,2,1998-08-24T21:00:00Z,ST THOMAS VI,0,0,0,5,5
Tropical Storm,Danielle,2,1998-08-24T21:00:00Z,TFFF 146N 610W,0,0,0,11,11
Tropical Storm,Danielle,2,1998-08-24T21:00:00Z,SAN JUAN PR,0,0,0,3,3
Tropical Storm,Danielle,2,1998-08-24T21:00:00Z,TDPR 153N 614W,0,0,0,12,12
Tropical Storm,Danielle,2,1998-08-24T21:00:00Z,PONCE PR,0,0,0,2,2
Tropical Storm,Danielle,2,1998-08-24T21:00:00Z,TFFR 163N 615W,0,0,0,13,13
Tropical Storm,Danielle,3,1998-08-25T03:00:00Z,16.4N  47.0W,43,4,0,0,47
Tropical Storm,Danielle,3,1998-08-25T03:00:00Z,TFFR 163N 615W,0,0,0,15,15
Tropical Storm,Danielle,3,1998-08-25T03:00:00Z,17.2N  50.7W,0,28,2,0,30
Tropical Storm,Danielle,3,1998-08-25T03:00:00Z,TAPA 171N 618W,0,0,0,15,15
Tropical Storm,Danielle,3,1998-08-25T03:00:00Z,17.7N  54.4W,0,0,21,1,22
Tropical Storm,Danielle,3,1998-08-25T03:00:00Z,TKPK 173N 627W,0,0,0,14,14
Tropical Storm,Danielle,3,1998-08-25T03:00:00Z,SVMG 110N 640W,0,0,0,3,3
Tropical Storm,Danielle,3,1998-08-25T03:00:00Z,TNCM 181N 631W,0,0,0,14,14
Tropical Storm,Danielle,3,1998-08-25T03:00:00Z,TTPP 106N 614W,0,0,0,5,5
Tropical Storm,Danielle,3,1998-08-25T03:00:00Z,TISX 177N 648W,0,0,0,10,10
Tropical Storm,Danielle,3,1998-08-25T03:00:00Z,TTPT 112N 608W,0,0,0,7,7
Tropical Storm,Danielle,3,1998-08-25T03:00:00Z,TIST 183N 650W,0,0,0,10,10
Tropical Storm,Danielle,3,1998-08-25T03:00:00Z,TGPY 120N 618W,0,0,0,8,8
Tropical Storm,Danielle,3,1998-08-25T03:00:00Z,TJPS 180N 666W,0,0,0,5,5
Tropical Storm,Danielle,3,1998-08-25T03:00:00Z,TBPB 131N 595W,0,0,1,11,12
Tropical Storm,Danielle,3,1998-08-25T03:00:00Z,TJSJ 184N 661W,0,0,0,7,7
Tropical Storm,Danielle,3,1998-08-25T03:00:00Z,TVSV 131N 612W,0,0,0,11,11
Tropical Storm,Danielle,3,1998-08-25T03:00:00Z,ST CROIX VI,0,0,0,10,10
Tropical Storm,Danielle,3,1998-08-25T03:00:00Z,TLPL 138N 610W,0,0,0,12,12
Tropical Storm,Danielle,3,1998-08-25T03:00:00Z,ST THOMAS VI,0,0,0,10,10
Tropical Storm,Danielle,3,1998-08-25T03:00:00Z,TFFF 146N 610W,0,0,0,14,14
Tropical Storm,Danielle,3,1998-08-25T03:00:00Z,SAN JUAN PR,0,0,0,7,7
Tropical Storm,Danielle,3,1998-08-25T03:00:00Z,TDPR 153N 614W,0,0,0,14,14
Tropical Storm,Danielle,3,1998-08-25T03:00:00Z,PONCE PR,0,0,0,5,5
Tropical Storm,Danielle,4,1998-08-25T09:00:00Z,17.2N  48.7W,44,3,0,0,47
Tropical Storm,Danielle,4,1998-08-25T09:00:00Z,TAPA 171N 618W,0,0,0,16,16
Tropical Storm,Danielle,4,1998-08-25T09:00:00Z,17.9N  52.4W,0,29,1,1,31
Tropical Storm,Danielle,4,1998-08-25T09:00:00Z,TKPK 173N 627W,0,0,0,16,16
Tropical Storm,Danielle,4,1998-08-25T09:00:00Z,18.5N  56.0W,0,0,21,1,22
Tropical Storm,Danielle,4,1998-08-25T09:00:00Z,TNCM 181N 631W,0,0,0,16,16
Tropical Storm,Danielle,4,1998-08-25T09:00:00Z,SVMG 110N 640W,0,0,0,4,4
Tropical Storm,Danielle,4,1998-08-25T09:00:00Z,TISX 177N 648W,0,0,0,13,13
Tropical Storm,Danielle,4,1998-08-25T09:00:00Z,TTPP 106N 614W,0,0,0,5,5
Tropical Storm,Danielle,4,1998-08-25T09:00:00Z,TIST 183N 650W,0,0,0,13,13
Tropical Storm,Danielle,4,1998-08-25T09:00:00Z,TTPT 112N 608W,0,0,0,7,7
Tropical Storm,Danielle,4,1998-08-25T09:00:00Z,TJPS 180N 666W,0,0,0,9,9
Tropical Storm,Danielle,4,1998-08-25T09:00:00Z,TGPY 120N 618W,0,0,0,8,8
Tropical Storm,Danielle,4,1998-08-25T09:00:00Z,MDSD 185N 697W,0,0,0,2,2
Tropical Storm,Danielle,4,1998-08-25T09:00:00Z,TBPB 131N 595W,0,0,2,10,12
Tropical Storm,Danielle,4,1998-08-25T09:00:00Z,TJSJ 184N 661W,0,0,0,11,11
Tropical Storm,Danielle,4,1998-08-25T09:00:00Z,TVSV 131N 612W,0,0,0,11,11
Tropical Storm,Danielle,4,1998-08-25T09:00:00Z,ST CROIX VI,0,0,0,13,13
Tropical Storm,Danielle,4,1998-08-25T09:00:00Z,TLPL 138N 610W,0,0,0,12,12
Tropical Storm,Danielle,4,1998-08-25T09:00:00Z,ST THOMAS VI,0,0,0,13,13
Tropical Storm,Danielle,4,1998-08-25T09:00:00Z,TFFF 146N 610W,0,0,1,13,14
Tropical Storm,Danielle,4,1998-08-25T09:00:00Z,SAN JUAN PR,0,0,0,11,11
Tropical Storm,Danielle,4,1998-08-25T09:00:00Z,TDPR 153N 614W,0,0,0,15,15
Tropical Storm,Danielle,4,1998-08-25T09:00:00Z,PONCE PR,0,0,0,9,9
Tropical Storm,Danielle,4,1998-08-25T09:00:00Z,TFFR 163N 615W,0,0,0,16,16
Hurricane,Danielle,5,1998-08-25T15:00:00Z,17.5N  51.5W,46,4,0,0,50
Hurricane,Danielle,5,1998-08-25T15:00:00Z,TNCM 181N 631W,0,0,3,16,19
Hurricane,Danielle,5,1998-08-25T15:00:00Z,18.0N  55.5W,0,29,2,0,31
Hurricane,Danielle,5,1998-08-25T15:00:00Z,TISX 177N 648W,0,0,0,17,17
Hurricane,Danielle,5,1998-08-25T15:00:00Z,18.5N  59.5W,0,0,21,2,23
Hurricane,Danielle,5,1998-08-25T15:00:00Z,TIST 183N 650W,0,0,0,17,17
Hurricane,Danielle,5,1998-08-25T15:00:00Z,TNCC 122N 690W,0,0,0,2,2
Hurricane,Danielle,5,1998-08-25T15:00:00Z,TJPS 180N 666W,0,0,0,15,15
Hurricane,Danielle,5,1998-08-25T15:00:00Z,SVMG 110N 640W,0,0,0,5,5
Hurricane,Danielle,5,1998-08-25T15:00:00Z,MDSD 185N 697W,0,0,0,10,10
Hurricane,Danielle,5,1998-08-25T15:00:00Z,TTPP 106N 614W,0,0,1,4,5
Hurricane,Danielle,5,1998-08-25T15:00:00Z,MDCB 176N 714W,0,0,0,5,5
Hurricane,Danielle,5,1998-08-25T15:00:00Z,TTPT 112N 608W,0,0,2,5,7
Hurricane,Danielle,5,1998-08-25T15:00:00Z,MTPP 186N 724W,0,0,0,3,3
Hurricane,Danielle,5,1998-08-25T15:00:00Z,TGPY 120N 618W,0,0,2,6,8
Hurricane,Danielle,5,1998-08-25T15:00:00Z,TJSJ 184N 661W,0,0,0,16,16
Hurricane,Danielle,5,1998-08-25T15:00:00Z,TBPB 131N 595W,0,0,10,3,13
Hurricane,Danielle,5,1998-08-25T15:00:00Z,MDPP 198N 707W,0,0,0,9,9
Hurricane,Danielle,5,1998-08-25T15:00:00Z,TVSV 131N 612W,0,0,6,6,12
Hurricane,Danielle,5,1998-08-25T15:00:00Z,MBJT 215N 712W,0,0,0,8,8
Hurricane,Danielle,5,1998-08-25T15:00:00Z,TLPL 138N 610W,0,0,8,6,14
Hurricane,Danielle,5,1998-08-25T15:00:00Z,MYMM 224N 730W,0,0,0,3,3
Hurricane,Danielle,5,1998-08-25T15:00:00Z,TFFF 146N 610W,0,0,10,6,16
Hurricane,Danielle,5,1998-08-25T15:00:00Z,ST CROIX VI,0,0,0,17,17
Hurricane,Danielle,5,1998-08-25T15:00:00Z,TDPR 153N 614W,0,0,10,7,17
Hurricane,Danielle,5,1998-08-25T15:00:00Z,ST THOMAS VI,0,0,0,17,17
Hurricane,Danielle,5,1998-08-25T15:00:00Z,TFFR 163N 615W,0,0,11,8,19
Hurricane,Danielle,5,1998-08-25T15:00:00Z,SAN JUAN PR,0,0,0,16,16
Hurricane,Danielle,5,1998-08-25T15:00:00Z,TAPA 171N 618W,0,0,10,10,20
Hurricane,Danielle,5,1998-08-25T15:00:00Z,PONCE PR,0,0,0,15,15
Hurricane,Danielle,5,1998-08-25T15:00:00Z,TKPK 173N 627W,0,0,5,14,19
Hurricane,Danielle,6,1998-08-25T21:00:00Z,18.5N  52.5W,58,2,0,0,60
Hurricane,Danielle,6,1998-08-25T21:00:00Z,MDSD 185N 697W,0,0,0,9,9
Hurricane,Danielle,6,1998-08-25T21:00:00Z,19.5N  56.0W,0,34,2,0,36
Hurricane,Danielle,6,1998-08-25T21:00:00Z,MDCB 176N 714W,0,0,0,3,3
Hurricane,Danielle,6,1998-08-25T21:00:00Z,20.0N  60.0W,0,1,24,1,26
Hurricane,Danielle,6,1998-08-25T21:00:00Z,MTPP 186N 724W,0,0,0,3,3
Hurricane,Danielle,6,1998-08-25T21:00:00Z,TFFF 146N 610W,0,0,1,2,3
Hurricane,Danielle,6,1998-08-25T21:00:00Z,TJSJ 184N 661W,0,0,0,14,14
Hurricane,Danielle,6,1998-08-25T21:00:00Z,TDPR 153N 614W,0,0,3,3,6
Hurricane,Danielle,6,1998-08-25T21:00:00Z,MDPP 198N 707W,0,0,0,9,9
Hurricane,Danielle,6,1998-08-25T21:00:00Z,TFFR 163N 615W,0,0,6,5,11
Hurricane,Danielle,6,1998-08-25T21:00:00Z,MBJT 215N 712W,0,0,0,9,9
Hurricane,Danielle,6,1998-08-25T21:00:00Z,TAPA 171N 618W,0,0,9,6,15
Hurricane,Danielle,6,1998-08-25T21:00:00Z,MYMM 224N 730W,0,0,0,4,4
Hurricane,Danielle,6,1998-08-25T21:00:00Z,TKPK 173N 627W,0,0,6,9,15
Hurricane,Danielle,6,1998-08-25T21:00:00Z,ST CROIX VI,0,0,1,13,14
Hurricane,Danielle,6,1998-08-25T21:00:00Z,TNCM 181N 631W,0,0,6,11,17
Hurricane,Danielle,6,1998-08-25T21:00:00Z,ST THOMAS VI,0,0,1,14,15
Hurricane,Danielle,6,1998-08-25T21:00:00Z,TISX 177N 648W,0,0,1,13,14
Hurricane,Danielle,6,1998-08-25T21:00:00Z,SAN JUAN PR,0,0,0,14,14
Hurricane,Danielle,6,1998-08-25T21:00:00Z,TIST 183N 650W,0,0,1,14,15
Hurricane,Danielle,6,1998-08-25T21:00:00Z,PONCE PR,0,0,0,13,13
Hurricane,Danielle,6,1998-08-25T21:00:00Z,TJPS 180N 666W,0,0,0,13,13
Hurricane,Danielle,7,1998-08-26T03:00:00Z,19.8N  55.5W,54,3,0,0,57
Hurricane,Danielle,7,1998-08-26T03:00:00Z,MUCM 214N 779W,0,0,0,2,2
Hurricane,Danielle,7,1998-08-26T03:00:00Z,21.0N  59.5W,0,32,1,0,33
Hurricane,Danielle,7,1998-08-26T03:00:00Z,TJSJ 184N 661W,0,0,4,6,10
Hurricane,Danielle,7,1998-08-26T03:00:00Z,22.3N  63.6W,0,1,22,1,24
Hurricane,Danielle,7,1998-08-26T03:00:00Z,MDPP 198N 707W,0,0,0,11,11
Hurricane,Danielle,7,1998-08-26T03:00:00Z,TFFR 163N 615W,0,1,1,0,2
Hurricane,Danielle,7,1998-08-26T03:00:00Z,MBJT 215N 712W,0,0,0,15,15
Hurricane,Danielle,7,1998-08-26T03:00:00Z,TAPA 171N 618W,0,2,3,0,5
Hurricane,Danielle,7,1998-08-26T03:00:00Z,MYMM 224N 730W,0,0,0,14,14
Hurricane,Danielle,7,1998-08-26T03:00:00Z,TKPK 173N 627W,0,1,5,0,6
Hurricane,Danielle,7,1998-08-26T03:00:00Z,MYSM 241N 745W,0,0,0,13,13
Hurricane,Danielle,7,1998-08-26T03:00:00Z,TNCM 181N 631W,0,1,9,1,11
Hurricane,Danielle,7,1998-08-26T03:00:00Z,MYEG 235N 758W,0,0,0,9,9
Hurricane,Danielle,7,1998-08-26T03:00:00Z,TISX 177N 648W,0,0,5,2,7
Hurricane,Danielle,7,1998-08-26T03:00:00Z,MYAK 241N 776W,0,0,0,4,4
Hurricane,Danielle,7,1998-08-26T03:00:00Z,TIST 183N 650W,0,0,7,3,10
Hurricane,Danielle,7,1998-08-26T03:00:00Z,MYNN 251N 775W,0,0,0,5,5
Hurricane,Danielle,7,1998-08-26T03:00:00Z,TJPS 180N 666W,0,0,2,6,8
Hurricane,Danielle,7,1998-08-26T03:00:00Z,MYGF 266N 787W,0,0,0,2,2
Hurricane,Danielle,7,1998-08-26T03:00:00Z,MDSD 185N 697W,0,0,0,8,8
Hurricane,Danielle,7,1998-08-26T03:00:00Z,ST CROIX VI,0,0,5,2,7
Hurricane,Danielle,7,1998-08-26T03:00:00Z,MDCB 176N 714W,0,0,0,4,4
Hurricane,Danielle,7,1998-08-26T03:00:00Z,ST THOMAS VI,0,0,7,3,10
Hurricane,Danielle,7,1998-08-26T03:00:00Z,MTPP 186N 724W,0,0,0,5,5
Hurricane,Danielle,7,1998-08-26T03:00:00Z,SAN JUAN PR,0,0,4,6,10
Hurricane,Danielle,7,1998-08-26T03:00:00Z,MTCA 183N 738W,0,0,0,3,3
Hurricane,Danielle,7,1998-08-26T03:00:00Z,PONCE PR,0,0,2,6,8
Hurricane,Danielle,7,1998-08-26T03:00:00Z,MUGM 200N 751W,0,0,0,5,5
Hurricane,Danielle,8,1998-08-26T09:00:00Z,20.5N  56.4W,59,1,0,0,60
Hurricane,Danielle,8,1998-08-26T09:00:00Z,MTCA 183N 738W,0,0,0,2,2
Hurricane,Danielle,8,1998-08-26T09:00:00Z,21.5N  60.0W,0,35,1,0,36
Hurricane,Danielle,8,1998-08-26T09:00:00Z,MUGM 200N 751W,0,0,0,2,2
Hurricane,Danielle,8,1998-08-26T09:00:00Z,22.5N  63.5W,0,2,23,1,26
Hurricane,Danielle,8,1998-08-26T09:00:00Z,TJSJ 184N 661W,0,0,3,6,9
Hurricane,Danielle,8,1998-08-26T09:00:00Z,TFFR 163N 615W,0,0,2,0,2
Hurricane,Danielle,8,1998-08-26T09:00:00Z,MDPP 198N 707W,0,0,0,9,9
Hurricane,Danielle,8,1998-08-26T09:00:00Z,TAPA 171N 618W,0,1,4,0,5
Hurricane,Danielle,8,1998-08-26T09:00:00Z,MBJT 215N 712W,0,0,0,12,12
Hurricane,Danielle,8,1998-08-26T09:00:00Z,TKPK 173N 627W,0,1,4,1,6
Hurricane,Danielle,8,1998-08-26T09:00:00Z,MYMM 224N 730W,0,0,0,10,10
Hurricane,Danielle,8,1998-08-26T09:00:00Z,TNCM 181N 631W,0,1,8,1,10
Hurricane,Danielle,8,1998-08-26T09:00:00Z,MYSM 241N 745W,0,0,0,7,7
Hurricane,Danielle,8,1998-08-26T09:00:00Z,TISX 177N 648W,0,0,4,3,7
Hurricane,Danielle,8,1998-08-26T09:00:00Z,MYEG 235N 758W,0,0,0,4,4
Hurricane,Danielle,8,1998-08-26T09:00:00Z,TIST 183N 650W,0,0,5,5,10
Hurricane,Danielle,8,1998-08-26T09:00:00Z,ST CROIX VI,0,0,4,3,7
Hurricane,Danielle,8,1998-08-26T09:00:00Z,TJPS 180N 666W,0,0,2,5,7
Hurricane,Danielle,8,1998-08-26T09:00:00Z,ST THOMAS VI,0,0,5,5,10
Hurricane,Danielle,8,1998-08-26T09:00:00Z,MDSD 185N 697W,0,0,0,6,6
Hurricane,Danielle,8,1998-08-26T09:00:00Z,SAN JUAN PR,0,0,3,6,9
Hurricane,Danielle,8,1998-08-26T09:00:00Z,MDCB 176N 714W,0,0,0,3,3
Hurricane,Danielle,8,1998-08-26T09:00:00Z,PONCE PR,0,0,2,5,7
Hurricane,Danielle,8,1998-08-26T09:00:00Z,MTPP 186N 724W,0,0,0,3,3
Hurricane,Danielle,9,1998-08-26T15:00:00Z,21.0N  58.5W,54,1,0,0,55
Hurricane,Danielle,9,1998-08-26T15:00:00Z,MUCM 214N 779W,0,0,0,2,2
Hurricane,Danielle,9,1998-08-26T15:00:00Z,22.0N  62.0W,0,32,1,0,33
Hurricane,Danielle,9,1998-08-26T15:00:00Z,TJSJ 184N 661W,0,0,6,2,8
Hurricane,Danielle,9,1998-08-26T15:00:00Z,23.0N  65.5W,0,2,21,1,24
Hurricane,Danielle,9,1998-08-26T15:00:00Z,MDPP 198N 707W,0,0,1,8,9
Hurricane,Danielle,9,1998-08-26T15:00:00Z,TAPA 171N 618W,0,1,1,0,2
Hurricane,Danielle,9,1998-08-26T15:00:00Z,MBJT 215N 712W,0,0,1,13,14
Hurricane,Danielle,9,1998-08-26T15:00:00Z,TKPK 173N 627W,0,2,1,0,3
Hurricane,Danielle,9,1998-08-26T15:00:00Z,MYMM 224N 730W,0,0,0,13,13
Hurricane,Danielle,9,1998-08-26T15:00:00Z,TNCM 181N 631W,0,4,3,1,8
Hurricane,Danielle,9,1998-08-26T15:00:00Z,MYSM 241N 745W,0,0,0,13,13
Hurricane,Danielle,9,1998-08-26T15:00:00Z,TISX 177N 648W,0,1,3,1,5
Hurricane,Danielle,9,1998-08-26T15:00:00Z,MYEG 235N 758W,0,0,0,9,9
Hurricane,Danielle,9,1998-08-26T15:00:00Z,TIST 183N 650W,0,1,6,1,8
Hurricane,Danielle,9,1998-08-26T15:00:00Z,MYAK 241N 776W,0,0,0,5,5
Hurricane,Danielle,9,1998-08-26T15:00:00Z,TJPS 180N 666W,0,0,3,3,6
Hurricane,Danielle,9,1998-08-26T15:00:00Z,MYNN 251N 775W,0,0,0,5,5
Hurricane,Danielle,9,1998-08-26T15:00:00Z,MDSD 185N 697W,0,0,1,5,6
Hurricane,Danielle,9,1998-08-26T15:00:00Z,MYGF 266N 787W,0,0,0,3,3
Hurricane,Danielle,9,1998-08-26T15:00:00Z,MDCB 176N 714W,0,0,0,2,2
Hurricane,Danielle,9,1998-08-26T15:00:00Z,ST CROIX VI,0,1,3,1,5
Hurricane,Danielle,9,1998-08-26T15:00:00Z,MTPP 186N 724W,0,0,0,4,4
Hurricane,Danielle,9,1998-08-26T15:00:00Z,ST THOMAS VI,0,1,6,1,8
Hurricane,Danielle,9,1998-08-26T15:00:00Z,MTCA 183N 738W,0,0,0,2,2
Hurricane,Danielle,9,1998-08-26T15:00:00Z,SAN JUAN PR,0,0,6,2,8
Hurricane,Danielle,9,1998-08-26T15:00:00Z,MUGM 200N 751W,0,0,0,4,4
Hurricane,Danielle,9,1998-08-26T15:00:00Z,PONCE PR,0,0,3,3,6
Hurricane,Danielle,10,1998-08-26T21:00:00Z,22.0N  59.0W,41,1,0,0,42
Hurricane,Danielle,10,1998-08-26T21:00:00Z,MBJT 215N 712W,0,0,1,10,11
Hurricane,Danielle,10,1998-08-26T21:00:00Z,23.0N  62.5W,1,28,0,1,30
Hurricane,Danielle,10,1998-08-26T21:00:00Z,MYMM 224N 730W,0,0,0,11,11
Hurricane,Danielle,10,1998-08-26T21:00:00Z,24.0N  65.5W,0,6,15,1,22
Hurricane,Danielle,10,1998-08-26T21:00:00Z,MYSM 241N 745W,0,0,0,11,11
Hurricane,Danielle,10,1998-08-26T21:00:00Z,MDSD 185N 697W,0,0,0,2,2
Hurricane,Danielle,10,1998-08-26T21:00:00Z,MYEG 235N 758W,0,0,0,8,8
Hurricane,Danielle,10,1998-08-26T21:00:00Z,MTPP 186N 724W,0,0,0,2,2
Hurricane,Danielle,10,1998-08-26T21:00:00Z,MYAK 241N 776W,0,0,0,4,4
Hurricane,Danielle,10,1998-08-26T21:00:00Z,MUGM 200N 751W,0,0,0,3,3
Hurricane,Danielle,10,1998-08-26T21:00:00Z,MYNN 251N 775W,0,0,0,5,5
Hurricane,Danielle,10,1998-08-26T21:00:00Z,MUCM 214N 779W,0,0,0,2,2
Hurricane,Danielle,10,1998-08-26T21:00:00Z,MYGF 266N 787W,0,0,0,2,2
Hurricane,Danielle,10,1998-08-26T21:00:00Z,TJSJ 184N 661W,0,0,1,1,2
Hurricane,Danielle,10,1998-08-26T21:00:00Z,SAN JUAN PR,0,0,1,1,2
Hurricane,Danielle,10,1998-08-26T21:00:00Z,MDPP 198N 707W,0,0,0,6,6
Hurricane,Danielle,11,1998-08-27T03:00:00Z,22.2N  61.4W,46,1,0,0,47
Hurricane,Danielle,11,1998-08-27T03:00:00Z,MYEG 235N 758W,0,0,0,10,10
Hurricane,Danielle,11,1998-08-27T03:00:00Z,23.1N  64.4W,4,27,0,0,31
Hurricane,Danielle,11,1998-08-27T03:00:00Z,MYAK 241N 776W,0,0,0,7,7
Hurricane,Danielle,11,1998-08-27T03:00:00Z,24.1N  67.6W,0,7,16,1,24
Hurricane,Danielle,11,1998-08-27T03:00:00Z,MYNN 251N 775W,0,0,0,9,9
Hurricane,Danielle,11,1998-08-27T03:00:00Z,MUGM 200N 751W,0,0,0,2,2
Hurricane,Danielle,11,1998-08-27T03:00:00Z,MYGF 266N 787W,0,0,0,7,7
Hurricane,Danielle,11,1998-08-27T03:00:00Z,MUCM 214N 779W,0,0,0,2,2
Hurricane,Danielle,11,1998-08-27T03:00:00Z,MIAMI FL,0,0,0,3,3
Hurricane,Danielle,11,1998-08-27T03:00:00Z,MDPP 198N 707W,0,0,1,3,4
Hurricane,Danielle,11,1998-08-27T03:00:00Z,W PALM BEACH FL,0,0,0,3,3
Hurricane,Danielle,11,1998-08-27T03:00:00Z,MBJT 215N 712W,0,0,3,7,10
Hurricane,Danielle,11,1998-08-27T03:00:00Z,FT PIERCE FL,0,0,0,3,3
Hurricane,Danielle,11,1998-08-27T03:00:00Z,MYMM 224N 730W,0,0,1,10,11
Hurricane,Danielle,11,1998-08-27T03:00:00Z,COCOA BEACH FL,0,0,0,2,2
Hurricane,Danielle,11,1998-08-27T03:00:00Z,MYSM 241N 745W,0,0,0,13,13
Hurricane,Danielle,12,1998-08-27T09:00:00Z,22.5N  63.5W,44,0,0,0,44
Hurricane,Danielle,12,1998-08-27T09:00:00Z,MYNN 251N 775W,0,0,0,7,7
Hurricane,Danielle,12,1998-08-27T09:00:00Z,23.5N  66.5W,3,26,1,0,30
Hurricane,Danielle,12,1998-08-27T09:00:00Z,MYGF 266N 787W,0,0,0,6,6
Hurricane,Danielle,12,1998-08-27T09:00:00Z,25.0N  69.0W,0,9,13,1,23
Hurricane,Danielle,12,1998-08-27T09:00:00Z,MIAMI FL,0,0,0,2,2
Hurricane,Danielle,12,1998-08-27T09:00:00Z,MDPP 198N 707W,0,0,1,1,2
Hurricane,Danielle,12,1998-08-27T09:00:00Z,W PALM BEACH FL,0,0,0,3,3
Hurricane,Danielle,12,1998-08-27T09:00:00Z,MBJT 215N 712W,0,0,5,2,7
Hurricane,Danielle,12,1998-08-27T09:00:00Z,FT PIERCE FL,0,0,0,3,3
Hurricane,Danielle,12,1998-08-27T09:00:00Z,MYMM 224N 730W,0,0,3,5,8
Hurricane,Danielle,12,1998-08-27T09:00:00Z,COCOA BEACH FL,0,0,0,2,2
Hurricane,Danielle,12,1998-08-27T09:00:00Z,MYSM 241N 745W,0,0,1,10,11
Hurricane,Danielle,12,1998-08-27T09:00:00Z,DAYTONA BEACH FL,0,0,0,2,2
Hurricane,Danielle,12,1998-08-27T09:00:00Z,MYEG 235N 758W,0,0,0,7,7
Hurricane,Danielle,12,1998-08-27T09:00:00Z,MOREHEAD CITY NC,0,0,0,2,2
Hurricane,Danielle,12,1998-08-27T09:00:00Z,MYAK 241N 776W,0,0,0,5,5
Hurricane,Danielle,13,1998-08-27T15:00:00Z,23.4N  65.0W,45,1,0,0,46
Hurricane,Danielle,13,1998-08-27T15:00:00Z,W PALM BEACH FL,0,0,0,3,3
Hurricane,Danielle,13,1998-08-27T15:00:00Z,24.8N  68.0W,2,27,0,0,29
Hurricane,Danielle,13,1998-08-27T15:00:00Z,FT PIERCE FL,0,0,0,3,3
Hurricane,Danielle,13,1998-08-27T15:00:00Z,26.4N  70.4W,0,7,14,1,22
Hurricane,Danielle,13,1998-08-27T15:00:00Z,COCOA BEACH FL,0,0,0,3,3
Hurricane,Danielle,13,1998-08-27T15:00:00Z,MBJT 215N 712W,0,1,2,1,4
Hurricane,Danielle,13,1998-08-27T15:00:00Z,DAYTONA BEACH FL,0,0,0,2,2
Hurricane,Danielle,13,1998-08-27T15:00:00Z,MYMM 224N 730W,0,0,4,2,6
Hurricane,Danielle,13,1998-08-27T15:00:00Z,JACKSONVILLE FL,0,0,0,2,2
Hurricane,Danielle,13,1998-08-27T15:00:00Z,MYSM 241N 745W,0,0,4,5,9
Hurricane,Danielle,13,1998-08-27T15:00:00Z,SAVANNAH GA,0,0,0,2,2
Hurricane,Danielle,13,1998-08-27T15:00:00Z,MYEG 235N 758W,0,0,1,5,6
Hurricane,Danielle,13,1998-08-27T15:00:00Z,CHARLESTON SC,0,0,0,2,2
Hurricane,Danielle,13,1998-08-27T15:00:00Z,MYAK 241N 776W,0,0,0,4,4
Hurricane,Danielle,13,1998-08-27T15:00:00Z,MYRTLE BEACH SC,0,0,0,3,3
Hurricane,Danielle,13,1998-08-27T15:00:00Z,MYNN 251N 775W,0,0,0,6,6
Hurricane,Danielle,13,1998-08-27T15:00:00Z,WILMINGTON NC,0,0,0,4,4
Hurricane,Danielle,13,1998-08-27T15:00:00Z,MYGF 266N 787W,0,0,0,6,6
Hurricane,Danielle,13,1998-08-27T15:00:00Z,MOREHEAD CITY NC,0,0,0,4,4
Hurricane,Danielle,13,1998-08-27T15:00:00Z,MIAMI FL,0,0,0,2,2
Hurricane,Danielle,13,1998-08-27T15:00:00Z,CAPE HATTERAS NC,0,0,0,4,4
Hurricane,Danielle,14,1998-08-27T21:00:00Z,24.0N  66.0W,39,1,0,0,40
Hurricane,Danielle,14,1998-08-27T21:00:00Z,FT PIERCE FL,0,0,0,4,4
Hurricane,Danielle,14,1998-08-27T21:00:00Z,25.2N  68.7W,4,23,1,0,28
Hurricane,Danielle,14,1998-08-27T21:00:00Z,COCOA BEACH FL,0,0,0,3,3
Hurricane,Danielle,14,1998-08-27T21:00:00Z,26.7N  71.2W,0,8,13,1,22
Hurricane,Danielle,14,1998-08-27T21:00:00Z,DAYTONA BEACH FL,0,0,0,3,3
Hurricane,Danielle,14,1998-08-27T21:00:00Z,MBJT 215N 712W,0,2,3,1,6
Hurricane,Danielle,14,1998-08-27T21:00:00Z,JACKSONVILLE FL,0,0,0,2,2
Hurricane,Danielle,14,1998-08-27T21:00:00Z,MYMM 224N 730W,0,1,4,2,7
Hurricane,Danielle,14,1998-08-27T21:00:00Z,SAVANNAH GA,0,0,0,2,2
Hurricane,Danielle,14,1998-08-27T21:00:00Z,MYSM 241N 745W,0,0,6,4,10
Hurricane,Danielle,14,1998-08-27T21:00:00Z,CHARLESTON SC,0,0,0,4,4
Hurricane,Danielle,14,1998-08-27T21:00:00Z,MYEG 235N 758W,0,0,2,4,6
Hurricane,Danielle,14,1998-08-27T21:00:00Z,MYRTLE BEACH SC,0,0,0,5,5
Hurricane,Danielle,14,1998-08-27T21:00:00Z,MYAK 241N 776W,0,0,0,4,4
Hurricane,Danielle,14,1998-08-27T21:00:00Z,WILMINGTON NC,0,0,0,6,6
Hurricane,Danielle,14,1998-08-27T21:00:00Z,MYNN 251N 775W,0,0,1,5,6
Hurricane,Danielle,14,1998-08-27T21:00:00Z,MOREHEAD CITY NC,0,0,0,7,7
Hurricane,Danielle,14,1998-08-27T21:00:00Z,MYGF 266N 787W,0,0,0,6,6
Hurricane,Danielle,14,1998-08-27T21:00:00Z,CAPE HATTERAS NC,0,0,0,7,7
Hurricane,Danielle,14,1998-08-27T21:00:00Z,MIAMI FL,0,0,0,2,2
Hurricane,Danielle,14,1998-08-27T21:00:00Z,NORFOLK VA,0,0,0,3,3
Hurricane,Danielle,14,1998-08-27T21:00:00Z,W PALM BEACH FL,0,0,0,3,3
Hurricane,Danielle,15,1998-08-28T03:00:00Z,24.4N  67.7W,43,1,0,1,45
Hurricane,Danielle,15,1998-08-28T03:00:00Z,FT PIERCE FL,0,0,0,4,4
Hurricane,Danielle,15,1998-08-28T03:00:00Z,26.0N  70.5W,2,29,0,0,31
Hurricane,Danielle,15,1998-08-28T03:00:00Z,COCOA BEACH FL,0,0,0,4,4
Hurricane,Danielle,15,1998-08-28T03:00:00Z,28.0N  72.5W,0,9,13,2,24
Hurricane,Danielle,15,1998-08-28T03:00:00Z,DAYTONA BEACH FL,0,0,0,4,4
Hurricane,Danielle,15,1998-08-28T03:00:00Z,MBJT 215N 712W,0,3,0,1,4
Hurricane,Danielle,15,1998-08-28T03:00:00Z,JACKSONVILLE FL,0,0,0,3,3
Hurricane,Danielle,15,1998-08-28T03:00:00Z,MYMM 224N 730W,0,2,2,1,5
Hurricane,Danielle,15,1998-08-28T03:00:00Z,SAVANNAH GA,0,0,0,4,4
Hurricane,Danielle,15,1998-08-28T03:00:00Z,MYSM 241N 745W,0,1,7,1,9
Hurricane,Danielle,15,1998-08-28T03:00:00Z,CHARLESTON SC,0,0,0,6,6
Hurricane,Danielle,15,1998-08-28T03:00:00Z,MYEG 235N 758W,0,0,2,2,4
Hurricane,Danielle,15,1998-08-28T03:00:00Z,MYRTLE BEACH SC,0,0,0,8,8
Hurricane,Danielle,15,1998-08-28T03:00:00Z,MYAK 241N 776W,0,0,1,2,3
Hurricane,Danielle,15,1998-08-28T03:00:00Z,WILMINGTON NC,0,0,0,9,9
Hurricane,Danielle,15,1998-08-28T03:00:00Z,MYNN 251N 775W,0,0,1,4,5
Hurricane,Danielle,15,1998-08-28T03:00:00Z,MOREHEAD CITY NC,0,0,0,10,10
Hurricane,Danielle,15,1998-08-28T03:00:00Z,MYGF 266N 787W,0,0,1,5,6
Hurricane,Danielle,15,1998-08-28T03:00:00Z,CAPE HATTERAS NC,0,0,0,10,10
Hurricane,Danielle,15,1998-08-28T03:00:00Z,MIAMI FL,0,0,0,2,2
Hurricane,Danielle,15,1998-08-28T03:00:00Z,NORFOLK VA,0,0,0,6,6
Hurricane,Danielle,15,1998-08-28T03:00:00Z,W PALM BEACH FL,0,0,0,3,3
Hurricane,Danielle,15,1998-08-28T03:00:00Z,OCEAN CITY MD,0,0,0,3,3
Hurricane,Danielle,16,1998-08-28T09:00:00Z,24.7N  68.8W,40,0,0,0,40
Hurricane,Danielle,16,1998-08-28T09:00:00Z,COCOA BEACH FL,0,0,0,5,5
Hurricane,Danielle,16,1998-08-28T09:00:00Z,26.0N  71.1W,8,19,1,0,28
Hurricane,Danielle,16,1998-08-28T09:00:00Z,DAYTONA BEACH FL,0,0,0,4,4
Hurricane,Danielle,16,1998-08-28T09:00:00Z,27.5N  73.0W,0,12,9,2,23
Hurricane,Danielle,16,1998-08-28T09:00:00Z,JACKSONVILLE FL,0,0,0,3,3
Hurricane,Danielle,16,1998-08-28T09:00:00Z,MBJT 215N 712W,1,5,1,0,7
Hurricane,Danielle,16,1998-08-28T09:00:00Z,SAVANNAH GA,0,0,0,4,4
Hurricane,Danielle,16,1998-08-28T09:00:00Z,MYMM 224N 730W,0,6,2,1,9
Hurricane,Danielle,16,1998-08-28T09:00:00Z,CHARLESTON SC,0,0,0,7,7
Hurricane,Danielle,16,1998-08-28T09:00:00Z,MYSM 241N 745W,0,4,7,2,13
Hurricane,Danielle,16,1998-08-28T09:00:00Z,MYRTLE BEACH SC,0,0,0,9,9
Hurricane,Danielle,16,1998-08-28T09:00:00Z,MYEG 235N 758W,0,1,4,3,8
Hurricane,Danielle,16,1998-08-28T09:00:00Z,WILMINGTON NC,0,0,0,10,10
Hurricane,Danielle,16,1998-08-28T09:00:00Z,MYAK 241N 776W,0,0,2,4,6
Hurricane,Danielle,16,1998-08-28T09:00:00Z,MOREHEAD CITY NC,0,0,0,11,11
Hurricane,Danielle,16,1998-08-28T09:00:00Z,MYNN 251N 775W,0,0,3,5,8
Hurricane,Danielle,16,1998-08-28T09:00:00Z,CAPE HATTERAS NC,0,0,0,11,11
Hurricane,Danielle,16,1998-08-28T09:00:00Z,MYGF 266N 787W,0,0,1,7,8
Hurricane,Danielle,16,1998-08-28T09:00:00Z,NORFOLK VA,0,0,0,6,6
Hurricane,Danielle,16,1998-08-28T09:00:00Z,MIAMI FL,0,0,0,3,3
Hurricane,Danielle,16,1998-08-28T09:00:00Z,OCEAN CITY MD,0,0,0,4,4
Hurricane,Danielle,16,1998-08-28T09:00:00Z,W PALM BEACH FL,0,0,0,4,4
Hurricane,Danielle,16,1998-08-28T09:00:00Z,ATLANTIC CITY NJ,0,0,0,2,2
Hurricane,Danielle,16,1998-08-28T09:00:00Z,FT PIERCE FL,0,0,0,5,5
Hurricane,Danielle,17,1998-08-28T15:00:00Z,24.5N  69.5W,38,1,0,0,39
Hurricane,Danielle,17,1998-08-28T15:00:00Z,FT PIERCE FL,0,0,0,5,5
Hurricane,Danielle,17,1998-08-28T15:00:00Z,26.0N  71.5W,9,18,1,0,28
Hurricane,Danielle,17,1998-08-28T15:00:00Z,COCOA BEACH FL,0,0,0,5,5
Hurricane,Danielle,17,1998-08-28T15:00:00Z,27.5N  73.0W,0,15,6,2,23
Hurricane,Danielle,17,1998-08-28T15:00:00Z,DAYTONA BEACH FL,0,0,0,4,4
Hurricane,Danielle,17,1998-08-28T15:00:00Z,MBJT 215N 712W,4,5,0,0,9
Hurricane,Danielle,17,1998-08-28T15:00:00Z,JACKSONVILLE FL,0,0,0,3,3
Hurricane,Danielle,17,1998-08-28T15:00:00Z,MYMM 224N 730W,1,6,2,1,10
Hurricane,Danielle,17,1998-08-28T15:00:00Z,SAVANNAH GA,0,0,0,4,4
Hurricane,Danielle,17,1998-08-28T15:00:00Z,MYSM 241N 745W,0,6,5,2,13
Hurricane,Danielle,17,1998-08-28T15:00:00Z,CHARLESTON SC,0,0,0,7,7
Hurricane,Danielle,17,1998-08-28T15:00:00Z,MYEG 235N 758W,0,1,4,2,7
Hurricane,Danielle,17,1998-08-28T15:00:00Z,MYRTLE BEACH SC,0,0,0,8,8
Hurricane,Danielle,17,1998-08-28T15:00:00Z,MYAK 241N 776W,0,0,2,3,5
Hurricane,Danielle,17,1998-08-28T15:00:00Z,WILMINGTON NC,0,0,0,9,9
Hurricane,Danielle,17,1998-08-28T15:00:00Z,MYNN 251N 775W,0,0,3,5,8
Hurricane,Danielle,17,1998-08-28T15:00:00Z,MOREHEAD CITY NC,0,0,0,10,10
Hurricane,Danielle,17,1998-08-28T15:00:00Z,MYGF 266N 787W,0,0,1,6,7
Hurricane,Danielle,17,1998-08-28T15:00:00Z,CAPE HATTERAS NC,0,0,0,10,10
Hurricane,Danielle,17,1998-08-28T15:00:00Z,MIAMI FL,0,0,0,3,3
Hurricane,Danielle,17,1998-08-28T15:00:00Z,NORFOLK VA,0,0,0,6,6
Hurricane,Danielle,17,1998-08-28T15:00:00Z,W PALM BEACH FL,0,0,0,4,4
Hurricane,Danielle,17,1998-08-28T15:00:00Z,OCEAN CITY MD,0,0,0,3,3
Hurricane,Danielle,18,1998-08-28T21:00:00Z,25.2N  70.7W,50,0,0,0,50
Hurricane,Danielle,18,1998-08-28T21:00:00Z,DAYTONA BEACH FL,0,0,0,2,2
Hurricane,Danielle,18,1998-08-28T21:00:00Z,26.5N  73.0W,4,33,1,0,38
Hurricane,Danielle,18,1998-08-28T21:00:00Z,JACKSONVILLE FL,0,0,0,2,2
Hurricane,Danielle,18,1998-08-28T21:00:00Z,28.0N  74.0W,0,21,7,1,29
Hurricane,Danielle,18,1998-08-28T21:00:00Z,SAVANNAH GA,0,0,0,4,4
Hurricane,Danielle,18,1998-08-28T21:00:00Z,MBJT 215N 712W,1,0,0,1,2
Hurricane,Danielle,18,1998-08-28T21:00:00Z,CHARLESTON SC,0,0,0,8,8
Hurricane,Danielle,18,1998-08-28T21:00:00Z,MYMM 224N 730W,1,3,1,1,6
Hurricane,Danielle,18,1998-08-28T21:00:00Z,MYRTLE BEACH SC,0,0,0,10,10
Hurricane,Danielle,18,1998-08-28T21:00:00Z,MYSM 241N 745W,0,11,3,0,14
Hurricane,Danielle,18,1998-08-28T21:00:00Z,WILMINGTON NC,0,0,0,12,12
Hurricane,Danielle,18,1998-08-28T21:00:00Z,MYEG 235N 758W,0,1,3,1,5
Hurricane,Danielle,18,1998-08-28T21:00:00Z,MOREHEAD CITY NC,0,0,0,13,13
Hurricane,Danielle,18,1998-08-28T21:00:00Z,MYAK 241N 776W,0,0,1,1,2
Hurricane,Danielle,18,1998-08-28T21:00:00Z,CAPE HATTERAS NC,0,0,0,12,12
Hurricane,Danielle,18,1998-08-28T21:00:00Z,MYNN 251N 775W,0,0,3,2,5
Hurricane,Danielle,18,1998-08-28T21:00:00Z,NORFOLK VA,0,0,0,8,8
Hurricane,Danielle,18,1998-08-28T21:00:00Z,MYGF 266N 787W,0,0,1,4,5
Hurricane,Danielle,18,1998-08-28T21:00:00Z,OCEAN CITY MD,0,0,0,4,4
Hurricane,Danielle,18,1998-08-28T21:00:00Z,FT PIERCE FL,0,0,0,2,2
Hurricane,Danielle,18,1998-08-28T21:00:00Z,ATLANTIC CITY NJ,0,0,0,2,2
Hurricane,Danielle,18,1998-08-28T21:00:00Z,COCOA BEACH FL,0,0,0,2,2
Hurricane,Danielle,19,1998-08-29T03:00:00Z,25.8N  71.1W,48,0,0,0,48
Hurricane,Danielle,19,1998-08-29T03:00:00Z,CHARLESTON SC,0,0,0,5,5
Hurricane,Danielle,19,1998-08-29T03:00:00Z,27.4N  72.8W,7,27,0,1,35
Hurricane,Danielle,19,1998-08-29T03:00:00Z,MYRTLE BEACH SC,0,0,0,8,8
Hurricane,Danielle,19,1998-08-29T03:00:00Z,29.4N  73.5W,0,16,10,1,27
Hurricane,Danielle,19,1998-08-29T03:00:00Z,WILMINGTON NC,0,0,0,10,10
Hurricane,Danielle,19,1998-08-29T03:00:00Z,MYMM 224N 730W,1,1,0,1,3
Hurricane,Danielle,19,1998-08-29T03:00:00Z,MOREHEAD CITY NC,0,0,0,12,12
Hurricane,Danielle,19,1998-08-29T03:00:00Z,MYSM 241N 745W,0,8,1,1,10
Hurricane,Danielle,19,1998-08-29T03:00:00Z,CAPE HATTERAS NC,0,0,0,13,13
Hurricane,Danielle,19,1998-08-29T03:00:00Z,MYEG 235N 758W,0,1,1,0,2
Hurricane,Danielle,19,1998-08-29T03:00:00Z,NORFOLK VA,0,0,0,10,10
Hurricane,Danielle,19,1998-08-29T03:00:00Z,MYNN 251N 775W,0,0,1,1,2
Hurricane,Danielle,19,1998-08-29T03:00:00Z,OCEAN CITY MD,0,0,0,7,7
Hurricane,Danielle,19,1998-08-29T03:00:00Z,MYGF 266N 787W,0,0,1,1,2
Hurricane,Danielle,19,1998-08-29T03:00:00Z,ATLANTIC CITY NJ,0,0,0,4,4
Hurricane,Danielle,19,1998-08-29T03:00:00Z,BERMUDA,0,0,0,2,2
Hurricane,Danielle,19,1998-08-29T03:00:00Z,NEW YORK CITY NY,0,0,0,2,2
Hurricane,Danielle,19,1998-08-29T03:00:00Z,SAVANNAH GA,0,0,0,2,2
Hurricane,Danielle,20,1998-08-29T09:00:00Z,26.6N  72.3W,54,0,0,0,54
Hurricane,Danielle,20,1998-08-29T09:00:00Z,MOREHEAD CITY NC,0,0,3,10,13
Hurricane,Danielle,20,1998-08-29T09:00:00Z,28.3N  73.6W,18,19,1,0,38
Hurricane,Danielle,20,1998-08-29T09:00:00Z,CAPE HATTERAS NC,0,0,3,12,15
Hurricane,Danielle,20,1998-08-29T09:00:00Z,31.0N  73.7W,0,11,20,1,32
Hurricane,Danielle,20,1998-08-29T09:00:00Z,NORFOLK VA,0,0,0,11,11
Hurricane,Danielle,20,1998-08-29T09:00:00Z,MYSM 241N 745W,2,4,1,1,8
Hurricane,Danielle,20,1998-08-29T09:00:00Z,OCEAN CITY MD,0,0,0,9,9
Hurricane,Danielle,20,1998-08-29T09:00:00Z,BERMUDA,0,0,0,3,3
Hurricane,Danielle,20,1998-08-29T09:00:00Z,ATLANTIC CITY NJ,0,0,0,6,6
Hurricane,Danielle,20,1998-08-29T09:00:00Z,CHARLESTON SC,0,0,0,3,3
Hurricane,Danielle,20,1998-08-29T09:00:00Z,NEW YORK CITY NY,0,0,0,3,3
Hurricane,Danielle,20,1998-08-29T09:00:00Z,MYRTLE BEACH SC,0,0,1,6,7
Hurricane,Danielle,20,1998-08-29T09:00:00Z,MONTAUK POINT NY,0,0,0,2,2
Hurricane,Danielle,20,1998-08-29T09:00:00Z,WILMINGTON NC,0,0,2,8,10
Hurricane,Danielle,21,1998-08-29T15:00:00Z,27.0N  74.0W,51,0,0,0,51
Hurricane,Danielle,21,1998-08-29T15:00:00Z,WILMINGTON NC,0,0,1,8,9
Hurricane,Danielle,21,1998-08-29T15:00:00Z,29.0N  75.0W,7,31,0,0,38
Hurricane,Danielle,21,1998-08-29T15:00:00Z,MOREHEAD CITY NC,0,0,1,12,13
Hurricane,Danielle,21,1998-08-29T15:00:00Z,30.5N  74.5W,0,23,4,1,28
Hurricane,Danielle,21,1998-08-29T15:00:00Z,CAPE HATTERAS NC,0,0,0,14,14
Hurricane,Danielle,21,1998-08-29T15:00:00Z,MYSM 241N 745W,8,0,0,0,8
Hurricane,Danielle,21,1998-08-29T15:00:00Z,NORFOLK VA,0,0,0,9,9
Hurricane,Danielle,21,1998-08-29T15:00:00Z,MYNN 251N 775W,0,1,1,0,2
Hurricane,Danielle,21,1998-08-29T15:00:00Z,OCEAN CITY MD,0,0,0,8,8
Hurricane,Danielle,21,1998-08-29T15:00:00Z,MYGF 266N 787W,0,1,1,0,2
Hurricane,Danielle,21,1998-08-29T15:00:00Z,ATLANTIC CITY NJ,0,0,0,5,5
Hurricane,Danielle,21,1998-08-29T15:00:00Z,BERMUDA,0,0,0,8,8
Hurricane,Danielle,21,1998-08-29T15:00:00Z,NEW YORK CITY NY,0,0,0,3,3
Hurricane,Danielle,21,1998-08-29T15:00:00Z,CHARLESTON SC,0,0,0,3,3
Hurricane,Danielle,21,1998-08-29T15:00:00Z,MONTAUK POINT NY,0,0,0,2,2
Hurricane,Danielle,21,1998-08-29T15:00:00Z,MYRTLE BEACH SC,0,0,1,6,7
Hurricane,Danielle,22,1998-08-29T21:00:00Z,28.0N  75.0W,56,0,0,0,56
Hurricane,Danielle,22,1998-08-29T21:00:00Z,MOREHEAD CITY NC,0,0,5,10,15
Hurricane,Danielle,22,1998-08-29T21:00:00Z,29.5N  75.5W,28,7,1,0,36
Hurricane,Danielle,22,1998-08-29T21:00:00Z,CAPE HATTERAS NC,0,0,3,12,15
Hurricane,Danielle,22,1998-08-29T21:00:00Z,31.5N  75.0W,2,15,10,1,28
Hurricane,Danielle,22,1998-08-29T21:00:00Z,NORFOLK VA,0,0,0,11,11
Hurricane,Danielle,22,1998-08-29T21:00:00Z,MYSM 241N 745W,3,1,0,0,4
Hurricane,Danielle,22,1998-08-29T21:00:00Z,OCEAN CITY MD,0,0,0,9,9
Hurricane,Danielle,22,1998-08-29T21:00:00Z,MYNN 251N 775W,1,1,0,0,2
Hurricane,Danielle,22,1998-08-29T21:00:00Z,ATLANTIC CITY NJ,0,0,0,7,7
Hurricane,Danielle,22,1998-08-29T21:00:00Z,MYGF 266N 787W,0,3,1,0,4
Hurricane,Danielle,22,1998-08-29T21:00:00Z,NEW YORK CITY NY,0,0,0,4,4
Hurricane,Danielle,22,1998-08-29T21:00:00Z,BERMUDA,0,0,0,4,4
Hurricane,Danielle,22,1998-08-29T21:00:00Z,MONTAUK POINT NY,0,0,0,3,3
Hurricane,Danielle,22,1998-08-29T21:00:00Z,SAVANNAH GA,0,0,1,1,2
Hurricane,Danielle,22,1998-08-29T21:00:00Z,PROVIDENCE RI,0,0,0,2,2
Hurricane,Danielle,22,1998-08-29T21:00:00Z,CHARLESTON SC,0,0,2,4,6
Hurricane,Danielle,22,1998-08-29T21:00:00Z,NANTUCKET MA,0,0,0,2,2
Hurricane,Danielle,22,1998-08-29T21:00:00Z,MYRTLE BEACH SC,0,0,3,6,9
Hurricane,Danielle,22,1998-08-29T21:00:00Z,HYANNIS MA,0,0,0,2,2
Hurricane,Danielle,22,1998-08-29T21:00:00Z,WILMINGTON NC,0,0,4,8,12
Hurricane,Danielle,23,1998-08-30T03:00:00Z,28.1N  74.2W,43,0,0,0,43
Hurricane,Danielle,23,1998-08-30T03:00:00Z,MOREHEAD CITY NC,0,0,4,9,13
Hurricane,Danielle,23,1998-08-30T03:00:00Z,29.6N  74.6W,28,3,1,0,32
Hurricane,Danielle,23,1998-08-30T03:00:00Z,CAPE HATTERAS NC,0,0,2,11,13
Hurricane,Danielle,23,1998-08-30T03:00:00Z,31.3N  74.2W,8,12,2,2,24
Hurricane,Danielle,23,1998-08-30T03:00:00Z,NORFOLK VA,0,0,0,10,10
Hurricane,Danielle,23,1998-08-30T03:00:00Z,MYSM 241N 745W,1,1,0,0,2
Hurricane,Danielle,23,1998-08-30T03:00:00Z,OCEAN CITY MD,0,0,0,8,8
Hurricane,Danielle,23,1998-08-30T03:00:00Z,MYGF 266N 787W,0,1,0,1,2
Hurricane,Danielle,23,1998-08-30T03:00:00Z,ATLANTIC CITY NJ,0,0,0,6,6
Hurricane,Danielle,23,1998-08-30T03:00:00Z,BERMUDA,0,0,0,7,7
Hurricane,Danielle,23,1998-08-30T03:00:00Z,NEW YORK CITY NY,0,0,0,4,4
Hurricane,Danielle,23,1998-08-30T03:00:00Z,SAVANNAH GA,0,0,1,2,3
Hurricane,Danielle,23,1998-08-30T03:00:00Z,MONTAUK POINT NY,0,0,0,3,3
Hurricane,Danielle,23,1998-08-30T03:00:00Z,CHARLESTON SC,0,0,2,5,7
Hurricane,Danielle,23,1998-08-30T03:00:00Z,PROVIDENCE RI,0,0,0,2,2
Hurricane,Danielle,23,1998-08-30T03:00:00Z,MYRTLE BEACH SC,0,0,4,5,9
Hurricane,Danielle,23,1998-08-30T03:00:00Z,NANTUCKET MA,0,0,0,2,2
Hurricane,Danielle,23,1998-08-30T03:00:00Z,WILMINGTON NC,0,0,4,7,11
Hurricane,Danielle,23,1998-08-30T03:00:00Z,HYANNIS MA,0,0,0,2,2
Hurricane,Danielle,24,1998-08-30T09:00:00Z,28.5N  74.0W,40,0,0,0,40
Hurricane,Danielle,24,1998-08-30T09:00:00Z,NORFOLK VA,0,0,2,8,10
Hurricane,Danielle,24,1998-08-30T09:00:00Z,29.8N  74.0W,27,1,1,0,29
Hurricane,Danielle,24,1998-08-30T09:00:00Z,OCEAN CITY MD,0,0,0,9,9
Hurricane,Danielle,24,1998-08-30T09:00:00Z,31.5N  73.0W,7,6,6,3,22
Hurricane,Danielle,24,1998-08-30T09:00:00Z,ATLANTIC CITY NJ,0,0,0,8,8
Hurricane,Danielle,24,1998-08-30T09:00:00Z,MYSM 241N 745W,1,0,1,1,3
Hurricane,Danielle,24,1998-08-30T09:00:00Z,NEW YORK CITY NY,0,0,0,7,7
Hurricane,Danielle,24,1998-08-30T09:00:00Z,MYGF 266N 787W,0,1,1,0,2
Hurricane,Danielle,24,1998-08-30T09:00:00Z,MONTAUK POINT NY,0,0,0,7,7
Hurricane,Danielle,24,1998-08-30T09:00:00Z,BERMUDA,0,0,0,8,8
Hurricane,Danielle,24,1998-08-30T09:00:00Z,PROVIDENCE RI,0,0,0,6,6
Hurricane,Danielle,24,1998-08-30T09:00:00Z,CHARLESTON SC,0,0,3,1,4
Hurricane,Danielle,24,1998-08-30T09:00:00Z,NANTUCKET MA,0,0,0,6,6
Hurricane,Danielle,24,1998-08-30T09:00:00Z,MYRTLE BEACH SC,0,1,4,3,8
Hurricane,Danielle,24,1998-08-30T09:00:00Z,HYANNIS MA,0,0,0,5,5
Hurricane,Danielle,24,1998-08-30T09:00:00Z,WILMINGTON NC,0,1,5,4,10
Hurricane,Danielle,24,1998-08-30T09:00:00Z,BOSTON MA,0,0,0,4,4
Hurricane,Danielle,24,1998-08-30T09:00:00Z,MOREHEAD CITY NC,0,1,6,5,12
Hurricane,Danielle,24,1998-08-30T09:00:00Z,PORTLAND ME,0,0,0,3,3
Hurricane,Danielle,24,1998-08-30T09:00:00Z,CAPE HATTERAS NC,0,0,6,7,13
Hurricane,Danielle,25,1998-08-30T15:00:00Z,29.1N  74.2W,43,0,0,0,43
Hurricane,Danielle,25,1998-08-30T15:00:00Z,OCEAN CITY MD,0,0,1,8,9
Hurricane,Danielle,25,1998-08-30T15:00:00Z,30.5N  73.7W,23,4,1,0,28
Hurricane,Danielle,25,1998-08-30T15:00:00Z,ATLANTIC CITY NJ,0,0,0,8,8
Hurricane,Danielle,25,1998-08-30T15:00:00Z,32.5N  72.0W,1,8,11,2,22
Hurricane,Danielle,25,1998-08-30T15:00:00Z,NEW YORK CITY NY,0,0,0,7,7
Hurricane,Danielle,25,1998-08-30T15:00:00Z,BERMUDA,0,0,0,10,10
Hurricane,Danielle,25,1998-08-30T15:00:00Z,MONTAUK POINT NY,0,0,0,8,8
Hurricane,Danielle,25,1998-08-30T15:00:00Z,CHARLESTON SC,0,0,1,1,2
Hurricane,Danielle,25,1998-08-30T15:00:00Z,PROVIDENCE RI,0,0,0,7,7
Hurricane,Danielle,25,1998-08-30T15:00:00Z,MYRTLE BEACH SC,0,0,3,2,5
Hurricane,Danielle,25,1998-08-30T15:00:00Z,NANTUCKET MA,0,0,0,7,7
Hurricane,Danielle,25,1998-08-30T15:00:00Z,WILMINGTON NC,0,1,5,2,8
Hurricane,Danielle,25,1998-08-30T15:00:00Z,HYANNIS MA,0,0,0,7,7
Hurricane,Danielle,25,1998-08-30T15:00:00Z,MOREHEAD CITY NC,0,1,8,2,11
Hurricane,Danielle,25,1998-08-30T15:00:00Z,BOSTON MA,0,0,0,6,6
Hurricane,Danielle,25,1998-08-30T15:00:00Z,CAPE HATTERAS NC,0,0,9,4,13
Hurricane,Danielle,25,1998-08-30T15:00:00Z,PORTLAND ME,0,0,0,3,3
Hurricane,Danielle,25,1998-08-30T15:00:00Z,NORFOLK VA,0,0,3,6,9
Hurricane,Danielle,25,1998-08-30T15:00:00Z,BAR HARBOR ME,0,0,0,2,2
Hurricane,Danielle,26,1998-08-30T21:00:00Z,30.8N  73.5W,39,0,0,0,39
Hurricane,Danielle,26,1998-08-30T21:00:00Z,HYANNIS MA,0,0,0,8,8
Hurricane,Danielle,26,1998-08-30T21:00:00Z,32.5N  72.0W,9,17,1,0,27
Hurricane,Danielle,26,1998-08-30T21:00:00Z,BOSTON MA,0,0,0,6,6
Hurricane,Danielle,26,1998-08-30T21:00:00Z,34.5N  69.5W,0,5,12,3,20
Hurricane,Danielle,26,1998-08-30T21:00:00Z,PORTLAND ME,0,0,0,5,5
Hurricane,Danielle,26,1998-08-30T21:00:00Z,BERMUDA,0,0,2,8,10
Hurricane,Danielle,26,1998-08-30T21:00:00Z,BAR HARBOR ME,0,0,0,6,6
Hurricane,Danielle,26,1998-08-30T21:00:00Z,MYRTLE BEACH SC,0,1,1,1,3
Hurricane,Danielle,26,1998-08-30T21:00:00Z,EASTPORT ME,0,0,0,5,5
Hurricane,Danielle,26,1998-08-30T21:00:00Z,WILMINGTON NC,0,1,2,2,5
Hurricane,Danielle,26,1998-08-30T21:00:00Z,ST JOHN NB,0,0,0,5,5
Hurricane,Danielle,26,1998-08-30T21:00:00Z,MOREHEAD CITY NC,0,2,5,1,8
Hurricane,Danielle,26,1998-08-30T21:00:00Z,MONCTON NB,0,0,0,5,5
Hurricane,Danielle,26,1998-08-30T21:00:00Z,CAPE HATTERAS NC,0,2,7,2,11
Hurricane,Danielle,26,1998-08-30T21:00:00Z,YARMOUTH NS,0,0,0,7,7
Hurricane,Danielle,26,1998-08-30T21:00:00Z,NORFOLK VA,0,0,3,3,6
Hurricane,Danielle,26,1998-08-30T21:00:00Z,HALIFAX NS,0,0,0,6,6
Hurricane,Danielle,26,1998-08-30T21:00:00Z,OCEAN CITY MD,0,0,2,5,7
Hurricane,Danielle,26,1998-08-30T21:00:00Z,SABLE ISLAND NS,0,0,0,5,5
Hurricane,Danielle,26,1998-08-30T21:00:00Z,ATLANTIC CITY NJ,0,0,1,5,6
Hurricane,Danielle,26,1998-08-30T21:00:00Z,SYDNEY NS,0,0,0,3,3
Hurricane,Danielle,26,1998-08-30T21:00:00Z,NEW YORK CITY NY,0,0,0,6,6
Hurricane,Danielle,26,1998-08-30T21:00:00Z,EDDY POINT NS,0,0,0,4,4
Hurricane,Danielle,26,1998-08-30T21:00:00Z,MONTAUK POINT NY,0,0,0,7,7
Hurricane,Danielle,26,1998-08-30T21:00:00Z,PTX BASQUES NFLD,0,0,0,2,2
Hurricane,Danielle,26,1998-08-30T21:00:00Z,PROVIDENCE RI,0,0,0,7,7
Hurricane,Danielle,26,1998-08-30T21:00:00Z,BURGEO NFLD,0,0,0,2,2
Hurricane,Danielle,26,1998-08-30T21:00:00Z,NANTUCKET MA,0,0,0,9,9
Hurricane,Danielle,27,1998-08-31T03:00:00Z,30.9N  73.6W,36,1,0,0,37
Hurricane,Danielle,27,1998-08-31T03:00:00Z,HYANNIS MA,0,0,0,7,7
Hurricane,Danielle,27,1998-08-31T03:00:00Z,32.5N  72.0W,7,19,2,1,29
Hurricane,Danielle,27,1998-08-31T03:00:00Z,BOSTON MA,0,0,0,5,5
Hurricane,Danielle,27,1998-08-31T03:00:00Z,34.5N  69.0W,0,3,15,2,20
Hurricane,Danielle,27,1998-08-31T03:00:00Z,PORTLAND ME,0,0,0,4,4
Hurricane,Danielle,27,1998-08-31T03:00:00Z,BERMUDA,0,0,4,7,11
Hurricane,Danielle,27,1998-08-31T03:00:00Z,BAR HARBOR ME,0,0,0,5,5
Hurricane,Danielle,27,1998-08-31T03:00:00Z,MYRTLE BEACH SC,0,1,1,1,3
Hurricane,Danielle,27,1998-08-31T03:00:00Z,EASTPORT ME,0,0,0,5,5
Hurricane,Danielle,27,1998-08-31T03:00:00Z,WILMINGTON NC,0,1,2,2,5
Hurricane,Danielle,27,1998-08-31T03:00:00Z,ST JOHN NB,0,0,0,5,5
Hurricane,Danielle,27,1998-08-31T03:00:00Z,MOREHEAD CITY NC,0,1,5,2,8
Hurricane,Danielle,27,1998-08-31T03:00:00Z,MONCTON NB,0,0,0,5,5
Hurricane,Danielle,27,1998-08-31T03:00:00Z,CAPE HATTERAS NC,0,1,6,2,9
Hurricane,Danielle,27,1998-08-31T03:00:00Z,YARMOUTH NS,0,0,0,7,7
Hurricane,Danielle,27,1998-08-31T03:00:00Z,NORFOLK VA,0,0,1,4,5
Hurricane,Danielle,27,1998-08-31T03:00:00Z,HALIFAX NS,0,0,0,7,7
Hurricane,Danielle,27,1998-08-31T03:00:00Z,OCEAN CITY MD,0,0,1,4,5
Hurricane,Danielle,27,1998-08-31T03:00:00Z,SABLE ISLAND NS,0,0,0,7,7
Hurricane,Danielle,27,1998-08-31T03:00:00Z,ATLANTIC CITY NJ,0,0,0,4,4
Hurricane,Danielle,27,1998-08-31T03:00:00Z,SYDNEY NS,0,0,0,5,5
Hurricane,Danielle,27,1998-08-31T03:00:00Z,NEW YORK CITY NY,0,0,0,4,4
Hurricane,Danielle,27,1998-08-31T03:00:00Z,EDDY POINT NS,0,0,0,5,5
Hurricane,Danielle,27,1998-08-31T03:00:00Z,MONTAUK POINT NY,0,0,0,6,6
Hurricane,Danielle,27,1998-08-31T03:00:00Z,PTX BASQUES NFLD,0,0,0,3,3
Hurricane,Danielle,27,1998-08-31T03:00:00Z,PROVIDENCE RI,0,0,0,5,5
Hurricane,Danielle,27,1998-08-31T03:00:00Z,BURGEO NFLD,0,0,0,3,3
Hurricane,Danielle,27,1998-08-31T03:00:00Z,NANTUCKET MA,0,0,0,7,7
Hurricane,Danielle,27,1998-08-31T03:00:00Z,ILE ST PIERRE,0,0,0,3,3
Hurricane,Danielle,28,1998-08-31T09:00:00Z,31.3N  73.5W,36,0,0,0,36
Hurricane,Danielle,28,1998-08-31T09:00:00Z,HYANNIS MA,0,0,2,6,8
Hurricane,Danielle,28,1998-08-31T09:00:00Z,32.6N  71.8W,6,9,2,1,18
Hurricane,Danielle,28,1998-08-31T09:00:00Z,BOSTON MA,0,0,2,4,6
Hurricane,Danielle,28,1998-08-31T09:00:00Z,35.0N  68.2W,0,2,9,4,15
Hurricane,Danielle,28,1998-08-31T09:00:00Z,PORTLAND ME,0,0,1,4,5
Hurricane,Danielle,28,1998-08-31T09:00:00Z,BERMUDA,0,0,4,7,11
Hurricane,Danielle,28,1998-08-31T09:00:00Z,BAR HARBOR ME,0,0,1,4,5
Hurricane,Danielle,28,1998-08-31T09:00:00Z,CHARLESTON SC,0,1,1,0,2
Hurricane,Danielle,28,1998-08-31T09:00:00Z,EASTPORT ME,0,0,0,6,6
Hurricane,Danielle,28,1998-08-31T09:00:00Z,MYRTLE BEACH SC,0,3,1,1,5
Hurricane,Danielle,28,1998-08-31T09:00:00Z,ST JOHN NB,0,0,0,6,6
Hurricane,Danielle,28,1998-08-31T09:00:00Z,WILMINGTON NC,0,5,2,0,7
Hurricane,Danielle,28,1998-08-31T09:00:00Z,MONCTON NB,0,0,0,5,5
Hurricane,Danielle,28,1998-08-31T09:00:00Z,MOREHEAD CITY NC,1,6,3,0,10
Hurricane,Danielle,28,1998-08-31T09:00:00Z,YARMOUTH NS,0,0,1,7,8
Hurricane,Danielle,28,1998-08-31T09:00:00Z,CAPE HATTERAS NC,1,7,3,1,12
Hurricane,Danielle,28,1998-08-31T09:00:00Z,HALIFAX NS,0,0,0,8,8
Hurricane,Danielle,28,1998-08-31T09:00:00Z,NORFOLK VA,0,3,4,1,8
Hurricane,Danielle,28,1998-08-31T09:00:00Z,SABLE ISLAND NS,0,0,0,10,10
Hurricane,Danielle,28,1998-08-31T09:00:00Z,OCEAN CITY MD,0,2,4,1,7
Hurricane,Danielle,28,1998-08-31T09:00:00Z,SYDNEY NS,0,0,0,7,7
Hurricane,Danielle,28,1998-08-31T09:00:00Z,ATLANTIC CITY NJ,0,1,3,2,6
Hurricane,Danielle,28,1998-08-31T09:00:00Z,EDDY POINT NS,0,0,0,7,7
Hurricane,Danielle,28,1998-08-31T09:00:00Z,NEW YORK CITY NY,0,0,3,2,5
Hurricane,Danielle,28,1998-08-31T09:00:00Z,PTX BASQUES NFLD,0,0,0,5,5
Hurricane,Danielle,28,1998-08-31T09:00:00Z,MONTAUK POINT NY,0,0,3,4,7
Hurricane,Danielle,28,1998-08-31T09:00:00Z,BURGEO NFLD,0,0,0,5,5
Hurricane,Danielle,28,1998-08-31T09:00:00Z,PROVIDENCE RI,0,0,2,5,7
Hurricane,Danielle,28,1998-08-31T09:00:00Z,ILE ST PIERRE,0,0,0,5,5
Hurricane,Danielle,28,1998-08-31T09:00:00Z,NANTUCKET MA,0,0,3,5,8
Hurricane,Danielle,28,1998-08-31T09:00:00Z,CAPE RACE NFLD,0,0,0,4,4
Hurricane,Danielle,29,1998-08-31T15:00:00Z,32.5N  72.0W,33,0,0,0,33
Hurricane,Danielle,29,1998-08-31T15:00:00Z,PORTLAND ME,0,0,2,2,4
Hurricane,Danielle,29,1998-08-31T15:00:00Z,34.5N  69.0W,1,15,1,1,18
Hurricane,Danielle,29,1998-08-31T15:00:00Z,BAR HARBOR ME,0,0,1,4,5
Hurricane,Danielle,29,1998-08-31T15:00:00Z,36.5N  65.5W,0,3,8,3,14
Hurricane,Danielle,29,1998-08-31T15:00:00Z,EASTPORT ME,0,0,1,4,5
Hurricane,Danielle,29,1998-08-31T15:00:00Z,BERMUDA,0,2,6,3,11
Hurricane,Danielle,29,1998-08-31T15:00:00Z,ST JOHN NB,0,0,1,4,5
Hurricane,Danielle,29,1998-08-31T15:00:00Z,MOREHEAD CITY NC,0,2,1,1,4
Hurricane,Danielle,29,1998-08-31T15:00:00Z,MONCTON NB,0,0,1,4,5
Hurricane,Danielle,29,1998-08-31T15:00:00Z,CAPE HATTERAS NC,1,5,1,0,7
Hurricane,Danielle,29,1998-08-31T15:00:00Z,YARMOUTH NS,0,0,2,5,7
Hurricane,Danielle,29,1998-08-31T15:00:00Z,NORFOLK VA,0,2,1,1,4
Hurricane,Danielle,29,1998-08-31T15:00:00Z,HALIFAX NS,0,0,1,7,8
Hurricane,Danielle,29,1998-08-31T15:00:00Z,OCEAN CITY MD,0,2,2,1,5
Hurricane,Danielle,29,1998-08-31T15:00:00Z,SABLE ISLAND NS,0,0,1,8,9
Hurricane,Danielle,29,1998-08-31T15:00:00Z,ATLANTIC CITY NJ,0,1,2,1,4
Hurricane,Danielle,29,1998-08-31T15:00:00Z,SYDNEY NS,0,0,0,7,7
Hurricane,Danielle,29,1998-08-31T15:00:00Z,NEW YORK CITY NY,0,1,2,1,4
Hurricane,Danielle,29,1998-08-31T15:00:00Z,EDDY POINT NS,0,0,0,7,7
Hurricane,Danielle,29,1998-08-31T15:00:00Z,MONTAUK POINT NY,0,1,3,2,6
Hurricane,Danielle,29,1998-08-31T15:00:00Z,PTX BASQUES NFLD,0,0,0,6,6
Hurricane,Danielle,29,1998-08-31T15:00:00Z,PROVIDENCE RI,0,0,4,2,6
Hurricane,Danielle,29,1998-08-31T15:00:00Z,BURGEO NFLD,0,0,0,6,6
Hurricane,Danielle,29,1998-08-31T15:00:00Z,NANTUCKET MA,0,1,4,3,8
Hurricane,Danielle,29,1998-08-31T15:00:00Z,ILE ST PIERRE,0,0,0,7,7
Hurricane,Danielle,29,1998-08-31T15:00:00Z,HYANNIS MA,0,1,3,3,7
Hurricane,Danielle,29,1998-08-31T15:00:00Z,CAPE RACE NFLD,0,0,0,6,6
Hurricane,Danielle,29,1998-08-31T15:00:00Z,BOSTON MA,0,0,3,2,5
Hurricane,Danielle,29,1998-08-31T15:00:00Z,HIBERNIA OILFLD,0,0,0,3,3
Hurricane,Danielle,30,1998-08-31T21:00:00Z,33.7N  70.0W,32,1,0,0,33
Hurricane,Danielle,30,1998-08-31T21:00:00Z,ST JOHN NB,0,0,1,3,4
Hurricane,Danielle,30,1998-08-31T21:00:00Z,35.7N  66.4W,0,14,3,0,17
Hurricane,Danielle,30,1998-08-31T21:00:00Z,MONCTON NB,0,0,1,3,4
Hurricane,Danielle,30,1998-08-31T21:00:00Z,38.0N  62.0W,0,1,8,4,13
Hurricane,Danielle,30,1998-08-31T21:00:00Z,YARMOUTH NS,0,0,3,3,6
Hurricane,Danielle,30,1998-08-31T21:00:00Z,BERMUDA,0,6,5,1,12
Hurricane,Danielle,30,1998-08-31T21:00:00Z,HALIFAX NS,0,0,2,5,7
Hurricane,Danielle,30,1998-08-31T21:00:00Z,MONTAUK POINT NY,0,1,1,1,3
Hurricane,Danielle,30,1998-08-31T21:00:00Z,SABLE ISLAND NS,0,0,2,7,9
Hurricane,Danielle,30,1998-08-31T21:00:00Z,PROVIDENCE RI,0,1,1,1,3
Hurricane,Danielle,30,1998-08-31T21:00:00Z,SYDNEY NS,0,0,1,6,7
Hurricane,Danielle,30,1998-08-31T21:00:00Z,NANTUCKET MA,0,1,3,1,5
Hurricane,Danielle,30,1998-08-31T21:00:00Z,EDDY POINT NS,0,0,1,6,7
Hurricane,Danielle,30,1998-08-31T21:00:00Z,HYANNIS MA,0,1,2,1,4
Hurricane,Danielle,30,1998-08-31T21:00:00Z,PTX BASQUES NFLD,0,0,0,6,6
Hurricane,Danielle,30,1998-08-31T21:00:00Z,BOSTON MA,0,0,2,1,3
Hurricane,Danielle,30,1998-08-31T21:00:00Z,BURGEO NFLD,0,0,0,6,6
Hurricane,Danielle,30,1998-08-31T21:00:00Z,PORTLAND ME,0,0,1,1,2
Hurricane,Danielle,30,1998-08-31T21:00:00Z,ILE ST PIERRE,0,0,0,7,7
Hurricane,Danielle,30,1998-08-31T21:00:00Z,BAR HARBOR ME,0,0,2,1,3
Hurricane,Danielle,30,1998-08-31T21:00:00Z,CAPE RACE NFLD,0,0,0,7,7
Hurricane,Danielle,30,1998-08-31T21:00:00Z,EASTPORT ME,0,0,2,2,4
Hurricane,Danielle,30,1998-08-31T21:00:00Z,HIBERNIA OILFLD,0,0,0,5,5
Hurricane,Danielle,31,1998-09-01T03:00:00Z,34.7N  68.5W,29,5,0,0,34
Hurricane,Danielle,31,1998-09-01T03:00:00Z,SABLE ISLAND NS,0,0,4,5,9
Hurricane,Danielle,31,1998-09-01T03:00:00Z,37.0N  64.5W,0,15,3,1,19
Hurricane,Danielle,31,1998-09-01T03:00:00Z,SYDNEY NS,0,0,2,4,6
Hurricane,Danielle,31,1998-09-01T03:00:00Z,39.5N  59.5W,0,1,9,3,13
Hurricane,Danielle,31,1998-09-01T03:00:00Z,EDDY POINT NS,0,0,2,4,6
Hurricane,Danielle,31,1998-09-01T03:00:00Z,BERMUDA,0,9,3,0,12
Hurricane,Danielle,31,1998-09-01T03:00:00Z,PTX BASQUES NFLD,0,0,1,4,5
Hurricane,Danielle,31,1998-09-01T03:00:00Z,ST JOHN NB,0,0,1,1,2
Hurricane,Danielle,31,1998-09-01T03:00:00Z,BURGEO NFLD,0,0,1,5,6
Hurricane,Danielle,31,1998-09-01T03:00:00Z,MONCTON NB,0,0,1,1,2
Hurricane,Danielle,31,1998-09-01T03:00:00Z,ILE ST PIERRE,0,0,1,6,7
Hurricane,Danielle,31,1998-09-01T03:00:00Z,YARMOUTH NS,0,0,2,1,3
Hurricane,Danielle,31,1998-09-01T03:00:00Z,CAPE RACE NFLD,0,0,0,8,8
Hurricane,Danielle,31,1998-09-01T03:00:00Z,HALIFAX NS,0,0,3,2,5
Hurricane,Danielle,31,1998-09-01T03:00:00Z,HIBERNIA OILFLD,0,0,0,6,6
Hurricane,Danielle,32,1998-09-01T09:00:00Z,35.3N  68.0W,22,9,0,0,31
Hurricane,Danielle,32,1998-09-01T09:00:00Z,SABLE ISLAND NS,0,0,5,4,9
Hurricane,Danielle,32,1998-09-01T09:00:00Z,38.0N  63.0W,0,12,6,1,19
Hurricane,Danielle,32,1998-09-01T09:00:00Z,SYDNEY NS,0,0,2,4,6
Hurricane,Danielle,32,1998-09-01T09:00:00Z,41.0N  57.5W,0,0,9,3,12
Hurricane,Danielle,32,1998-09-01T09:00:00Z,EDDY POINT NS,0,0,3,3,6
Hurricane,Danielle,32,1998-09-01T09:00:00Z,BERMUDA,1,9,1,0,11
Hurricane,Danielle,32,1998-09-01T09:00:00Z,PTX BASQUES NFLD,0,0,1,4,5
Hurricane,Danielle,32,1998-09-01T09:00:00Z,ST JOHN NB,0,0,1,1,2
Hurricane,Danielle,32,1998-09-01T09:00:00Z,BURGEO NFLD,0,0,1,5,6
Hurricane,Danielle,32,1998-09-01T09:00:00Z,MONCTON NB,0,0,1,1,2
Hurricane,Danielle,32,1998-09-01T09:00:00Z,ILE ST PIERRE,0,0,1,6,7
Hurricane,Danielle,32,1998-09-01T09:00:00Z,YARMOUTH NS,0,0,3,0,3
Hurricane,Danielle,32,1998-09-01T09:00:00Z,CAPE RACE NFLD,0,0,0,8,8
Hurricane,Danielle,32,1998-09-01T09:00:00Z,HALIFAX NS,0,0,3,2,5
Hurricane,Danielle,32,1998-09-01T09:00:00Z,HIBERNIA OILFLD,0,0,0,7,7
Hurricane,Danielle,33,1998-09-01T15:00:00Z,35.3N  65.6W,27,6,0,0,33
Hurricane,Danielle,33,1998-09-01T15:00:00Z,SABLE ISLAND NS,0,1,6,2,9
Hurricane,Danielle,33,1998-09-01T15:00:00Z,38.8N  60.5W,0,13,3,1,17
Hurricane,Danielle,33,1998-09-01T15:00:00Z,SYDNEY NS,0,0,3,3,6
Hurricane,Danielle,33,1998-09-01T15:00:00Z,41.3N  54.9W,0,1,8,3,12
Hurricane,Danielle,33,1998-09-01T15:00:00Z,EDDY POINT NS,0,0,3,3,6
Hurricane,Danielle,33,1998-09-01T15:00:00Z,BERMUDA,21,4,0,0,25
Hurricane,Danielle,33,1998-09-01T15:00:00Z,PTX BASQUES NFLD,0,0,1,4,5
Hurricane,Danielle,33,1998-09-01T15:00:00Z,ST JOHN NB,0,0,1,1,2
Hurricane,Danielle,33,1998-09-01T15:00:00Z,BURGEO NFLD,0,0,2,4,6
Hurricane,Danielle,33,1998-09-01T15:00:00Z,MONCTON NB,0,0,1,1,2
Hurricane,Danielle,33,1998-09-01T15:00:00Z,ILE ST PIERRE,0,0,2,5,7
Hurricane,Danielle,33,1998-09-01T15:00:00Z,YARMOUTH NS,0,1,1,1,3
Hurricane,Danielle,33,1998-09-01T15:00:00Z,CAPE RACE NFLD,0,0,2,7,9
Hurricane,Danielle,33,1998-09-01T15:00:00Z,HALIFAX NS,0,1,2,2,5
Hurricane,Danielle,33,1998-09-01T15:00:00Z,HIBERNIA OILFLD,0,0,0,9,9
Hurricane,Danielle,34,1998-09-01T21:00:00Z,37.2N  63.5W,20,11,0,0,31
Hurricane,Danielle,34,1998-09-01T21:00:00Z,SABLE ISLAND NS,0,6,7,1,14
Hurricane,Danielle,34,1998-09-01T21:00:00Z,40.9N  58.1W,0,13,5,1,19
Hurricane,Danielle,34,1998-09-01T21:00:00Z,SYDNEY NS,0,1,7,2,10
Hurricane,Danielle,34,1998-09-01T21:00:00Z,43.7N  52.6W,0,0,11,3,14
Hurricane,Danielle,34,1998-09-01T21:00:00Z,EDDY POINT NS,0,2,7,1,10
Hurricane,Danielle,34,1998-09-01T21:00:00Z,BERMUDA,12,1,0,0,13
Hurricane,Danielle,34,1998-09-01T21:00:00Z,PTX BASQUES NFLD,0,0,6,2,8
Hurricane,Danielle,34,1998-09-01T21:00:00Z,EASTPORT ME,0,1,1,0,2
Hurricane,Danielle,34,1998-09-01T21:00:00Z,BURGEO NFLD,0,0,6,3,9
Hurricane,Danielle,34,1998-09-01T21:00:00Z,ST JOHN NB,0,1,2,0,3
Hurricane,Danielle,34,1998-09-01T21:00:00Z,ILE ST PIERRE,0,0,8,3,11
Hurricane,Danielle,34,1998-09-01T21:00:00Z,MONCTON NB,0,1,3,0,4
Hurricane,Danielle,34,1998-09-01T21:00:00Z,CAPE RACE NFLD,0,0,6,5,11
Hurricane,Danielle,34,1998-09-01T21:00:00Z,YARMOUTH NS,0,2,2,0,4
Hurricane,Danielle,34,1998-09-01T21:00:00Z,HIBERNIA OILFLD,0,0,2,9,11
Hurricane,Danielle,34,1998-09-01T21:00:00Z,HALIFAX NS,0,3,5,0,8
Hurricane,Danielle,35,1998-09-02T03:00:00Z,36.8N  62.9W,21,5,0,0,26
Hurricane,Danielle,35,1998-09-02T03:00:00Z,SABLE ISLAND NS,0,2,7,1,10
Hurricane,Danielle,35,1998-09-02T03:00:00Z,39.1N  59.1W,0,14,5,0,19
Hurricane,Danielle,35,1998-09-02T03:00:00Z,SYDNEY NS,0,0,4,2,6
Hurricane,Danielle,35,1998-09-02T03:00:00Z,41.5N  53.0W,0,0,10,4,14
Hurricane,Danielle,35,1998-09-02T03:00:00Z,EDDY POINT NS,0,1,4,1,6
Hurricane,Danielle,35,1998-09-02T03:00:00Z,BERMUDA,16,1,0,0,17
Hurricane,Danielle,35,1998-09-02T03:00:00Z,PTX BASQUES NFLD,0,0,2,2,4
Hurricane,Danielle,35,1998-09-02T03:00:00Z,ST JOHN NB,0,0,2,0,2
Hurricane,Danielle,35,1998-09-02T03:00:00Z,BURGEO NFLD,0,0,2,3,5
Hurricane,Danielle,35,1998-09-02T03:00:00Z,MONCTON NB,0,0,2,0,2
Hurricane,Danielle,35,1998-09-02T03:00:00Z,ILE ST PIERRE,0,0,3,4,7
Hurricane,Danielle,35,1998-09-02T03:00:00Z,YARMOUTH NS,0,1,2,0,3
Hurricane,Danielle,35,1998-09-02T03:00:00Z,CAPE RACE NFLD,0,0,2,6,8
Hurricane,Danielle,35,1998-09-02T03:00:00Z,HALIFAX NS,0,1,4,0,5
Hurricane,Danielle,35,1998-09-02T03:00:00Z,HIBERNIA OILFLD,0,0,1,7,8
Hurricane,Danielle,37,1998-09-02T15:00:00Z,42.5N  54.4W,15,6,0,0,21
Hurricane,Danielle,37,1998-09-02T15:00:00Z,BURGEO NFLD,1,2,0,0,3
Hurricane,Danielle,37,1998-09-02T15:00:00Z,44.9N  46.3W,0,10,3,0,13
Hurricane,Danielle,37,1998-09-02T15:00:00Z,ILE ST PIERRE,2,3,0,0,5
Hurricane,Danielle,37,1998-09-02T15:00:00Z,45.8N  38.1W,0,0,7,3,10
Hurricane,Danielle,37,1998-09-02T15:00:00Z,CAPE RACE NFLD,0,9,1,0,10
Hurricane,Danielle,37,1998-09-02T15:00:00Z,SABLE ISLAND NS,5,0,0,0,5
Hurricane,Danielle,37,1998-09-02T15:00:00Z,HIBERNIA OILFLD,0,9,2,1,12
Hurricane,Danielle,37,1998-09-02T15:00:00Z,SYDNEY NS,1,1,0,0,2
Hurricane,Danielle,38,1998-09-02T21:00:00Z,44.7N  52.2W,17,6,0,0,23
Hurricane,Danielle,38,1998-09-02T21:00:00Z,PTX BASQUES NFLD,1,1,0,0,2
Hurricane,Danielle,38,1998-09-02T21:00:00Z,46.4N  44.0W,0,11,3,0,14
Hurricane,Danielle,38,1998-09-02T21:00:00Z,BURGEO NFLD,3,1,0,0,4
Hurricane,Danielle,38,1998-09-02T21:00:00Z,46.8N  35.3W,0,0,8,3,11
Hurricane,Danielle,38,1998-09-02T21:00:00Z,ILE ST PIERRE,8,2,0,0,10
Hurricane,Danielle,38,1998-09-02T21:00:00Z,SABLE ISLAND NS,8,0,0,0,8
Hurricane,Danielle,38,1998-09-02T21:00:00Z,CAPE RACE NFLD,8,8,0,0,16
Hurricane,Danielle,38,1998-09-02T21:00:00Z,SYDNEY NS,2,0,0,0,2
Hurricane,Danielle,38,1998-09-02T21:00:00Z,HIBERNIA OILFLD,0,15,0,0,15
Hurricane,Danielle,39,1998-09-03T03:00:00Z,46.5N  43.3W,22,5,0,0,27
Hurricane,Danielle,39,1998-09-03T03:00:00Z,CAPE RACE NFLD,7,0,0,0,7
Hurricane,Danielle,39,1998-09-03T03:00:00Z,46.5N  34.0W,0,15,0,0,15
Hurricane,Danielle,39,1998-09-03T03:00:00Z,HIBERNIA OILFLD,20,1,0,0,21
Hurricane,Danielle,40,1998-09-03T09:00:00Z,45.7N  43.8W,19,3,0,0,22
Hurricane,Danielle,40,1998-09-03T09:00:00Z,46.5N  30.0W,0,2,8,0,10
Hurricane,Danielle,40,1998-09-03T09:00:00Z,46.2N  36.8W,0,13,3,0,16
Hurricane,Danielle,40,1998-09-03T09:00:00Z,HIBERNIA OILFLD,14,1,1,0,16
Hurricane,Danielle,41,1998-09-03T15:00:00Z,45.7N  41.5W,20,6,0,0,26
Hurricane,Danielle,41,1998-09-03T15:00:00Z,47.8N  23.9W,0,0,11,3,14
Hurricane,Danielle,41,1998-09-03T15:00:00Z,46.3N  32.8W,0,14,4,0,18
Hurricane,Danielle,41,1998-09-03T15:00:00Z,HIBERNIA OILFLD,7,0,0,0,7
Tropical Storm,Earl,1,1998-08-31T21:00:00Z,25.0N  93.5W,37,0,0,0,37
Tropical Storm,Earl,1,1998-08-31T21:00:00Z,APALACHICOLA FL,0,0,0,11,11
Tropical Storm,Earl,1,1998-08-31T21:00:00Z,26.5N  92.0W,10,18,1,0,29
Tropical Storm,Earl,1,1998-08-31T21:00:00Z,PANAMA CITY FL,0,0,1,11,12
Tropical Storm,Earl,1,1998-08-31T21:00:00Z,28.5N  90.0W,0,4,16,2,22
Tropical Storm,Earl,1,1998-08-31T21:00:00Z,PENSACOLA FL,0,0,3,12,15
Tropical Storm,Earl,1,1998-08-31T21:00:00Z,MUAN 219N 850W,0,0,0,2,2
Tropical Storm,Earl,1,1998-08-31T21:00:00Z,MOBILE AL,0,0,7,9,16
Tropical Storm,Earl,1,1998-08-31T21:00:00Z,MMCZ 205N 869W,0,0,0,2,2
Tropical Storm,Earl,1,1998-08-31T21:00:00Z,GULFPORT MS,0,0,11,7,18
Tropical Storm,Earl,1,1998-08-31T21:00:00Z,MMMD 210N 897W,0,1,0,2,3
Tropical Storm,Earl,1,1998-08-31T21:00:00Z,BURAS LA,0,1,16,3,20
Tropical Storm,Earl,1,1998-08-31T21:00:00Z,W PALM BEACH FL,0,0,0,2,2
Tropical Storm,Earl,1,1998-08-31T21:00:00Z,NEW ORLEANS LA,0,1,16,3,20
Tropical Storm,Earl,1,1998-08-31T21:00:00Z,FT PIERCE FL,0,0,0,2,2
Tropical Storm,Earl,1,1998-08-31T21:00:00Z,NEW IBERIA LA,0,5,14,2,21
Tropical Storm,Earl,1,1998-08-31T21:00:00Z,COCOA BEACH FL,0,0,0,3,3
Tropical Storm,Earl,1,1998-08-31T21:00:00Z,PORT ARTHUR TX,0,6,8,1,15
Tropical Storm,Earl,1,1998-08-31T21:00:00Z,DAYTONA BEACH FL,0,0,0,4,4
Tropical Storm,Earl,1,1998-08-31T21:00:00Z,GALVESTON TX,0,8,4,1,13
Tropical Storm,Earl,1,1998-08-31T21:00:00Z,JACKSONVILLE FL,0,0,0,5,5
Tropical Storm,Earl,1,1998-08-31T21:00:00Z,FREEPORT TX,1,5,3,1,10
Tropical Storm,Earl,1,1998-08-31T21:00:00Z,SAVANNAH GA,0,0,0,4,4
Tropical Storm,Earl,1,1998-08-31T21:00:00Z,PORT O CONNOR TX,1,2,1,1,5
Tropical Storm,Earl,1,1998-08-31T21:00:00Z,CHARLESTON SC,0,0,0,2,2
Tropical Storm,Earl,1,1998-08-31T21:00:00Z,GULF 29N 85W,0,0,0,11,11
Tropical Storm,Earl,1,1998-08-31T21:00:00Z,KEY WEST FL,0,0,0,2,2
Tropical Storm,Earl,1,1998-08-31T21:00:00Z,GULF 29N 87W,0,0,4,11,15
Tropical Storm,Earl,1,1998-08-31T21:00:00Z,MARCO ISLAND FL,0,0,0,3,3
Tropical Storm,Earl,1,1998-08-31T21:00:00Z,GULF 28N 89W,0,1,15,3,19
Tropical Storm,Earl,1,1998-08-31T21:00:00Z,FT MYERS FL,0,0,0,3,3
Tropical Storm,Earl,1,1998-08-31T21:00:00Z,GULF 28N 91W,0,14,11,1,26
Tropical Storm,Earl,1,1998-08-31T21:00:00Z,VENICE FL,0,0,0,5,5
Tropical Storm,Earl,1,1998-08-31T21:00:00Z,GULF 28N 93W,3,19,3,0,25
Tropical Storm,Earl,1,1998-08-31T21:00:00Z,TAMPA FL,0,0,0,5,5
Tropical Storm,Earl,1,1998-08-31T21:00:00Z,GULF 28N 95W,3,11,1,1,16
Tropical Storm,Earl,1,1998-08-31T21:00:00Z,CEDAR KEY FL,0,0,0,7,7
Tropical Storm,Earl,1,1998-08-31T21:00:00Z,GULF 27N 96W,4,5,1,0,10
Tropical Storm,Earl,1,1998-08-31T21:00:00Z,ST MARKS FL,0,0,0,9,9
Tropical Storm,Earl,1,1998-08-31T21:00:00Z,GULF 25N 96W,11,1,0,1,13
Tropical Storm,Earl,2,1998-09-01T03:00:00Z,24.5N  93.6W,40,0,0,0,40
Tropical Storm,Earl,2,1998-09-01T03:00:00Z,ST MARKS FL,0,0,0,11,11
Tropical Storm,Earl,2,1998-09-01T03:00:00Z,26.5N  92.0W,8,23,0,0,31
Tropical Storm,Earl,2,1998-09-01T03:00:00Z,APALACHICOLA FL,0,0,1,11,12
Tropical Storm,Earl,2,1998-09-01T03:00:00Z,28.5N  90.0W,0,5,15,2,22
Tropical Storm,Earl,2,1998-09-01T03:00:00Z,PANAMA CITY FL,0,0,2,11,13
Tropical Storm,Earl,2,1998-09-01T03:00:00Z,MUHA 230N 824W,0,0,0,2,2
Tropical Storm,Earl,2,1998-09-01T03:00:00Z,PENSACOLA FL,0,0,4,11,15
Tropical Storm,Earl,2,1998-09-01T03:00:00Z,MUAN 219N 850W,0,0,0,2,2
Tropical Storm,Earl,2,1998-09-01T03:00:00Z,MOBILE AL,0,0,7,9,16
Tropical Storm,Earl,2,1998-09-01T03:00:00Z,MYGF 266N 787W,0,0,0,2,2
Tropical Storm,Earl,2,1998-09-01T03:00:00Z,GULFPORT MS,0,0,11,7,18
Tropical Storm,Earl,2,1998-09-01T03:00:00Z,MMMD 210N 897W,0,0,1,1,2
Tropical Storm,Earl,2,1998-09-01T03:00:00Z,BURAS LA,0,1,16,3,20
Tropical Storm,Earl,2,1998-09-01T03:00:00Z,MARATHON FL,0,0,0,3,3
Tropical Storm,Earl,2,1998-09-01T03:00:00Z,NEW ORLEANS LA,0,1,15,3,19
Tropical Storm,Earl,2,1998-09-01T03:00:00Z,MIAMI FL,0,0,0,3,3
Tropical Storm,Earl,2,1998-09-01T03:00:00Z,NEW IBERIA LA,0,4,13,2,19
Tropical Storm,Earl,2,1998-09-01T03:00:00Z,W PALM BEACH FL,0,0,0,3,3
Tropical Storm,Earl,2,1998-09-01T03:00:00Z,PORT ARTHUR TX,0,4,9,1,14
Tropical Storm,Earl,2,1998-09-01T03:00:00Z,FT PIERCE FL,0,0,0,4,4
Tropical Storm,Earl,2,1998-09-01T03:00:00Z,GALVESTON TX,0,6,6,1,13
Tropical Storm,Earl,2,1998-09-01T03:00:00Z,COCOA BEACH FL,0,0,0,5,5
Tropical Storm,Earl,2,1998-09-01T03:00:00Z,FREEPORT TX,0,5,5,1,11
Tropical Storm,Earl,2,1998-09-01T03:00:00Z,DAYTONA BEACH FL,0,0,0,6,6
Tropical Storm,Earl,2,1998-09-01T03:00:00Z,PORT O CONNOR TX,0,3,2,1,6
Tropical Storm,Earl,2,1998-09-01T03:00:00Z,JACKSONVILLE FL,0,0,0,7,7
Tropical Storm,Earl,2,1998-09-01T03:00:00Z,CORPUSCHRISTI TX,0,1,0,1,2
Tropical Storm,Earl,2,1998-09-01T03:00:00Z,SAVANNAH GA,0,0,0,7,7
Tropical Storm,Earl,2,1998-09-01T03:00:00Z,BROWNSVILLE TX,0,1,0,1,2
Tropical Storm,Earl,2,1998-09-01T03:00:00Z,CHARLESTON SC,0,0,0,5,5
Tropical Storm,Earl,2,1998-09-01T03:00:00Z,GULF 29N 85W,0,0,1,11,12
Tropical Storm,Earl,2,1998-09-01T03:00:00Z,MYRTLE BEACH SC,0,0,0,3,3
Tropical Storm,Earl,2,1998-09-01T03:00:00Z,GULF 29N 87W,0,0,7,9,16
Tropical Storm,Earl,2,1998-09-01T03:00:00Z,WILMINGTON NC,0,0,0,2,2
Tropical Storm,Earl,2,1998-09-01T03:00:00Z,GULF 28N 89W,0,3,14,3,20
Tropical Storm,Earl,2,1998-09-01T03:00:00Z,KEY WEST FL,0,0,0,3,3
Tropical Storm,Earl,2,1998-09-01T03:00:00Z,GULF 28N 91W,0,15,9,1,25
Tropical Storm,Earl,2,1998-09-01T03:00:00Z,MARCO ISLAND FL,0,0,0,5,5
Tropical Storm,Earl,2,1998-09-01T03:00:00Z,GULF 28N 93W,1,21,3,0,25
Tropical Storm,Earl,2,1998-09-01T03:00:00Z,FT MYERS FL,0,0,0,6,6
Tropical Storm,Earl,2,1998-09-01T03:00:00Z,GULF 28N 95W,1,13,1,1,16
Tropical Storm,Earl,2,1998-09-01T03:00:00Z,VENICE FL,0,0,0,7,7
Tropical Storm,Earl,2,1998-09-01T03:00:00Z,GULF 27N 96W,2,8,0,1,11
Tropical Storm,Earl,2,1998-09-01T03:00:00Z,TAMPA FL,0,0,0,8,8
Tropical Storm,Earl,2,1998-09-01T03:00:00Z,GULF 25N 96W,10,3,1,0,14
Tropical Storm,Earl,2,1998-09-01T03:00:00Z,CEDAR KEY FL,0,0,0,9,9
Tropical Storm,Earl,3,1998-09-01T09:00:00Z,24.0N  93.5W,47,0,0,0,47
Tropical Storm,Earl,3,1998-09-01T09:00:00Z,NEW ORLEANS LA,0,0,5,9,14
Tropical Storm,Earl,3,1998-09-01T09:00:00Z,25.0N  93.5W,30,1,1,0,32
Tropical Storm,Earl,3,1998-09-01T09:00:00Z,NEW IBERIA LA,0,1,8,7,16
Tropical Storm,Earl,3,1998-09-01T09:00:00Z,26.5N  92.5W,11,7,3,2,23
Tropical Storm,Earl,3,1998-09-01T09:00:00Z,PORT ARTHUR TX,0,1,8,6,15
Tropical Storm,Earl,3,1998-09-01T09:00:00Z,MMSO 238N 982W,0,1,1,3,5
Tropical Storm,Earl,3,1998-09-01T09:00:00Z,GALVESTON TX,0,3,8,4,15
Tropical Storm,Earl,3,1998-09-01T09:00:00Z,MMTM 222N 979W,0,1,1,1,3
Tropical Storm,Earl,3,1998-09-01T09:00:00Z,FREEPORT TX,0,3,7,4,14
Tropical Storm,Earl,3,1998-09-01T09:00:00Z,MMTX 210N 974W,0,0,1,2,3
Tropical Storm,Earl,3,1998-09-01T09:00:00Z,PORT O CONNOR TX,0,2,6,4,12
Tropical Storm,Earl,3,1998-09-01T09:00:00Z,MMVR 192N 961W,0,0,1,1,2
Tropical Storm,Earl,3,1998-09-01T09:00:00Z,CORPUSCHRISTI TX,0,1,3,4,8
Tropical Storm,Earl,3,1998-09-01T09:00:00Z,MMFR 185N 926W,0,0,0,2,2
Tropical Storm,Earl,3,1998-09-01T09:00:00Z,BROWNSVILLE TX,0,3,4,3,10
Tropical Storm,Earl,3,1998-09-01T09:00:00Z,MMMD 210N 897W,0,0,1,3,4
Tropical Storm,Earl,3,1998-09-01T09:00:00Z,GULF 29N 85W,0,0,0,4,4
Tropical Storm,Earl,3,1998-09-01T09:00:00Z,ST MARKS FL,0,0,0,3,3
Tropical Storm,Earl,3,1998-09-01T09:00:00Z,GULF 29N 87W,0,0,0,8,8
Tropical Storm,Earl,3,1998-09-01T09:00:00Z,APALACHICOLA FL,0,0,0,4,4
Tropical Storm,Earl,3,1998-09-01T09:00:00Z,GULF 28N 89W,0,0,3,9,12
Tropical Storm,Earl,3,1998-09-01T09:00:00Z,PANAMA CITY FL,0,0,0,5,5
Tropical Storm,Earl,3,1998-09-01T09:00:00Z,GULF 28N 91W,0,4,8,5,17
Tropical Storm,Earl,3,1998-09-01T09:00:00Z,PENSACOLA FL,0,0,0,8,8
Tropical Storm,Earl,3,1998-09-01T09:00:00Z,GULF 28N 93W,1,10,8,2,21
Tropical Storm,Earl,3,1998-09-01T09:00:00Z,MOBILE AL,0,0,1,9,10
Tropical Storm,Earl,3,1998-09-01T09:00:00Z,GULF 28N 95W,1,8,7,2,18
Tropical Storm,Earl,3,1998-09-01T09:00:00Z,GULFPORT MS,0,0,1,11,12
Tropical Storm,Earl,3,1998-09-01T09:00:00Z,GULF 27N 96W,1,8,5,2,16
Tropical Storm,Earl,3,1998-09-01T09:00:00Z,BURAS LA,0,0,3,10,13
Tropical Storm,Earl,3,1998-09-01T09:00:00Z,GULF 25N 96W,4,10,2,2,18
Tropical Storm,Earl,4,1998-09-01T15:00:00Z,26.5N  92.5W,47,0,0,0,47
Tropical Storm,Earl,4,1998-09-01T15:00:00Z,NEW IBERIA LA,5,8,4,4,21
Tropical Storm,Earl,4,1998-09-01T15:00:00Z,27.3N  92.5W,30,1,0,1,32
Tropical Storm,Earl,4,1998-09-01T15:00:00Z,PORT ARTHUR TX,4,7,4,4,19
Tropical Storm,Earl,4,1998-09-01T15:00:00Z,28.3N  92.5W,19,3,2,1,25
Tropical Storm,Earl,4,1998-09-01T15:00:00Z,GALVESTON TX,4,7,4,4,19
Tropical Storm,Earl,4,1998-09-01T15:00:00Z,MMSO 238N 982W,0,0,2,4,6
Tropical Storm,Earl,4,1998-09-01T15:00:00Z,FREEPORT TX,3,6,4,5,18
Tropical Storm,Earl,4,1998-09-01T15:00:00Z,MMTM 222N 979W,0,0,1,2,3
Tropical Storm,Earl,4,1998-09-01T15:00:00Z,PORT O CONNOR TX,1,4,5,5,15
Tropical Storm,Earl,4,1998-09-01T15:00:00Z,MMTX 210N 974W,0,0,0,2,2
Tropical Storm,Earl,4,1998-09-01T15:00:00Z,CORPUSCHRISTI TX,0,2,4,6,12
Tropical Storm,Earl,4,1998-09-01T15:00:00Z,CEDAR KEY FL,0,0,0,2,2
Tropical Storm,Earl,4,1998-09-01T15:00:00Z,BROWNSVILLE TX,0,2,4,5,11
Tropical Storm,Earl,4,1998-09-01T15:00:00Z,ST MARKS FL,0,0,0,4,4
Tropical Storm,Earl,4,1998-09-01T15:00:00Z,GULF 29N 85W,0,0,0,4,4
Tropical Storm,Earl,4,1998-09-01T15:00:00Z,APALACHICOLA FL,0,0,0,5,5
Tropical Storm,Earl,4,1998-09-01T15:00:00Z,GULF 29N 87W,0,0,3,6,9
Tropical Storm,Earl,4,1998-09-01T15:00:00Z,PANAMA CITY FL,0,0,1,5,6
Tropical Storm,Earl,4,1998-09-01T15:00:00Z,GULF 28N 89W,1,5,4,4,14
Tropical Storm,Earl,4,1998-09-01T15:00:00Z,PENSACOLA FL,0,0,3,7,10
Tropical Storm,Earl,4,1998-09-01T15:00:00Z,GULF 28N 91W,13,5,2,2,22
Tropical Storm,Earl,4,1998-09-01T15:00:00Z,MOBILE AL,0,2,5,6,13
Tropical Storm,Earl,4,1998-09-01T15:00:00Z,GULF 28N 93W,20,3,2,1,26
Tropical Storm,Earl,4,1998-09-01T15:00:00Z,GULFPORT MS,0,4,6,5,15
Tropical Storm,Earl,4,1998-09-01T15:00:00Z,GULF 28N 95W,8,6,3,3,20
Tropical Storm,Earl,4,1998-09-01T15:00:00Z,BURAS LA,1,7,5,4,17
Tropical Storm,Earl,4,1998-09-01T15:00:00Z,GULF 27N 96W,2,7,4,3,16
Tropical Storm,Earl,4,1998-09-01T15:00:00Z,NEW ORLEANS LA,1,8,5,4,18
Tropical Storm,Earl,4,1998-09-01T15:00:00Z,GULF 25N 96W,1,5,4,3,13
Tropical Storm,Earl,5,1998-09-01T21:00:00Z,29.5N  91.5W,36,0,0,0,36
Tropical Storm,Earl,5,1998-09-01T21:00:00Z,BURAS LA,17,3,1,2,23
Tropical Storm,Earl,5,1998-09-01T21:00:00Z,30.5N  91.2W,15,5,2,1,23
Tropical Storm,Earl,5,1998-09-01T21:00:00Z,NEW ORLEANS LA,17,4,1,1,23
Tropical Storm,Earl,5,1998-09-01T21:00:00Z,32.0N  90.5W,1,11,4,2,18
Tropical Storm,Earl,5,1998-09-01T21:00:00Z,NEW IBERIA LA,27,1,0,1,29
Tropical Storm,Earl,5,1998-09-01T21:00:00Z,DAYTONA BEACH FL,0,0,0,2,2
Tropical Storm,Earl,5,1998-09-01T21:00:00Z,PORT ARTHUR TX,14,2,1,1,18
Tropical Storm,Earl,5,1998-09-01T21:00:00Z,JACKSONVILLE FL,0,0,0,4,4
Tropical Storm,Earl,5,1998-09-01T21:00:00Z,GALVESTON TX,7,3,1,2,13
Tropical Storm,Earl,5,1998-09-01T21:00:00Z,SAVANNAH GA,0,0,0,3,3
Tropical Storm,Earl,5,1998-09-01T21:00:00Z,FREEPORT TX,2,4,1,2,9
Tropical Storm,Earl,5,1998-09-01T21:00:00Z,CHARLESTON SC,0,0,0,2,2
Tropical Storm,Earl,5,1998-09-01T21:00:00Z,PORT O CONNOR TX,0,1,2,1,4
Tropical Storm,Earl,5,1998-09-01T21:00:00Z,VENICE FL,0,0,0,2,2
Tropical Storm,Earl,5,1998-09-01T21:00:00Z,CORPUSCHRISTI TX,0,0,1,1,2
Tropical Storm,Earl,5,1998-09-01T21:00:00Z,TAMPA FL,0,0,0,3,3
Tropical Storm,Earl,5,1998-09-01T21:00:00Z,GULF 29N 85W,0,1,3,5,9
Tropical Storm,Earl,5,1998-09-01T21:00:00Z,CEDAR KEY FL,0,0,1,4,5
Tropical Storm,Earl,5,1998-09-01T21:00:00Z,GULF 29N 87W,1,6,3,4,14
Tropical Storm,Earl,5,1998-09-01T21:00:00Z,ST MARKS FL,0,0,3,5,8
Tropical Storm,Earl,5,1998-09-01T21:00:00Z,GULF 28N 89W,15,3,1,1,20
Tropical Storm,Earl,5,1998-09-01T21:00:00Z,APALACHICOLA FL,0,1,3,6,10
Tropical Storm,Earl,5,1998-09-01T21:00:00Z,GULF 28N 91W,59,0,0,0,59
Tropical Storm,Earl,5,1998-09-01T21:00:00Z,PANAMA CITY FL,0,2,4,5,11
Tropical Storm,Earl,5,1998-09-01T21:00:00Z,GULF 28N 93W,99,0,0,0,99
Tropical Storm,Earl,5,1998-09-01T21:00:00Z,PENSACOLA FL,0,6,5,4,15
Tropical Storm,Earl,5,1998-09-01T21:00:00Z,GULF 28N 95W,1,4,1,2,8
Tropical Storm,Earl,5,1998-09-01T21:00:00Z,MOBILE AL,1,9,4,3,17
Tropical Storm,Earl,5,1998-09-01T21:00:00Z,GULF 27N 96W,0,1,1,1,3
Tropical Storm,Earl,5,1998-09-01T21:00:00Z,GULFPORT MS,4,10,3,2,19
Tropical Storm,Earl,6,1998-09-02T03:00:00Z,29.8N  89.8W,35,1,0,0,36
Tropical Storm,Earl,6,1998-09-02T03:00:00Z,BURAS LA,40,0,0,0,40
Tropical Storm,Earl,6,1998-09-02T03:00:00Z,30.5N  89.5W,22,2,1,0,25
Tropical Storm,Earl,6,1998-09-02T03:00:00Z,NEW ORLEANS LA,30,0,1,0,31
Tropical Storm,Earl,6,1998-09-02T03:00:00Z,31.0N  89.5W,17,3,2,1,23
Tropical Storm,Earl,6,1998-09-02T03:00:00Z,NEW IBERIA LA,17,2,1,1,21
Tropical Storm,Earl,6,1998-09-02T03:00:00Z,MMMD 210N 897W,0,0,0,2,2
Tropical Storm,Earl,6,1998-09-02T03:00:00Z,PORT ARTHUR TX,1,3,3,3,10
Tropical Storm,Earl,6,1998-09-02T03:00:00Z,DAYTONA BEACH FL,0,0,0,2,2
Tropical Storm,Earl,6,1998-09-02T03:00:00Z,GALVESTON TX,0,1,3,4,8
Tropical Storm,Earl,6,1998-09-02T03:00:00Z,JACKSONVILLE FL,0,0,0,3,3
Tropical Storm,Earl,6,1998-09-02T03:00:00Z,FREEPORT TX,0,1,1,4,6
Tropical Storm,Earl,6,1998-09-02T03:00:00Z,SAVANNAH GA,0,0,0,3,3
Tropical Storm,Earl,6,1998-09-02T03:00:00Z,PORT O CONNOR TX,0,0,1,3,4
Tropical Storm,Earl,6,1998-09-02T03:00:00Z,CHARLESTON SC,0,0,0,2,2
Tropical Storm,Earl,6,1998-09-02T03:00:00Z,CORPUSCHRISTI TX,0,0,0,2,2
Tropical Storm,Earl,6,1998-09-02T03:00:00Z,VENICE FL,0,0,0,2,2
Tropical Storm,Earl,6,1998-09-02T03:00:00Z,BROWNSVILLE TX,0,0,0,2,2
Tropical Storm,Earl,6,1998-09-02T03:00:00Z,TAMPA FL,0,0,0,3,3
Tropical Storm,Earl,6,1998-09-02T03:00:00Z,GULF 29N 85W,1,3,2,4,10
Tropical Storm,Earl,6,1998-09-02T03:00:00Z,CEDAR KEY FL,0,0,1,4,5
Tropical Storm,Earl,6,1998-09-02T03:00:00Z,GULF 29N 87W,12,3,1,2,18
Tropical Storm,Earl,6,1998-09-02T03:00:00Z,ST MARKS FL,0,2,2,4,8
Tropical Storm,Earl,6,1998-09-02T03:00:00Z,GULF 28N 89W,45,1,0,0,46
Tropical Storm,Earl,6,1998-09-02T03:00:00Z,APALACHICOLA FL,1,3,3,3,10
Tropical Storm,Earl,6,1998-09-02T03:00:00Z,GULF 28N 91W,99,0,0,0,99
Tropical Storm,Earl,6,1998-09-02T03:00:00Z,PANAMA CITY FL,2,4,3,4,13
Tropical Storm,Earl,6,1998-09-02T03:00:00Z,GULF 28N 93W,21,1,0,0,22
Tropical Storm,Earl,6,1998-09-02T03:00:00Z,PENSACOLA FL,9,5,2,2,18
Tropical Storm,Earl,6,1998-09-02T03:00:00Z,GULF 28N 95W,0,1,2,4,7
Tropical Storm,Earl,6,1998-09-02T03:00:00Z,MOBILE AL,15,4,1,2,22
Tropical Storm,Earl,6,1998-09-02T03:00:00Z,GULF 27N 96W,0,0,1,3,4
Tropical Storm,Earl,6,1998-09-02T03:00:00Z,GULFPORT MS,22,2,1,0,25
Tropical Storm,Earl,6,1998-09-02T03:00:00Z,GULF 25N 96W,0,0,1,2,3
Tropical Storm,Earl,7,1998-09-02T09:00:00Z,30.0N  88.5W,36,0,0,0,36
Tropical Storm,Earl,7,1998-09-02T09:00:00Z,PENSACOLA FL,23,1,1,1,26
Tropical Storm,Earl,7,1998-09-02T09:00:00Z,31.0N  88.5W,21,2,1,1,25
Tropical Storm,Earl,7,1998-09-02T09:00:00Z,MOBILE AL,24,2,0,1,27
Tropical Storm,Earl,7,1998-09-02T09:00:00Z,32.0N  88.5W,9,7,3,1,20
Tropical Storm,Earl,7,1998-09-02T09:00:00Z,GULFPORT MS,28,1,0,1,30
Tropical Storm,Earl,7,1998-09-02T09:00:00Z,COCOA BEACH FL,0,0,0,2,2
Tropical Storm,Earl,7,1998-09-02T09:00:00Z,BURAS LA,47,0,0,0,47
Tropical Storm,Earl,7,1998-09-02T09:00:00Z,DAYTONA BEACH FL,0,0,1,3,4
Tropical Storm,Earl,7,1998-09-02T09:00:00Z,NEW ORLEANS LA,26,1,0,0,27
Tropical Storm,Earl,7,1998-09-02T09:00:00Z,JACKSONVILLE FL,0,1,2,4,7
Tropical Storm,Earl,7,1998-09-02T09:00:00Z,NEW IBERIA LA,6,3,2,3,14
Tropical Storm,Earl,7,1998-09-02T09:00:00Z,SAVANNAH GA,0,0,2,5,7
Tropical Storm,Earl,7,1998-09-02T09:00:00Z,PORT ARTHUR TX,0,1,2,4,7
Tropical Storm,Earl,7,1998-09-02T09:00:00Z,CHARLESTON SC,0,0,1,4,5
Tropical Storm,Earl,7,1998-09-02T09:00:00Z,GALVESTON TX,0,0,1,4,5
Tropical Storm,Earl,7,1998-09-02T09:00:00Z,MYRTLE BEACH SC,0,0,0,3,3
Tropical Storm,Earl,7,1998-09-02T09:00:00Z,FREEPORT TX,0,0,1,3,4
Tropical Storm,Earl,7,1998-09-02T09:00:00Z,WILMINGTON NC,0,0,0,2,2
Tropical Storm,Earl,7,1998-09-02T09:00:00Z,PORT O CONNOR TX,0,0,0,3,3
Tropical Storm,Earl,7,1998-09-02T09:00:00Z,FT MYERS FL,0,0,0,2,2
Tropical Storm,Earl,7,1998-09-02T09:00:00Z,GULF 29N 85W,6,6,2,1,15
Tropical Storm,Earl,7,1998-09-02T09:00:00Z,VENICE FL,0,0,1,2,3
Tropical Storm,Earl,7,1998-09-02T09:00:00Z,GULF 29N 87W,29,1,0,0,30
Tropical Storm,Earl,7,1998-09-02T09:00:00Z,TAMPA FL,0,1,1,3,5
Tropical Storm,Earl,7,1998-09-02T09:00:00Z,GULF 28N 89W,71,0,0,0,71
Tropical Storm,Earl,7,1998-09-02T09:00:00Z,CEDAR KEY FL,0,3,2,3,8
Tropical Storm,Earl,7,1998-09-02T09:00:00Z,GULF 28N 91W,99,0,0,0,99
Tropical Storm,Earl,7,1998-09-02T09:00:00Z,ST MARKS FL,2,7,2,3,14
Tropical Storm,Earl,7,1998-09-02T09:00:00Z,GULF 28N 93W,0,2,2,4,8
Tropical Storm,Earl,7,1998-09-02T09:00:00Z,APALACHICOLA FL,6,7,2,1,16
Tropical Storm,Earl,7,1998-09-02T09:00:00Z,GULF 28N 95W,0,0,1,3,4
Tropical Storm,Earl,7,1998-09-02T09:00:00Z,PANAMA CITY FL,11,5,2,1,19
Tropical Storm,Earl,7,1998-09-02T09:00:00Z,GULF 27N 96W,0,0,0,2,2
Tropical Storm,Earl,8,1998-09-02T13:00:00Z,31.0N  84.0W,37,0,0,0,37
Tropical Storm,Earl,8,1998-09-02T13:00:00Z,PROVIDENCE RI,0,0,0,2,2
Tropical Storm,Earl,8,1998-09-02T13:00:00Z,32.5N  82.0W,10,11,1,1,23
Tropical Storm,Earl,8,1998-09-02T13:00:00Z,NANTUCKET MA,0,0,0,2,2
Tropical Storm,Earl,8,1998-09-02T13:00:00Z,34.0N  81.0W,1,12,3,2,18
Tropical Storm,Earl,8,1998-09-02T13:00:00Z,HYANNIS MA,0,0,0,2,2
Tropical Storm,Earl,8,1998-09-02T13:00:00Z,MYGF 266N 787W,0,0,1,2,3
Tropical Storm,Earl,8,1998-09-02T13:00:00Z,BOSTON MA,0,0,0,2,2
Tropical Storm,Earl,8,1998-09-02T13:00:00Z,MARATHON FL,0,0,1,1,2
Tropical Storm,Earl,8,1998-09-02T13:00:00Z,KEY WEST FL,0,0,0,2,2
Tropical Storm,Earl,8,1998-09-02T13:00:00Z,MIAMI FL,0,0,1,2,3
Tropical Storm,Earl,8,1998-09-02T13:00:00Z,MARCO ISLAND FL,0,1,1,2,4
Tropical Storm,Earl,8,1998-09-02T13:00:00Z,W PALM BEACH FL,0,1,2,2,5
Tropical Storm,Earl,8,1998-09-02T13:00:00Z,FT MYERS FL,1,2,1,2,6
Tropical Storm,Earl,8,1998-09-02T13:00:00Z,FT PIERCE FL,0,3,2,3,8
Tropical Storm,Earl,8,1998-09-02T13:00:00Z,VENICE FL,2,4,2,1,9
Tropical Storm,Earl,8,1998-09-02T13:00:00Z,COCOA BEACH FL,1,6,2,2,11
Tropical Storm,Earl,8,1998-09-02T13:00:00Z,TAMPA FL,9,4,1,1,15
Tropical Storm,Earl,8,1998-09-02T13:00:00Z,DAYTONA BEACH FL,6,8,1,1,16
Tropical Storm,Earl,8,1998-09-02T13:00:00Z,CEDAR KEY FL,24,1,0,0,25
Tropical Storm,Earl,8,1998-09-02T13:00:00Z,JACKSONVILLE FL,16,6,1,0,23
Tropical Storm,Earl,8,1998-09-02T13:00:00Z,ST MARKS FL,44,0,0,0,44
Tropical Storm,Earl,8,1998-09-02T13:00:00Z,SAVANNAH GA,6,14,1,1,22
Tropical Storm,Earl,8,1998-09-02T13:00:00Z,APALACHICOLA FL,56,0,0,0,56
Tropical Storm,Earl,8,1998-09-02T13:00:00Z,CHARLESTON SC,1,13,2,2,18
Tropical Storm,Earl,8,1998-09-02T13:00:00Z,PANAMA CITY FL,62,0,0,0,62
Tropical Storm,Earl,8,1998-09-02T13:00:00Z,MYRTLE BEACH SC,0,8,5,3,16
Tropical Storm,Earl,8,1998-09-02T13:00:00Z,PENSACOLA FL,47,0,0,0,47
Tropical Storm,Earl,8,1998-09-02T13:00:00Z,WILMINGTON NC,0,4,6,4,14
Tropical Storm,Earl,8,1998-09-02T13:00:00Z,MOBILE AL,9,0,1,1,11
Tropical Storm,Earl,8,1998-09-02T13:00:00Z,MOREHEAD CITY NC,0,1,6,5,12
Tropical Storm,Earl,8,1998-09-02T13:00:00Z,GULFPORT MS,3,0,1,2,6
Tropical Storm,Earl,8,1998-09-02T13:00:00Z,CAPE HATTERAS NC,0,0,5,5,10
Tropical Storm,Earl,8,1998-09-02T13:00:00Z,BURAS LA,24,0,0,0,24
Tropical Storm,Earl,8,1998-09-02T13:00:00Z,NORFOLK VA,0,0,4,6,10
Tropical Storm,Earl,8,1998-09-02T13:00:00Z,NEW ORLEANS LA,0,0,0,2,2
Tropical Storm,Earl,8,1998-09-02T13:00:00Z,OCEAN CITY MD,0,0,2,6,8
Tropical Storm,Earl,8,1998-09-02T13:00:00Z,GULF 29N 85W,53,0,0,0,53
Tropical Storm,Earl,8,1998-09-02T13:00:00Z,ATLANTIC CITY NJ,0,0,1,5,6
Tropical Storm,Earl,8,1998-09-02T13:00:00Z,GULF 29N 87W,99,0,0,0,99
Tropical Storm,Earl,8,1998-09-02T13:00:00Z,NEW YORK CITY NY,0,0,0,4,4
Tropical Storm,Earl,8,1998-09-02T13:00:00Z,GULF 28N 89W,99,0,0,0,99
Tropical Storm,Earl,8,1998-09-02T13:00:00Z,MONTAUK POINT NY,0,0,0,3,3
Hurricane,Earl,9,1998-09-02T15:00:00Z,31.0N  84.0W,37,0,0,0,37
Hurricane,Earl,9,1998-09-02T15:00:00Z,PROVIDENCE RI,0,0,0,2,2
Hurricane,Earl,9,1998-09-02T15:00:00Z,32.5N  82.0W,9,12,1,1,23
Hurricane,Earl,9,1998-09-02T15:00:00Z,NANTUCKET MA,0,0,0,2,2
Hurricane,Earl,9,1998-09-02T15:00:00Z,34.0N  81.0W,1,12,3,2,18
Hurricane,Earl,9,1998-09-02T15:00:00Z,HYANNIS MA,0,0,0,2,2
Hurricane,Earl,9,1998-09-02T15:00:00Z,MYGF 266N 787W,0,0,1,2,3
Hurricane,Earl,9,1998-09-02T15:00:00Z,BOSTON MA,0,0,0,2,2
Hurricane,Earl,9,1998-09-02T15:00:00Z,MARATHON FL,0,0,0,2,2
Hurricane,Earl,9,1998-09-02T15:00:00Z,KEY WEST FL,0,0,0,2,2
Hurricane,Earl,9,1998-09-02T15:00:00Z,MIAMI FL,0,0,1,2,3
Hurricane,Earl,9,1998-09-02T15:00:00Z,MARCO ISLAND FL,0,1,1,2,4
Hurricane,Earl,9,1998-09-02T15:00:00Z,W PALM BEACH FL,0,1,2,2,5
Hurricane,Earl,9,1998-09-02T15:00:00Z,FT MYERS FL,1,2,2,1,6
Hurricane,Earl,9,1998-09-02T15:00:00Z,FT PIERCE FL,0,4,2,2,8
Hurricane,Earl,9,1998-09-02T15:00:00Z,VENICE FL,2,4,2,1,9
Hurricane,Earl,9,1998-09-02T15:00:00Z,COCOA BEACH FL,1,6,2,2,11
Hurricane,Earl,9,1998-09-02T15:00:00Z,TAMPA FL,8,5,1,1,15
Hurricane,Earl,9,1998-09-02T15:00:00Z,DAYTONA BEACH FL,5,9,2,1,17
Hurricane,Earl,9,1998-09-02T15:00:00Z,CEDAR KEY FL,24,0,1,0,25
Hurricane,Earl,9,1998-09-02T15:00:00Z,JACKSONVILLE FL,15,7,1,0,23
Hurricane,Earl,9,1998-09-02T15:00:00Z,ST MARKS FL,44,0,0,0,44
Hurricane,Earl,9,1998-09-02T15:00:00Z,SAVANNAH GA,5,15,1,1,22
Hurricane,Earl,9,1998-09-02T15:00:00Z,APALACHICOLA FL,58,0,0,0,58
Hurricane,Earl,9,1998-09-02T15:00:00Z,CHARLESTON SC,1,13,3,2,19
Hurricane,Earl,9,1998-09-02T15:00:00Z,PANAMA CITY FL,64,0,0,0,64
Hurricane,Earl,9,1998-09-02T15:00:00Z,MYRTLE BEACH SC,0,8,5,3,16
Hurricane,Earl,9,1998-09-02T15:00:00Z,PENSACOLA FL,47,0,0,0,47
Hurricane,Earl,9,1998-09-02T15:00:00Z,WILMINGTON NC,0,3,8,3,14
Hurricane,Earl,9,1998-09-02T15:00:00Z,MOBILE AL,6,0,1,2,9
Hurricane,Earl,9,1998-09-02T15:00:00Z,MOREHEAD CITY NC,0,1,6,5,12
Hurricane,Earl,9,1998-09-02T15:00:00Z,GULFPORT MS,0,1,0,3,4
Hurricane,Earl,9,1998-09-02T15:00:00Z,CAPE HATTERAS NC,0,0,5,5,10
Hurricane,Earl,9,1998-09-02T15:00:00Z,BURAS LA,2,0,1,1,4
Hurricane,Earl,9,1998-09-02T15:00:00Z,NORFOLK VA,0,0,4,6,10
Hurricane,Earl,9,1998-09-02T15:00:00Z,NEW ORLEANS LA,0,0,0,2,2
Hurricane,Earl,9,1998-09-02T15:00:00Z,OCEAN CITY MD,0,0,2,6,8
Hurricane,Earl,9,1998-09-02T15:00:00Z,GULF 29N 85W,52,0,0,0,52
Hurricane,Earl,9,1998-09-02T15:00:00Z,ATLANTIC CITY NJ,0,0,1,5,6
Hurricane,Earl,9,1998-09-02T15:00:00Z,GULF 29N 87W,99,0,0,0,99
Hurricane,Earl,9,1998-09-02T15:00:00Z,NEW YORK CITY NY,0,0,0,5,5
Hurricane,Earl,9,1998-09-02T15:00:00Z,GULF 28N 89W,99,0,0,0,99
Hurricane,Earl,9,1998-09-02T15:00:00Z,MONTAUK POINT NY,0,0,0,3,3
Hurricane,Earl,10,1998-09-02T21:00:00Z,31.5N  84.5W,33,0,1,0,34
Hurricane,Earl,10,1998-09-02T21:00:00Z,PROVIDENCE RI,0,0,0,3,3
Hurricane,Earl,10,1998-09-02T21:00:00Z,32.5N  83.5W,20,2,1,0,23
Hurricane,Earl,10,1998-09-02T21:00:00Z,NANTUCKET MA,0,0,0,2,2
Hurricane,Earl,10,1998-09-02T21:00:00Z,34.0N  81.5W,2,10,4,2,18
Hurricane,Earl,10,1998-09-02T21:00:00Z,HYANNIS MA,0,0,0,2,2
Hurricane,Earl,10,1998-09-02T21:00:00Z,MYGF 266N 787W,0,0,1,2,3
Hurricane,Earl,10,1998-09-02T21:00:00Z,BOSTON MA,0,0,0,2,2
Hurricane,Earl,10,1998-09-02T21:00:00Z,MARATHON FL,0,0,0,2,2
Hurricane,Earl,10,1998-09-02T21:00:00Z,KEY WEST FL,0,0,1,1,2
Hurricane,Earl,10,1998-09-02T21:00:00Z,MIAMI FL,0,0,1,2,3
Hurricane,Earl,10,1998-09-02T21:00:00Z,MARCO ISLAND FL,0,1,1,3,5
Hurricane,Earl,10,1998-09-02T21:00:00Z,W PALM BEACH FL,0,0,2,3,5
Hurricane,Earl,10,1998-09-02T21:00:00Z,FT MYERS FL,0,2,2,3,7
Hurricane,Earl,10,1998-09-02T21:00:00Z,FT PIERCE FL,0,1,3,4,8
Hurricane,Earl,10,1998-09-02T21:00:00Z,VENICE FL,1,3,3,2,9
Hurricane,Earl,10,1998-09-02T21:00:00Z,COCOA BEACH FL,0,3,4,3,10
Hurricane,Earl,10,1998-09-02T21:00:00Z,TAMPA FL,3,5,3,2,13
Hurricane,Earl,10,1998-09-02T21:00:00Z,DAYTONA BEACH FL,2,6,4,2,14
Hurricane,Earl,10,1998-09-02T21:00:00Z,CEDAR KEY FL,15,2,1,1,19
Hurricane,Earl,10,1998-09-02T21:00:00Z,JACKSONVILLE FL,10,6,2,1,19
Hurricane,Earl,10,1998-09-02T21:00:00Z,ST MARKS FL,38,0,0,1,39
Hurricane,Earl,10,1998-09-02T21:00:00Z,SAVANNAH GA,6,9,3,2,20
Hurricane,Earl,10,1998-09-02T21:00:00Z,APALACHICOLA FL,52,0,0,0,52
Hurricane,Earl,10,1998-09-02T21:00:00Z,CHARLESTON SC,1,8,6,3,18
Hurricane,Earl,10,1998-09-02T21:00:00Z,PANAMA CITY FL,61,0,0,0,61
Hurricane,Earl,10,1998-09-02T21:00:00Z,MYRTLE BEACH SC,0,5,8,3,16
Hurricane,Earl,10,1998-09-02T21:00:00Z,PENSACOLA FL,45,0,0,0,45
Hurricane,Earl,10,1998-09-02T21:00:00Z,WILMINGTON NC,0,2,8,5,15
Hurricane,Earl,10,1998-09-02T21:00:00Z,MOBILE AL,7,1,1,1,10
Hurricane,Earl,10,1998-09-02T21:00:00Z,MOREHEAD CITY NC,0,1,6,6,13
Hurricane,Earl,10,1998-09-02T21:00:00Z,GULFPORT MS,2,1,1,2,6
Hurricane,Earl,10,1998-09-02T21:00:00Z,CAPE HATTERAS NC,0,0,4,7,11
Hurricane,Earl,10,1998-09-02T21:00:00Z,BURAS LA,0,1,1,2,4
Hurricane,Earl,10,1998-09-02T21:00:00Z,NORFOLK VA,0,0,4,7,11
Hurricane,Earl,10,1998-09-02T21:00:00Z,NEW ORLEANS LA,0,0,1,1,2
Hurricane,Earl,10,1998-09-02T21:00:00Z,OCEAN CITY MD,0,0,2,7,9
Hurricane,Earl,10,1998-09-02T21:00:00Z,GULF 29N 85W,45,0,0,0,45
Hurricane,Earl,10,1998-09-02T21:00:00Z,ATLANTIC CITY NJ,0,0,1,6,7
Hurricane,Earl,10,1998-09-02T21:00:00Z,GULF 29N 87W,99,0,0,0,99
Hurricane,Earl,10,1998-09-02T21:00:00Z,NEW YORK CITY NY,0,0,0,5,5
Hurricane,Earl,10,1998-09-02T21:00:00Z,GULF 28N 89W,1,0,1,2,4
Hurricane,Earl,10,1998-09-02T21:00:00Z,MONTAUK POINT NY,0,0,0,3,3
Hurricane,Earl,11,1998-09-03T03:00:00Z,31.4N  83.2W,31,1,0,0,32
Hurricane,Earl,11,1998-09-03T03:00:00Z,NEW YORK CITY NY,0,0,0,7,7
Hurricane,Earl,11,1998-09-03T03:00:00Z,32.5N  81.5W,10,9,2,1,22
Hurricane,Earl,11,1998-09-03T03:00:00Z,MONTAUK POINT NY,0,0,0,6,6
Hurricane,Earl,11,1998-09-03T03:00:00Z,34.0N  79.5W,0,10,5,3,18
Hurricane,Earl,11,1998-09-03T03:00:00Z,PROVIDENCE RI,0,0,0,5,5
Hurricane,Earl,11,1998-09-03T03:00:00Z,MYGF 266N 787W,0,0,2,1,3
Hurricane,Earl,11,1998-09-03T03:00:00Z,NANTUCKET MA,0,0,0,5,5
Hurricane,Earl,11,1998-09-03T03:00:00Z,MIAMI FL,0,1,0,2,3
Hurricane,Earl,11,1998-09-03T03:00:00Z,HYANNIS MA,0,0,0,5,5
Hurricane,Earl,11,1998-09-03T03:00:00Z,W PALM BEACH FL,0,2,1,2,5
Hurricane,Earl,11,1998-09-03T03:00:00Z,BOSTON MA,0,0,0,4,4
Hurricane,Earl,11,1998-09-03T03:00:00Z,FT PIERCE FL,0,4,2,2,8
Hurricane,Earl,11,1998-09-03T03:00:00Z,PORTLAND ME,0,0,0,2,2
Hurricane,Earl,11,1998-09-03T03:00:00Z,COCOA BEACH FL,2,6,2,1,11
Hurricane,Earl,11,1998-09-03T03:00:00Z,MARCO ISLAND FL,0,2,1,1,4
Hurricane,Earl,11,1998-09-03T03:00:00Z,DAYTONA BEACH FL,8,7,1,1,17
Hurricane,Earl,11,1998-09-03T03:00:00Z,FT MYERS FL,1,3,1,1,6
Hurricane,Earl,11,1998-09-03T03:00:00Z,JACKSONVILLE FL,20,3,1,0,24
Hurricane,Earl,11,1998-09-03T03:00:00Z,VENICE FL,3,4,1,1,9
Hurricane,Earl,11,1998-09-03T03:00:00Z,SAVANNAH GA,10,9,2,1,22
Hurricane,Earl,11,1998-09-03T03:00:00Z,TAMPA FL,10,3,1,0,14
Hurricane,Earl,11,1998-09-03T03:00:00Z,CHARLESTON SC,1,13,3,2,19
Hurricane,Earl,11,1998-09-03T03:00:00Z,CEDAR KEY FL,25,0,0,1,26
Hurricane,Earl,11,1998-09-03T03:00:00Z,MYRTLE BEACH SC,0,9,6,3,18
Hurricane,Earl,11,1998-09-03T03:00:00Z,ST MARKS FL,51,0,0,0,51
Hurricane,Earl,11,1998-09-03T03:00:00Z,WILMINGTON NC,0,5,8,4,17
Hurricane,Earl,11,1998-09-03T03:00:00Z,APALACHICOLA FL,69,0,0,0,69
Hurricane,Earl,11,1998-09-03T03:00:00Z,MOREHEAD CITY NC,0,2,9,5,16
Hurricane,Earl,11,1998-09-03T03:00:00Z,PANAMA CITY FL,99,0,0,0,99
Hurricane,Earl,11,1998-09-03T03:00:00Z,CAPE HATTERAS NC,0,1,7,7,15
Hurricane,Earl,11,1998-09-03T03:00:00Z,PENSACOLA FL,58,0,0,0,58
Hurricane,Earl,11,1998-09-03T03:00:00Z,NORFOLK VA,0,0,6,7,13
Hurricane,Earl,11,1998-09-03T03:00:00Z,MOBILE AL,1,1,1,0,3
Hurricane,Earl,11,1998-09-03T03:00:00Z,OCEAN CITY MD,0,0,3,8,11
Hurricane,Earl,11,1998-09-03T03:00:00Z,GULF 29N 85W,60,0,0,0,60
Hurricane,Earl,11,1998-09-03T03:00:00Z,ATLANTIC CITY NJ,0,0,1,8,9
Hurricane,Earl,11,1998-09-03T03:00:00Z,GULF 29N 87W,99,0,0,0,99
Hurricane,Earl,12,1998-09-03T09:00:00Z,32.5N  82.0W,37,0,0,0,37
Hurricane,Earl,12,1998-09-03T09:00:00Z,MONTAUK POINT NY,0,0,1,7,8
Hurricane,Earl,12,1998-09-03T09:00:00Z,34.0N  80.0W,9,12,1,0,22
Hurricane,Earl,12,1998-09-03T09:00:00Z,PROVIDENCE RI,0,0,0,7,7
Hurricane,Earl,12,1998-09-03T09:00:00Z,35.5N  78.0W,0,10,5,2,17
Hurricane,Earl,12,1998-09-03T09:00:00Z,NANTUCKET MA,0,0,0,7,7
Hurricane,Earl,12,1998-09-03T09:00:00Z,MYGF 266N 787W,0,0,1,2,3
Hurricane,Earl,12,1998-09-03T09:00:00Z,HYANNIS MA,0,0,0,7,7
Hurricane,Earl,12,1998-09-03T09:00:00Z,MIAMI FL,0,0,1,1,2
Hurricane,Earl,12,1998-09-03T09:00:00Z,BOSTON MA,0,0,0,6,6
Hurricane,Earl,12,1998-09-03T09:00:00Z,W PALM BEACH FL,0,0,1,2,3
Hurricane,Earl,12,1998-09-03T09:00:00Z,PORTLAND ME,0,0,0,5,5
Hurricane,Earl,12,1998-09-03T09:00:00Z,FT PIERCE FL,0,2,1,2,5
Hurricane,Earl,12,1998-09-03T09:00:00Z,BAR HARBOR ME,0,0,0,4,4
Hurricane,Earl,12,1998-09-03T09:00:00Z,COCOA BEACH FL,1,3,2,1,7
Hurricane,Earl,12,1998-09-03T09:00:00Z,EASTPORT ME,0,0,0,3,3
Hurricane,Earl,12,1998-09-03T09:00:00Z,DAYTONA BEACH FL,8,4,1,0,13
Hurricane,Earl,12,1998-09-03T09:00:00Z,ST JOHN NB,0,0,0,2,2
Hurricane,Earl,12,1998-09-03T09:00:00Z,JACKSONVILLE FL,29,0,0,0,29
Hurricane,Earl,12,1998-09-03T09:00:00Z,YARMOUTH NS,0,0,0,3,3
Hurricane,Earl,12,1998-09-03T09:00:00Z,SAVANNAH GA,33,0,0,0,33
Hurricane,Earl,12,1998-09-03T09:00:00Z,HALIFAX NS,0,0,0,2,2
Hurricane,Earl,12,1998-09-03T09:00:00Z,CHARLESTON SC,17,7,1,0,25
Hurricane,Earl,12,1998-09-03T09:00:00Z,FT MYERS FL,0,0,1,1,2
Hurricane,Earl,12,1998-09-03T09:00:00Z,MYRTLE BEACH SC,4,14,2,0,20
Hurricane,Earl,12,1998-09-03T09:00:00Z,VENICE FL,0,1,1,1,3
Hurricane,Earl,12,1998-09-03T09:00:00Z,WILMINGTON NC,1,12,3,2,18
Hurricane,Earl,12,1998-09-03T09:00:00Z,TAMPA FL,1,2,1,1,5
Hurricane,Earl,12,1998-09-03T09:00:00Z,MOREHEAD CITY NC,0,8,5,3,16
Hurricane,Earl,12,1998-09-03T09:00:00Z,CEDAR KEY FL,13,1,0,1,15
Hurricane,Earl,12,1998-09-03T09:00:00Z,CAPE HATTERAS NC,0,3,8,3,14
Hurricane,Earl,12,1998-09-03T09:00:00Z,ST MARKS FL,81,0,0,0,81
Hurricane,Earl,12,1998-09-03T09:00:00Z,NORFOLK VA,0,2,8,4,14
Hurricane,Earl,12,1998-09-03T09:00:00Z,APALACHICOLA FL,99,0,0,0,99
Hurricane,Earl,12,1998-09-03T09:00:00Z,OCEAN CITY MD,0,0,6,6,12
Hurricane,Earl,12,1998-09-03T09:00:00Z,PANAMA CITY FL,99,0,0,0,99
Hurricane,Earl,12,1998-09-03T09:00:00Z,ATLANTIC CITY NJ,0,0,4,7,11
Hurricane,Earl,12,1998-09-03T09:00:00Z,PENSACOLA FL,1,0,0,1,2
Hurricane,Earl,12,1998-09-03T09:00:00Z,NEW YORK CITY NY,0,0,2,7,9
Hurricane,Earl,12,1998-09-03T09:00:00Z,GULF 29N 85W,50,0,0,0,50
Tropical Storm,Earl,13,1998-09-03T15:00:00Z,35.4N  77.2W,27,4,0,0,31
Tropical Storm,Earl,13,1998-09-03T15:00:00Z,BOSTON MA,0,1,9,2,12
Tropical Storm,Earl,13,1998-09-03T15:00:00Z,37.7N  73.3W,1,21,3,0,25
Tropical Storm,Earl,13,1998-09-03T15:00:00Z,PORTLAND ME,0,0,5,4,9
Tropical Storm,Earl,13,1998-09-03T15:00:00Z,39.8N  68.3W,0,3,16,1,20
Tropical Storm,Earl,13,1998-09-03T15:00:00Z,BAR HARBOR ME,0,0,4,5,9
Tropical Storm,Earl,13,1998-09-03T15:00:00Z,JACKSONVILLE FL,47,0,0,0,47
Tropical Storm,Earl,13,1998-09-03T15:00:00Z,EASTPORT ME,0,0,3,6,9
Tropical Storm,Earl,13,1998-09-03T15:00:00Z,SAVANNAH GA,80,0,0,0,80
Tropical Storm,Earl,13,1998-09-03T15:00:00Z,ST JOHN NB,0,0,2,7,9
Tropical Storm,Earl,13,1998-09-03T15:00:00Z,CHARLESTON SC,60,0,0,1,61
Tropical Storm,Earl,13,1998-09-03T15:00:00Z,MONCTON NB,0,0,1,7,8
Tropical Storm,Earl,13,1998-09-03T15:00:00Z,MYRTLE BEACH SC,46,0,0,0,46
Tropical Storm,Earl,13,1998-09-03T15:00:00Z,YARMOUTH NS,0,0,6,7,13
Tropical Storm,Earl,13,1998-09-03T15:00:00Z,WILMINGTON NC,37,0,0,0,37
Tropical Storm,Earl,13,1998-09-03T15:00:00Z,HALIFAX NS,0,0,3,9,12
Tropical Storm,Earl,13,1998-09-03T15:00:00Z,MOREHEAD CITY NC,29,3,0,0,32
Tropical Storm,Earl,13,1998-09-03T15:00:00Z,SABLE ISLAND NS,0,0,1,12,13
Tropical Storm,Earl,13,1998-09-03T15:00:00Z,CAPE HATTERAS NC,19,9,0,1,29
Tropical Storm,Earl,13,1998-09-03T15:00:00Z,SYDNEY NS,0,0,0,9,9
Tropical Storm,Earl,13,1998-09-03T15:00:00Z,NORFOLK VA,12,13,0,0,25
Tropical Storm,Earl,13,1998-09-03T15:00:00Z,EDDY POINT NS,0,0,1,9,10
Tropical Storm,Earl,13,1998-09-03T15:00:00Z,OCEAN CITY MD,2,18,2,0,22
Tropical Storm,Earl,13,1998-09-03T15:00:00Z,PTX BASQUES NFLD,0,0,0,6,6
Tropical Storm,Earl,13,1998-09-03T15:00:00Z,ATLANTIC CITY NJ,0,13,4,0,17
Tropical Storm,Earl,13,1998-09-03T15:00:00Z,BURGEO NFLD,0,0,0,6,6
Tropical Storm,Earl,13,1998-09-03T15:00:00Z,NEW YORK CITY NY,0,7,7,0,14
Tropical Storm,Earl,13,1998-09-03T15:00:00Z,ILE ST PIERRE,0,0,0,8,8
Tropical Storm,Earl,13,1998-09-03T15:00:00Z,MONTAUK POINT NY,0,5,10,1,16
Tropical Storm,Earl,13,1998-09-03T15:00:00Z,CAPE RACE NFLD,0,0,0,7,7
Tropical Storm,Earl,13,1998-09-03T15:00:00Z,PROVIDENCE RI,0,3,9,2,14
Tropical Storm,Earl,13,1998-09-03T15:00:00Z,HIBERNIA OILFLD,0,0,0,4,4
Tropical Storm,Earl,13,1998-09-03T15:00:00Z,NANTUCKET MA,0,3,12,2,17
Tropical Storm,Earl,13,1998-09-03T15:00:00Z,ST MARKS FL,99,0,0,0,99
Tropical Storm,Earl,13,1998-09-03T15:00:00Z,HYANNIS MA,0,2,12,2,16
Tropical Depression,Six,1,1998-09-08T21:00:00Z,26.7N  97.0W,43,0,0,0,43
Tropical Depression,Six,1,1998-09-08T21:00:00Z,FREEPORT TX,9,4,2,2,17
Tropical Depression,Six,1,1998-09-08T21:00:00Z,27.0N  98.0W,28,1,1,1,31
Tropical Depression,Six,1,1998-09-08T21:00:00Z,PORT O CONNOR TX,23,2,1,0,26
Tropical Depression,Six,1,1998-09-08T21:00:00Z,27.5N  99.0W,15,10,1,1,27
Tropical Depression,Six,1,1998-09-08T21:00:00Z,CORPUSCHRISTI TX,30,2,0,1,33
Tropical Depression,Six,1,1998-09-08T21:00:00Z,MMSO 238N 982W,0,1,1,7,9
Tropical Depression,Six,1,1998-09-08T21:00:00Z,BROWNSVILLE TX,28,1,0,1,30
Tropical Depression,Six,1,1998-09-08T21:00:00Z,MMTM 222N 979W,0,0,0,5,5
Tropical Depression,Six,1,1998-09-08T21:00:00Z,GULF 28N 91W,0,0,1,2,3
Tropical Depression,Six,1,1998-09-08T21:00:00Z,MMTX 210N 974W,0,0,0,3,3
Tropical Depression,Six,1,1998-09-08T21:00:00Z,GULF 28N 93W,3,3,2,2,10
Tropical Depression,Six,1,1998-09-08T21:00:00Z,NEW IBERIA LA,0,0,0,3,3
Tropical Depression,Six,1,1998-09-08T21:00:00Z,GULF 28N 95W,28,1,0,0,29
Tropical Depression,Six,1,1998-09-08T21:00:00Z,PORT ARTHUR TX,0,1,2,4,7
Tropical Depression,Six,1,1998-09-08T21:00:00Z,GULF 27N 96W,56,0,0,0,56
Tropical Depression,Six,1,1998-09-08T21:00:00Z,GALVESTON TX,3,4,2,4,13
Tropical Depression,Six,1,1998-09-08T21:00:00Z,GULF 25N 96W,48,0,0,0,48
Tropical Depression,Six,2,1998-09-09T03:00:00Z,26.2N  96.4W,45,0,0,0,45
Tropical Depression,Six,2,1998-09-09T03:00:00Z,FREEPORT TX,3,5,5,3,16
Tropical Depression,Six,2,1998-09-09T03:00:00Z,26.8N  97.6W,30,3,0,0,33
Tropical Depression,Six,2,1998-09-09T03:00:00Z,PORT O CONNOR TX,10,8,3,1,22
Tropical Depression,Six,2,1998-09-09T03:00:00Z,27.5N  99.0W,6,19,1,1,27
Tropical Depression,Six,2,1998-09-09T03:00:00Z,CORPUSCHRISTI TX,15,12,1,1,29
Tropical Depression,Six,2,1998-09-09T03:00:00Z,MMSO 238N 982W,1,0,1,7,9
Tropical Depression,Six,2,1998-09-09T03:00:00Z,BROWNSVILLE TX,29,1,0,1,31
Tropical Depression,Six,2,1998-09-09T03:00:00Z,MMTM 222N 979W,0,0,0,5,5
Tropical Depression,Six,2,1998-09-09T03:00:00Z,GULF 28N 91W,0,0,1,2,3
Tropical Depression,Six,2,1998-09-09T03:00:00Z,MMTX 210N 974W,0,0,0,3,3
Tropical Depression,Six,2,1998-09-09T03:00:00Z,GULF 28N 93W,3,4,2,2,11
Tropical Depression,Six,2,1998-09-09T03:00:00Z,NEW IBERIA LA,0,0,0,2,2
Tropical Depression,Six,2,1998-09-09T03:00:00Z,GULF 28N 95W,20,1,1,1,23
Tropical Depression,Six,2,1998-09-09T03:00:00Z,PORT ARTHUR TX,0,0,3,4,7
Tropical Depression,Six,2,1998-09-09T03:00:00Z,GULF 27N 96W,40,1,0,0,41
Tropical Depression,Six,2,1998-09-09T03:00:00Z,GALVESTON TX,1,3,5,3,12
Tropical Depression,Six,2,1998-09-09T03:00:00Z,GULF 25N 96W,40,0,0,0,40
Tropical Depression,Six,3,1998-09-09T09:00:00Z,26.2N  96.6W,43,0,0,0,43
Tropical Depression,Six,3,1998-09-09T09:00:00Z,FREEPORT TX,6,5,3,3,17
Tropical Depression,Six,3,1998-09-09T09:00:00Z,26.5N  97.6W,27,1,1,0,29
Tropical Depression,Six,3,1998-09-09T09:00:00Z,PORT O CONNOR TX,13,5,2,2,22
Tropical Depression,Six,3,1998-09-09T09:00:00Z,26.8N  98.7W,15,7,2,1,25
Tropical Depression,Six,3,1998-09-09T09:00:00Z,CORPUSCHRISTI TX,17,6,2,1,26
Tropical Depression,Six,3,1998-09-09T09:00:00Z,MMSO 238N 982W,2,1,1,6,10
Tropical Depression,Six,3,1998-09-09T09:00:00Z,BROWNSVILLE TX,28,0,1,0,29
Tropical Depression,Six,3,1998-09-09T09:00:00Z,MMTM 222N 979W,0,0,0,5,5
Tropical Depression,Six,3,1998-09-09T09:00:00Z,GULF 28N 89W,0,0,0,2,2
Tropical Depression,Six,3,1998-09-09T09:00:00Z,MMTX 210N 974W,0,0,0,3,3
Tropical Depression,Six,3,1998-09-09T09:00:00Z,GULF 28N 91W,0,1,2,2,5
Tropical Depression,Six,3,1998-09-09T09:00:00Z,BURAS LA,0,0,0,2,2
Tropical Depression,Six,3,1998-09-09T09:00:00Z,GULF 28N 93W,5,4,2,2,13
Tropical Depression,Six,3,1998-09-09T09:00:00Z,NEW ORLEANS LA,0,0,0,2,2
Tropical Depression,Six,3,1998-09-09T09:00:00Z,GULF 28N 95W,18,2,1,1,22
Tropical Depression,Six,3,1998-09-09T09:00:00Z,NEW IBERIA LA,0,0,1,3,4
Tropical Depression,Six,3,1998-09-09T09:00:00Z,GULF 27N 96W,37,0,0,0,37
Tropical Depression,Six,3,1998-09-09T09:00:00Z,PORT ARTHUR TX,0,2,2,5,9
Tropical Depression,Six,3,1998-09-09T09:00:00Z,GULF 25N 96W,50,0,0,0,50
Tropical Depression,Six,3,1998-09-09T09:00:00Z,GALVESTON TX,3,4,3,4,14
Tropical Depression,Six,4,1998-09-09T15:00:00Z,26.2N  96.6W,48,0,0,0,48
Tropical Depression,Six,4,1998-09-09T15:00:00Z,FREEPORT TX,4,6,3,3,16
Tropical Depression,Six,4,1998-09-09T15:00:00Z,26.5N  97.6W,28,1,1,0,30
Tropical Depression,Six,4,1998-09-09T15:00:00Z,PORT O CONNOR TX,13,6,2,1,22
Tropical Depression,Six,4,1998-09-09T15:00:00Z,26.8N  98.7W,15,8,1,2,26
Tropical Depression,Six,4,1998-09-09T15:00:00Z,CORPUSCHRISTI TX,18,8,1,1,28
Tropical Depression,Six,4,1998-09-09T15:00:00Z,MMSO 238N 982W,1,1,2,6,10
Tropical Depression,Six,4,1998-09-09T15:00:00Z,BROWNSVILLE TX,28,1,0,1,30
Tropical Depression,Six,4,1998-09-09T15:00:00Z,MMTM 222N 979W,0,0,0,6,6
Tropical Depression,Six,4,1998-09-09T15:00:00Z,GULF 28N 89W,0,0,0,2,2
Tropical Depression,Six,4,1998-09-09T15:00:00Z,MMTX 210N 974W,0,0,0,4,4
Tropical Depression,Six,4,1998-09-09T15:00:00Z,GULF 28N 91W,0,1,1,3,5
Tropical Depression,Six,4,1998-09-09T15:00:00Z,MMVR 192N 961W,0,0,0,2,2
Tropical Depression,Six,4,1998-09-09T15:00:00Z,GULF 28N 93W,4,3,3,2,12
Tropical Depression,Six,4,1998-09-09T15:00:00Z,NEW ORLEANS LA,0,0,0,2,2
Tropical Depression,Six,4,1998-09-09T15:00:00Z,GULF 28N 95W,17,3,1,1,22
Tropical Depression,Six,4,1998-09-09T15:00:00Z,NEW IBERIA LA,0,0,0,3,3
Tropical Depression,Six,4,1998-09-09T15:00:00Z,GULF 27N 96W,41,0,1,0,42
Tropical Depression,Six,4,1998-09-09T15:00:00Z,PORT ARTHUR TX,0,1,2,4,7
Tropical Depression,Six,4,1998-09-09T15:00:00Z,GULF 25N 96W,44,0,0,0,44
Tropical Depression,Six,4,1998-09-09T15:00:00Z,GALVESTON TX,2,4,3,4,13
Tropical Storm,Frances,5,1998-09-09T21:00:00Z,26.2N  96.6W,49,0,0,0,49
Tropical Storm,Frances,5,1998-09-09T21:00:00Z,FREEPORT TX,6,5,3,2,16
Tropical Storm,Frances,5,1998-09-09T21:00:00Z,26.5N  97.6W,29,1,1,0,31
Tropical Storm,Frances,5,1998-09-09T21:00:00Z,PORT O CONNOR TX,14,5,1,2,22
Tropical Storm,Frances,5,1998-09-09T21:00:00Z,26.8N  98.7W,16,6,2,1,25
Tropical Storm,Frances,5,1998-09-09T21:00:00Z,CORPUSCHRISTI TX,19,5,1,1,26
Tropical Storm,Frances,5,1998-09-09T21:00:00Z,MMSO 238N 982W,2,1,2,6,11
Tropical Storm,Frances,5,1998-09-09T21:00:00Z,BROWNSVILLE TX,29,1,0,1,31
Tropical Storm,Frances,5,1998-09-09T21:00:00Z,MMTM 222N 979W,0,0,0,6,6
Tropical Storm,Frances,5,1998-09-09T21:00:00Z,GULF 28N 91W,0,1,1,3,5
Tropical Storm,Frances,5,1998-09-09T21:00:00Z,MMTX 210N 974W,0,0,0,3,3
Tropical Storm,Frances,5,1998-09-09T21:00:00Z,GULF 28N 93W,3,4,2,3,12
Tropical Storm,Frances,5,1998-09-09T21:00:00Z,NEW ORLEANS LA,0,0,0,2,2
Tropical Storm,Frances,5,1998-09-09T21:00:00Z,GULF 28N 95W,17,3,1,1,22
Tropical Storm,Frances,5,1998-09-09T21:00:00Z,NEW IBERIA LA,0,0,1,3,4
Tropical Storm,Frances,5,1998-09-09T21:00:00Z,GULF 27N 96W,43,0,0,0,43
Tropical Storm,Frances,5,1998-09-09T21:00:00Z,PORT ARTHUR TX,0,1,3,4,8
Tropical Storm,Frances,5,1998-09-09T21:00:00Z,GULF 25N 96W,48,0,0,0,48
Tropical Storm,Frances,5,1998-09-09T21:00:00Z,GALVESTON TX,2,5,3,3,13
Tropical Storm,Frances,6,1998-09-10T03:00:00Z,24.0N  96.5W,99,0,0,0,99
Tropical Storm,Frances,6,1998-09-10T03:00:00Z,FREEPORT TX,0,1,3,5,9
Tropical Storm,Frances,6,1998-09-10T03:00:00Z,24.5N  97.5W,28,1,1,0,30
Tropical Storm,Frances,6,1998-09-10T03:00:00Z,PORT O CONNOR TX,0,4,5,4,13
Tropical Storm,Frances,6,1998-09-10T03:00:00Z,25.3N  98.5W,10,9,2,2,23
Tropical Storm,Frances,6,1998-09-10T03:00:00Z,CORPUSCHRISTI TX,1,8,5,3,17
Tropical Storm,Frances,6,1998-09-10T03:00:00Z,MMSO 238N 982W,17,3,2,1,23
Tropical Storm,Frances,6,1998-09-10T03:00:00Z,BROWNSVILLE TX,16,6,2,1,25
Tropical Storm,Frances,6,1998-09-10T03:00:00Z,MMTM 222N 979W,8,4,3,2,17
Tropical Storm,Frances,6,1998-09-10T03:00:00Z,GULF 28N 93W,0,0,1,2,3
Tropical Storm,Frances,6,1998-09-10T03:00:00Z,MMTX 210N 974W,1,4,3,3,11
Tropical Storm,Frances,6,1998-09-10T03:00:00Z,GULF 28N 95W,0,2,3,5,10
Tropical Storm,Frances,6,1998-09-10T03:00:00Z,MMVR 192N 961W,0,0,1,3,4
Tropical Storm,Frances,6,1998-09-10T03:00:00Z,GULF 27N 96W,4,7,3,3,17
Tropical Storm,Frances,6,1998-09-10T03:00:00Z,PORT ARTHUR TX,0,0,0,4,4
Tropical Storm,Frances,6,1998-09-10T03:00:00Z,GULF 25N 96W,34,0,0,0,34
Tropical Storm,Frances,6,1998-09-10T03:00:00Z,GALVESTON TX,0,0,2,5,7
Tropical Storm,Frances,7,1998-09-10T09:00:00Z,24.3N  96.3W,55,0,0,0,55
Tropical Storm,Frances,7,1998-09-10T09:00:00Z,FREEPORT TX,0,2,4,5,11
Tropical Storm,Frances,7,1998-09-10T09:00:00Z,24.8N  97.0W,34,1,0,0,35
Tropical Storm,Frances,7,1998-09-10T09:00:00Z,PORT O CONNOR TX,0,5,5,4,14
Tropical Storm,Frances,7,1998-09-10T09:00:00Z,25.4N  97.9W,16,5,2,1,24
Tropical Storm,Frances,7,1998-09-10T09:00:00Z,CORPUSCHRISTI TX,0,8,5,4,17
Tropical Storm,Frances,7,1998-09-10T09:00:00Z,MMSO 238N 982W,16,3,1,1,21
Tropical Storm,Frances,7,1998-09-10T09:00:00Z,BROWNSVILLE TX,15,6,2,1,24
Tropical Storm,Frances,7,1998-09-10T09:00:00Z,MMTM 222N 979W,6,3,2,2,13
Tropical Storm,Frances,7,1998-09-10T09:00:00Z,GULF 28N 89W,0,0,0,2,2
Tropical Storm,Frances,7,1998-09-10T09:00:00Z,MMTX 210N 974W,1,1,1,5,8
Tropical Storm,Frances,7,1998-09-10T09:00:00Z,GULF 28N 91W,0,0,1,3,4
Tropical Storm,Frances,7,1998-09-10T09:00:00Z,MMVR 192N 961W,0,0,0,3,3
Tropical Storm,Frances,7,1998-09-10T09:00:00Z,GULF 28N 93W,0,2,3,4,9
Tropical Storm,Frances,7,1998-09-10T09:00:00Z,NEW ORLEANS LA,0,0,0,2,2
Tropical Storm,Frances,7,1998-09-10T09:00:00Z,GULF 28N 95W,1,5,4,4,14
Tropical Storm,Frances,7,1998-09-10T09:00:00Z,NEW IBERIA LA,0,0,0,3,3
Tropical Storm,Frances,7,1998-09-10T09:00:00Z,GULF 27N 96W,6,8,3,2,19
Tropical Storm,Frances,7,1998-09-10T09:00:00Z,PORT ARTHUR TX,0,0,2,4,6
Tropical Storm,Frances,7,1998-09-10T09:00:00Z,GULF 25N 96W,44,0,0,0,44
Tropical Storm,Frances,7,1998-09-10T09:00:00Z,GALVESTON TX,0,1,3,5,9
Tropical Storm,Frances,8,1998-09-10T15:00:00Z,25.9N  96.5W,99,0,0,0,99
Tropical Storm,Frances,8,1998-09-10T15:00:00Z,FREEPORT TX,1,3,3,4,11
Tropical Storm,Frances,8,1998-09-10T15:00:00Z,26.0N  97.2W,32,1,0,1,34
Tropical Storm,Frances,8,1998-09-10T15:00:00Z,PORT O CONNOR TX,6,6,3,3,18
Tropical Storm,Frances,8,1998-09-10T15:00:00Z,26.2N  98.0W,20,3,2,1,26
Tropical Storm,Frances,8,1998-09-10T15:00:00Z,CORPUSCHRISTI TX,11,8,3,1,23
Tropical Storm,Frances,8,1998-09-10T15:00:00Z,MMSO 238N 982W,2,2,5,6,15
Tropical Storm,Frances,8,1998-09-10T15:00:00Z,BROWNSVILLE TX,27,1,1,1,30
Tropical Storm,Frances,8,1998-09-10T15:00:00Z,MMTM 222N 979W,0,0,2,8,10
Tropical Storm,Frances,8,1998-09-10T15:00:00Z,GULF 28N 93W,1,1,1,3,6
Tropical Storm,Frances,8,1998-09-10T15:00:00Z,MMTX 210N 974W,0,0,0,7,7
Tropical Storm,Frances,8,1998-09-10T15:00:00Z,GULF 28N 95W,8,4,2,2,16
Tropical Storm,Frances,8,1998-09-10T15:00:00Z,MMVR 192N 961W,0,0,0,3,3
Tropical Storm,Frances,8,1998-09-10T15:00:00Z,GULF 27N 96W,30,1,0,1,32
Tropical Storm,Frances,8,1998-09-10T15:00:00Z,PORT ARTHUR TX,0,0,0,3,3
Tropical Storm,Frances,8,1998-09-10T15:00:00Z,GULF 25N 96W,99,0,0,0,99
Tropical Storm,Frances,8,1998-09-10T15:00:00Z,GALVESTON TX,0,1,2,4,7
Tropical Storm,Frances,9,1998-09-10T21:00:00Z,27.6N  97.0W,46,0,0,0,46
Tropical Storm,Frances,9,1998-09-10T21:00:00Z,FREEPORT TX,21,1,1,1,24
Tropical Storm,Frances,9,1998-09-10T21:00:00Z,28.0N  98.0W,29,2,0,1,32
Tropical Storm,Frances,9,1998-09-10T21:00:00Z,PORT O CONNOR TX,37,1,0,0,38
Tropical Storm,Frances,9,1998-09-10T21:00:00Z,28.5N  99.0W,15,11,1,1,28
Tropical Storm,Frances,9,1998-09-10T21:00:00Z,CORPUSCHRISTI TX,35,1,0,0,36
Tropical Storm,Frances,9,1998-09-10T21:00:00Z,MMSO 238N 982W,0,0,0,6,6
Tropical Storm,Frances,9,1998-09-10T21:00:00Z,BROWNSVILLE TX,22,0,0,1,23
Tropical Storm,Frances,9,1998-09-10T21:00:00Z,MMTM 222N 979W,0,0,0,3,3
Tropical Storm,Frances,9,1998-09-10T21:00:00Z,GULF 28N 91W,0,0,1,1,2
Tropical Storm,Frances,9,1998-09-10T21:00:00Z,MMTX 210N 974W,0,0,0,2,2
Tropical Storm,Frances,9,1998-09-10T21:00:00Z,GULF 28N 93W,4,3,1,2,10
Tropical Storm,Frances,9,1998-09-10T21:00:00Z,NEW IBERIA LA,0,0,0,3,3
Tropical Storm,Frances,9,1998-09-10T21:00:00Z,GULF 28N 95W,67,0,0,0,67
Tropical Storm,Frances,9,1998-09-10T21:00:00Z,PORT ARTHUR TX,1,2,2,4,9
Tropical Storm,Frances,9,1998-09-10T21:00:00Z,GULF 27N 96W,99,0,0,0,99
Tropical Storm,Frances,9,1998-09-10T21:00:00Z,GALVESTON TX,12,2,2,1,17
Tropical Storm,Frances,9,1998-09-10T21:00:00Z,GULF 25N 96W,16,0,0,1,17
Tropical Storm,Frances,10,1998-09-11T03:00:00Z,29.3N  97.2W,47,0,0,0,47
Tropical Storm,Frances,10,1998-09-11T03:00:00Z,FREEPORT TX,52,0,0,0,52
Tropical Storm,Frances,10,1998-09-11T03:00:00Z,30.0N  98.0W,29,1,1,0,31
Tropical Storm,Frances,10,1998-09-11T03:00:00Z,PORT O CONNOR TX,99,0,0,0,99
Tropical Storm,Frances,10,1998-09-11T03:00:00Z,30.5N  99.0W,18,8,2,1,29
Tropical Storm,Frances,10,1998-09-11T03:00:00Z,CORPUSCHRISTI TX,32,0,0,0,32
Tropical Storm,Frances,10,1998-09-11T03:00:00Z,MMSO 238N 982W,0,0,0,5,5
Tropical Storm,Frances,10,1998-09-11T03:00:00Z,BROWNSVILLE TX,2,1,2,5,10
Tropical Storm,Frances,10,1998-09-11T03:00:00Z,MMTM 222N 979W,0,0,0,2,2
Tropical Storm,Frances,10,1998-09-11T03:00:00Z,GULF 28N 93W,3,1,1,2,7
Tropical Storm,Frances,10,1998-09-11T03:00:00Z,NEW IBERIA LA,0,0,0,3,3
Tropical Storm,Frances,10,1998-09-11T03:00:00Z,GULF 28N 95W,99,0,0,0,99
Tropical Storm,Frances,10,1998-09-11T03:00:00Z,PORT ARTHUR TX,8,2,1,2,13
Tropical Storm,Frances,10,1998-09-11T03:00:00Z,GULF 27N 96W,99,0,0,0,99
Tropical Storm,Frances,10,1998-09-11T03:00:00Z,GALVESTON TX,26,0,0,1,27
Tropical Storm,Frances,10,1998-09-11T03:00:00Z,GULF 25N 96W,0,1,1,4,6
Tropical Storm,Frances,11,1998-09-11T09:00:00Z,30.0N 100.0W,44,1,0,0,45
Tropical Storm,Frances,11,1998-09-11T09:00:00Z,PORT O CONNOR TX,99,0,0,0,99
Tropical Storm,Frances,11,1998-09-11T09:00:00Z,30.5N 101.0W,30,2,0,0,32
Tropical Storm,Frances,11,1998-09-11T09:00:00Z,CORPUSCHRISTI TX,99,0,0,0,99
Tropical Storm,Frances,11,1998-09-11T09:00:00Z,31.0N 102.0W,15,10,1,0,26
Tropical Storm,Frances,11,1998-09-11T09:00:00Z,GULF 28N 95W,0,1,1,0,2
Tropical Storm,Frances,11,1998-09-11T09:00:00Z,GALVESTON TX,0,1,2,0,3
Tropical Storm,Frances,11,1998-09-11T09:00:00Z,GULF 27N 96W,0,0,2,0,2
Tropical Storm,Frances,11,1998-09-11T09:00:00Z,FREEPORT TX,13,1,0,0,14
Tropical Depression,Seven,1,1998-09-15T15:00:00Z,9.0N  32.0W,41,2,0,0,43
Tropical Depression,Seven,1,1998-09-15T15:00:00Z,10.0N  39.0W,0,1,21,1,23
Tropical Depression,Seven,1,1998-09-15T15:00:00Z,9.5N  35.5W,0,29,1,1,31
Tropical Depression,Seven,3,1998-09-16T03:00:00Z,10.6N  33.5W,42,2,0,0,44
Tropical Depression,Seven,3,1998-09-16T03:00:00Z,11.6N  39.1W,0,3,19,1,23
Tropical Depression,Seven,3,1998-09-16T03:00:00Z,11.0N  36.3W,0,29,1,0,30
Tropical Depression,Seven,4,1998-09-16T09:00:00Z,10.6N  35.9W,47,1,0,0,48
Tropical Depression,Seven,4,1998-09-16T09:00:00Z,12.0N  42.0W,0,2,20,1,23
Tropical Depression,Seven,4,1998-09-16T09:00:00Z,11.3N  38.9W,0,30,1,0,31
Tropical Storm,Georges,5,1998-09-16T15:00:00Z,11.2N  38.0W,47,1,0,0,48
Tropical Storm,Georges,5,1998-09-16T15:00:00Z,12.2N  44.0W,0,2,20,1,23
Tropical Storm,Georges,5,1998-09-16T15:00:00Z,11.5N  41.0W,0,30,1,0,31
Tropical Storm,Georges,6,1998-09-16T21:00:00Z,11.3N  39.6W,44,1,0,0,45
Tropical Storm,Georges,6,1998-09-16T21:00:00Z,12.0N  46.0W,0,1,20,1,22
Tropical Storm,Georges,6,1998-09-16T21:00:00Z,11.8N  42.8W,0,29,1,0,30
Tropical Storm,Georges,7,1998-09-17T03:00:00Z,11.6N  41.4W,48,1,0,0,49
Tropical Storm,Georges,7,1998-09-17T03:00:00Z,12.8N  47.7W,0,2,19,2,23
Tropical Storm,Georges,7,1998-09-17T03:00:00Z,12.1N  44.7W,0,30,1,0,31
Tropical Storm,Georges,7,1998-09-17T03:00:00Z,TBPB 131N 595W,0,0,0,2,2
Tropical Storm,Georges,8,1998-09-17T09:00:00Z,12.3N  43.2W,44,1,0,0,45
Tropical Storm,Georges,8,1998-09-17T09:00:00Z,TFFF 146N 610W,0,0,0,2,2
Tropical Storm,Georges,8,1998-09-17T09:00:00Z,12.8N  46.3W,0,29,1,0,30
Tropical Storm,Georges,8,1998-09-17T09:00:00Z,TDPR 153N 614W,0,0,0,2,2
Tropical Storm,Georges,8,1998-09-17T09:00:00Z,13.5N  49.5W,0,1,21,1,23
Tropical Storm,Georges,8,1998-09-17T09:00:00Z,TFFR 163N 615W,0,0,0,2,2
Tropical Storm,Georges,8,1998-09-17T09:00:00Z,TBPB 131N 595W,0,0,0,5,5
Tropical Storm,Georges,8,1998-09-17T09:00:00Z,TAPA 171N 618W,0,0,0,2,2
Tropical Storm,Georges,8,1998-09-17T09:00:00Z,TLPL 138N 610W,0,0,0,2,2
Tropical Storm,Georges,9,1998-09-17T15:00:00Z,12.7N  44.9W,44,0,1,0,45
Tropical Storm,Georges,9,1998-09-17T15:00:00Z,TFFF 146N 610W,0,0,0,9,9
Tropical Storm,Georges,9,1998-09-17T15:00:00Z,13.2N  48.1W,0,30,1,0,31
Tropical Storm,Georges,9,1998-09-17T15:00:00Z,TDPR 153N 614W,0,0,0,9,9
Tropical Storm,Georges,9,1998-09-17T15:00:00Z,14.0N  51.5W,0,1,22,0,23
Tropical Storm,Georges,9,1998-09-17T15:00:00Z,TFFR 163N 615W,0,0,0,9,9
Tropical Storm,Georges,9,1998-09-17T15:00:00Z,TTPP 106N 614W,0,0,0,4,4
Tropical Storm,Georges,9,1998-09-17T15:00:00Z,TAPA 171N 618W,0,0,0,8,8
Tropical Storm,Georges,9,1998-09-17T15:00:00Z,TTPT 112N 608W,0,0,0,6,6
Tropical Storm,Georges,9,1998-09-17T15:00:00Z,TKPK 173N 627W,0,0,0,6,6
Tropical Storm,Georges,9,1998-09-17T15:00:00Z,TGPY 120N 618W,0,0,0,5,5
Tropical Storm,Georges,9,1998-09-17T15:00:00Z,TNCM 181N 631W,0,0,0,4,4
Tropical Storm,Georges,9,1998-09-17T15:00:00Z,TBPB 131N 595W,0,0,0,11,11
Tropical Storm,Georges,9,1998-09-17T15:00:00Z,TISX 177N 648W,0,0,0,2,2
Tropical Storm,Georges,9,1998-09-17T15:00:00Z,TVSV 131N 612W,0,0,0,7,7
Tropical Storm,Georges,9,1998-09-17T15:00:00Z,ST CROIX VI,0,0,0,2,2
Tropical Storm,Georges,9,1998-09-17T15:00:00Z,TLPL 138N 610W,0,0,0,9,9
Hurricane,Georges,10,1998-09-17T21:00:00Z,13.2N  47.2W,48,1,0,0,49
Hurricane,Georges,10,1998-09-17T21:00:00Z,TFFR 163N 615W,0,0,0,13,13
Hurricane,Georges,10,1998-09-17T21:00:00Z,14.0N  51.0W,0,30,1,0,31
Hurricane,Georges,10,1998-09-17T21:00:00Z,TAPA 171N 618W,0,0,0,12,12
Hurricane,Georges,10,1998-09-17T21:00:00Z,15.0N  54.0W,0,1,20,1,22
Hurricane,Georges,10,1998-09-17T21:00:00Z,TKPK 173N 627W,0,0,0,11,11
Hurricane,Georges,10,1998-09-17T21:00:00Z,SVMG 110N 640W,0,0,0,3,3
Hurricane,Georges,10,1998-09-17T21:00:00Z,TNCM 181N 631W,0,0,0,9,9
Hurricane,Georges,10,1998-09-17T21:00:00Z,TTPP 106N 614W,0,0,0,7,7
Hurricane,Georges,10,1998-09-17T21:00:00Z,TISX 177N 648W,0,0,0,6,6
Hurricane,Georges,10,1998-09-17T21:00:00Z,TTPT 112N 608W,0,0,0,9,9
Hurricane,Georges,10,1998-09-17T21:00:00Z,TIST 183N 650W,0,0,0,5,5
Hurricane,Georges,10,1998-09-17T21:00:00Z,TGPY 120N 618W,0,0,0,9,9
Hurricane,Georges,10,1998-09-17T21:00:00Z,TJPS 180N 666W,0,0,0,2,2
Hurricane,Georges,10,1998-09-17T21:00:00Z,TBPB 131N 595W,0,0,0,14,14
Hurricane,Georges,10,1998-09-17T21:00:00Z,TJSJ 184N 661W,0,0,0,3,3
Hurricane,Georges,10,1998-09-17T21:00:00Z,TVSV 131N 612W,0,0,0,11,11
Hurricane,Georges,10,1998-09-17T21:00:00Z,ST CROIX VI,0,0,0,6,6
Hurricane,Georges,10,1998-09-17T21:00:00Z,TLPL 138N 610W,0,0,0,13,13
Hurricane,Georges,10,1998-09-17T21:00:00Z,ST THOMAS VI,0,0,0,5,5
Hurricane,Georges,10,1998-09-17T21:00:00Z,TFFF 146N 610W,0,0,0,13,13
Hurricane,Georges,10,1998-09-17T21:00:00Z,SAN JUAN PR,0,0,0,3,3
Hurricane,Georges,10,1998-09-17T21:00:00Z,TDPR 153N 614W,0,0,0,13,13
Hurricane,Georges,10,1998-09-17T21:00:00Z,PONCE PR,0,0,0,2,2
Hurricane,Georges,11,1998-09-18T03:00:00Z,13.2N  49.6W,41,3,0,0,44
Hurricane,Georges,11,1998-09-18T03:00:00Z,TFFR 163N 615W,0,0,0,16,16
Hurricane,Georges,11,1998-09-18T03:00:00Z,13.9N  53.2W,0,28,1,1,30
Hurricane,Georges,11,1998-09-18T03:00:00Z,TAPA 171N 618W,0,0,0,15,15
Hurricane,Georges,11,1998-09-18T03:00:00Z,14.3N  56.2W,0,2,19,1,22
Hurricane,Georges,11,1998-09-18T03:00:00Z,TKPK 173N 627W,0,0,0,14,14
Hurricane,Georges,11,1998-09-18T03:00:00Z,SVMG 110N 640W,0,0,0,7,7
Hurricane,Georges,11,1998-09-18T03:00:00Z,TNCM 181N 631W,0,0,0,13,13
Hurricane,Georges,11,1998-09-18T03:00:00Z,TTPP 106N 614W,0,0,0,11,11
Hurricane,Georges,11,1998-09-18T03:00:00Z,TISX 177N 648W,0,0,0,11,11
Hurricane,Georges,11,1998-09-18T03:00:00Z,TTPT 112N 608W,0,0,1,12,13
Hurricane,Georges,11,1998-09-18T03:00:00Z,TIST 183N 650W,0,0,0,10,10
Hurricane,Georges,11,1998-09-18T03:00:00Z,TGPY 120N 618W,0,0,0,13,13
Hurricane,Georges,11,1998-09-18T03:00:00Z,TJPS 180N 666W,0,0,0,6,6
Hurricane,Georges,11,1998-09-18T03:00:00Z,TBPB 131N 595W,0,0,4,14,18
Hurricane,Georges,11,1998-09-18T03:00:00Z,TJSJ 184N 661W,0,0,0,8,8
Hurricane,Georges,11,1998-09-18T03:00:00Z,TVSV 131N 612W,0,0,0,16,16
Hurricane,Georges,11,1998-09-18T03:00:00Z,ST CROIX VI,0,0,0,11,11
Hurricane,Georges,11,1998-09-18T03:00:00Z,TLPL 138N 610W,0,0,1,15,16
Hurricane,Georges,11,1998-09-18T03:00:00Z,ST THOMAS VI,0,0,0,10,10
Hurricane,Georges,11,1998-09-18T03:00:00Z,TFFF 146N 610W,0,0,1,16,17
Hurricane,Georges,11,1998-09-18T03:00:00Z,SAN JUAN PR,0,0,0,8,8
Hurricane,Georges,11,1998-09-18T03:00:00Z,TDPR 153N 614W,0,0,0,16,16
Hurricane,Georges,11,1998-09-18T03:00:00Z,PONCE PR,0,0,0,6,6
Hurricane,Georges,12,1998-09-18T09:00:00Z,13.8N  52.3W,41,5,0,0,46
Hurricane,Georges,12,1998-09-18T09:00:00Z,TNCM 181N 631W,0,0,8,13,21
Hurricane,Georges,12,1998-09-18T09:00:00Z,14.4N  56.3W,0,32,3,0,35
Hurricane,Georges,12,1998-09-18T09:00:00Z,TISX 177N 648W,0,0,2,19,21
Hurricane,Georges,12,1998-09-18T09:00:00Z,15.1N  60.4W,0,0,27,2,29
Hurricane,Georges,12,1998-09-18T09:00:00Z,TIST 183N 650W,0,0,1,19,20
Hurricane,Georges,12,1998-09-18T09:00:00Z,SKPG 125N 717W,0,0,0,4,4
Hurricane,Georges,12,1998-09-18T09:00:00Z,TJPS 180N 666W,0,0,0,20,20
Hurricane,Georges,12,1998-09-18T09:00:00Z,TNCC 122N 690W,0,0,0,9,9
Hurricane,Georges,12,1998-09-18T09:00:00Z,MDSD 185N 697W,0,0,0,16,16
Hurricane,Georges,12,1998-09-18T09:00:00Z,SVMG 110N 640W,0,0,1,11,12
Hurricane,Georges,12,1998-09-18T09:00:00Z,MDCB 176N 714W,0,0,0,12,12
Hurricane,Georges,12,1998-09-18T09:00:00Z,TTPP 106N 614W,0,0,5,8,13
Hurricane,Georges,12,1998-09-18T09:00:00Z,MTPP 186N 724W,0,0,0,9,9
Hurricane,Georges,12,1998-09-18T09:00:00Z,TTPT 112N 608W,0,0,11,5,16
Hurricane,Georges,12,1998-09-18T09:00:00Z,MTCA 183N 738W,0,0,0,4,4
Hurricane,Georges,12,1998-09-18T09:00:00Z,TGPY 120N 618W,0,0,9,9,18
Hurricane,Georges,12,1998-09-18T09:00:00Z,MUGM 200N 751W,0,0,0,2,2
Hurricane,Georges,12,1998-09-18T09:00:00Z,TBPB 131N 595W,0,2,24,1,27
Hurricane,Georges,12,1998-09-18T09:00:00Z,TJSJ 184N 661W,0,0,0,19,19
Hurricane,Georges,12,1998-09-18T09:00:00Z,TVSV 131N 612W,0,0,19,5,24
Hurricane,Georges,12,1998-09-18T09:00:00Z,MDPP 198N 707W,0,0,0,13,13
Hurricane,Georges,12,1998-09-18T09:00:00Z,TLPL 138N 610W,0,0,22,4,26
Hurricane,Georges,12,1998-09-18T09:00:00Z,MBJT 215N 712W,0,0,0,9,9
Hurricane,Georges,12,1998-09-18T09:00:00Z,TFFF 146N 610W,0,0,24,3,27
Hurricane,Georges,12,1998-09-18T09:00:00Z,MYMM 224N 730W,0,0,0,4,4
Hurricane,Georges,12,1998-09-18T09:00:00Z,TDPR 153N 614W,0,0,23,4,27
Hurricane,Georges,12,1998-09-18T09:00:00Z,ST CROIX VI,0,0,2,19,21
Hurricane,Georges,12,1998-09-18T09:00:00Z,TFFR 163N 615W,0,0,21,5,26
Hurricane,Georges,12,1998-09-18T09:00:00Z,ST THOMAS VI,0,0,1,19,20
Hurricane,Georges,12,1998-09-18T09:00:00Z,TAPA 171N 618W,0,0,17,7,24
Hurricane,Georges,12,1998-09-18T09:00:00Z,SAN JUAN PR,0,0,0,19,19
Hurricane,Georges,12,1998-09-18T09:00:00Z,TKPK 173N 627W,0,0,12,11,23
Hurricane,Georges,12,1998-09-18T09:00:00Z,PONCE PR,0,0,0,20,20
Hurricane,Georges,13,1998-09-18T15:00:00Z,13.7N  52.9W,55,3,0,0,58
Hurricane,Georges,13,1998-09-18T15:00:00Z,TAPA 171N 618W,0,0,10,9,19
Hurricane,Georges,13,1998-09-18T15:00:00Z,14.3N  56.6W,0,34,1,0,35
Hurricane,Georges,13,1998-09-18T15:00:00Z,TKPK 173N 627W,0,0,5,13,18
Hurricane,Georges,13,1998-09-18T15:00:00Z,15.0N  60.0W,0,3,21,1,25
Hurricane,Georges,13,1998-09-18T15:00:00Z,TNCM 181N 631W,0,0,2,14,16
Hurricane,Georges,13,1998-09-18T15:00:00Z,SKPG 125N 717W,0,0,0,2,2
Hurricane,Georges,13,1998-09-18T15:00:00Z,TISX 177N 648W,0,0,1,16,17
Hurricane,Georges,13,1998-09-18T15:00:00Z,TNCC 122N 690W,0,0,0,5,5
Hurricane,Georges,13,1998-09-18T15:00:00Z,TIST 183N 650W,0,0,0,15,15
Hurricane,Georges,13,1998-09-18T15:00:00Z,SVMG 110N 640W,0,0,1,5,6
Hurricane,Georges,13,1998-09-18T15:00:00Z,TJPS 180N 666W,0,0,0,14,14
Hurricane,Georges,13,1998-09-18T15:00:00Z,TTPP 106N 614W,0,0,2,2,4
Hurricane,Georges,13,1998-09-18T15:00:00Z,MDSD 185N 697W,0,0,0,7,7
Hurricane,Georges,13,1998-09-18T15:00:00Z,TTPT 112N 608W,0,0,4,3,7
Hurricane,Georges,13,1998-09-18T15:00:00Z,MDCB 176N 714W,0,0,0,4,4
Hurricane,Georges,13,1998-09-18T15:00:00Z,TGPY 120N 618W,0,0,6,5,11
Hurricane,Georges,13,1998-09-18T15:00:00Z,MTPP 186N 724W,0,0,0,2,2
Hurricane,Georges,13,1998-09-18T15:00:00Z,TBPB 131N 595W,0,5,15,1,21
Hurricane,Georges,13,1998-09-18T15:00:00Z,TJSJ 184N 661W,0,0,0,14,14
Hurricane,Georges,13,1998-09-18T15:00:00Z,TVSV 131N 612W,0,0,14,4,18
Hurricane,Georges,13,1998-09-18T15:00:00Z,MDPP 198N 707W,0,0,0,3,3
Hurricane,Georges,13,1998-09-18T15:00:00Z,TLPL 138N 610W,0,1,17,3,21
Hurricane,Georges,13,1998-09-18T15:00:00Z,ST CROIX VI,0,0,1,16,17
Hurricane,Georges,13,1998-09-18T15:00:00Z,TFFF 146N 610W,0,1,19,3,23
Hurricane,Georges,13,1998-09-18T15:00:00Z,ST THOMAS VI,0,0,0,15,15
Hurricane,Georges,13,1998-09-18T15:00:00Z,TDPR 153N 614W,0,0,18,5,23
Hurricane,Georges,13,1998-09-18T15:00:00Z,SAN JUAN PR,0,0,0,14,14
Hurricane,Georges,13,1998-09-18T15:00:00Z,TFFR 163N 615W,0,0,15,7,22
Hurricane,Georges,13,1998-09-18T15:00:00Z,PONCE PR,0,0,0,14,14
Hurricane,Georges,14,1998-09-18T21:00:00Z,14.5N  55.3W,47,3,0,0,50
Hurricane,Georges,14,1998-09-18T21:00:00Z,TKPK 173N 627W,0,1,17,3,21
Hurricane,Georges,14,1998-09-18T21:00:00Z,15.0N  59.1W,0,32,2,0,34
Hurricane,Georges,14,1998-09-18T21:00:00Z,TNCM 181N 631W,0,0,12,5,17
Hurricane,Georges,14,1998-09-18T21:00:00Z,15.5N  62.5W,0,3,21,1,25
Hurricane,Georges,14,1998-09-18T21:00:00Z,TISX 177N 648W,0,0,8,10,18
Hurricane,Georges,14,1998-09-18T21:00:00Z,SKPG 125N 717W,0,0,0,3,3
Hurricane,Georges,14,1998-09-18T21:00:00Z,TIST 183N 650W,0,0,5,11,16
Hurricane,Georges,14,1998-09-18T21:00:00Z,TNCC 122N 690W,0,0,0,6,6
Hurricane,Georges,14,1998-09-18T21:00:00Z,TJPS 180N 666W,0,0,2,15,17
Hurricane,Georges,14,1998-09-18T21:00:00Z,SVMG 110N 640W,0,0,2,2,4
Hurricane,Georges,14,1998-09-18T21:00:00Z,MDSD 185N 697W,0,0,0,11,11
Hurricane,Georges,14,1998-09-18T21:00:00Z,TTPP 106N 614W,0,0,2,0,2
Hurricane,Georges,14,1998-09-18T21:00:00Z,MDCB 176N 714W,0,0,0,9,9
Hurricane,Georges,14,1998-09-18T21:00:00Z,TTPT 112N 608W,0,1,3,1,5
Hurricane,Georges,14,1998-09-18T21:00:00Z,MTPP 186N 724W,0,0,0,5,5
Hurricane,Georges,14,1998-09-18T21:00:00Z,TGPY 120N 618W,0,2,7,1,10
Hurricane,Georges,14,1998-09-18T21:00:00Z,MTCA 183N 738W,0,0,0,2,2
Hurricane,Georges,14,1998-09-18T21:00:00Z,TBPB 131N 595W,0,19,3,0,22
Hurricane,Georges,14,1998-09-18T21:00:00Z,TJSJ 184N 661W,0,0,2,14,16
Hurricane,Georges,14,1998-09-18T21:00:00Z,TVSV 131N 612W,0,8,11,0,19
Hurricane,Georges,14,1998-09-18T21:00:00Z,MDPP 198N 707W,0,0,0,6,6
Hurricane,Georges,14,1998-09-18T21:00:00Z,TLPL 138N 610W,0,13,11,0,24
Hurricane,Georges,14,1998-09-18T21:00:00Z,MBJT 215N 712W,0,0,0,2,2
Hurricane,Georges,14,1998-09-18T21:00:00Z,TFFF 146N 610W,0,15,13,0,28
Hurricane,Georges,14,1998-09-18T21:00:00Z,ST CROIX VI,0,0,8,10,18
Hurricane,Georges,14,1998-09-18T21:00:00Z,TDPR 153N 614W,0,10,17,1,28
Hurricane,Georges,14,1998-09-18T21:00:00Z,ST THOMAS VI,0,0,5,11,16
Hurricane,Georges,14,1998-09-18T21:00:00Z,TFFR 163N 615W,0,6,19,1,26
Hurricane,Georges,14,1998-09-18T21:00:00Z,SAN JUAN PR,0,0,2,14,16
Hurricane,Georges,14,1998-09-18T21:00:00Z,TAPA 171N 618W,0,2,19,1,22
Hurricane,Georges,14,1998-09-18T21:00:00Z,PONCE PR,0,0,2,15,17
Hurricane,Georges,15,1998-09-19T03:00:00Z,14.9N  56.2W,56,2,0,0,58
Hurricane,Georges,15,1998-09-19T03:00:00Z,TKPK 173N 627W,0,3,17,2,22
Hurricane,Georges,15,1998-09-19T03:00:00Z,15.5N  59.7W,0,35,0,0,35
Hurricane,Georges,15,1998-09-19T03:00:00Z,TNCM 181N 631W,0,1,14,3,18
Hurricane,Georges,15,1998-09-19T03:00:00Z,15.9N  62.8W,0,6,19,0,25
Hurricane,Georges,15,1998-09-19T03:00:00Z,TISX 177N 648W,0,0,11,8,19
Hurricane,Georges,15,1998-09-19T03:00:00Z,SKPG 125N 717W,0,0,0,4,4
Hurricane,Georges,15,1998-09-19T03:00:00Z,TIST 183N 650W,0,0,7,10,17
Hurricane,Georges,15,1998-09-19T03:00:00Z,TNCC 122N 690W,0,0,0,8,8
Hurricane,Georges,15,1998-09-19T03:00:00Z,TJPS 180N 666W,0,0,3,14,17
Hurricane,Georges,15,1998-09-19T03:00:00Z,SVMG 110N 640W,0,0,2,3,5
Hurricane,Georges,15,1998-09-19T03:00:00Z,MDSD 185N 697W,0,0,0,13,13
Hurricane,Georges,15,1998-09-19T03:00:00Z,TTPP 106N 614W,0,0,1,1,2
Hurricane,Georges,15,1998-09-19T03:00:00Z,MDCB 176N 714W,0,0,0,10,10
Hurricane,Georges,15,1998-09-19T03:00:00Z,TTPT 112N 608W,0,1,2,1,4
Hurricane,Georges,15,1998-09-19T03:00:00Z,MTPP 186N 724W,0,0,0,7,7
Hurricane,Georges,15,1998-09-19T03:00:00Z,TGPY 120N 618W,0,2,6,2,10
Hurricane,Georges,15,1998-09-19T03:00:00Z,MTCA 183N 738W,0,0,0,4,4
Hurricane,Georges,15,1998-09-19T03:00:00Z,TBPB 131N 595W,0,19,2,0,21
Hurricane,Georges,15,1998-09-19T03:00:00Z,TJSJ 184N 661W,0,0,3,13,16
Hurricane,Georges,15,1998-09-19T03:00:00Z,TVSV 131N 612W,0,10,7,1,18
Hurricane,Georges,15,1998-09-19T03:00:00Z,MDPP 198N 707W,0,0,0,8,8
Hurricane,Georges,15,1998-09-19T03:00:00Z,TLPL 138N 610W,0,17,6,0,23
Hurricane,Georges,15,1998-09-19T03:00:00Z,MBJT 215N 712W,0,0,0,4,4
Hurricane,Georges,15,1998-09-19T03:00:00Z,TFFF 146N 610W,0,22,6,0,28
Hurricane,Georges,15,1998-09-19T03:00:00Z,ST CROIX VI,0,0,11,8,19
Hurricane,Georges,15,1998-09-19T03:00:00Z,TDPR 153N 614W,0,20,8,1,29
Hurricane,Georges,15,1998-09-19T03:00:00Z,ST THOMAS VI,0,0,7,10,17
Hurricane,Georges,15,1998-09-19T03:00:00Z,TFFR 163N 615W,0,16,11,0,27
Hurricane,Georges,15,1998-09-19T03:00:00Z,SAN JUAN PR,0,0,3,13,16
Hurricane,Georges,15,1998-09-19T03:00:00Z,TAPA 171N 618W,0,9,14,0,23
Hurricane,Georges,15,1998-09-19T03:00:00Z,PONCE PR,0,0,3,14,17
Hurricane,Georges,16,1998-09-19T09:00:00Z,15.2N  57.4W,56,1,0,0,57
Hurricane,Georges,16,1998-09-19T09:00:00Z,TISX 177N 648W,0,1,15,4,20
Hurricane,Georges,16,1998-09-19T09:00:00Z,15.6N  60.7W,0,33,0,0,33
Hurricane,Georges,16,1998-09-19T09:00:00Z,TIST 183N 650W,0,0,12,6,18
Hurricane,Georges,16,1998-09-19T09:00:00Z,16.2N  63.6W,0,8,15,1,24
Hurricane,Georges,16,1998-09-19T09:00:00Z,TJPS 180N 666W,0,0,7,12,19
Hurricane,Georges,16,1998-09-19T09:00:00Z,SKPG 125N 717W,0,0,0,4,4
Hurricane,Georges,16,1998-09-19T09:00:00Z,MDSD 185N 697W,0,0,0,15,15
Hurricane,Georges,16,1998-09-19T09:00:00Z,TNCC 122N 690W,0,0,0,7,7
Hurricane,Georges,16,1998-09-19T09:00:00Z,MDCB 176N 714W,0,0,0,14,14
Hurricane,Georges,16,1998-09-19T09:00:00Z,SVMG 110N 640W,0,0,2,1,3
Hurricane,Georges,16,1998-09-19T09:00:00Z,MTPP 186N 724W,0,0,0,10,10
Hurricane,Georges,16,1998-09-19T09:00:00Z,TTPT 112N 608W,0,1,1,0,2
Hurricane,Georges,16,1998-09-19T09:00:00Z,MTCA 183N 738W,0,0,0,7,7
Hurricane,Georges,16,1998-09-19T09:00:00Z,TGPY 120N 618W,0,3,3,1,7
Hurricane,Georges,16,1998-09-19T09:00:00Z,MUGM 200N 751W,0,0,0,2,2
Hurricane,Georges,16,1998-09-19T09:00:00Z,TBPB 131N 595W,2,15,0,1,18
Hurricane,Georges,16,1998-09-19T09:00:00Z,TJSJ 184N 661W,0,0,8,10,18
Hurricane,Georges,16,1998-09-19T09:00:00Z,TVSV 131N 612W,0,13,3,0,16
Hurricane,Georges,16,1998-09-19T09:00:00Z,MDPP 198N 707W,0,0,0,12,12
Hurricane,Georges,16,1998-09-19T09:00:00Z,TLPL 138N 610W,0,21,2,0,23
Hurricane,Georges,16,1998-09-19T09:00:00Z,MBJT 215N 712W,0,0,0,6,6
Hurricane,Georges,16,1998-09-19T09:00:00Z,TFFF 146N 610W,0,28,1,0,29
Hurricane,Georges,16,1998-09-19T09:00:00Z,MYMM 224N 730W,0,0,0,2,2
Hurricane,Georges,16,1998-09-19T09:00:00Z,TDPR 153N 614W,0,28,2,0,30
Hurricane,Georges,16,1998-09-19T09:00:00Z,ST CROIX VI,0,1,15,4,20
Hurricane,Georges,16,1998-09-19T09:00:00Z,TFFR 163N 615W,0,26,3,0,29
Hurricane,Georges,16,1998-09-19T09:00:00Z,ST THOMAS VI,0,0,12,6,18
Hurricane,Georges,16,1998-09-19T09:00:00Z,TAPA 171N 618W,0,18,6,1,25
Hurricane,Georges,16,1998-09-19T09:00:00Z,SAN JUAN PR,0,0,8,10,18
Hurricane,Georges,16,1998-09-19T09:00:00Z,TKPK 173N 627W,0,9,13,1,23
Hurricane,Georges,16,1998-09-19T09:00:00Z,PONCE PR,0,0,7,12,19
Hurricane,Georges,16,1998-09-19T09:00:00Z,TNCM 181N 631W,0,3,15,1,19
Hurricane,Georges,17,1998-09-19T15:00:00Z,15.7N  58.4W,56,0,0,0,56
Hurricane,Georges,17,1998-09-19T15:00:00Z,TJPS 180N 666W,0,0,14,6,20
Hurricane,Georges,17,1998-09-19T15:00:00Z,16.0N  61.5W,0,32,1,0,33
Hurricane,Georges,17,1998-09-19T15:00:00Z,MDSD 185N 697W,0,0,2,16,18
Hurricane,Georges,17,1998-09-19T15:00:00Z,16.5N  65.0W,0,3,21,0,24
Hurricane,Georges,17,1998-09-19T15:00:00Z,MDCB 176N 714W,0,0,0,17,17
Hurricane,Georges,17,1998-09-19T15:00:00Z,SKPG 125N 717W,0,0,0,7,7
Hurricane,Georges,17,1998-09-19T15:00:00Z,MTPP 186N 724W,0,0,0,15,15
Hurricane,Georges,17,1998-09-19T15:00:00Z,TNCC 122N 690W,0,0,1,6,7
Hurricane,Georges,17,1998-09-19T15:00:00Z,MTCA 183N 738W,0,0,0,12,12
Hurricane,Georges,17,1998-09-19T15:00:00Z,TGPY 120N 618W,0,2,1,1,4
Hurricane,Georges,17,1998-09-19T15:00:00Z,MKJP 179N 768W,0,0,0,4,4
Hurricane,Georges,17,1998-09-19T15:00:00Z,TBPB 131N 595W,3,7,1,0,11
Hurricane,Georges,17,1998-09-19T15:00:00Z,MKJS 185N 779W,0,0,0,2,2
Hurricane,Georges,17,1998-09-19T15:00:00Z,TVSV 131N 612W,0,10,3,0,13
Hurricane,Georges,17,1998-09-19T15:00:00Z,MUGM 200N 751W,0,0,0,7,7
Hurricane,Georges,17,1998-09-19T15:00:00Z,TLPL 138N 610W,1,18,1,1,21
Hurricane,Georges,17,1998-09-19T15:00:00Z,TJSJ 184N 661W,0,0,14,5,19
Hurricane,Georges,17,1998-09-19T15:00:00Z,TFFF 146N 610W,2,26,0,1,29
Hurricane,Georges,17,1998-09-19T15:00:00Z,MDPP 198N 707W,0,0,0,14,14
Hurricane,Georges,17,1998-09-19T15:00:00Z,TDPR 153N 614W,1,30,1,0,32
Hurricane,Georges,17,1998-09-19T15:00:00Z,MBJT 215N 712W,0,0,0,8,8
Hurricane,Georges,17,1998-09-19T15:00:00Z,TFFR 163N 615W,0,32,1,0,33
Hurricane,Georges,17,1998-09-19T15:00:00Z,MYMM 224N 730W,0,0,0,4,4
Hurricane,Georges,17,1998-09-19T15:00:00Z,TAPA 171N 618W,0,26,3,1,30
Hurricane,Georges,17,1998-09-19T15:00:00Z,ST CROIX VI,0,2,20,1,23
Hurricane,Georges,17,1998-09-19T15:00:00Z,TKPK 173N 627W,0,18,9,1,28
Hurricane,Georges,17,1998-09-19T15:00:00Z,ST THOMAS VI,0,1,17,2,20
Hurricane,Georges,17,1998-09-19T15:00:00Z,TNCM 181N 631W,0,9,14,0,23
Hurricane,Georges,17,1998-09-19T15:00:00Z,SAN JUAN PR,0,0,14,5,19
Hurricane,Georges,17,1998-09-19T15:00:00Z,TISX 177N 648W,0,2,20,1,23
Hurricane,Georges,17,1998-09-19T15:00:00Z,PONCE PR,0,0,14,6,20
Hurricane,Georges,17,1998-09-19T15:00:00Z,TIST 183N 650W,0,1,17,2,20
Hurricane,Georges,18,1998-09-19T21:00:00Z,17.0N  60.3W,57,1,0,0,58
Hurricane,Georges,18,1998-09-19T21:00:00Z,MTPP 186N 724W,0,0,1,16,17
Hurricane,Georges,18,1998-09-19T21:00:00Z,17.5N  63.5W,0,33,0,0,33
Hurricane,Georges,18,1998-09-19T21:00:00Z,MTCA 183N 738W,0,0,0,16,16
Hurricane,Georges,18,1998-09-19T21:00:00Z,18.0N  66.5W,0,6,17,1,24
Hurricane,Georges,18,1998-09-19T21:00:00Z,MKJP 179N 768W,0,0,0,8,8
Hurricane,Georges,18,1998-09-19T21:00:00Z,SKPG 125N 717W,0,0,0,2,2
Hurricane,Georges,18,1998-09-19T21:00:00Z,MKJS 185N 779W,0,0,0,5,5
Hurricane,Georges,18,1998-09-19T21:00:00Z,TLPL 138N 610W,1,2,0,0,3
Hurricane,Georges,18,1998-09-19T21:00:00Z,MUGM 200N 751W,0,0,0,12,12
Hurricane,Georges,18,1998-09-19T21:00:00Z,TFFF 146N 610W,7,6,0,0,13
Hurricane,Georges,18,1998-09-19T21:00:00Z,MUCM 214N 779W,0,0,0,3,3
Hurricane,Georges,18,1998-09-19T21:00:00Z,TDPR 153N 614W,14,12,0,0,26
Hurricane,Georges,18,1998-09-19T21:00:00Z,TJSJ 184N 661W,0,8,16,0,24
Hurricane,Georges,18,1998-09-19T21:00:00Z,TFFR 163N 615W,27,14,0,1,42
Hurricane,Georges,18,1998-09-19T21:00:00Z,MDPP 198N 707W,0,0,2,16,18
Hurricane,Georges,18,1998-09-19T21:00:00Z,TAPA 171N 618W,20,24,0,0,44
Hurricane,Georges,18,1998-09-19T21:00:00Z,MBJT 215N 712W,0,0,0,13,13
Hurricane,Georges,18,1998-09-19T21:00:00Z,TKPK 173N 627W,3,35,0,0,38
Hurricane,Georges,18,1998-09-19T21:00:00Z,MYMM 224N 730W,0,0,0,9,9
Hurricane,Georges,18,1998-09-19T21:00:00Z,TNCM 181N 631W,0,33,1,0,34
Hurricane,Georges,18,1998-09-19T21:00:00Z,MYSM 241N 745W,0,0,0,3,3
Hurricane,Georges,18,1998-09-19T21:00:00Z,TISX 177N 648W,0,23,5,0,28
Hurricane,Georges,18,1998-09-19T21:00:00Z,MYEG 235N 758W,0,0,0,3,3
Hurricane,Georges,18,1998-09-19T21:00:00Z,TIST 183N 650W,0,19,8,0,27
Hurricane,Georges,18,1998-09-19T21:00:00Z,ST CROIX VI,0,23,5,0,28
Hurricane,Georges,18,1998-09-19T21:00:00Z,TJPS 180N 666W,0,5,18,1,24
Hurricane,Georges,18,1998-09-19T21:00:00Z,ST THOMAS VI,0,19,8,0,27
Hurricane,Georges,18,1998-09-19T21:00:00Z,MDSD 185N 697W,0,0,9,11,20
Hurricane,Georges,18,1998-09-19T21:00:00Z,SAN JUAN PR,0,8,16,0,24
Hurricane,Georges,18,1998-09-19T21:00:00Z,MDCB 176N 714W,0,0,2,16,18
Hurricane,Georges,18,1998-09-19T21:00:00Z,PONCE PR,0,5,18,1,24
Hurricane,Georges,19,1998-09-20T03:00:00Z,16.8N  61.6W,54,1,0,0,55
Hurricane,Georges,19,1998-09-20T03:00:00Z,MTPP 186N 724W,0,0,3,15,18
Hurricane,Georges,19,1998-09-20T03:00:00Z,17.4N  65.0W,0,32,0,0,32
Hurricane,Georges,19,1998-09-20T03:00:00Z,MTCA 183N 738W,0,0,1,15,16
Hurricane,Georges,19,1998-09-20T03:00:00Z,17.8N  68.0W,0,6,16,1,23
Hurricane,Georges,19,1998-09-20T03:00:00Z,MKJP 179N 768W,0,0,0,10,10
Hurricane,Georges,19,1998-09-20T03:00:00Z,SKPG 125N 717W,0,0,0,5,5
Hurricane,Georges,19,1998-09-20T03:00:00Z,MKJS 185N 779W,0,0,0,8,8
Hurricane,Georges,19,1998-09-20T03:00:00Z,TNCC 122N 690W,0,0,1,2,3
Hurricane,Georges,19,1998-09-20T03:00:00Z,MUGM 200N 751W,0,0,0,13,13
Hurricane,Georges,19,1998-09-20T03:00:00Z,TLPL 138N 610W,5,1,0,0,6
Hurricane,Georges,19,1998-09-20T03:00:00Z,MUCM 214N 779W,0,0,0,6,6
Hurricane,Georges,19,1998-09-20T03:00:00Z,TFFF 146N 610W,23,2,0,0,25
Hurricane,Georges,19,1998-09-20T03:00:00Z,TJSJ 184N 661W,0,20,6,0,26
Hurricane,Georges,19,1998-09-20T03:00:00Z,TDPR 153N 614W,39,2,0,0,41
Hurricane,Georges,19,1998-09-20T03:00:00Z,MDPP 198N 707W,0,0,7,11,18
Hurricane,Georges,19,1998-09-20T03:00:00Z,TFFR 163N 615W,53,1,0,0,54
Hurricane,Georges,19,1998-09-20T03:00:00Z,MBJT 215N 712W,0,0,2,11,13
Hurricane,Georges,19,1998-09-20T03:00:00Z,TAPA 171N 618W,49,3,0,0,52
Hurricane,Georges,19,1998-09-20T03:00:00Z,MYMM 224N 730W,0,0,0,11,11
Hurricane,Georges,19,1998-09-20T03:00:00Z,TKPK 173N 627W,25,20,0,0,45
Hurricane,Georges,19,1998-09-20T03:00:00Z,MYSM 241N 745W,0,0,0,5,5
Hurricane,Georges,19,1998-09-20T03:00:00Z,TNCM 181N 631W,8,29,0,0,37
Hurricane,Georges,19,1998-09-20T03:00:00Z,MYEG 235N 758W,0,0,0,6,6
Hurricane,Georges,19,1998-09-20T03:00:00Z,TISX 177N 648W,0,32,0,1,33
Hurricane,Georges,19,1998-09-20T03:00:00Z,MYAK 241N 776W,0,0,0,2,2
Hurricane,Georges,19,1998-09-20T03:00:00Z,TIST 183N 650W,0,28,1,1,30
Hurricane,Georges,19,1998-09-20T03:00:00Z,ST CROIX VI,0,32,0,1,33
Hurricane,Georges,19,1998-09-20T03:00:00Z,TJPS 180N 666W,0,17,9,0,26
Hurricane,Georges,19,1998-09-20T03:00:00Z,ST THOMAS VI,0,28,1,1,30
Hurricane,Georges,19,1998-09-20T03:00:00Z,MDSD 185N 697W,0,0,16,5,21
Hurricane,Georges,19,1998-09-20T03:00:00Z,SAN JUAN PR,0,20,6,0,26
Hurricane,Georges,19,1998-09-20T03:00:00Z,MDCB 176N 714W,0,0,8,11,19
Hurricane,Georges,19,1998-09-20T03:00:00Z,PONCE PR,0,17,9,0,26
Hurricane,Georges,20,1998-09-20T09:00:00Z,17.2N  62.2W,58,0,0,1,59
Hurricane,Georges,20,1998-09-20T09:00:00Z,MTCA 183N 738W,0,0,1,15,16
Hurricane,Georges,20,1998-09-20T09:00:00Z,17.9N  65.2W,1,34,0,0,35
Hurricane,Georges,20,1998-09-20T09:00:00Z,MKJP 179N 768W,0,0,0,8,8
Hurricane,Georges,20,1998-09-20T09:00:00Z,18.5N  68.0W,0,7,17,1,25
Hurricane,Georges,20,1998-09-20T09:00:00Z,MKJS 185N 779W,0,0,0,6,6
Hurricane,Georges,20,1998-09-20T09:00:00Z,SKPG 125N 717W,0,0,0,3,3
Hurricane,Georges,20,1998-09-20T09:00:00Z,MUGM 200N 751W,0,0,0,14,14
Hurricane,Georges,20,1998-09-20T09:00:00Z,TNCC 122N 690W,0,0,1,1,2
Hurricane,Georges,20,1998-09-20T09:00:00Z,MUCM 214N 779W,0,0,0,6,6
Hurricane,Georges,20,1998-09-20T09:00:00Z,TLPL 138N 610W,6,0,0,0,6
Hurricane,Georges,20,1998-09-20T09:00:00Z,TJSJ 184N 661W,0,27,3,0,30
Hurricane,Georges,20,1998-09-20T09:00:00Z,TFFF 146N 610W,25,0,0,0,25
Hurricane,Georges,20,1998-09-20T09:00:00Z,MDPP 198N 707W,0,0,11,9,20
Hurricane,Georges,20,1998-09-20T09:00:00Z,TDPR 153N 614W,43,0,0,0,43
Hurricane,Georges,20,1998-09-20T09:00:00Z,MBJT 215N 712W,0,0,4,13,17
Hurricane,Georges,20,1998-09-20T09:00:00Z,TFFR 163N 615W,61,0,0,0,61
Hurricane,Georges,20,1998-09-20T09:00:00Z,MYMM 224N 730W,0,0,0,14,14
Hurricane,Georges,20,1998-09-20T09:00:00Z,TAPA 171N 618W,65,0,0,0,65
Hurricane,Georges,20,1998-09-20T09:00:00Z,MYSM 241N 745W,0,0,0,9,9
Hurricane,Georges,20,1998-09-20T09:00:00Z,TKPK 173N 627W,52,1,0,0,53
Hurricane,Georges,20,1998-09-20T09:00:00Z,MYEG 235N 758W,0,0,0,9,9
Hurricane,Georges,20,1998-09-20T09:00:00Z,TNCM 181N 631W,37,9,0,0,46
Hurricane,Georges,20,1998-09-20T09:00:00Z,MYAK 241N 776W,0,0,0,4,4
Hurricane,Georges,20,1998-09-20T09:00:00Z,TISX 177N 648W,2,35,0,0,37
Hurricane,Georges,20,1998-09-20T09:00:00Z,MYNN 251N 775W,0,0,0,3,3
Hurricane,Georges,20,1998-09-20T09:00:00Z,TIST 183N 650W,1,33,0,1,35
Hurricane,Georges,20,1998-09-20T09:00:00Z,ST CROIX VI,2,35,0,0,37
Hurricane,Georges,20,1998-09-20T09:00:00Z,TJPS 180N 666W,0,23,6,0,29
Hurricane,Georges,20,1998-09-20T09:00:00Z,ST THOMAS VI,1,33,0,1,35
Hurricane,Georges,20,1998-09-20T09:00:00Z,MDSD 185N 697W,0,0,18,4,22
Hurricane,Georges,20,1998-09-20T09:00:00Z,SAN JUAN PR,0,27,3,0,30
Hurricane,Georges,20,1998-09-20T09:00:00Z,MDCB 176N 714W,0,0,8,10,18
Hurricane,Georges,20,1998-09-20T09:00:00Z,PONCE PR,0,23,6,0,29
Hurricane,Georges,20,1998-09-20T09:00:00Z,MTPP 186N 724W,0,0,3,15,18
Hurricane,Georges,21,1998-09-20T15:00:00Z,17.5N  63.5W,53,0,0,0,53
Hurricane,Georges,21,1998-09-20T15:00:00Z,MTCA 183N 738W,0,0,1,12,13
Hurricane,Georges,21,1998-09-20T15:00:00Z,18.3N  66.0W,2,28,0,1,31
Hurricane,Georges,21,1998-09-20T15:00:00Z,MKJP 179N 768W,0,0,0,6,6
Hurricane,Georges,21,1998-09-20T15:00:00Z,19.0N  68.0W,0,14,7,2,23
Hurricane,Georges,21,1998-09-20T15:00:00Z,MKJS 185N 779W,0,0,0,4,4
Hurricane,Georges,21,1998-09-20T15:00:00Z,SKPG 125N 717W,0,0,0,2,2
Hurricane,Georges,21,1998-09-20T15:00:00Z,MUGM 200N 751W,0,0,0,11,11
Hurricane,Georges,21,1998-09-20T15:00:00Z,TNCC 122N 690W,0,0,0,2,2
Hurricane,Georges,21,1998-09-20T15:00:00Z,MUCM 214N 779W,0,0,0,5,5
Hurricane,Georges,21,1998-09-20T15:00:00Z,TFFF 146N 610W,11,0,0,0,11
Hurricane,Georges,21,1998-09-20T15:00:00Z,TJSJ 184N 661W,1,28,1,0,30
Hurricane,Georges,21,1998-09-20T15:00:00Z,TDPR 153N 614W,42,0,0,0,42
Hurricane,Georges,21,1998-09-20T15:00:00Z,MDPP 198N 707W,0,0,11,8,19
Hurricane,Georges,21,1998-09-20T15:00:00Z,TFFR 163N 615W,69,0,0,0,69
Hurricane,Georges,21,1998-09-20T15:00:00Z,MBJT 215N 712W,0,0,5,12,17
Hurricane,Georges,21,1998-09-20T15:00:00Z,TAPA 171N 618W,72,0,0,0,72
Hurricane,Georges,21,1998-09-20T15:00:00Z,MYMM 224N 730W,0,0,1,13,14
Hurricane,Georges,21,1998-09-20T15:00:00Z,TKPK 173N 627W,61,0,0,0,61
Hurricane,Georges,21,1998-09-20T15:00:00Z,MYSM 241N 745W,0,0,0,9,9
Hurricane,Georges,21,1998-09-20T15:00:00Z,TNCM 181N 631W,54,0,0,0,54
Hurricane,Georges,21,1998-09-20T15:00:00Z,MYEG 235N 758W,0,0,0,8,8
Hurricane,Georges,21,1998-09-20T15:00:00Z,TISX 177N 648W,24,15,0,0,39
Hurricane,Georges,21,1998-09-20T15:00:00Z,MYAK 241N 776W,0,0,0,4,4
Hurricane,Georges,21,1998-09-20T15:00:00Z,TIST 183N 650W,15,22,0,0,37
Hurricane,Georges,21,1998-09-20T15:00:00Z,MYNN 251N 775W,0,0,0,3,3
Hurricane,Georges,21,1998-09-20T15:00:00Z,TJPS 180N 666W,0,27,0,1,28
Hurricane,Georges,21,1998-09-20T15:00:00Z,ST CROIX VI,24,15,0,0,39
Hurricane,Georges,21,1998-09-20T15:00:00Z,MDSD 185N 697W,0,3,13,3,19
Hurricane,Georges,21,1998-09-20T15:00:00Z,ST THOMAS VI,15,22,0,0,37
Hurricane,Georges,21,1998-09-20T15:00:00Z,MDCB 176N 714W,0,0,7,9,16
Hurricane,Georges,21,1998-09-20T15:00:00Z,SAN JUAN PR,1,28,1,0,30
Hurricane,Georges,21,1998-09-20T15:00:00Z,MTPP 186N 724W,0,0,4,12,16
Hurricane,Georges,21,1998-09-20T15:00:00Z,PONCE PR,0,27,0,1,28
Hurricane,Georges,22,1998-09-20T21:00:00Z,17.7N  64.5W,54,0,0,0,54
Hurricane,Georges,22,1998-09-20T21:00:00Z,MKJS 185N 779W,0,0,0,5,5
Hurricane,Georges,22,1998-09-20T21:00:00Z,18.5N  67.0W,2,30,0,1,33
Hurricane,Georges,22,1998-09-20T21:00:00Z,MUGM 200N 751W,0,0,1,13,14
Hurricane,Georges,22,1998-09-20T21:00:00Z,19.2N  69.0W,0,14,9,1,24
Hurricane,Georges,22,1998-09-20T21:00:00Z,MUCM 214N 779W,0,0,0,7,7
Hurricane,Georges,22,1998-09-20T21:00:00Z,TFFF 146N 610W,3,0,0,0,3
Hurricane,Georges,22,1998-09-20T21:00:00Z,MUCF 221N 805W,0,0,0,2,2
Hurricane,Georges,22,1998-09-20T21:00:00Z,TDPR 153N 614W,49,0,0,0,49
Hurricane,Georges,22,1998-09-20T21:00:00Z,TJSJ 184N 661W,14,24,0,0,38
Hurricane,Georges,22,1998-09-20T21:00:00Z,TFFR 163N 615W,92,0,0,0,92
Hurricane,Georges,22,1998-09-20T21:00:00Z,MDPP 198N 707W,0,2,14,5,21
Hurricane,Georges,22,1998-09-20T21:00:00Z,TAPA 171N 618W,89,0,0,0,89
Hurricane,Georges,22,1998-09-20T21:00:00Z,MBJT 215N 712W,0,0,9,9,18
Hurricane,Georges,22,1998-09-20T21:00:00Z,TKPK 173N 627W,82,0,0,0,82
Hurricane,Georges,22,1998-09-20T21:00:00Z,MYMM 224N 730W,0,0,1,15,16
Hurricane,Georges,22,1998-09-20T21:00:00Z,TNCM 181N 631W,61,0,0,0,61
Hurricane,Georges,22,1998-09-20T21:00:00Z,MYSM 241N 745W,0,0,0,11,11
Hurricane,Georges,22,1998-09-20T21:00:00Z,TISX 177N 648W,50,0,0,0,50
Hurricane,Georges,22,1998-09-20T21:00:00Z,MYEG 235N 758W,0,0,0,10,10
Hurricane,Georges,22,1998-09-20T21:00:00Z,TIST 183N 650W,44,3,0,0,47
Hurricane,Georges,22,1998-09-20T21:00:00Z,MYAK 241N 776W,0,0,0,6,6
Hurricane,Georges,22,1998-09-20T21:00:00Z,TJPS 180N 666W,6,29,0,0,35
Hurricane,Georges,22,1998-09-20T21:00:00Z,MYNN 251N 775W,0,0,0,4,4
Hurricane,Georges,22,1998-09-20T21:00:00Z,MDSD 185N 697W,0,9,11,2,22
Hurricane,Georges,22,1998-09-20T21:00:00Z,ST CROIX VI,50,0,0,0,50
Hurricane,Georges,22,1998-09-20T21:00:00Z,MDCB 176N 714W,0,1,11,5,17
Hurricane,Georges,22,1998-09-20T21:00:00Z,ST THOMAS VI,44,3,0,0,47
Hurricane,Georges,22,1998-09-20T21:00:00Z,MTPP 186N 724W,0,0,9,8,17
Hurricane,Georges,22,1998-09-20T21:00:00Z,SAN JUAN PR,14,24,0,0,38
Hurricane,Georges,22,1998-09-20T21:00:00Z,MTCA 183N 738W,0,0,3,11,14
Hurricane,Georges,22,1998-09-20T21:00:00Z,PONCE PR,6,29,0,0,35
Hurricane,Georges,22,1998-09-20T21:00:00Z,MKJP 179N 768W,0,0,0,6,6
Hurricane,Georges,23,1998-09-21T03:00:00Z,18.0N  66.0W,52,0,0,0,52
Hurricane,Georges,23,1998-09-21T03:00:00Z,MKJS 185N 779W,0,0,0,8,8
Hurricane,Georges,23,1998-09-21T03:00:00Z,18.8N  68.3W,3,28,1,0,32
Hurricane,Georges,23,1998-09-21T03:00:00Z,MUGM 200N 751W,0,0,3,13,16
Hurricane,Georges,23,1998-09-21T03:00:00Z,19.6N  70.3W,0,14,8,2,24
Hurricane,Georges,23,1998-09-21T03:00:00Z,MUCM 214N 779W,0,0,0,10,10
Hurricane,Georges,23,1998-09-21T03:00:00Z,TDPR 153N 614W,7,0,0,0,7
Hurricane,Georges,23,1998-09-21T03:00:00Z,MUCF 221N 805W,0,0,0,3,3
Hurricane,Georges,23,1998-09-21T03:00:00Z,TFFR 163N 615W,99,0,0,0,99
Hurricane,Georges,23,1998-09-21T03:00:00Z,TJSJ 184N 661W,49,0,0,0,49
Hurricane,Georges,23,1998-09-21T03:00:00Z,TAPA 171N 618W,99,0,0,0,99
Hurricane,Georges,23,1998-09-21T03:00:00Z,MDPP 198N 707W,0,10,11,2,23
Hurricane,Georges,23,1998-09-21T03:00:00Z,TKPK 173N 627W,96,0,0,0,96
Hurricane,Georges,23,1998-09-21T03:00:00Z,MBJT 215N 712W,0,1,13,5,19
Hurricane,Georges,23,1998-09-21T03:00:00Z,TNCM 181N 631W,76,0,0,0,76
Hurricane,Georges,23,1998-09-21T03:00:00Z,MYMM 224N 730W,0,0,5,11,16
Hurricane,Georges,23,1998-09-21T03:00:00Z,TISX 177N 648W,68,0,0,0,68
Hurricane,Georges,23,1998-09-21T03:00:00Z,MYSM 241N 745W,0,0,0,11,11
Hurricane,Georges,23,1998-09-21T03:00:00Z,TIST 183N 650W,59,0,0,0,59
Hurricane,Georges,23,1998-09-21T03:00:00Z,MYEG 235N 758W,0,0,0,11,11
Hurricane,Georges,23,1998-09-21T03:00:00Z,TJPS 180N 666W,43,3,0,0,46
Hurricane,Georges,23,1998-09-21T03:00:00Z,MYAK 241N 776W,0,0,0,7,7
Hurricane,Georges,23,1998-09-21T03:00:00Z,MDSD 185N 697W,0,22,3,0,25
Hurricane,Georges,23,1998-09-21T03:00:00Z,MYNN 251N 775W,0,0,0,5,5
Hurricane,Georges,23,1998-09-21T03:00:00Z,MDCB 176N 714W,0,6,10,2,18
Hurricane,Georges,23,1998-09-21T03:00:00Z,ST CROIX VI,68,0,0,0,68
Hurricane,Georges,23,1998-09-21T03:00:00Z,MTPP 186N 724W,0,2,13,4,19
Hurricane,Georges,23,1998-09-21T03:00:00Z,ST THOMAS VI,59,0,0,0,59
Hurricane,Georges,23,1998-09-21T03:00:00Z,MTCA 183N 738W,0,0,8,8,16
Hurricane,Georges,23,1998-09-21T03:00:00Z,SAN JUAN PR,49,0,0,0,49
Hurricane,Georges,23,1998-09-21T03:00:00Z,MKJP 179N 768W,0,0,0,9,9
Hurricane,Georges,23,1998-09-21T03:00:00Z,PONCE PR,43,3,0,0,46
Hurricane,Georges,24,1998-09-21T09:00:00Z,18.7N  68.2W,54,0,0,0,54
Hurricane,Georges,24,1998-09-21T09:00:00Z,MUSN 216N 826W,0,0,0,4,4
Hurricane,Georges,24,1998-09-21T09:00:00Z,19.4N  70.7W,2,29,1,0,32
Hurricane,Georges,24,1998-09-21T09:00:00Z,MUHA 230N 824W,0,0,0,4,4
Hurricane,Georges,24,1998-09-21T09:00:00Z,20.0N  72.8W,0,13,10,1,24
Hurricane,Georges,24,1998-09-21T09:00:00Z,TJSJ 184N 661W,75,0,0,0,75
Hurricane,Georges,24,1998-09-21T09:00:00Z,TFFR 163N 615W,8,0,0,0,8
Hurricane,Georges,24,1998-09-21T09:00:00Z,MDPP 198N 707W,1,29,0,0,30
Hurricane,Georges,24,1998-09-21T09:00:00Z,TAPA 171N 618W,99,0,0,0,99
Hurricane,Georges,24,1998-09-21T09:00:00Z,MBJT 215N 712W,0,14,6,1,21
Hurricane,Georges,24,1998-09-21T09:00:00Z,TKPK 173N 627W,99,0,0,0,99
Hurricane,Georges,24,1998-09-21T09:00:00Z,MYMM 224N 730W,0,2,12,4,18
Hurricane,Georges,24,1998-09-21T09:00:00Z,TNCM 181N 631W,99,0,0,0,99
Hurricane,Georges,24,1998-09-21T09:00:00Z,MYSM 241N 745W,0,0,3,10,13
Hurricane,Georges,24,1998-09-21T09:00:00Z,TISX 177N 648W,88,0,0,0,88
Hurricane,Georges,24,1998-09-21T09:00:00Z,MYEG 235N 758W,0,0,3,12,15
Hurricane,Georges,24,1998-09-21T09:00:00Z,TIST 183N 650W,86,0,0,0,86
Hurricane,Georges,24,1998-09-21T09:00:00Z,MYAK 241N 776W,0,0,0,12,12
Hurricane,Georges,24,1998-09-21T09:00:00Z,TJPS 180N 666W,69,0,0,0,69
Hurricane,Georges,24,1998-09-21T09:00:00Z,MYNN 251N 775W,0,0,0,9,9
Hurricane,Georges,24,1998-09-21T09:00:00Z,MDSD 185N 697W,18,20,0,0,38
Hurricane,Georges,24,1998-09-21T09:00:00Z,MYGF 266N 787W,0,0,0,4,4
Hurricane,Georges,24,1998-09-21T09:00:00Z,MDCB 176N 714W,0,20,2,0,22
Hurricane,Georges,24,1998-09-21T09:00:00Z,ST CROIX VI,88,0,0,0,88
Hurricane,Georges,24,1998-09-21T09:00:00Z,MTPP 186N 724W,0,18,5,1,24
Hurricane,Georges,24,1998-09-21T09:00:00Z,ST THOMAS VI,86,0,0,0,86
Hurricane,Georges,24,1998-09-21T09:00:00Z,MTCA 183N 738W,0,6,11,2,19
Hurricane,Georges,24,1998-09-21T09:00:00Z,SAN JUAN PR,75,0,0,0,75
Hurricane,Georges,24,1998-09-21T09:00:00Z,MKJP 179N 768W,0,0,4,8,12
Hurricane,Georges,24,1998-09-21T09:00:00Z,PONCE PR,69,0,0,0,69
Hurricane,Georges,24,1998-09-21T09:00:00Z,MKJS 185N 779W,0,0,2,9,11
Hurricane,Georges,24,1998-09-21T09:00:00Z,MARATHON FL,0,0,0,5,5
Hurricane,Georges,24,1998-09-21T09:00:00Z,MWCG 193N 814W,0,0,0,5,5
Hurricane,Georges,24,1998-09-21T09:00:00Z,MIAMI FL,0,0,0,4,4
Hurricane,Georges,24,1998-09-21T09:00:00Z,MUGM 200N 751W,0,1,14,5,20
Hurricane,Georges,24,1998-09-21T09:00:00Z,W PALM BEACH FL,0,0,0,2,2
Hurricane,Georges,24,1998-09-21T09:00:00Z,MUCM 214N 779W,0,0,2,13,15
Hurricane,Georges,24,1998-09-21T09:00:00Z,KEY WEST FL,0,0,0,4,4
Hurricane,Georges,24,1998-09-21T09:00:00Z,MUCF 221N 805W,0,0,0,9,9
Hurricane,Georges,24,1998-09-21T09:00:00Z,MARCO ISLAND FL,0,0,0,2,2
Hurricane,Georges,25,1998-09-21T15:00:00Z,19.0N  69.0W,52,0,0,0,52
Hurricane,Georges,25,1998-09-21T15:00:00Z,MBJT 215N 712W,1,25,1,1,28
Hurricane,Georges,25,1998-09-21T15:00:00Z,19.8N  71.5W,3,33,1,0,37
Hurricane,Georges,25,1998-09-21T15:00:00Z,MYMM 224N 730W,0,7,12,3,22
Hurricane,Georges,25,1998-09-21T15:00:00Z,20.5N  73.5W,0,14,12,1,27
Hurricane,Georges,25,1998-09-21T15:00:00Z,MYSM 241N 745W,0,0,7,9,16
Hurricane,Georges,25,1998-09-21T15:00:00Z,TKPK 173N 627W,2,0,0,0,2
Hurricane,Georges,25,1998-09-21T15:00:00Z,MYEG 235N 758W,0,0,6,12,18
Hurricane,Georges,25,1998-09-21T15:00:00Z,TNCM 181N 631W,99,0,0,0,99
Hurricane,Georges,25,1998-09-21T15:00:00Z,MYAK 241N 776W,0,0,1,14,15
Hurricane,Georges,25,1998-09-21T15:00:00Z,TISX 177N 648W,99,0,0,0,99
Hurricane,Georges,25,1998-09-21T15:00:00Z,MYNN 251N 775W,0,0,0,13,13
Hurricane,Georges,25,1998-09-21T15:00:00Z,TIST 183N 650W,99,0,0,0,99
Hurricane,Georges,25,1998-09-21T15:00:00Z,MYGF 266N 787W,0,0,0,9,9
Hurricane,Georges,25,1998-09-21T15:00:00Z,TJPS 180N 666W,77,0,0,0,77
Hurricane,Georges,25,1998-09-21T15:00:00Z,ST CROIX VI,99,0,0,0,99
Hurricane,Georges,25,1998-09-21T15:00:00Z,MDSD 185N 697W,38,4,0,0,42
Hurricane,Georges,25,1998-09-21T15:00:00Z,ST THOMAS VI,99,0,0,0,99
Hurricane,Georges,25,1998-09-21T15:00:00Z,MDCB 176N 714W,2,20,1,0,23
Hurricane,Georges,25,1998-09-21T15:00:00Z,SAN JUAN PR,88,0,0,0,88
Hurricane,Georges,25,1998-09-21T15:00:00Z,MTPP 186N 724W,0,24,3,0,27
Hurricane,Georges,25,1998-09-21T15:00:00Z,PONCE PR,77,0,0,0,77
Hurricane,Georges,25,1998-09-21T15:00:00Z,MTCA 183N 738W,0,8,10,2,20
Hurricane,Georges,25,1998-09-21T15:00:00Z,MARATHON FL,0,0,0,8,8
Hurricane,Georges,25,1998-09-21T15:00:00Z,MKJP 179N 768W,0,0,3,8,11
Hurricane,Georges,25,1998-09-21T15:00:00Z,MIAMI FL,0,0,0,8,8
Hurricane,Georges,25,1998-09-21T15:00:00Z,MKJS 185N 779W,0,0,1,9,10
Hurricane,Georges,25,1998-09-21T15:00:00Z,W PALM BEACH FL,0,0,0,7,7
Hurricane,Georges,25,1998-09-21T15:00:00Z,MWCG 193N 814W,0,0,0,3,3
Hurricane,Georges,25,1998-09-21T15:00:00Z,FT PIERCE FL,0,0,0,5,5
Hurricane,Georges,25,1998-09-21T15:00:00Z,MUGM 200N 751W,0,2,16,4,22
Hurricane,Georges,25,1998-09-21T15:00:00Z,COCOA BEACH FL,0,0,0,4,4
Hurricane,Georges,25,1998-09-21T15:00:00Z,MUCM 214N 779W,0,0,2,14,16
Hurricane,Georges,25,1998-09-21T15:00:00Z,DAYTONA BEACH FL,0,0,0,2,2
Hurricane,Georges,25,1998-09-21T15:00:00Z,MUCF 221N 805W,0,0,0,9,9
Hurricane,Georges,25,1998-09-21T15:00:00Z,KEY WEST FL,0,0,0,6,6
Hurricane,Georges,25,1998-09-21T15:00:00Z,MUSN 216N 826W,0,0,0,3,3
Hurricane,Georges,25,1998-09-21T15:00:00Z,MARCO ISLAND FL,0,0,0,5,5
Hurricane,Georges,25,1998-09-21T15:00:00Z,MUHA 230N 824W,0,0,0,5,5
Hurricane,Georges,25,1998-09-21T15:00:00Z,FT MYERS FL,0,0,0,4,4
Hurricane,Georges,25,1998-09-21T15:00:00Z,TJSJ 184N 661W,88,0,0,0,88
Hurricane,Georges,25,1998-09-21T15:00:00Z,VENICE FL,0,0,0,3,3
Hurricane,Georges,25,1998-09-21T15:00:00Z,MDPP 198N 707W,15,26,0,0,41
Hurricane,Georges,25,1998-09-21T15:00:00Z,TAMPA FL,0,0,0,2,2
Hurricane,Georges,26,1998-09-21T21:00:00Z,19.2N  70.1W,54,0,0,0,54
Hurricane,Georges,26,1998-09-21T21:00:00Z,MYSM 241N 745W,0,1,10,6,17
Hurricane,Georges,26,1998-09-21T21:00:00Z,20.0N  72.5W,4,33,0,1,38
Hurricane,Georges,26,1998-09-21T21:00:00Z,MYEG 235N 758W,0,0,13,7,20
Hurricane,Georges,26,1998-09-21T21:00:00Z,21.0N  74.5W,0,14,13,1,28
Hurricane,Georges,26,1998-09-21T21:00:00Z,MYAK 241N 776W,0,0,3,14,17
Hurricane,Georges,26,1998-09-21T21:00:00Z,TISX 177N 648W,99,0,0,0,99
Hurricane,Georges,26,1998-09-21T21:00:00Z,MYNN 251N 775W,0,0,1,14,15
Hurricane,Georges,26,1998-09-21T21:00:00Z,TIST 183N 650W,99,0,0,0,99
Hurricane,Georges,26,1998-09-21T21:00:00Z,MYGF 266N 787W,0,0,0,11,11
Hurricane,Georges,26,1998-09-21T21:00:00Z,TJPS 180N 666W,99,0,0,0,99
Hurricane,Georges,26,1998-09-21T21:00:00Z,ST CROIX VI,99,0,0,0,99
Hurricane,Georges,26,1998-09-21T21:00:00Z,MDSD 185N 697W,51,0,0,0,51
Hurricane,Georges,26,1998-09-21T21:00:00Z,ST THOMAS VI,99,0,0,0,99
Hurricane,Georges,26,1998-09-21T21:00:00Z,MDCB 176N 714W,13,13,0,0,26
Hurricane,Georges,26,1998-09-21T21:00:00Z,SAN JUAN PR,99,0,0,0,99
Hurricane,Georges,26,1998-09-21T21:00:00Z,MTPP 186N 724W,5,27,0,0,32
Hurricane,Georges,26,1998-09-21T21:00:00Z,PONCE PR,99,0,0,0,99
Hurricane,Georges,26,1998-09-21T21:00:00Z,MTCA 183N 738W,0,17,4,1,22
Hurricane,Georges,26,1998-09-21T21:00:00Z,MARATHON FL,0,0,0,10,10
Hurricane,Georges,26,1998-09-21T21:00:00Z,MKJP 179N 768W,0,0,5,6,11
Hurricane,Georges,26,1998-09-21T21:00:00Z,MIAMI FL,0,0,0,11,11
Hurricane,Georges,26,1998-09-21T21:00:00Z,MKJS 185N 779W,0,0,3,8,11
Hurricane,Georges,26,1998-09-21T21:00:00Z,W PALM BEACH FL,0,0,0,9,9
Hurricane,Georges,26,1998-09-21T21:00:00Z,MWCG 193N 814W,0,0,0,4,4
Hurricane,Georges,26,1998-09-21T21:00:00Z,FT PIERCE FL,0,0,0,7,7
Hurricane,Georges,26,1998-09-21T21:00:00Z,MUGM 200N 751W,0,8,15,2,25
Hurricane,Georges,26,1998-09-21T21:00:00Z,COCOA BEACH FL,0,0,0,6,6
Hurricane,Georges,26,1998-09-21T21:00:00Z,MUCM 214N 779W,0,0,7,11,18
Hurricane,Georges,26,1998-09-21T21:00:00Z,DAYTONA BEACH FL,0,0,0,3,3
Hurricane,Georges,26,1998-09-21T21:00:00Z,MUCF 221N 805W,0,0,0,12,12
Hurricane,Georges,26,1998-09-21T21:00:00Z,KEY WEST FL,0,0,0,9,9
Hurricane,Georges,26,1998-09-21T21:00:00Z,MUSN 216N 826W,0,0,0,5,5
Hurricane,Georges,26,1998-09-21T21:00:00Z,MARCO ISLAND FL,0,0,0,8,8
Hurricane,Georges,26,1998-09-21T21:00:00Z,MUHA 230N 824W,0,0,0,7,7
Hurricane,Georges,26,1998-09-21T21:00:00Z,FT MYERS FL,0,0,0,7,7
Hurricane,Georges,26,1998-09-21T21:00:00Z,TJSJ 184N 661W,99,0,0,0,99
Hurricane,Georges,26,1998-09-21T21:00:00Z,VENICE FL,0,0,0,5,5
Hurricane,Georges,26,1998-09-21T21:00:00Z,MDPP 198N 707W,44,4,0,0,48
Hurricane,Georges,26,1998-09-21T21:00:00Z,TAMPA FL,0,0,0,4,4
Hurricane,Georges,26,1998-09-21T21:00:00Z,MBJT 215N 712W,12,20,0,0,32
Hurricane,Georges,26,1998-09-21T21:00:00Z,CEDAR KEY FL,0,0,0,2,2
Hurricane,Georges,26,1998-09-21T21:00:00Z,MYMM 224N 730W,0,16,7,1,24
Hurricane,Georges,27,1998-09-22T03:00:00Z,19.4N  71.3W,54,0,0,0,54
Hurricane,Georges,27,1998-09-22T03:00:00Z,MYMM 224N 730W,2,20,2,0,24
Hurricane,Georges,27,1998-09-22T03:00:00Z,20.4N  73.5W,8,28,0,0,36
Hurricane,Georges,27,1998-09-22T03:00:00Z,MYSM 241N 745W,0,3,10,4,17
Hurricane,Georges,27,1998-09-22T03:00:00Z,21.3N  75.4W,0,15,12,1,28
Hurricane,Georges,27,1998-09-22T03:00:00Z,MYEG 235N 758W,0,2,14,4,20
Hurricane,Georges,27,1998-09-22T03:00:00Z,TIST 183N 650W,3,0,0,0,3
Hurricane,Georges,27,1998-09-22T03:00:00Z,MYAK 241N 776W,0,0,8,10,18
Hurricane,Georges,27,1998-09-22T03:00:00Z,TJPS 180N 666W,99,0,0,0,99
Hurricane,Georges,27,1998-09-22T03:00:00Z,MYNN 251N 775W,0,0,4,11,15
Hurricane,Georges,27,1998-09-22T03:00:00Z,MDSD 185N 697W,72,0,0,0,72
Hurricane,Georges,27,1998-09-22T03:00:00Z,MYGF 266N 787W,0,0,0,11,11
Hurricane,Georges,27,1998-09-22T03:00:00Z,MDCB 176N 714W,27,2,0,0,29
Hurricane,Georges,27,1998-09-22T03:00:00Z,ST THOMAS VI,3,0,0,0,3
Hurricane,Georges,27,1998-09-22T03:00:00Z,MTPP 186N 724W,28,8,0,0,36
Hurricane,Georges,27,1998-09-22T03:00:00Z,SAN JUAN PR,99,0,0,0,99
Hurricane,Georges,27,1998-09-22T03:00:00Z,MTCA 183N 738W,2,20,1,0,23
Hurricane,Georges,27,1998-09-22T03:00:00Z,PONCE PR,99,0,0,0,99
Hurricane,Georges,27,1998-09-22T03:00:00Z,MKJP 179N 768W,0,1,7,3,11
Hurricane,Georges,27,1998-09-22T03:00:00Z,MARATHON FL,0,0,0,12,12
Hurricane,Georges,27,1998-09-22T03:00:00Z,MKJS 185N 779W,0,0,6,6,12
Hurricane,Georges,27,1998-09-22T03:00:00Z,MIAMI FL,0,0,0,12,12
Hurricane,Georges,27,1998-09-22T03:00:00Z,MWCG 193N 814W,0,0,0,6,6
Hurricane,Georges,27,1998-09-22T03:00:00Z,W PALM BEACH FL,0,0,0,10,10
Hurricane,Georges,27,1998-09-22T03:00:00Z,MUGM 200N 751W,0,20,7,0,27
Hurricane,Georges,27,1998-09-22T03:00:00Z,FT PIERCE FL,0,0,0,8,8
Hurricane,Georges,27,1998-09-22T03:00:00Z,MUCM 214N 779W,0,0,14,6,20
Hurricane,Georges,27,1998-09-22T03:00:00Z,COCOA BEACH FL,0,0,0,6,6
Hurricane,Georges,27,1998-09-22T03:00:00Z,MUCF 221N 805W,0,0,1,13,14
Hurricane,Georges,27,1998-09-22T03:00:00Z,DAYTONA BEACH FL,0,0,0,3,3
Hurricane,Georges,27,1998-09-22T03:00:00Z,MUSN 216N 826W,0,0,0,7,7
Hurricane,Georges,27,1998-09-22T03:00:00Z,KEY WEST FL,0,0,0,11,11
Hurricane,Georges,27,1998-09-22T03:00:00Z,MUHA 230N 824W,0,0,0,9,9
Hurricane,Georges,27,1998-09-22T03:00:00Z,MARCO ISLAND FL,0,0,0,9,9
Hurricane,Georges,27,1998-09-22T03:00:00Z,MUAN 219N 850W,0,0,0,2,2
Hurricane,Georges,27,1998-09-22T03:00:00Z,FT MYERS FL,0,0,0,8,8
Hurricane,Georges,27,1998-09-22T03:00:00Z,TJSJ 184N 661W,99,0,0,0,99
Hurricane,Georges,27,1998-09-22T03:00:00Z,VENICE FL,0,0,0,6,6
Hurricane,Georges,27,1998-09-22T03:00:00Z,MDPP 198N 707W,59,0,0,0,59
Hurricane,Georges,27,1998-09-22T03:00:00Z,TAMPA FL,0,0,0,4,4
Hurricane,Georges,27,1998-09-22T03:00:00Z,MBJT 215N 712W,26,5,0,0,31
Hurricane,Georges,27,1998-09-22T03:00:00Z,CEDAR KEY FL,0,0,0,2,2
Hurricane,Georges,28,1998-09-22T09:00:00Z,19.3N  72.7W,55,0,0,0,55
Hurricane,Georges,28,1998-09-22T09:00:00Z,MYAK 241N 776W,0,0,14,6,20
Hurricane,Georges,28,1998-09-22T09:00:00Z,20.4N  74.7W,11,26,0,0,37
Hurricane,Georges,28,1998-09-22T09:00:00Z,MYNN 251N 775W,0,0,8,9,17
Hurricane,Georges,28,1998-09-22T09:00:00Z,21.6N  76.7W,0,14,14,1,29
Hurricane,Georges,28,1998-09-22T09:00:00Z,MYGF 266N 787W,0,0,1,12,13
Hurricane,Georges,28,1998-09-22T09:00:00Z,TJPS 180N 666W,99,0,0,0,99
Hurricane,Georges,28,1998-09-22T09:00:00Z,PONCE PR,99,0,0,0,99
Hurricane,Georges,28,1998-09-22T09:00:00Z,MDSD 185N 697W,89,0,0,0,89
Hurricane,Georges,28,1998-09-22T09:00:00Z,MARATHON FL,0,0,1,15,16
Hurricane,Georges,28,1998-09-22T09:00:00Z,MDCB 176N 714W,52,0,0,0,52
Hurricane,Georges,28,1998-09-22T09:00:00Z,MIAMI FL,0,0,1,14,15
Hurricane,Georges,28,1998-09-22T09:00:00Z,MTPP 186N 724W,54,0,0,0,54
Hurricane,Georges,28,1998-09-22T09:00:00Z,W PALM BEACH FL,0,0,0,13,13
Hurricane,Georges,28,1998-09-22T09:00:00Z,MTCA 183N 738W,23,10,0,0,33
Hurricane,Georges,28,1998-09-22T09:00:00Z,FT PIERCE FL,0,0,0,11,11
Hurricane,Georges,28,1998-09-22T09:00:00Z,MKJP 179N 768W,0,5,7,1,13
Hurricane,Georges,28,1998-09-22T09:00:00Z,COCOA BEACH FL,0,0,0,9,9
Hurricane,Georges,28,1998-09-22T09:00:00Z,MKJS 185N 779W,0,1,10,2,13
Hurricane,Georges,28,1998-09-22T09:00:00Z,DAYTONA BEACH FL,0,0,0,6,6
Hurricane,Georges,28,1998-09-22T09:00:00Z,MWCG 193N 814W,0,0,1,6,7
Hurricane,Georges,28,1998-09-22T09:00:00Z,JACKSONVILLE FL,0,0,0,3,3
Hurricane,Georges,28,1998-09-22T09:00:00Z,MUGM 200N 751W,4,29,1,0,34
Hurricane,Georges,28,1998-09-22T09:00:00Z,KEY WEST FL,0,0,0,15,15
Hurricane,Georges,28,1998-09-22T09:00:00Z,MUCM 214N 779W,0,3,19,2,24
Hurricane,Georges,28,1998-09-22T09:00:00Z,MARCO ISLAND FL,0,0,0,13,13
Hurricane,Georges,28,1998-09-22T09:00:00Z,MUCF 221N 805W,0,0,5,12,17
Hurricane,Georges,28,1998-09-22T09:00:00Z,FT MYERS FL,0,0,0,12,12
Hurricane,Georges,28,1998-09-22T09:00:00Z,MUSN 216N 826W,0,0,0,11,11
Hurricane,Georges,28,1998-09-22T09:00:00Z,VENICE FL,0,0,0,10,10
Hurricane,Georges,28,1998-09-22T09:00:00Z,MUHA 230N 824W,0,0,0,13,13
Hurricane,Georges,28,1998-09-22T09:00:00Z,TAMPA FL,0,0,0,8,8
Hurricane,Georges,28,1998-09-22T09:00:00Z,MUAN 219N 850W,0,0,0,5,5
Hurricane,Georges,28,1998-09-22T09:00:00Z,CEDAR KEY FL,0,0,0,5,5
Hurricane,Georges,28,1998-09-22T09:00:00Z,MDPP 198N 707W,57,0,0,0,57
Hurricane,Georges,28,1998-09-22T09:00:00Z,ST MARKS FL,0,0,0,2,2
Hurricane,Georges,28,1998-09-22T09:00:00Z,MBJT 215N 712W,13,3,0,0,16
Hurricane,Georges,28,1998-09-22T09:00:00Z,APALACHICOLA FL,0,0,0,3,3
Hurricane,Georges,28,1998-09-22T09:00:00Z,MYMM 224N 730W,6,13,1,1,21
Hurricane,Georges,28,1998-09-22T09:00:00Z,PANAMA CITY FL,0,0,0,2,2
Hurricane,Georges,28,1998-09-22T09:00:00Z,MYSM 241N 745W,0,4,8,3,15
Hurricane,Georges,28,1998-09-22T09:00:00Z,GULF 29N 85W,0,0,0,4,4
Hurricane,Georges,28,1998-09-22T09:00:00Z,MYEG 235N 758W,0,6,13,2,21
Hurricane,Georges,28,1998-09-22T09:00:00Z,GULF 29N 87W,0,0,0,2,2
Hurricane,Georges,29,1998-09-22T15:00:00Z,19.8N  73.0W,52,0,0,0,52
Hurricane,Georges,29,1998-09-22T15:00:00Z,MYGF 266N 787W,0,0,6,11,17
Hurricane,Georges,29,1998-09-22T15:00:00Z,21.0N  75.5W,2,36,1,0,39
Hurricane,Georges,29,1998-09-22T15:00:00Z,MARATHON FL,0,0,6,13,19
Hurricane,Georges,29,1998-09-22T15:00:00Z,23.0N  77.8W,0,5,24,1,30
Hurricane,Georges,29,1998-09-22T15:00:00Z,MIAMI FL,0,0,6,13,19
Hurricane,Georges,29,1998-09-22T15:00:00Z,MDSD 185N 697W,99,0,0,0,99
Hurricane,Georges,29,1998-09-22T15:00:00Z,W PALM BEACH FL,0,0,3,15,18
Hurricane,Georges,29,1998-09-22T15:00:00Z,MDCB 176N 714W,43,0,0,0,43
Hurricane,Georges,29,1998-09-22T15:00:00Z,FT PIERCE FL,0,0,1,15,16
Hurricane,Georges,29,1998-09-22T15:00:00Z,MTPP 186N 724W,52,0,0,0,52
Hurricane,Georges,29,1998-09-22T15:00:00Z,COCOA BEACH FL,0,0,0,14,14
Hurricane,Georges,29,1998-09-22T15:00:00Z,MTCA 183N 738W,24,7,0,0,31
Hurricane,Georges,29,1998-09-22T15:00:00Z,DAYTONA BEACH FL,0,0,0,11,11
Hurricane,Georges,29,1998-09-22T15:00:00Z,MKJP 179N 768W,0,5,4,0,9
Hurricane,Georges,29,1998-09-22T15:00:00Z,JACKSONVILLE FL,0,0,0,8,8
Hurricane,Georges,29,1998-09-22T15:00:00Z,MKJS 185N 779W,0,3,6,1,10
Hurricane,Georges,29,1998-09-22T15:00:00Z,SAVANNAH GA,0,0,0,3,3
Hurricane,Georges,29,1998-09-22T15:00:00Z,MWCG 193N 814W,0,0,1,3,4
Hurricane,Georges,29,1998-09-22T15:00:00Z,CHARLESTON SC,0,0,0,2,2
Hurricane,Georges,29,1998-09-22T15:00:00Z,MUGM 200N 751W,8,31,0,0,39
Hurricane,Georges,29,1998-09-22T15:00:00Z,KEY WEST FL,0,0,3,14,17
Hurricane,Georges,29,1998-09-22T15:00:00Z,MUCM 214N 779W,0,10,19,0,29
Hurricane,Georges,29,1998-09-22T15:00:00Z,MARCO ISLAND FL,0,0,2,15,17
Hurricane,Georges,29,1998-09-22T15:00:00Z,MUCF 221N 805W,0,0,12,6,18
Hurricane,Georges,29,1998-09-22T15:00:00Z,FT MYERS FL,0,0,1,15,16
Hurricane,Georges,29,1998-09-22T15:00:00Z,MUSN 216N 826W,0,0,1,8,9
Hurricane,Georges,29,1998-09-22T15:00:00Z,VENICE FL,0,0,0,15,15
Hurricane,Georges,29,1998-09-22T15:00:00Z,MUHA 230N 824W,0,0,2,12,14
Hurricane,Georges,29,1998-09-22T15:00:00Z,TAMPA FL,0,0,0,13,13
Hurricane,Georges,29,1998-09-22T15:00:00Z,MUAN 219N 850W,0,0,0,4,4
Hurricane,Georges,29,1998-09-22T15:00:00Z,CEDAR KEY FL,0,0,0,10,10
Hurricane,Georges,29,1998-09-22T15:00:00Z,MDPP 198N 707W,62,0,0,0,62
Hurricane,Georges,29,1998-09-22T15:00:00Z,ST MARKS FL,0,0,0,7,7
Hurricane,Georges,29,1998-09-22T15:00:00Z,MBJT 215N 712W,20,2,0,0,22
Hurricane,Georges,29,1998-09-22T15:00:00Z,APALACHICOLA FL,0,0,0,7,7
Hurricane,Georges,29,1998-09-22T15:00:00Z,MYMM 224N 730W,14,13,0,0,27
Hurricane,Georges,29,1998-09-22T15:00:00Z,PANAMA CITY FL,0,0,0,5,5
Hurricane,Georges,29,1998-09-22T15:00:00Z,MYSM 241N 745W,0,9,8,1,18
Hurricane,Georges,29,1998-09-22T15:00:00Z,PENSACOLA FL,0,0,0,2,2
Hurricane,Georges,29,1998-09-22T15:00:00Z,MYEG 235N 758W,0,15,13,0,28
Hurricane,Georges,29,1998-09-22T15:00:00Z,GULF 29N 85W,0,0,0,8,8
Hurricane,Georges,29,1998-09-22T15:00:00Z,MYAK 241N 776W,0,2,23,1,26
Hurricane,Georges,29,1998-09-22T15:00:00Z,GULF 29N 87W,0,0,0,4,4
Hurricane,Georges,29,1998-09-22T15:00:00Z,MYNN 251N 775W,0,1,17,3,21
Hurricane,Georges,30,1998-09-22T21:00:00Z,20.4N  74.3W,54,0,0,0,54
Hurricane,Georges,30,1998-09-22T21:00:00Z,MARATHON FL,0,0,9,12,21
Hurricane,Georges,30,1998-09-22T21:00:00Z,21.7N  76.5W,6,31,0,0,37
Hurricane,Georges,30,1998-09-22T21:00:00Z,MIAMI FL,0,0,7,12,19
Hurricane,Georges,30,1998-09-22T21:00:00Z,23.0N  78.5W,0,11,16,0,27
Hurricane,Georges,30,1998-09-22T21:00:00Z,W PALM BEACH FL,0,0,3,14,17
Hurricane,Georges,30,1998-09-22T21:00:00Z,MDSD 185N 697W,99,0,0,0,99
Hurricane,Georges,30,1998-09-22T21:00:00Z,FT PIERCE FL,0,0,1,14,15
Hurricane,Georges,30,1998-09-22T21:00:00Z,MDCB 176N 714W,36,0,0,0,36
Hurricane,Georges,30,1998-09-22T21:00:00Z,COCOA BEACH FL,0,0,0,13,13
Hurricane,Georges,30,1998-09-22T21:00:00Z,MTPP 186N 724W,61,0,0,0,61
Hurricane,Georges,30,1998-09-22T21:00:00Z,DAYTONA BEACH FL,0,0,0,11,11
Hurricane,Georges,30,1998-09-22T21:00:00Z,MTCA 183N 738W,31,0,0,1,32
Hurricane,Georges,30,1998-09-22T21:00:00Z,JACKSONVILLE FL,0,0,0,7,7
Hurricane,Georges,30,1998-09-22T21:00:00Z,MKJP 179N 768W,0,5,1,0,6
Hurricane,Georges,30,1998-09-22T21:00:00Z,SAVANNAH GA,0,0,0,3,3
Hurricane,Georges,30,1998-09-22T21:00:00Z,MKJS 185N 779W,0,5,3,0,8
Hurricane,Georges,30,1998-09-22T21:00:00Z,KEY WEST FL,0,0,6,13,19
Hurricane,Georges,30,1998-09-22T21:00:00Z,MWCG 193N 814W,0,0,2,4,6
Hurricane,Georges,30,1998-09-22T21:00:00Z,MARCO ISLAND FL,0,0,2,16,18
Hurricane,Georges,30,1998-09-22T21:00:00Z,MUGM 200N 751W,41,3,0,0,44
Hurricane,Georges,30,1998-09-22T21:00:00Z,FT MYERS FL,0,0,1,16,17
Hurricane,Georges,30,1998-09-22T21:00:00Z,MUCM 214N 779W,0,25,4,0,29
Hurricane,Georges,30,1998-09-22T21:00:00Z,VENICE FL,0,0,0,16,16
Hurricane,Georges,30,1998-09-22T21:00:00Z,MUCF 221N 805W,0,1,16,3,20
Hurricane,Georges,30,1998-09-22T21:00:00Z,TAMPA FL,0,0,0,14,14
Hurricane,Georges,30,1998-09-22T21:00:00Z,MUSN 216N 826W,0,0,3,9,12
Hurricane,Georges,30,1998-09-22T21:00:00Z,CEDAR KEY FL,0,0,0,12,12
Hurricane,Georges,30,1998-09-22T21:00:00Z,MUHA 230N 824W,0,0,5,11,16
Hurricane,Georges,30,1998-09-22T21:00:00Z,ST MARKS FL,0,0,0,8,8
Hurricane,Georges,30,1998-09-22T21:00:00Z,MUAN 219N 850W,0,0,0,6,6
Hurricane,Georges,30,1998-09-22T21:00:00Z,APALACHICOLA FL,0,0,0,9,9
Hurricane,Georges,30,1998-09-22T21:00:00Z,MDPP 198N 707W,74,0,0,0,74
Hurricane,Georges,30,1998-09-22T21:00:00Z,PANAMA CITY FL,0,0,0,7,7
Hurricane,Georges,30,1998-09-22T21:00:00Z,MBJT 215N 712W,11,0,0,0,11
Hurricane,Georges,30,1998-09-22T21:00:00Z,PENSACOLA FL,0,0,0,4,4
Hurricane,Georges,30,1998-09-22T21:00:00Z,MYMM 224N 730W,23,3,0,0,26
Hurricane,Georges,30,1998-09-22T21:00:00Z,MOBILE AL,0,0,0,3,3
Hurricane,Georges,30,1998-09-22T21:00:00Z,MYSM 241N 745W,2,12,2,0,16
Hurricane,Georges,30,1998-09-22T21:00:00Z,GULFPORT MS,0,0,0,2,2
Hurricane,Georges,30,1998-09-22T21:00:00Z,MYEG 235N 758W,2,23,1,1,27
Hurricane,Georges,30,1998-09-22T21:00:00Z,BURAS LA,0,0,0,2,2
Hurricane,Georges,30,1998-09-22T21:00:00Z,MYAK 241N 776W,0,10,13,2,25
Hurricane,Georges,30,1998-09-22T21:00:00Z,GULF 29N 85W,0,0,0,10,10
Hurricane,Georges,30,1998-09-22T21:00:00Z,MYNN 251N 775W,0,3,14,3,20
Hurricane,Georges,30,1998-09-22T21:00:00Z,GULF 29N 87W,0,0,0,7,7
Hurricane,Georges,30,1998-09-22T21:00:00Z,MYGF 266N 787W,0,0,6,10,16
Hurricane,Georges,30,1998-09-22T21:00:00Z,GULF 28N 89W,0,0,0,3,3
Hurricane,Georges,31,1998-09-23T03:00:00Z,21.0N  75.5W,49,0,0,0,49
Hurricane,Georges,31,1998-09-23T03:00:00Z,MIAMI FL,0,0,16,6,22
Hurricane,Georges,31,1998-09-23T03:00:00Z,22.4N  77.7W,3,33,1,0,37
Hurricane,Georges,31,1998-09-23T03:00:00Z,W PALM BEACH FL,0,0,12,8,20
Hurricane,Georges,31,1998-09-23T03:00:00Z,23.7N  79.5W,0,11,16,1,28
Hurricane,Georges,31,1998-09-23T03:00:00Z,FT PIERCE FL,0,0,6,11,17
Hurricane,Georges,31,1998-09-23T03:00:00Z,MDCB 176N 714W,5,0,0,0,5
Hurricane,Georges,31,1998-09-23T03:00:00Z,COCOA BEACH FL,0,0,3,13,16
Hurricane,Georges,31,1998-09-23T03:00:00Z,MTPP 186N 724W,99,0,0,0,99
Hurricane,Georges,31,1998-09-23T03:00:00Z,DAYTONA BEACH FL,0,0,1,12,13
Hurricane,Georges,31,1998-09-23T03:00:00Z,MTCA 183N 738W,41,0,0,0,41
Hurricane,Georges,31,1998-09-23T03:00:00Z,JACKSONVILLE FL,0,0,0,9,9
Hurricane,Georges,31,1998-09-23T03:00:00Z,MKJP 179N 768W,2,2,1,0,5
Hurricane,Georges,31,1998-09-23T03:00:00Z,SAVANNAH GA,0,0,0,4,4
Hurricane,Georges,31,1998-09-23T03:00:00Z,MKJS 185N 779W,1,7,1,1,10
Hurricane,Georges,31,1998-09-23T03:00:00Z,CHARLESTON SC,0,0,0,2,2
Hurricane,Georges,31,1998-09-23T03:00:00Z,MWCG 193N 814W,0,0,3,3,6
Hurricane,Georges,31,1998-09-23T03:00:00Z,KEY WEST FL,0,0,13,8,21
Hurricane,Georges,31,1998-09-23T03:00:00Z,MUGM 200N 751W,51,0,0,0,51
Hurricane,Georges,31,1998-09-23T03:00:00Z,MARCO ISLAND FL,0,0,9,12,21
Hurricane,Georges,31,1998-09-23T03:00:00Z,MUCM 214N 779W,3,30,1,0,34
Hurricane,Georges,31,1998-09-23T03:00:00Z,FT MYERS FL,0,0,6,13,19
Hurricane,Georges,31,1998-09-23T03:00:00Z,MUCF 221N 805W,0,6,14,2,22
Hurricane,Georges,31,1998-09-23T03:00:00Z,VENICE FL,0,0,2,16,18
Hurricane,Georges,31,1998-09-23T03:00:00Z,MUSN 216N 826W,0,0,5,8,13
Hurricane,Georges,31,1998-09-23T03:00:00Z,TAMPA FL,0,0,1,15,16
Hurricane,Georges,31,1998-09-23T03:00:00Z,MUHA 230N 824W,0,0,9,8,17
Hurricane,Georges,31,1998-09-23T03:00:00Z,CEDAR KEY FL,0,0,0,13,13
Hurricane,Georges,31,1998-09-23T03:00:00Z,MUAN 219N 850W,0,0,0,6,6
Hurricane,Georges,31,1998-09-23T03:00:00Z,ST MARKS FL,0,0,0,10,10
Hurricane,Georges,31,1998-09-23T03:00:00Z,MDPP 198N 707W,52,0,0,0,52
Hurricane,Georges,31,1998-09-23T03:00:00Z,APALACHICOLA FL,0,0,0,10,10
Hurricane,Georges,31,1998-09-23T03:00:00Z,MBJT 215N 712W,4,0,0,0,4
Hurricane,Georges,31,1998-09-23T03:00:00Z,PANAMA CITY FL,0,0,0,9,9
Hurricane,Georges,31,1998-09-23T03:00:00Z,MYMM 224N 730W,25,1,0,0,26
Hurricane,Georges,31,1998-09-23T03:00:00Z,PENSACOLA FL,0,0,0,5,5
Hurricane,Georges,31,1998-09-23T03:00:00Z,MYSM 241N 745W,5,11,1,0,17
Hurricane,Georges,31,1998-09-23T03:00:00Z,MOBILE AL,0,0,0,3,3
Hurricane,Georges,31,1998-09-23T03:00:00Z,MYEG 235N 758W,8,22,0,0,30
Hurricane,Georges,31,1998-09-23T03:00:00Z,GULFPORT MS,0,0,0,2,2
Hurricane,Georges,31,1998-09-23T03:00:00Z,MYAK 241N 776W,0,23,5,0,28
Hurricane,Georges,31,1998-09-23T03:00:00Z,BURAS LA,0,0,0,2,2
Hurricane,Georges,31,1998-09-23T03:00:00Z,MYNN 251N 775W,0,12,9,1,22
Hurricane,Georges,31,1998-09-23T03:00:00Z,GULF 29N 85W,0,0,0,11,11
Hurricane,Georges,31,1998-09-23T03:00:00Z,MYGF 266N 787W,0,1,12,5,18
Hurricane,Georges,31,1998-09-23T03:00:00Z,GULF 29N 87W,0,0,0,7,7
Hurricane,Georges,31,1998-09-23T03:00:00Z,MARATHON FL,0,0,17,6,23
Hurricane,Georges,31,1998-09-23T03:00:00Z,GULF 28N 89W,0,0,0,3,3
Hurricane,Georges,32,1998-09-23T09:00:00Z,22.0N  77.6W,53,0,0,0,53
Hurricane,Georges,32,1998-09-23T09:00:00Z,FT PIERCE FL,0,1,15,4,20
Hurricane,Georges,32,1998-09-23T09:00:00Z,23.5N  79.5W,3,33,0,0,36
Hurricane,Georges,32,1998-09-23T09:00:00Z,COCOA BEACH FL,0,0,11,7,18
Hurricane,Georges,32,1998-09-23T09:00:00Z,25.0N  81.2W,0,12,16,1,29
Hurricane,Georges,32,1998-09-23T09:00:00Z,DAYTONA BEACH FL,0,0,5,10,15
Hurricane,Georges,32,1998-09-23T09:00:00Z,MTPP 186N 724W,99,0,0,0,99
Hurricane,Georges,32,1998-09-23T09:00:00Z,JACKSONVILLE FL,0,0,1,10,11
Hurricane,Georges,32,1998-09-23T09:00:00Z,MTCA 183N 738W,21,0,0,0,21
Hurricane,Georges,32,1998-09-23T09:00:00Z,SAVANNAH GA,0,0,0,6,6
Hurricane,Georges,32,1998-09-23T09:00:00Z,MKJS 185N 779W,2,0,0,1,3
Hurricane,Georges,32,1998-09-23T09:00:00Z,CHARLESTON SC,0,0,0,2,2
Hurricane,Georges,32,1998-09-23T09:00:00Z,MWCG 193N 814W,0,1,1,2,4
Hurricane,Georges,32,1998-09-23T09:00:00Z,KEY WEST FL,0,7,18,1,26
Hurricane,Georges,32,1998-09-23T09:00:00Z,MUGM 200N 751W,75,0,0,0,75
Hurricane,Georges,32,1998-09-23T09:00:00Z,MARCO ISLAND FL,0,3,20,2,25
Hurricane,Georges,32,1998-09-23T09:00:00Z,MUCM 214N 779W,46,0,0,0,46
Hurricane,Georges,32,1998-09-23T09:00:00Z,FT MYERS FL,0,1,18,4,23
Hurricane,Georges,32,1998-09-23T09:00:00Z,MUCF 221N 805W,1,23,2,0,26
Hurricane,Georges,32,1998-09-23T09:00:00Z,VENICE FL,0,0,14,7,21
Hurricane,Georges,32,1998-09-23T09:00:00Z,MUSN 216N 826W,0,2,8,3,13
Hurricane,Georges,32,1998-09-23T09:00:00Z,TAMPA FL,0,0,9,10,19
Hurricane,Georges,32,1998-09-23T09:00:00Z,MUHA 230N 824W,0,5,13,2,20
Hurricane,Georges,32,1998-09-23T09:00:00Z,CEDAR KEY FL,0,0,3,13,16
Hurricane,Georges,32,1998-09-23T09:00:00Z,MUAN 219N 850W,0,0,1,6,7
Hurricane,Georges,32,1998-09-23T09:00:00Z,ST MARKS FL,0,0,0,12,12
Hurricane,Georges,32,1998-09-23T09:00:00Z,MDPP 198N 707W,2,0,0,0,2
Hurricane,Georges,32,1998-09-23T09:00:00Z,APALACHICOLA FL,0,0,0,13,13
Hurricane,Georges,32,1998-09-23T09:00:00Z,MYMM 224N 730W,2,0,0,0,2
Hurricane,Georges,32,1998-09-23T09:00:00Z,PANAMA CITY FL,0,0,0,11,11
Hurricane,Georges,32,1998-09-23T09:00:00Z,MYSM 241N 745W,4,1,0,0,5
Hurricane,Georges,32,1998-09-23T09:00:00Z,PENSACOLA FL,0,0,0,7,7
Hurricane,Georges,32,1998-09-23T09:00:00Z,MYEG 235N 758W,32,1,0,0,33
Hurricane,Georges,32,1998-09-23T09:00:00Z,MOBILE AL,0,0,0,5,5
Hurricane,Georges,32,1998-09-23T09:00:00Z,MYAK 241N 776W,19,15,0,0,34
Hurricane,Georges,32,1998-09-23T09:00:00Z,GULFPORT MS,0,0,0,4,4
Hurricane,Georges,32,1998-09-23T09:00:00Z,MYNN 251N 775W,3,20,1,0,24
Hurricane,Georges,32,1998-09-23T09:00:00Z,BURAS LA,0,0,0,3,3
Hurricane,Georges,32,1998-09-23T09:00:00Z,MYGF 266N 787W,0,9,9,2,20
Hurricane,Georges,32,1998-09-23T09:00:00Z,NEW ORLEANS LA,0,0,0,2,2
Hurricane,Georges,32,1998-09-23T09:00:00Z,MARATHON FL,0,14,14,1,29
Hurricane,Georges,32,1998-09-23T09:00:00Z,GULF 29N 85W,0,0,1,13,14
Hurricane,Georges,32,1998-09-23T09:00:00Z,MIAMI FL,0,12,14,2,28
Hurricane,Georges,32,1998-09-23T09:00:00Z,GULF 29N 87W,0,0,0,9,9
Hurricane,Georges,32,1998-09-23T09:00:00Z,W PALM BEACH FL,0,5,16,2,23
Hurricane,Georges,32,1998-09-23T09:00:00Z,GULF 28N 89W,0,0,0,4,4
Hurricane,Georges,33,1998-09-23T15:00:00Z,22.4N  78.0W,51,1,0,0,52
Hurricane,Georges,33,1998-09-23T15:00:00Z,JACKSONVILLE FL,0,0,1,10,11
Hurricane,Georges,33,1998-09-23T15:00:00Z,24.0N  80.5W,2,36,0,1,39
Hurricane,Georges,33,1998-09-23T15:00:00Z,SAVANNAH GA,0,0,0,5,5
Hurricane,Georges,33,1998-09-23T15:00:00Z,25.5N  82.0W,0,15,12,1,28
Hurricane,Georges,33,1998-09-23T15:00:00Z,CHARLESTON SC,0,0,0,2,2
Hurricane,Georges,33,1998-09-23T15:00:00Z,MTCA 183N 738W,4,0,0,0,4
Hurricane,Georges,33,1998-09-23T15:00:00Z,KEY WEST FL,0,24,6,1,31
Hurricane,Georges,33,1998-09-23T15:00:00Z,MKJS 185N 779W,3,0,0,0,3
Hurricane,Georges,33,1998-09-23T15:00:00Z,MARCO ISLAND FL,0,13,13,2,28
Hurricane,Georges,33,1998-09-23T15:00:00Z,MWCG 193N 814W,0,1,0,1,2
Hurricane,Georges,33,1998-09-23T15:00:00Z,FT MYERS FL,0,7,17,2,26
Hurricane,Georges,33,1998-09-23T15:00:00Z,MUGM 200N 751W,99,0,0,0,99
Hurricane,Georges,33,1998-09-23T15:00:00Z,VENICE FL,0,2,18,4,24
Hurricane,Georges,33,1998-09-23T15:00:00Z,MUCM 214N 779W,53,0,0,0,53
Hurricane,Georges,33,1998-09-23T15:00:00Z,TAMPA FL,0,0,15,6,21
Hurricane,Georges,33,1998-09-23T15:00:00Z,MUCF 221N 805W,5,26,0,0,31
Hurricane,Georges,33,1998-09-23T15:00:00Z,CEDAR KEY FL,0,0,7,11,18
Hurricane,Georges,33,1998-09-23T15:00:00Z,MUSN 216N 826W,0,6,5,2,13
Hurricane,Georges,33,1998-09-23T15:00:00Z,ST MARKS FL,0,0,1,14,15
Hurricane,Georges,33,1998-09-23T15:00:00Z,MUHA 230N 824W,0,16,6,1,23
Hurricane,Georges,33,1998-09-23T15:00:00Z,APALACHICOLA FL,0,0,1,15,16
Hurricane,Georges,33,1998-09-23T15:00:00Z,MUAN 219N 850W,0,0,2,4,6
Hurricane,Georges,33,1998-09-23T15:00:00Z,PANAMA CITY FL,0,0,1,14,15
Hurricane,Georges,33,1998-09-23T15:00:00Z,MYEG 235N 758W,22,1,1,0,24
Hurricane,Georges,33,1998-09-23T15:00:00Z,PENSACOLA FL,0,0,0,12,12
Hurricane,Georges,33,1998-09-23T15:00:00Z,MYAK 241N 776W,27,10,0,0,37
Hurricane,Georges,33,1998-09-23T15:00:00Z,MOBILE AL,0,0,0,10,10
Hurricane,Georges,33,1998-09-23T15:00:00Z,MYNN 251N 775W,8,15,1,0,24
Hurricane,Georges,33,1998-09-23T15:00:00Z,GULFPORT MS,0,0,0,9,9
Hurricane,Georges,33,1998-09-23T15:00:00Z,MYGF 266N 787W,0,11,4,2,17
Hurricane,Georges,33,1998-09-23T15:00:00Z,BURAS LA,0,0,0,8,8
Hurricane,Georges,33,1998-09-23T15:00:00Z,MARATHON FL,0,31,3,0,34
Hurricane,Georges,33,1998-09-23T15:00:00Z,NEW ORLEANS LA,0,0,0,6,6
Hurricane,Georges,33,1998-09-23T15:00:00Z,MIAMI FL,0,24,4,1,29
Hurricane,Georges,33,1998-09-23T15:00:00Z,NEW IBERIA LA,0,0,0,3,3
Hurricane,Georges,33,1998-09-23T15:00:00Z,W PALM BEACH FL,0,12,9,1,22
Hurricane,Georges,33,1998-09-23T15:00:00Z,GULF 29N 85W,0,0,3,15,18
Hurricane,Georges,33,1998-09-23T15:00:00Z,FT PIERCE FL,0,4,12,3,19
Hurricane,Georges,33,1998-09-23T15:00:00Z,GULF 29N 87W,0,0,0,14,14
Hurricane,Georges,33,1998-09-23T15:00:00Z,COCOA BEACH FL,0,1,11,5,17
Hurricane,Georges,33,1998-09-23T15:00:00Z,GULF 28N 89W,0,0,0,9,9
Hurricane,Georges,33,1998-09-23T15:00:00Z,DAYTONA BEACH FL,0,0,6,9,15
Hurricane,Georges,33,1998-09-23T15:00:00Z,GULF 28N 91W,0,0,0,3,3
Hurricane,Georges,34,1998-09-23T21:00:00Z,22.0N  78.5W,50,0,0,0,50
Hurricane,Georges,34,1998-09-23T21:00:00Z,JACKSONVILLE FL,0,0,2,10,12
Hurricane,Georges,34,1998-09-23T21:00:00Z,23.5N  80.0W,8,28,1,0,37
Hurricane,Georges,34,1998-09-23T21:00:00Z,SAVANNAH GA,0,0,0,6,6
Hurricane,Georges,34,1998-09-23T21:00:00Z,25.5N  82.0W,0,6,24,1,31
Hurricane,Georges,34,1998-09-23T21:00:00Z,CHARLESTON SC,0,0,0,2,2
Hurricane,Georges,34,1998-09-23T21:00:00Z,MKJP 179N 768W,2,0,0,0,2
Hurricane,Georges,34,1998-09-23T21:00:00Z,KEY WEST FL,0,14,18,1,33
Hurricane,Georges,34,1998-09-23T21:00:00Z,MKJS 185N 779W,8,0,0,0,8
Hurricane,Georges,34,1998-09-23T21:00:00Z,MARCO ISLAND FL,0,5,24,1,30
Hurricane,Georges,34,1998-09-23T21:00:00Z,MWCG 193N 814W,0,3,1,0,4
Hurricane,Georges,34,1998-09-23T21:00:00Z,FT MYERS FL,0,2,23,2,27
Hurricane,Georges,34,1998-09-23T21:00:00Z,MUGM 200N 751W,99,0,0,0,99
Hurricane,Georges,34,1998-09-23T21:00:00Z,VENICE FL,0,1,20,3,24
Hurricane,Georges,34,1998-09-23T21:00:00Z,MUCM 214N 779W,66,0,0,0,66
Hurricane,Georges,34,1998-09-23T21:00:00Z,TAMPA FL,0,0,15,7,22
Hurricane,Georges,34,1998-09-23T21:00:00Z,MUCF 221N 805W,9,21,1,0,31
Hurricane,Georges,34,1998-09-23T21:00:00Z,CEDAR KEY FL,0,0,7,11,18
Hurricane,Georges,34,1998-09-23T21:00:00Z,MUSN 216N 826W,0,5,9,1,15
Hurricane,Georges,34,1998-09-23T21:00:00Z,ST MARKS FL,0,0,1,14,15
Hurricane,Georges,34,1998-09-23T21:00:00Z,MUHA 230N 824W,0,10,14,0,24
Hurricane,Georges,34,1998-09-23T21:00:00Z,APALACHICOLA FL,0,0,1,15,16
Hurricane,Georges,34,1998-09-23T21:00:00Z,MUAN 219N 850W,0,0,2,4,6
Hurricane,Georges,34,1998-09-23T21:00:00Z,PANAMA CITY FL,0,0,1,14,15
Hurricane,Georges,34,1998-09-23T21:00:00Z,MYEG 235N 758W,11,2,0,1,14
Hurricane,Georges,34,1998-09-23T21:00:00Z,PENSACOLA FL,0,0,0,12,12
Hurricane,Georges,34,1998-09-23T21:00:00Z,MYAK 241N 776W,24,5,0,0,29
Hurricane,Georges,34,1998-09-23T21:00:00Z,MOBILE AL,0,0,0,9,9
Hurricane,Georges,34,1998-09-23T21:00:00Z,MYNN 251N 775W,6,12,2,0,20
Hurricane,Georges,34,1998-09-23T21:00:00Z,GULFPORT MS,0,0,0,8,8
Hurricane,Georges,34,1998-09-23T21:00:00Z,MYGF 266N 787W,0,9,9,1,19
Hurricane,Georges,34,1998-09-23T21:00:00Z,BURAS LA,0,0,0,7,7
Hurricane,Georges,34,1998-09-23T21:00:00Z,MARATHON FL,0,21,14,0,35
Hurricane,Georges,34,1998-09-23T21:00:00Z,NEW ORLEANS LA,0,0,0,5,5
Hurricane,Georges,34,1998-09-23T21:00:00Z,MIAMI FL,0,16,15,0,31
Hurricane,Georges,34,1998-09-23T21:00:00Z,NEW IBERIA LA,0,0,0,2,2
Hurricane,Georges,34,1998-09-23T21:00:00Z,W PALM BEACH FL,0,7,17,1,25
Hurricane,Georges,34,1998-09-23T21:00:00Z,GULF 29N 85W,0,0,3,15,18
Hurricane,Georges,34,1998-09-23T21:00:00Z,FT PIERCE FL,0,2,16,2,20
Hurricane,Georges,34,1998-09-23T21:00:00Z,GULF 29N 87W,0,0,0,14,14
Hurricane,Georges,34,1998-09-23T21:00:00Z,COCOA BEACH FL,0,1,12,5,18
Hurricane,Georges,34,1998-09-23T21:00:00Z,GULF 28N 89W,0,0,0,8,8
Hurricane,Georges,34,1998-09-23T21:00:00Z,DAYTONA BEACH FL,0,0,7,8,15
Hurricane,Georges,34,1998-09-23T21:00:00Z,GULF 28N 91W,0,0,0,3,3
Hurricane,Georges,35,1998-09-24T03:00:00Z,23.0N  79.0W,49,0,0,0,49
Hurricane,Georges,35,1998-09-24T03:00:00Z,CHARLESTON SC,0,0,0,2,2
Hurricane,Georges,35,1998-09-24T03:00:00Z,24.6N  80.8W,10,25,0,0,35
Hurricane,Georges,35,1998-09-24T03:00:00Z,KEY WEST FL,3,26,1,1,31
Hurricane,Georges,35,1998-09-24T03:00:00Z,26.0N  82.5W,0,16,9,2,27
Hurricane,Georges,35,1998-09-24T03:00:00Z,MARCO ISLAND FL,0,22,5,1,28
Hurricane,Georges,35,1998-09-24T03:00:00Z,MUGM 200N 751W,99,0,0,0,99
Hurricane,Georges,35,1998-09-24T03:00:00Z,FT MYERS FL,0,15,9,2,26
Hurricane,Georges,35,1998-09-24T03:00:00Z,MUCM 214N 779W,58,0,0,0,58
Hurricane,Georges,35,1998-09-24T03:00:00Z,VENICE FL,0,7,15,2,24
Hurricane,Georges,35,1998-09-24T03:00:00Z,MUCF 221N 805W,20,7,1,0,28
Hurricane,Georges,35,1998-09-24T03:00:00Z,TAMPA FL,0,2,15,4,21
Hurricane,Georges,35,1998-09-24T03:00:00Z,MUSN 216N 826W,0,5,4,2,11
Hurricane,Georges,35,1998-09-24T03:00:00Z,CEDAR KEY FL,0,0,10,8,18
Hurricane,Georges,35,1998-09-24T03:00:00Z,MUHA 230N 824W,1,16,3,1,21
Hurricane,Georges,35,1998-09-24T03:00:00Z,ST MARKS FL,0,0,3,13,16
Hurricane,Georges,35,1998-09-24T03:00:00Z,MUAN 219N 850W,0,0,2,4,6
Hurricane,Georges,35,1998-09-24T03:00:00Z,APALACHICOLA FL,0,0,4,13,17
Hurricane,Georges,35,1998-09-24T03:00:00Z,MYEG 235N 758W,18,0,0,1,19
Hurricane,Georges,35,1998-09-24T03:00:00Z,PANAMA CITY FL,0,0,2,14,16
Hurricane,Georges,35,1998-09-24T03:00:00Z,MYAK 241N 776W,36,0,0,1,37
Hurricane,Georges,35,1998-09-24T03:00:00Z,PENSACOLA FL,0,0,0,13,13
Hurricane,Georges,35,1998-09-24T03:00:00Z,MYNN 251N 775W,13,7,0,1,21
Hurricane,Georges,35,1998-09-24T03:00:00Z,MOBILE AL,0,0,0,11,11
Hurricane,Georges,35,1998-09-24T03:00:00Z,MYGF 266N 787W,1,11,3,1,16
Hurricane,Georges,35,1998-09-24T03:00:00Z,GULFPORT MS,0,0,0,9,9
Hurricane,Georges,35,1998-09-24T03:00:00Z,MARATHON FL,7,26,1,0,34
Hurricane,Georges,35,1998-09-24T03:00:00Z,BURAS LA,0,0,0,8,8
Hurricane,Georges,35,1998-09-24T03:00:00Z,MIAMI FL,3,24,1,1,29
Hurricane,Georges,35,1998-09-24T03:00:00Z,NEW ORLEANS LA,0,0,0,6,6
Hurricane,Georges,35,1998-09-24T03:00:00Z,W PALM BEACH FL,1,16,4,1,22
Hurricane,Georges,35,1998-09-24T03:00:00Z,NEW IBERIA LA,0,0,0,2,2
Hurricane,Georges,35,1998-09-24T03:00:00Z,FT PIERCE FL,0,8,8,3,19
Hurricane,Georges,35,1998-09-24T03:00:00Z,GULF 29N 85W,0,0,6,12,18
Hurricane,Georges,35,1998-09-24T03:00:00Z,COCOA BEACH FL,0,3,10,4,17
Hurricane,Georges,35,1998-09-24T03:00:00Z,GULF 29N 87W,0,0,1,14,15
Hurricane,Georges,35,1998-09-24T03:00:00Z,DAYTONA BEACH FL,0,0,8,7,15
Hurricane,Georges,35,1998-09-24T03:00:00Z,GULF 28N 89W,0,0,0,9,9
Hurricane,Georges,35,1998-09-24T03:00:00Z,JACKSONVILLE FL,0,0,2,10,12
Hurricane,Georges,35,1998-09-24T03:00:00Z,GULF 28N 91W,0,0,0,3,3
Hurricane,Georges,35,1998-09-24T03:00:00Z,SAVANNAH GA,0,0,0,6,6
Hurricane,Georges,36,1998-09-24T09:00:00Z,23.3N  79.9W,53,0,0,0,53
Hurricane,Georges,36,1998-09-24T09:00:00Z,KEY WEST FL,5,30,1,0,36
Hurricane,Georges,36,1998-09-24T09:00:00Z,24.8N  81.8W,4,31,0,0,35
Hurricane,Georges,36,1998-09-24T09:00:00Z,MARCO ISLAND FL,0,26,2,1,29
Hurricane,Georges,36,1998-09-24T09:00:00Z,26.2N  83.3W,0,13,12,1,26
Hurricane,Georges,36,1998-09-24T09:00:00Z,FT MYERS FL,0,18,6,1,25
Hurricane,Georges,36,1998-09-24T09:00:00Z,MUCM 214N 779W,83,0,0,0,83
Hurricane,Georges,36,1998-09-24T09:00:00Z,VENICE FL,0,10,12,1,23
Hurricane,Georges,36,1998-09-24T09:00:00Z,MUCF 221N 805W,40,1,0,0,41
Hurricane,Georges,36,1998-09-24T09:00:00Z,TAMPA FL,0,3,14,3,20
Hurricane,Georges,36,1998-09-24T09:00:00Z,MUSN 216N 826W,2,11,0,1,14
Hurricane,Georges,36,1998-09-24T09:00:00Z,CEDAR KEY FL,0,0,9,8,17
Hurricane,Georges,36,1998-09-24T09:00:00Z,MUHA 230N 824W,4,23,0,0,27
Hurricane,Georges,36,1998-09-24T09:00:00Z,ST MARKS FL,0,0,3,12,15
Hurricane,Georges,36,1998-09-24T09:00:00Z,MUAN 219N 850W,0,1,3,2,6
Hurricane,Georges,36,1998-09-24T09:00:00Z,APALACHICOLA FL,0,0,4,13,17
Hurricane,Georges,36,1998-09-24T09:00:00Z,MYEG 235N 758W,5,0,0,0,5
Hurricane,Georges,36,1998-09-24T09:00:00Z,PANAMA CITY FL,0,0,2,14,16
Hurricane,Georges,36,1998-09-24T09:00:00Z,MYAK 241N 776W,40,0,0,0,40
Hurricane,Georges,36,1998-09-24T09:00:00Z,PENSACOLA FL,0,0,0,15,15
Hurricane,Georges,36,1998-09-24T09:00:00Z,MYNN 251N 775W,18,1,0,0,19
Hurricane,Georges,36,1998-09-24T09:00:00Z,MOBILE AL,0,0,0,13,13
Hurricane,Georges,36,1998-09-24T09:00:00Z,MYGF 266N 787W,4,8,2,0,14
Hurricane,Georges,36,1998-09-24T09:00:00Z,GULFPORT MS,0,0,0,12,12
Hurricane,Georges,36,1998-09-24T09:00:00Z,MARATHON FL,13,25,0,0,38
Hurricane,Georges,36,1998-09-24T09:00:00Z,BURAS LA,0,0,0,11,11
Hurricane,Georges,36,1998-09-24T09:00:00Z,MIAMI FL,7,21,1,0,29
Hurricane,Georges,36,1998-09-24T09:00:00Z,NEW ORLEANS LA,0,0,0,10,10
Hurricane,Georges,36,1998-09-24T09:00:00Z,W PALM BEACH FL,1,16,2,1,20
Hurricane,Georges,36,1998-09-24T09:00:00Z,NEW IBERIA LA,0,0,0,6,6
Hurricane,Georges,36,1998-09-24T09:00:00Z,FT PIERCE FL,0,8,6,2,16
Hurricane,Georges,36,1998-09-24T09:00:00Z,PORT ARTHUR TX,0,0,0,2,2
Hurricane,Georges,36,1998-09-24T09:00:00Z,COCOA BEACH FL,0,3,8,3,14
Hurricane,Georges,36,1998-09-24T09:00:00Z,GULF 29N 85W,0,0,8,11,19
Hurricane,Georges,36,1998-09-24T09:00:00Z,DAYTONA BEACH FL,0,0,6,6,12
Hurricane,Georges,36,1998-09-24T09:00:00Z,GULF 29N 87W,0,0,3,14,17
Hurricane,Georges,36,1998-09-24T09:00:00Z,JACKSONVILLE FL,0,0,2,8,10
Hurricane,Georges,36,1998-09-24T09:00:00Z,GULF 28N 89W,0,0,1,11,12
Hurricane,Georges,36,1998-09-24T09:00:00Z,SAVANNAH GA,0,0,0,5,5
Hurricane,Georges,36,1998-09-24T09:00:00Z,GULF 28N 91W,0,0,0,7,7
Hurricane,Georges,36,1998-09-24T09:00:00Z,CHARLESTON SC,0,0,0,2,2
Hurricane,Georges,36,1998-09-24T09:00:00Z,GULF 28N 93W,0,0,0,2,2
Hurricane,Georges,37,1998-09-24T15:00:00Z,24.1N  80.8W,49,0,0,0,49
Hurricane,Georges,37,1998-09-24T15:00:00Z,MARCO ISLAND FL,14,19,0,0,33
Hurricane,Georges,37,1998-09-24T15:00:00Z,25.5N  82.5W,10,23,0,0,33
Hurricane,Georges,37,1998-09-24T15:00:00Z,FT MYERS FL,4,24,1,1,30
Hurricane,Georges,37,1998-09-24T15:00:00Z,27.0N  84.0W,0,14,11,1,26
Hurricane,Georges,37,1998-09-24T15:00:00Z,VENICE FL,1,21,5,0,27
Hurricane,Georges,37,1998-09-24T15:00:00Z,MUCM 214N 779W,99,0,0,0,99
Hurricane,Georges,37,1998-09-24T15:00:00Z,TAMPA FL,0,12,10,1,23
Hurricane,Georges,37,1998-09-24T15:00:00Z,MUCF 221N 805W,39,0,0,0,39
Hurricane,Georges,37,1998-09-24T15:00:00Z,CEDAR KEY FL,0,2,14,4,20
Hurricane,Georges,37,1998-09-24T15:00:00Z,MUSN 216N 826W,4,3,0,1,8
Hurricane,Georges,37,1998-09-24T15:00:00Z,ST MARKS FL,0,0,9,8,17
Hurricane,Georges,37,1998-09-24T15:00:00Z,MUHA 230N 824W,20,5,0,0,25
Hurricane,Georges,37,1998-09-24T15:00:00Z,APALACHICOLA FL,0,0,11,8,19
Hurricane,Georges,37,1998-09-24T15:00:00Z,MUAN 219N 850W,0,1,1,2,4
Hurricane,Georges,37,1998-09-24T15:00:00Z,PANAMA CITY FL,0,0,8,10,18
Hurricane,Georges,37,1998-09-24T15:00:00Z,MYAK 241N 776W,27,0,1,0,28
Hurricane,Georges,37,1998-09-24T15:00:00Z,PENSACOLA FL,0,0,2,14,16
Hurricane,Georges,37,1998-09-24T15:00:00Z,MYNN 251N 775W,8,1,0,1,10
Hurricane,Georges,37,1998-09-24T15:00:00Z,MOBILE AL,0,0,1,14,15
Hurricane,Georges,37,1998-09-24T15:00:00Z,MYGF 266N 787W,7,6,1,0,14
Hurricane,Georges,37,1998-09-24T15:00:00Z,GULFPORT MS,0,0,0,13,13
Hurricane,Georges,37,1998-09-24T15:00:00Z,MARATHON FL,43,1,0,0,44
Hurricane,Georges,37,1998-09-24T15:00:00Z,BURAS LA,0,0,0,12,12
Hurricane,Georges,37,1998-09-24T15:00:00Z,MIAMI FL,30,4,1,0,35
Hurricane,Georges,37,1998-09-24T15:00:00Z,NEW ORLEANS LA,0,0,0,11,11
Hurricane,Georges,37,1998-09-24T15:00:00Z,W PALM BEACH FL,12,11,1,0,24
Hurricane,Georges,37,1998-09-24T15:00:00Z,NEW IBERIA LA,0,0,0,7,7
Hurricane,Georges,37,1998-09-24T15:00:00Z,FT PIERCE FL,2,14,2,1,19
Hurricane,Georges,37,1998-09-24T15:00:00Z,PORT ARTHUR TX,0,0,0,2,2
Hurricane,Georges,37,1998-09-24T15:00:00Z,COCOA BEACH FL,0,10,5,2,17
Hurricane,Georges,37,1998-09-24T15:00:00Z,GULF 29N 85W,0,0,15,5,20
Hurricane,Georges,37,1998-09-24T15:00:00Z,DAYTONA BEACH FL,0,2,9,4,15
Hurricane,Georges,37,1998-09-24T15:00:00Z,GULF 29N 87W,0,0,7,11,18
Hurricane,Georges,37,1998-09-24T15:00:00Z,JACKSONVILLE FL,0,0,5,7,12
Hurricane,Georges,37,1998-09-24T15:00:00Z,GULF 28N 89W,0,0,2,11,13
Hurricane,Georges,37,1998-09-24T15:00:00Z,SAVANNAH GA,0,0,1,5,6
Hurricane,Georges,37,1998-09-24T15:00:00Z,GULF 28N 91W,0,0,0,7,7
Hurricane,Georges,37,1998-09-24T15:00:00Z,CHARLESTON SC,0,0,0,2,2
Hurricane,Georges,37,1998-09-24T15:00:00Z,GULF 28N 93W,0,0,0,3,3
Hurricane,Georges,37,1998-09-24T15:00:00Z,KEY WEST FL,35,5,0,0,40
Hurricane,Georges,40,1998-09-25T09:00:00Z,26.2N  84.0W,48,0,0,0,48
Hurricane,Georges,40,1998-09-25T09:00:00Z,ST MARKS FL,1,12,5,2,20
Hurricane,Georges,40,1998-09-25T09:00:00Z,27.5N  85.5W,17,16,0,0,33
Hurricane,Georges,40,1998-09-25T09:00:00Z,APALACHICOLA FL,2,16,5,1,24
Hurricane,Georges,40,1998-09-25T09:00:00Z,29.0N  87.0W,0,15,10,1,26
Hurricane,Georges,40,1998-09-25T09:00:00Z,PANAMA CITY FL,0,13,9,2,24
Hurricane,Georges,40,1998-09-25T09:00:00Z,MUHA 230N 824W,22,0,0,0,22
Hurricane,Georges,40,1998-09-25T09:00:00Z,PENSACOLA FL,0,3,15,4,22
Hurricane,Georges,40,1998-09-25T09:00:00Z,MARATHON FL,78,0,0,1,79
Hurricane,Georges,40,1998-09-25T09:00:00Z,MOBILE AL,0,1,14,5,20
Hurricane,Georges,40,1998-09-25T09:00:00Z,MIAMI FL,29,0,0,1,30
Hurricane,Georges,40,1998-09-25T09:00:00Z,GULFPORT MS,0,0,13,6,19
Hurricane,Georges,40,1998-09-25T09:00:00Z,W PALM BEACH FL,6,0,1,0,7
Hurricane,Georges,40,1998-09-25T09:00:00Z,BURAS LA,0,0,13,5,18
Hurricane,Georges,40,1998-09-25T09:00:00Z,FT PIERCE FL,4,1,0,1,6
Hurricane,Georges,40,1998-09-25T09:00:00Z,NEW ORLEANS LA,0,0,8,9,17
Hurricane,Georges,40,1998-09-25T09:00:00Z,COCOA BEACH FL,3,2,1,1,7
Hurricane,Georges,40,1998-09-25T09:00:00Z,NEW IBERIA LA,0,0,2,11,13
Hurricane,Georges,40,1998-09-25T09:00:00Z,DAYTONA BEACH FL,2,3,2,1,8
Hurricane,Georges,40,1998-09-25T09:00:00Z,PORT ARTHUR TX,0,0,0,8,8
Hurricane,Georges,40,1998-09-25T09:00:00Z,JACKSONVILLE FL,0,3,2,3,8
Hurricane,Georges,40,1998-09-25T09:00:00Z,GALVESTON TX,0,0,0,5,5
Hurricane,Georges,40,1998-09-25T09:00:00Z,SAVANNAH GA,0,0,1,2,3
Hurricane,Georges,40,1998-09-25T09:00:00Z,FREEPORT TX,0,0,0,3,3
Hurricane,Georges,40,1998-09-25T09:00:00Z,KEY WEST FL,80,0,0,0,80
Hurricane,Georges,40,1998-09-25T09:00:00Z,GULF 29N 85W,6,19,2,1,28
Hurricane,Georges,40,1998-09-25T09:00:00Z,MARCO ISLAND FL,57,0,0,0,57
Hurricane,Georges,40,1998-09-25T09:00:00Z,GULF 29N 87W,0,15,10,1,26
Hurricane,Georges,40,1998-09-25T09:00:00Z,FT MYERS FL,46,0,0,0,46
Hurricane,Georges,40,1998-09-25T09:00:00Z,GULF 28N 89W,0,3,13,3,19
Hurricane,Georges,40,1998-09-25T09:00:00Z,VENICE FL,42,0,0,0,42
Hurricane,Georges,40,1998-09-25T09:00:00Z,GULF 28N 91W,0,0,5,8,13
Hurricane,Georges,40,1998-09-25T09:00:00Z,TAMPA FL,26,2,0,0,28
Hurricane,Georges,40,1998-09-25T09:00:00Z,GULF 28N 93W,0,0,1,6,7
Hurricane,Georges,40,1998-09-25T09:00:00Z,CEDAR KEY FL,10,9,1,1,21
Hurricane,Georges,40,1998-09-25T09:00:00Z,GULF 28N 95W,0,0,0,3,3
Hurricane,Georges,39,1998-09-25T03:00:00Z,25.8N  82.8W,49,0,0,0,49
Hurricane,Georges,39,1998-09-25T03:00:00Z,TAMPA FL,20,10,0,0,30
Hurricane,Georges,39,1998-09-25T03:00:00Z,27.2N  84.5W,13,21,0,0,34
Hurricane,Georges,39,1998-09-25T03:00:00Z,CEDAR KEY FL,3,17,2,1,23
Hurricane,Georges,39,1998-09-25T03:00:00Z,28.5N  86.0W,0,16,8,2,26
Hurricane,Georges,39,1998-09-25T03:00:00Z,ST MARKS FL,0,7,10,2,19
Hurricane,Georges,39,1998-09-25T03:00:00Z,MUCF 221N 805W,14,0,0,0,14
Hurricane,Georges,39,1998-09-25T03:00:00Z,APALACHICOLA FL,0,11,9,2,22
Hurricane,Georges,39,1998-09-25T03:00:00Z,MUHA 230N 824W,22,1,0,0,23
Hurricane,Georges,39,1998-09-25T03:00:00Z,PANAMA CITY FL,0,5,14,3,22
Hurricane,Georges,39,1998-09-25T03:00:00Z,MYAK 241N 776W,5,0,0,0,5
Hurricane,Georges,39,1998-09-25T03:00:00Z,PENSACOLA FL,0,0,13,7,20
Hurricane,Georges,39,1998-09-25T03:00:00Z,MYGF 266N 787W,1,1,0,0,2
Hurricane,Georges,39,1998-09-25T03:00:00Z,MOBILE AL,0,0,8,10,18
Hurricane,Georges,39,1998-09-25T03:00:00Z,MARATHON FL,75,0,0,0,75
Hurricane,Georges,39,1998-09-25T03:00:00Z,GULFPORT MS,0,0,6,11,17
Hurricane,Georges,39,1998-09-25T03:00:00Z,MIAMI FL,46,0,0,0,46
Hurricane,Georges,39,1998-09-25T03:00:00Z,BURAS LA,0,0,7,9,16
Hurricane,Georges,39,1998-09-25T03:00:00Z,W PALM BEACH FL,22,0,0,0,22
Hurricane,Georges,39,1998-09-25T03:00:00Z,NEW ORLEANS LA,0,0,3,12,15
Hurricane,Georges,39,1998-09-25T03:00:00Z,FT PIERCE FL,13,3,0,0,16
Hurricane,Georges,39,1998-09-25T03:00:00Z,NEW IBERIA LA,0,0,1,10,11
Hurricane,Georges,39,1998-09-25T03:00:00Z,COCOA BEACH FL,8,6,0,1,15
Hurricane,Georges,39,1998-09-25T03:00:00Z,PORT ARTHUR TX,0,0,0,6,6
Hurricane,Georges,39,1998-09-25T03:00:00Z,DAYTONA BEACH FL,2,8,2,1,13
Hurricane,Georges,39,1998-09-25T03:00:00Z,GALVESTON TX,0,0,0,4,4
Hurricane,Georges,39,1998-09-25T03:00:00Z,JACKSONVILLE FL,0,3,5,2,10
Hurricane,Georges,39,1998-09-25T03:00:00Z,FREEPORT TX,0,0,0,3,3
Hurricane,Georges,39,1998-09-25T03:00:00Z,SAVANNAH GA,0,0,1,4,5
Hurricane,Georges,39,1998-09-25T03:00:00Z,GULF 29N 85W,1,17,7,1,26
Hurricane,Georges,39,1998-09-25T03:00:00Z,CHARLESTON SC,0,0,0,2,2
Hurricane,Georges,39,1998-09-25T03:00:00Z,GULF 29N 87W,0,5,15,3,23
Hurricane,Georges,39,1998-09-25T03:00:00Z,KEY WEST FL,60,0,0,0,60
Hurricane,Georges,39,1998-09-25T03:00:00Z,GULF 28N 89W,0,0,11,6,17
Hurricane,Georges,39,1998-09-25T03:00:00Z,MARCO ISLAND FL,53,0,0,0,53
Hurricane,Georges,39,1998-09-25T03:00:00Z,GULF 28N 91W,0,0,2,9,11
Hurricane,Georges,39,1998-09-25T03:00:00Z,FT MYERS FL,44,0,0,0,44
Hurricane,Georges,39,1998-09-25T03:00:00Z,GULF 28N 93W,0,0,0,6,6
Hurricane,Georges,39,1998-09-25T03:00:00Z,VENICE FL,37,2,0,0,39
Hurricane,Georges,39,1998-09-25T03:00:00Z,GULF 28N 95W,0,0,0,2,2
Hurricane,Georges,41,1998-09-25T15:00:00Z,26.7N  85.3W,54,0,0,0,54
Hurricane,Georges,41,1998-09-25T15:00:00Z,APALACHICOLA FL,8,14,1,1,24
Hurricane,Georges,41,1998-09-25T15:00:00Z,28.1N  86.7W,16,18,0,1,35
Hurricane,Georges,41,1998-09-25T15:00:00Z,PANAMA CITY FL,3,17,3,1,24
Hurricane,Georges,41,1998-09-25T15:00:00Z,29.6N  87.9W,0,15,11,1,27
Hurricane,Georges,41,1998-09-25T15:00:00Z,PENSACOLA FL,0,11,12,2,25
Hurricane,Georges,41,1998-09-25T15:00:00Z,MUHA 230N 824W,16,0,0,0,16
Hurricane,Georges,41,1998-09-25T15:00:00Z,MOBILE AL,0,4,16,3,23
Hurricane,Georges,41,1998-09-25T15:00:00Z,MARATHON FL,99,0,0,0,99
Hurricane,Georges,41,1998-09-25T15:00:00Z,GULFPORT MS,0,2,17,3,22
Hurricane,Georges,41,1998-09-25T15:00:00Z,MIAMI FL,9,0,0,0,9
Hurricane,Georges,41,1998-09-25T15:00:00Z,BURAS LA,0,3,15,3,21
Hurricane,Georges,41,1998-09-25T15:00:00Z,DAYTONA BEACH FL,0,0,1,2,3
Hurricane,Georges,41,1998-09-25T15:00:00Z,NEW ORLEANS LA,0,1,13,5,19
Hurricane,Georges,41,1998-09-25T15:00:00Z,JACKSONVILLE FL,0,1,1,3,5
Hurricane,Georges,41,1998-09-25T15:00:00Z,NEW IBERIA LA,0,0,5,8,13
Hurricane,Georges,41,1998-09-25T15:00:00Z,SAVANNAH GA,0,0,0,3,3
Hurricane,Georges,41,1998-09-25T15:00:00Z,PORT ARTHUR TX,0,0,0,6,6
Hurricane,Georges,41,1998-09-25T15:00:00Z,KEY WEST FL,99,0,0,0,99
Hurricane,Georges,41,1998-09-25T15:00:00Z,GALVESTON TX,0,0,0,3,3
Hurricane,Georges,41,1998-09-25T15:00:00Z,MARCO ISLAND FL,56,0,0,0,56
Hurricane,Georges,41,1998-09-25T15:00:00Z,GULF 29N 85W,20,9,1,0,30
Hurricane,Georges,41,1998-09-25T15:00:00Z,FT MYERS FL,39,0,1,0,40
Hurricane,Georges,41,1998-09-25T15:00:00Z,GULF 29N 87W,2,25,2,1,30
Hurricane,Georges,41,1998-09-25T15:00:00Z,VENICE FL,40,0,0,0,40
Hurricane,Georges,41,1998-09-25T15:00:00Z,GULF 28N 89W,0,13,7,1,21
Hurricane,Georges,41,1998-09-25T15:00:00Z,TAMPA FL,19,0,0,1,20
Hurricane,Georges,41,1998-09-25T15:00:00Z,GULF 28N 91W,0,1,8,3,12
Hurricane,Georges,41,1998-09-25T15:00:00Z,CEDAR KEY FL,10,4,1,1,16
Hurricane,Georges,41,1998-09-25T15:00:00Z,GULF 28N 93W,0,0,1,4,5
Hurricane,Georges,41,1998-09-25T15:00:00Z,ST MARKS FL,3,11,2,2,18
Hurricane,Georges,42,1998-09-25T21:00:00Z,27.3N  86.2W,49,0,0,0,49
Hurricane,Georges,42,1998-09-25T21:00:00Z,PANAMA CITY FL,13,10,2,1,26
Hurricane,Georges,42,1998-09-25T21:00:00Z,28.8N  87.7W,15,19,0,0,34
Hurricane,Georges,42,1998-09-25T21:00:00Z,PENSACOLA FL,2,19,3,2,26
Hurricane,Georges,42,1998-09-25T21:00:00Z,30.1N  88.2W,1,22,2,2,27
Hurricane,Georges,42,1998-09-25T21:00:00Z,MOBILE AL,0,16,6,2,24
Hurricane,Georges,42,1998-09-25T21:00:00Z,MARATHON FL,14,0,0,0,14
Hurricane,Georges,42,1998-09-25T21:00:00Z,GULFPORT MS,0,14,7,2,23
Hurricane,Georges,42,1998-09-25T21:00:00Z,DAYTONA BEACH FL,0,0,0,3,3
Hurricane,Georges,42,1998-09-25T21:00:00Z,BURAS LA,0,16,5,1,22
Hurricane,Georges,42,1998-09-25T21:00:00Z,JACKSONVILLE FL,0,0,1,4,5
Hurricane,Georges,42,1998-09-25T21:00:00Z,NEW ORLEANS LA,0,7,9,4,20
Hurricane,Georges,42,1998-09-25T21:00:00Z,SAVANNAH GA,0,0,0,3,3
Hurricane,Georges,42,1998-09-25T21:00:00Z,NEW IBERIA LA,0,1,7,6,14
Hurricane,Georges,42,1998-09-25T21:00:00Z,KEY WEST FL,99,0,0,0,99
Hurricane,Georges,42,1998-09-25T21:00:00Z,PORT ARTHUR TX,0,0,1,5,6
Hurricane,Georges,42,1998-09-25T21:00:00Z,MARCO ISLAND FL,37,0,0,0,37
Hurricane,Georges,42,1998-09-25T21:00:00Z,GALVESTON TX,0,0,0,3,3
Hurricane,Georges,42,1998-09-25T21:00:00Z,FT MYERS FL,20,0,0,0,20
Hurricane,Georges,42,1998-09-25T21:00:00Z,FREEPORT TX,0,0,0,2,2
Hurricane,Georges,42,1998-09-25T21:00:00Z,VENICE FL,27,0,0,0,27
Hurricane,Georges,42,1998-09-25T21:00:00Z,GULF 29N 85W,29,1,1,0,31
Hurricane,Georges,42,1998-09-25T21:00:00Z,TAMPA FL,8,1,1,1,11
Hurricane,Georges,42,1998-09-25T21:00:00Z,GULF 29N 87W,20,15,0,0,35
Hurricane,Georges,42,1998-09-25T21:00:00Z,CEDAR KEY FL,6,3,1,2,12
Hurricane,Georges,42,1998-09-25T21:00:00Z,GULF 28N 89W,3,20,1,1,25
Hurricane,Georges,42,1998-09-25T21:00:00Z,ST MARKS FL,6,7,2,2,17
Hurricane,Georges,42,1998-09-25T21:00:00Z,GULF 28N 91W,0,5,5,3,13
Hurricane,Georges,42,1998-09-25T21:00:00Z,APALACHICOLA FL,17,6,1,1,25
Hurricane,Georges,42,1998-09-25T21:00:00Z,GULF 28N 93W,0,0,2,3,5
Hurricane,Georges,43,1998-09-26T03:00:00Z,26.5N  86.5W,51,0,0,0,51
Hurricane,Georges,43,1998-09-26T03:00:00Z,MOBILE AL,0,7,10,4,21
Hurricane,Georges,43,1998-09-26T03:00:00Z,27.7N  87.9W,16,19,1,0,36
Hurricane,Georges,43,1998-09-26T03:00:00Z,GULFPORT MS,0,6,11,5,22
Hurricane,Georges,43,1998-09-26T03:00:00Z,29.0N  88.6W,1,22,3,1,27
Hurricane,Georges,43,1998-09-26T03:00:00Z,BURAS LA,0,11,9,3,23
Hurricane,Georges,43,1998-09-26T03:00:00Z,DAYTONA BEACH FL,0,0,0,2,2
Hurricane,Georges,43,1998-09-26T03:00:00Z,NEW ORLEANS LA,0,3,12,5,20
Hurricane,Georges,43,1998-09-26T03:00:00Z,JACKSONVILLE FL,0,0,0,4,4
Hurricane,Georges,43,1998-09-26T03:00:00Z,NEW IBERIA LA,0,0,8,8,16
Hurricane,Georges,43,1998-09-26T03:00:00Z,SAVANNAH GA,0,0,0,2,2
Hurricane,Georges,43,1998-09-26T03:00:00Z,PORT ARTHUR TX,0,0,1,9,10
Hurricane,Georges,43,1998-09-26T03:00:00Z,MARCO ISLAND FL,12,0,0,0,12
Hurricane,Georges,43,1998-09-26T03:00:00Z,GALVESTON TX,0,0,0,6,6
Hurricane,Georges,43,1998-09-26T03:00:00Z,FT MYERS FL,2,0,0,1,3
Hurricane,Georges,43,1998-09-26T03:00:00Z,FREEPORT TX,0,0,0,4,4
Hurricane,Georges,43,1998-09-26T03:00:00Z,VENICE FL,3,0,0,2,5
Hurricane,Georges,43,1998-09-26T03:00:00Z,PORT O CONNOR TX,0,0,0,2,2
Hurricane,Georges,43,1998-09-26T03:00:00Z,TAMPA FL,0,0,1,4,5
Hurricane,Georges,43,1998-09-26T03:00:00Z,GULF 29N 85W,15,5,1,1,22
Hurricane,Georges,43,1998-09-26T03:00:00Z,CEDAR KEY FL,0,1,2,4,7
Hurricane,Georges,43,1998-09-26T03:00:00Z,GULF 29N 87W,12,16,1,1,30
Hurricane,Georges,43,1998-09-26T03:00:00Z,ST MARKS FL,1,3,3,5,12
Hurricane,Georges,43,1998-09-26T03:00:00Z,GULF 28N 89W,1,24,2,0,27
Hurricane,Georges,43,1998-09-26T03:00:00Z,APALACHICOLA FL,5,8,2,3,18
Hurricane,Georges,43,1998-09-26T03:00:00Z,GULF 28N 91W,0,5,9,3,17
Hurricane,Georges,43,1998-09-26T03:00:00Z,PANAMA CITY FL,4,10,2,3,19
Hurricane,Georges,43,1998-09-26T03:00:00Z,GULF 28N 93W,0,0,4,5,9
Hurricane,Georges,43,1998-09-26T03:00:00Z,PENSACOLA FL,0,11,6,4,21
Hurricane,Georges,43,1998-09-26T03:00:00Z,GULF 28N 95W,0,0,0,3,3
Hurricane,Georges,44,1998-09-26T09:00:00Z,27.1N  87.3W,43,0,0,0,43
Hurricane,Georges,44,1998-09-26T09:00:00Z,PANAMA CITY FL,4,6,3,4,17
Hurricane,Georges,44,1998-09-26T09:00:00Z,28.0N  88.5W,21,6,1,1,29
Hurricane,Georges,44,1998-09-26T09:00:00Z,PENSACOLA FL,2,9,4,4,19
Hurricane,Georges,44,1998-09-26T09:00:00Z,29.0N  89.5W,4,18,2,2,26
Hurricane,Georges,44,1998-09-26T09:00:00Z,MOBILE AL,1,10,6,3,20
Hurricane,Georges,44,1998-09-26T09:00:00Z,MUHA 230N 824W,0,0,0,2,2
Hurricane,Georges,44,1998-09-26T09:00:00Z,GULFPORT MS,1,13,5,3,22
Hurricane,Georges,44,1998-09-26T09:00:00Z,MUAN 219N 850W,0,0,0,2,2
Hurricane,Georges,44,1998-09-26T09:00:00Z,BURAS LA,2,18,3,2,25
Hurricane,Georges,44,1998-09-26T09:00:00Z,MARATHON FL,0,0,0,3,3
Hurricane,Georges,44,1998-09-26T09:00:00Z,NEW ORLEANS LA,0,15,6,2,23
Hurricane,Georges,44,1998-09-26T09:00:00Z,MIAMI FL,0,0,0,3,3
Hurricane,Georges,44,1998-09-26T09:00:00Z,NEW IBERIA LA,0,9,8,4,21
Hurricane,Georges,44,1998-09-26T09:00:00Z,W PALM BEACH FL,0,0,0,3,3
Hurricane,Georges,44,1998-09-26T09:00:00Z,PORT ARTHUR TX,0,2,8,5,15
Hurricane,Georges,44,1998-09-26T09:00:00Z,FT PIERCE FL,0,0,0,3,3
Hurricane,Georges,44,1998-09-26T09:00:00Z,GALVESTON TX,0,1,5,6,12
Hurricane,Georges,44,1998-09-26T09:00:00Z,COCOA BEACH FL,0,0,1,2,3
Hurricane,Georges,44,1998-09-26T09:00:00Z,FREEPORT TX,0,0,4,6,10
Hurricane,Georges,44,1998-09-26T09:00:00Z,DAYTONA BEACH FL,0,0,1,3,4
Hurricane,Georges,44,1998-09-26T09:00:00Z,PORT O CONNOR TX,0,0,1,5,6
Hurricane,Georges,44,1998-09-26T09:00:00Z,JACKSONVILLE FL,0,0,0,4,4
Hurricane,Georges,44,1998-09-26T09:00:00Z,CORPUSCHRISTI TX,0,0,0,3,3
Hurricane,Georges,44,1998-09-26T09:00:00Z,SAVANNAH GA,0,0,0,2,2
Hurricane,Georges,44,1998-09-26T09:00:00Z,GULF 29N 85W,11,4,2,2,19
Hurricane,Georges,44,1998-09-26T09:00:00Z,KEY WEST FL,0,0,1,2,3
Hurricane,Georges,44,1998-09-26T09:00:00Z,GULF 29N 87W,17,6,1,1,25
Hurricane,Georges,44,1998-09-26T09:00:00Z,MARCO ISLAND FL,0,0,1,4,5
Hurricane,Georges,44,1998-09-26T09:00:00Z,GULF 28N 89W,15,10,1,1,27
Hurricane,Georges,44,1998-09-26T09:00:00Z,FT MYERS FL,0,1,1,4,6
Hurricane,Georges,44,1998-09-26T09:00:00Z,GULF 28N 91W,1,14,3,2,20
Hurricane,Georges,44,1998-09-26T09:00:00Z,VENICE FL,1,2,2,3,8
Hurricane,Georges,44,1998-09-26T09:00:00Z,GULF 28N 93W,0,4,5,5,14
Hurricane,Georges,44,1998-09-26T09:00:00Z,TAMPA FL,1,2,2,3,8
Hurricane,Georges,44,1998-09-26T09:00:00Z,GULF 28N 95W,0,0,3,5,8
Hurricane,Georges,44,1998-09-26T09:00:00Z,CEDAR KEY FL,1,2,2,4,9
Hurricane,Georges,44,1998-09-26T09:00:00Z,GULF 27N 96W,0,0,0,4,4
Hurricane,Georges,44,1998-09-26T09:00:00Z,ST MARKS FL,1,3,3,4,11
Hurricane,Georges,44,1998-09-26T09:00:00Z,GULF 25N 96W,0,0,0,2,2
Hurricane,Georges,44,1998-09-26T09:00:00Z,APALACHICOLA FL,5,5,3,3,16
Hurricane,Georges,45,1998-09-26T15:00:00Z,28.2N  88.4W,45,0,0,0,45
Hurricane,Georges,45,1998-09-26T15:00:00Z,APALACHICOLA FL,4,4,3,4,15
Hurricane,Georges,45,1998-09-26T15:00:00Z,29.0N  89.1W,30,2,1,0,33
Hurricane,Georges,45,1998-09-26T15:00:00Z,PANAMA CITY FL,5,5,3,3,16
Hurricane,Georges,45,1998-09-26T15:00:00Z,29.9N  89.6W,15,12,1,1,29
Hurricane,Georges,45,1998-09-26T15:00:00Z,PENSACOLA FL,8,7,3,2,20
Hurricane,Georges,45,1998-09-26T15:00:00Z,MUHA 230N 824W,0,0,0,2,2
Hurricane,Georges,45,1998-09-26T15:00:00Z,MOBILE AL,6,11,3,2,22
Hurricane,Georges,45,1998-09-26T15:00:00Z,MUAN 219N 850W,0,0,0,2,2
Hurricane,Georges,45,1998-09-26T15:00:00Z,GULFPORT MS,8,14,2,1,25
Hurricane,Georges,45,1998-09-26T15:00:00Z,MARATHON FL,0,0,0,2,2
Hurricane,Georges,45,1998-09-26T15:00:00Z,BURAS LA,19,10,0,1,30
Hurricane,Georges,45,1998-09-26T15:00:00Z,MIAMI FL,0,0,0,2,2
Hurricane,Georges,45,1998-09-26T15:00:00Z,NEW ORLEANS LA,6,18,1,1,26
Hurricane,Georges,45,1998-09-26T15:00:00Z,W PALM BEACH FL,0,0,0,2,2
Hurricane,Georges,45,1998-09-26T15:00:00Z,NEW IBERIA LA,1,15,3,2,21
Hurricane,Georges,45,1998-09-26T15:00:00Z,FT PIERCE FL,0,0,0,2,2
Hurricane,Georges,45,1998-09-26T15:00:00Z,PORT ARTHUR TX,0,4,6,4,14
Hurricane,Georges,45,1998-09-26T15:00:00Z,COCOA BEACH FL,0,0,0,3,3
Hurricane,Georges,45,1998-09-26T15:00:00Z,GALVESTON TX,0,1,3,6,10
Hurricane,Georges,45,1998-09-26T15:00:00Z,DAYTONA BEACH FL,0,0,0,3,3
Hurricane,Georges,45,1998-09-26T15:00:00Z,FREEPORT TX,0,0,2,6,8
Hurricane,Georges,45,1998-09-26T15:00:00Z,JACKSONVILLE FL,0,0,0,4,4
Hurricane,Georges,45,1998-09-26T15:00:00Z,PORT O CONNOR TX,0,0,0,5,5
Hurricane,Georges,45,1998-09-26T15:00:00Z,SAVANNAH GA,0,0,0,2,2
Hurricane,Georges,45,1998-09-26T15:00:00Z,CORPUSCHRISTI TX,0,0,0,2,2
Hurricane,Georges,45,1998-09-26T15:00:00Z,KEY WEST FL,0,0,0,2,2
Hurricane,Georges,45,1998-09-26T15:00:00Z,GULF 29N 85W,8,3,3,2,16
Hurricane,Georges,45,1998-09-26T15:00:00Z,MARCO ISLAND FL,0,0,1,2,3
Hurricane,Georges,45,1998-09-26T15:00:00Z,GULF 29N 87W,32,0,1,0,33
Hurricane,Georges,45,1998-09-26T15:00:00Z,FT MYERS FL,0,0,1,3,4
Hurricane,Georges,45,1998-09-26T15:00:00Z,GULF 28N 89W,37,0,0,0,37
Hurricane,Georges,45,1998-09-26T15:00:00Z,VENICE FL,0,0,2,4,6
Hurricane,Georges,45,1998-09-26T15:00:00Z,GULF 28N 91W,8,7,2,2,19
Hurricane,Georges,45,1998-09-26T15:00:00Z,TAMPA FL,0,0,2,4,6
Hurricane,Georges,45,1998-09-26T15:00:00Z,GULF 28N 93W,0,3,3,6,12
Hurricane,Georges,45,1998-09-26T15:00:00Z,CEDAR KEY FL,0,1,2,5,8
Hurricane,Georges,45,1998-09-26T15:00:00Z,GULF 28N 95W,0,0,1,6,7
Hurricane,Georges,45,1998-09-26T15:00:00Z,ST MARKS FL,0,2,3,5,10
Hurricane,Georges,45,1998-09-26T15:00:00Z,GULF 27N 96W,0,0,0,3,3
Hurricane,Georges,46,1998-09-26T21:00:00Z,28.1N  88.5W,44,0,0,0,44
Hurricane,Georges,46,1998-09-26T21:00:00Z,APALACHICOLA FL,3,3,3,4,13
Hurricane,Georges,46,1998-09-26T21:00:00Z,28.9N  89.3W,30,2,1,0,33
Hurricane,Georges,46,1998-09-26T21:00:00Z,PANAMA CITY FL,5,3,4,3,15
Hurricane,Georges,46,1998-09-26T21:00:00Z,29.7N  89.7W,18,10,1,1,30
Hurricane,Georges,46,1998-09-26T21:00:00Z,PENSACOLA FL,7,6,4,2,19
Hurricane,Georges,46,1998-09-26T21:00:00Z,MUHA 230N 824W,0,0,0,2,2
Hurricane,Georges,46,1998-09-26T21:00:00Z,MOBILE AL,7,9,3,2,21
Hurricane,Georges,46,1998-09-26T21:00:00Z,MUAN 219N 850W,0,0,0,2,2
Hurricane,Georges,46,1998-09-26T21:00:00Z,GULFPORT MS,10,12,2,1,25
Hurricane,Georges,46,1998-09-26T21:00:00Z,MARATHON FL,0,0,0,2,2
Hurricane,Georges,46,1998-09-26T21:00:00Z,BURAS LA,22,8,1,0,31
Hurricane,Georges,46,1998-09-26T21:00:00Z,MIAMI FL,0,0,0,2,2
Hurricane,Georges,46,1998-09-26T21:00:00Z,NEW ORLEANS LA,9,16,1,1,27
Hurricane,Georges,46,1998-09-26T21:00:00Z,W PALM BEACH FL,0,0,0,2,2
Hurricane,Georges,46,1998-09-26T21:00:00Z,NEW IBERIA LA,1,15,3,2,21
Hurricane,Georges,46,1998-09-26T21:00:00Z,FT PIERCE FL,0,0,0,2,2
Hurricane,Georges,46,1998-09-26T21:00:00Z,PORT ARTHUR TX,0,4,5,5,14
Hurricane,Georges,46,1998-09-26T21:00:00Z,COCOA BEACH FL,0,0,0,2,2
Hurricane,Georges,46,1998-09-26T21:00:00Z,GALVESTON TX,0,1,2,6,9
Hurricane,Georges,46,1998-09-26T21:00:00Z,DAYTONA BEACH FL,0,0,0,3,3
Hurricane,Georges,46,1998-09-26T21:00:00Z,FREEPORT TX,0,0,1,6,7
Hurricane,Georges,46,1998-09-26T21:00:00Z,JACKSONVILLE FL,0,0,0,3,3
Hurricane,Georges,46,1998-09-26T21:00:00Z,PORT O CONNOR TX,0,0,0,4,4
Hurricane,Georges,46,1998-09-26T21:00:00Z,SAVANNAH GA,0,0,0,2,2
Hurricane,Georges,46,1998-09-26T21:00:00Z,CORPUSCHRISTI TX,0,0,0,2,2
Hurricane,Georges,46,1998-09-26T21:00:00Z,KEY WEST FL,0,0,0,2,2
Hurricane,Georges,46,1998-09-26T21:00:00Z,GULF 29N 85W,11,2,1,2,16
Hurricane,Georges,46,1998-09-26T21:00:00Z,MARCO ISLAND FL,0,0,0,3,3
Hurricane,Georges,46,1998-09-26T21:00:00Z,GULF 29N 87W,36,0,0,0,36
Hurricane,Georges,46,1998-09-26T21:00:00Z,FT MYERS FL,0,0,1,3,4
Hurricane,Georges,46,1998-09-26T21:00:00Z,GULF 28N 89W,35,0,1,0,36
Hurricane,Georges,46,1998-09-26T21:00:00Z,VENICE FL,0,0,2,4,6
Hurricane,Georges,46,1998-09-26T21:00:00Z,GULF 28N 91W,6,7,2,3,18
Hurricane,Georges,46,1998-09-26T21:00:00Z,TAMPA FL,0,0,2,4,6
Hurricane,Georges,46,1998-09-26T21:00:00Z,GULF 28N 93W,0,2,3,6,11
Hurricane,Georges,46,1998-09-26T21:00:00Z,CEDAR KEY FL,0,0,2,5,7
Hurricane,Georges,46,1998-09-26T21:00:00Z,GULF 28N 95W,0,0,1,5,6
Hurricane,Georges,46,1998-09-26T21:00:00Z,ST MARKS FL,0,1,3,5,9
Hurricane,Georges,46,1998-09-26T21:00:00Z,GULF 27N 96W,0,0,0,3,3
Hurricane,Georges,47,1998-09-27T03:00:00Z,28.8N  88.7W,47,0,0,0,47
Hurricane,Georges,47,1998-09-27T03:00:00Z,GULFPORT MS,16,7,1,2,26
Hurricane,Georges,47,1998-09-27T03:00:00Z,29.4N  89.5W,28,1,1,1,31
Hurricane,Georges,47,1998-09-27T03:00:00Z,BURAS LA,26,2,0,1,29
Hurricane,Georges,47,1998-09-27T03:00:00Z,30.3N  90.0W,16,8,1,2,27
Hurricane,Georges,47,1998-09-27T03:00:00Z,NEW ORLEANS LA,17,7,1,1,26
Hurricane,Georges,47,1998-09-27T03:00:00Z,MUAN 219N 850W,0,0,0,2,2
Hurricane,Georges,47,1998-09-27T03:00:00Z,NEW IBERIA LA,6,9,3,3,21
Hurricane,Georges,47,1998-09-27T03:00:00Z,DAYTONA BEACH FL,0,0,0,2,2
Hurricane,Georges,47,1998-09-27T03:00:00Z,PORT ARTHUR TX,0,4,4,6,14
Hurricane,Georges,47,1998-09-27T03:00:00Z,JACKSONVILLE FL,0,0,0,2,2
Hurricane,Georges,47,1998-09-27T03:00:00Z,GALVESTON TX,0,1,2,6,9
Hurricane,Georges,47,1998-09-27T03:00:00Z,MARCO ISLAND FL,0,0,0,2,2
Hurricane,Georges,47,1998-09-27T03:00:00Z,FREEPORT TX,0,0,1,6,7
Hurricane,Georges,47,1998-09-27T03:00:00Z,FT MYERS FL,0,0,0,2,2
Hurricane,Georges,47,1998-09-27T03:00:00Z,PORT O CONNOR TX,0,0,0,4,4
Hurricane,Georges,47,1998-09-27T03:00:00Z,VENICE FL,0,0,1,3,4
Hurricane,Georges,47,1998-09-27T03:00:00Z,CORPUSCHRISTI TX,0,0,0,2,2
Hurricane,Georges,47,1998-09-27T03:00:00Z,TAMPA FL,0,0,1,3,4
Hurricane,Georges,47,1998-09-27T03:00:00Z,GULF 29N 85W,8,3,1,3,15
Hurricane,Georges,47,1998-09-27T03:00:00Z,CEDAR KEY FL,0,1,1,3,5
Hurricane,Georges,47,1998-09-27T03:00:00Z,GULF 29N 87W,38,0,0,0,38
Hurricane,Georges,47,1998-09-27T03:00:00Z,ST MARKS FL,0,2,2,5,9
Hurricane,Georges,47,1998-09-27T03:00:00Z,GULF 28N 89W,33,0,0,0,33
Hurricane,Georges,47,1998-09-27T03:00:00Z,APALACHICOLA FL,4,3,3,3,13
Hurricane,Georges,47,1998-09-27T03:00:00Z,GULF 28N 91W,7,4,3,3,17
Hurricane,Georges,47,1998-09-27T03:00:00Z,PANAMA CITY FL,5,4,3,3,15
Hurricane,Georges,47,1998-09-27T03:00:00Z,GULF 28N 93W,0,2,3,6,11
Hurricane,Georges,47,1998-09-27T03:00:00Z,PENSACOLA FL,9,6,3,2,20
Hurricane,Georges,47,1998-09-27T03:00:00Z,GULF 28N 95W,0,0,1,5,6
Hurricane,Georges,47,1998-09-27T03:00:00Z,MOBILE AL,10,8,2,3,23
Hurricane,Georges,47,1998-09-27T03:00:00Z,GULF 27N 96W,0,0,0,3,3
Hurricane,Georges,48,1998-09-27T09:00:00Z,29.4N  89.3W,42,0,1,0,43
Hurricane,Georges,48,1998-09-27T09:00:00Z,NEW ORLEANS LA,23,3,1,1,28
Hurricane,Georges,48,1998-09-27T09:00:00Z,30.0N  90.0W,26,1,1,1,29
Hurricane,Georges,48,1998-09-27T09:00:00Z,NEW IBERIA LA,11,7,2,2,22
Hurricane,Georges,48,1998-09-27T09:00:00Z,30.5N  90.0W,20,6,2,1,29
Hurricane,Georges,48,1998-09-27T09:00:00Z,PORT ARTHUR TX,1,4,3,6,14
Hurricane,Georges,48,1998-09-27T09:00:00Z,FT MYERS FL,0,0,0,2,2
Hurricane,Georges,48,1998-09-27T09:00:00Z,GALVESTON TX,0,1,1,7,9
Hurricane,Georges,48,1998-09-27T09:00:00Z,VENICE FL,0,0,0,3,3
Hurricane,Georges,48,1998-09-27T09:00:00Z,FREEPORT TX,0,0,1,6,7
Hurricane,Georges,48,1998-09-27T09:00:00Z,TAMPA FL,0,0,0,3,3
Hurricane,Georges,48,1998-09-27T09:00:00Z,PORT O CONNOR TX,0,0,0,4,4
Hurricane,Georges,48,1998-09-27T09:00:00Z,CEDAR KEY FL,0,0,1,3,4
Hurricane,Georges,48,1998-09-27T09:00:00Z,CORPUSCHRISTI TX,0,0,0,2,2
Hurricane,Georges,48,1998-09-27T09:00:00Z,ST MARKS FL,1,1,1,4,7
Hurricane,Georges,48,1998-09-27T09:00:00Z,GULF 29N 85W,4,2,2,4,12
Hurricane,Georges,48,1998-09-27T09:00:00Z,APALACHICOLA FL,4,2,2,4,12
Hurricane,Georges,48,1998-09-27T09:00:00Z,GULF 29N 87W,55,0,0,0,55
Hurricane,Georges,48,1998-09-27T09:00:00Z,PANAMA CITY FL,7,2,2,4,15
Hurricane,Georges,48,1998-09-27T09:00:00Z,GULF 28N 89W,45,0,0,1,46
Hurricane,Georges,48,1998-09-27T09:00:00Z,PENSACOLA FL,17,2,1,2,22
Hurricane,Georges,48,1998-09-27T09:00:00Z,GULF 28N 91W,11,2,1,4,18
Hurricane,Georges,48,1998-09-27T09:00:00Z,MOBILE AL,19,3,1,2,25
Hurricane,Georges,48,1998-09-27T09:00:00Z,GULF 28N 93W,2,1,1,7,11
Hurricane,Georges,48,1998-09-27T09:00:00Z,GULFPORT MS,24,2,2,1,29
Hurricane,Georges,48,1998-09-27T09:00:00Z,GULF 28N 95W,0,0,0,6,6
Hurricane,Georges,48,1998-09-27T09:00:00Z,BURAS LA,37,0,0,0,37
Hurricane,Georges,48,1998-09-27T09:00:00Z,GULF 27N 96W,0,0,0,3,3
Hurricane,Georges,49,1998-09-27T15:00:00Z,29.6N  89.5W,42,0,0,0,42
Hurricane,Georges,49,1998-09-27T15:00:00Z,GULFPORT MS,31,1,0,1,33
Hurricane,Georges,49,1998-09-27T15:00:00Z,30.3N  89.9W,31,1,1,0,33
Hurricane,Georges,49,1998-09-27T15:00:00Z,BURAS LA,42,0,0,1,43
Hurricane,Georges,49,1998-09-27T15:00:00Z,30.8N  89.9W,24,3,1,1,29
Hurricane,Georges,49,1998-09-27T15:00:00Z,NEW ORLEANS LA,29,1,1,1,32
Hurricane,Georges,49,1998-09-27T15:00:00Z,MUAN 219N 850W,0,0,0,2,2
Hurricane,Georges,49,1998-09-27T15:00:00Z,NEW IBERIA LA,13,5,2,3,23
Hurricane,Georges,49,1998-09-27T15:00:00Z,JACKSONVILLE FL,0,0,0,2,2
Hurricane,Georges,49,1998-09-27T15:00:00Z,PORT ARTHUR TX,1,3,4,5,13
Hurricane,Georges,49,1998-09-27T15:00:00Z,MARCO ISLAND FL,0,0,0,2,2
Hurricane,Georges,49,1998-09-27T15:00:00Z,GALVESTON TX,0,1,1,6,8
Hurricane,Georges,49,1998-09-27T15:00:00Z,FT MYERS FL,0,0,0,2,2
Hurricane,Georges,49,1998-09-27T15:00:00Z,FREEPORT TX,0,0,1,5,6
Hurricane,Georges,49,1998-09-27T15:00:00Z,VENICE FL,0,0,0,3,3
Hurricane,Georges,49,1998-09-27T15:00:00Z,PORT O CONNOR TX,0,0,0,3,3
Hurricane,Georges,49,1998-09-27T15:00:00Z,TAMPA FL,0,0,0,3,3
Hurricane,Georges,49,1998-09-27T15:00:00Z,GULF 29N 85W,3,1,3,5,12
Hurricane,Georges,49,1998-09-27T15:00:00Z,CEDAR KEY FL,0,0,1,3,4
Hurricane,Georges,49,1998-09-27T15:00:00Z,GULF 29N 87W,65,0,0,0,65
Hurricane,Georges,49,1998-09-27T15:00:00Z,ST MARKS FL,0,1,2,5,8
Hurricane,Georges,49,1998-09-27T15:00:00Z,GULF 28N 89W,99,0,0,0,99
Hurricane,Georges,49,1998-09-27T15:00:00Z,APALACHICOLA FL,3,2,2,5,12
Hurricane,Georges,49,1998-09-27T15:00:00Z,GULF 28N 91W,5,3,3,5,16
Hurricane,Georges,49,1998-09-27T15:00:00Z,PANAMA CITY FL,6,3,2,4,15
Hurricane,Georges,49,1998-09-27T15:00:00Z,GULF 28N 93W,0,1,2,7,10
Hurricane,Georges,49,1998-09-27T15:00:00Z,PENSACOLA FL,18,2,1,2,23
Hurricane,Georges,49,1998-09-27T15:00:00Z,GULF 28N 95W,0,0,0,5,5
Hurricane,Georges,49,1998-09-27T15:00:00Z,MOBILE AL,23,2,1,1,27
Hurricane,Georges,49,1998-09-27T15:00:00Z,GULF 27N 96W,0,0,0,2,2
Hurricane,Georges,50,1998-09-27T21:00:00Z,30.0N  89.6W,56,0,0,0,56
Hurricane,Georges,50,1998-09-27T21:00:00Z,MOBILE AL,27,1,1,0,29
Hurricane,Georges,50,1998-09-27T21:00:00Z,30.5N  89.7W,44,0,0,0,44
Hurricane,Georges,50,1998-09-27T21:00:00Z,GULFPORT MS,48,0,0,0,48
Hurricane,Georges,50,1998-09-27T21:00:00Z,31.0N  89.6W,33,1,0,0,34
Hurricane,Georges,50,1998-09-27T21:00:00Z,BURAS LA,99,0,0,0,99
Hurricane,Georges,50,1998-09-27T21:00:00Z,COCOA BEACH FL,0,0,0,2,2
Hurricane,Georges,50,1998-09-27T21:00:00Z,NEW ORLEANS LA,32,1,0,0,33
Hurricane,Georges,50,1998-09-27T21:00:00Z,DAYTONA BEACH FL,0,0,0,2,2
Hurricane,Georges,50,1998-09-27T21:00:00Z,NEW IBERIA LA,10,5,2,2,19
Hurricane,Georges,50,1998-09-27T21:00:00Z,JACKSONVILLE FL,0,0,0,3,3
Hurricane,Georges,50,1998-09-27T21:00:00Z,PORT ARTHUR TX,0,2,3,5,10
Hurricane,Georges,50,1998-09-27T21:00:00Z,SAVANNAH GA,0,0,0,3,3
Hurricane,Georges,50,1998-09-27T21:00:00Z,GALVESTON TX,0,0,1,5,6
Hurricane,Georges,50,1998-09-27T21:00:00Z,MARCO ISLAND FL,0,0,0,2,2
Hurricane,Georges,50,1998-09-27T21:00:00Z,FREEPORT TX,0,0,0,5,5
Hurricane,Georges,50,1998-09-27T21:00:00Z,FT MYERS FL,0,0,0,2,2
Hurricane,Georges,50,1998-09-27T21:00:00Z,PORT O CONNOR TX,0,0,0,2,2
Hurricane,Georges,50,1998-09-27T21:00:00Z,VENICE FL,0,0,0,3,3
Hurricane,Georges,50,1998-09-27T21:00:00Z,GULF 29N 85W,2,2,3,5,12
Hurricane,Georges,50,1998-09-27T21:00:00Z,TAMPA FL,0,0,0,4,4
Hurricane,Georges,50,1998-09-27T21:00:00Z,GULF 29N 87W,50,0,0,0,50
Hurricane,Georges,50,1998-09-27T21:00:00Z,CEDAR KEY FL,0,0,1,5,6
Hurricane,Georges,50,1998-09-27T21:00:00Z,GULF 28N 89W,99,0,0,0,99
Hurricane,Georges,50,1998-09-27T21:00:00Z,ST MARKS FL,0,1,1,7,9
Hurricane,Georges,50,1998-09-27T21:00:00Z,GULF 28N 91W,3,4,3,5,15
Hurricane,Georges,50,1998-09-27T21:00:00Z,APALACHICOLA FL,1,2,3,6,12
Hurricane,Georges,50,1998-09-27T21:00:00Z,GULF 28N 93W,0,1,2,6,9
Hurricane,Georges,50,1998-09-27T21:00:00Z,PANAMA CITY FL,3,3,3,5,14
Hurricane,Georges,50,1998-09-27T21:00:00Z,GULF 28N 95W,0,0,0,4,4
Hurricane,Georges,50,1998-09-27T21:00:00Z,PENSACOLA FL,14,3,2,2,21
Hurricane,Georges,50,1998-09-27T21:00:00Z,GULF 27N 96W,0,0,0,2,2
Hurricane,Georges,51,1998-09-28T03:00:00Z,30.3N  89.2W,99,0,0,0,99
Hurricane,Georges,51,1998-09-28T03:00:00Z,MOBILE AL,86,0,0,0,86
Hurricane,Georges,51,1998-09-28T03:00:00Z,30.5N  89.6W,52,0,0,0,52
Hurricane,Georges,51,1998-09-28T03:00:00Z,GULFPORT MS,66,0,0,0,66
Hurricane,Georges,51,1998-09-28T03:00:00Z,30.8N  89.6W,47,0,0,0,47
Hurricane,Georges,51,1998-09-28T03:00:00Z,BURAS LA,99,0,0,0,99
Hurricane,Georges,51,1998-09-28T03:00:00Z,MUAN 219N 850W,0,0,0,2,2
Hurricane,Georges,51,1998-09-28T03:00:00Z,NEW ORLEANS LA,26,1,1,1,29
Hurricane,Georges,51,1998-09-28T03:00:00Z,DAYTONA BEACH FL,0,0,0,2,2
Hurricane,Georges,51,1998-09-28T03:00:00Z,NEW IBERIA LA,7,4,4,3,18
Hurricane,Georges,51,1998-09-28T03:00:00Z,JACKSONVILLE FL,0,0,0,3,3
Hurricane,Georges,51,1998-09-28T03:00:00Z,PORT ARTHUR TX,0,1,2,7,10
Hurricane,Georges,51,1998-09-28T03:00:00Z,SAVANNAH GA,0,0,0,2,2
Hurricane,Georges,51,1998-09-28T03:00:00Z,GALVESTON TX,0,0,0,6,6
Hurricane,Georges,51,1998-09-28T03:00:00Z,MARCO ISLAND FL,0,0,0,2,2
Hurricane,Georges,51,1998-09-28T03:00:00Z,FREEPORT TX,0,0,0,5,5
Hurricane,Georges,51,1998-09-28T03:00:00Z,FT MYERS FL,0,0,0,2,2
Hurricane,Georges,51,1998-09-28T03:00:00Z,PORT O CONNOR TX,0,0,0,3,3
Hurricane,Georges,51,1998-09-28T03:00:00Z,VENICE FL,0,0,0,4,4
Hurricane,Georges,51,1998-09-28T03:00:00Z,GULF 29N 85W,4,2,2,5,13
Hurricane,Georges,51,1998-09-28T03:00:00Z,TAMPA FL,0,0,0,4,4
Hurricane,Georges,51,1998-09-28T03:00:00Z,GULF 29N 87W,28,1,0,1,30
Hurricane,Georges,51,1998-09-28T03:00:00Z,CEDAR KEY FL,0,0,0,5,5
Hurricane,Georges,51,1998-09-28T03:00:00Z,GULF 28N 89W,77,0,0,0,77
Hurricane,Georges,51,1998-09-28T03:00:00Z,ST MARKS FL,0,1,1,7,9
Hurricane,Georges,51,1998-09-28T03:00:00Z,GULF 28N 91W,1,3,5,5,14
Hurricane,Georges,51,1998-09-28T03:00:00Z,APALACHICOLA FL,3,2,2,5,12
Hurricane,Georges,51,1998-09-28T03:00:00Z,GULF 28N 93W,0,0,1,8,9
Hurricane,Georges,51,1998-09-28T03:00:00Z,PANAMA CITY FL,6,2,3,4,15
Hurricane,Georges,51,1998-09-28T03:00:00Z,GULF 28N 95W,0,0,0,5,5
Hurricane,Georges,51,1998-09-28T03:00:00Z,PENSACOLA FL,59,0,0,0,59
Hurricane,Georges,51,1998-09-28T03:00:00Z,GULF 27N 96W,0,0,0,2,2
Hurricane,Georges,52,1998-09-28T09:00:00Z,30.6N  89.3W,99,0,0,0,99
Hurricane,Georges,52,1998-09-28T09:00:00Z,GULFPORT MS,99,0,0,0,99
Hurricane,Georges,52,1998-09-28T09:00:00Z,31.0N  89.5W,53,0,0,0,53
Hurricane,Georges,52,1998-09-28T09:00:00Z,BURAS LA,99,0,0,0,99
Hurricane,Georges,52,1998-09-28T09:00:00Z,31.5N  89.5W,34,1,0,0,35
Hurricane,Georges,52,1998-09-28T09:00:00Z,NEW ORLEANS LA,28,1,0,1,30
Hurricane,Georges,52,1998-09-28T09:00:00Z,DAYTONA BEACH FL,0,0,0,2,2
Hurricane,Georges,52,1998-09-28T09:00:00Z,NEW IBERIA LA,10,5,3,2,20
Hurricane,Georges,52,1998-09-28T09:00:00Z,JACKSONVILLE FL,0,0,0,3,3
Hurricane,Georges,52,1998-09-28T09:00:00Z,PORT ARTHUR TX,1,3,3,5,12
Hurricane,Georges,52,1998-09-28T09:00:00Z,SAVANNAH GA,0,0,0,2,2
Hurricane,Georges,52,1998-09-28T09:00:00Z,GALVESTON TX,0,1,2,5,8
Hurricane,Georges,52,1998-09-28T09:00:00Z,FT MYERS FL,0,0,0,2,2
Hurricane,Georges,52,1998-09-28T09:00:00Z,FREEPORT TX,0,0,1,5,6
Hurricane,Georges,52,1998-09-28T09:00:00Z,VENICE FL,0,0,0,2,2
Hurricane,Georges,52,1998-09-28T09:00:00Z,PORT O CONNOR TX,0,0,0,3,3
Hurricane,Georges,52,1998-09-28T09:00:00Z,TAMPA FL,0,0,0,3,3
Hurricane,Georges,52,1998-09-28T09:00:00Z,GULF 29N 85W,1,2,2,5,10
Hurricane,Georges,52,1998-09-28T09:00:00Z,CEDAR KEY FL,0,0,0,5,5
Hurricane,Georges,52,1998-09-28T09:00:00Z,GULF 29N 87W,10,3,1,3,17
Hurricane,Georges,52,1998-09-28T09:00:00Z,ST MARKS FL,1,0,2,5,8
Hurricane,Georges,52,1998-09-28T09:00:00Z,GULF 28N 89W,12,2,2,3,19
Hurricane,Georges,52,1998-09-28T09:00:00Z,APALACHICOLA FL,2,2,2,5,11
Hurricane,Georges,52,1998-09-28T09:00:00Z,GULF 28N 91W,2,5,4,4,15
Hurricane,Georges,52,1998-09-28T09:00:00Z,PANAMA CITY FL,5,2,2,5,14
Hurricane,Georges,52,1998-09-28T09:00:00Z,GULF 28N 93W,0,2,3,6,11
Hurricane,Georges,52,1998-09-28T09:00:00Z,PENSACOLA FL,56,0,0,0,56
Hurricane,Georges,52,1998-09-28T09:00:00Z,GULF 28N 95W,0,0,1,4,5
Hurricane,Georges,52,1998-09-28T09:00:00Z,MOBILE AL,99,0,0,0,99
Hurricane,Georges,52,1998-09-28T09:00:00Z,GULF 27N 96W,0,0,0,3,3
Hurricane,Georges,53,1998-09-28T15:00:00Z,30.7N  89.5W,99,0,0,0,99
Hurricane,Georges,53,1998-09-28T15:00:00Z,APALACHICOLA FL,3,4,4,4,15
Hurricane,Georges,53,1998-09-28T15:00:00Z,31.0N  89.5W,99,0,0,0,99
Hurricane,Georges,53,1998-09-28T15:00:00Z,PANAMA CITY FL,6,5,3,4,18
Hurricane,Georges,53,1998-09-28T15:00:00Z,31.5N  89.5W,33,0,1,0,34
Hurricane,Georges,53,1998-09-28T15:00:00Z,PENSACOLA FL,23,2,1,1,27
Hurricane,Georges,53,1998-09-28T15:00:00Z,MARATHON FL,0,0,0,2,2
Hurricane,Georges,53,1998-09-28T15:00:00Z,MOBILE AL,99,0,0,0,99
Hurricane,Georges,53,1998-09-28T15:00:00Z,MIAMI FL,0,0,0,2,2
Hurricane,Georges,53,1998-09-28T15:00:00Z,GULFPORT MS,99,0,0,0,99
Hurricane,Georges,53,1998-09-28T15:00:00Z,W PALM BEACH FL,0,0,0,2,2
Hurricane,Georges,53,1998-09-28T15:00:00Z,BURAS LA,99,0,0,0,99
Hurricane,Georges,53,1998-09-28T15:00:00Z,FT PIERCE FL,0,0,0,3,3
Hurricane,Georges,53,1998-09-28T15:00:00Z,NEW ORLEANS LA,99,0,0,0,99
Hurricane,Georges,53,1998-09-28T15:00:00Z,COCOA BEACH FL,0,0,0,4,4
Hurricane,Georges,53,1998-09-28T15:00:00Z,NEW IBERIA LA,14,3,2,2,21
Hurricane,Georges,53,1998-09-28T15:00:00Z,DAYTONA BEACH FL,0,0,0,5,5
Hurricane,Georges,53,1998-09-28T15:00:00Z,PORT ARTHUR TX,1,4,3,5,13
Hurricane,Georges,53,1998-09-28T15:00:00Z,JACKSONVILLE FL,0,0,1,5,6
Hurricane,Georges,53,1998-09-28T15:00:00Z,GALVESTON TX,0,1,2,5,8
Hurricane,Georges,53,1998-09-28T15:00:00Z,SAVANNAH GA,0,0,0,4,4
Hurricane,Georges,53,1998-09-28T15:00:00Z,FREEPORT TX,0,0,1,4,5
Hurricane,Georges,53,1998-09-28T15:00:00Z,CHARLESTON SC,0,0,0,2,2
Hurricane,Georges,53,1998-09-28T15:00:00Z,PORT O CONNOR TX,0,0,0,3,3
Hurricane,Georges,53,1998-09-28T15:00:00Z,KEY WEST FL,0,0,0,2,2
Hurricane,Georges,53,1998-09-28T15:00:00Z,GULF 29N 85W,1,4,4,5,14
Hurricane,Georges,53,1998-09-28T15:00:00Z,MARCO ISLAND FL,0,0,0,4,4
Hurricane,Georges,53,1998-09-28T15:00:00Z,GULF 29N 87W,8,5,3,3,19
Hurricane,Georges,53,1998-09-28T15:00:00Z,FT MYERS FL,0,0,0,4,4
Hurricane,Georges,53,1998-09-28T15:00:00Z,GULF 28N 89W,2,4,4,5,15
Hurricane,Georges,53,1998-09-28T15:00:00Z,VENICE FL,0,0,0,6,6
Hurricane,Georges,53,1998-09-28T15:00:00Z,GULF 28N 91W,1,3,3,5,12
Hurricane,Georges,53,1998-09-28T15:00:00Z,TAMPA FL,0,0,1,6,7
Hurricane,Georges,53,1998-09-28T15:00:00Z,GULF 28N 93W,0,1,2,5,8
Hurricane,Georges,53,1998-09-28T15:00:00Z,CEDAR KEY FL,0,1,2,6,9
Hurricane,Georges,53,1998-09-28T15:00:00Z,GULF 28N 95W,0,0,1,3,4
Hurricane,Georges,53,1998-09-28T15:00:00Z,ST MARKS FL,1,3,4,5,13
Tropical Storm,Georges,54,1998-09-28T21:00:00Z,31.7N  88.4W,48,0,0,0,48
Tropical Storm,Georges,54,1998-09-28T21:00:00Z,CEDAR KEY FL,0,0,3,7,10
Tropical Storm,Georges,54,1998-09-28T21:00:00Z,32.0N  87.7W,29,1,0,1,31
Tropical Storm,Georges,54,1998-09-28T21:00:00Z,ST MARKS FL,1,3,5,5,14
Tropical Storm,Georges,54,1998-09-28T21:00:00Z,32.3N  87.0W,19,3,1,2,25
Tropical Storm,Georges,54,1998-09-28T21:00:00Z,APALACHICOLA FL,2,5,4,5,16
Tropical Storm,Georges,54,1998-09-28T21:00:00Z,MIAMI FL,0,0,0,2,2
Tropical Storm,Georges,54,1998-09-28T21:00:00Z,PANAMA CITY FL,6,5,4,3,18
Tropical Storm,Georges,54,1998-09-28T21:00:00Z,W PALM BEACH FL,0,0,0,2,2
Tropical Storm,Georges,54,1998-09-28T21:00:00Z,PENSACOLA FL,33,0,1,0,34
Tropical Storm,Georges,54,1998-09-28T21:00:00Z,FT PIERCE FL,0,0,0,3,3
Tropical Storm,Georges,54,1998-09-28T21:00:00Z,MOBILE AL,99,0,0,0,99
Tropical Storm,Georges,54,1998-09-28T21:00:00Z,COCOA BEACH FL,0,0,0,4,4
Tropical Storm,Georges,54,1998-09-28T21:00:00Z,GULFPORT MS,99,0,0,0,99
Tropical Storm,Georges,54,1998-09-28T21:00:00Z,DAYTONA BEACH FL,0,0,1,5,6
Tropical Storm,Georges,54,1998-09-28T21:00:00Z,BURAS LA,15,2,2,2,21
Tropical Storm,Georges,54,1998-09-28T21:00:00Z,JACKSONVILLE FL,0,0,2,7,9
Tropical Storm,Georges,54,1998-09-28T21:00:00Z,NEW ORLEANS LA,16,2,1,2,21
Tropical Storm,Georges,54,1998-09-28T21:00:00Z,SAVANNAH GA,0,0,2,8,10
Tropical Storm,Georges,54,1998-09-28T21:00:00Z,NEW IBERIA LA,1,5,3,4,13
Tropical Storm,Georges,54,1998-09-28T21:00:00Z,CHARLESTON SC,0,0,1,7,8
Tropical Storm,Georges,54,1998-09-28T21:00:00Z,PORT ARTHUR TX,0,0,2,4,6
Tropical Storm,Georges,54,1998-09-28T21:00:00Z,MYRTLE BEACH SC,0,0,0,6,6
Tropical Storm,Georges,54,1998-09-28T21:00:00Z,GALVESTON TX,0,0,1,3,4
Tropical Storm,Georges,54,1998-09-28T21:00:00Z,WILMINGTON NC,0,0,0,4,4
Tropical Storm,Georges,54,1998-09-28T21:00:00Z,FREEPORT TX,0,0,0,3,3
Tropical Storm,Georges,54,1998-09-28T21:00:00Z,MOREHEAD CITY NC,0,0,0,3,3
Tropical Storm,Georges,54,1998-09-28T21:00:00Z,PORT O CONNOR TX,0,0,0,2,2
Tropical Storm,Georges,54,1998-09-28T21:00:00Z,CAPE HATTERAS NC,0,0,0,2,2
Tropical Storm,Georges,54,1998-09-28T21:00:00Z,GULF 29N 85W,1,4,4,5,14
Tropical Storm,Georges,54,1998-09-28T21:00:00Z,NORFOLK VA,0,0,0,2,2
Tropical Storm,Georges,54,1998-09-28T21:00:00Z,GULF 29N 87W,9,4,3,2,18
Tropical Storm,Georges,54,1998-09-28T21:00:00Z,MARCO ISLAND FL,0,0,0,3,3
Tropical Storm,Georges,54,1998-09-28T21:00:00Z,GULF 28N 89W,2,5,4,4,15
Tropical Storm,Georges,54,1998-09-28T21:00:00Z,FT MYERS FL,0,0,0,4,4
Tropical Storm,Georges,54,1998-09-28T21:00:00Z,GULF 28N 91W,0,4,4,3,11
Tropical Storm,Georges,54,1998-09-28T21:00:00Z,VENICE FL,0,0,1,4,5
Tropical Storm,Georges,54,1998-09-28T21:00:00Z,GULF 28N 93W,0,1,2,4,7
Tropical Storm,Georges,54,1998-09-28T21:00:00Z,TAMPA FL,0,0,1,6,7
Tropical Storm,Georges,54,1998-09-28T21:00:00Z,GULF 28N 95W,0,0,0,3,3
Tropical Storm,Georges,56,1998-09-29T09:00:00Z,30.9N  86.1W,37,0,0,0,37
Tropical Storm,Georges,56,1998-09-29T09:00:00Z,FT MYERS FL,0,1,2,5,8
Tropical Storm,Georges,56,1998-09-29T09:00:00Z,31.1N  84.9W,23,2,0,1,26
Tropical Storm,Georges,56,1998-09-29T09:00:00Z,VENICE FL,0,2,4,4,10
Tropical Storm,Georges,56,1998-09-29T09:00:00Z,31.3N  84.0W,16,3,2,1,22
Tropical Storm,Georges,56,1998-09-29T09:00:00Z,TAMPA FL,1,4,4,4,13
Tropical Storm,Georges,56,1998-09-29T09:00:00Z,MYNN 251N 775W,0,0,0,2,2
Tropical Storm,Georges,56,1998-09-29T09:00:00Z,CEDAR KEY FL,5,7,2,3,17
Tropical Storm,Georges,56,1998-09-29T09:00:00Z,MYGF 266N 787W,0,0,1,4,5
Tropical Storm,Georges,56,1998-09-29T09:00:00Z,ST MARKS FL,18,3,1,1,23
Tropical Storm,Georges,56,1998-09-29T09:00:00Z,MARATHON FL,0,0,0,3,3
Tropical Storm,Georges,56,1998-09-29T09:00:00Z,APALACHICOLA FL,23,1,1,1,26
Tropical Storm,Georges,56,1998-09-29T09:00:00Z,MIAMI FL,0,0,1,4,5
Tropical Storm,Georges,56,1998-09-29T09:00:00Z,PANAMA CITY FL,32,0,0,0,32
Tropical Storm,Georges,56,1998-09-29T09:00:00Z,W PALM BEACH FL,0,0,2,5,7
Tropical Storm,Georges,56,1998-09-29T09:00:00Z,PENSACOLA FL,99,0,0,0,99
Tropical Storm,Georges,56,1998-09-29T09:00:00Z,FT PIERCE FL,0,1,3,5,9
Tropical Storm,Georges,56,1998-09-29T09:00:00Z,MOBILE AL,99,0,0,0,99
Tropical Storm,Georges,56,1998-09-29T09:00:00Z,COCOA BEACH FL,0,2,4,5,11
Tropical Storm,Georges,56,1998-09-29T09:00:00Z,GULFPORT MS,99,0,0,0,99
Tropical Storm,Georges,56,1998-09-29T09:00:00Z,DAYTONA BEACH FL,0,6,4,4,14
Tropical Storm,Georges,56,1998-09-29T09:00:00Z,BURAS LA,11,2,2,1,16
Tropical Storm,Georges,56,1998-09-29T09:00:00Z,JACKSONVILLE FL,1,9,4,3,17
Tropical Storm,Georges,56,1998-09-29T09:00:00Z,NEW ORLEANS LA,3,4,3,2,12
Tropical Storm,Georges,56,1998-09-29T09:00:00Z,SAVANNAH GA,0,8,5,3,16
Tropical Storm,Georges,56,1998-09-29T09:00:00Z,NEW IBERIA LA,0,2,3,3,8
Tropical Storm,Georges,56,1998-09-29T09:00:00Z,CHARLESTON SC,0,4,5,5,14
Tropical Storm,Georges,56,1998-09-29T09:00:00Z,PORT ARTHUR TX,0,0,2,2,4
Tropical Storm,Georges,56,1998-09-29T09:00:00Z,MYRTLE BEACH SC,0,2,4,5,11
Tropical Storm,Georges,56,1998-09-29T09:00:00Z,GALVESTON TX,0,0,1,2,3
Tropical Storm,Georges,56,1998-09-29T09:00:00Z,WILMINGTON NC,0,1,3,5,9
Tropical Storm,Georges,56,1998-09-29T09:00:00Z,FREEPORT TX,0,0,1,1,2
Tropical Storm,Georges,56,1998-09-29T09:00:00Z,MOREHEAD CITY NC,0,0,2,6,8
Tropical Storm,Georges,56,1998-09-29T09:00:00Z,GULF 29N 85W,18,2,1,1,22
Tropical Storm,Georges,56,1998-09-29T09:00:00Z,CAPE HATTERAS NC,0,0,1,5,6
Tropical Storm,Georges,56,1998-09-29T09:00:00Z,GULF 29N 87W,39,0,0,0,39
Tropical Storm,Georges,56,1998-09-29T09:00:00Z,NORFOLK VA,0,0,0,4,4
Tropical Storm,Georges,56,1998-09-29T09:00:00Z,GULF 28N 89W,6,3,2,2,13
Tropical Storm,Georges,56,1998-09-29T09:00:00Z,OCEAN CITY MD,0,0,0,2,2
Tropical Storm,Georges,56,1998-09-29T09:00:00Z,GULF 28N 91W,0,3,2,3,8
Tropical Storm,Georges,56,1998-09-29T09:00:00Z,KEY WEST FL,0,0,0,3,3
Tropical Storm,Georges,56,1998-09-29T09:00:00Z,GULF 28N 93W,0,1,1,3,5
Tropical Storm,Georges,56,1998-09-29T09:00:00Z,MARCO ISLAND FL,0,0,2,4,6
Tropical Storm,Georges,56,1998-09-29T09:00:00Z,GULF 28N 95W,0,0,1,1,2
Tropical Depression,Eight,1,1998-09-17T21:00:00Z,27.5N  93.5W,43,0,0,0,43
Tropical Depression,Eight,1,1998-09-17T21:00:00Z,BURAS LA,2,12,2,2,18
Tropical Depression,Eight,1,1998-09-17T21:00:00Z,29.0N  93.5W,20,12,0,0,32
Tropical Depression,Eight,1,1998-09-17T21:00:00Z,NEW ORLEANS LA,2,14,3,2,21
Tropical Depression,Eight,1,1998-09-17T21:00:00Z,30.5N  93.0W,2,17,5,1,25
Tropical Depression,Eight,1,1998-09-17T21:00:00Z,NEW IBERIA LA,6,17,2,1,26
Tropical Depression,Eight,1,1998-09-17T21:00:00Z,COCOA BEACH FL,0,0,0,2,2
Tropical Depression,Eight,1,1998-09-17T21:00:00Z,PORT ARTHUR TX,3,21,2,1,27
Tropical Depression,Eight,1,1998-09-17T21:00:00Z,DAYTONA BEACH FL,0,0,0,3,3
Tropical Depression,Eight,1,1998-09-17T21:00:00Z,GALVESTON TX,7,18,1,1,27
Tropical Depression,Eight,1,1998-09-17T21:00:00Z,JACKSONVILLE FL,0,0,0,4,4
Tropical Depression,Eight,1,1998-09-17T21:00:00Z,FREEPORT TX,5,18,1,1,25
Tropical Depression,Eight,1,1998-09-17T21:00:00Z,SAVANNAH GA,0,0,0,4,4
Tropical Depression,Eight,1,1998-09-17T21:00:00Z,PORT O CONNOR TX,3,14,1,1,19
Tropical Depression,Eight,1,1998-09-17T21:00:00Z,CHARLESTON SC,0,0,0,2,2
Tropical Depression,Eight,1,1998-09-17T21:00:00Z,CORPUSCHRISTI TX,1,8,1,1,11
Tropical Depression,Eight,1,1998-09-17T21:00:00Z,VENICE FL,0,0,0,2,2
Tropical Depression,Eight,1,1998-09-17T21:00:00Z,BROWNSVILLE TX,0,2,0,1,3
Tropical Depression,Eight,1,1998-09-17T21:00:00Z,TAMPA FL,0,0,0,3,3
Tropical Depression,Eight,1,1998-09-17T21:00:00Z,GULF 29N 85W,0,0,1,5,6
Tropical Depression,Eight,1,1998-09-17T21:00:00Z,CEDAR KEY FL,0,0,0,4,4
Tropical Depression,Eight,1,1998-09-17T21:00:00Z,GULF 29N 87W,0,1,3,5,9
Tropical Depression,Eight,1,1998-09-17T21:00:00Z,ST MARKS FL,0,0,1,6,7
Tropical Depression,Eight,1,1998-09-17T21:00:00Z,GULF 28N 89W,1,5,2,3,11
Tropical Depression,Eight,1,1998-09-17T21:00:00Z,APALACHICOLA FL,0,0,1,6,7
Tropical Depression,Eight,1,1998-09-17T21:00:00Z,GULF 28N 91W,35,1,0,0,36
Tropical Depression,Eight,1,1998-09-17T21:00:00Z,PANAMA CITY FL,0,0,2,7,9
Tropical Depression,Eight,1,1998-09-17T21:00:00Z,GULF 28N 93W,43,0,0,0,43
Tropical Depression,Eight,1,1998-09-17T21:00:00Z,PENSACOLA FL,0,1,6,6,13
Tropical Depression,Eight,1,1998-09-17T21:00:00Z,GULF 28N 95W,18,8,0,1,27
Tropical Depression,Eight,1,1998-09-17T21:00:00Z,MOBILE AL,0,3,8,5,16
Tropical Depression,Eight,1,1998-09-17T21:00:00Z,GULF 27N 96W,8,7,0,0,15
Tropical Depression,Eight,1,1998-09-17T21:00:00Z,GULFPORT MS,0,8,6,3,17
Tropical Depression,Eight,1,1998-09-17T21:00:00Z,GULF 25N 96W,1,0,0,1,2
Tropical Depression,Eight,2,1998-09-18T03:00:00Z,26.6N  92.4W,99,0,0,0,99
Tropical Depression,Eight,2,1998-09-18T03:00:00Z,NEW IBERIA LA,4,9,9,2,24
Tropical Depression,Eight,2,1998-09-18T03:00:00Z,27.3N  92.5W,99,0,0,0,99
Tropical Depression,Eight,2,1998-09-18T03:00:00Z,PORT ARTHUR TX,2,4,10,4,20
Tropical Depression,Eight,2,1998-09-18T03:00:00Z,28.7N  92.3W,15,6,5,1,27
Tropical Depression,Eight,2,1998-09-18T03:00:00Z,GALVESTON TX,1,4,10,4,19
Tropical Depression,Eight,2,1998-09-18T03:00:00Z,MMSO 238N 982W,0,0,1,2,3
Tropical Depression,Eight,2,1998-09-18T03:00:00Z,FREEPORT TX,0,3,10,5,18
Tropical Depression,Eight,2,1998-09-18T03:00:00Z,JACKSONVILLE FL,0,0,0,2,2
Tropical Depression,Eight,2,1998-09-18T03:00:00Z,PORT O CONNOR TX,0,1,7,7,15
Tropical Depression,Eight,2,1998-09-18T03:00:00Z,SAVANNAH GA,0,0,0,2,2
Tropical Depression,Eight,2,1998-09-18T03:00:00Z,CORPUSCHRISTI TX,0,0,4,7,11
Tropical Depression,Eight,2,1998-09-18T03:00:00Z,CHARLESTON SC,0,0,0,2,2
Tropical Depression,Eight,2,1998-09-18T03:00:00Z,BROWNSVILLE TX,0,0,4,5,9
Tropical Depression,Eight,2,1998-09-18T03:00:00Z,CEDAR KEY FL,0,0,0,2,2
Tropical Depression,Eight,2,1998-09-18T03:00:00Z,GULF 29N 85W,0,0,0,5,5
Tropical Depression,Eight,2,1998-09-18T03:00:00Z,ST MARKS FL,0,0,0,5,5
Tropical Depression,Eight,2,1998-09-18T03:00:00Z,GULF 29N 87W,0,0,1,7,8
Tropical Depression,Eight,2,1998-09-18T03:00:00Z,APALACHICOLA FL,0,0,0,6,6
Tropical Depression,Eight,2,1998-09-18T03:00:00Z,GULF 28N 89W,1,3,5,4,13
Tropical Depression,Eight,2,1998-09-18T03:00:00Z,PANAMA CITY FL,0,0,0,7,7
Tropical Depression,Eight,2,1998-09-18T03:00:00Z,GULF 28N 91W,15,5,2,1,23
Tropical Depression,Eight,2,1998-09-18T03:00:00Z,PENSACOLA FL,0,0,3,9,12
Tropical Depression,Eight,2,1998-09-18T03:00:00Z,GULF 28N 93W,21,3,2,1,27
Tropical Depression,Eight,2,1998-09-18T03:00:00Z,MOBILE AL,0,1,6,8,15
Tropical Depression,Eight,2,1998-09-18T03:00:00Z,GULF 28N 95W,3,5,10,2,20
Tropical Depression,Eight,2,1998-09-18T03:00:00Z,GULFPORT MS,0,3,9,5,17
Tropical Depression,Eight,2,1998-09-18T03:00:00Z,GULF 27N 96W,0,3,9,4,16
Tropical Depression,Eight,2,1998-09-18T03:00:00Z,BURAS LA,1,6,8,4,19
Tropical Depression,Eight,2,1998-09-18T03:00:00Z,GULF 25N 96W,0,3,5,3,11
Tropical Depression,Eight,2,1998-09-18T03:00:00Z,NEW ORLEANS LA,1,8,9,3,21
Tropical Depression,Eight,3,1998-09-18T09:00:00Z,25.0N  93.7W,99,0,0,0,99
Tropical Depression,Eight,3,1998-09-18T09:00:00Z,PORT ARTHUR TX,0,4,11,4,19
Tropical Depression,Eight,3,1998-09-18T09:00:00Z,25.8N  93.9W,58,0,0,0,58
Tropical Depression,Eight,3,1998-09-18T09:00:00Z,GALVESTON TX,0,5,12,3,20
Tropical Depression,Eight,3,1998-09-18T09:00:00Z,27.7N  93.9W,11,8,4,1,24
Tropical Depression,Eight,3,1998-09-18T09:00:00Z,FREEPORT TX,0,4,12,3,19
Tropical Depression,Eight,3,1998-09-18T09:00:00Z,MMSO 238N 982W,0,2,5,2,9
Tropical Depression,Eight,3,1998-09-18T09:00:00Z,PORT O CONNOR TX,0,3,10,4,17
Tropical Depression,Eight,3,1998-09-18T09:00:00Z,MMTM 222N 979W,0,2,3,1,6
Tropical Depression,Eight,3,1998-09-18T09:00:00Z,CORPUSCHRISTI TX,0,1,8,4,13
Tropical Depression,Eight,3,1998-09-18T09:00:00Z,MMTX 210N 974W,0,1,2,1,4
Tropical Depression,Eight,3,1998-09-18T09:00:00Z,BROWNSVILLE TX,1,4,8,2,15
Tropical Depression,Eight,3,1998-09-18T09:00:00Z,ST MARKS FL,0,0,0,3,3
Tropical Depression,Eight,3,1998-09-18T09:00:00Z,GULF 29N 85W,0,0,0,3,3
Tropical Depression,Eight,3,1998-09-18T09:00:00Z,APALACHICOLA FL,0,0,0,4,4
Tropical Depression,Eight,3,1998-09-18T09:00:00Z,GULF 29N 87W,0,0,0,6,6
Tropical Depression,Eight,3,1998-09-18T09:00:00Z,PANAMA CITY FL,0,0,0,5,5
Tropical Depression,Eight,3,1998-09-18T09:00:00Z,GULF 28N 89W,0,1,2,6,9
Tropical Depression,Eight,3,1998-09-18T09:00:00Z,PENSACOLA FL,0,0,0,8,8
Tropical Depression,Eight,3,1998-09-18T09:00:00Z,GULF 28N 91W,2,8,4,3,17
Tropical Depression,Eight,3,1998-09-18T09:00:00Z,MOBILE AL,0,0,2,8,10
Tropical Depression,Eight,3,1998-09-18T09:00:00Z,GULF 28N 93W,8,9,5,1,23
Tropical Depression,Eight,3,1998-09-18T09:00:00Z,GULFPORT MS,0,0,4,8,12
Tropical Depression,Eight,3,1998-09-18T09:00:00Z,GULF 28N 95W,4,8,9,1,22
Tropical Depression,Eight,3,1998-09-18T09:00:00Z,BURAS LA,0,2,4,6,12
Tropical Depression,Eight,3,1998-09-18T09:00:00Z,GULF 27N 96W,4,7,8,2,21
Tropical Depression,Eight,3,1998-09-18T09:00:00Z,NEW ORLEANS LA,0,2,7,6,15
Tropical Depression,Eight,3,1998-09-18T09:00:00Z,GULF 25N 96W,9,7,3,1,20
Tropical Depression,Eight,3,1998-09-18T09:00:00Z,NEW IBERIA LA,0,5,10,3,18
Tropical Depression,Eight,4,1998-09-18T15:00:00Z,27.5N  92.0W,34,0,1,0,35
Tropical Depression,Eight,4,1998-09-18T15:00:00Z,GULFPORT MS,0,8,10,3,21
Tropical Depression,Eight,4,1998-09-18T15:00:00Z,28.8N  91.5W,18,6,2,0,26
Tropical Depression,Eight,4,1998-09-18T15:00:00Z,BURAS LA,3,11,7,1,22
Tropical Depression,Eight,4,1998-09-18T15:00:00Z,31.0N  90.5W,1,12,10,2,25
Tropical Depression,Eight,4,1998-09-18T15:00:00Z,NEW ORLEANS LA,3,13,8,1,25
Tropical Depression,Eight,4,1998-09-18T15:00:00Z,DAYTONA BEACH FL,0,0,0,2,2
Tropical Depression,Eight,4,1998-09-18T15:00:00Z,NEW IBERIA LA,8,13,5,1,27
Tropical Depression,Eight,4,1998-09-18T15:00:00Z,JACKSONVILLE FL,0,0,0,4,4
Tropical Depression,Eight,4,1998-09-18T15:00:00Z,PORT ARTHUR TX,8,7,4,1,20
Tropical Depression,Eight,4,1998-09-18T15:00:00Z,SAVANNAH GA,0,0,0,5,5
Tropical Depression,Eight,4,1998-09-18T15:00:00Z,GALVESTON TX,8,5,3,1,17
Tropical Depression,Eight,4,1998-09-18T15:00:00Z,CHARLESTON SC,0,0,0,4,4
Tropical Depression,Eight,4,1998-09-18T15:00:00Z,FREEPORT TX,6,4,2,1,13
Tropical Depression,Eight,4,1998-09-18T15:00:00Z,MYRTLE BEACH SC,0,0,0,3,3
Tropical Depression,Eight,4,1998-09-18T15:00:00Z,PORT O CONNOR TX,1,3,2,1,7
Tropical Depression,Eight,4,1998-09-18T15:00:00Z,WILMINGTON NC,0,0,0,2,2
Tropical Depression,Eight,4,1998-09-18T15:00:00Z,CORPUSCHRISTI TX,0,0,1,1,2
Tropical Depression,Eight,4,1998-09-18T15:00:00Z,VENICE FL,0,0,0,2,2
Tropical Depression,Eight,4,1998-09-18T15:00:00Z,GULF 29N 85W,0,0,0,8,8
Tropical Depression,Eight,4,1998-09-18T15:00:00Z,TAMPA FL,0,0,0,3,3
Tropical Depression,Eight,4,1998-09-18T15:00:00Z,GULF 29N 87W,0,1,5,6,12
Tropical Depression,Eight,4,1998-09-18T15:00:00Z,CEDAR KEY FL,0,0,0,5,5
Tropical Depression,Eight,4,1998-09-18T15:00:00Z,GULF 28N 89W,4,7,5,2,18
Tropical Depression,Eight,4,1998-09-18T15:00:00Z,ST MARKS FL,0,0,0,8,8
Tropical Depression,Eight,4,1998-09-18T15:00:00Z,GULF 28N 91W,20,3,1,1,25
Tropical Depression,Eight,4,1998-09-18T15:00:00Z,APALACHICOLA FL,0,0,1,8,9
Tropical Depression,Eight,4,1998-09-18T15:00:00Z,GULF 28N 93W,27,1,0,1,29
Tropical Depression,Eight,4,1998-09-18T15:00:00Z,PANAMA CITY FL,0,0,1,9,10
Tropical Depression,Eight,4,1998-09-18T15:00:00Z,GULF 28N 95W,10,3,2,0,15
Tropical Depression,Eight,4,1998-09-18T15:00:00Z,PENSACOLA FL,0,1,7,7,15
Tropical Depression,Eight,4,1998-09-18T15:00:00Z,GULF 27N 96W,2,2,2,1,7
Tropical Depression,Eight,4,1998-09-18T15:00:00Z,MOBILE AL,0,4,10,4,18
Tropical Depression,Eight,4,1998-09-18T15:00:00Z,GULF 25N 96W,0,1,0,2,3
Tropical Depression,Eight,5,1998-09-18T21:00:00Z,27.5N  92.0W,45,0,0,0,45
Tropical Depression,Eight,5,1998-09-18T21:00:00Z,PANAMA CITY FL,0,0,1,12,13
Tropical Depression,Eight,5,1998-09-18T21:00:00Z,29.0N  91.5W,26,4,0,1,31
Tropical Depression,Eight,5,1998-09-18T21:00:00Z,PENSACOLA FL,0,0,7,9,16
Tropical Depression,Eight,5,1998-09-18T21:00:00Z,30.5N  90.0W,2,13,6,1,22
Tropical Depression,Eight,5,1998-09-18T21:00:00Z,MOBILE AL,0,2,11,6,19
Tropical Depression,Eight,5,1998-09-18T21:00:00Z,FT PIERCE FL,0,0,0,2,2
Tropical Depression,Eight,5,1998-09-18T21:00:00Z,GULFPORT MS,1,6,10,3,20
Tropical Depression,Eight,5,1998-09-18T21:00:00Z,COCOA BEACH FL,0,0,0,2,2
Tropical Depression,Eight,5,1998-09-18T21:00:00Z,BURAS LA,3,11,5,2,21
Tropical Depression,Eight,5,1998-09-18T21:00:00Z,DAYTONA BEACH FL,0,0,0,4,4
Tropical Depression,Eight,5,1998-09-18T21:00:00Z,NEW ORLEANS LA,6,13,3,2,24
Tropical Depression,Eight,5,1998-09-18T21:00:00Z,JACKSONVILLE FL,0,0,0,7,7
Tropical Depression,Eight,5,1998-09-18T21:00:00Z,NEW IBERIA LA,17,9,1,1,28
Tropical Depression,Eight,5,1998-09-18T21:00:00Z,SAVANNAH GA,0,0,0,7,7
Tropical Depression,Eight,5,1998-09-18T21:00:00Z,PORT ARTHUR TX,7,9,1,1,18
Tropical Depression,Eight,5,1998-09-18T21:00:00Z,CHARLESTON SC,0,0,0,6,6
Tropical Depression,Eight,5,1998-09-18T21:00:00Z,GALVESTON TX,3,7,2,1,13
Tropical Depression,Eight,5,1998-09-18T21:00:00Z,MYRTLE BEACH SC,0,0,0,5,5
Tropical Depression,Eight,5,1998-09-18T21:00:00Z,FREEPORT TX,1,4,2,1,8
Tropical Depression,Eight,5,1998-09-18T21:00:00Z,WILMINGTON NC,0,0,0,3,3
Tropical Depression,Eight,5,1998-09-18T21:00:00Z,PORT O CONNOR TX,0,1,0,2,3
Tropical Depression,Eight,5,1998-09-18T21:00:00Z,MOREHEAD CITY NC,0,0,0,2,2
Tropical Depression,Eight,5,1998-09-18T21:00:00Z,GULF 29N 85W,0,0,1,9,10
Tropical Depression,Eight,5,1998-09-18T21:00:00Z,NORFOLK VA,0,0,0,2,2
Tropical Depression,Eight,5,1998-09-18T21:00:00Z,GULF 29N 87W,0,0,5,9,14
Tropical Depression,Eight,5,1998-09-18T21:00:00Z,FT MYERS FL,0,0,0,2,2
Tropical Depression,Eight,5,1998-09-18T21:00:00Z,GULF 28N 89W,2,7,5,3,17
Tropical Depression,Eight,5,1998-09-18T21:00:00Z,VENICE FL,0,0,0,3,3
Tropical Depression,Eight,5,1998-09-18T21:00:00Z,GULF 28N 91W,28,2,0,0,30
Tropical Depression,Eight,5,1998-09-18T21:00:00Z,TAMPA FL,0,0,0,4,4
Tropical Depression,Eight,5,1998-09-18T21:00:00Z,GULF 28N 93W,34,0,0,0,34
Tropical Depression,Eight,5,1998-09-18T21:00:00Z,CEDAR KEY FL,0,0,0,7,7
Tropical Depression,Eight,5,1998-09-18T21:00:00Z,GULF 28N 95W,3,5,2,0,10
Tropical Depression,Eight,5,1998-09-18T21:00:00Z,ST MARKS FL,0,0,0,10,10
Tropical Depression,Eight,5,1998-09-18T21:00:00Z,GULF 27N 96W,0,1,1,1,3
Tropical Depression,Eight,5,1998-09-18T21:00:00Z,APALACHICOLA FL,0,0,1,10,11
Tropical Depression,Eight,6,1998-09-19T03:00:00Z,27.1N  91.7W,43,0,0,0,43
Tropical Depression,Eight,6,1998-09-19T03:00:00Z,PENSACOLA FL,0,0,7,9,16
Tropical Depression,Eight,6,1998-09-19T03:00:00Z,28.5N  91.1W,25,4,0,1,30
Tropical Depression,Eight,6,1998-09-19T03:00:00Z,MOBILE AL,0,3,10,6,19
Tropical Depression,Eight,6,1998-09-19T03:00:00Z,30.1N  90.1W,3,14,4,2,23
Tropical Depression,Eight,6,1998-09-19T03:00:00Z,GULFPORT MS,1,8,8,3,20
Tropical Depression,Eight,6,1998-09-19T03:00:00Z,COCOA BEACH FL,0,0,0,2,2
Tropical Depression,Eight,6,1998-09-19T03:00:00Z,BURAS LA,4,12,4,2,22
Tropical Depression,Eight,6,1998-09-19T03:00:00Z,DAYTONA BEACH FL,0,0,0,4,4
Tropical Depression,Eight,6,1998-09-19T03:00:00Z,NEW ORLEANS LA,6,13,4,1,24
Tropical Depression,Eight,6,1998-09-19T03:00:00Z,JACKSONVILLE FL,0,0,0,6,6
Tropical Depression,Eight,6,1998-09-19T03:00:00Z,NEW IBERIA LA,14,10,1,1,26
Tropical Depression,Eight,6,1998-09-19T03:00:00Z,SAVANNAH GA,0,0,0,7,7
Tropical Depression,Eight,6,1998-09-19T03:00:00Z,PORT ARTHUR TX,3,8,3,1,15
Tropical Depression,Eight,6,1998-09-19T03:00:00Z,CHARLESTON SC,0,0,0,5,5
Tropical Depression,Eight,6,1998-09-19T03:00:00Z,GALVESTON TX,1,5,3,2,11
Tropical Depression,Eight,6,1998-09-19T03:00:00Z,MYRTLE BEACH SC,0,0,0,4,4
Tropical Depression,Eight,6,1998-09-19T03:00:00Z,FREEPORT TX,0,2,3,2,7
Tropical Depression,Eight,6,1998-09-19T03:00:00Z,WILMINGTON NC,0,0,0,3,3
Tropical Depression,Eight,6,1998-09-19T03:00:00Z,PORT O CONNOR TX,0,0,1,2,3
Tropical Depression,Eight,6,1998-09-19T03:00:00Z,MOREHEAD CITY NC,0,0,0,2,2
Tropical Depression,Eight,6,1998-09-19T03:00:00Z,GULF 29N 85W,0,0,1,9,10
Tropical Depression,Eight,6,1998-09-19T03:00:00Z,FT MYERS FL,0,0,0,2,2
Tropical Depression,Eight,6,1998-09-19T03:00:00Z,GULF 29N 87W,0,0,6,8,14
Tropical Depression,Eight,6,1998-09-19T03:00:00Z,VENICE FL,0,0,0,3,3
Tropical Depression,Eight,6,1998-09-19T03:00:00Z,GULF 28N 89W,3,9,4,2,18
Tropical Depression,Eight,6,1998-09-19T03:00:00Z,TAMPA FL,0,0,0,4,4
Tropical Depression,Eight,6,1998-09-19T03:00:00Z,GULF 28N 91W,29,2,0,0,31
Tropical Depression,Eight,6,1998-09-19T03:00:00Z,CEDAR KEY FL,0,0,0,6,6
Tropical Depression,Eight,6,1998-09-19T03:00:00Z,GULF 28N 93W,25,1,1,0,27
Tropical Depression,Eight,6,1998-09-19T03:00:00Z,ST MARKS FL,0,0,0,10,10
Tropical Depression,Eight,6,1998-09-19T03:00:00Z,GULF 28N 95W,1,4,2,1,8
Tropical Depression,Eight,6,1998-09-19T03:00:00Z,APALACHICOLA FL,0,0,1,10,11
Tropical Depression,Eight,6,1998-09-19T03:00:00Z,GULF 27N 96W,0,0,1,2,3
Tropical Depression,Eight,6,1998-09-19T03:00:00Z,PANAMA CITY FL,0,0,1,11,12
Tropical Depression,Eight,7,1998-09-19T09:00:00Z,27.1N  91.2W,42,0,0,0,42
Tropical Depression,Eight,7,1998-09-19T09:00:00Z,APALACHICOLA FL,0,0,1,10,11
Tropical Depression,Eight,7,1998-09-19T09:00:00Z,28.7N  90.6W,23,5,1,0,29
Tropical Depression,Eight,7,1998-09-19T09:00:00Z,PANAMA CITY FL,0,0,3,9,12
Tropical Depression,Eight,7,1998-09-19T09:00:00Z,30.9N  89.4W,2,13,8,1,24
Tropical Depression,Eight,7,1998-09-19T09:00:00Z,PENSACOLA FL,0,2,9,6,17
Tropical Depression,Eight,7,1998-09-19T09:00:00Z,COCOA BEACH FL,0,0,0,2,2
Tropical Depression,Eight,7,1998-09-19T09:00:00Z,MOBILE AL,0,7,11,2,20
Tropical Depression,Eight,7,1998-09-19T09:00:00Z,DAYTONA BEACH FL,0,0,0,3,3
Tropical Depression,Eight,7,1998-09-19T09:00:00Z,GULFPORT MS,2,12,8,1,23
Tropical Depression,Eight,7,1998-09-19T09:00:00Z,JACKSONVILLE FL,0,0,0,6,6
Tropical Depression,Eight,7,1998-09-19T09:00:00Z,BURAS LA,8,13,3,1,25
Tropical Depression,Eight,7,1998-09-19T09:00:00Z,SAVANNAH GA,0,0,0,7,7
Tropical Depression,Eight,7,1998-09-19T09:00:00Z,NEW ORLEANS LA,9,15,2,1,27
Tropical Depression,Eight,7,1998-09-19T09:00:00Z,CHARLESTON SC,0,0,0,5,5
Tropical Depression,Eight,7,1998-09-19T09:00:00Z,NEW IBERIA LA,12,11,2,0,25
Tropical Depression,Eight,7,1998-09-19T09:00:00Z,MYRTLE BEACH SC,0,0,0,4,4
Tropical Depression,Eight,7,1998-09-19T09:00:00Z,PORT ARTHUR TX,1,7,3,2,13
Tropical Depression,Eight,7,1998-09-19T09:00:00Z,WILMINGTON NC,0,0,0,3,3
Tropical Depression,Eight,7,1998-09-19T09:00:00Z,GALVESTON TX,0,3,3,2,8
Tropical Depression,Eight,7,1998-09-19T09:00:00Z,MOREHEAD CITY NC,0,0,0,2,2
Tropical Depression,Eight,7,1998-09-19T09:00:00Z,FREEPORT TX,0,1,1,2,4
Tropical Depression,Eight,7,1998-09-19T09:00:00Z,NORFOLK VA,0,0,0,2,2
Tropical Depression,Eight,7,1998-09-19T09:00:00Z,GULF 29N 85W,0,0,1,8,9
Tropical Depression,Eight,7,1998-09-19T09:00:00Z,FT MYERS FL,0,0,0,2,2
Tropical Depression,Eight,7,1998-09-19T09:00:00Z,GULF 29N 87W,0,2,7,5,14
Tropical Depression,Eight,7,1998-09-19T09:00:00Z,VENICE FL,0,0,0,3,3
Tropical Depression,Eight,7,1998-09-19T09:00:00Z,GULF 28N 89W,9,9,2,1,21
Tropical Depression,Eight,7,1998-09-19T09:00:00Z,TAMPA FL,0,0,0,4,4
Tropical Depression,Eight,7,1998-09-19T09:00:00Z,GULF 28N 91W,33,1,0,0,34
Tropical Depression,Eight,7,1998-09-19T09:00:00Z,CEDAR KEY FL,0,0,0,6,6
Tropical Depression,Eight,7,1998-09-19T09:00:00Z,GULF 28N 93W,18,3,1,0,22
Tropical Depression,Eight,7,1998-09-19T09:00:00Z,ST MARKS FL,0,0,1,9,10
Tropical Depression,Eight,7,1998-09-19T09:00:00Z,GULF 28N 95W,0,2,2,2,6
Tropical Storm,Hermine,8,1998-09-19T15:00:00Z,30.0N  89.8W,34,0,0,1,35
Tropical Storm,Hermine,8,1998-09-19T15:00:00Z,ST MARKS FL,0,1,4,6,11
Tropical Storm,Hermine,8,1998-09-19T15:00:00Z,31.5N  89.0W,16,6,1,1,24
Tropical Storm,Hermine,8,1998-09-19T15:00:00Z,APALACHICOLA FL,0,4,4,4,12
Tropical Storm,Hermine,8,1998-09-19T15:00:00Z,32.0N  88.0W,6,12,2,1,21
Tropical Storm,Hermine,8,1998-09-19T15:00:00Z,PANAMA CITY FL,1,6,4,3,14
Tropical Storm,Hermine,8,1998-09-19T15:00:00Z,FT PIERCE FL,0,0,0,2,2
Tropical Storm,Hermine,8,1998-09-19T15:00:00Z,PENSACOLA FL,10,7,2,1,20
Tropical Storm,Hermine,8,1998-09-19T15:00:00Z,COCOA BEACH FL,0,0,0,3,3
Tropical Storm,Hermine,8,1998-09-19T15:00:00Z,MOBILE AL,19,4,1,0,24
Tropical Storm,Hermine,8,1998-09-19T15:00:00Z,DAYTONA BEACH FL,0,0,0,4,4
Tropical Storm,Hermine,8,1998-09-19T15:00:00Z,GULFPORT MS,27,1,1,0,29
Tropical Storm,Hermine,8,1998-09-19T15:00:00Z,JACKSONVILLE FL,0,0,1,5,6
Tropical Storm,Hermine,8,1998-09-19T15:00:00Z,BURAS LA,42,0,0,0,42
Tropical Storm,Hermine,8,1998-09-19T15:00:00Z,SAVANNAH GA,0,0,1,6,7
Tropical Storm,Hermine,8,1998-09-19T15:00:00Z,NEW ORLEANS LA,33,1,0,0,34
Tropical Storm,Hermine,8,1998-09-19T15:00:00Z,CHARLESTON SC,0,0,0,6,6
Tropical Storm,Hermine,8,1998-09-19T15:00:00Z,NEW IBERIA LA,19,1,1,0,21
Tropical Storm,Hermine,8,1998-09-19T15:00:00Z,MYRTLE BEACH SC,0,0,0,4,4
Tropical Storm,Hermine,8,1998-09-19T15:00:00Z,PORT ARTHUR TX,1,2,1,2,6
Tropical Storm,Hermine,8,1998-09-19T15:00:00Z,WILMINGTON NC,0,0,0,3,3
Tropical Storm,Hermine,8,1998-09-19T15:00:00Z,GALVESTON TX,0,1,1,1,3
Tropical Storm,Hermine,8,1998-09-19T15:00:00Z,MOREHEAD CITY NC,0,0,0,2,2
Tropical Storm,Hermine,8,1998-09-19T15:00:00Z,FREEPORT TX,0,0,1,1,2
Tropical Storm,Hermine,8,1998-09-19T15:00:00Z,NORFOLK VA,0,0,0,2,2
Tropical Storm,Hermine,8,1998-09-19T15:00:00Z,GULF 29N 85W,0,3,4,4,11
Tropical Storm,Hermine,8,1998-09-19T15:00:00Z,MARCO ISLAND FL,0,0,0,2,2
Tropical Storm,Hermine,8,1998-09-19T15:00:00Z,GULF 29N 87W,11,4,2,1,18
Tropical Storm,Hermine,8,1998-09-19T15:00:00Z,FT MYERS FL,0,0,0,2,2
Tropical Storm,Hermine,8,1998-09-19T15:00:00Z,GULF 28N 89W,44,0,0,0,44
Tropical Storm,Hermine,8,1998-09-19T15:00:00Z,VENICE FL,0,0,0,4,4
Tropical Storm,Hermine,8,1998-09-19T15:00:00Z,GULF 28N 91W,99,0,0,0,99
Tropical Storm,Hermine,8,1998-09-19T15:00:00Z,TAMPA FL,0,0,1,4,5
Tropical Storm,Hermine,8,1998-09-19T15:00:00Z,GULF 28N 93W,24,1,0,0,25
Tropical Storm,Hermine,8,1998-09-19T15:00:00Z,CEDAR KEY FL,0,0,2,5,7
Tropical Storm,Hermine,8,1998-09-19T15:00:00Z,GULF 28N 95W,0,0,1,1,2
Tropical Storm,Hermine,9,1998-09-19T21:00:00Z,31.0N  90.5W,32,0,0,0,32
Tropical Storm,Hermine,9,1998-09-19T21:00:00Z,WILMINGTON NC,0,0,0,8,8
Tropical Storm,Hermine,9,1998-09-19T21:00:00Z,33.0N  89.0W,9,13,2,0,24
Tropical Storm,Hermine,9,1998-09-19T21:00:00Z,MOREHEAD CITY NC,0,0,0,6,6
Tropical Storm,Hermine,9,1998-09-19T21:00:00Z,35.0N  87.0W,0,11,7,2,20
Tropical Storm,Hermine,9,1998-09-19T21:00:00Z,CAPE HATTERAS NC,0,0,0,5,5
Tropical Storm,Hermine,9,1998-09-19T21:00:00Z,FT PIERCE FL,0,0,0,2,2
Tropical Storm,Hermine,9,1998-09-19T21:00:00Z,NORFOLK VA,0,0,0,7,7
Tropical Storm,Hermine,9,1998-09-19T21:00:00Z,COCOA BEACH FL,0,0,0,3,3
Tropical Storm,Hermine,9,1998-09-19T21:00:00Z,OCEAN CITY MD,0,0,0,6,6
Tropical Storm,Hermine,9,1998-09-19T21:00:00Z,DAYTONA BEACH FL,0,0,0,5,5
Tropical Storm,Hermine,9,1998-09-19T21:00:00Z,ATLANTIC CITY NJ,0,0,0,5,5
Tropical Storm,Hermine,9,1998-09-19T21:00:00Z,JACKSONVILLE FL,0,0,1,7,8
Tropical Storm,Hermine,9,1998-09-19T21:00:00Z,NEW YORK CITY NY,0,0,0,4,4
Tropical Storm,Hermine,9,1998-09-19T21:00:00Z,SAVANNAH GA,0,0,1,9,10
Tropical Storm,Hermine,9,1998-09-19T21:00:00Z,MONTAUK POINT NY,0,0,0,2,2
Tropical Storm,Hermine,9,1998-09-19T21:00:00Z,CHARLESTON SC,0,0,1,8,9
Tropical Storm,Hermine,9,1998-09-19T21:00:00Z,MARCO ISLAND FL,0,0,0,2,2
Tropical Storm,Hermine,9,1998-09-19T21:00:00Z,MYRTLE BEACH SC,0,0,0,9,9
Tropical Storm,Hermine,9,1998-09-19T21:00:00Z,FT MYERS FL,0,0,0,2,2
Tropical Storm,Hermine,10,1998-09-20T03:00:00Z,31.8N  89.2W,35,0,0,0,35
Tropical Storm,Hermine,10,1998-09-20T03:00:00Z,MOBILE AL,32,1,0,0,33
Tropical Storm,Hermine,10,1998-09-20T03:00:00Z,33.7N  87.5W,10,13,1,0,24
Tropical Storm,Hermine,10,1998-09-20T03:00:00Z,GULFPORT MS,41,0,0,0,41
Tropical Storm,Hermine,10,1998-09-20T03:00:00Z,35.0N  85.3W,0,13,4,0,17
Tropical Storm,Hermine,10,1998-09-20T03:00:00Z,BURAS LA,99,0,0,0,99
Tropical Storm,Hermine,10,1998-09-20T03:00:00Z,JACKSONVILLE FL,0,0,3,0,3
Tropical Storm,Hermine,10,1998-09-20T03:00:00Z,NEW ORLEANS LA,99,0,0,0,99
Tropical Storm,Hermine,10,1998-09-20T03:00:00Z,SAVANNAH GA,0,0,3,0,3
Tropical Storm,Hermine,10,1998-09-20T03:00:00Z,NEW IBERIA LA,39,0,0,0,39
Tropical Storm,Hermine,10,1998-09-20T03:00:00Z,CHARLESTON SC,0,0,2,0,2
Tropical Storm,Hermine,10,1998-09-20T03:00:00Z,PORT ARTHUR TX,1,1,1,0,3
Tropical Storm,Hermine,10,1998-09-20T03:00:00Z,CEDAR KEY FL,0,0,3,0,3
Tropical Storm,Hermine,10,1998-09-20T03:00:00Z,GULF 29N 85W,0,3,4,0,7
Tropical Storm,Hermine,10,1998-09-20T03:00:00Z,ST MARKS FL,0,3,5,0,8
Tropical Storm,Hermine,10,1998-09-20T03:00:00Z,GULF 29N 87W,9,4,1,0,14
Tropical Storm,Hermine,10,1998-09-20T03:00:00Z,APALACHICOLA FL,1,4,4,0,9
Tropical Storm,Hermine,10,1998-09-20T03:00:00Z,GULF 28N 89W,30,0,0,0,30
Tropical Storm,Hermine,10,1998-09-20T03:00:00Z,PANAMA CITY FL,3,6,3,0,12
Tropical Storm,Hermine,10,1998-09-20T03:00:00Z,GULF 28N 91W,99,0,0,0,99
Tropical Storm,Hermine,10,1998-09-20T03:00:00Z,PENSACOLA FL,20,2,1,0,23
Tropical Storm,Hermine,10,1998-09-20T03:00:00Z,GULF 28N 93W,1,1,1,0,3
Tropical Storm,Hermine,11,1998-09-20T09:00:00Z,31.5N  89.8W,32,0,0,0,32
Tropical Storm,Hermine,11,1998-09-20T09:00:00Z,BURAS LA,79,0,0,0,79
Tropical Storm,Hermine,11,1998-09-20T09:00:00Z,0.0N   0.0W,99,0,0,0,99
Tropical Storm,Hermine,11,1998-09-20T09:00:00Z,NEW ORLEANS LA,99,0,0,0,99
Tropical Storm,Hermine,11,1998-09-20T09:00:00Z,0.0N   0.0W,99,0,0,0,99
Tropical Storm,Hermine,11,1998-09-20T09:00:00Z,NEW IBERIA LA,49,0,0,0,49
Tropical Storm,Hermine,11,1998-09-20T09:00:00Z,PENSACOLA FL,12,0,0,0,12
Tropical Storm,Hermine,11,1998-09-20T09:00:00Z,GULF 29N 87W,6,0,0,0,6
Tropical Storm,Hermine,11,1998-09-20T09:00:00Z,MOBILE AL,24,0,0,0,24
Tropical Storm,Hermine,11,1998-09-20T09:00:00Z,GULF 28N 89W,18,0,0,0,18
Tropical Storm,Hermine,11,1998-09-20T09:00:00Z,GULFPORT MS,36,0,0,0,36
Tropical Storm,Hermine,11,1998-09-20T09:00:00Z,GULF 28N 91W,21,0,0,0,21
Tropical Depression,Nine,1,1998-09-20T15:00:00Z,15.5N  36.5W,50,0,0,0,50
Tropical Depression,Nine,1,1998-09-20T15:00:00Z,17.5N  42.0W,0,9,18,1,28
Tropical Depression,Nine,1,1998-09-20T15:00:00Z,16.5N  39.0W,5,31,0,0,36
Tropical Depression,Nine,2,1998-09-20T21:00:00Z,16.5N  36.5W,48,0,0,0,48
Tropical Depression,Nine,2,1998-09-20T21:00:00Z,18.0N  41.0W,0,6,16,1,23
Tropical Depression,Nine,2,1998-09-20T21:00:00Z,17.5N  38.5W,3,27,0,0,30
Tropical Storm,Ivan,3,1998-09-21T03:00:00Z,18.8N  38.1W,47,1,0,0,48
Tropical Storm,Ivan,3,1998-09-21T03:00:00Z,21.0N  42.0W,1,22,3,1,27
Tropical Storm,Ivan,3,1998-09-21T03:00:00Z,19.9N  40.2W,19,15,1,0,35
Tropical Storm,Ivan,4,1998-09-21T09:00:00Z,19.3N  39.1W,48,0,0,0,48
Tropical Storm,Ivan,4,1998-09-21T09:00:00Z,22.1N  43.2W,0,23,4,1,28
Tropical Storm,Ivan,4,1998-09-21T09:00:00Z,20.7N  41.2W,15,21,1,0,37
Tropical Storm,Ivan,5,1998-09-21T15:00:00Z,21.5N  39.1W,29,0,0,0,29
Tropical Storm,Ivan,5,1998-09-21T15:00:00Z,24.5N  42.6W,0,11,5,2,18
Tropical Storm,Ivan,5,1998-09-21T15:00:00Z,22.9N  40.8W,12,8,1,1,22
Tropical Storm,Ivan,6,1998-09-21T21:00:00Z,21.9N  38.8W,31,1,0,0,32
Tropical Storm,Ivan,6,1998-09-21T21:00:00Z,25.2N  41.8W,1,13,2,2,18
Tropical Storm,Ivan,6,1998-09-21T21:00:00Z,23.6N  40.3W,14,6,1,1,22
Tropical Storm,Ivan,7,1998-09-22T03:00:00Z,23.0N  39.0W,29,1,0,0,30
Tropical Storm,Ivan,7,1998-09-22T03:00:00Z,26.0N  41.5W,2,11,3,2,18
Tropical Storm,Ivan,7,1998-09-22T03:00:00Z,24.5N  40.2W,15,4,2,0,21
Tropical Storm,Ivan,8,1998-09-22T09:00:00Z,24.9N  36.1W,27,1,0,0,28
Tropical Storm,Ivan,8,1998-09-22T09:00:00Z,27.8N  34.8W,1,8,5,3,17
Tropical Storm,Ivan,8,1998-09-22T09:00:00Z,26.6N  35.6W,6,10,2,2,20
Tropical Storm,Ivan,9,1998-09-22T15:00:00Z,26.8N  37.7W,29,1,0,0,30
Tropical Storm,Ivan,9,1998-09-22T15:00:00Z,30.2N  37.9W,0,9,5,3,17
Tropical Storm,Ivan,9,1998-09-22T15:00:00Z,28.4N  37.9W,11,6,2,1,20
Tropical Storm,Ivan,10,1998-09-22T21:00:00Z,28.0N  39.1W,23,1,1,0,25
Tropical Storm,Ivan,10,1998-09-22T21:00:00Z,31.5N  39.6W,1,8,4,3,16
Tropical Storm,Ivan,10,1998-09-22T21:00:00Z,29.9N  39.6W,8,8,2,1,19
Tropical Storm,Ivan,11,1998-09-23T03:00:00Z,29.1N  39.4W,23,1,1,0,25
Tropical Storm,Ivan,11,1998-09-23T03:00:00Z,32.3N  40.5W,1,9,4,3,17
Tropical Storm,Ivan,11,1998-09-23T03:00:00Z,30.6N  40.0W,11,5,2,2,20
Tropical Storm,Ivan,12,1998-09-23T09:00:00Z,31.4N  39.7W,28,0,1,0,29
Tropical Storm,Ivan,12,1998-09-23T09:00:00Z,35.4N  39.9W,0,7,6,3,16
Tropical Storm,Ivan,12,1998-09-23T09:00:00Z,33.5N  40.1W,4,13,2,1,20
Tropical Storm,Ivan,13,1998-09-23T15:00:00Z,34.2N  40.9W,30,0,0,0,30
Tropical Storm,Ivan,13,1998-09-23T15:00:00Z,38.7N  38.3W,0,8,6,3,17
Tropical Storm,Ivan,13,1998-09-23T15:00:00Z,36.4N  40.1W,6,12,1,1,20
Hurricane,Ivan,14,1998-09-23T21:00:00Z,34.8N  41.0W,33,1,0,0,34
Hurricane,Ivan,14,1998-09-23T21:00:00Z,39.6N  36.5W,0,5,8,2,15
Hurricane,Ivan,14,1998-09-23T21:00:00Z,37.4N  39.6W,3,14,2,0,19
Hurricane,Ivan,15,1998-09-24T03:00:00Z,35.9N  40.7W,27,1,0,0,28
Hurricane,Ivan,15,1998-09-24T03:00:00Z,39.5N  33.0W,0,5,7,2,14
Hurricane,Ivan,15,1998-09-24T03:00:00Z,38.2N  37.2W,3,13,2,0,18
Hurricane,Ivan,16,1998-09-24T09:00:00Z,35.5N  41.2W,29,0,0,0,29
Hurricane,Ivan,16,1998-09-24T09:00:00Z,39.2N  33.0W,0,3,9,2,14
Hurricane,Ivan,16,1998-09-24T09:00:00Z,37.7N  37.9W,3,14,1,1,19
Hurricane,Ivan,17,1998-09-24T15:00:00Z,37.0N  39.2W,27,1,0,0,28
Hurricane,Ivan,17,1998-09-24T15:00:00Z,38.9N  29.3W,0,3,9,2,14
Hurricane,Ivan,17,1998-09-24T15:00:00Z,38.2N  35.0W,2,14,2,0,18
Hurricane,Ivan,18,1998-09-24T21:00:00Z,37.8N  40.0W,29,0,0,0,29
Hurricane,Ivan,18,1998-09-24T21:00:00Z,40.1N  30.5W,0,2,9,2,13
Hurricane,Ivan,18,1998-09-24T21:00:00Z,39.2N  36.6W,6,10,2,0,18
Hurricane,Ivan,19,1998-09-25T03:00:00Z,38.4N  38.1W,29,1,0,0,30
Hurricane,Ivan,19,1998-09-25T03:00:00Z,39.0N  27.5W,0,2,8,3,13
Hurricane,Ivan,19,1998-09-25T03:00:00Z,39.0N  33.3W,2,13,2,0,17
Hurricane,Ivan,20,1998-09-25T09:00:00Z,38.6N  36.6W,20,3,0,0,23
Hurricane,Ivan,20,1998-09-25T09:00:00Z,39.0N  25.3W,0,1,11,3,15
Hurricane,Ivan,20,1998-09-25T09:00:00Z,39.0N  31.6W,1,14,3,1,19
Hurricane,Ivan,21,1998-09-25T15:00:00Z,39.1N  33.2W,24,4,0,0,28
Hurricane,Ivan,21,1998-09-25T15:00:00Z,39.6N  20.0W,0,1,12,0,13
Hurricane,Ivan,21,1998-09-25T15:00:00Z,39.6N  27.2W,0,17,4,0,21
Hurricane,Ivan,22,1998-09-25T21:00:00Z,39.5N  31.6W,24,5,0,0,29
Hurricane,Ivan,22,1998-09-25T21:00:00Z,38.9N  17.9W,0,1,12,0,13
Hurricane,Ivan,22,1998-09-25T21:00:00Z,39.5N  25.3W,0,17,3,0,20
Hurricane,Ivan,23,1998-09-26T03:00:00Z,39.5N  28.0W,25,3,0,0,28
Hurricane,Ivan,23,1998-09-26T03:00:00Z,38.5N  16.0W,0,3,11,0,14
Hurricane,Ivan,23,1998-09-26T03:00:00Z,39.0N  22.0W,1,17,2,0,20
Hurricane,Ivan,24,1998-09-26T09:00:00Z,39.2N  23.8W,26,2,0,0,28
Hurricane,Ivan,24,1998-09-26T09:00:00Z,38.4N  13.0W,0,4,10,3,17
Hurricane,Ivan,24,1998-09-26T09:00:00Z,38.9N  18.3W,1,17,2,0,20
Hurricane,Ivan,25,1998-09-26T15:00:00Z,42.2N  16.1W,24,6,0,0,30
Hurricane,Ivan,25,1998-09-26T15:00:00Z,41.8N   6.1W,0,14,0,0,14
Hurricane,Ivan,26,1998-09-26T21:00:00Z,42.1N  13.8W,24,6,0,0,30
Hurricane,Ivan,26,1998-09-26T21:00:00Z,41.7N   2.0W,0,13,0,0,13
Tropical Storm,Ivan,27,1998-09-27T03:00:00Z,40.7N   7.5W,23,0,0,0,23
Tropical Storm,Jeanne,1,1998-09-21T21:00:00Z,12.1N  24.4W,52,1,0,0,53
Tropical Storm,Jeanne,1,1998-09-21T21:00:00Z,13.4N  29.8W,0,11,17,1,29
Tropical Storm,Jeanne,1,1998-09-21T21:00:00Z,12.8N  27.2W,1,37,0,0,38
Tropical Storm,Jeanne,2,1998-09-22T03:00:00Z,12.4N  25.7W,52,0,0,0,52
Tropical Storm,Jeanne,2,1998-09-22T03:00:00Z,13.8N  31.5W,0,6,20,0,26
Tropical Storm,Jeanne,2,1998-09-22T03:00:00Z,13.0N  28.5W,3,31,1,0,35
Tropical Storm,Jeanne,3,1998-09-22T09:00:00Z,14.0N  28.7W,46,1,0,0,47
Tropical Storm,Jeanne,3,1998-09-22T09:00:00Z,15.9N  34.2W,0,1,21,1,23
Tropical Storm,Jeanne,3,1998-09-22T09:00:00Z,14.9N  31.4W,0,29,1,1,31
Tropical Storm,Jeanne,4,1998-09-22T15:00:00Z,14.7N  29.7W,43,2,0,0,45
Tropical Storm,Jeanne,4,1998-09-22T15:00:00Z,16.4N  35.3W,0,1,19,2,22
Tropical Storm,Jeanne,4,1998-09-22T15:00:00Z,15.5N  32.6W,0,27,2,0,29
Hurricane,Jeanne,5,1998-09-22T21:00:00Z,15.0N  31.3W,47,1,0,0,48
Hurricane,Jeanne,5,1998-09-22T21:00:00Z,16.7N  36.9W,0,2,20,1,23
Hurricane,Jeanne,5,1998-09-22T21:00:00Z,15.9N  34.2W,0,30,1,0,31
Hurricane,Jeanne,7,1998-09-23T09:00:00Z,15.9N  33.9W,46,1,0,0,47
Hurricane,Jeanne,7,1998-09-23T09:00:00Z,17.4N  38.7W,0,4,17,1,22
Hurricane,Jeanne,7,1998-09-23T09:00:00Z,16.7N  36.4W,0,29,1,0,30
Hurricane,Jeanne,8,1998-09-23T15:00:00Z,16.6N  35.6W,46,1,0,0,47
Hurricane,Jeanne,8,1998-09-23T15:00:00Z,18.4N  40.8W,0,3,19,1,23
Hurricane,Jeanne,8,1998-09-23T15:00:00Z,17.5N  38.2W,0,30,0,0,30
Hurricane,Jeanne,9,1998-09-23T21:00:00Z,16.8N  36.8W,45,0,0,0,45
Hurricane,Jeanne,9,1998-09-23T21:00:00Z,18.8N  41.8W,0,3,19,1,23
Hurricane,Jeanne,9,1998-09-23T21:00:00Z,17.7N  39.3W,1,28,1,0,30
Hurricane,Jeanne,10,1998-09-24T03:00:00Z,17.2N  37.9W,48,1,0,0,49
Hurricane,Jeanne,10,1998-09-24T03:00:00Z,19.6N  42.7W,0,2,20,2,24
Hurricane,Jeanne,10,1998-09-24T03:00:00Z,18.4N  40.3W,1,30,0,1,32
Hurricane,Jeanne,11,1998-09-24T09:00:00Z,17.7N  39.4W,47,0,0,0,47
Hurricane,Jeanne,11,1998-09-24T09:00:00Z,20.3N  43.9W,0,6,16,1,23
Hurricane,Jeanne,11,1998-09-24T09:00:00Z,18.9N  41.9W,1,29,1,0,31
Hurricane,Jeanne,12,1998-09-24T15:00:00Z,18.5N  39.2W,51,1,0,0,52
Hurricane,Jeanne,12,1998-09-24T15:00:00Z,21.4N  43.1W,0,15,9,2,26
Hurricane,Jeanne,12,1998-09-24T15:00:00Z,19.7N  41.5W,5,28,0,1,34
Hurricane,Jeanne,13,1998-09-24T21:00:00Z,19.1N  40.1W,53,0,0,0,53
Hurricane,Jeanne,13,1998-09-24T21:00:00Z,22.7N  43.4W,0,16,10,1,27
Hurricane,Jeanne,13,1998-09-24T21:00:00Z,20.8N  42.0W,9,25,1,0,35
Hurricane,Jeanne,14,1998-09-25T03:00:00Z,20.1N  40.6W,58,0,0,0,58
Hurricane,Jeanne,14,1998-09-25T03:00:00Z,24.1N  43.2W,0,11,13,1,25
Hurricane,Jeanne,14,1998-09-25T03:00:00Z,21.9N  42.2W,4,30,0,1,35
Hurricane,Jeanne,15,1998-09-25T09:00:00Z,21.3N  41.2W,61,0,0,0,61
Hurricane,Jeanne,15,1998-09-25T09:00:00Z,26.0N  42.8W,0,10,14,1,25
Hurricane,Jeanne,15,1998-09-25T09:00:00Z,23.5N  42.4W,2,34,1,0,37
Hurricane,Jeanne,16,1998-09-25T15:00:00Z,21.8N  41.5W,43,0,0,0,43
Hurricane,Jeanne,16,1998-09-25T15:00:00Z,27.0N  43.0W,0,13,6,2,21
Hurricane,Jeanne,16,1998-09-25T15:00:00Z,24.2N  42.6W,14,13,1,0,28
Hurricane,Jeanne,17,1998-09-25T21:00:00Z,22.9N  40.3W,29,1,0,0,30
Hurricane,Jeanne,17,1998-09-25T21:00:00Z,28.3N  41.2W,0,7,8,2,17
Hurricane,Jeanne,17,1998-09-25T21:00:00Z,25.1N  41.1W,10,9,1,0,20
Hurricane,Jeanne,18,1998-09-26T03:00:00Z,23.4N  40.9W,28,1,0,0,29
Hurricane,Jeanne,18,1998-09-26T03:00:00Z,28.8N  40.8W,0,6,8,2,16
Hurricane,Jeanne,18,1998-09-26T03:00:00Z,25.8N  41.1W,8,10,1,1,20
Hurricane,Jeanne,19,1998-09-26T09:00:00Z,25.0N  40.8W,24,1,1,0,26
Hurricane,Jeanne,19,1998-09-26T09:00:00Z,30.0N  40.0W,0,4,9,3,16
Hurricane,Jeanne,19,1998-09-26T09:00:00Z,27.2N  40.7W,5,11,2,0,18
Hurricane,Jeanne,20,1998-09-26T15:00:00Z,25.9N  40.8W,23,1,0,0,24
Hurricane,Jeanne,20,1998-09-26T15:00:00Z,31.4N  38.9W,0,2,10,2,14
Hurricane,Jeanne,20,1998-09-26T15:00:00Z,28.5N  40.3W,2,13,2,1,18
Hurricane,Jeanne,21,1998-09-26T21:00:00Z,27.0N  41.5W,20,3,0,0,23
Hurricane,Jeanne,21,1998-09-26T21:00:00Z,34.5N  37.5W,0,0,10,4,14
Hurricane,Jeanne,21,1998-09-26T21:00:00Z,30.0N  40.0W,0,14,5,0,19
Hurricane,Jeanne,22,1998-09-27T03:00:00Z,28.0N  41.0W,25,7,0,0,32
Hurricane,Jeanne,22,1998-09-27T03:00:00Z,36.0N  35.0W,0,0,12,4,16
Hurricane,Jeanne,22,1998-09-27T03:00:00Z,32.0N  39.0W,0,16,7,0,23
Hurricane,Jeanne,23,1998-09-27T09:00:00Z,30.0N  40.0W,28,8,0,0,36
Hurricane,Jeanne,23,1998-09-27T09:00:00Z,37.5N  32.6W,0,0,13,3,16
Hurricane,Jeanne,23,1998-09-27T09:00:00Z,34.3N  37.4W,0,17,5,1,23
Hurricane,Jeanne,24,1998-09-27T15:00:00Z,32.0N  39.0W,34,2,0,0,36
Hurricane,Jeanne,24,1998-09-27T15:00:00Z,38.0N  30.0W,0,2,12,1,15
Hurricane,Jeanne,24,1998-09-27T15:00:00Z,35.5N  35.5W,0,18,2,0,20
Hurricane,Jeanne,25,1998-09-27T21:00:00Z,33.3N  38.6W,29,1,0,0,30
Hurricane,Jeanne,25,1998-09-27T21:00:00Z,37.5N  31.5W,0,4,8,2,14
Hurricane,Jeanne,25,1998-09-27T21:00:00Z,36.0N  35.5W,2,14,2,0,18
Hurricane,Jeanne,26,1998-09-28T03:00:00Z,34.5N  38.3W,30,0,1,0,31
Hurricane,Jeanne,26,1998-09-28T03:00:00Z,39.1N  31.5W,0,3,9,2,14
Hurricane,Jeanne,26,1998-09-28T03:00:00Z,37.2N  35.2W,3,14,1,0,18
Hurricane,Jeanne,27,1998-09-28T09:00:00Z,36.1N  37.2W,20,2,0,0,22
Hurricane,Jeanne,27,1998-09-28T09:00:00Z,40.5N  30.9W,0,4,8,3,15
Hurricane,Jeanne,27,1998-09-28T09:00:00Z,38.6N  34.4W,1,13,2,1,17
Hurricane,Jeanne,28,1998-09-28T15:00:00Z,38.6N  34.7W,24,2,0,0,26
Hurricane,Jeanne,28,1998-09-28T15:00:00Z,41.5N  29.5W,0,10,4,2,16
Hurricane,Jeanne,28,1998-09-28T15:00:00Z,40.3N  32.0W,3,14,1,1,19
Hurricane,Jeanne,29,1998-09-28T21:00:00Z,37.9N  33.3W,24,1,0,0,25
Hurricane,Jeanne,29,1998-09-28T21:00:00Z,39.5N  27.0W,0,10,4,2,16
Hurricane,Jeanne,29,1998-09-28T21:00:00Z,39.1N  30.1W,6,11,2,0,19
Hurricane,Jeanne,30,1998-09-29T03:00:00Z,39.0N  31.5W,24,1,0,0,25
Hurricane,Jeanne,30,1998-09-29T03:00:00Z,40.0N  25.5W,0,11,3,2,16
Hurricane,Jeanne,30,1998-09-29T03:00:00Z,39.8N  28.5W,7,10,2,0,19
Hurricane,Jeanne,31,1998-09-29T09:00:00Z,38.1N  28.6W,24,1,0,0,25
Hurricane,Jeanne,31,1998-09-29T09:00:00Z,38.5N  22.3W,0,9,5,2,16
Hurricane,Jeanne,31,1998-09-29T09:00:00Z,38.4N  25.5W,6,11,1,1,19
Hurricane,Jeanne,32,1998-09-29T15:00:00Z,38.2N  30.7W,22,1,0,0,23
Hurricane,Jeanne,32,1998-09-29T15:00:00Z,39.5N  24.5W,0,7,5,2,14
Hurricane,Jeanne,32,1998-09-29T15:00:00Z,39.0N  27.7W,6,8,2,1,17
Tropical Storm,Jeanne,33,1998-09-29T21:00:00Z,38.2N  31.0W,33,0,0,0,33
Tropical Storm,Jeanne,33,1998-09-29T21:00:00Z,39.5N  26.5W,3,7,3,2,15
Tropical Storm,Jeanne,33,1998-09-29T21:00:00Z,39.0N  29.0W,15,3,1,0,19
Tropical Storm,Jeanne,34,1998-09-30T03:00:00Z,38.6N  30.0W,29,0,1,0,30
Tropical Storm,Jeanne,34,1998-09-30T03:00:00Z,40.5N  25.0W,1,8,3,3,15
Tropical Storm,Jeanne,34,1998-09-30T03:00:00Z,39.5N  27.5W,11,4,2,1,18
Tropical Storm,Jeanne,35,1998-09-30T09:00:00Z,38.7N  26.6W,21,1,1,0,23
Tropical Storm,Jeanne,35,1998-09-30T09:00:00Z,39.0N  20.0W,0,6,7,0,13
Tropical Storm,Jeanne,35,1998-09-30T09:00:00Z,38.9N  23.4W,4,11,2,0,17
Tropical Storm,Jeanne,36,1998-09-30T15:00:00Z,39.0N  25.0W,22,1,0,0,23
Tropical Storm,Jeanne,36,1998-09-30T15:00:00Z,40.0N  18.0W,0,6,7,0,13
Tropical Storm,Jeanne,36,1998-09-30T15:00:00Z,39.5N  22.0W,7,8,2,0,17
Tropical Depression,Jeanne,37,1998-09-30T21:00:00Z,39.5N  23.5W,26,1,0,0,27
Tropical Depression,Jeanne,37,1998-09-30T21:00:00Z,40.5N  17.5W,0,10,4,0,14
Tropical Depression,Jeanne,37,1998-09-30T21:00:00Z,40.0N  20.5W,8,10,1,0,19
Tropical Depression,Eleven,1,1998-09-23T21:00:00Z,33.7N  53.0W,18,1,0,1,20
Tropical Depression,Eleven,1,1998-09-23T21:00:00Z,35.3N  44.2W,0,3,6,3,12
Tropical Depression,Eleven,1,1998-09-23T21:00:00Z,34.3N  48.5W,1,11,1,1,14
Tropical Depression,Eleven,1,1998-09-23T21:00:00Z,BERMUDA,2,0,0,0,2
Tropical Storm,Karl,2,1998-09-24T03:00:00Z,34.5N  51.0W,16,2,0,1,19
Tropical Storm,Karl,2,1998-09-24T03:00:00Z,36.6N  42.3W,0,3,6,3,12
Tropical Storm,Karl,2,1998-09-24T03:00:00Z,35.5N  46.5W,2,10,2,0,14
Tropical Storm,Karl,3,1998-09-24T09:00:00Z,32.7N  51.0W,25,0,1,0,26
Tropical Storm,Karl,3,1998-09-24T09:00:00Z,34.2N  42.8W,0,4,5,3,12
Tropical Storm,Karl,3,1998-09-24T09:00:00Z,33.2N  46.9W,2,11,1,1,15
Tropical Storm,Karl,4,1998-09-24T15:00:00Z,30.6N  52.9W,27,2,1,0,30
Tropical Storm,Karl,4,1998-09-24T15:00:00Z,31.1N  47.4W,0,5,7,3,15
Tropical Storm,Karl,4,1998-09-24T15:00:00Z,30.6N  50.4W,2,14,2,1,19
Tropical Storm,Karl,5,1998-09-24T21:00:00Z,31.3N  53.9W,27,1,0,0,28
Tropical Storm,Karl,5,1998-09-24T21:00:00Z,32.2N  49.4W,1,8,4,2,15
Tropical Storm,Karl,5,1998-09-24T21:00:00Z,31.6N  51.8W,9,6,2,1,18
Tropical Storm,Karl,6,1998-09-25T03:00:00Z,30.9N  52.4W,26,0,1,0,27
Tropical Storm,Karl,6,1998-09-25T03:00:00Z,33.1N  48.0W,0,8,6,3,17
Tropical Storm,Karl,6,1998-09-25T03:00:00Z,31.9N  50.4W,8,9,2,1,20
Tropical Storm,Karl,7,1998-09-25T09:00:00Z,31.4N  51.0W,29,2,0,0,31
Tropical Storm,Karl,7,1998-09-25T09:00:00Z,34.3N  47.0W,0,6,7,3,16
Tropical Storm,Karl,7,1998-09-25T09:00:00Z,32.8N  49.0W,2,15,2,1,20
Hurricane,Karl,8,1998-09-25T15:00:00Z,32.8N  49.2W,20,2,0,0,22
Hurricane,Karl,8,1998-09-25T15:00:00Z,CAPE RACE NFLD,0,0,0,2,2
Hurricane,Karl,8,1998-09-25T15:00:00Z,35.2N  47.2W,2,11,2,1,16
Hurricane,Karl,8,1998-09-25T15:00:00Z,HIBERNIA OILFLD,0,0,0,4,4
Hurricane,Karl,8,1998-09-25T15:00:00Z,37.5N  44.8W,0,5,5,3,13
Hurricane,Karl,9,1998-09-25T21:00:00Z,33.8N  48.4W,24,4,0,0,28
Hurricane,Karl,9,1998-09-25T21:00:00Z,CAPE RACE NFLD,0,0,0,2,2
Hurricane,Karl,9,1998-09-25T21:00:00Z,36.3N  46.5W,1,16,3,1,21
Hurricane,Karl,9,1998-09-25T21:00:00Z,HIBERNIA OILFLD,0,0,0,4,4
Hurricane,Karl,9,1998-09-25T21:00:00Z,38.8N  43.6W,0,2,11,3,16
Hurricane,Karl,10,1998-09-26T03:00:00Z,35.0N  47.0W,24,2,0,0,26
Hurricane,Karl,10,1998-09-26T03:00:00Z,CAPE RACE NFLD,0,0,0,2,2
Hurricane,Karl,10,1998-09-26T03:00:00Z,37.0N  45.0W,3,12,3,0,18
Hurricane,Karl,10,1998-09-26T03:00:00Z,HIBERNIA OILFLD,0,0,0,4,4
Hurricane,Karl,10,1998-09-26T03:00:00Z,39.5N  42.0W,0,4,8,3,15
Hurricane,Karl,11,1998-09-26T09:00:00Z,33.3N  47.9W,21,2,0,1,24
Hurricane,Karl,11,1998-09-26T09:00:00Z,CAPE RACE NFLD,0,0,0,2,2
Hurricane,Karl,11,1998-09-26T09:00:00Z,34.7N  46.4W,5,10,2,1,18
Hurricane,Karl,11,1998-09-26T09:00:00Z,HIBERNIA OILFLD,0,0,0,3,3
Hurricane,Karl,11,1998-09-26T09:00:00Z,36.9N  44.3W,0,5,7,2,14
Hurricane,Karl,12,1998-09-26T15:00:00Z,36.3N  45.5W,35,0,0,0,35
Hurricane,Karl,12,1998-09-26T15:00:00Z,41.7N  36.6W,0,1,8,3,12
Hurricane,Karl,12,1998-09-26T15:00:00Z,38.9N  41.7W,0,14,3,0,17
Hurricane,Karl,12,1998-09-26T15:00:00Z,HIBERNIA OILFLD,0,0,2,1,3
Hurricane,Karl,13,1998-09-26T21:00:00Z,37.6N  43.6W,15,4,0,0,19
Hurricane,Karl,13,1998-09-26T21:00:00Z,42.7N  32.8W,0,0,8,3,11
Hurricane,Karl,13,1998-09-26T21:00:00Z,40.2N  39.1W,0,10,3,0,13
Hurricane,Karl,14,1998-09-27T03:00:00Z,39.5N  40.0W,15,7,0,0,22
Hurricane,Karl,14,1998-09-27T03:00:00Z,44.0N  28.0W,0,1,9,3,13
Hurricane,Karl,14,1998-09-27T03:00:00Z,42.0N  34.0W,0,12,4,0,16
Hurricane,Karl,15,1998-09-27T09:00:00Z,43.3N  33.5W,17,5,0,0,22
Hurricane,Karl,15,1998-09-27T09:00:00Z,45.5N  19.0W,0,2,8,3,13
Hurricane,Karl,15,1998-09-27T09:00:00Z,44.7N  25.8W,0,13,2,1,16
Hurricane,Karl,16,1998-09-27T15:00:00Z,43.6N  28.2W,23,5,0,0,28
Hurricane,Karl,16,1998-09-27T15:00:00Z,45.0N  19.0W,0,14,0,0,14
Hurricane,Karl,17,1998-09-27T21:00:00Z,44.0N  22.5W,25,7,0,0,32
Hurricane,Karl,17,1998-09-27T21:00:00Z,45.5N  11.0W,0,13,0,0,13
Tropical Storm,Karl,18,1998-09-28T03:00:00Z,45.0N  14.8W,21,0,0,0,21
Tropical Storm,Lisa,1,1998-10-05T21:00:00Z,19.5N  52.0W,36,1,0,0,37
Tropical Storm,Lisa,1,1998-10-05T21:00:00Z,23.5N  48.5W,0,2,14,3,19
Tropical Storm,Lisa,1,1998-10-05T21:00:00Z,21.5N  51.5W,11,10,2,1,24
Tropical Storm,Lisa,2,1998-10-06T03:00:00Z,19.5N  52.0W,41,0,0,0,41
Tropical Storm,Lisa,2,1998-10-06T03:00:00Z,23.0N  48.5W,0,8,8,2,18
Tropical Storm,Lisa,2,1998-10-06T03:00:00Z,21.5N  50.5W,5,17,1,0,23
Tropical Storm,Lisa,3,1998-10-06T09:00:00Z,19.6N  49.0W,31,1,0,0,32
Tropical Storm,Lisa,3,1998-10-06T09:00:00Z,23.9N  45.5W,0,2,16,4,22
Tropical Storm,Lisa,3,1998-10-06T09:00:00Z,21.3N  47.8W,5,16,4,1,26
Tropical Storm,Lisa,4,1998-10-06T15:00:00Z,21.0N  46.0W,37,1,0,0,38
Tropical Storm,Lisa,4,1998-10-06T15:00:00Z,26.5N  41.0W,0,3,15,2,20
Tropical Storm,Lisa,4,1998-10-06T15:00:00Z,23.5N  44.0W,4,22,1,0,27
Tropical Storm,Lisa,5,1998-10-06T21:00:00Z,22.0N  45.0W,40,0,0,1,41
Tropical Storm,Lisa,5,1998-10-06T21:00:00Z,27.5N  40.5W,0,3,15,1,19
Tropical Storm,Lisa,5,1998-10-06T21:00:00Z,24.5N  43.0W,3,23,1,0,27
Tropical Storm,Lisa,6,1998-10-07T03:00:00Z,22.5N  45.0W,40,1,0,0,41
Tropical Storm,Lisa,6,1998-10-07T03:00:00Z,28.0N  40.5W,0,5,14,1,20
Tropical Storm,Lisa,6,1998-10-07T03:00:00Z,25.0N  43.0W,5,22,1,0,28
Tropical Storm,Lisa,7,1998-10-07T09:00:00Z,24.0N  44.0W,26,5,0,1,32
Tropical Storm,Lisa,7,1998-10-07T09:00:00Z,32.0N  41.0W,0,2,11,2,15
Tropical Storm,Lisa,7,1998-10-07T09:00:00Z,27.5N  42.0W,0,17,3,0,20
Tropical Storm,Lisa,7,1998-10-07T09:00:00Z,HIBERNIA OILFLD,0,0,0,2,2
Tropical Storm,Lisa,8,1998-10-07T15:00:00Z,25.5N  42.0W,23,10,0,0,33
Tropical Storm,Lisa,8,1998-10-07T15:00:00Z,CAPE RACE NFLD,0,0,0,2,2
Tropical Storm,Lisa,8,1998-10-07T15:00:00Z,29.5N  40.0W,0,17,4,0,21
Tropical Storm,Lisa,8,1998-10-07T15:00:00Z,HIBERNIA OILFLD,0,0,0,3,3
Tropical Storm,Lisa,8,1998-10-07T15:00:00Z,33.5N  40.0W,0,1,13,2,16
Tropical Storm,Lisa,9,1998-10-07T21:00:00Z,26.0N  41.5W,19,4,0,1,24
Tropical Storm,Lisa,9,1998-10-07T21:00:00Z,CAPE RACE NFLD,0,0,0,2,2
Tropical Storm,Lisa,9,1998-10-07T21:00:00Z,29.5N  39.5W,1,12,2,0,15
Tropical Storm,Lisa,9,1998-10-07T21:00:00Z,HIBERNIA OILFLD,0,0,0,3,3
Tropical Storm,Lisa,9,1998-10-07T21:00:00Z,33.5N  39.5W,0,3,7,2,12
Tropical Storm,Lisa,10,1998-10-08T03:00:00Z,29.0N  40.0W,25,3,0,0,28
Tropical Storm,Lisa,10,1998-10-08T03:00:00Z,37.5N  38.5W,0,2,10,3,15
Tropical Storm,Lisa,10,1998-10-08T03:00:00Z,33.0N  39.0W,0,15,3,0,18
Tropical Storm,Lisa,10,1998-10-08T03:00:00Z,HIBERNIA OILFLD,0,0,0,2,2
Tropical Storm,Lisa,11,1998-10-08T09:00:00Z,32.5N  38.0W,27,3,0,0,30
Tropical Storm,Lisa,11,1998-10-08T09:00:00Z,CAPE RACE NFLD,0,0,0,2,2
Tropical Storm,Lisa,11,1998-10-08T09:00:00Z,37.0N  39.0W,0,17,1,1,19
Tropical Storm,Lisa,11,1998-10-08T09:00:00Z,HIBERNIA OILFLD,0,0,0,6,6
Tropical Storm,Lisa,11,1998-10-08T09:00:00Z,40.0N  40.0W,0,7,6,3,16
Tropical Storm,Lisa,12,1998-10-08T15:00:00Z,35.0N  38.0W,27,2,1,0,30
Tropical Storm,Lisa,12,1998-10-08T15:00:00Z,43.5N  38.0W,0,3,10,2,15
Tropical Storm,Lisa,12,1998-10-08T15:00:00Z,39.0N  38.0W,1,16,2,0,19
Tropical Storm,Lisa,12,1998-10-08T15:00:00Z,HIBERNIA OILFLD,0,0,1,3,4
Tropical Storm,Lisa,13,1998-10-08T21:00:00Z,39.0N  36.5W,28,3,1,0,32
Tropical Storm,Lisa,13,1998-10-08T21:00:00Z,48.3N  36.5W,0,2,11,0,13
Tropical Storm,Lisa,13,1998-10-08T21:00:00Z,43.5N  36.5W,0,17,2,0,19
Tropical Storm,Lisa,14,1998-10-09T03:00:00Z,47.0N  39.0W,21,3,0,0,24
Tropical Storm,Lisa,14,1998-10-09T03:00:00Z,51.0N  30.0W,0,6,7,0,13
Tropical Storm,Lisa,14,1998-10-09T03:00:00Z,50.0N  35.0W,1,15,1,0,17
Tropical Depression,Thirteen,1,1998-10-22T03:00:00Z,14.0N  80.0W,54,0,0,0,54
Tropical Depression,Thirteen,1,1998-10-22T03:00:00Z,MMCZ 205N 869W,0,0,0,9,9
Tropical Depression,Thirteen,1,1998-10-22T03:00:00Z,14.5N  81.0W,27,7,0,1,35
Tropical Depression,Thirteen,1,1998-10-22T03:00:00Z,MZBZ 175N 883W,0,0,0,5,5
Tropical Depression,Thirteen,1,1998-10-22T03:00:00Z,16.0N  82.0W,1,18,10,1,30
Tropical Depression,Thirteen,1,1998-10-22T03:00:00Z,MGPB 157N 886W,0,0,0,3,3
Tropical Depression,Thirteen,1,1998-10-22T03:00:00Z,MKJP 179N 768W,0,0,1,3,4
Tropical Depression,Thirteen,1,1998-10-22T03:00:00Z,MHNJ 165N 859W,0,0,3,10,13
Tropical Depression,Thirteen,1,1998-10-22T03:00:00Z,MKJS 185N 779W,0,1,1,6,8
Tropical Depression,Thirteen,1,1998-10-22T03:00:00Z,MNPC 141N 834W,0,9,10,2,21
Tropical Depression,Thirteen,1,1998-10-22T03:00:00Z,MWCG 193N 814W,0,1,8,8,17
Tropical Depression,Thirteen,1,1998-10-22T03:00:00Z,MNBL 120N 839W,0,2,3,3,8
Tropical Depression,Thirteen,1,1998-10-22T03:00:00Z,MUCM 214N 779W,0,0,0,3,3
Tropical Depression,Thirteen,1,1998-10-22T03:00:00Z,SKSP 126N 817W,9,10,2,1,22
Tropical Depression,Thirteen,1,1998-10-22T03:00:00Z,MUCF 221N 805W,0,0,0,6,6
Tropical Depression,Thirteen,1,1998-10-22T03:00:00Z,MRLM 100N 831W,0,0,1,1,2
Tropical Depression,Thirteen,1,1998-10-22T03:00:00Z,MUSN 216N 826W,0,0,1,9,10
Tropical Depression,Thirteen,1,1998-10-22T03:00:00Z,MMMD 210N 897W,0,0,0,2,2
Tropical Depression,Thirteen,1,1998-10-22T03:00:00Z,MUHA 230N 824W,0,0,0,6,6
Tropical Depression,Thirteen,1,1998-10-22T03:00:00Z,KEY WEST FL,0,0,0,2,2
Tropical Depression,Thirteen,1,1998-10-22T03:00:00Z,MUAN 219N 850W,0,0,0,9,9
Tropical Depression,Thirteen,2,1998-10-22T09:00:00Z,14.0N  80.5W,52,0,0,0,52
Tropical Depression,Thirteen,2,1998-10-22T09:00:00Z,MMCZ 205N 869W,0,0,0,10,10
Tropical Depression,Thirteen,2,1998-10-22T09:00:00Z,15.0N  81.5W,22,11,0,1,34
Tropical Depression,Thirteen,2,1998-10-22T09:00:00Z,MZBZ 175N 883W,0,0,0,6,6
Tropical Depression,Thirteen,2,1998-10-22T09:00:00Z,16.2N  82.2W,2,21,4,1,28
Tropical Depression,Thirteen,2,1998-10-22T09:00:00Z,MGPB 157N 886W,0,0,0,3,3
Tropical Depression,Thirteen,2,1998-10-22T09:00:00Z,MKJP 179N 768W,0,0,0,4,4
Tropical Depression,Thirteen,2,1998-10-22T09:00:00Z,MHNJ 165N 859W,0,0,5,9,14
Tropical Depression,Thirteen,2,1998-10-22T09:00:00Z,MKJS 185N 779W,0,1,1,5,7
Tropical Depression,Thirteen,2,1998-10-22T09:00:00Z,MNPC 141N 834W,1,14,3,2,20
Tropical Depression,Thirteen,2,1998-10-22T09:00:00Z,MWCG 193N 814W,0,2,9,6,17
Tropical Depression,Thirteen,2,1998-10-22T09:00:00Z,MNBL 120N 839W,0,3,3,2,8
Tropical Depression,Thirteen,2,1998-10-22T09:00:00Z,MUCM 214N 779W,0,0,0,2,2
Tropical Depression,Thirteen,2,1998-10-22T09:00:00Z,SKSP 126N 817W,19,3,1,0,23
Tropical Depression,Thirteen,2,1998-10-22T09:00:00Z,MUCF 221N 805W,0,0,0,6,6
Tropical Depression,Thirteen,2,1998-10-22T09:00:00Z,MRLM 100N 831W,0,0,1,1,2
Tropical Depression,Thirteen,2,1998-10-22T09:00:00Z,MUSN 216N 826W,0,0,1,10,11
Tropical Depression,Thirteen,2,1998-10-22T09:00:00Z,MMMD 210N 897W,0,0,0,3,3
Tropical Depression,Thirteen,2,1998-10-22T09:00:00Z,MUHA 230N 824W,0,0,0,6,6
Tropical Depression,Thirteen,2,1998-10-22T09:00:00Z,KEY WEST FL,0,0,0,2,2
Tropical Depression,Thirteen,2,1998-10-22T09:00:00Z,MUAN 219N 850W,0,0,0,10,10
Tropical Depression,Thirteen,3,1998-10-22T15:00:00Z,13.2N  79.4W,55,0,0,0,55
Tropical Depression,Thirteen,3,1998-10-22T15:00:00Z,MUAN 219N 850W,0,0,0,5,5
Tropical Depression,Thirteen,3,1998-10-22T15:00:00Z,13.8N  79.8W,42,0,0,0,42
Tropical Depression,Thirteen,3,1998-10-22T15:00:00Z,MMCZ 205N 869W,0,0,0,4,4
Tropical Depression,Thirteen,3,1998-10-22T15:00:00Z,14.7N  80.3W,21,6,1,1,29
Tropical Depression,Thirteen,3,1998-10-22T15:00:00Z,MZBZ 175N 883W,0,0,0,2,2
Tropical Depression,Thirteen,3,1998-10-22T15:00:00Z,MKJP 179N 768W,0,0,2,5,7
Tropical Depression,Thirteen,3,1998-10-22T15:00:00Z,MHNJ 165N 859W,0,0,0,8,8
Tropical Depression,Thirteen,3,1998-10-22T15:00:00Z,MKJS 185N 779W,0,0,3,6,9
Tropical Depression,Thirteen,3,1998-10-22T15:00:00Z,MNPC 141N 834W,0,2,7,7,16
Tropical Depression,Thirteen,3,1998-10-22T15:00:00Z,MWCG 193N 814W,0,0,3,11,14
Tropical Depression,Thirteen,3,1998-10-22T15:00:00Z,MNBL 120N 839W,0,0,3,5,8
Tropical Depression,Thirteen,3,1998-10-22T15:00:00Z,MUCM 214N 779W,0,0,0,2,2
Tropical Depression,Thirteen,3,1998-10-22T15:00:00Z,SKSP 126N 817W,9,7,3,2,21
Tropical Depression,Thirteen,3,1998-10-22T15:00:00Z,MUCF 221N 805W,0,0,0,4,4
Tropical Depression,Thirteen,3,1998-10-22T15:00:00Z,MRLM 100N 831W,0,0,1,4,5
Tropical Depression,Thirteen,3,1998-10-22T15:00:00Z,MUSN 216N 826W,0,0,0,7,7
Tropical Depression,Thirteen,3,1998-10-22T15:00:00Z,MPCO 093N 799W,1,1,2,4,8
Tropical Depression,Thirteen,3,1998-10-22T15:00:00Z,MUHA 230N 824W,0,0,0,3,3
Tropical Storm,Mitch,4,1998-10-22T21:00:00Z,13.1N  78.3W,56,0,0,0,56
Tropical Storm,Mitch,4,1998-10-22T21:00:00Z,MUAN 219N 850W,0,0,0,2,2
Tropical Storm,Mitch,4,1998-10-22T21:00:00Z,14.2N  78.7W,34,1,0,1,36
Tropical Storm,Mitch,4,1998-10-22T21:00:00Z,MHNJ 165N 859W,0,0,0,6,6
Tropical Storm,Mitch,4,1998-10-22T21:00:00Z,15.3N  79.5W,8,16,5,1,30
Tropical Storm,Mitch,4,1998-10-22T21:00:00Z,MNPC 141N 834W,0,0,6,9,15
Tropical Storm,Mitch,4,1998-10-22T21:00:00Z,MTCA 183N 738W,0,0,0,2,2
Tropical Storm,Mitch,4,1998-10-22T21:00:00Z,MNBL 120N 839W,0,0,1,9,10
Tropical Storm,Mitch,4,1998-10-22T21:00:00Z,MKJP 179N 768W,0,2,9,4,15
Tropical Storm,Mitch,4,1998-10-22T21:00:00Z,SKSP 126N 817W,2,6,5,4,17
Tropical Storm,Mitch,4,1998-10-22T21:00:00Z,MKJS 185N 779W,0,1,10,7,18
Tropical Storm,Mitch,4,1998-10-22T21:00:00Z,MRLM 100N 831W,0,0,0,6,6
Tropical Storm,Mitch,4,1998-10-22T21:00:00Z,MWCG 193N 814W,0,0,3,13,16
Tropical Storm,Mitch,4,1998-10-22T21:00:00Z,MPCO 093N 799W,0,0,1,2,3
Tropical Storm,Mitch,4,1998-10-22T21:00:00Z,MUGM 200N 751W,0,0,1,4,5
Tropical Storm,Mitch,4,1998-10-22T21:00:00Z,MYEG 235N 758W,0,0,0,3,3
Tropical Storm,Mitch,4,1998-10-22T21:00:00Z,MUCM 214N 779W,0,0,1,9,10
Tropical Storm,Mitch,4,1998-10-22T21:00:00Z,MYAK 241N 776W,0,0,0,4,4
Tropical Storm,Mitch,4,1998-10-22T21:00:00Z,MUCF 221N 805W,0,0,0,9,9
Tropical Storm,Mitch,4,1998-10-22T21:00:00Z,MYNN 251N 775W,0,0,0,2,2
Tropical Storm,Mitch,4,1998-10-22T21:00:00Z,MUSN 216N 826W,0,0,0,7,7
Tropical Storm,Mitch,4,1998-10-22T21:00:00Z,MARATHON FL,0,0,0,2,2
Tropical Storm,Mitch,4,1998-10-22T21:00:00Z,MUHA 230N 824W,0,0,0,4,4
Tropical Storm,Mitch,4,1998-10-22T21:00:00Z,KEY WEST FL,0,0,0,2,2
Tropical Storm,Mitch,5,1998-10-23T03:00:00Z,14.0N  78.0W,45,0,0,0,45
Tropical Storm,Mitch,5,1998-10-23T03:00:00Z,SKSP 126N 817W,1,5,4,5,15
Tropical Storm,Mitch,5,1998-10-23T03:00:00Z,15.0N  78.5W,26,3,1,0,30
Tropical Storm,Mitch,5,1998-10-23T03:00:00Z,MRLM 100N 831W,0,0,0,7,7
Tropical Storm,Mitch,5,1998-10-23T03:00:00Z,16.0N  79.0W,9,13,2,1,25
Tropical Storm,Mitch,5,1998-10-23T03:00:00Z,MPCO 093N 799W,0,0,1,4,5
Tropical Storm,Mitch,5,1998-10-23T03:00:00Z,MTCA 183N 738W,0,0,0,2,2
Tropical Storm,Mitch,5,1998-10-23T03:00:00Z,MYSM 241N 745W,0,0,0,2,2
Tropical Storm,Mitch,5,1998-10-23T03:00:00Z,MKJP 179N 768W,0,4,5,5,14
Tropical Storm,Mitch,5,1998-10-23T03:00:00Z,MYEG 235N 758W,0,0,0,4,4
Tropical Storm,Mitch,5,1998-10-23T03:00:00Z,MKJS 185N 779W,0,3,8,5,16
Tropical Storm,Mitch,5,1998-10-23T03:00:00Z,MYAK 241N 776W,0,0,0,6,6
Tropical Storm,Mitch,5,1998-10-23T03:00:00Z,MWCG 193N 814W,0,0,5,10,15
Tropical Storm,Mitch,5,1998-10-23T03:00:00Z,MYNN 251N 775W,0,0,0,4,4
Tropical Storm,Mitch,5,1998-10-23T03:00:00Z,MUGM 200N 751W,0,0,1,4,5
Tropical Storm,Mitch,5,1998-10-23T03:00:00Z,MYGF 266N 787W,0,0,0,3,3
Tropical Storm,Mitch,5,1998-10-23T03:00:00Z,MUCM 214N 779W,0,0,1,9,10
Tropical Storm,Mitch,5,1998-10-23T03:00:00Z,MARATHON FL,0,0,0,5,5
Tropical Storm,Mitch,5,1998-10-23T03:00:00Z,MUCF 221N 805W,0,0,1,10,11
Tropical Storm,Mitch,5,1998-10-23T03:00:00Z,MIAMI FL,0,0,0,4,4
Tropical Storm,Mitch,5,1998-10-23T03:00:00Z,MUSN 216N 826W,0,0,0,9,9
Tropical Storm,Mitch,5,1998-10-23T03:00:00Z,W PALM BEACH FL,0,0,0,3,3
Tropical Storm,Mitch,5,1998-10-23T03:00:00Z,MUHA 230N 824W,0,0,0,7,7
Tropical Storm,Mitch,5,1998-10-23T03:00:00Z,FT PIERCE FL,0,0,0,2,2
Tropical Storm,Mitch,5,1998-10-23T03:00:00Z,MUAN 219N 850W,0,0,0,4,4
Tropical Storm,Mitch,5,1998-10-23T03:00:00Z,KEY WEST FL,0,0,0,5,5
Tropical Storm,Mitch,5,1998-10-23T03:00:00Z,MMCZ 205N 869W,0,0,0,2,2
Tropical Storm,Mitch,5,1998-10-23T03:00:00Z,MARCO ISLAND FL,0,0,0,3,3
Tropical Storm,Mitch,5,1998-10-23T03:00:00Z,MHNJ 165N 859W,0,0,0,6,6
Tropical Storm,Mitch,5,1998-10-23T03:00:00Z,FT MYERS FL,0,0,0,2,2
Tropical Storm,Mitch,5,1998-10-23T03:00:00Z,MNPC 141N 834W,0,1,3,9,13
Tropical Storm,Mitch,5,1998-10-23T03:00:00Z,VENICE FL,0,0,0,2,2
Tropical Storm,Mitch,5,1998-10-23T03:00:00Z,MNBL 120N 839W,0,0,1,8,9
Tropical Storm,Mitch,6,1998-10-23T09:00:00Z,15.0N  78.0W,44,0,0,0,44
Tropical Storm,Mitch,6,1998-10-23T09:00:00Z,SKSP 126N 817W,0,2,6,6,14
Tropical Storm,Mitch,6,1998-10-23T09:00:00Z,15.9N  78.5W,29,1,1,0,31
Tropical Storm,Mitch,6,1998-10-23T09:00:00Z,MRLM 100N 831W,0,0,0,6,6
Tropical Storm,Mitch,6,1998-10-23T09:00:00Z,16.9N  79.3W,9,12,3,1,25
Tropical Storm,Mitch,6,1998-10-23T09:00:00Z,MPCO 093N 799W,0,0,1,2,3
Tropical Storm,Mitch,6,1998-10-23T09:00:00Z,MKJP 179N 768W,1,7,3,3,14
Tropical Storm,Mitch,6,1998-10-23T09:00:00Z,MYEG 235N 758W,0,0,0,3,3
Tropical Storm,Mitch,6,1998-10-23T09:00:00Z,MKJS 185N 779W,0,8,6,3,17
Tropical Storm,Mitch,6,1998-10-23T09:00:00Z,MYAK 241N 776W,0,0,0,6,6
Tropical Storm,Mitch,6,1998-10-23T09:00:00Z,MWCG 193N 814W,0,1,10,7,18
Tropical Storm,Mitch,6,1998-10-23T09:00:00Z,MYNN 251N 775W,0,0,0,4,4
Tropical Storm,Mitch,6,1998-10-23T09:00:00Z,MUGM 200N 751W,0,0,1,2,3
Tropical Storm,Mitch,6,1998-10-23T09:00:00Z,MYGF 266N 787W,0,0,0,4,4
Tropical Storm,Mitch,6,1998-10-23T09:00:00Z,MUCM 214N 779W,0,0,3,8,11
Tropical Storm,Mitch,6,1998-10-23T09:00:00Z,MARATHON FL,0,0,0,7,7
Tropical Storm,Mitch,6,1998-10-23T09:00:00Z,MUCF 221N 805W,0,0,2,11,13
Tropical Storm,Mitch,6,1998-10-23T09:00:00Z,MIAMI FL,0,0,0,5,5
Tropical Storm,Mitch,6,1998-10-23T09:00:00Z,MUSN 216N 826W,0,0,1,11,12
Tropical Storm,Mitch,6,1998-10-23T09:00:00Z,W PALM BEACH FL,0,0,0,4,4
Tropical Storm,Mitch,6,1998-10-23T09:00:00Z,MUHA 230N 824W,0,0,0,10,10
Tropical Storm,Mitch,6,1998-10-23T09:00:00Z,FT PIERCE FL,0,0,0,3,3
Tropical Storm,Mitch,6,1998-10-23T09:00:00Z,MUAN 219N 850W,0,0,0,6,6
Tropical Storm,Mitch,6,1998-10-23T09:00:00Z,COCOA BEACH FL,0,0,0,2,2
Tropical Storm,Mitch,6,1998-10-23T09:00:00Z,MMCZ 205N 869W,0,0,0,3,3
Tropical Storm,Mitch,6,1998-10-23T09:00:00Z,KEY WEST FL,0,0,0,7,7
Tropical Storm,Mitch,6,1998-10-23T09:00:00Z,MZBZ 175N 883W,0,0,0,2,2
Tropical Storm,Mitch,6,1998-10-23T09:00:00Z,MARCO ISLAND FL,0,0,0,5,5
Tropical Storm,Mitch,6,1998-10-23T09:00:00Z,MGPB 157N 886W,0,0,0,2,2
Tropical Storm,Mitch,6,1998-10-23T09:00:00Z,FT MYERS FL,0,0,0,3,3
Tropical Storm,Mitch,6,1998-10-23T09:00:00Z,MHNJ 165N 859W,0,0,0,8,8
Tropical Storm,Mitch,6,1998-10-23T09:00:00Z,VENICE FL,0,0,0,2,2
Tropical Storm,Mitch,6,1998-10-23T09:00:00Z,MNPC 141N 834W,0,0,4,10,14
Tropical Storm,Mitch,6,1998-10-23T09:00:00Z,TAMPA FL,0,0,0,2,2
Tropical Storm,Mitch,6,1998-10-23T09:00:00Z,MNBL 120N 839W,0,0,1,8,9
Tropical Storm,Mitch,7,1998-10-23T15:00:00Z,14.0N  78.2W,50,0,0,0,50
Tropical Storm,Mitch,7,1998-10-23T15:00:00Z,MUAN 219N 850W,0,0,0,2,2
Tropical Storm,Mitch,7,1998-10-23T15:00:00Z,14.8N  78.6W,36,1,0,0,37
Tropical Storm,Mitch,7,1998-10-23T15:00:00Z,MHNJ 165N 859W,0,0,0,7,7
Tropical Storm,Mitch,7,1998-10-23T15:00:00Z,16.0N  79.0W,15,9,3,1,28
Tropical Storm,Mitch,7,1998-10-23T15:00:00Z,MNPC 141N 834W,0,0,2,11,13
Tropical Storm,Mitch,7,1998-10-23T15:00:00Z,MTCA 183N 738W,0,0,1,1,2
Tropical Storm,Mitch,7,1998-10-23T15:00:00Z,MNBL 120N 839W,0,0,0,7,7
Tropical Storm,Mitch,7,1998-10-23T15:00:00Z,MKJP 179N 768W,0,5,9,3,17
Tropical Storm,Mitch,7,1998-10-23T15:00:00Z,SKSP 126N 817W,0,2,4,7,13
Tropical Storm,Mitch,7,1998-10-23T15:00:00Z,MKJS 185N 779W,0,4,10,5,19
Tropical Storm,Mitch,7,1998-10-23T15:00:00Z,MRLM 100N 831W,0,0,0,3,3
Tropical Storm,Mitch,7,1998-10-23T15:00:00Z,MWCG 193N 814W,0,0,4,12,16
Tropical Storm,Mitch,7,1998-10-23T15:00:00Z,MYEG 235N 758W,0,0,0,3,3
Tropical Storm,Mitch,7,1998-10-23T15:00:00Z,MUGM 200N 751W,0,0,1,5,6
Tropical Storm,Mitch,7,1998-10-23T15:00:00Z,MYAK 241N 776W,0,0,0,4,4
Tropical Storm,Mitch,7,1998-10-23T15:00:00Z,MUCM 214N 779W,0,0,1,10,11
Tropical Storm,Mitch,7,1998-10-23T15:00:00Z,MYNN 251N 775W,0,0,0,2,2
Tropical Storm,Mitch,7,1998-10-23T15:00:00Z,MUCF 221N 805W,0,0,0,9,9
Tropical Storm,Mitch,7,1998-10-23T15:00:00Z,MARATHON FL,0,0,0,2,2
Tropical Storm,Mitch,7,1998-10-23T15:00:00Z,MUSN 216N 826W,0,0,0,8,8
Tropical Storm,Mitch,7,1998-10-23T15:00:00Z,KEY WEST FL,0,0,0,2,2
Tropical Storm,Mitch,7,1998-10-23T15:00:00Z,MUHA 230N 824W,0,0,0,5,5
Tropical Storm,Mitch,8,1998-10-23T21:00:00Z,14.0N  78.5W,58,0,0,0,58
Tropical Storm,Mitch,8,1998-10-23T21:00:00Z,MUAN 219N 850W,0,0,0,6,6
Tropical Storm,Mitch,8,1998-10-23T21:00:00Z,14.7N  78.7W,44,0,0,0,44
Tropical Storm,Mitch,8,1998-10-23T21:00:00Z,MMCZ 205N 869W,0,0,0,3,3
Tropical Storm,Mitch,8,1998-10-23T21:00:00Z,15.5N  79.5W,20,3,2,2,27
Tropical Storm,Mitch,8,1998-10-23T21:00:00Z,MHNJ 165N 859W,0,0,0,7,7
Tropical Storm,Mitch,8,1998-10-23T21:00:00Z,MKJP 179N 768W,0,3,5,4,12
Tropical Storm,Mitch,8,1998-10-23T21:00:00Z,MNPC 141N 834W,0,0,3,9,12
Tropical Storm,Mitch,8,1998-10-23T21:00:00Z,MKJS 185N 779W,0,2,7,5,14
Tropical Storm,Mitch,8,1998-10-23T21:00:00Z,MNBL 120N 839W,0,0,0,6,6
Tropical Storm,Mitch,8,1998-10-23T21:00:00Z,MWCG 193N 814W,0,0,5,11,16
Tropical Storm,Mitch,8,1998-10-23T21:00:00Z,SKSP 126N 817W,1,3,4,6,14
Tropical Storm,Mitch,8,1998-10-23T21:00:00Z,MUGM 200N 751W,0,0,0,2,2
Tropical Storm,Mitch,8,1998-10-23T21:00:00Z,MRLM 100N 831W,0,0,0,4,4
Tropical Storm,Mitch,8,1998-10-23T21:00:00Z,MUCM 214N 779W,0,0,0,6,6
Tropical Storm,Mitch,8,1998-10-23T21:00:00Z,MPCO 093N 799W,0,0,1,3,4
Tropical Storm,Mitch,8,1998-10-23T21:00:00Z,MUCF 221N 805W,0,0,0,8,8
Tropical Storm,Mitch,8,1998-10-23T21:00:00Z,MARATHON FL,0,0,0,3,3
Tropical Storm,Mitch,8,1998-10-23T21:00:00Z,MUSN 216N 826W,0,0,0,10,10
Tropical Storm,Mitch,8,1998-10-23T21:00:00Z,KEY WEST FL,0,0,0,3,3
Tropical Storm,Mitch,8,1998-10-23T21:00:00Z,MUHA 230N 824W,0,0,0,6,6
Tropical Storm,Mitch,9,1998-10-24T03:00:00Z,15.0N  78.5W,55,0,0,0,55
Tropical Storm,Mitch,9,1998-10-24T03:00:00Z,MHNJ 165N 859W,0,0,0,9,9
Tropical Storm,Mitch,9,1998-10-24T03:00:00Z,15.4N  79.4W,36,1,0,0,37
Tropical Storm,Mitch,9,1998-10-24T03:00:00Z,MNPC 141N 834W,0,3,7,7,17
Tropical Storm,Mitch,9,1998-10-24T03:00:00Z,15.8N  80.1W,22,11,1,0,34
Tropical Storm,Mitch,9,1998-10-24T03:00:00Z,MNBL 120N 839W,0,0,3,9,12
Tropical Storm,Mitch,9,1998-10-24T03:00:00Z,MKJP 179N 768W,0,4,3,3,10
Tropical Storm,Mitch,9,1998-10-24T03:00:00Z,SKSP 126N 817W,0,8,6,4,18
Tropical Storm,Mitch,9,1998-10-24T03:00:00Z,MKJS 185N 779W,0,5,5,4,14
Tropical Storm,Mitch,9,1998-10-24T03:00:00Z,MRLM 100N 831W,0,0,1,7,8
Tropical Storm,Mitch,9,1998-10-24T03:00:00Z,MWCG 193N 814W,0,1,9,7,17
Tropical Storm,Mitch,9,1998-10-24T03:00:00Z,MPCO 093N 799W,0,0,1,4,5
Tropical Storm,Mitch,9,1998-10-24T03:00:00Z,MUGM 200N 751W,0,0,0,2,2
Tropical Storm,Mitch,9,1998-10-24T03:00:00Z,MYAK 241N 776W,0,0,0,3,3
Tropical Storm,Mitch,9,1998-10-24T03:00:00Z,MUCM 214N 779W,0,0,1,6,7
Tropical Storm,Mitch,9,1998-10-24T03:00:00Z,MYNN 251N 775W,0,0,0,2,2
Tropical Storm,Mitch,9,1998-10-24T03:00:00Z,MUCF 221N 805W,0,0,1,9,10
Tropical Storm,Mitch,9,1998-10-24T03:00:00Z,MARATHON FL,0,0,0,5,5
Tropical Storm,Mitch,9,1998-10-24T03:00:00Z,MUSN 216N 826W,0,0,1,10,11
Tropical Storm,Mitch,9,1998-10-24T03:00:00Z,MIAMI FL,0,0,0,3,3
Tropical Storm,Mitch,9,1998-10-24T03:00:00Z,MUHA 230N 824W,0,0,0,8,8
Tropical Storm,Mitch,9,1998-10-24T03:00:00Z,W PALM BEACH FL,0,0,0,2,2
Tropical Storm,Mitch,9,1998-10-24T03:00:00Z,MUAN 219N 850W,0,0,0,6,6
Tropical Storm,Mitch,9,1998-10-24T03:00:00Z,KEY WEST FL,0,0,0,5,5
Tropical Storm,Mitch,9,1998-10-24T03:00:00Z,MMCZ 205N 869W,0,0,0,4,4
Tropical Storm,Mitch,9,1998-10-24T03:00:00Z,MARCO ISLAND FL,0,0,0,3,3
Tropical Storm,Mitch,9,1998-10-24T03:00:00Z,MZBZ 175N 883W,0,0,0,3,3
Tropical Storm,Mitch,9,1998-10-24T03:00:00Z,FT MYERS FL,0,0,0,2,2
Tropical Storm,Mitch,9,1998-10-24T03:00:00Z,MGPB 157N 886W,0,0,0,2,2
Hurricane,Mitch,10,1998-10-24T09:00:00Z,16.1N  77.5W,42,0,0,0,42
Hurricane,Mitch,10,1998-10-24T09:00:00Z,MHNJ 165N 859W,0,0,0,8,8
Hurricane,Mitch,10,1998-10-24T09:00:00Z,16.7N  78.1W,32,0,1,0,33
Hurricane,Mitch,10,1998-10-24T09:00:00Z,MNPC 141N 834W,0,0,4,10,14
Hurricane,Mitch,10,1998-10-24T09:00:00Z,17.0N  79.1W,18,6,2,1,27
Hurricane,Mitch,10,1998-10-24T09:00:00Z,MNBL 120N 839W,0,0,1,9,10
Hurricane,Mitch,10,1998-10-24T09:00:00Z,MTCA 183N 738W,0,1,1,1,3
Hurricane,Mitch,10,1998-10-24T09:00:00Z,SKSP 126N 817W,0,1,5,7,13
Hurricane,Mitch,10,1998-10-24T09:00:00Z,MKJP 179N 768W,12,7,1,1,21
Hurricane,Mitch,10,1998-10-24T09:00:00Z,MRLM 100N 831W,0,0,0,5,5
Hurricane,Mitch,10,1998-10-24T09:00:00Z,MKJS 185N 779W,6,10,3,2,21
Hurricane,Mitch,10,1998-10-24T09:00:00Z,MPCO 093N 799W,0,0,0,2,2
Hurricane,Mitch,10,1998-10-24T09:00:00Z,MWCG 193N 814W,0,1,6,9,16
Hurricane,Mitch,10,1998-10-24T09:00:00Z,MYSM 241N 745W,0,0,0,3,3
Hurricane,Mitch,10,1998-10-24T09:00:00Z,MUGM 200N 751W,0,1,3,4,8
Hurricane,Mitch,10,1998-10-24T09:00:00Z,MYEG 235N 758W,0,0,0,5,5
Hurricane,Mitch,10,1998-10-24T09:00:00Z,MUCM 214N 779W,0,0,5,8,13
Hurricane,Mitch,10,1998-10-24T09:00:00Z,MYAK 241N 776W,0,0,0,7,7
Hurricane,Mitch,10,1998-10-24T09:00:00Z,MUCF 221N 805W,0,0,1,10,11
Hurricane,Mitch,10,1998-10-24T09:00:00Z,MYNN 251N 775W,0,0,0,5,5
Hurricane,Mitch,10,1998-10-24T09:00:00Z,MUSN 216N 826W,0,0,0,9,9
Hurricane,Mitch,10,1998-10-24T09:00:00Z,MYGF 266N 787W,0,0,0,3,3
Hurricane,Mitch,10,1998-10-24T09:00:00Z,MUHA 230N 824W,0,0,0,6,6
Hurricane,Mitch,10,1998-10-24T09:00:00Z,MARATHON FL,0,0,0,4,4
Hurricane,Mitch,10,1998-10-24T09:00:00Z,MUAN 219N 850W,0,0,0,3,3
Hurricane,Mitch,10,1998-10-24T09:00:00Z,MIAMI FL,0,0,0,3,3
Hurricane,Mitch,10,1998-10-24T09:00:00Z,MMCZ 205N 869W,0,0,0,2,2
Hurricane,Mitch,10,1998-10-24T09:00:00Z,W PALM BEACH FL,0,0,0,2,2
Hurricane,Mitch,10,1998-10-24T09:00:00Z,MZBZ 175N 883W,0,0,0,2,2
Hurricane,Mitch,10,1998-10-24T09:00:00Z,KEY WEST FL,0,0,0,4,4
Hurricane,Mitch,10,1998-10-24T09:00:00Z,MGPB 157N 886W,0,0,0,2,2
Hurricane,Mitch,10,1998-10-24T09:00:00Z,MARCO ISLAND FL,0,0,0,2,2
Hurricane,Mitch,11,1998-10-24T15:00:00Z,16.8N  78.6W,51,0,0,0,51
Hurricane,Mitch,11,1998-10-24T15:00:00Z,MNBL 120N 839W,0,0,0,7,7
Hurricane,Mitch,11,1998-10-24T15:00:00Z,17.6N  79.5W,28,7,0,0,35
Hurricane,Mitch,11,1998-10-24T15:00:00Z,SKSP 126N 817W,0,0,3,6,9
Hurricane,Mitch,11,1998-10-24T15:00:00Z,18.2N  80.5W,7,19,2,0,28
Hurricane,Mitch,11,1998-10-24T15:00:00Z,MRLM 100N 831W,0,0,0,3,3
Hurricane,Mitch,11,1998-10-24T15:00:00Z,MKJP 179N 768W,14,2,0,1,17
Hurricane,Mitch,11,1998-10-24T15:00:00Z,MYAK 241N 776W,0,0,0,4,4
Hurricane,Mitch,11,1998-10-24T15:00:00Z,MKJS 185N 779W,19,3,1,0,23
Hurricane,Mitch,11,1998-10-24T15:00:00Z,MYNN 251N 775W,0,0,0,3,3
Hurricane,Mitch,11,1998-10-24T15:00:00Z,MWCG 193N 814W,0,11,9,3,23
Hurricane,Mitch,11,1998-10-24T15:00:00Z,MYGF 266N 787W,0,0,0,3,3
Hurricane,Mitch,11,1998-10-24T15:00:00Z,MUCM 214N 779W,0,2,4,4,10
Hurricane,Mitch,11,1998-10-24T15:00:00Z,MARATHON FL,0,0,1,7,8
Hurricane,Mitch,11,1998-10-24T15:00:00Z,MUCF 221N 805W,0,1,7,7,15
Hurricane,Mitch,11,1998-10-24T15:00:00Z,MIAMI FL,0,0,0,5,5
Hurricane,Mitch,11,1998-10-24T15:00:00Z,MUSN 216N 826W,0,0,6,9,15
Hurricane,Mitch,11,1998-10-24T15:00:00Z,W PALM BEACH FL,0,0,0,4,4
Hurricane,Mitch,11,1998-10-24T15:00:00Z,MUHA 230N 824W,0,0,2,10,12
Hurricane,Mitch,11,1998-10-24T15:00:00Z,FT PIERCE FL,0,0,0,3,3
Hurricane,Mitch,11,1998-10-24T15:00:00Z,MUAN 219N 850W,0,0,0,10,10
Hurricane,Mitch,11,1998-10-24T15:00:00Z,COCOA BEACH FL,0,0,0,2,2
Hurricane,Mitch,11,1998-10-24T15:00:00Z,MMCZ 205N 869W,0,0,0,7,7
Hurricane,Mitch,11,1998-10-24T15:00:00Z,KEY WEST FL,0,0,1,8,9
Hurricane,Mitch,11,1998-10-24T15:00:00Z,MZBZ 175N 883W,0,0,0,5,5
Hurricane,Mitch,11,1998-10-24T15:00:00Z,MARCO ISLAND FL,0,0,0,5,5
Hurricane,Mitch,11,1998-10-24T15:00:00Z,MGPB 157N 886W,0,0,0,4,4
Hurricane,Mitch,11,1998-10-24T15:00:00Z,FT MYERS FL,0,0,0,4,4
Hurricane,Mitch,11,1998-10-24T15:00:00Z,MHNJ 165N 859W,0,0,1,10,11
Hurricane,Mitch,11,1998-10-24T15:00:00Z,VENICE FL,0,0,0,3,3
Hurricane,Mitch,11,1998-10-24T15:00:00Z,MNPC 141N 834W,0,0,5,8,13
Hurricane,Mitch,11,1998-10-24T15:00:00Z,TAMPA FL,0,0,0,2,2
Hurricane,Mitch,12,1998-10-24T21:00:00Z,16.8N  78.6W,65,0,0,0,65
Hurricane,Mitch,12,1998-10-24T21:00:00Z,MNBL 120N 839W,0,0,1,6,7
Hurricane,Mitch,12,1998-10-24T21:00:00Z,17.5N  79.5W,30,5,0,1,36
Hurricane,Mitch,12,1998-10-24T21:00:00Z,SKSP 126N 817W,0,0,3,6,9
Hurricane,Mitch,12,1998-10-24T21:00:00Z,18.0N  80.5W,12,17,1,1,31
Hurricane,Mitch,12,1998-10-24T21:00:00Z,MRLM 100N 831W,0,0,0,3,3
Hurricane,Mitch,12,1998-10-24T21:00:00Z,MKJP 179N 768W,13,2,1,0,16
Hurricane,Mitch,12,1998-10-24T21:00:00Z,MYAK 241N 776W,0,0,1,3,4
Hurricane,Mitch,12,1998-10-24T21:00:00Z,MKJS 185N 779W,13,8,1,0,22
Hurricane,Mitch,12,1998-10-24T21:00:00Z,MYNN 251N 775W,0,0,0,3,3
Hurricane,Mitch,12,1998-10-24T21:00:00Z,MWCG 193N 814W,0,14,7,3,24
Hurricane,Mitch,12,1998-10-24T21:00:00Z,MYGF 266N 787W,0,0,0,3,3
Hurricane,Mitch,12,1998-10-24T21:00:00Z,MUCM 214N 779W,0,2,5,4,11
Hurricane,Mitch,12,1998-10-24T21:00:00Z,MARATHON FL,0,0,1,8,9
Hurricane,Mitch,12,1998-10-24T21:00:00Z,MUCF 221N 805W,0,1,8,7,16
Hurricane,Mitch,12,1998-10-24T21:00:00Z,MIAMI FL,0,0,0,6,6
Hurricane,Mitch,12,1998-10-24T21:00:00Z,MUSN 216N 826W,0,0,7,10,17
Hurricane,Mitch,12,1998-10-24T21:00:00Z,W PALM BEACH FL,0,0,0,4,4
Hurricane,Mitch,12,1998-10-24T21:00:00Z,MUHA 230N 824W,0,0,3,10,13
Hurricane,Mitch,12,1998-10-24T21:00:00Z,FT PIERCE FL,0,0,0,3,3
Hurricane,Mitch,12,1998-10-24T21:00:00Z,MUAN 219N 850W,0,0,0,11,11
Hurricane,Mitch,12,1998-10-24T21:00:00Z,COCOA BEACH FL,0,0,0,2,2
Hurricane,Mitch,12,1998-10-24T21:00:00Z,MMCZ 205N 869W,0,0,0,8,8
Hurricane,Mitch,12,1998-10-24T21:00:00Z,KEY WEST FL,0,0,1,9,10
Hurricane,Mitch,12,1998-10-24T21:00:00Z,MZBZ 175N 883W,0,0,0,5,5
Hurricane,Mitch,12,1998-10-24T21:00:00Z,MARCO ISLAND FL,0,0,0,6,6
Hurricane,Mitch,12,1998-10-24T21:00:00Z,MGPB 157N 886W,0,0,0,4,4
Hurricane,Mitch,12,1998-10-24T21:00:00Z,FT MYERS FL,0,0,0,5,5
Hurricane,Mitch,12,1998-10-24T21:00:00Z,MHNJ 165N 859W,0,0,1,11,12
Hurricane,Mitch,12,1998-10-24T21:00:00Z,VENICE FL,0,0,0,3,3
Hurricane,Mitch,12,1998-10-24T21:00:00Z,MNPC 141N 834W,0,0,5,9,14
Hurricane,Mitch,12,1998-10-24T21:00:00Z,TAMPA FL,0,0,0,2,2
Hurricane,Mitch,13,1998-10-25T03:00:00Z,16.9N  79.1W,66,0,0,0,66
Hurricane,Mitch,13,1998-10-25T03:00:00Z,MNPC 141N 834W,0,0,4,8,12
Hurricane,Mitch,13,1998-10-25T03:00:00Z,17.7N  79.9W,35,2,1,0,38
Hurricane,Mitch,13,1998-10-25T03:00:00Z,MNBL 120N 839W,0,0,0,6,6
Hurricane,Mitch,13,1998-10-25T03:00:00Z,18.1N  80.9W,16,14,1,0,31
Hurricane,Mitch,13,1998-10-25T03:00:00Z,SKSP 126N 817W,0,0,1,4,5
Hurricane,Mitch,13,1998-10-25T03:00:00Z,MKJP 179N 768W,14,1,1,0,16
Hurricane,Mitch,13,1998-10-25T03:00:00Z,MYAK 241N 776W,0,0,0,3,3
Hurricane,Mitch,13,1998-10-25T03:00:00Z,MKJS 185N 779W,21,3,0,1,25
Hurricane,Mitch,13,1998-10-25T03:00:00Z,MYNN 251N 775W,0,0,0,2,2
Hurricane,Mitch,13,1998-10-25T03:00:00Z,MWCG 193N 814W,2,16,6,2,26
Hurricane,Mitch,13,1998-10-25T03:00:00Z,MYGF 266N 787W,0,0,0,2,2
Hurricane,Mitch,13,1998-10-25T03:00:00Z,MUCM 214N 779W,0,2,5,4,11
Hurricane,Mitch,13,1998-10-25T03:00:00Z,MARATHON FL,0,0,0,8,8
Hurricane,Mitch,13,1998-10-25T03:00:00Z,MUCF 221N 805W,0,1,8,7,16
Hurricane,Mitch,13,1998-10-25T03:00:00Z,MIAMI FL,0,0,0,5,5
Hurricane,Mitch,13,1998-10-25T03:00:00Z,MUSN 216N 826W,0,0,7,10,17
Hurricane,Mitch,13,1998-10-25T03:00:00Z,W PALM BEACH FL,0,0,0,3,3
Hurricane,Mitch,13,1998-10-25T03:00:00Z,MUHA 230N 824W,0,0,2,11,13
Hurricane,Mitch,13,1998-10-25T03:00:00Z,FT PIERCE FL,0,0,0,2,2
Hurricane,Mitch,13,1998-10-25T03:00:00Z,MUAN 219N 850W,0,0,0,12,12
Hurricane,Mitch,13,1998-10-25T03:00:00Z,KEY WEST FL,0,0,0,9,9
Hurricane,Mitch,13,1998-10-25T03:00:00Z,MMCZ 205N 869W,0,0,0,8,8
Hurricane,Mitch,13,1998-10-25T03:00:00Z,MARCO ISLAND FL,0,0,0,5,5
Hurricane,Mitch,13,1998-10-25T03:00:00Z,MZBZ 175N 883W,0,0,0,6,6
Hurricane,Mitch,13,1998-10-25T03:00:00Z,FT MYERS FL,0,0,0,3,3
Hurricane,Mitch,13,1998-10-25T03:00:00Z,MGPB 157N 886W,0,0,0,5,5
Hurricane,Mitch,13,1998-10-25T03:00:00Z,VENICE FL,0,0,0,2,2
Hurricane,Mitch,13,1998-10-25T03:00:00Z,MHNJ 165N 859W,0,0,1,12,13
Hurricane,Mitch,14,1998-10-25T09:00:00Z,16.7N  81.0W,61,0,0,0,61
Hurricane,Mitch,14,1998-10-25T09:00:00Z,MUAN 219N 850W,0,0,1,9,10
Hurricane,Mitch,14,1998-10-25T09:00:00Z,17.0N  81.7W,40,0,1,0,41
Hurricane,Mitch,14,1998-10-25T09:00:00Z,MMCZ 205N 869W,0,0,0,11,11
Hurricane,Mitch,14,1998-10-25T09:00:00Z,17.3N  82.5W,19,8,1,1,29
Hurricane,Mitch,14,1998-10-25T09:00:00Z,MZBZ 175N 883W,0,0,0,8,8
Hurricane,Mitch,14,1998-10-25T09:00:00Z,MKJP 179N 768W,0,0,0,2,2
Hurricane,Mitch,14,1998-10-25T09:00:00Z,MGPB 157N 886W,0,0,0,4,4
Hurricane,Mitch,14,1998-10-25T09:00:00Z,MKJS 185N 779W,2,2,1,2,7
Hurricane,Mitch,14,1998-10-25T09:00:00Z,MHNJ 165N 859W,0,0,6,9,15
Hurricane,Mitch,14,1998-10-25T09:00:00Z,MWCG 193N 814W,10,7,3,2,22
Hurricane,Mitch,14,1998-10-25T09:00:00Z,MNPC 141N 834W,1,5,5,4,15
Hurricane,Mitch,14,1998-10-25T09:00:00Z,MUCM 214N 779W,0,0,0,2,2
Hurricane,Mitch,14,1998-10-25T09:00:00Z,MNBL 120N 839W,0,0,1,4,5
Hurricane,Mitch,14,1998-10-25T09:00:00Z,MUCF 221N 805W,0,0,2,4,6
Hurricane,Mitch,14,1998-10-25T09:00:00Z,SKSP 126N 817W,0,1,2,5,8
Hurricane,Mitch,14,1998-10-25T09:00:00Z,MUSN 216N 826W,0,0,4,7,11
Hurricane,Mitch,14,1998-10-25T09:00:00Z,MMMD 210N 897W,0,0,0,4,4
Hurricane,Mitch,14,1998-10-25T09:00:00Z,MUHA 230N 824W,0,0,1,5,6
Hurricane,Mitch,15,1998-10-25T12:00:00Z,16.7N  81.0W,61,0,0,0,61
Hurricane,Mitch,15,1998-10-25T12:00:00Z,MUAN 219N 850W,0,0,1,9,10
Hurricane,Mitch,15,1998-10-25T12:00:00Z,17.0N  81.7W,40,0,1,0,41
Hurricane,Mitch,15,1998-10-25T12:00:00Z,MMCZ 205N 869W,0,0,0,11,11
Hurricane,Mitch,15,1998-10-25T12:00:00Z,17.3N  82.5W,19,8,1,1,29
Hurricane,Mitch,15,1998-10-25T12:00:00Z,MZBZ 175N 883W,0,0,0,8,8
Hurricane,Mitch,15,1998-10-25T12:00:00Z,MKJP 179N 768W,0,0,0,2,2
Hurricane,Mitch,15,1998-10-25T12:00:00Z,MGPB 157N 886W,0,0,0,4,4
Hurricane,Mitch,15,1998-10-25T12:00:00Z,MKJS 185N 779W,2,2,1,2,7
Hurricane,Mitch,15,1998-10-25T12:00:00Z,MHNJ 165N 859W,0,0,6,9,15
Hurricane,Mitch,15,1998-10-25T12:00:00Z,MWCG 193N 814W,10,7,3,2,22
Hurricane,Mitch,15,1998-10-25T12:00:00Z,MNPC 141N 834W,1,5,5,4,15
Hurricane,Mitch,15,1998-10-25T12:00:00Z,MUCM 214N 779W,0,0,0,2,2
Hurricane,Mitch,15,1998-10-25T12:00:00Z,MNBL 120N 839W,0,0,1,4,5
Hurricane,Mitch,15,1998-10-25T12:00:00Z,MUCF 221N 805W,0,0,2,4,6
Hurricane,Mitch,15,1998-10-25T12:00:00Z,SKSP 126N 817W,0,1,2,5,8
Hurricane,Mitch,15,1998-10-25T12:00:00Z,MUSN 216N 826W,0,0,4,7,11
Hurricane,Mitch,15,1998-10-25T12:00:00Z,MMMD 210N 897W,0,0,0,4,4
Hurricane,Mitch,15,1998-10-25T12:00:00Z,MUHA 230N 824W,0,0,1,5,6
Hurricane,Mitch,16,1998-10-25T15:00:00Z,17.0N  81.8W,57,0,0,0,57
Hurricane,Mitch,16,1998-10-25T15:00:00Z,MMCZ 205N 869W,0,0,2,11,13
Hurricane,Mitch,16,1998-10-25T15:00:00Z,17.2N  82.6W,41,0,1,0,42
Hurricane,Mitch,16,1998-10-25T15:00:00Z,MZBZ 175N 883W,0,0,1,8,9
Hurricane,Mitch,16,1998-10-25T15:00:00Z,17.4N  83.1W,31,1,1,0,33
Hurricane,Mitch,16,1998-10-25T15:00:00Z,MGPB 157N 886W,0,0,0,5,5
Hurricane,Mitch,16,1998-10-25T15:00:00Z,MKJS 185N 779W,0,0,1,3,4
Hurricane,Mitch,16,1998-10-25T15:00:00Z,MHNJ 165N 859W,0,4,6,7,17
Hurricane,Mitch,16,1998-10-25T15:00:00Z,MWCG 193N 814W,20,2,1,1,24
Hurricane,Mitch,16,1998-10-25T15:00:00Z,MNPC 141N 834W,2,5,4,5,16
Hurricane,Mitch,16,1998-10-25T15:00:00Z,MUCF 221N 805W,0,0,1,4,5
Hurricane,Mitch,16,1998-10-25T15:00:00Z,MNBL 120N 839W,0,0,1,4,5
Hurricane,Mitch,16,1998-10-25T15:00:00Z,MUSN 216N 826W,0,2,3,7,12
Hurricane,Mitch,16,1998-10-25T15:00:00Z,SKSP 126N 817W,0,0,2,6,8
Hurricane,Mitch,16,1998-10-25T15:00:00Z,MUHA 230N 824W,0,0,1,5,6
Hurricane,Mitch,16,1998-10-25T15:00:00Z,MMMD 210N 897W,0,0,0,5,5
Hurricane,Mitch,16,1998-10-25T15:00:00Z,MUAN 219N 850W,0,0,2,10,12
Hurricane,Mitch,17,1998-10-25T21:00:00Z,17.2N  82.6W,61,0,0,0,61
Hurricane,Mitch,17,1998-10-25T21:00:00Z,MUAN 219N 850W,0,0,2,7,9
Hurricane,Mitch,17,1998-10-25T21:00:00Z,17.3N  83.0W,44,0,0,0,44
Hurricane,Mitch,17,1998-10-25T21:00:00Z,MMCZ 205N 869W,0,0,2,10,12
Hurricane,Mitch,17,1998-10-25T21:00:00Z,17.4N  83.5W,32,1,0,1,34
Hurricane,Mitch,17,1998-10-25T21:00:00Z,MZBZ 175N 883W,0,0,2,9,11
Hurricane,Mitch,17,1998-10-25T21:00:00Z,MKJP 179N 768W,0,0,0,2,2
Hurricane,Mitch,17,1998-10-25T21:00:00Z,MGPB 157N 886W,0,0,1,7,8
Hurricane,Mitch,17,1998-10-25T21:00:00Z,MKJS 185N 779W,0,0,1,3,4
Hurricane,Mitch,17,1998-10-25T21:00:00Z,MHNJ 165N 859W,0,7,6,5,18
Hurricane,Mitch,17,1998-10-25T21:00:00Z,MWCG 193N 814W,18,2,1,2,23
Hurricane,Mitch,17,1998-10-25T21:00:00Z,MNPC 141N 834W,1,3,3,5,12
Hurricane,Mitch,17,1998-10-25T21:00:00Z,MUCF 221N 805W,0,0,1,4,5
Hurricane,Mitch,17,1998-10-25T21:00:00Z,MNBL 120N 839W,0,0,0,3,3
Hurricane,Mitch,17,1998-10-25T21:00:00Z,MUSN 216N 826W,0,1,3,6,10
Hurricane,Mitch,17,1998-10-25T21:00:00Z,SKSP 126N 817W,0,0,0,4,4
Hurricane,Mitch,17,1998-10-25T21:00:00Z,MUHA 230N 824W,0,0,0,4,4
Hurricane,Mitch,17,1998-10-25T21:00:00Z,MMMD 210N 897W,0,0,0,5,5
Hurricane,Mitch,18,1998-10-26T03:00:00Z,16.5N  83.2W,56,0,0,0,56
Hurricane,Mitch,18,1998-10-26T03:00:00Z,MMCZ 205N 869W,0,0,1,9,10
Hurricane,Mitch,18,1998-10-26T03:00:00Z,16.6N  83.8W,28,2,0,1,31
Hurricane,Mitch,18,1998-10-26T03:00:00Z,MZBZ 175N 883W,0,0,5,7,12
Hurricane,Mitch,18,1998-10-26T03:00:00Z,17.0N  84.5W,14,7,2,1,24
Hurricane,Mitch,18,1998-10-26T03:00:00Z,MGPB 157N 886W,0,0,5,6,11
Hurricane,Mitch,18,1998-10-26T03:00:00Z,MKJP 179N 768W,0,0,1,4,5
Hurricane,Mitch,18,1998-10-26T03:00:00Z,MHNJ 165N 859W,1,11,4,3,19
Hurricane,Mitch,18,1998-10-26T03:00:00Z,MKJS 185N 779W,0,0,3,5,8
Hurricane,Mitch,18,1998-10-26T03:00:00Z,MNPC 141N 834W,7,2,1,2,12
Hurricane,Mitch,18,1998-10-26T03:00:00Z,MWCG 193N 814W,6,5,3,3,17
Hurricane,Mitch,18,1998-10-26T03:00:00Z,MNBL 120N 839W,0,0,0,3,3
Hurricane,Mitch,18,1998-10-26T03:00:00Z,MUGM 200N 751W,0,0,0,2,2
Hurricane,Mitch,18,1998-10-26T03:00:00Z,SKSP 126N 817W,0,0,0,3,3
Hurricane,Mitch,18,1998-10-26T03:00:00Z,MUCM 214N 779W,0,0,1,4,5
Hurricane,Mitch,18,1998-10-26T03:00:00Z,MMFR 185N 926W,0,0,0,3,3
Hurricane,Mitch,18,1998-10-26T03:00:00Z,MUCF 221N 805W,0,0,1,6,7
Hurricane,Mitch,18,1998-10-26T03:00:00Z,MMMD 210N 897W,0,0,0,5,5
Hurricane,Mitch,18,1998-10-26T03:00:00Z,MUSN 216N 826W,0,0,2,7,9
Hurricane,Mitch,18,1998-10-26T03:00:00Z,MARATHON FL,0,0,0,2,2
Hurricane,Mitch,18,1998-10-26T03:00:00Z,MUHA 230N 824W,0,0,0,5,5
Hurricane,Mitch,18,1998-10-26T03:00:00Z,KEY WEST FL,0,0,0,3,3
Hurricane,Mitch,18,1998-10-26T03:00:00Z,MUAN 219N 850W,0,0,0,8,8
Hurricane,Mitch,19,1998-10-26T09:00:00Z,16.8N  83.7W,53,0,0,0,53
Hurricane,Mitch,19,1998-10-26T09:00:00Z,MMCZ 205N 869W,0,0,5,8,13
Hurricane,Mitch,19,1998-10-26T09:00:00Z,17.1N  84.3W,30,1,0,0,31
Hurricane,Mitch,19,1998-10-26T09:00:00Z,MZBZ 175N 883W,0,3,6,5,14
Hurricane,Mitch,19,1998-10-26T09:00:00Z,17.6N  84.8W,16,6,2,1,25
Hurricane,Mitch,19,1998-10-26T09:00:00Z,MGPB 157N 886W,0,1,2,5,8
Hurricane,Mitch,19,1998-10-26T09:00:00Z,MKJP 179N 768W,0,0,1,3,4
Hurricane,Mitch,19,1998-10-26T09:00:00Z,MHNJ 165N 859W,7,7,3,2,19
Hurricane,Mitch,19,1998-10-26T09:00:00Z,MKJS 185N 779W,0,0,2,5,7
Hurricane,Mitch,19,1998-10-26T09:00:00Z,MNPC 141N 834W,5,0,0,3,8
Hurricane,Mitch,19,1998-10-26T09:00:00Z,MWCG 193N 814W,6,4,3,3,16
Hurricane,Mitch,19,1998-10-26T09:00:00Z,MNBL 120N 839W,0,0,0,2,2
Hurricane,Mitch,19,1998-10-26T09:00:00Z,MUCM 214N 779W,0,0,0,4,4
Hurricane,Mitch,19,1998-10-26T09:00:00Z,SKSP 126N 817W,0,0,0,2,2
Hurricane,Mitch,19,1998-10-26T09:00:00Z,MUCF 221N 805W,0,0,0,6,6
Hurricane,Mitch,19,1998-10-26T09:00:00Z,MMFR 185N 926W,0,0,0,5,5
Hurricane,Mitch,19,1998-10-26T09:00:00Z,MUSN 216N 826W,0,0,2,7,9
Hurricane,Mitch,19,1998-10-26T09:00:00Z,MMMD 210N 897W,0,0,1,7,8
Hurricane,Mitch,19,1998-10-26T09:00:00Z,MUHA 230N 824W,0,0,0,6,6
Hurricane,Mitch,19,1998-10-26T09:00:00Z,MARATHON FL,0,0,0,2,2
Hurricane,Mitch,19,1998-10-26T09:00:00Z,MUAN 219N 850W,0,0,1,9,10
Hurricane,Mitch,19,1998-10-26T09:00:00Z,KEY WEST FL,0,0,0,3,3
Hurricane,Mitch,20,1998-10-26T15:00:00Z,17.2N  84.7W,51,0,0,0,51
Hurricane,Mitch,20,1998-10-26T15:00:00Z,MMCZ 205N 869W,0,0,3,8,11
Hurricane,Mitch,20,1998-10-26T15:00:00Z,17.5N  84.8W,42,0,0,0,42
Hurricane,Mitch,20,1998-10-26T15:00:00Z,MZBZ 175N 883W,0,3,6,5,14
Hurricane,Mitch,20,1998-10-26T15:00:00Z,17.8N  84.9W,37,0,0,1,38
Hurricane,Mitch,20,1998-10-26T15:00:00Z,MGPB 157N 886W,0,2,4,5,11
Hurricane,Mitch,20,1998-10-26T15:00:00Z,MKJP 179N 768W,0,0,0,3,3
Hurricane,Mitch,20,1998-10-26T15:00:00Z,MHNJ 165N 859W,15,4,1,2,22
Hurricane,Mitch,20,1998-10-26T15:00:00Z,MKJS 185N 779W,0,0,1,5,6
Hurricane,Mitch,20,1998-10-26T15:00:00Z,MNPC 141N 834W,3,0,1,4,8
Hurricane,Mitch,20,1998-10-26T15:00:00Z,MWCG 193N 814W,1,8,4,4,17
Hurricane,Mitch,20,1998-10-26T15:00:00Z,MNBL 120N 839W,0,0,0,2,2
Hurricane,Mitch,20,1998-10-26T15:00:00Z,MUGM 200N 751W,0,0,0,2,2
Hurricane,Mitch,20,1998-10-26T15:00:00Z,SKSP 126N 817W,0,0,0,2,2
Hurricane,Mitch,20,1998-10-26T15:00:00Z,MUCM 214N 779W,0,0,1,4,5
Hurricane,Mitch,20,1998-10-26T15:00:00Z,MMFR 185N 926W,0,0,0,4,4
Hurricane,Mitch,20,1998-10-26T15:00:00Z,MUCF 221N 805W,0,0,2,5,7
Hurricane,Mitch,20,1998-10-26T15:00:00Z,MMMD 210N 897W,0,0,0,6,6
Hurricane,Mitch,20,1998-10-26T15:00:00Z,MUSN 216N 826W,0,1,3,7,11
Hurricane,Mitch,20,1998-10-26T15:00:00Z,MARATHON FL,0,0,0,2,2
Hurricane,Mitch,20,1998-10-26T15:00:00Z,MUHA 230N 824W,0,0,0,6,6
Hurricane,Mitch,20,1998-10-26T15:00:00Z,KEY WEST FL,0,0,0,3,3
Hurricane,Mitch,20,1998-10-26T15:00:00Z,MUAN 219N 850W,0,0,1,8,9
Hurricane,Mitch,21,1998-10-26T21:00:00Z,17.5N  85.2W,55,0,0,0,55
Hurricane,Mitch,21,1998-10-26T21:00:00Z,MMCZ 205N 869W,0,3,6,6,15
Hurricane,Mitch,21,1998-10-26T21:00:00Z,18.0N  85.4W,39,0,0,1,40
Hurricane,Mitch,21,1998-10-26T21:00:00Z,MZBZ 175N 883W,1,7,4,4,16
Hurricane,Mitch,21,1998-10-26T21:00:00Z,18.2N  85.5W,34,1,0,0,35
Hurricane,Mitch,21,1998-10-26T21:00:00Z,MGPB 157N 886W,0,1,3,5,9
Hurricane,Mitch,21,1998-10-26T21:00:00Z,MKJP 179N 768W,0,0,0,3,3
Hurricane,Mitch,21,1998-10-26T21:00:00Z,MHNJ 165N 859W,22,1,1,0,24
Hurricane,Mitch,21,1998-10-26T21:00:00Z,MKJS 185N 779W,0,0,1,4,5
Hurricane,Mitch,21,1998-10-26T21:00:00Z,MNPC 141N 834W,0,0,0,5,5
Hurricane,Mitch,21,1998-10-26T21:00:00Z,MWCG 193N 814W,1,6,5,4,16
Hurricane,Mitch,21,1998-10-26T21:00:00Z,MNBL 120N 839W,0,0,0,2,2
Hurricane,Mitch,21,1998-10-26T21:00:00Z,MUCM 214N 779W,0,0,0,4,4
Hurricane,Mitch,21,1998-10-26T21:00:00Z,SKSP 126N 817W,0,0,0,2,2
Hurricane,Mitch,21,1998-10-26T21:00:00Z,MUCF 221N 805W,0,0,1,6,7
Hurricane,Mitch,21,1998-10-26T21:00:00Z,MMFR 185N 926W,0,0,1,4,5
Hurricane,Mitch,21,1998-10-26T21:00:00Z,MUSN 216N 826W,0,1,4,6,11
Hurricane,Mitch,21,1998-10-26T21:00:00Z,MMMD 210N 897W,0,0,1,8,9
Hurricane,Mitch,21,1998-10-26T21:00:00Z,MUHA 230N 824W,0,0,1,6,7
Hurricane,Mitch,21,1998-10-26T21:00:00Z,MARATHON FL,0,0,0,2,2
Hurricane,Mitch,21,1998-10-26T21:00:00Z,MUAN 219N 850W,0,0,3,8,11
Hurricane,Mitch,21,1998-10-26T21:00:00Z,KEY WEST FL,0,0,0,3,3
Hurricane,Mitch,22,1998-10-27T03:00:00Z,18.0N  85.5W,65,0,0,0,65
Hurricane,Mitch,22,1998-10-27T03:00:00Z,MMCZ 205N 869W,2,9,5,3,19
Hurricane,Mitch,22,1998-10-27T03:00:00Z,18.2N  85.8W,49,0,0,0,49
Hurricane,Mitch,22,1998-10-27T03:00:00Z,MZBZ 175N 883W,2,6,4,3,15
Hurricane,Mitch,22,1998-10-27T03:00:00Z,18.5N  86.0W,37,1,0,0,38
Hurricane,Mitch,22,1998-10-27T03:00:00Z,MGPB 157N 886W,0,1,1,6,8
Hurricane,Mitch,22,1998-10-27T03:00:00Z,MKJP 179N 768W,0,0,0,3,3
Hurricane,Mitch,22,1998-10-27T03:00:00Z,MHNJ 165N 859W,27,0,0,1,28
Hurricane,Mitch,22,1998-10-27T03:00:00Z,MKJS 185N 779W,0,0,1,3,4
Hurricane,Mitch,22,1998-10-27T03:00:00Z,MNPC 141N 834W,0,0,1,4,5
Hurricane,Mitch,22,1998-10-27T03:00:00Z,MWCG 193N 814W,1,4,4,5,14
Hurricane,Mitch,22,1998-10-27T03:00:00Z,MNBL 120N 839W,0,0,0,2,2
Hurricane,Mitch,22,1998-10-27T03:00:00Z,MUCM 214N 779W,0,0,0,2,2
Hurricane,Mitch,22,1998-10-27T03:00:00Z,SKSP 126N 817W,0,0,0,2,2
Hurricane,Mitch,22,1998-10-27T03:00:00Z,MUCF 221N 805W,0,0,1,4,5
Hurricane,Mitch,22,1998-10-27T03:00:00Z,MMFR 185N 926W,0,0,1,5,6
Hurricane,Mitch,22,1998-10-27T03:00:00Z,MUSN 216N 826W,0,2,3,6,11
Hurricane,Mitch,22,1998-10-27T03:00:00Z,MMMD 210N 897W,0,1,5,7,13
Hurricane,Mitch,22,1998-10-27T03:00:00Z,MUHA 230N 824W,0,0,1,5,6
Hurricane,Mitch,22,1998-10-27T03:00:00Z,MARATHON FL,0,0,0,2,2
Hurricane,Mitch,22,1998-10-27T03:00:00Z,MUAN 219N 850W,1,2,5,5,13
Hurricane,Mitch,22,1998-10-27T03:00:00Z,KEY WEST FL,0,0,0,3,3
Hurricane,Mitch,23,1998-10-27T09:00:00Z,17.9N  86.3W,55,0,0,0,55
Hurricane,Mitch,23,1998-10-27T09:00:00Z,MZBZ 175N 883W,10,5,2,2,19
Hurricane,Mitch,23,1998-10-27T09:00:00Z,18.4N  86.6W,41,0,0,0,41
Hurricane,Mitch,23,1998-10-27T09:00:00Z,MGPB 157N 886W,2,2,2,3,9
Hurricane,Mitch,23,1998-10-27T09:00:00Z,18.7N  86.8W,27,1,1,0,29
Hurricane,Mitch,23,1998-10-27T09:00:00Z,MHNJ 165N 859W,49,0,0,0,49
Hurricane,Mitch,23,1998-10-27T09:00:00Z,MKJS 185N 779W,0,0,0,3,3
Hurricane,Mitch,23,1998-10-27T09:00:00Z,MNPC 141N 834W,0,0,0,2,2
Hurricane,Mitch,23,1998-10-27T09:00:00Z,MWCG 193N 814W,0,2,5,4,11
Hurricane,Mitch,23,1998-10-27T09:00:00Z,MMVR 192N 961W,0,0,0,2,2
Hurricane,Mitch,23,1998-10-27T09:00:00Z,MUCM 214N 779W,0,0,0,3,3
Hurricane,Mitch,23,1998-10-27T09:00:00Z,MMFR 185N 926W,0,0,2,6,8
Hurricane,Mitch,23,1998-10-27T09:00:00Z,MUCF 221N 805W,0,0,1,5,6
Hurricane,Mitch,23,1998-10-27T09:00:00Z,MMMD 210N 897W,0,0,5,8,13
Hurricane,Mitch,23,1998-10-27T09:00:00Z,MUSN 216N 826W,0,1,4,6,11
Hurricane,Mitch,23,1998-10-27T09:00:00Z,MARATHON FL,0,0,0,3,3
Hurricane,Mitch,23,1998-10-27T09:00:00Z,MUHA 230N 824W,0,0,1,6,7
Hurricane,Mitch,23,1998-10-27T09:00:00Z,KEY WEST FL,0,0,0,4,4
Hurricane,Mitch,23,1998-10-27T09:00:00Z,MUAN 219N 850W,0,1,5,7,13
Hurricane,Mitch,23,1998-10-27T09:00:00Z,MARCO ISLAND FL,0,0,0,2,2
Hurricane,Mitch,23,1998-10-27T09:00:00Z,MMCZ 205N 869W,3,6,5,4,18
Hurricane,Mitch,24,1998-10-27T15:00:00Z,17.8N  86.5W,54,0,0,0,54
Hurricane,Mitch,24,1998-10-27T15:00:00Z,MMCZ 205N 869W,3,5,5,4,17
Hurricane,Mitch,24,1998-10-27T15:00:00Z,18.0N  86.7W,46,0,0,0,46
Hurricane,Mitch,24,1998-10-27T15:00:00Z,MZBZ 175N 883W,10,6,2,2,20
Hurricane,Mitch,24,1998-10-27T15:00:00Z,18.2N  86.9W,33,1,0,0,34
Hurricane,Mitch,24,1998-10-27T15:00:00Z,MGPB 157N 886W,2,3,2,5,12
Hurricane,Mitch,24,1998-10-27T15:00:00Z,MKJS 185N 779W,0,0,0,3,3
Hurricane,Mitch,24,1998-10-27T15:00:00Z,MHNJ 165N 859W,64,0,0,0,64
Hurricane,Mitch,24,1998-10-27T15:00:00Z,MWCG 193N 814W,0,2,4,5,11
Hurricane,Mitch,24,1998-10-27T15:00:00Z,MNPC 141N 834W,0,0,0,4,4
Hurricane,Mitch,24,1998-10-27T15:00:00Z,MUCM 214N 779W,0,0,0,2,2
Hurricane,Mitch,24,1998-10-27T15:00:00Z,MMVR 192N 961W,0,0,0,2,2
Hurricane,Mitch,24,1998-10-27T15:00:00Z,MUCF 221N 805W,0,0,1,4,5
Hurricane,Mitch,24,1998-10-27T15:00:00Z,MMFR 185N 926W,0,0,2,6,8
Hurricane,Mitch,24,1998-10-27T15:00:00Z,MUSN 216N 826W,0,1,3,6,10
Hurricane,Mitch,24,1998-10-27T15:00:00Z,MMMD 210N 897W,0,0,3,8,11
Hurricane,Mitch,24,1998-10-27T15:00:00Z,MUHA 230N 824W,0,0,1,5,6
Hurricane,Mitch,24,1998-10-27T15:00:00Z,MARATHON FL,0,0,0,2,2
Hurricane,Mitch,24,1998-10-27T15:00:00Z,MUAN 219N 850W,0,1,4,6,11
Hurricane,Mitch,24,1998-10-27T15:00:00Z,KEY WEST FL,0,0,0,2,2
Hurricane,Mitch,25,1998-10-27T21:00:00Z,16.8N  87.3W,58,0,0,0,58
Hurricane,Mitch,25,1998-10-27T21:00:00Z,MGPB 157N 886W,15,3,2,1,21
Hurricane,Mitch,25,1998-10-27T21:00:00Z,17.2N  88.0W,32,1,0,0,33
Hurricane,Mitch,25,1998-10-27T21:00:00Z,MHNJ 165N 859W,99,0,0,0,99
Hurricane,Mitch,25,1998-10-27T21:00:00Z,17.8N  88.5W,18,4,1,2,25
Hurricane,Mitch,25,1998-10-27T21:00:00Z,MNPC 141N 834W,0,0,0,2,2
Hurricane,Mitch,25,1998-10-27T21:00:00Z,MWCG 193N 814W,0,0,1,4,5
Hurricane,Mitch,25,1998-10-27T21:00:00Z,MMTX 210N 974W,0,0,0,2,2
Hurricane,Mitch,25,1998-10-27T21:00:00Z,MUCF 221N 805W,0,0,0,3,3
Hurricane,Mitch,25,1998-10-27T21:00:00Z,MMVR 192N 961W,0,0,0,4,4
Hurricane,Mitch,25,1998-10-27T21:00:00Z,MUSN 216N 826W,0,0,2,6,8
Hurricane,Mitch,25,1998-10-27T21:00:00Z,MMFR 185N 926W,0,0,3,9,12
Hurricane,Mitch,25,1998-10-27T21:00:00Z,MUHA 230N 824W,0,0,1,4,5
Hurricane,Mitch,25,1998-10-27T21:00:00Z,MMMD 210N 897W,0,0,4,9,13
Hurricane,Mitch,25,1998-10-27T21:00:00Z,MUAN 219N 850W,0,1,4,6,11
Hurricane,Mitch,25,1998-10-27T21:00:00Z,MARATHON FL,0,0,0,2,2
Hurricane,Mitch,25,1998-10-27T21:00:00Z,MMCZ 205N 869W,1,6,6,4,17
Hurricane,Mitch,25,1998-10-27T21:00:00Z,KEY WEST FL,0,0,0,2,2
Hurricane,Mitch,25,1998-10-27T21:00:00Z,MZBZ 175N 883W,23,2,1,1,27
Hurricane,Mitch,26,1998-10-28T03:00:00Z,16.6N  86.8W,50,0,0,0,50
Hurricane,Mitch,26,1998-10-28T03:00:00Z,MGPB 157N 886W,4,9,3,1,17
Hurricane,Mitch,26,1998-10-28T03:00:00Z,17.0N  87.5W,33,1,0,0,34
Hurricane,Mitch,26,1998-10-28T03:00:00Z,MHNJ 165N 859W,99,0,0,0,99
Hurricane,Mitch,26,1998-10-28T03:00:00Z,18.0N  88.0W,19,3,2,1,25
Hurricane,Mitch,26,1998-10-28T03:00:00Z,MMTX 210N 974W,0,0,0,2,2
Hurricane,Mitch,26,1998-10-28T03:00:00Z,MWCG 193N 814W,0,0,2,3,5
Hurricane,Mitch,26,1998-10-28T03:00:00Z,MMVR 192N 961W,0,0,0,3,3
Hurricane,Mitch,26,1998-10-28T03:00:00Z,MUCF 221N 805W,0,0,1,3,4
Hurricane,Mitch,26,1998-10-28T03:00:00Z,MMFR 185N 926W,0,0,2,8,10
Hurricane,Mitch,26,1998-10-28T03:00:00Z,MUSN 216N 826W,0,0,4,5,9
Hurricane,Mitch,26,1998-10-28T03:00:00Z,MMMD 210N 897W,0,0,3,9,12
Hurricane,Mitch,26,1998-10-28T03:00:00Z,MUHA 230N 824W,0,0,1,6,7
Hurricane,Mitch,26,1998-10-28T03:00:00Z,MARATHON FL,0,0,0,3,3
Hurricane,Mitch,26,1998-10-28T03:00:00Z,MUAN 219N 850W,0,0,6,7,13
Hurricane,Mitch,26,1998-10-28T03:00:00Z,KEY WEST FL,0,0,0,4,4
Hurricane,Mitch,26,1998-10-28T03:00:00Z,MMCZ 205N 869W,1,4,8,4,17
Hurricane,Mitch,26,1998-10-28T03:00:00Z,MARCO ISLAND FL,0,0,0,2,2
Hurricane,Mitch,26,1998-10-28T03:00:00Z,MZBZ 175N 883W,15,5,2,1,23
Hurricane,Mitch,27,1998-10-28T09:00:00Z,16.6N  86.8W,50,0,1,0,51
Hurricane,Mitch,27,1998-10-28T09:00:00Z,SKSP 126N 817W,0,0,0,2,2
Hurricane,Mitch,27,1998-10-28T09:00:00Z,17.0N  87.5W,40,0,0,0,40
Hurricane,Mitch,27,1998-10-28T09:00:00Z,MMSO 238N 982W,0,0,0,2,2
Hurricane,Mitch,27,1998-10-28T09:00:00Z,18.0N  88.0W,25,3,0,1,29
Hurricane,Mitch,27,1998-10-28T09:00:00Z,MMTM 222N 979W,0,0,0,2,2
Hurricane,Mitch,27,1998-10-28T09:00:00Z,MWCG 193N 814W,0,0,1,4,5
Hurricane,Mitch,27,1998-10-28T09:00:00Z,MMTX 210N 974W,0,0,0,2,2
Hurricane,Mitch,27,1998-10-28T09:00:00Z,MUSN 216N 826W,0,0,0,5,5
Hurricane,Mitch,27,1998-10-28T09:00:00Z,MMVR 192N 961W,0,0,0,4,4
Hurricane,Mitch,27,1998-10-28T09:00:00Z,MUHA 230N 824W,0,0,0,3,3
Hurricane,Mitch,27,1998-10-28T09:00:00Z,MMFR 185N 926W,0,1,4,6,11
Hurricane,Mitch,27,1998-10-28T09:00:00Z,MUAN 219N 850W,0,0,1,7,8
Hurricane,Mitch,27,1998-10-28T09:00:00Z,MMMD 210N 897W,0,2,8,6,16
Hurricane,Mitch,27,1998-10-28T09:00:00Z,MMCZ 205N 869W,0,3,7,6,16
Hurricane,Mitch,27,1998-10-28T09:00:00Z,BROWNSVILLE TX,0,0,0,2,2
Hurricane,Mitch,27,1998-10-28T09:00:00Z,MZBZ 175N 883W,24,2,1,1,28
Hurricane,Mitch,27,1998-10-28T09:00:00Z,GULF 28N 89W,0,0,0,2,2
Hurricane,Mitch,27,1998-10-28T09:00:00Z,MGPB 157N 886W,6,4,3,2,15
Hurricane,Mitch,27,1998-10-28T09:00:00Z,GULF 28N 91W,0,0,0,2,2
Hurricane,Mitch,27,1998-10-28T09:00:00Z,MHNJ 165N 859W,99,0,0,0,99
Hurricane,Mitch,27,1998-10-28T09:00:00Z,GULF 28N 93W,0,0,0,2,2
Hurricane,Mitch,27,1998-10-28T09:00:00Z,MNPC 141N 834W,0,2,3,3,8
Hurricane,Mitch,27,1998-10-28T09:00:00Z,GULF 27N 96W,0,0,0,2,2
Hurricane,Mitch,27,1998-10-28T09:00:00Z,MNBL 120N 839W,0,0,0,2,2
Hurricane,Mitch,27,1998-10-28T09:00:00Z,GULF 25N 96W,0,0,0,3,3
Hurricane,Mitch,28,1998-10-28T15:00:00Z,17.1N  86.3W,99,0,0,0,99
Hurricane,Mitch,28,1998-10-28T15:00:00Z,SKSP 126N 817W,0,0,0,2,2
Hurricane,Mitch,28,1998-10-28T15:00:00Z,17.7N  86.8W,34,1,0,0,35
Hurricane,Mitch,28,1998-10-28T15:00:00Z,MMVR 192N 961W,0,0,0,2,2
Hurricane,Mitch,28,1998-10-28T15:00:00Z,18.7N  87.2W,17,5,2,1,25
Hurricane,Mitch,28,1998-10-28T15:00:00Z,MMFR 185N 926W,0,0,2,5,7
Hurricane,Mitch,28,1998-10-28T15:00:00Z,MWCG 193N 814W,0,0,2,5,7
Hurricane,Mitch,28,1998-10-28T15:00:00Z,MMMD 210N 897W,0,3,7,5,15
Hurricane,Mitch,28,1998-10-28T15:00:00Z,MUCF 221N 805W,0,0,0,3,3
Hurricane,Mitch,28,1998-10-28T15:00:00Z,MARATHON FL,0,0,0,2,2
Hurricane,Mitch,28,1998-10-28T15:00:00Z,MUSN 216N 826W,0,0,2,6,8
Hurricane,Mitch,28,1998-10-28T15:00:00Z,KEY WEST FL,0,0,0,3,3
Hurricane,Mitch,28,1998-10-28T15:00:00Z,MUHA 230N 824W,0,0,0,6,6
Hurricane,Mitch,28,1998-10-28T15:00:00Z,MARCO ISLAND FL,0,0,0,2,2
Hurricane,Mitch,28,1998-10-28T15:00:00Z,MUAN 219N 850W,0,1,5,7,13
Hurricane,Mitch,28,1998-10-28T15:00:00Z,BURAS LA,0,0,0,2,2
Hurricane,Mitch,28,1998-10-28T15:00:00Z,MMCZ 205N 869W,1,8,6,4,19
Hurricane,Mitch,28,1998-10-28T15:00:00Z,GULF 29N 87W,0,0,0,2,2
Hurricane,Mitch,28,1998-10-28T15:00:00Z,MZBZ 175N 883W,13,5,2,1,21
Hurricane,Mitch,28,1998-10-28T15:00:00Z,GULF 28N 89W,0,0,0,3,3
Hurricane,Mitch,28,1998-10-28T15:00:00Z,MGPB 157N 886W,3,4,2,4,13
Hurricane,Mitch,28,1998-10-28T15:00:00Z,GULF 28N 91W,0,0,0,3,3
Hurricane,Mitch,28,1998-10-28T15:00:00Z,MHNJ 165N 859W,99,0,0,0,99
Hurricane,Mitch,28,1998-10-28T15:00:00Z,GULF 28N 93W,0,0,0,2,2
Hurricane,Mitch,28,1998-10-28T15:00:00Z,MNPC 141N 834W,0,2,2,3,7
Hurricane,Mitch,28,1998-10-28T15:00:00Z,GULF 25N 96W,0,0,0,2,2
Hurricane,Mitch,28,1998-10-28T15:00:00Z,MNBL 120N 839W,0,0,0,2,2
Hurricane,Mitch,29,1998-10-28T21:00:00Z,17.0N  86.7W,99,0,0,0,99
Hurricane,Mitch,29,1998-10-28T21:00:00Z,SKSP 126N 817W,0,0,0,2,2
Hurricane,Mitch,29,1998-10-28T21:00:00Z,17.5N  87.2W,41,0,0,0,41
Hurricane,Mitch,29,1998-10-28T21:00:00Z,MMTM 222N 979W,0,0,0,2,2
Hurricane,Mitch,29,1998-10-28T21:00:00Z,18.3N  87.5W,24,2,1,0,27
Hurricane,Mitch,29,1998-10-28T21:00:00Z,MMTX 210N 974W,0,0,0,2,2
Hurricane,Mitch,29,1998-10-28T21:00:00Z,MKJS 185N 779W,0,0,0,2,2
Hurricane,Mitch,29,1998-10-28T21:00:00Z,MMVR 192N 961W,0,0,0,3,3
Hurricane,Mitch,29,1998-10-28T21:00:00Z,MWCG 193N 814W,0,0,2,5,7
Hurricane,Mitch,29,1998-10-28T21:00:00Z,MMFR 185N 926W,0,1,4,5,10
Hurricane,Mitch,29,1998-10-28T21:00:00Z,MUCF 221N 805W,0,0,0,3,3
Hurricane,Mitch,29,1998-10-28T21:00:00Z,MMMD 210N 897W,0,2,6,7,15
Hurricane,Mitch,29,1998-10-28T21:00:00Z,MUSN 216N 826W,0,0,0,7,7
Hurricane,Mitch,29,1998-10-28T21:00:00Z,MARATHON FL,0,0,0,2,2
Hurricane,Mitch,29,1998-10-28T21:00:00Z,MUHA 230N 824W,0,0,0,4,4
Hurricane,Mitch,29,1998-10-28T21:00:00Z,KEY WEST FL,0,0,0,2,2
Hurricane,Mitch,29,1998-10-28T21:00:00Z,MUAN 219N 850W,0,0,1,9,10
Hurricane,Mitch,29,1998-10-28T21:00:00Z,GULF 28N 89W,0,0,0,2,2
Hurricane,Mitch,29,1998-10-28T21:00:00Z,MMCZ 205N 869W,0,3,6,7,16
Hurricane,Mitch,29,1998-10-28T21:00:00Z,GULF 28N 91W,0,0,0,2,2
Hurricane,Mitch,29,1998-10-28T21:00:00Z,MZBZ 175N 883W,19,3,2,0,24
Hurricane,Mitch,29,1998-10-28T21:00:00Z,GULF 28N 93W,0,0,0,2,2
Hurricane,Mitch,29,1998-10-28T21:00:00Z,MGPB 157N 886W,4,3,3,2,12
Hurricane,Mitch,29,1998-10-28T21:00:00Z,GULF 27N 96W,0,0,0,2,2
Hurricane,Mitch,29,1998-10-28T21:00:00Z,MHNJ 165N 859W,99,0,0,0,99
Hurricane,Mitch,29,1998-10-28T21:00:00Z,GULF 25N 96W,0,0,0,3,3
Hurricane,Mitch,29,1998-10-28T21:00:00Z,MNPC 141N 834W,0,1,2,3,6
Hurricane,Mitch,30,1998-10-29T03:00:00Z,17.0N  87.0W,54,0,0,0,54
Hurricane,Mitch,30,1998-10-29T03:00:00Z,MMSO 238N 982W,0,0,0,2,2
Hurricane,Mitch,30,1998-10-29T03:00:00Z,17.5N  87.5W,31,1,0,0,32
Hurricane,Mitch,30,1998-10-29T03:00:00Z,MMTM 222N 979W,0,0,0,2,2
Hurricane,Mitch,30,1998-10-29T03:00:00Z,18.5N  88.0W,12,7,2,2,23
Hurricane,Mitch,30,1998-10-29T03:00:00Z,MMTX 210N 974W,0,0,0,2,2
Hurricane,Mitch,30,1998-10-29T03:00:00Z,MWCG 193N 814W,0,0,2,5,7
Hurricane,Mitch,30,1998-10-29T03:00:00Z,MMVR 192N 961W,0,0,0,4,4
Hurricane,Mitch,30,1998-10-29T03:00:00Z,MUCF 221N 805W,0,0,0,3,3
Hurricane,Mitch,30,1998-10-29T03:00:00Z,MMFR 185N 926W,0,1,6,4,11
Hurricane,Mitch,30,1998-10-29T03:00:00Z,MUSN 216N 826W,0,0,0,6,6
Hurricane,Mitch,30,1998-10-29T03:00:00Z,MMMD 210N 897W,0,1,7,7,15
Hurricane,Mitch,30,1998-10-29T03:00:00Z,MUHA 230N 824W,0,0,0,4,4
Hurricane,Mitch,30,1998-10-29T03:00:00Z,KEY WEST FL,0,0,0,2,2
Hurricane,Mitch,30,1998-10-29T03:00:00Z,MUAN 219N 850W,0,0,1,9,10
Hurricane,Mitch,30,1998-10-29T03:00:00Z,GULF 28N 89W,0,0,0,2,2
Hurricane,Mitch,30,1998-10-29T03:00:00Z,MMCZ 205N 869W,0,3,7,6,16
Hurricane,Mitch,30,1998-10-29T03:00:00Z,GULF 28N 91W,0,0,0,2,2
Hurricane,Mitch,30,1998-10-29T03:00:00Z,MZBZ 175N 883W,20,3,2,0,25
Hurricane,Mitch,30,1998-10-29T03:00:00Z,GULF 28N 93W,0,0,0,2,2
Hurricane,Mitch,30,1998-10-29T03:00:00Z,MGPB 157N 886W,9,3,2,1,15
Hurricane,Mitch,30,1998-10-29T03:00:00Z,GULF 27N 96W,0,0,0,2,2
Hurricane,Mitch,30,1998-10-29T03:00:00Z,MHNJ 165N 859W,99,0,0,0,99
Hurricane,Mitch,30,1998-10-29T03:00:00Z,GULF 25N 96W,0,0,0,3,3
Hurricane,Mitch,30,1998-10-29T03:00:00Z,MNPC 141N 834W,0,1,1,3,5
Hurricane,Mitch,31,1998-10-29T09:00:00Z,16.9N  87.1W,55,0,0,0,55
Hurricane,Mitch,31,1998-10-29T09:00:00Z,MMSO 238N 982W,0,0,0,2,2
Hurricane,Mitch,31,1998-10-29T09:00:00Z,17.6N  87.7W,30,1,1,0,32
Hurricane,Mitch,31,1998-10-29T09:00:00Z,MMTM 222N 979W,0,0,0,2,2
Hurricane,Mitch,31,1998-10-29T09:00:00Z,18.5N  88.2W,12,9,2,1,24
Hurricane,Mitch,31,1998-10-29T09:00:00Z,MMTX 210N 974W,0,0,0,2,2
Hurricane,Mitch,31,1998-10-29T09:00:00Z,MWCG 193N 814W,0,0,1,4,5
Hurricane,Mitch,31,1998-10-29T09:00:00Z,MMVR 192N 961W,0,0,0,4,4
Hurricane,Mitch,31,1998-10-29T09:00:00Z,MUCF 221N 805W,0,0,0,2,2
Hurricane,Mitch,31,1998-10-29T09:00:00Z,MMFR 185N 926W,0,1,5,5,11
Hurricane,Mitch,31,1998-10-29T09:00:00Z,MUSN 216N 826W,0,0,0,5,5
Hurricane,Mitch,31,1998-10-29T09:00:00Z,MMMD 210N 897W,0,4,7,5,16
Hurricane,Mitch,31,1998-10-29T09:00:00Z,MUHA 230N 824W,0,0,0,3,3
Hurricane,Mitch,31,1998-10-29T09:00:00Z,KEY WEST FL,0,0,0,2,2
Hurricane,Mitch,31,1998-10-29T09:00:00Z,MUAN 219N 850W,0,0,3,6,9
Hurricane,Mitch,31,1998-10-29T09:00:00Z,BROWNSVILLE TX,0,0,0,2,2
Hurricane,Mitch,31,1998-10-29T09:00:00Z,MMCZ 205N 869W,1,7,4,4,16
Hurricane,Mitch,31,1998-10-29T09:00:00Z,GULF 28N 89W,0,0,0,2,2
Hurricane,Mitch,31,1998-10-29T09:00:00Z,MZBZ 175N 883W,20,4,1,1,26
Hurricane,Mitch,31,1998-10-29T09:00:00Z,GULF 28N 91W,0,0,0,3,3
Hurricane,Mitch,31,1998-10-29T09:00:00Z,MGPB 157N 886W,14,2,1,2,19
Hurricane,Mitch,31,1998-10-29T09:00:00Z,GULF 28N 93W,0,0,0,2,2
Hurricane,Mitch,31,1998-10-29T09:00:00Z,MHNJ 165N 859W,99,0,0,0,99
Hurricane,Mitch,31,1998-10-29T09:00:00Z,GULF 28N 95W,0,0,0,2,2
Hurricane,Mitch,31,1998-10-29T09:00:00Z,MNPC 141N 834W,0,1,2,3,6
Hurricane,Mitch,31,1998-10-29T09:00:00Z,GULF 27N 96W,0,0,0,2,2
Hurricane,Mitch,31,1998-10-29T09:00:00Z,MNBL 120N 839W,0,0,0,2,2
Hurricane,Mitch,31,1998-10-29T09:00:00Z,GULF 25N 96W,0,0,0,3,3
Hurricane,Mitch,31,1998-10-29T09:00:00Z,SKSP 126N 817W,0,0,0,2,2
Hurricane,Mitch,32,1998-10-29T15:00:00Z,16.5N  86.3W,99,0,0,0,99
Hurricane,Mitch,32,1998-10-29T15:00:00Z,MNPC 141N 834W,0,2,0,3,5
Hurricane,Mitch,32,1998-10-29T15:00:00Z,17.1N  87.0W,34,1,0,0,35
Hurricane,Mitch,32,1998-10-29T15:00:00Z,MMTM 222N 979W,0,0,0,2,2
Hurricane,Mitch,32,1998-10-29T15:00:00Z,18.2N  87.7W,14,7,2,1,24
Hurricane,Mitch,32,1998-10-29T15:00:00Z,MMTX 210N 974W,0,0,0,3,3
Hurricane,Mitch,32,1998-10-29T15:00:00Z,MKJS 185N 779W,0,0,0,2,2
Hurricane,Mitch,32,1998-10-29T15:00:00Z,MMVR 192N 961W,0,0,1,3,4
Hurricane,Mitch,32,1998-10-29T15:00:00Z,MWCG 193N 814W,0,0,3,4,7
Hurricane,Mitch,32,1998-10-29T15:00:00Z,MMFR 185N 926W,0,1,6,5,12
Hurricane,Mitch,32,1998-10-29T15:00:00Z,MUCF 221N 805W,0,0,0,3,3
Hurricane,Mitch,32,1998-10-29T15:00:00Z,MMMD 210N 897W,0,1,6,7,14
Hurricane,Mitch,32,1998-10-29T15:00:00Z,MUSN 216N 826W,0,0,1,6,7
Hurricane,Mitch,32,1998-10-29T15:00:00Z,MARATHON FL,0,0,0,2,2
Hurricane,Mitch,32,1998-10-29T15:00:00Z,MUHA 230N 824W,0,0,0,4,4
Hurricane,Mitch,32,1998-10-29T15:00:00Z,KEY WEST FL,0,0,0,2,2
Hurricane,Mitch,32,1998-10-29T15:00:00Z,MUAN 219N 850W,0,0,2,8,10
Hurricane,Mitch,32,1998-10-29T15:00:00Z,GULF 28N 89W,0,0,0,2,2
Hurricane,Mitch,32,1998-10-29T15:00:00Z,MMCZ 205N 869W,0,3,7,5,15
Hurricane,Mitch,32,1998-10-29T15:00:00Z,GULF 28N 91W,0,0,0,2,2
Hurricane,Mitch,32,1998-10-29T15:00:00Z,MZBZ 175N 883W,11,9,2,1,23
Hurricane,Mitch,32,1998-10-29T15:00:00Z,GULF 28N 93W,0,0,0,2,2
Hurricane,Mitch,32,1998-10-29T15:00:00Z,MGPB 157N 886W,5,6,2,2,15
Hurricane,Mitch,32,1998-10-29T15:00:00Z,GULF 25N 96W,0,0,0,2,2
Hurricane,Mitch,32,1998-10-29T15:00:00Z,MHNJ 165N 859W,99,0,0,0,99
Tropical Storm,Mitch,33,1998-10-29T21:00:00Z,16.2N  86.0W,99,0,0,0,99
Tropical Storm,Mitch,33,1998-10-29T21:00:00Z,MNPC 141N 834W,3,3,2,1,9
Tropical Storm,Mitch,33,1998-10-29T21:00:00Z,16.8N  86.6W,34,1,0,0,35
Tropical Storm,Mitch,33,1998-10-29T21:00:00Z,MNBL 120N 839W,0,0,2,2,4
Tropical Storm,Mitch,33,1998-10-29T21:00:00Z,17.5N  87.2W,19,3,2,1,25
Tropical Storm,Mitch,33,1998-10-29T21:00:00Z,SKSP 126N 817W,0,0,0,2,2
Tropical Storm,Mitch,33,1998-10-29T21:00:00Z,MWCG 193N 814W,0,0,1,3,4
Tropical Storm,Mitch,33,1998-10-29T21:00:00Z,MMVR 192N 961W,0,0,0,2,2
Tropical Storm,Mitch,33,1998-10-29T21:00:00Z,MUCF 221N 805W,0,0,0,2,2
Tropical Storm,Mitch,33,1998-10-29T21:00:00Z,MMFR 185N 926W,0,0,1,7,8
Tropical Storm,Mitch,33,1998-10-29T21:00:00Z,MUSN 216N 826W,0,0,1,4,5
Tropical Storm,Mitch,33,1998-10-29T21:00:00Z,MMMD 210N 897W,0,1,6,7,14
Tropical Storm,Mitch,33,1998-10-29T21:00:00Z,MUHA 230N 824W,0,0,0,4,4
Tropical Storm,Mitch,33,1998-10-29T21:00:00Z,KEY WEST FL,0,0,0,2,2
Tropical Storm,Mitch,33,1998-10-29T21:00:00Z,MUAN 219N 850W,0,1,4,6,11
Tropical Storm,Mitch,33,1998-10-29T21:00:00Z,BURAS LA,0,0,0,2,2
Tropical Storm,Mitch,33,1998-10-29T21:00:00Z,MMCZ 205N 869W,0,7,6,4,17
Tropical Storm,Mitch,33,1998-10-29T21:00:00Z,GULF 29N 87W,0,0,0,2,2
Tropical Storm,Mitch,33,1998-10-29T21:00:00Z,MZBZ 175N 883W,7,7,3,2,19
Tropical Storm,Mitch,33,1998-10-29T21:00:00Z,GULF 28N 89W,0,0,0,3,3
Tropical Storm,Mitch,33,1998-10-29T21:00:00Z,MGPB 157N 886W,4,5,3,3,15
Tropical Storm,Mitch,33,1998-10-29T21:00:00Z,GULF 28N 91W,0,0,0,3,3
Tropical Storm,Mitch,33,1998-10-29T21:00:00Z,MHNJ 165N 859W,99,0,0,0,99
Tropical Storm,Mitch,33,1998-10-29T21:00:00Z,GULF 28N 93W,0,0,0,2,2
Tropical Storm,Mitch,34,1998-10-30T03:00:00Z,16.4N  86.4W,57,0,0,0,57
Tropical Storm,Mitch,34,1998-10-30T03:00:00Z,MNBL 120N 839W,0,0,0,2,2
Tropical Storm,Mitch,34,1998-10-30T03:00:00Z,17.0N  87.0W,34,0,0,0,34
Tropical Storm,Mitch,34,1998-10-30T03:00:00Z,SKSP 126N 817W,0,0,0,2,2
Tropical Storm,Mitch,34,1998-10-30T03:00:00Z,18.0N  87.5W,14,8,1,1,24
Tropical Storm,Mitch,34,1998-10-30T03:00:00Z,MMTM 222N 979W,0,0,0,2,2
Tropical Storm,Mitch,34,1998-10-30T03:00:00Z,MWCG 193N 814W,0,0,2,5,7
Tropical Storm,Mitch,34,1998-10-30T03:00:00Z,MMTX 210N 974W,0,0,0,2,2
Tropical Storm,Mitch,34,1998-10-30T03:00:00Z,MUCF 221N 805W,0,0,0,2,2
Tropical Storm,Mitch,34,1998-10-30T03:00:00Z,MMVR 192N 961W,0,0,0,3,3
Tropical Storm,Mitch,34,1998-10-30T03:00:00Z,MUSN 216N 826W,0,0,1,5,6
Tropical Storm,Mitch,34,1998-10-30T03:00:00Z,MMFR 185N 926W,0,0,4,6,10
Tropical Storm,Mitch,34,1998-10-30T03:00:00Z,MUHA 230N 824W,0,0,0,4,4
Tropical Storm,Mitch,34,1998-10-30T03:00:00Z,MMMD 210N 897W,0,1,7,6,14
Tropical Storm,Mitch,34,1998-10-30T03:00:00Z,MUAN 219N 850W,0,0,3,7,10
Tropical Storm,Mitch,34,1998-10-30T03:00:00Z,KEY WEST FL,0,0,0,2,2
Tropical Storm,Mitch,34,1998-10-30T03:00:00Z,MMCZ 205N 869W,0,4,7,5,16
Tropical Storm,Mitch,34,1998-10-30T03:00:00Z,GULF 28N 89W,0,0,0,2,2
Tropical Storm,Mitch,34,1998-10-30T03:00:00Z,MZBZ 175N 883W,10,9,2,1,22
Tropical Storm,Mitch,34,1998-10-30T03:00:00Z,GULF 28N 91W,0,0,0,2,2
Tropical Storm,Mitch,34,1998-10-30T03:00:00Z,MGPB 157N 886W,9,4,1,2,16
Tropical Storm,Mitch,34,1998-10-30T03:00:00Z,GULF 28N 93W,0,0,0,2,2
Tropical Storm,Mitch,34,1998-10-30T03:00:00Z,MHNJ 165N 859W,99,0,0,0,99
Tropical Storm,Mitch,34,1998-10-30T03:00:00Z,GULF 25N 96W,0,0,0,2,2
Tropical Storm,Mitch,34,1998-10-30T03:00:00Z,MNPC 141N 834W,0,2,1,4,7
Tropical Storm,Mitch,35,1998-10-30T09:00:00Z,16.2N  87.2W,56,0,0,0,56
Tropical Storm,Mitch,35,1998-10-30T09:00:00Z,MHNJ 165N 859W,73,0,0,0,73
Tropical Storm,Mitch,35,1998-10-30T09:00:00Z,17.0N  87.9W,30,1,1,0,32
Tropical Storm,Mitch,35,1998-10-30T09:00:00Z,MNPC 141N 834W,0,1,1,3,5
Tropical Storm,Mitch,35,1998-10-30T09:00:00Z,18.0N  88.5W,10,12,1,2,25
Tropical Storm,Mitch,35,1998-10-30T09:00:00Z,MNBL 120N 839W,0,0,0,2,2
Tropical Storm,Mitch,35,1998-10-30T09:00:00Z,MWCG 193N 814W,0,0,1,5,6
Tropical Storm,Mitch,35,1998-10-30T09:00:00Z,MMSO 238N 982W,0,0,0,2,2
Tropical Storm,Mitch,35,1998-10-30T09:00:00Z,MUCF 221N 805W,0,0,0,2,2
Tropical Storm,Mitch,35,1998-10-30T09:00:00Z,MMTM 222N 979W,0,0,0,3,3
Tropical Storm,Mitch,35,1998-10-30T09:00:00Z,MUSN 216N 826W,0,0,1,4,5
Tropical Storm,Mitch,35,1998-10-30T09:00:00Z,MMTX 210N 974W,0,0,0,3,3
Tropical Storm,Mitch,35,1998-10-30T09:00:00Z,MUHA 230N 824W,0,0,0,3,3
Tropical Storm,Mitch,35,1998-10-30T09:00:00Z,MMVR 192N 961W,0,0,0,5,5
Tropical Storm,Mitch,35,1998-10-30T09:00:00Z,MUAN 219N 850W,0,0,3,6,9
Tropical Storm,Mitch,35,1998-10-30T09:00:00Z,MMFR 185N 926W,0,1,5,6,12
Tropical Storm,Mitch,35,1998-10-30T09:00:00Z,MMCZ 205N 869W,0,5,7,4,16
Tropical Storm,Mitch,35,1998-10-30T09:00:00Z,MMMD 210N 897W,0,2,7,6,15
Tropical Storm,Mitch,35,1998-10-30T09:00:00Z,MZBZ 175N 883W,19,6,1,0,26
Tropical Storm,Mitch,35,1998-10-30T09:00:00Z,GULF 28N 91W,0,0,0,2,2
Tropical Storm,Mitch,35,1998-10-30T09:00:00Z,MGPB 157N 886W,20,1,1,1,23
Tropical Storm,Mitch,35,1998-10-30T09:00:00Z,GULF 25N 96W,0,0,0,3,3
Tropical Storm,Mitch,36,1998-10-30T15:00:00Z,15.8N  87.8W,51,0,0,0,51
Tropical Storm,Mitch,36,1998-10-30T15:00:00Z,MHNJ 165N 859W,99,0,0,0,99
Tropical Storm,Mitch,36,1998-10-30T15:00:00Z,16.5N  88.5W,32,1,0,0,33
Tropical Storm,Mitch,36,1998-10-30T15:00:00Z,MNPC 141N 834W,0,0,0,2,2
Tropical Storm,Mitch,36,1998-10-30T15:00:00Z,17.3N  89.0W,17,6,2,1,26
Tropical Storm,Mitch,36,1998-10-30T15:00:00Z,MMSO 238N 982W,0,0,0,2,2
Tropical Storm,Mitch,36,1998-10-30T15:00:00Z,MWCG 193N 814W,0,0,1,3,4
Tropical Storm,Mitch,36,1998-10-30T15:00:00Z,MMTM 222N 979W,0,0,0,3,3
Tropical Storm,Mitch,36,1998-10-30T15:00:00Z,MUCF 221N 805W,0,0,0,2,2
Tropical Storm,Mitch,36,1998-10-30T15:00:00Z,MMTX 210N 974W,0,0,0,4,4
Tropical Storm,Mitch,36,1998-10-30T15:00:00Z,MUSN 216N 826W,0,0,1,5,6
Tropical Storm,Mitch,36,1998-10-30T15:00:00Z,MMVR 192N 961W,0,0,0,7,7
Tropical Storm,Mitch,36,1998-10-30T15:00:00Z,MUHA 230N 824W,0,0,0,3,3
Tropical Storm,Mitch,36,1998-10-30T15:00:00Z,MMFR 185N 926W,0,0,5,8,13
Tropical Storm,Mitch,36,1998-10-30T15:00:00Z,MUAN 219N 850W,0,0,2,7,9
Tropical Storm,Mitch,36,1998-10-30T15:00:00Z,MMMD 210N 897W,0,0,4,9,13
Tropical Storm,Mitch,36,1998-10-30T15:00:00Z,MMCZ 205N 869W,0,2,7,6,15
Tropical Storm,Mitch,36,1998-10-30T15:00:00Z,KEY WEST FL,0,0,0,2,2
Tropical Storm,Mitch,36,1998-10-30T15:00:00Z,MZBZ 175N 883W,23,3,1,1,28
Tropical Storm,Mitch,36,1998-10-30T15:00:00Z,GULF 25N 96W,0,0,0,2,2
Tropical Storm,Mitch,36,1998-10-30T15:00:00Z,MGPB 157N 886W,29,1,0,1,31
Tropical Storm,Mitch,37,1998-10-30T21:00:00Z,15.4N  88.6W,49,0,0,0,49
Tropical Storm,Mitch,37,1998-10-30T21:00:00Z,MHNJ 165N 859W,30,0,1,0,31
Tropical Storm,Mitch,37,1998-10-30T21:00:00Z,16.1N  89.4W,27,2,1,0,30
Tropical Storm,Mitch,37,1998-10-30T21:00:00Z,MNPC 141N 834W,0,0,0,2,2
Tropical Storm,Mitch,37,1998-10-30T21:00:00Z,17.1N  90.0W,11,10,2,1,24
Tropical Storm,Mitch,37,1998-10-30T21:00:00Z,MMSO 238N 982W,0,0,0,2,2
Tropical Storm,Mitch,37,1998-10-30T21:00:00Z,MWCG 193N 814W,0,0,0,3,3
Tropical Storm,Mitch,37,1998-10-30T21:00:00Z,MMTM 222N 979W,0,0,0,3,3
Tropical Storm,Mitch,37,1998-10-30T21:00:00Z,MUSN 216N 826W,0,0,0,4,4
Tropical Storm,Mitch,37,1998-10-30T21:00:00Z,MMTX 210N 974W,0,0,0,5,5
Tropical Storm,Mitch,37,1998-10-30T21:00:00Z,MUHA 230N 824W,0,0,0,2,2
Tropical Storm,Mitch,37,1998-10-30T21:00:00Z,MMVR 192N 961W,0,0,1,7,8
Tropical Storm,Mitch,37,1998-10-30T21:00:00Z,MUAN 219N 850W,0,0,1,6,7
Tropical Storm,Mitch,37,1998-10-30T21:00:00Z,MMFR 185N 926W,0,1,8,7,16
Tropical Storm,Mitch,37,1998-10-30T21:00:00Z,MMCZ 205N 869W,0,1,5,7,13
Tropical Storm,Mitch,37,1998-10-30T21:00:00Z,MMMD 210N 897W,0,0,4,9,13
Tropical Storm,Mitch,37,1998-10-30T21:00:00Z,MZBZ 175N 883W,21,3,1,1,26
Tropical Storm,Mitch,37,1998-10-30T21:00:00Z,GULF 25N 96W,0,0,0,2,2
Tropical Storm,Mitch,37,1998-10-30T21:00:00Z,MGPB 157N 886W,46,0,0,1,47
Tropical Storm,Mitch,38,1998-10-31T03:00:00Z,14.7N  89.1W,45,0,0,1,46
Tropical Storm,Mitch,38,1998-10-31T03:00:00Z,MHNJ 165N 859W,3,7,2,2,14
Tropical Storm,Mitch,38,1998-10-31T03:00:00Z,15.4N  90.2W,21,5,1,0,27
Tropical Storm,Mitch,38,1998-10-31T03:00:00Z,MMSO 238N 982W,0,0,0,2,2
Tropical Storm,Mitch,38,1998-10-31T03:00:00Z,16.1N  91.2W,4,14,3,2,23
Tropical Storm,Mitch,38,1998-10-31T03:00:00Z,MMTM 222N 979W,0,0,0,4,4
Tropical Storm,Mitch,38,1998-10-31T03:00:00Z,MUSN 216N 826W,0,0,0,2,2
Tropical Storm,Mitch,38,1998-10-31T03:00:00Z,MMTX 210N 974W,0,0,0,6,6
Tropical Storm,Mitch,38,1998-10-31T03:00:00Z,MUAN 219N 850W,0,0,0,3,3
Tropical Storm,Mitch,38,1998-10-31T03:00:00Z,MMVR 192N 961W,0,0,1,9,10
Tropical Storm,Mitch,38,1998-10-31T03:00:00Z,MMCZ 205N 869W,0,0,2,7,9
Tropical Storm,Mitch,38,1998-10-31T03:00:00Z,MMFR 185N 926W,0,1,8,7,16
Tropical Storm,Mitch,38,1998-10-31T03:00:00Z,MZBZ 175N 883W,9,7,3,2,21
Tropical Storm,Mitch,38,1998-10-31T03:00:00Z,MMMD 210N 897W,0,0,2,8,10
Tropical Storm,Mitch,38,1998-10-31T03:00:00Z,MGPB 157N 886W,40,1,0,0,41
Tropical Depression,Mitch,41,1998-10-31T21:00:00Z,15.4N  92.7W,41,0,0,0,41
Tropical Depression,Mitch,41,1998-10-31T21:00:00Z,MMSO 238N 982W,0,0,0,5,5
Tropical Depression,Mitch,41,1998-10-31T21:00:00Z,16.4N  93.9W,11,16,0,1,28
Tropical Depression,Mitch,41,1998-10-31T21:00:00Z,MMTM 222N 979W,0,0,0,7,7
Tropical Depression,Mitch,41,1998-10-31T21:00:00Z,17.5N  94.5W,1,16,4,2,23
Tropical Depression,Mitch,41,1998-10-31T21:00:00Z,MMTX 210N 974W,0,0,1,9,10
Tropical Depression,Mitch,41,1998-10-31T21:00:00Z,MUAN 219N 850W,0,0,0,2,2
Tropical Depression,Mitch,41,1998-10-31T21:00:00Z,MMVR 192N 961W,0,1,8,7,16
Tropical Depression,Mitch,41,1998-10-31T21:00:00Z,MMCZ 205N 869W,0,0,1,5,6
Tropical Depression,Mitch,41,1998-10-31T21:00:00Z,MMFR 185N 926W,3,11,4,3,21
Tropical Depression,Mitch,41,1998-10-31T21:00:00Z,MZBZ 175N 883W,0,1,3,4,8
Tropical Depression,Mitch,41,1998-10-31T21:00:00Z,MMMD 210N 897W,0,0,3,7,10
Tropical Depression,Mitch,41,1998-10-31T21:00:00Z,MGPB 157N 886W,11,0,0,1,12
Tropical Depression,Mitch,41,1998-10-31T21:00:00Z,BROWNSVILLE TX,0,0,0,2,2
Tropical Depression,Mitch,41,1998-10-31T21:00:00Z,MHNJ 165N 859W,0,0,0,2,2
Tropical Depression,Mitch,41,1998-10-31T21:00:00Z,GULF 25N 96W,0,0,0,4,4
Tropical Depression,Mitch,42,1998-11-01T03:00:00Z,15.8N  92.9W,43,0,0,0,43
Tropical Depression,Mitch,42,1998-11-01T03:00:00Z,MMTM 222N 979W,0,0,1,9,10
Tropical Depression,Mitch,42,1998-11-01T03:00:00Z,17.1N  93.9W,16,12,0,1,29
Tropical Depression,Mitch,42,1998-11-01T03:00:00Z,MMTX 210N 974W,0,0,5,8,13
Tropical Depression,Mitch,42,1998-11-01T03:00:00Z,18.5N  94.0W,3,17,3,1,24
Tropical Depression,Mitch,42,1998-11-01T03:00:00Z,MMVR 192N 961W,0,6,8,4,18
Tropical Depression,Mitch,42,1998-11-01T03:00:00Z,MUAN 219N 850W,0,0,0,2,2
Tropical Depression,Mitch,42,1998-11-01T03:00:00Z,MMFR 185N 926W,8,14,2,1,25
Tropical Depression,Mitch,42,1998-11-01T03:00:00Z,MMCZ 205N 869W,0,0,1,6,7
Tropical Depression,Mitch,42,1998-11-01T03:00:00Z,MMMD 210N 897W,0,0,5,7,12
Tropical Depression,Mitch,42,1998-11-01T03:00:00Z,MZBZ 175N 883W,0,2,5,3,10
Tropical Depression,Mitch,42,1998-11-01T03:00:00Z,BROWNSVILLE TX,0,0,0,4,4
Tropical Depression,Mitch,42,1998-11-01T03:00:00Z,MGPB 157N 886W,0,2,2,3,7
Tropical Depression,Mitch,42,1998-11-01T03:00:00Z,GULF 27N 96W,0,0,0,2,2
Tropical Depression,Mitch,42,1998-11-01T03:00:00Z,MHNJ 165N 859W,0,0,0,3,3
Tropical Depression,Mitch,42,1998-11-01T03:00:00Z,GULF 25N 96W,0,0,0,6,6
Tropical Depression,Mitch,42,1998-11-01T03:00:00Z,MMSO 238N 982W,0,0,0,7,7
Tropical Depression,Mitch,43,1998-11-01T09:00:00Z,16.4N  93.5W,53,0,0,0,53
Tropical Depression,Mitch,43,1998-11-01T09:00:00Z,MMTX 210N 974W,0,0,5,7,12
Tropical Depression,Mitch,43,1998-11-01T09:00:00Z,17.4N  93.9W,31,0,1,0,32
Tropical Depression,Mitch,43,1998-11-01T09:00:00Z,MMVR 192N 961W,0,10,5,3,18
Tropical Depression,Mitch,43,1998-11-01T09:00:00Z,18.3N  93.8W,14,8,1,2,25
Tropical Depression,Mitch,43,1998-11-01T09:00:00Z,MMFR 185N 926W,7,9,3,2,21
Tropical Depression,Mitch,43,1998-11-01T09:00:00Z,MUAN 219N 850W,0,0,0,2,2
Tropical Depression,Mitch,43,1998-11-01T09:00:00Z,MMMD 210N 897W,0,0,1,9,10
Tropical Depression,Mitch,43,1998-11-01T09:00:00Z,MMCZ 205N 869W,0,0,0,6,6
Tropical Depression,Mitch,43,1998-11-01T09:00:00Z,CORPUSCHRISTI TX,0,0,0,2,2
Tropical Depression,Mitch,43,1998-11-01T09:00:00Z,MZBZ 175N 883W,0,2,4,5,11
Tropical Depression,Mitch,43,1998-11-01T09:00:00Z,BROWNSVILLE TX,0,0,0,4,4
Tropical Depression,Mitch,43,1998-11-01T09:00:00Z,MGPB 157N 886W,0,3,3,3,9
Tropical Depression,Mitch,43,1998-11-01T09:00:00Z,GULF 28N 95W,0,0,0,2,2
Tropical Depression,Mitch,43,1998-11-01T09:00:00Z,MHNJ 165N 859W,0,0,1,4,5
Tropical Depression,Mitch,43,1998-11-01T09:00:00Z,GULF 27N 96W,0,0,0,3,3
Tropical Depression,Mitch,43,1998-11-01T09:00:00Z,MMSO 238N 982W,0,0,0,7,7
Tropical Depression,Mitch,43,1998-11-01T09:00:00Z,GULF 25N 96W,0,0,0,6,6
Tropical Depression,Mitch,43,1998-11-01T09:00:00Z,MMTM 222N 979W,0,0,1,9,10
Tropical Depression,Mitch,44,1998-11-01T15:00:00Z,16.2N  93.8W,46,0,0,0,46
Tropical Depression,Mitch,44,1998-11-01T15:00:00Z,MMFR 185N 926W,8,9,3,1,21
Tropical Depression,Mitch,44,1998-11-01T15:00:00Z,17.5N  94.5W,22,5,1,0,28
Tropical Depression,Mitch,44,1998-11-01T15:00:00Z,MMMD 210N 897W,0,0,3,8,11
Tropical Depression,Mitch,44,1998-11-01T15:00:00Z,19.0N  94.5W,2,16,2,2,22
Tropical Depression,Mitch,44,1998-11-01T15:00:00Z,GALVESTON TX,0,0,0,2,2
Tropical Depression,Mitch,44,1998-11-01T15:00:00Z,MUAN 219N 850W,0,0,0,2,2
Tropical Depression,Mitch,44,1998-11-01T15:00:00Z,FREEPORT TX,0,0,0,2,2
Tropical Depression,Mitch,44,1998-11-01T15:00:00Z,MMCZ 205N 869W,0,0,0,6,6
Tropical Depression,Mitch,44,1998-11-01T15:00:00Z,PORT O CONNOR TX,0,0,0,3,3
Tropical Depression,Mitch,44,1998-11-01T15:00:00Z,MZBZ 175N 883W,0,1,2,5,8
Tropical Depression,Mitch,44,1998-11-01T15:00:00Z,CORPUSCHRISTI TX,0,0,0,4,4
Tropical Depression,Mitch,44,1998-11-01T15:00:00Z,MGPB 157N 886W,0,1,1,4,6
Tropical Depression,Mitch,44,1998-11-01T15:00:00Z,BROWNSVILLE TX,0,0,0,7,7
Tropical Depression,Mitch,44,1998-11-01T15:00:00Z,MHNJ 165N 859W,0,0,0,3,3
Tropical Depression,Mitch,44,1998-11-01T15:00:00Z,GULF 28N 91W,0,0,0,2,2
Tropical Depression,Mitch,44,1998-11-01T15:00:00Z,MMSO 238N 982W,0,0,2,8,10
Tropical Depression,Mitch,44,1998-11-01T15:00:00Z,GULF 28N 93W,0,0,0,3,3
Tropical Depression,Mitch,44,1998-11-01T15:00:00Z,MMTM 222N 979W,0,0,5,7,12
Tropical Depression,Mitch,44,1998-11-01T15:00:00Z,GULF 28N 95W,0,0,0,4,4
Tropical Depression,Mitch,44,1998-11-01T15:00:00Z,MMTX 210N 974W,0,1,9,5,15
Tropical Depression,Mitch,44,1998-11-01T15:00:00Z,GULF 27N 96W,0,0,0,5,5
Tropical Depression,Mitch,44,1998-11-01T15:00:00Z,MMVR 192N 961W,0,13,4,3,20
Tropical Depression,Mitch,44,1998-11-01T15:00:00Z,GULF 25N 96W,0,0,1,8,9
Tropical Storm,Mitch,46,1998-11-03T21:00:00Z,21.7N  87.2W,35,1,0,0,36
Tropical Storm,Mitch,46,1998-11-03T21:00:00Z,W PALM BEACH FL,0,4,14,2,20
Tropical Storm,Mitch,46,1998-11-03T21:00:00Z,23.5N  84.0W,3,23,1,1,28
Tropical Storm,Mitch,46,1998-11-03T21:00:00Z,FT PIERCE FL,0,2,13,3,18
Tropical Storm,Mitch,46,1998-11-03T21:00:00Z,25.5N  80.5W,0,8,13,1,22
Tropical Storm,Mitch,46,1998-11-03T21:00:00Z,COCOA BEACH FL,0,1,10,5,16
Tropical Storm,Mitch,46,1998-11-03T21:00:00Z,MWCG 193N 814W,0,1,1,1,3
Tropical Storm,Mitch,46,1998-11-03T21:00:00Z,DAYTONA BEACH FL,0,0,6,6,12
Tropical Storm,Mitch,46,1998-11-03T21:00:00Z,MUCM 214N 779W,0,0,2,4,6
Tropical Storm,Mitch,46,1998-11-03T21:00:00Z,JACKSONVILLE FL,0,0,1,6,7
Tropical Storm,Mitch,46,1998-11-03T21:00:00Z,MUCF 221N 805W,0,5,8,2,15
Tropical Storm,Mitch,46,1998-11-03T21:00:00Z,SAVANNAH GA,0,0,0,4,4
Tropical Storm,Mitch,46,1998-11-03T21:00:00Z,MUSN 216N 826W,1,15,3,0,19
Tropical Storm,Mitch,46,1998-11-03T21:00:00Z,CHARLESTON SC,0,0,0,4,4
Tropical Storm,Mitch,46,1998-11-03T21:00:00Z,MUHA 230N 824W,1,19,3,1,24
Tropical Storm,Mitch,46,1998-11-03T21:00:00Z,MYRTLE BEACH SC,0,0,0,4,4
Tropical Storm,Mitch,46,1998-11-03T21:00:00Z,MUAN 219N 850W,16,14,0,0,30
Tropical Storm,Mitch,46,1998-11-03T21:00:00Z,WILMINGTON NC,0,0,0,4,4
Tropical Storm,Mitch,46,1998-11-03T21:00:00Z,MMCZ 205N 869W,35,1,0,0,36
Tropical Storm,Mitch,46,1998-11-03T21:00:00Z,MOREHEAD CITY NC,0,0,0,4,4
Tropical Storm,Mitch,46,1998-11-03T21:00:00Z,MZBZ 175N 883W,11,1,0,0,12
Tropical Storm,Mitch,46,1998-11-03T21:00:00Z,CAPE HATTERAS NC,0,0,0,4,4
Tropical Storm,Mitch,46,1998-11-03T21:00:00Z,MYMM 224N 730W,0,0,0,3,3
Tropical Storm,Mitch,46,1998-11-03T21:00:00Z,KEY WEST FL,0,16,7,1,24
Tropical Storm,Mitch,46,1998-11-03T21:00:00Z,MYSM 241N 745W,0,0,2,8,10
Tropical Storm,Mitch,46,1998-11-03T21:00:00Z,MARCO ISLAND FL,0,10,10,1,21
Tropical Storm,Mitch,46,1998-11-03T21:00:00Z,MYEG 235N 758W,0,0,3,7,10
Tropical Storm,Mitch,46,1998-11-03T21:00:00Z,FT MYERS FL,0,7,11,1,19
Tropical Storm,Mitch,46,1998-11-03T21:00:00Z,MYAK 241N 776W,0,1,9,5,15
Tropical Storm,Mitch,46,1998-11-03T21:00:00Z,VENICE FL,0,4,10,2,16
Tropical Storm,Mitch,46,1998-11-03T21:00:00Z,MYNN 251N 775W,0,1,11,5,17
Tropical Storm,Mitch,46,1998-11-03T21:00:00Z,TAMPA FL,0,1,8,4,13
Tropical Storm,Mitch,46,1998-11-03T21:00:00Z,MYGF 266N 787W,0,2,14,4,20
Tropical Storm,Mitch,46,1998-11-03T21:00:00Z,CEDAR KEY FL,0,0,3,5,8
Tropical Storm,Mitch,46,1998-11-03T21:00:00Z,MMFR 185N 926W,9,0,0,0,9
Tropical Storm,Mitch,46,1998-11-03T21:00:00Z,ST MARKS FL,0,0,0,3,3
Tropical Storm,Mitch,46,1998-11-03T21:00:00Z,MMMD 210N 897W,46,0,0,0,46
Tropical Storm,Mitch,46,1998-11-03T21:00:00Z,APALACHICOLA FL,0,0,1,2,3
Tropical Storm,Mitch,46,1998-11-03T21:00:00Z,BERMUDA,0,0,0,5,5
Tropical Storm,Mitch,46,1998-11-03T21:00:00Z,PANAMA CITY FL,0,0,0,2,2
Tropical Storm,Mitch,46,1998-11-03T21:00:00Z,MARATHON FL,0,13,9,1,23
Tropical Storm,Mitch,46,1998-11-03T21:00:00Z,GULF 29N 85W,0,0,1,3,4
Tropical Storm,Mitch,46,1998-11-03T21:00:00Z,MIAMI FL,0,7,13,2,22
Tropical Storm,Mitch,47,1998-11-04T03:00:00Z,23.0N  85.7W,36,2,0,0,38
Tropical Storm,Mitch,47,1998-11-04T03:00:00Z,FT PIERCE FL,0,5,12,1,18
Tropical Storm,Mitch,47,1998-11-04T03:00:00Z,25.1N  82.1W,1,21,2,0,24
Tropical Storm,Mitch,47,1998-11-04T03:00:00Z,COCOA BEACH FL,0,4,10,2,16
Tropical Storm,Mitch,47,1998-11-04T03:00:00Z,27.2N  78.3W,0,2,14,2,18
Tropical Storm,Mitch,47,1998-11-04T03:00:00Z,DAYTONA BEACH FL,0,2,8,2,12
Tropical Storm,Mitch,47,1998-11-04T03:00:00Z,MWCG 193N 814W,0,1,2,0,3
Tropical Storm,Mitch,47,1998-11-04T03:00:00Z,JACKSONVILLE FL,0,0,4,3,7
Tropical Storm,Mitch,47,1998-11-04T03:00:00Z,MUCM 214N 779W,0,0,5,2,7
Tropical Storm,Mitch,47,1998-11-04T03:00:00Z,SAVANNAH GA,0,0,1,3,4
Tropical Storm,Mitch,47,1998-11-04T03:00:00Z,MUCF 221N 805W,0,8,6,1,15
Tropical Storm,Mitch,47,1998-11-04T03:00:00Z,CHARLESTON SC,0,0,1,3,4
Tropical Storm,Mitch,47,1998-11-04T03:00:00Z,MUSN 216N 826W,2,16,1,0,19
Tropical Storm,Mitch,47,1998-11-04T03:00:00Z,MYRTLE BEACH SC,0,0,1,3,4
Tropical Storm,Mitch,47,1998-11-04T03:00:00Z,MUHA 230N 824W,3,21,1,0,25
Tropical Storm,Mitch,47,1998-11-04T03:00:00Z,WILMINGTON NC,0,0,0,4,4
Tropical Storm,Mitch,47,1998-11-04T03:00:00Z,MUAN 219N 850W,29,5,0,0,34
Tropical Storm,Mitch,47,1998-11-04T03:00:00Z,MOREHEAD CITY NC,0,0,0,5,5
Tropical Storm,Mitch,47,1998-11-04T03:00:00Z,MMCZ 205N 869W,45,0,0,0,45
Tropical Storm,Mitch,47,1998-11-04T03:00:00Z,CAPE HATTERAS NC,0,0,0,5,5
Tropical Storm,Mitch,47,1998-11-04T03:00:00Z,MYMM 224N 730W,0,0,0,4,4
Tropical Storm,Mitch,47,1998-11-04T03:00:00Z,NORFOLK VA,0,0,0,2,2
Tropical Storm,Mitch,47,1998-11-04T03:00:00Z,MYSM 241N 745W,0,0,3,6,9
Tropical Storm,Mitch,47,1998-11-04T03:00:00Z,KEY WEST FL,1,21,2,1,25
Tropical Storm,Mitch,47,1998-11-04T03:00:00Z,MYEG 235N 758W,0,0,5,5,10
Tropical Storm,Mitch,47,1998-11-04T03:00:00Z,MARCO ISLAND FL,0,17,5,0,22
Tropical Storm,Mitch,47,1998-11-04T03:00:00Z,MYAK 241N 776W,0,1,11,3,15
Tropical Storm,Mitch,47,1998-11-04T03:00:00Z,FT MYERS FL,0,14,5,1,20
Tropical Storm,Mitch,47,1998-11-04T03:00:00Z,MYNN 251N 775W,0,1,13,2,16
Tropical Storm,Mitch,47,1998-11-04T03:00:00Z,VENICE FL,0,12,5,0,17
Tropical Storm,Mitch,47,1998-11-04T03:00:00Z,MYGF 266N 787W,0,3,14,2,19
Tropical Storm,Mitch,47,1998-11-04T03:00:00Z,TAMPA FL,0,6,7,0,13
Tropical Storm,Mitch,47,1998-11-04T03:00:00Z,MMMD 210N 897W,99,0,0,0,99
Tropical Storm,Mitch,47,1998-11-04T03:00:00Z,CEDAR KEY FL,0,2,4,2,8
Tropical Storm,Mitch,47,1998-11-04T03:00:00Z,BERMUDA,0,0,0,5,5
Tropical Storm,Mitch,47,1998-11-04T03:00:00Z,ST MARKS FL,0,0,1,1,2
Tropical Storm,Mitch,47,1998-11-04T03:00:00Z,MARATHON FL,0,18,5,0,23
Tropical Storm,Mitch,47,1998-11-04T03:00:00Z,APALACHICOLA FL,0,0,1,1,2
Tropical Storm,Mitch,47,1998-11-04T03:00:00Z,MIAMI FL,0,11,9,1,21
Tropical Storm,Mitch,47,1998-11-04T03:00:00Z,GULF 29N 85W,0,1,1,1,3
Tropical Storm,Mitch,47,1998-11-04T03:00:00Z,W PALM BEACH FL,0,8,11,0,19
Tropical Depression,Mitch,48,1998-11-04T09:00:00Z,23.6N  84.9W,40,2,0,1,43
Tropical Depression,Mitch,48,1998-11-04T09:00:00Z,W PALM BEACH FL,0,13,9,0,22
Tropical Depression,Mitch,48,1998-11-04T09:00:00Z,25.6N  81.5W,1,22,3,0,26
Tropical Depression,Mitch,48,1998-11-04T09:00:00Z,FT PIERCE FL,0,9,10,1,20
Tropical Depression,Mitch,48,1998-11-04T09:00:00Z,28.0N  77.3W,0,1,14,3,18
Tropical Depression,Mitch,48,1998-11-04T09:00:00Z,COCOA BEACH FL,0,6,11,0,17
Tropical Depression,Mitch,48,1998-11-04T09:00:00Z,MWCG 193N 814W,0,1,1,0,2
Tropical Depression,Mitch,48,1998-11-04T09:00:00Z,DAYTONA BEACH FL,0,3,8,1,12
Tropical Depression,Mitch,48,1998-11-04T09:00:00Z,MUCM 214N 779W,0,0,4,2,6
Tropical Depression,Mitch,48,1998-11-04T09:00:00Z,JACKSONVILLE FL,0,1,3,2,6
Tropical Depression,Mitch,48,1998-11-04T09:00:00Z,MUCF 221N 805W,0,9,5,0,14
Tropical Depression,Mitch,48,1998-11-04T09:00:00Z,SAVANNAH GA,0,0,1,2,3
Tropical Depression,Mitch,48,1998-11-04T09:00:00Z,MUSN 216N 826W,3,14,0,1,18
Tropical Depression,Mitch,48,1998-11-04T09:00:00Z,CHARLESTON SC,0,0,1,2,3
Tropical Depression,Mitch,48,1998-11-04T09:00:00Z,MUHA 230N 824W,6,20,1,0,27
Tropical Depression,Mitch,48,1998-11-04T09:00:00Z,MYRTLE BEACH SC,0,0,1,3,4
Tropical Depression,Mitch,48,1998-11-04T09:00:00Z,MUAN 219N 850W,37,1,0,0,38
Tropical Depression,Mitch,48,1998-11-04T09:00:00Z,WILMINGTON NC,0,0,1,3,4
Tropical Depression,Mitch,48,1998-11-04T09:00:00Z,MMCZ 205N 869W,45,0,0,0,45
Tropical Depression,Mitch,48,1998-11-04T09:00:00Z,MOREHEAD CITY NC,0,0,0,5,5
Tropical Depression,Mitch,48,1998-11-04T09:00:00Z,MYMM 224N 730W,0,0,0,3,3
Tropical Depression,Mitch,48,1998-11-04T09:00:00Z,CAPE HATTERAS NC,0,0,0,5,5
Tropical Depression,Mitch,48,1998-11-04T09:00:00Z,MYSM 241N 745W,0,0,3,6,9
Tropical Depression,Mitch,48,1998-11-04T09:00:00Z,NORFOLK VA,0,0,0,2,2
Tropical Depression,Mitch,48,1998-11-04T09:00:00Z,MYEG 235N 758W,0,0,5,4,9
Tropical Depression,Mitch,48,1998-11-04T09:00:00Z,OCEAN CITY MD,0,0,0,2,2
Tropical Depression,Mitch,48,1998-11-04T09:00:00Z,MYAK 241N 776W,0,2,11,2,15
Tropical Depression,Mitch,48,1998-11-04T09:00:00Z,KEY WEST FL,3,24,1,0,28
Tropical Depression,Mitch,48,1998-11-04T09:00:00Z,MYNN 251N 775W,0,2,13,2,17
Tropical Depression,Mitch,48,1998-11-04T09:00:00Z,MARCO ISLAND FL,1,21,3,0,25
Tropical Depression,Mitch,48,1998-11-04T09:00:00Z,MYGF 266N 787W,0,6,14,0,20
Tropical Depression,Mitch,48,1998-11-04T09:00:00Z,FT MYERS FL,0,19,3,0,22
Tropical Depression,Mitch,48,1998-11-04T09:00:00Z,MMMD 210N 897W,99,0,0,0,99
Tropical Depression,Mitch,48,1998-11-04T09:00:00Z,VENICE FL,0,16,3,0,19
Tropical Depression,Mitch,48,1998-11-04T09:00:00Z,BERMUDA,0,0,0,6,6
Tropical Depression,Mitch,48,1998-11-04T09:00:00Z,TAMPA FL,0,8,6,0,14
Tropical Depression,Mitch,48,1998-11-04T09:00:00Z,MARATHON FL,1,22,3,0,26
Tropical Depression,Mitch,48,1998-11-04T09:00:00Z,CEDAR KEY FL,0,2,4,1,7
Tropical Depression,Mitch,48,1998-11-04T09:00:00Z,MIAMI FL,0,17,6,1,24
Tropical Depression,Mitch,48,1998-11-04T09:00:00Z,GULF 29N 85W,0,1,0,1,2
Tropical Storm,Mitch,49,1998-11-04T15:00:00Z,25.2N  83.3W,30,4,0,0,34
Tropical Storm,Mitch,49,1998-11-04T15:00:00Z,JACKSONVILLE FL,0,7,3,0,10
Tropical Storm,Mitch,49,1998-11-04T15:00:00Z,27.9N  78.9W,0,19,5,0,24
Tropical Storm,Mitch,49,1998-11-04T15:00:00Z,SAVANNAH GA,0,2,3,0,5
Tropical Storm,Mitch,49,1998-11-04T15:00:00Z,30.9N  73.4W,0,0,14,4,18
Tropical Storm,Mitch,49,1998-11-04T15:00:00Z,CHARLESTON SC,0,1,4,0,5
Tropical Storm,Mitch,49,1998-11-04T15:00:00Z,MUCM 214N 779W,0,1,1,0,2
Tropical Storm,Mitch,49,1998-11-04T15:00:00Z,MYRTLE BEACH SC,0,1,3,1,5
Tropical Storm,Mitch,49,1998-11-04T15:00:00Z,MUCF 221N 805W,2,6,1,0,9
Tropical Storm,Mitch,49,1998-11-04T15:00:00Z,WILMINGTON NC,0,0,4,2,6
Tropical Storm,Mitch,49,1998-11-04T15:00:00Z,MUSN 216N 826W,8,3,0,0,11
Tropical Storm,Mitch,49,1998-11-04T15:00:00Z,MOREHEAD CITY NC,0,0,5,2,7
Tropical Storm,Mitch,49,1998-11-04T15:00:00Z,MUHA 230N 824W,19,5,0,0,24
Tropical Storm,Mitch,49,1998-11-04T15:00:00Z,CAPE HATTERAS NC,0,0,4,3,7
Tropical Storm,Mitch,49,1998-11-04T15:00:00Z,MUAN 219N 850W,32,0,0,0,32
Tropical Storm,Mitch,49,1998-11-04T15:00:00Z,NORFOLK VA,0,0,1,2,3
Tropical Storm,Mitch,49,1998-11-04T15:00:00Z,MMCZ 205N 869W,10,0,0,0,10
Tropical Storm,Mitch,49,1998-11-04T15:00:00Z,OCEAN CITY MD,0,0,0,2,2
Tropical Storm,Mitch,49,1998-11-04T15:00:00Z,MYSM 241N 745W,0,0,4,1,5
Tropical Storm,Mitch,49,1998-11-04T15:00:00Z,NANTUCKET MA,0,0,0,2,2
Tropical Storm,Mitch,49,1998-11-04T15:00:00Z,MYEG 235N 758W,0,1,3,1,5
Tropical Storm,Mitch,49,1998-11-04T15:00:00Z,HYANNIS MA,0,0,0,2,2
Tropical Storm,Mitch,49,1998-11-04T15:00:00Z,MYAK 241N 776W,0,6,5,0,11
Tropical Storm,Mitch,49,1998-11-04T15:00:00Z,SABLE ISLAND NS,0,0,0,2,2
Tropical Storm,Mitch,49,1998-11-04T15:00:00Z,MYNN 251N 775W,0,9,6,1,16
Tropical Storm,Mitch,49,1998-11-04T15:00:00Z,KEY WEST FL,17,12,0,0,29
Tropical Storm,Mitch,49,1998-11-04T15:00:00Z,MYGF 266N 787W,0,19,4,0,23
Tropical Storm,Mitch,49,1998-11-04T15:00:00Z,MARCO ISLAND FL,11,18,0,1,30
Tropical Storm,Mitch,49,1998-11-04T15:00:00Z,MMMD 210N 897W,7,0,0,0,7
Tropical Storm,Mitch,49,1998-11-04T15:00:00Z,FT MYERS FL,9,19,0,0,28
Tropical Storm,Mitch,49,1998-11-04T15:00:00Z,BERMUDA,0,0,0,12,12
Tropical Storm,Mitch,49,1998-11-04T15:00:00Z,VENICE FL,9,17,0,0,26
Tropical Storm,Mitch,49,1998-11-04T15:00:00Z,MARATHON FL,10,17,0,0,27
Tropical Storm,Mitch,49,1998-11-04T15:00:00Z,TAMPA FL,4,17,0,0,21
Tropical Storm,Mitch,49,1998-11-04T15:00:00Z,MIAMI FL,3,23,0,0,26
Tropical Storm,Mitch,49,1998-11-04T15:00:00Z,CEDAR KEY FL,1,10,2,0,13
Tropical Storm,Mitch,49,1998-11-04T15:00:00Z,W PALM BEACH FL,1,24,1,0,26
Tropical Storm,Mitch,49,1998-11-04T15:00:00Z,ST MARKS FL,0,3,0,0,3
Tropical Storm,Mitch,49,1998-11-04T15:00:00Z,FT PIERCE FL,1,23,1,0,25
Tropical Storm,Mitch,49,1998-11-04T15:00:00Z,APALACHICOLA FL,1,1,0,0,2
Tropical Storm,Mitch,49,1998-11-04T15:00:00Z,COCOA BEACH FL,1,20,2,0,23
Tropical Storm,Mitch,49,1998-11-04T15:00:00Z,GULF 29N 85W,1,3,0,0,4
Tropical Storm,Mitch,49,1998-11-04T15:00:00Z,DAYTONA BEACH FL,0,16,2,0,18
Tropical Storm,Mitch,50,1998-11-04T21:00:00Z,28.0N  78.5W,30,6,0,0,36
Tropical Storm,Mitch,50,1998-11-04T21:00:00Z,DAYTONA BEACH FL,9,2,0,0,11
Tropical Storm,Mitch,50,1998-11-04T21:00:00Z,31.0N  73.0W,0,19,6,0,25
Tropical Storm,Mitch,50,1998-11-04T21:00:00Z,CAPE HATTERAS NC,0,1,1,0,2
Tropical Storm,Mitch,50,1998-11-04T21:00:00Z,34.0N  67.0W,0,0,15,3,18
Tropical Storm,Mitch,50,1998-11-04T21:00:00Z,HALIFAX NS,0,0,0,2,2
Tropical Storm,Mitch,50,1998-11-04T21:00:00Z,MUHA 230N 824W,6,0,0,0,6
Tropical Storm,Mitch,50,1998-11-04T21:00:00Z,SABLE ISLAND NS,0,0,0,4,4
Tropical Storm,Mitch,50,1998-11-04T21:00:00Z,MUAN 219N 850W,7,0,0,0,7
Tropical Storm,Mitch,50,1998-11-04T21:00:00Z,SYDNEY NS,0,0,0,2,2
Tropical Storm,Mitch,50,1998-11-04T21:00:00Z,MYAK 241N 776W,4,2,0,0,6
Tropical Storm,Mitch,50,1998-11-04T21:00:00Z,EDDY POINT NS,0,0,0,2,2
Tropical Storm,Mitch,50,1998-11-04T21:00:00Z,MYNN 251N 775W,9,6,0,0,15
Tropical Storm,Mitch,50,1998-11-04T21:00:00Z,ILE ST PIERRE,0,0,0,2,2
Tropical Storm,Mitch,50,1998-11-04T21:00:00Z,MYGF 266N 787W,34,3,0,0,37
Tropical Storm,Mitch,50,1998-11-04T21:00:00Z,CAPE RACE NFLD,0,0,0,2,2
Tropical Storm,Mitch,50,1998-11-04T21:00:00Z,BERMUDA,0,0,7,7,14
Tropical Storm,Mitch,50,1998-11-04T21:00:00Z,KEY WEST FL,51,0,0,0,51
Tropical Storm,Mitch,50,1998-11-04T21:00:00Z,MARATHON FL,42,0,0,0,42
Tropical Storm,Mitch,50,1998-11-04T21:00:00Z,MARCO ISLAND FL,63,0,0,0,63
Tropical Storm,Mitch,50,1998-11-04T21:00:00Z,MIAMI FL,47,0,0,0,47
Tropical Storm,Mitch,50,1998-11-04T21:00:00Z,FT MYERS FL,53,0,0,0,53
Tropical Storm,Mitch,50,1998-11-04T21:00:00Z,W PALM BEACH FL,47,0,0,0,47
Tropical Storm,Mitch,50,1998-11-04T21:00:00Z,VENICE FL,31,0,0,0,31
Tropical Storm,Mitch,50,1998-11-04T21:00:00Z,FT PIERCE FL,40,1,0,0,41
Tropical Storm,Mitch,50,1998-11-04T21:00:00Z,TAMPA FL,11,0,0,0,11
Tropical Storm,Mitch,50,1998-11-04T21:00:00Z,COCOA BEACH FL,29,1,0,0,30
Tropical Storm,Mitch,51,1998-11-05T03:00:00Z,30.5N  75.5W,26,8,0,0,34
Tropical Storm,Mitch,51,1998-11-05T03:00:00Z,COCOA BEACH FL,40,0,0,0,40
Tropical Storm,Mitch,51,1998-11-05T03:00:00Z,34.0N  70.0W,0,21,9,0,30
Tropical Storm,Mitch,51,1998-11-05T03:00:00Z,DAYTONA BEACH FL,9,0,0,0,9
Tropical Storm,Mitch,51,1998-11-05T03:00:00Z,38.0N  62.0W,0,0,18,0,18
Tropical Storm,Mitch,51,1998-11-05T03:00:00Z,MOREHEAD CITY NC,1,1,1,0,3
Tropical Storm,Mitch,51,1998-11-05T03:00:00Z,MYNN 251N 775W,4,0,0,0,4
Tropical Storm,Mitch,51,1998-11-05T03:00:00Z,CAPE HATTERAS NC,0,3,0,0,3
Tropical Storm,Mitch,51,1998-11-05T03:00:00Z,MYGF 266N 787W,42,0,0,0,42
Tropical Storm,Mitch,51,1998-11-05T03:00:00Z,KEY WEST FL,35,0,0,0,35
Tropical Storm,Mitch,51,1998-11-05T03:00:00Z,BERMUDA,0,1,7,0,8
Tropical Storm,Mitch,51,1998-11-05T03:00:00Z,MARCO ISLAND FL,79,0,0,0,79
Tropical Storm,Mitch,51,1998-11-05T03:00:00Z,MARATHON FL,25,0,0,0,25
Tropical Storm,Mitch,51,1998-11-05T03:00:00Z,FT MYERS FL,73,0,0,0,73
Tropical Storm,Mitch,51,1998-11-05T03:00:00Z,MIAMI FL,50,0,0,0,50
Tropical Storm,Mitch,51,1998-11-05T03:00:00Z,VENICE FL,40,0,0,0,40
Tropical Storm,Mitch,51,1998-11-05T03:00:00Z,W PALM BEACH FL,65,0,0,0,65
Tropical Storm,Mitch,51,1998-11-05T03:00:00Z,TAMPA FL,10,0,0,0,10
Tropical Storm,Mitch,51,1998-11-05T03:00:00Z,FT PIERCE FL,61,0,0,0,61
Tropical Storm,Mitch,52,1998-11-05T09:00:00Z,29.6N  73.7W,17,7,0,0,24
Tropical Storm,Mitch,52,1998-11-05T09:00:00Z,MIAMI FL,84,0,0,0,84
Tropical Storm,Mitch,52,1998-11-05T09:00:00Z,32.6N  67.4W,0,13,6,0,19
Tropical Storm,Mitch,52,1998-11-05T09:00:00Z,W PALM BEACH FL,71,0,0,0,71
Tropical Storm,Mitch,52,1998-11-05T09:00:00Z,36.0N  60.0W,0,0,11,0,11
Tropical Storm,Mitch,52,1998-11-05T09:00:00Z,FT PIERCE FL,41,0,0,0,41
Tropical Storm,Mitch,52,1998-11-05T09:00:00Z,MYSM 241N 745W,7,1,0,0,8
Tropical Storm,Mitch,52,1998-11-05T09:00:00Z,COCOA BEACH FL,14,0,0,0,14
Tropical Storm,Mitch,52,1998-11-05T09:00:00Z,MYEG 235N 758W,5,0,0,0,5
Tropical Storm,Mitch,52,1998-11-05T09:00:00Z,DAYTONA BEACH FL,2,0,0,0,2
Tropical Storm,Mitch,52,1998-11-05T09:00:00Z,MYAK 241N 776W,13,0,0,0,13
Tropical Storm,Mitch,52,1998-11-05T09:00:00Z,KEY WEST FL,75,0,0,0,75
Tropical Storm,Mitch,52,1998-11-05T09:00:00Z,MYNN 251N 775W,39,0,0,0,39
Tropical Storm,Mitch,52,1998-11-05T09:00:00Z,MARCO ISLAND FL,99,0,0,0,99
Tropical Storm,Mitch,52,1998-11-05T09:00:00Z,MYGF 266N 787W,67,0,0,0,67
Tropical Storm,Mitch,52,1998-11-05T09:00:00Z,FT MYERS FL,54,0,0,0,54
Tropical Storm,Mitch,52,1998-11-05T09:00:00Z,BERMUDA,0,4,13,0,17
Tropical Storm,Mitch,52,1998-11-05T09:00:00Z,VENICE FL,10,0,0,0,10
Tropical Storm,Mitch,52,1998-11-05T09:00:00Z,MARATHON FL,75,0,0,0,75
Tropical Storm,Mitch,53,1998-11-05T15:00:00Z,33.4N  69.1W,21,7,0,0,28
Tropical Storm,Mitch,53,1998-11-05T15:00:00Z,FT PIERCE FL,99,0,0,0,99
Tropical Storm,Mitch,53,1998-11-05T15:00:00Z,37.0N  61.1W,0,13,6,0,19
Tropical Storm,Mitch,53,1998-11-05T15:00:00Z,COCOA BEACH FL,16,0,0,0,16
Tropical Storm,Mitch,53,1998-11-05T15:00:00Z,39.6N  51.6W,0,0,9,0,9
Tropical Storm,Mitch,53,1998-11-05T15:00:00Z,SABLE ISLAND NS,0,0,3,0,3
Tropical Storm,Mitch,53,1998-11-05T15:00:00Z,MYGF 266N 787W,58,0,0,0,58
Tropical Storm,Mitch,53,1998-11-05T15:00:00Z,MARCO ISLAND FL,99,0,0,0,99
Tropical Storm,Mitch,53,1998-11-05T15:00:00Z,BERMUDA,1,14,0,0,15
Tropical Storm,Mitch,53,1998-11-05T15:00:00Z,FT MYERS FL,99,0,0,0,99
Tropical Storm,Mitch,53,1998-11-05T15:00:00Z,MIAMI FL,40,0,0,0,40
Tropical Storm,Mitch,53,1998-11-05T15:00:00Z,VENICE FL,5,0,0,0,5
Tropical Storm,Mitch,53,1998-11-05T15:00:00Z,W PALM BEACH FL,99,0,0,0,99
Tropical Storm,Nicole,1,1998-11-24T12:00:00Z,27.0N  33.5W,34,0,0,0,34
Tropical Storm,Nicole,1,1998-11-24T12:00:00Z,26.0N  37.0W,8,10,2,1,21
Tropical Storm,Nicole,1,1998-11-24T12:00:00Z,26.2N  35.6W,19,3,1,1,24
Tropical Storm,Nicole,2,1998-11-24T15:00:00Z,26.7N  35.0W,28,0,0,1,29
Tropical Storm,Nicole,2,1998-11-24T15:00:00Z,26.5N  37.5W,9,7,2,2,20
Tropical Storm,Nicole,2,1998-11-24T15:00:00Z,26.5N  36.5W,17,3,1,1,22
Tropical Storm,Nicole,3,1998-11-24T21:00:00Z,26.0N  35.0W,28,1,0,0,29
Tropical Storm,Nicole,3,1998-11-24T21:00:00Z,26.5N  38.0W,4,9,4,2,19
Tropical Storm,Nicole,3,1998-11-24T21:00:00Z,26.0N  36.5W,17,3,1,1,22
Tropical Storm,Nicole,4,1998-11-25T03:00:00Z,26.0N  35.7W,31,1,0,0,32
Tropical Storm,Nicole,4,1998-11-25T03:00:00Z,26.9N  38.6W,6,9,3,1,19
Tropical Storm,Nicole,4,1998-11-25T03:00:00Z,26.2N  37.2W,19,2,1,1,23
Tropical Storm,Nicole,5,1998-11-25T09:00:00Z,25.7N  37.6W,29,1,0,0,30
Tropical Storm,Nicole,5,1998-11-25T09:00:00Z,26.5N  40.0W,7,7,3,2,19
Tropical Storm,Nicole,5,1998-11-25T09:00:00Z,25.8N  38.5W,21,1,1,1,24
Tropical Storm,Nicole,6,1998-11-25T15:00:00Z,25.3N  37.2W,32,0,0,0,32
Tropical Storm,Nicole,6,1998-11-25T15:00:00Z,25.5N  40.0W,8,8,2,2,20
Tropical Storm,Nicole,6,1998-11-25T15:00:00Z,25.3N  38.8W,19,3,1,0,23
Tropical Storm,Nicole,7,1998-11-25T21:00:00Z,25.5N  38.0W,32,1,0,0,33
Tropical Storm,Nicole,7,1998-11-25T21:00:00Z,26.0N  41.0W,8,8,2,2,20
Tropical Storm,Nicole,7,1998-11-25T21:00:00Z,25.5N  39.5W,21,2,0,1,24
Tropical Storm,Nicole,8,1998-11-26T03:00:00Z,25.3N  39.0W,33,0,0,0,33
Tropical Storm,Nicole,8,1998-11-26T03:00:00Z,26.5N  43.0W,2,12,2,2,18
Tropical Storm,Nicole,8,1998-11-26T03:00:00Z,25.7N  41.0W,16,4,1,1,22
Tropical Depression,Nicole,9,1998-11-26T09:00:00Z,25.4N  40.3W,31,0,0,0,31
Tropical Depression,Nicole,9,1998-11-26T09:00:00Z,26.0N  42.0W,16,3,0,0,19
Tropical Depression,Nicole,11,1998-11-27T15:00:00Z,26.6N  45.7W,34,0,0,0,34
Tropical Depression,Nicole,11,1998-11-27T15:00:00Z,30.0N  47.7W,1,10,4,3,18
Tropical Depression,Nicole,11,1998-11-27T15:00:00Z,28.0N  47.3W,15,6,1,0,22
Tropical Storm,Nicole,12,1998-11-27T21:00:00Z,27.5N  45.8W,27,1,0,0,28
Tropical Storm,Nicole,12,1998-11-27T21:00:00Z,30.7N  45.6W,1,9,4,3,17
Tropical Storm,Nicole,12,1998-11-27T21:00:00Z,29.0N  46.0W,12,5,2,1,20
Tropical Storm,Nicole,13,1998-11-28T03:00:00Z,28.0N  48.0W,28,0,0,1,29
Tropical Storm,Nicole,13,1998-11-28T03:00:00Z,31.0N  47.0W,4,9,3,2,18
Tropical Storm,Nicole,13,1998-11-28T03:00:00Z,29.5N  47.0W,16,3,1,1,21
Tropical Storm,Nicole,14,1998-11-28T09:00:00Z,28.0N  47.5W,53,0,0,0,53
Tropical Storm,Nicole,14,1998-11-28T09:00:00Z,30.5N  47.0W,8,7,2,2,19
Tropical Storm,Nicole,14,1998-11-28T09:00:00Z,29.0N  47.5W,27,1,1,0,29
Tropical Storm,Nicole,15,1998-11-28T15:00:00Z,32.5N  45.0W,23,4,0,0,27
Tropical Storm,Nicole,15,1998-11-28T15:00:00Z,36.5N  39.8W,0,4,9,3,16
Tropical Storm,Nicole,15,1998-11-28T15:00:00Z,34.5N  42.3W,1,16,2,1,20
Tropical Storm,Nicole,16,1998-11-28T21:00:00Z,31.7N  44.9W,15,3,1,0,19
Tropical Storm,Nicole,16,1998-11-28T21:00:00Z,35.0N  40.0W,0,4,5,3,12
Tropical Storm,Nicole,16,1998-11-28T21:00:00Z,33.3N  42.6W,2,9,2,2,15
Tropical Storm,Nicole,17,1998-11-29T03:00:00Z,31.5N  44.5W,26,1,0,1,28
Tropical Storm,Nicole,17,1998-11-29T03:00:00Z,32.8N  41.6W,4,8,3,3,18
Tropical Storm,Nicole,17,1998-11-29T03:00:00Z,32.3N  43.0W,13,5,1,2,21
Tropical Storm,Nicole,18,1998-11-29T09:00:00Z,32.3N  43.3W,23,2,0,1,26
Tropical Storm,Nicole,18,1998-11-29T09:00:00Z,33.5N  40.5W,5,7,3,2,17
Tropical Storm,Nicole,18,1998-11-29T09:00:00Z,33.0N  42.0W,14,3,2,1,20
Tropical Storm,Nicole,19,1998-11-29T15:00:00Z,33.0N  41.1W,19,2,0,1,22
Tropical Storm,Nicole,19,1998-11-29T15:00:00Z,34.0N  37.2W,1,7,4,3,15
Tropical Storm,Nicole,19,1998-11-29T15:00:00Z,33.5N  39.2W,9,5,2,1,17
Tropical Storm,Nicole,20,1998-11-29T21:00:00Z,36.6N  36.4W,23,2,0,0,25
Tropical Storm,Nicole,20,1998-11-29T21:00:00Z,40.4N  27.4W,0,5,9,2,16
Tropical Storm,Nicole,20,1998-11-29T21:00:00Z,38.6N  32.1W,1,17,1,1,20
Hurricane,Nicole,21,1998-11-30T03:00:00Z,35.4N  37.2W,22,1,1,0,24
Hurricane,Nicole,21,1998-11-30T03:00:00Z,39.5N  31.1W,0,6,7,2,15
Hurricane,Nicole,21,1998-11-30T03:00:00Z,37.4N  34.4W,4,12,2,0,18
Hurricane,Nicole,22,1998-11-30T09:00:00Z,36.5N  36.5W,23,1,0,0,24
Hurricane,Nicole,22,1998-11-30T09:00:00Z,43.0N  32.0W,0,5,9,2,16
Hurricane,Nicole,22,1998-11-30T09:00:00Z,39.0N  33.5W,2,15,1,0,18
Hurricane,Nicole,23,1998-11-30T15:00:00Z,37.2N  34.2W,23,2,0,0,25
Hurricane,Nicole,23,1998-11-30T15:00:00Z,45.0N  31.5W,0,3,11,2,16
Hurricane,Nicole,23,1998-11-30T15:00:00Z,40.6N  31.9W,1,16,2,0,19
Hurricane,Nicole,23,1998-11-30T15:00:00Z,HIBERNIA OILFLD,0,0,0,2,2
Tropical Depression,One,1,1999-06-11T21:00:00Z,29.1N  56.1W,37,0,1,0,38
Tropical Depression,One,1,1999-06-11T21:00:00Z,29.5N  56.0W,30,0,1,0,31
Tropical Depression,One,1,1999-06-11T21:00:00Z,29.3N  56.1W,35,0,0,0,35
Tropical Depression,One,1,1999-06-11T21:00:00Z,BERMUDA,0,0,1,5,6
Tropical Depression,One,2,1999-06-12T03:00:00Z,29.4N  55.9W,41,0,0,1,42
Tropical Depression,One,2,1999-06-12T03:00:00Z,30.2N  56.2W,23,2,1,1,27
Tropical Depression,One,2,1999-06-12T03:00:00Z,29.9N  56.0W,29,1,1,0,31
Tropical Depression,One,2,1999-06-12T03:00:00Z,BERMUDA,0,0,1,5,6
Tropical Depression,One,3,1999-06-12T09:00:00Z,29.0N  57.0W,99,0,0,0,99
Tropical Depression,One,3,1999-06-12T09:00:00Z,29.8N  57.0W,35,0,0,1,36
Tropical Depression,One,3,1999-06-12T09:00:00Z,29.4N  57.0W,49,0,0,0,49
Tropical Depression,One,3,1999-06-12T09:00:00Z,BERMUDA,0,0,0,5,5
Tropical Storm,Arlene,4,1999-06-12T15:00:00Z,29.2N  57.8W,99,0,0,0,99
Tropical Storm,Arlene,4,1999-06-12T15:00:00Z,30.0N  58.5W,30,1,0,1,32
Tropical Storm,Arlene,4,1999-06-12T15:00:00Z,29.6N  58.0W,45,0,0,0,45
Tropical Storm,Arlene,4,1999-06-12T15:00:00Z,BERMUDA,0,0,3,6,9
Tropical Storm,Arlene,5,1999-06-12T21:00:00Z,29.4N  57.7W,99,0,0,0,99
Tropical Storm,Arlene,5,1999-06-12T21:00:00Z,30.3N  58.3W,28,1,0,1,30
Tropical Storm,Arlene,5,1999-06-12T21:00:00Z,29.8N  57.9W,43,0,0,0,43
Tropical Storm,Arlene,5,1999-06-12T21:00:00Z,BERMUDA,0,0,3,7,10
Tropical Storm,Arlene,6,1999-06-13T03:00:00Z,29.8N  57.7W,99,0,0,0,99
Tropical Storm,Arlene,6,1999-06-13T03:00:00Z,30.4N  58.6W,35,1,0,0,36
Tropical Storm,Arlene,6,1999-06-13T03:00:00Z,30.2N  58.1W,58,0,0,0,58
Tropical Storm,Arlene,6,1999-06-13T03:00:00Z,BERMUDA,0,0,4,6,10
Tropical Storm,Arlene,7,1999-06-13T09:00:00Z,29.6N  57.6W,99,0,0,0,99
Tropical Storm,Arlene,7,1999-06-13T09:00:00Z,30.4N  58.3W,32,1,0,0,33
Tropical Storm,Arlene,7,1999-06-13T09:00:00Z,30.0N  57.8W,99,0,0,0,99
Tropical Storm,Arlene,7,1999-06-13T09:00:00Z,BERMUDA,0,0,1,7,8
Tropical Storm,Arlene,8,1999-06-13T15:00:00Z,29.6N  59.0W,99,0,0,0,99
Tropical Storm,Arlene,8,1999-06-13T15:00:00Z,30.2N  60.0W,35,0,0,0,35
Tropical Storm,Arlene,8,1999-06-13T15:00:00Z,29.9N  59.4W,75,0,0,0,75
Tropical Storm,Arlene,8,1999-06-13T15:00:00Z,BERMUDA,0,2,5,7,14
Tropical Storm,Arlene,9,1999-06-13T21:00:00Z,29.6N  60.1W,99,0,0,0,99
Tropical Storm,Arlene,9,1999-06-13T21:00:00Z,30.4N  61.2W,39,0,0,0,39
Tropical Storm,Arlene,9,1999-06-13T21:00:00Z,30.0N  60.7W,55,0,0,0,55
Tropical Storm,Arlene,9,1999-06-13T21:00:00Z,BERMUDA,2,7,5,4,18
Tropical Storm,Arlene,10,1999-06-14T03:00:00Z,29.8N  61.2W,49,0,0,0,49
Tropical Storm,Arlene,10,1999-06-14T03:00:00Z,BERMUDA,0,3,8,5,16
Tropical Storm,Arlene,10,1999-06-14T03:00:00Z,30.3N  61.8W,39,0,1,0,40
Tropical Storm,Arlene,10,1999-06-14T03:00:00Z,CAPE HATTERAS NC,0,0,0,2,2
Tropical Storm,Arlene,10,1999-06-14T03:00:00Z,31.0N  62.5W,19,5,1,1,26
Tropical Storm,Arlene,11,1999-06-14T09:00:00Z,29.7N  61.9W,50,0,0,0,50
Tropical Storm,Arlene,11,1999-06-14T09:00:00Z,MOREHEAD CITY NC,0,0,0,2,2
Tropical Storm,Arlene,11,1999-06-14T09:00:00Z,30.5N  62.8W,32,2,0,0,34
Tropical Storm,Arlene,11,1999-06-14T09:00:00Z,CAPE HATTERAS NC,0,0,0,3,3
Tropical Storm,Arlene,11,1999-06-14T09:00:00Z,31.5N  63.5W,9,11,2,1,23
Tropical Storm,Arlene,11,1999-06-14T09:00:00Z,NORFOLK VA,0,0,0,2,2
Tropical Storm,Arlene,11,1999-06-14T09:00:00Z,BERMUDA,0,8,7,3,18
Tropical Storm,Arlene,11,1999-06-14T09:00:00Z,OCEAN CITY MD,0,0,0,2,2
Tropical Storm,Arlene,11,1999-06-14T09:00:00Z,WILMINGTON NC,0,0,0,2,2
Tropical Storm,Arlene,12,1999-06-14T15:00:00Z,30.1N  62.4W,53,0,0,0,53
Tropical Storm,Arlene,12,1999-06-14T15:00:00Z,OCEAN CITY MD,0,0,0,3,3
Tropical Storm,Arlene,12,1999-06-14T15:00:00Z,30.9N  63.1W,40,1,0,0,41
Tropical Storm,Arlene,12,1999-06-14T15:00:00Z,ATLANTIC CITY NJ,0,0,0,2,2
Tropical Storm,Arlene,12,1999-06-14T15:00:00Z,32.0N  63.5W,14,7,2,1,24
Tropical Storm,Arlene,12,1999-06-14T15:00:00Z,NEW YORK CITY NY,0,0,0,2,2
Tropical Storm,Arlene,12,1999-06-14T15:00:00Z,BERMUDA,3,10,5,2,20
Tropical Storm,Arlene,12,1999-06-14T15:00:00Z,MONTAUK POINT NY,0,0,0,2,2
Tropical Storm,Arlene,12,1999-06-14T15:00:00Z,MOREHEAD CITY NC,0,0,0,2,2
Tropical Storm,Arlene,12,1999-06-14T15:00:00Z,PROVIDENCE RI,0,0,0,2,2
Tropical Storm,Arlene,12,1999-06-14T15:00:00Z,CAPE HATTERAS NC,0,0,0,3,3
Tropical Storm,Arlene,12,1999-06-14T15:00:00Z,NANTUCKET MA,0,0,0,2,2
Tropical Storm,Arlene,12,1999-06-14T15:00:00Z,NORFOLK VA,0,0,0,2,2
Tropical Storm,Arlene,12,1999-06-14T15:00:00Z,HYANNIS MA,0,0,0,2,2
Tropical Storm,Arlene,13,1999-06-14T21:00:00Z,31.0N  62.4W,47,0,0,0,47
Tropical Storm,Arlene,13,1999-06-14T21:00:00Z,NEW YORK CITY NY,0,0,0,3,3
Tropical Storm,Arlene,13,1999-06-14T21:00:00Z,31.8N  63.1W,35,0,1,0,36
Tropical Storm,Arlene,13,1999-06-14T21:00:00Z,MONTAUK POINT NY,0,0,0,4,4
Tropical Storm,Arlene,13,1999-06-14T21:00:00Z,32.5N  63.5W,18,6,1,1,26
Tropical Storm,Arlene,13,1999-06-14T21:00:00Z,PROVIDENCE RI,0,0,0,3,3
Tropical Storm,Arlene,13,1999-06-14T21:00:00Z,BERMUDA,7,13,2,2,24
Tropical Storm,Arlene,13,1999-06-14T21:00:00Z,NANTUCKET MA,0,0,0,4,4
Tropical Storm,Arlene,13,1999-06-14T21:00:00Z,CAPE HATTERAS NC,0,0,0,2,2
Tropical Storm,Arlene,13,1999-06-14T21:00:00Z,HYANNIS MA,0,0,0,4,4
Tropical Storm,Arlene,13,1999-06-14T21:00:00Z,NORFOLK VA,0,0,0,2,2
Tropical Storm,Arlene,13,1999-06-14T21:00:00Z,BOSTON MA,0,0,0,3,3
Tropical Storm,Arlene,13,1999-06-14T21:00:00Z,OCEAN CITY MD,0,0,0,3,3
Tropical Storm,Arlene,13,1999-06-14T21:00:00Z,PORTLAND ME,0,0,0,2,2
Tropical Storm,Arlene,13,1999-06-14T21:00:00Z,ATLANTIC CITY NJ,0,0,0,3,3
Tropical Storm,Arlene,14,1999-06-15T03:00:00Z,31.0N  62.6W,45,0,1,0,46
Tropical Storm,Arlene,14,1999-06-15T03:00:00Z,MONTAUK POINT NY,0,0,0,4,4
Tropical Storm,Arlene,14,1999-06-15T03:00:00Z,31.7N  63.0W,36,0,0,0,36
Tropical Storm,Arlene,14,1999-06-15T03:00:00Z,PROVIDENCE RI,0,0,0,4,4
Tropical Storm,Arlene,14,1999-06-15T03:00:00Z,32.5N  63.5W,18,6,1,1,26
Tropical Storm,Arlene,14,1999-06-15T03:00:00Z,NANTUCKET MA,0,0,0,5,5
Tropical Storm,Arlene,14,1999-06-15T03:00:00Z,BERMUDA,8,11,3,1,23
Tropical Storm,Arlene,14,1999-06-15T03:00:00Z,HYANNIS MA,0,0,0,5,5
Tropical Storm,Arlene,14,1999-06-15T03:00:00Z,CAPE HATTERAS NC,0,0,0,2,2
Tropical Storm,Arlene,14,1999-06-15T03:00:00Z,BOSTON MA,0,0,0,4,4
Tropical Storm,Arlene,14,1999-06-15T03:00:00Z,NORFOLK VA,0,0,0,2,2
Tropical Storm,Arlene,14,1999-06-15T03:00:00Z,PORTLAND ME,0,0,0,3,3
Tropical Storm,Arlene,14,1999-06-15T03:00:00Z,OCEAN CITY MD,0,0,0,3,3
Tropical Storm,Arlene,14,1999-06-15T03:00:00Z,BAR HARBOR ME,0,0,0,2,2
Tropical Storm,Arlene,14,1999-06-15T03:00:00Z,ATLANTIC CITY NJ,0,0,0,3,3
Tropical Storm,Arlene,14,1999-06-15T03:00:00Z,EASTPORT ME,0,0,0,2,2
Tropical Storm,Arlene,14,1999-06-15T03:00:00Z,NEW YORK CITY NY,0,0,0,4,4
Tropical Storm,Arlene,14,1999-06-15T03:00:00Z,YARMOUTH NS,0,0,0,2,2
Tropical Storm,Arlene,15,1999-06-15T09:00:00Z,30.4N  63.3W,57,0,0,0,57
Tropical Storm,Arlene,15,1999-06-15T09:00:00Z,ATLANTIC CITY NJ,0,0,0,5,5
Tropical Storm,Arlene,15,1999-06-15T09:00:00Z,31.4N  64.3W,31,4,0,0,35
Tropical Storm,Arlene,15,1999-06-15T09:00:00Z,NEW YORK CITY NY,0,0,0,4,4
Tropical Storm,Arlene,15,1999-06-15T09:00:00Z,33.0N  65.0W,3,13,5,1,22
Tropical Storm,Arlene,15,1999-06-15T09:00:00Z,MONTAUK POINT NY,0,0,0,4,4
Tropical Storm,Arlene,15,1999-06-15T09:00:00Z,BERMUDA,10,13,1,1,25
Tropical Storm,Arlene,15,1999-06-15T09:00:00Z,PROVIDENCE RI,0,0,0,4,4
Tropical Storm,Arlene,15,1999-06-15T09:00:00Z,WILMINGTON NC,0,0,0,2,2
Tropical Storm,Arlene,15,1999-06-15T09:00:00Z,NANTUCKET MA,0,0,0,4,4
Tropical Storm,Arlene,15,1999-06-15T09:00:00Z,MOREHEAD CITY NC,0,0,0,3,3
Tropical Storm,Arlene,15,1999-06-15T09:00:00Z,HYANNIS MA,0,0,0,4,4
Tropical Storm,Arlene,15,1999-06-15T09:00:00Z,CAPE HATTERAS NC,0,0,0,5,5
Tropical Storm,Arlene,15,1999-06-15T09:00:00Z,BOSTON MA,0,0,0,3,3
Tropical Storm,Arlene,15,1999-06-15T09:00:00Z,NORFOLK VA,0,0,0,4,4
Tropical Storm,Arlene,15,1999-06-15T09:00:00Z,PORTLAND ME,0,0,0,2,2
Tropical Storm,Arlene,15,1999-06-15T09:00:00Z,OCEAN CITY MD,0,0,0,5,5
Tropical Storm,Arlene,16,1999-06-15T15:00:00Z,30.1N  62.0W,99,0,0,0,99
Tropical Storm,Arlene,16,1999-06-15T15:00:00Z,ATLANTIC CITY NJ,0,0,0,4,4
Tropical Storm,Arlene,16,1999-06-15T15:00:00Z,30.9N  63.1W,32,3,0,0,35
Tropical Storm,Arlene,16,1999-06-15T15:00:00Z,NEW YORK CITY NY,0,0,0,4,4
Tropical Storm,Arlene,16,1999-06-15T15:00:00Z,32.0N  64.0W,5,15,2,2,24
Tropical Storm,Arlene,16,1999-06-15T15:00:00Z,MONTAUK POINT NY,0,0,0,4,4
Tropical Storm,Arlene,16,1999-06-15T15:00:00Z,BERMUDA,1,14,4,2,21
Tropical Storm,Arlene,16,1999-06-15T15:00:00Z,PROVIDENCE RI,0,0,0,4,4
Tropical Storm,Arlene,16,1999-06-15T15:00:00Z,MOREHEAD CITY NC,0,0,0,2,2
Tropical Storm,Arlene,16,1999-06-15T15:00:00Z,NANTUCKET MA,0,0,0,4,4
Tropical Storm,Arlene,16,1999-06-15T15:00:00Z,CAPE HATTERAS NC,0,0,0,3,3
Tropical Storm,Arlene,16,1999-06-15T15:00:00Z,HYANNIS MA,0,0,0,4,4
Tropical Storm,Arlene,16,1999-06-15T15:00:00Z,NORFOLK VA,0,0,0,3,3
Tropical Storm,Arlene,16,1999-06-15T15:00:00Z,BOSTON MA,0,0,0,3,3
Tropical Storm,Arlene,16,1999-06-15T15:00:00Z,OCEAN CITY MD,0,0,0,4,4
Tropical Storm,Arlene,16,1999-06-15T15:00:00Z,PORTLAND ME,0,0,0,2,2
Tropical Storm,Arlene,17,1999-06-15T21:00:00Z,30.9N  62.4W,56,0,0,0,56
Tropical Storm,Arlene,17,1999-06-15T21:00:00Z,HYANNIS MA,0,0,0,5,5
Tropical Storm,Arlene,17,1999-06-15T21:00:00Z,31.8N  63.1W,31,2,1,0,34
Tropical Storm,Arlene,17,1999-06-15T21:00:00Z,BOSTON MA,0,0,0,4,4
Tropical Storm,Arlene,17,1999-06-15T21:00:00Z,33.0N  64.0W,2,16,3,2,23
Tropical Storm,Arlene,17,1999-06-15T21:00:00Z,PORTLAND ME,0,0,0,3,3
Tropical Storm,Arlene,17,1999-06-15T21:00:00Z,BERMUDA,3,18,3,1,25
Tropical Storm,Arlene,17,1999-06-15T21:00:00Z,BAR HARBOR ME,0,0,0,3,3
Tropical Storm,Arlene,17,1999-06-15T21:00:00Z,NEW YORK CITY NY,0,0,0,2,2
Tropical Storm,Arlene,17,1999-06-15T21:00:00Z,EASTPORT ME,0,0,0,3,3
Tropical Storm,Arlene,17,1999-06-15T21:00:00Z,MONTAUK POINT NY,0,0,0,4,4
Tropical Storm,Arlene,17,1999-06-15T21:00:00Z,ST JOHN NB,0,0,0,2,2
Tropical Storm,Arlene,17,1999-06-15T21:00:00Z,PROVIDENCE RI,0,0,0,4,4
Tropical Storm,Arlene,17,1999-06-15T21:00:00Z,YARMOUTH NS,0,0,0,4,4
Tropical Storm,Arlene,17,1999-06-15T21:00:00Z,NANTUCKET MA,0,0,0,5,5
Tropical Storm,Arlene,17,1999-06-15T21:00:00Z,HALIFAX NS,0,0,0,2,2
Tropical Storm,Arlene,18,1999-06-16T03:00:00Z,31.1N  63.5W,50,0,0,0,50
Tropical Storm,Arlene,18,1999-06-16T03:00:00Z,PROVIDENCE RI,0,0,0,6,6
Tropical Storm,Arlene,18,1999-06-16T03:00:00Z,32.2N  63.9W,31,3,0,0,34
Tropical Storm,Arlene,18,1999-06-16T03:00:00Z,NANTUCKET MA,0,0,0,6,6
Tropical Storm,Arlene,18,1999-06-16T03:00:00Z,33.5N  64.5W,7,13,2,1,23
Tropical Storm,Arlene,18,1999-06-16T03:00:00Z,HYANNIS MA,0,0,0,6,6
Tropical Storm,Arlene,18,1999-06-16T03:00:00Z,BERMUDA,22,8,0,1,31
Tropical Storm,Arlene,18,1999-06-16T03:00:00Z,BOSTON MA,0,0,0,5,5
Tropical Storm,Arlene,18,1999-06-16T03:00:00Z,MOREHEAD CITY NC,0,0,0,2,2
Tropical Storm,Arlene,18,1999-06-16T03:00:00Z,PORTLAND ME,0,0,0,4,4
Tropical Storm,Arlene,18,1999-06-16T03:00:00Z,CAPE HATTERAS NC,0,0,0,3,3
Tropical Storm,Arlene,18,1999-06-16T03:00:00Z,BAR HARBOR ME,0,0,0,3,3
Tropical Storm,Arlene,18,1999-06-16T03:00:00Z,NORFOLK VA,0,0,0,3,3
Tropical Storm,Arlene,18,1999-06-16T03:00:00Z,EASTPORT ME,0,0,0,3,3
Tropical Storm,Arlene,18,1999-06-16T03:00:00Z,OCEAN CITY MD,0,0,0,4,4
Tropical Storm,Arlene,18,1999-06-16T03:00:00Z,ST JOHN NB,0,0,0,2,2
Tropical Storm,Arlene,18,1999-06-16T03:00:00Z,ATLANTIC CITY NJ,0,0,0,4,4
Tropical Storm,Arlene,18,1999-06-16T03:00:00Z,YARMOUTH NS,0,0,0,4,4
Tropical Storm,Arlene,18,1999-06-16T03:00:00Z,NEW YORK CITY NY,0,0,0,5,5
Tropical Storm,Arlene,18,1999-06-16T03:00:00Z,HALIFAX NS,0,0,0,2,2
Tropical Storm,Arlene,18,1999-06-16T03:00:00Z,MONTAUK POINT NY,0,0,0,6,6
Tropical Storm,Arlene,18,1999-06-16T03:00:00Z,SABLE ISLAND NS,0,0,0,2,2
Tropical Storm,Arlene,19,1999-06-16T06:00:00Z,31.1N  63.5W,50,0,0,0,50
Tropical Storm,Arlene,19,1999-06-16T06:00:00Z,PROVIDENCE RI,0,0,0,6,6
Tropical Storm,Arlene,19,1999-06-16T06:00:00Z,32.2N  63.9W,31,3,0,0,34
Tropical Storm,Arlene,19,1999-06-16T06:00:00Z,NANTUCKET MA,0,0,0,6,6
Tropical Storm,Arlene,19,1999-06-16T06:00:00Z,33.5N  64.5W,7,13,2,1,23
Tropical Storm,Arlene,19,1999-06-16T06:00:00Z,HYANNIS MA,0,0,0,6,6
Tropical Storm,Arlene,19,1999-06-16T06:00:00Z,BERMUDA,22,8,0,1,31
Tropical Storm,Arlene,19,1999-06-16T06:00:00Z,BOSTON MA,0,0,0,5,5
Tropical Storm,Arlene,19,1999-06-16T06:00:00Z,MOREHEAD CITY NC,0,0,0,2,2
Tropical Storm,Arlene,19,1999-06-16T06:00:00Z,PORTLAND ME,0,0,0,4,4
Tropical Storm,Arlene,19,1999-06-16T06:00:00Z,CAPE HATTERAS NC,0,0,0,3,3
Tropical Storm,Arlene,19,1999-06-16T06:00:00Z,BAR HARBOR ME,0,0,0,3,3
Tropical Storm,Arlene,19,1999-06-16T06:00:00Z,NORFOLK VA,0,0,0,3,3
Tropical Storm,Arlene,19,1999-06-16T06:00:00Z,EASTPORT ME,0,0,0,3,3
Tropical Storm,Arlene,19,1999-06-16T06:00:00Z,OCEAN CITY MD,0,0,0,4,4
Tropical Storm,Arlene,19,1999-06-16T06:00:00Z,ST JOHN NB,0,0,0,2,2
Tropical Storm,Arlene,19,1999-06-16T06:00:00Z,ATLANTIC CITY NJ,0,0,0,4,4
Tropical Storm,Arlene,19,1999-06-16T06:00:00Z,YARMOUTH NS,0,0,0,4,4
Tropical Storm,Arlene,19,1999-06-16T06:00:00Z,NEW YORK CITY NY,0,0,0,5,5
Tropical Storm,Arlene,19,1999-06-16T06:00:00Z,HALIFAX NS,0,0,0,2,2
Tropical Storm,Arlene,19,1999-06-16T06:00:00Z,MONTAUK POINT NY,0,0,0,6,6
Tropical Storm,Arlene,19,1999-06-16T06:00:00Z,SABLE ISLAND NS,0,0,0,2,2
Tropical Storm,Arlene,20,1999-06-16T09:00:00Z,31.6N  64.0W,46,0,0,0,46
Tropical Storm,Arlene,20,1999-06-16T09:00:00Z,PORTLAND ME,0,0,0,8,8
Tropical Storm,Arlene,20,1999-06-16T09:00:00Z,33.4N  64.7W,16,16,0,0,32
Tropical Storm,Arlene,20,1999-06-16T09:00:00Z,BAR HARBOR ME,0,0,0,8,8
Tropical Storm,Arlene,20,1999-06-16T09:00:00Z,36.0N  64.5W,0,6,14,1,21
Tropical Storm,Arlene,20,1999-06-16T09:00:00Z,EASTPORT ME,0,0,0,8,8
Tropical Storm,Arlene,20,1999-06-16T09:00:00Z,BERMUDA,33,6,0,0,39
Tropical Storm,Arlene,20,1999-06-16T09:00:00Z,ST JOHN NB,0,0,0,8,8
Tropical Storm,Arlene,20,1999-06-16T09:00:00Z,OCEAN CITY MD,0,0,0,2,2
Tropical Storm,Arlene,20,1999-06-16T09:00:00Z,MONCTON NB,0,0,0,6,6
Tropical Storm,Arlene,20,1999-06-16T09:00:00Z,ATLANTIC CITY NJ,0,0,0,3,3
Tropical Storm,Arlene,20,1999-06-16T09:00:00Z,YARMOUTH NS,0,0,0,9,9
Tropical Storm,Arlene,20,1999-06-16T09:00:00Z,NEW YORK CITY NY,0,0,0,5,5
Tropical Storm,Arlene,20,1999-06-16T09:00:00Z,HALIFAX NS,0,0,0,8,8
Tropical Storm,Arlene,20,1999-06-16T09:00:00Z,MONTAUK POINT NY,0,0,0,7,7
Tropical Storm,Arlene,20,1999-06-16T09:00:00Z,SABLE ISLAND NS,0,0,0,7,7
Tropical Storm,Arlene,20,1999-06-16T09:00:00Z,PROVIDENCE RI,0,0,0,8,8
Tropical Storm,Arlene,20,1999-06-16T09:00:00Z,SYDNEY NS,0,0,0,4,4
Tropical Storm,Arlene,20,1999-06-16T09:00:00Z,NANTUCKET MA,0,0,0,9,9
Tropical Storm,Arlene,20,1999-06-16T09:00:00Z,EDDY POINT NS,0,0,0,6,6
Tropical Storm,Arlene,20,1999-06-16T09:00:00Z,HYANNIS MA,0,0,0,9,9
Tropical Storm,Arlene,20,1999-06-16T09:00:00Z,PTX BASQUES NFLD,0,0,0,2,2
Tropical Storm,Arlene,20,1999-06-16T09:00:00Z,BOSTON MA,0,0,0,8,8
Tropical Storm,Arlene,21,1999-06-16T15:00:00Z,33.4N  63.2W,41,0,0,0,41
Tropical Storm,Arlene,21,1999-06-16T15:00:00Z,ST JOHN NB,0,0,0,9,9
Tropical Storm,Arlene,21,1999-06-16T15:00:00Z,35.1N  63.5W,16,12,1,0,29
Tropical Storm,Arlene,21,1999-06-16T15:00:00Z,MONCTON NB,0,0,0,9,9
Tropical Storm,Arlene,21,1999-06-16T15:00:00Z,37.5N  63.5W,0,6,14,1,21
Tropical Storm,Arlene,21,1999-06-16T15:00:00Z,YARMOUTH NS,0,0,0,11,11
Tropical Storm,Arlene,21,1999-06-16T15:00:00Z,BERMUDA,33,0,0,0,33
Tropical Storm,Arlene,21,1999-06-16T15:00:00Z,HALIFAX NS,0,0,0,11,11
Tropical Storm,Arlene,21,1999-06-16T15:00:00Z,MONTAUK POINT NY,0,0,0,3,3
Tropical Storm,Arlene,21,1999-06-16T15:00:00Z,SABLE ISLAND NS,0,0,0,10,10
Tropical Storm,Arlene,21,1999-06-16T15:00:00Z,PROVIDENCE RI,0,0,0,4,4
Tropical Storm,Arlene,21,1999-06-16T15:00:00Z,SYDNEY NS,0,0,0,8,8
Tropical Storm,Arlene,21,1999-06-16T15:00:00Z,NANTUCKET MA,0,0,1,6,7
Tropical Storm,Arlene,21,1999-06-16T15:00:00Z,EDDY POINT NS,0,0,0,9,9
Tropical Storm,Arlene,21,1999-06-16T15:00:00Z,HYANNIS MA,0,0,1,5,6
Tropical Storm,Arlene,21,1999-06-16T15:00:00Z,PTX BASQUES NFLD,0,0,0,6,6
Tropical Storm,Arlene,21,1999-06-16T15:00:00Z,BOSTON MA,0,0,0,5,5
Tropical Storm,Arlene,21,1999-06-16T15:00:00Z,BURGEO NFLD,0,0,0,5,5
Tropical Storm,Arlene,21,1999-06-16T15:00:00Z,PORTLAND ME,0,0,0,5,5
Tropical Storm,Arlene,21,1999-06-16T15:00:00Z,ILE ST PIERRE,0,0,0,4,4
Tropical Storm,Arlene,21,1999-06-16T15:00:00Z,BAR HARBOR ME,0,0,0,8,8
Tropical Storm,Arlene,21,1999-06-16T15:00:00Z,CAPE RACE NFLD,0,0,0,2,2
Tropical Storm,Arlene,21,1999-06-16T15:00:00Z,EASTPORT ME,0,0,0,9,9
Tropical Storm,Arlene,22,1999-06-16T21:00:00Z,34.5N  63.3W,48,0,0,0,48
Tropical Storm,Arlene,22,1999-06-16T21:00:00Z,BERMUDA,36,0,0,0,36
Tropical Storm,Arlene,22,1999-06-16T21:00:00Z,36.4N  63.2W,18,12,0,0,30
Tropical Storm,Arlene,22,1999-06-16T21:00:00Z,YARMOUTH NS,0,0,2,0,2
Tropical Storm,Arlene,22,1999-06-16T21:00:00Z,38.8N  62.1W,0,7,11,0,18
Tropical Storm,Arlene,23,1999-06-17T03:00:00Z,34.7N  63.0W,50,0,0,0,50
Tropical Storm,Arlene,23,1999-06-17T03:00:00Z,YARMOUTH NS,0,0,2,0,2
Tropical Storm,Arlene,23,1999-06-17T03:00:00Z,37.0N  62.5W,8,23,1,0,32
Tropical Storm,Arlene,23,1999-06-17T03:00:00Z,HALIFAX NS,0,0,2,0,2
Tropical Storm,Arlene,23,1999-06-17T03:00:00Z,39.5N  61.0W,0,5,13,0,18
Tropical Storm,Arlene,23,1999-06-17T03:00:00Z,SABLE ISLAND NS,0,0,2,0,2
Tropical Storm,Arlene,23,1999-06-17T03:00:00Z,BERMUDA,40,0,0,0,40
Tropical Depression,Arlene,24,1999-06-17T09:00:00Z,36.2N  63.4W,47,0,0,0,47
Tropical Depression,Arlene,24,1999-06-17T09:00:00Z,MONCTON NB,0,0,3,0,3
Tropical Depression,Arlene,24,1999-06-17T09:00:00Z,39.0N  62.2W,3,21,2,0,26
Tropical Depression,Arlene,24,1999-06-17T09:00:00Z,YARMOUTH NS,0,0,6,0,6
Tropical Depression,Arlene,24,1999-06-17T09:00:00Z,42.0N  59.0W,0,1,13,0,14
Tropical Depression,Arlene,24,1999-06-17T09:00:00Z,HALIFAX NS,0,0,8,0,8
Tropical Depression,Arlene,24,1999-06-17T09:00:00Z,BERMUDA,37,0,0,0,37
Tropical Depression,Arlene,24,1999-06-17T09:00:00Z,SABLE ISLAND NS,0,0,10,0,10
Tropical Depression,Arlene,24,1999-06-17T09:00:00Z,BAR HARBOR ME,0,0,2,0,2
Tropical Depression,Arlene,24,1999-06-17T09:00:00Z,SYDNEY NS,0,0,3,0,3
Tropical Depression,Arlene,24,1999-06-17T09:00:00Z,EASTPORT ME,0,0,3,0,3
Tropical Depression,Arlene,24,1999-06-17T09:00:00Z,EDDY POINT NS,0,0,5,0,5
Tropical Depression,Arlene,24,1999-06-17T09:00:00Z,ST JOHN NB,0,0,3,0,3
Tropical Depression,Arlene,25,1999-06-17T15:00:00Z,38.1N  62.3W,40,0,0,0,40
Tropical Depression,Arlene,25,1999-06-17T15:00:00Z,HALIFAX NS,0,4,0,0,4
Tropical Depression,Arlene,25,1999-06-17T15:00:00Z,41.0N  60.2W,1,18,0,0,19
Tropical Depression,Arlene,25,1999-06-17T15:00:00Z,SABLE ISLAND NS,0,6,0,0,6
Tropical Depression,Arlene,25,1999-06-17T15:00:00Z,YARMOUTH NS,0,4,0,0,4
Tropical Depression,Arlene,25,1999-06-17T15:00:00Z,EDDY POINT NS,0,2,0,0,2
Tropical Depression,Arlene,26,1999-06-17T21:00:00Z,39.0N  59.0W,32,0,0,0,32
Tropical Depression,Three,1,1999-08-18T21:00:00Z,20.5N  95.0W,46,0,0,0,46
Tropical Depression,Three,1,1999-08-18T21:00:00Z,MMMD 210N 897W,0,1,3,4,8
Tropical Depression,Three,1,1999-08-18T21:00:00Z,20.7N  95.5W,34,0,1,0,35
Tropical Depression,Three,1,1999-08-18T21:00:00Z,FREEPORT TX,0,0,0,2,2
Tropical Depression,Three,1,1999-08-18T21:00:00Z,21.0N  96.0W,25,1,1,1,28
Tropical Depression,Three,1,1999-08-18T21:00:00Z,PORT O CONNOR TX,0,0,0,3,3
Tropical Depression,Three,1,1999-08-18T21:00:00Z,MMCZ 205N 869W,0,0,0,2,2
Tropical Depression,Three,1,1999-08-18T21:00:00Z,CORPUSCHRISTI TX,0,0,0,4,4
Tropical Depression,Three,1,1999-08-18T21:00:00Z,MZBZ 175N 883W,0,0,0,2,2
Tropical Depression,Three,1,1999-08-18T21:00:00Z,BROWNSVILLE TX,0,0,1,8,9
Tropical Depression,Three,1,1999-08-18T21:00:00Z,MMSO 238N 982W,0,2,6,7,15
Tropical Depression,Three,1,1999-08-18T21:00:00Z,GULF 28N 93W,0,0,0,2,2
Tropical Depression,Three,1,1999-08-18T21:00:00Z,MMTM 222N 979W,1,9,5,4,19
Tropical Depression,Three,1,1999-08-18T21:00:00Z,GULF 28N 95W,0,0,0,3,3
Tropical Depression,Three,1,1999-08-18T21:00:00Z,MMTX 210N 974W,5,10,3,2,20
Tropical Depression,Three,1,1999-08-18T21:00:00Z,GULF 27N 96W,0,0,0,6,6
Tropical Depression,Three,1,1999-08-18T21:00:00Z,MMVR 192N 961W,13,3,1,1,18
Tropical Depression,Three,1,1999-08-18T21:00:00Z,GULF 25N 96W,0,1,4,7,12
Tropical Depression,Three,1,1999-08-18T21:00:00Z,MMFR 185N 926W,12,1,0,2,15
Tropical Depression,Three,2,1999-08-19T03:00:00Z,19.9N  95.1W,99,0,0,0,99
Tropical Depression,Three,2,1999-08-19T03:00:00Z,MMFR 185N 926W,7,3,1,3,14
Tropical Depression,Three,2,1999-08-19T03:00:00Z,20.2N  95.5W,39,0,0,0,39
Tropical Depression,Three,2,1999-08-19T03:00:00Z,MMMD 210N 897W,0,1,4,3,8
Tropical Depression,Three,2,1999-08-19T03:00:00Z,20.5N  96.0W,26,2,0,1,29
Tropical Depression,Three,2,1999-08-19T03:00:00Z,PORT O CONNOR TX,0,0,0,2,2
Tropical Depression,Three,2,1999-08-19T03:00:00Z,MMCZ 205N 869W,0,0,0,2,2
Tropical Depression,Three,2,1999-08-19T03:00:00Z,CORPUSCHRISTI TX,0,0,0,3,3
Tropical Depression,Three,2,1999-08-19T03:00:00Z,MZBZ 175N 883W,0,0,0,2,2
Tropical Depression,Three,2,1999-08-19T03:00:00Z,BROWNSVILLE TX,0,0,0,8,8
Tropical Depression,Three,2,1999-08-19T03:00:00Z,MMSO 238N 982W,0,1,5,7,13
Tropical Depression,Three,2,1999-08-19T03:00:00Z,GULF 28N 93W,0,0,0,2,2
Tropical Depression,Three,2,1999-08-19T03:00:00Z,MMTM 222N 979W,1,7,6,4,18
Tropical Depression,Three,2,1999-08-19T03:00:00Z,GULF 28N 95W,0,0,0,2,2
Tropical Depression,Three,2,1999-08-19T03:00:00Z,MMTX 210N 974W,6,8,4,3,21
Tropical Depression,Three,2,1999-08-19T03:00:00Z,GULF 27N 96W,0,0,0,5,5
Tropical Depression,Three,2,1999-08-19T03:00:00Z,MMVR 192N 961W,22,2,0,1,25
Tropical Depression,Three,2,1999-08-19T03:00:00Z,GULF 25N 96W,0,0,3,7,10
Tropical Depression,Three,3,1999-08-19T09:00:00Z,20.3N  95.1W,58,0,0,0,58
Tropical Depression,Three,3,1999-08-19T09:00:00Z,MMFR 185N 926W,4,3,2,3,12
Tropical Depression,Three,3,1999-08-19T09:00:00Z,20.5N  95.6W,40,0,0,0,40
Tropical Depression,Three,3,1999-08-19T09:00:00Z,MMMD 210N 897W,0,2,3,4,9
Tropical Depression,Three,3,1999-08-19T09:00:00Z,20.7N  96.1W,28,1,1,0,30
Tropical Depression,Three,3,1999-08-19T09:00:00Z,PORT O CONNOR TX,0,0,0,2,2
Tropical Depression,Three,3,1999-08-19T09:00:00Z,MMCZ 205N 869W,0,0,0,2,2
Tropical Depression,Three,3,1999-08-19T09:00:00Z,CORPUSCHRISTI TX,0,0,0,4,4
Tropical Depression,Three,3,1999-08-19T09:00:00Z,MZBZ 175N 883W,0,0,0,2,2
Tropical Depression,Three,3,1999-08-19T09:00:00Z,BROWNSVILLE TX,0,0,1,7,8
Tropical Depression,Three,3,1999-08-19T09:00:00Z,MMSO 238N 982W,0,2,6,7,15
Tropical Depression,Three,3,1999-08-19T09:00:00Z,GULF 28N 93W,0,0,0,2,2
Tropical Depression,Three,3,1999-08-19T09:00:00Z,MMTM 222N 979W,1,9,5,4,19
Tropical Depression,Three,3,1999-08-19T09:00:00Z,GULF 28N 95W,0,0,0,3,3
Tropical Depression,Three,3,1999-08-19T09:00:00Z,MMTX 210N 974W,7,8,3,3,21
Tropical Depression,Three,3,1999-08-19T09:00:00Z,GULF 27N 96W,0,0,0,5,5
Tropical Depression,Three,3,1999-08-19T09:00:00Z,MMVR 192N 961W,17,2,1,1,21
Tropical Depression,Three,3,1999-08-19T09:00:00Z,GULF 25N 96W,0,1,3,7,11
Tropical Depression,Three,4,1999-08-19T15:00:00Z,19.8N  95.0W,99,0,0,0,99
Tropical Depression,Three,4,1999-08-19T15:00:00Z,MMFR 185N 926W,13,3,2,1,19
Tropical Depression,Three,4,1999-08-19T15:00:00Z,20.2N  95.5W,43,0,0,0,43
Tropical Depression,Three,4,1999-08-19T15:00:00Z,MMMD 210N 897W,0,0,1,4,5
Tropical Depression,Three,4,1999-08-19T15:00:00Z,20.5N  96.0W,27,2,0,1,30
Tropical Depression,Three,4,1999-08-19T15:00:00Z,FREEPORT TX,0,0,0,2,2
Tropical Depression,Three,4,1999-08-19T15:00:00Z,MZBZ 175N 883W,0,0,1,2,3
Tropical Depression,Three,4,1999-08-19T15:00:00Z,PORT O CONNOR TX,0,0,0,3,3
Tropical Depression,Three,4,1999-08-19T15:00:00Z,MGPB 157N 886W,0,0,0,2,2
Tropical Depression,Three,4,1999-08-19T15:00:00Z,CORPUSCHRISTI TX,0,0,0,4,4
Tropical Depression,Three,4,1999-08-19T15:00:00Z,MMSO 238N 982W,0,3,6,6,15
Tropical Depression,Three,4,1999-08-19T15:00:00Z,BROWNSVILLE TX,0,0,1,7,8
Tropical Depression,Three,4,1999-08-19T15:00:00Z,MMTM 222N 979W,1,10,5,3,19
Tropical Depression,Three,4,1999-08-19T15:00:00Z,GULF 28N 95W,0,0,0,3,3
Tropical Depression,Three,4,1999-08-19T15:00:00Z,MMTX 210N 974W,8,9,2,2,21
Tropical Depression,Three,4,1999-08-19T15:00:00Z,GULF 27N 96W,0,0,0,5,5
Tropical Depression,Three,4,1999-08-19T15:00:00Z,MMVR 192N 961W,20,2,1,1,24
Tropical Depression,Three,4,1999-08-19T15:00:00Z,GULF 25N 96W,0,0,2,8,10
Tropical Storm,Bret,5,1999-08-19T21:00:00Z,20.5N  95.5W,99,0,0,0,99
Tropical Storm,Bret,5,1999-08-19T21:00:00Z,MMMD 210N 897W,0,0,1,2,3
Tropical Storm,Bret,5,1999-08-19T21:00:00Z,20.9N  96.2W,37,1,0,0,38
Tropical Storm,Bret,5,1999-08-19T21:00:00Z,FREEPORT TX,0,0,0,2,2
Tropical Storm,Bret,5,1999-08-19T21:00:00Z,21.5N  97.0W,19,4,2,1,26
Tropical Storm,Bret,5,1999-08-19T21:00:00Z,PORT O CONNOR TX,0,0,0,4,4
Tropical Storm,Bret,5,1999-08-19T21:00:00Z,MMSO 238N 982W,0,8,5,5,18
Tropical Storm,Bret,5,1999-08-19T21:00:00Z,CORPUSCHRISTI TX,0,0,0,6,6
Tropical Storm,Bret,5,1999-08-19T21:00:00Z,MMTM 222N 979W,6,11,3,2,22
Tropical Storm,Bret,5,1999-08-19T21:00:00Z,BROWNSVILLE TX,0,0,3,7,10
Tropical Storm,Bret,5,1999-08-19T21:00:00Z,MMTX 210N 974W,14,5,2,2,23
Tropical Storm,Bret,5,1999-08-19T21:00:00Z,GULF 28N 95W,0,0,0,3,3
Tropical Storm,Bret,5,1999-08-19T21:00:00Z,MMVR 192N 961W,18,1,1,1,21
Tropical Storm,Bret,5,1999-08-19T21:00:00Z,GULF 27N 96W,0,0,0,6,6
Tropical Storm,Bret,5,1999-08-19T21:00:00Z,MMFR 185N 926W,4,5,2,2,13
Tropical Storm,Bret,5,1999-08-19T21:00:00Z,GULF 25N 96W,0,1,3,7,11
Tropical Storm,Bret,6,1999-08-20T03:00:00Z,20.0N  95.0W,99,0,0,0,99
Tropical Storm,Bret,6,1999-08-20T03:00:00Z,GALVESTON TX,0,0,0,4,4
Tropical Storm,Bret,6,1999-08-20T03:00:00Z,20.3N  95.4W,99,0,0,0,99
Tropical Storm,Bret,6,1999-08-20T03:00:00Z,FREEPORT TX,0,0,0,5,5
Tropical Storm,Bret,6,1999-08-20T03:00:00Z,21.0N  96.0W,21,3,1,1,26
Tropical Storm,Bret,6,1999-08-20T03:00:00Z,PORT O CONNOR TX,0,0,1,6,7
Tropical Storm,Bret,6,1999-08-20T03:00:00Z,MMSO 238N 982W,0,2,7,6,15
Tropical Storm,Bret,6,1999-08-20T03:00:00Z,CORPUSCHRISTI TX,0,0,2,7,9
Tropical Storm,Bret,6,1999-08-20T03:00:00Z,MMTM 222N 979W,0,6,6,5,17
Tropical Storm,Bret,6,1999-08-20T03:00:00Z,BROWNSVILLE TX,0,1,6,6,13
Tropical Storm,Bret,6,1999-08-20T03:00:00Z,MMTX 210N 974W,2,8,4,4,18
Tropical Storm,Bret,6,1999-08-20T03:00:00Z,GULF 28N 91W,0,0,0,2,2
Tropical Storm,Bret,6,1999-08-20T03:00:00Z,MMVR 192N 961W,56,0,0,0,56
Tropical Storm,Bret,6,1999-08-20T03:00:00Z,GULF 28N 93W,0,0,0,4,4
Tropical Storm,Bret,6,1999-08-20T03:00:00Z,MMFR 185N 926W,8,3,1,2,14
Tropical Storm,Bret,6,1999-08-20T03:00:00Z,GULF 28N 95W,0,0,1,6,7
Tropical Storm,Bret,6,1999-08-20T03:00:00Z,MMMD 210N 897W,0,0,0,2,2
Tropical Storm,Bret,6,1999-08-20T03:00:00Z,GULF 27N 96W,0,0,4,6,10
Tropical Storm,Bret,6,1999-08-20T03:00:00Z,PORT ARTHUR TX,0,0,0,3,3
Tropical Storm,Bret,6,1999-08-20T03:00:00Z,GULF 25N 96W,0,4,6,5,15
Tropical Storm,Bret,7,1999-08-20T09:00:00Z,20.0N  95.0W,99,0,0,0,99
Tropical Storm,Bret,7,1999-08-20T09:00:00Z,GALVESTON TX,0,0,0,5,5
Tropical Storm,Bret,7,1999-08-20T09:00:00Z,20.3N  95.4W,99,0,0,0,99
Tropical Storm,Bret,7,1999-08-20T09:00:00Z,FREEPORT TX,0,0,1,5,6
Tropical Storm,Bret,7,1999-08-20T09:00:00Z,21.0N  96.0W,24,2,1,1,28
Tropical Storm,Bret,7,1999-08-20T09:00:00Z,PORT O CONNOR TX,0,0,1,7,8
Tropical Storm,Bret,7,1999-08-20T09:00:00Z,MMSO 238N 982W,0,2,6,7,15
Tropical Storm,Bret,7,1999-08-20T09:00:00Z,CORPUSCHRISTI TX,0,0,2,7,9
Tropical Storm,Bret,7,1999-08-20T09:00:00Z,MMTM 222N 979W,1,4,6,5,16
Tropical Storm,Bret,7,1999-08-20T09:00:00Z,BROWNSVILLE TX,0,1,5,7,13
Tropical Storm,Bret,7,1999-08-20T09:00:00Z,MMTX 210N 974W,4,6,4,4,18
Tropical Storm,Bret,7,1999-08-20T09:00:00Z,GULF 28N 91W,0,0,0,2,2
Tropical Storm,Bret,7,1999-08-20T09:00:00Z,MMVR 192N 961W,24,1,1,0,26
Tropical Storm,Bret,7,1999-08-20T09:00:00Z,GULF 28N 93W,0,0,0,5,5
Tropical Storm,Bret,7,1999-08-20T09:00:00Z,MMFR 185N 926W,6,4,2,1,13
Tropical Storm,Bret,7,1999-08-20T09:00:00Z,GULF 28N 95W,0,0,1,7,8
Tropical Storm,Bret,7,1999-08-20T09:00:00Z,MMMD 210N 897W,0,0,0,2,2
Tropical Storm,Bret,7,1999-08-20T09:00:00Z,GULF 27N 96W,0,0,4,7,11
Tropical Storm,Bret,7,1999-08-20T09:00:00Z,NEW IBERIA LA,0,0,0,2,2
Tropical Storm,Bret,7,1999-08-20T09:00:00Z,GULF 25N 96W,0,4,7,5,16
Tropical Storm,Bret,7,1999-08-20T09:00:00Z,PORT ARTHUR TX,0,0,0,3,3
Tropical Storm,Bret,8,1999-08-20T15:00:00Z,22.3N  95.1W,58,0,0,0,58
Tropical Storm,Bret,8,1999-08-20T15:00:00Z,GALVESTON TX,0,0,2,5,7
Tropical Storm,Bret,8,1999-08-20T15:00:00Z,23.0N  95.6W,34,1,0,0,35
Tropical Storm,Bret,8,1999-08-20T15:00:00Z,FREEPORT TX,0,0,3,6,9
Tropical Storm,Bret,8,1999-08-20T15:00:00Z,23.5N  96.5W,16,5,2,1,24
Tropical Storm,Bret,8,1999-08-20T15:00:00Z,PORT O CONNOR TX,0,1,5,5,11
Tropical Storm,Bret,8,1999-08-20T15:00:00Z,MMSO 238N 982W,1,8,5,3,17
Tropical Storm,Bret,8,1999-08-20T15:00:00Z,CORPUSCHRISTI TX,0,1,7,5,13
Tropical Storm,Bret,8,1999-08-20T15:00:00Z,MMTM 222N 979W,4,6,3,4,17
Tropical Storm,Bret,8,1999-08-20T15:00:00Z,BROWNSVILLE TX,0,8,6,4,18
Tropical Storm,Bret,8,1999-08-20T15:00:00Z,MMTX 210N 974W,6,4,2,3,15
Tropical Storm,Bret,8,1999-08-20T15:00:00Z,GULF 28N 91W,0,0,0,3,3
Tropical Storm,Bret,8,1999-08-20T15:00:00Z,MMVR 192N 961W,2,2,2,4,10
Tropical Storm,Bret,8,1999-08-20T15:00:00Z,GULF 28N 93W,0,0,2,4,6
Tropical Storm,Bret,8,1999-08-20T15:00:00Z,MMFR 185N 926W,0,1,1,3,5
Tropical Storm,Bret,8,1999-08-20T15:00:00Z,GULF 28N 95W,0,1,4,6,11
Tropical Storm,Bret,8,1999-08-20T15:00:00Z,MMMD 210N 897W,0,0,0,2,2
Tropical Storm,Bret,8,1999-08-20T15:00:00Z,GULF 27N 96W,0,5,6,4,15
Tropical Storm,Bret,8,1999-08-20T15:00:00Z,NEW IBERIA LA,0,0,0,2,2
Tropical Storm,Bret,8,1999-08-20T15:00:00Z,GULF 25N 96W,4,13,3,1,21
Tropical Storm,Bret,8,1999-08-20T15:00:00Z,PORT ARTHUR TX,0,0,0,5,5
Tropical Storm,Bret,9,1999-08-20T21:00:00Z,22.7N  94.8W,54,0,0,0,54
Tropical Storm,Bret,9,1999-08-20T21:00:00Z,PORT ARTHUR TX,0,0,2,5,7
Tropical Storm,Bret,9,1999-08-20T21:00:00Z,23.3N  95.5W,34,0,1,0,35
Tropical Storm,Bret,9,1999-08-20T21:00:00Z,GALVESTON TX,0,0,4,5,9
Tropical Storm,Bret,9,1999-08-20T21:00:00Z,24.0N  96.5W,13,6,2,2,23
Tropical Storm,Bret,9,1999-08-20T21:00:00Z,FREEPORT TX,0,1,5,5,11
Tropical Storm,Bret,9,1999-08-20T21:00:00Z,MMSO 238N 982W,1,6,5,5,17
Tropical Storm,Bret,9,1999-08-20T21:00:00Z,PORT O CONNOR TX,0,1,7,5,13
Tropical Storm,Bret,9,1999-08-20T21:00:00Z,MMTM 222N 979W,2,5,4,4,15
Tropical Storm,Bret,9,1999-08-20T21:00:00Z,CORPUSCHRISTI TX,0,2,7,6,15
Tropical Storm,Bret,9,1999-08-20T21:00:00Z,MMTX 210N 974W,3,3,4,4,14
Tropical Storm,Bret,9,1999-08-20T21:00:00Z,BROWNSVILLE TX,0,8,6,4,18
Tropical Storm,Bret,9,1999-08-20T21:00:00Z,MMVR 192N 961W,0,2,3,4,9
Tropical Storm,Bret,9,1999-08-20T21:00:00Z,GULF 28N 91W,0,0,1,3,4
Tropical Storm,Bret,9,1999-08-20T21:00:00Z,MMFR 185N 926W,0,0,2,2,4
Tropical Storm,Bret,9,1999-08-20T21:00:00Z,GULF 28N 93W,0,1,3,5,9
Tropical Storm,Bret,9,1999-08-20T21:00:00Z,MMMD 210N 897W,0,0,0,2,2
Tropical Storm,Bret,9,1999-08-20T21:00:00Z,GULF 28N 95W,0,3,6,4,13
Tropical Storm,Bret,9,1999-08-20T21:00:00Z,NEW ORLEANS LA,0,0,0,2,2
Tropical Storm,Bret,9,1999-08-20T21:00:00Z,GULF 27N 96W,0,7,6,4,17
Tropical Storm,Bret,9,1999-08-20T21:00:00Z,NEW IBERIA LA,0,0,0,4,4
Tropical Storm,Bret,9,1999-08-20T21:00:00Z,GULF 25N 96W,8,10,3,1,22
Hurricane,Bret,10,1999-08-21T03:00:00Z,24.3N  95.6W,47,0,0,0,47
Hurricane,Bret,10,1999-08-21T03:00:00Z,GALVESTON TX,0,1,4,5,10
Hurricane,Bret,10,1999-08-21T03:00:00Z,24.7N  96.2W,35,0,0,1,36
Hurricane,Bret,10,1999-08-21T03:00:00Z,FREEPORT TX,0,2,5,5,12
Hurricane,Bret,10,1999-08-21T03:00:00Z,25.0N  97.0W,20,3,2,1,26
Hurricane,Bret,10,1999-08-21T03:00:00Z,PORT O CONNOR TX,0,5,6,4,15
Hurricane,Bret,10,1999-08-21T03:00:00Z,MMSO 238N 982W,6,6,3,3,18
Hurricane,Bret,10,1999-08-21T03:00:00Z,CORPUSCHRISTI TX,0,7,6,4,17
Hurricane,Bret,10,1999-08-21T03:00:00Z,MMTM 222N 979W,2,4,4,4,14
Hurricane,Bret,10,1999-08-21T03:00:00Z,BROWNSVILLE TX,8,9,3,2,22
Hurricane,Bret,10,1999-08-21T03:00:00Z,MMTX 210N 974W,0,2,3,5,10
Hurricane,Bret,10,1999-08-21T03:00:00Z,GULF 28N 91W,0,0,1,3,4
Hurricane,Bret,10,1999-08-21T03:00:00Z,MMVR 192N 961W,0,0,1,4,5
Hurricane,Bret,10,1999-08-21T03:00:00Z,GULF 28N 93W,0,2,3,4,9
Hurricane,Bret,10,1999-08-21T03:00:00Z,MMFR 185N 926W,0,0,0,2,2
Hurricane,Bret,10,1999-08-21T03:00:00Z,GULF 28N 95W,0,7,4,4,15
Hurricane,Bret,10,1999-08-21T03:00:00Z,NEW IBERIA LA,0,0,0,3,3
Hurricane,Bret,10,1999-08-21T03:00:00Z,GULF 27N 96W,4,10,4,2,20
Hurricane,Bret,10,1999-08-21T03:00:00Z,PORT ARTHUR TX,0,0,2,5,7
Hurricane,Bret,10,1999-08-21T03:00:00Z,GULF 25N 96W,33,0,1,0,34
Hurricane,Bret,11,1999-08-21T09:00:00Z,24.5N  96.0W,50,0,0,0,50
Hurricane,Bret,11,1999-08-21T09:00:00Z,GALVESTON TX,0,2,4,4,10
Hurricane,Bret,11,1999-08-21T09:00:00Z,25.1N  96.8W,31,1,0,1,33
Hurricane,Bret,11,1999-08-21T09:00:00Z,FREEPORT TX,0,5,4,4,13
Hurricane,Bret,11,1999-08-21T09:00:00Z,25.5N  97.5W,17,7,1,1,26
Hurricane,Bret,11,1999-08-21T09:00:00Z,PORT O CONNOR TX,1,10,3,3,17
Hurricane,Bret,11,1999-08-21T09:00:00Z,MMSO 238N 982W,6,7,3,3,19
Hurricane,Bret,11,1999-08-21T09:00:00Z,CORPUSCHRISTI TX,1,13,3,3,20
Hurricane,Bret,11,1999-08-21T09:00:00Z,MMTM 222N 979W,2,4,4,4,14
Hurricane,Bret,11,1999-08-21T09:00:00Z,BROWNSVILLE TX,15,9,1,1,26
Hurricane,Bret,11,1999-08-21T09:00:00Z,MMTX 210N 974W,0,2,3,5,10
Hurricane,Bret,11,1999-08-21T09:00:00Z,GULF 28N 91W,0,0,1,2,3
Hurricane,Bret,11,1999-08-21T09:00:00Z,MMVR 192N 961W,0,0,1,4,5
Hurricane,Bret,11,1999-08-21T09:00:00Z,GULF 28N 93W,0,2,3,3,8
Hurricane,Bret,11,1999-08-21T09:00:00Z,MMFR 185N 926W,0,0,0,2,2
Hurricane,Bret,11,1999-08-21T09:00:00Z,GULF 28N 95W,2,8,3,3,16
Hurricane,Bret,11,1999-08-21T09:00:00Z,NEW IBERIA LA,0,0,0,3,3
Hurricane,Bret,11,1999-08-21T09:00:00Z,GULF 27N 96W,12,8,2,1,23
Hurricane,Bret,11,1999-08-21T09:00:00Z,PORT ARTHUR TX,0,0,2,5,7
Hurricane,Bret,11,1999-08-21T09:00:00Z,GULF 25N 96W,46,0,0,0,46
Hurricane,Bret,12,1999-08-21T15:00:00Z,25.2N  96.1W,48,0,0,0,48
Hurricane,Bret,12,1999-08-21T15:00:00Z,FREEPORT TX,1,6,3,4,14
Hurricane,Bret,12,1999-08-21T15:00:00Z,25.8N  97.0W,29,1,0,1,31
Hurricane,Bret,12,1999-08-21T15:00:00Z,PORT O CONNOR TX,3,11,3,2,19
Hurricane,Bret,12,1999-08-21T15:00:00Z,26.0N  98.0W,11,9,2,1,23
Hurricane,Bret,12,1999-08-21T15:00:00Z,CORPUSCHRISTI TX,4,13,3,2,22
Hurricane,Bret,12,1999-08-21T15:00:00Z,MMSO 238N 982W,4,6,3,3,16
Hurricane,Bret,12,1999-08-21T15:00:00Z,BROWNSVILLE TX,21,4,1,1,27
Hurricane,Bret,12,1999-08-21T15:00:00Z,MMTM 222N 979W,0,2,3,6,11
Hurricane,Bret,12,1999-08-21T15:00:00Z,GULF 28N 91W,0,0,0,2,2
Hurricane,Bret,12,1999-08-21T15:00:00Z,MMTX 210N 974W,0,0,2,6,8
Hurricane,Bret,12,1999-08-21T15:00:00Z,GULF 28N 93W,0,2,2,3,7
Hurricane,Bret,12,1999-08-21T15:00:00Z,MMVR 192N 961W,0,0,0,4,4
Hurricane,Bret,12,1999-08-21T15:00:00Z,GULF 28N 95W,5,7,3,1,16
Hurricane,Bret,12,1999-08-21T15:00:00Z,NEW IBERIA LA,0,0,0,3,3
Hurricane,Bret,12,1999-08-21T15:00:00Z,GULF 27N 96W,21,4,1,1,27
Hurricane,Bret,12,1999-08-21T15:00:00Z,PORT ARTHUR TX,0,1,1,5,7
Hurricane,Bret,12,1999-08-21T15:00:00Z,GULF 25N 96W,50,0,0,0,50
Hurricane,Bret,12,1999-08-21T15:00:00Z,GALVESTON TX,0,4,3,4,11
Hurricane,Bret,13,1999-08-21T21:00:00Z,25.7N  96.5W,43,0,1,0,44
Hurricane,Bret,13,1999-08-21T21:00:00Z,FREEPORT TX,3,4,2,2,11
Hurricane,Bret,13,1999-08-21T21:00:00Z,26.0N  97.5W,24,2,1,1,28
Hurricane,Bret,13,1999-08-21T21:00:00Z,PORT O CONNOR TX,11,7,1,1,20
Hurricane,Bret,13,1999-08-21T21:00:00Z,25.8N  98.3W,12,6,3,2,23
Hurricane,Bret,13,1999-08-21T21:00:00Z,CORPUSCHRISTI TX,15,10,1,1,27
Hurricane,Bret,13,1999-08-21T21:00:00Z,MMSO 238N 982W,2,5,7,3,17
Hurricane,Bret,13,1999-08-21T21:00:00Z,BROWNSVILLE TX,25,2,1,1,29
Hurricane,Bret,13,1999-08-21T21:00:00Z,MMTM 222N 979W,0,1,6,6,13
Hurricane,Bret,13,1999-08-21T21:00:00Z,GULF 28N 93W,1,0,0,2,3
Hurricane,Bret,13,1999-08-21T21:00:00Z,MMTX 210N 974W,0,0,4,6,10
Hurricane,Bret,13,1999-08-21T21:00:00Z,GULF 28N 95W,10,3,1,1,15
Hurricane,Bret,13,1999-08-21T21:00:00Z,MMVR 192N 961W,0,0,1,4,5
Hurricane,Bret,13,1999-08-21T21:00:00Z,GULF 27N 96W,30,1,0,1,32
Hurricane,Bret,13,1999-08-21T21:00:00Z,PORT ARTHUR TX,0,0,0,4,4
Hurricane,Bret,13,1999-08-21T21:00:00Z,GULF 25N 96W,65,0,0,0,65
Hurricane,Bret,13,1999-08-21T21:00:00Z,GALVESTON TX,1,2,1,3,7
Hurricane,Bret,14,1999-08-22T03:00:00Z,26.9N  96.1W,38,0,0,0,38
Hurricane,Bret,14,1999-08-22T03:00:00Z,FREEPORT TX,14,5,1,2,22
Hurricane,Bret,14,1999-08-22T03:00:00Z,27.5N  97.3W,20,8,1,0,29
Hurricane,Bret,14,1999-08-22T03:00:00Z,PORT O CONNOR TX,24,4,0,1,29
Hurricane,Bret,14,1999-08-22T03:00:00Z,27.5N  97.7W,16,10,1,1,28
Hurricane,Bret,14,1999-08-22T03:00:00Z,CORPUSCHRISTI TX,17,10,1,1,29
Hurricane,Bret,14,1999-08-22T03:00:00Z,MMSO 238N 982W,0,3,6,5,14
Hurricane,Bret,14,1999-08-22T03:00:00Z,BROWNSVILLE TX,10,9,2,2,23
Hurricane,Bret,14,1999-08-22T03:00:00Z,MMTM 222N 979W,0,0,3,6,9
Hurricane,Bret,14,1999-08-22T03:00:00Z,GULF 28N 91W,0,0,0,2,2
Hurricane,Bret,14,1999-08-22T03:00:00Z,MMTX 210N 974W,0,0,1,4,5
Hurricane,Bret,14,1999-08-22T03:00:00Z,GULF 28N 93W,2,1,2,3,8
Hurricane,Bret,14,1999-08-22T03:00:00Z,NEW IBERIA LA,0,0,0,4,4
Hurricane,Bret,14,1999-08-22T03:00:00Z,GULF 28N 95W,25,1,0,1,27
Hurricane,Bret,14,1999-08-22T03:00:00Z,PORT ARTHUR TX,0,3,2,6,11
Hurricane,Bret,14,1999-08-22T03:00:00Z,GULF 27N 96W,38,0,0,0,38
Hurricane,Bret,14,1999-08-22T03:00:00Z,GALVESTON TX,7,5,2,3,17
Hurricane,Bret,14,1999-08-22T03:00:00Z,GULF 25N 96W,99,0,0,0,99
Hurricane,Bret,15,1999-08-22T09:00:00Z,27.3N  96.9W,54,0,0,0,54
Hurricane,Bret,15,1999-08-22T09:00:00Z,FREEPORT TX,17,1,1,1,20
Hurricane,Bret,15,1999-08-22T09:00:00Z,27.5N  97.5W,40,0,0,0,40
Hurricane,Bret,15,1999-08-22T09:00:00Z,PORT O CONNOR TX,37,1,0,0,38
Hurricane,Bret,15,1999-08-22T09:00:00Z,27.5N  98.2W,27,2,1,0,30
Hurricane,Bret,15,1999-08-22T09:00:00Z,CORPUSCHRISTI TX,39,0,0,0,39
Hurricane,Bret,15,1999-08-22T09:00:00Z,MMSO 238N 982W,0,2,4,7,13
Hurricane,Bret,15,1999-08-22T09:00:00Z,BROWNSVILLE TX,25,1,1,1,28
Hurricane,Bret,15,1999-08-22T09:00:00Z,MMTM 222N 979W,0,0,1,7,8
Hurricane,Bret,15,1999-08-22T09:00:00Z,GULF 28N 91W,0,0,0,2,2
Hurricane,Bret,15,1999-08-22T09:00:00Z,MMTX 210N 974W,0,0,0,6,6
Hurricane,Bret,15,1999-08-22T09:00:00Z,GULF 28N 93W,1,1,0,4,6
Hurricane,Bret,15,1999-08-22T09:00:00Z,MMVR 192N 961W,0,0,0,2,2
Hurricane,Bret,15,1999-08-22T09:00:00Z,GULF 28N 95W,29,1,0,0,30
Hurricane,Bret,15,1999-08-22T09:00:00Z,NEW IBERIA LA,0,0,0,2,2
Hurricane,Bret,15,1999-08-22T09:00:00Z,GULF 27N 96W,83,0,0,0,83
Hurricane,Bret,15,1999-08-22T09:00:00Z,PORT ARTHUR TX,1,0,1,4,6
Hurricane,Bret,15,1999-08-22T09:00:00Z,GULF 25N 96W,99,0,0,0,99
Hurricane,Bret,15,1999-08-22T09:00:00Z,GALVESTON TX,8,2,0,3,13
Hurricane,Bret,16,1999-08-22T15:00:00Z,27.7N  98.4W,52,0,0,0,52
Hurricane,Bret,16,1999-08-22T15:00:00Z,FREEPORT TX,7,2,1,3,13
Hurricane,Bret,16,1999-08-22T15:00:00Z,27.7N  99.0W,38,1,0,0,39
Hurricane,Bret,16,1999-08-22T15:00:00Z,PORT O CONNOR TX,50,0,0,0,50
Hurricane,Bret,16,1999-08-22T15:00:00Z,27.7N  99.5W,28,1,1,1,31
Hurricane,Bret,16,1999-08-22T15:00:00Z,CORPUSCHRISTI TX,81,0,0,0,81
Hurricane,Bret,16,1999-08-22T15:00:00Z,MMSO 238N 982W,0,1,4,6,11
Hurricane,Bret,16,1999-08-22T15:00:00Z,BROWNSVILLE TX,42,0,0,0,42
Hurricane,Bret,16,1999-08-22T15:00:00Z,MMTM 222N 979W,0,0,1,6,7
Hurricane,Bret,16,1999-08-22T15:00:00Z,GULF 28N 93W,0,0,1,3,4
Hurricane,Bret,16,1999-08-22T15:00:00Z,MMTX 210N 974W,0,0,0,4,4
Hurricane,Bret,16,1999-08-22T15:00:00Z,GULF 28N 95W,10,2,1,2,15
Hurricane,Bret,16,1999-08-22T15:00:00Z,MMVR 192N 961W,0,0,0,2,2
Hurricane,Bret,16,1999-08-22T15:00:00Z,GULF 27N 96W,99,0,0,0,99
Hurricane,Bret,16,1999-08-22T15:00:00Z,PORT ARTHUR TX,0,0,0,4,4
Hurricane,Bret,16,1999-08-22T15:00:00Z,GULF 25N 96W,31,0,0,0,31
Hurricane,Bret,16,1999-08-22T15:00:00Z,GALVESTON TX,1,1,1,5,8
Hurricane,Bret,17,1999-08-22T21:00:00Z,27.5N  99.1W,53,0,0,0,53
Hurricane,Bret,17,1999-08-22T21:00:00Z,FREEPORT TX,3,2,2,3,10
Hurricane,Bret,17,1999-08-22T21:00:00Z,27.5N 100.0W,28,1,1,1,31
Hurricane,Bret,17,1999-08-22T21:00:00Z,PORT O CONNOR TX,25,0,1,0,26
Hurricane,Bret,17,1999-08-22T21:00:00Z,27.5N 100.5W,21,4,1,1,27
Hurricane,Bret,17,1999-08-22T21:00:00Z,CORPUSCHRISTI TX,86,0,0,0,86
Hurricane,Bret,17,1999-08-22T21:00:00Z,MMSO 238N 982W,0,1,3,6,10
Hurricane,Bret,17,1999-08-22T21:00:00Z,BROWNSVILLE TX,99,0,0,0,99
Hurricane,Bret,17,1999-08-22T21:00:00Z,MMTM 222N 979W,0,0,0,5,5
Hurricane,Bret,17,1999-08-22T21:00:00Z,GULF 28N 93W,0,0,1,3,4
Hurricane,Bret,17,1999-08-22T21:00:00Z,MMTX 210N 974W,0,0,0,2,2
Hurricane,Bret,17,1999-08-22T21:00:00Z,GULF 28N 95W,4,2,2,3,11
Hurricane,Bret,17,1999-08-22T21:00:00Z,PORT ARTHUR TX,0,0,0,3,3
Hurricane,Bret,17,1999-08-22T21:00:00Z,GULF 27N 96W,99,0,0,0,99
Hurricane,Bret,17,1999-08-22T21:00:00Z,GALVESTON TX,1,1,1,4,7
Hurricane,Bret,17,1999-08-22T21:00:00Z,GULF 25N 96W,1,3,4,4,12
Hurricane,Bret,18,1999-08-23T03:00:00Z,27.1N  99.2W,65,0,0,0,65
Hurricane,Bret,18,1999-08-23T03:00:00Z,FREEPORT TX,1,4,3,4,12
Hurricane,Bret,18,1999-08-23T03:00:00Z,27.2N 100.0W,34,0,1,0,35
Hurricane,Bret,18,1999-08-23T03:00:00Z,PORT O CONNOR TX,12,3,2,2,19
Hurricane,Bret,18,1999-08-23T03:00:00Z,27.2N 100.5W,24,2,1,1,28
Hurricane,Bret,18,1999-08-23T03:00:00Z,CORPUSCHRISTI TX,99,0,0,0,99
Hurricane,Bret,18,1999-08-23T03:00:00Z,MMSO 238N 982W,0,1,2,5,8
Hurricane,Bret,18,1999-08-23T03:00:00Z,BROWNSVILLE TX,99,0,0,0,99
Hurricane,Bret,18,1999-08-23T03:00:00Z,MMTM 222N 979W,0,0,0,4,4
Hurricane,Bret,18,1999-08-23T03:00:00Z,GULF 28N 91W,0,0,0,2,2
Hurricane,Bret,18,1999-08-23T03:00:00Z,MMTX 210N 974W,0,0,0,2,2
Hurricane,Bret,18,1999-08-23T03:00:00Z,GULF 28N 93W,0,0,2,4,6
Hurricane,Bret,18,1999-08-23T03:00:00Z,NEW IBERIA LA,0,0,0,2,2
Hurricane,Bret,18,1999-08-23T03:00:00Z,GULF 28N 95W,2,4,4,3,13
Hurricane,Bret,18,1999-08-23T03:00:00Z,PORT ARTHUR TX,0,0,1,4,5
Hurricane,Bret,18,1999-08-23T03:00:00Z,GULF 27N 96W,17,2,1,1,21
Hurricane,Bret,18,1999-08-23T03:00:00Z,GALVESTON TX,0,2,2,5,9
Hurricane,Bret,18,1999-08-23T03:00:00Z,GULF 25N 96W,1,3,3,4,11
Hurricane,Bret,19,1999-08-23T09:00:00Z,27.1N  99.8W,60,0,0,0,60
Hurricane,Bret,19,1999-08-23T09:00:00Z,PORT O CONNOR TX,5,4,4,0,13
Hurricane,Bret,19,1999-08-23T09:00:00Z,27.1N 100.4W,41,0,0,0,41
Hurricane,Bret,19,1999-08-23T09:00:00Z,CORPUSCHRISTI TX,99,0,0,0,99
Hurricane,Bret,19,1999-08-23T09:00:00Z,27.1N 101.0W,28,2,0,0,30
Hurricane,Bret,19,1999-08-23T09:00:00Z,BROWNSVILLE TX,65,0,0,0,65
Hurricane,Bret,19,1999-08-23T09:00:00Z,MMSO 238N 982W,0,1,1,0,2
Hurricane,Bret,19,1999-08-23T09:00:00Z,GULF 28N 95W,0,3,4,0,7
Hurricane,Bret,19,1999-08-23T09:00:00Z,GALVESTON TX,0,1,2,0,3
Hurricane,Bret,19,1999-08-23T09:00:00Z,GULF 27N 96W,6,4,3,0,13
Hurricane,Bret,19,1999-08-23T09:00:00Z,FREEPORT TX,0,2,3,0,5
Hurricane,Bret,19,1999-08-23T09:00:00Z,GULF 25N 96W,1,1,3,0,5
Tropical Depression,Four,2,1999-08-19T09:00:00Z,14.9N  25.6W,44,0,0,0,44
Tropical Depression,Four,2,1999-08-19T09:00:00Z,15.5N  29.0W,0,16,5,2,23
Tropical Depression,Four,2,1999-08-19T09:00:00Z,15.3N  27.6W,4,23,1,1,29
Tropical Depression,Four,3,1999-08-19T15:00:00Z,14.8N  25.8W,51,0,0,0,51
Tropical Depression,Four,3,1999-08-19T15:00:00Z,15.5N  30.0W,0,16,9,1,26
Tropical Depression,Four,3,1999-08-19T15:00:00Z,15.1N  27.9W,13,21,0,0,34
Tropical Depression,Four,4,1999-08-19T21:00:00Z,14.4N  26.0W,45,0,0,0,45
Tropical Depression,Four,4,1999-08-19T21:00:00Z,15.0N  30.5W,0,4,18,1,23
Tropical Depression,Four,4,1999-08-19T21:00:00Z,14.7N  28.0W,4,25,1,0,30
Tropical Depression,Four,5,1999-08-20T03:00:00Z,14.4N  26.9W,53,0,0,0,53
Tropical Depression,Four,5,1999-08-20T03:00:00Z,15.0N  31.5W,0,18,9,1,28
Tropical Depression,Four,5,1999-08-20T03:00:00Z,14.7N  29.1W,11,26,0,0,37
Tropical Depression,Four,6,1999-08-20T09:00:00Z,13.6N  28.2W,47,0,0,0,47
Tropical Depression,Four,6,1999-08-20T09:00:00Z,14.0N  33.0W,0,8,13,2,23
Tropical Depression,Four,6,1999-08-20T09:00:00Z,13.8N  30.7W,2,29,0,0,31
Tropical Depression,Four,7,1999-08-20T15:00:00Z,14.0N  28.9W,44,0,0,0,44
Tropical Depression,Four,7,1999-08-20T15:00:00Z,15.0N  33.5W,0,7,14,1,22
Tropical Depression,Four,7,1999-08-20T15:00:00Z,14.4N  31.2W,2,27,0,0,29
Tropical Storm,Cindy,8,1999-08-20T21:00:00Z,13.9N  30.7W,47,0,0,1,48
Tropical Storm,Cindy,8,1999-08-20T21:00:00Z,15.0N  35.5W,0,5,17,1,23
Tropical Storm,Cindy,8,1999-08-20T21:00:00Z,14.3N  33.1W,3,28,0,0,31
Tropical Storm,Cindy,9,1999-08-21T03:00:00Z,13.7N  32.5W,42,0,0,1,43
Tropical Storm,Cindy,9,1999-08-21T03:00:00Z,14.5N  37.0W,0,4,18,1,23
Tropical Storm,Cindy,9,1999-08-21T03:00:00Z,14.0N  34.5W,3,25,0,0,28
Tropical Storm,Cindy,10,1999-08-21T09:00:00Z,14.0N  33.0W,43,0,0,0,43
Tropical Storm,Cindy,10,1999-08-21T09:00:00Z,15.0N  38.0W,0,3,19,1,23
Tropical Storm,Cindy,10,1999-08-21T09:00:00Z,14.5N  35.5W,1,28,0,1,30
Tropical Storm,Cindy,11,1999-08-21T15:00:00Z,14.4N  33.8W,47,0,0,0,47
Tropical Storm,Cindy,11,1999-08-21T15:00:00Z,15.5N  38.7W,0,4,18,1,23
Tropical Storm,Cindy,11,1999-08-21T15:00:00Z,14.8N  36.2W,1,29,1,0,31
Tropical Storm,Cindy,12,1999-08-21T21:00:00Z,14.8N  35.2W,43,0,0,0,43
Tropical Storm,Cindy,12,1999-08-21T21:00:00Z,16.1N  40.3W,0,2,19,1,22
Tropical Storm,Cindy,12,1999-08-21T21:00:00Z,15.3N  37.6W,1,26,1,0,28
Hurricane,Cindy,13,1999-08-22T03:00:00Z,15.0N  36.4W,42,1,0,0,43
Hurricane,Cindy,13,1999-08-22T03:00:00Z,16.4N  41.4W,0,3,18,1,22
Hurricane,Cindy,13,1999-08-22T03:00:00Z,15.5N  38.9W,1,27,1,0,29
Hurricane,Cindy,14,1999-08-22T09:00:00Z,14.9N  36.4W,45,0,0,1,46
Hurricane,Cindy,14,1999-08-22T09:00:00Z,15.6N  40.9W,0,4,17,2,23
Hurricane,Cindy,14,1999-08-22T09:00:00Z,15.2N  38.6W,3,26,1,0,30
Hurricane,Cindy,15,1999-08-22T15:00:00Z,14.7N  35.3W,50,1,0,0,51
Hurricane,Cindy,15,1999-08-22T15:00:00Z,15.5N  41.0W,0,7,20,1,28
Hurricane,Cindy,15,1999-08-22T15:00:00Z,15.0N  38.0W,4,32,0,0,36
Tropical Storm,Cindy,16,1999-08-22T21:00:00Z,15.0N  35.3W,51,0,0,0,51
Tropical Storm,Cindy,16,1999-08-22T21:00:00Z,15.5N  39.0W,0,18,5,1,24
Tropical Storm,Cindy,16,1999-08-22T21:00:00Z,15.0N  37.0W,21,10,1,0,32
Tropical Storm,Cindy,17,1999-08-23T03:00:00Z,15.5N  36.4W,47,0,0,0,47
Tropical Storm,Cindy,17,1999-08-23T03:00:00Z,16.5N  40.5W,0,15,9,0,24
Tropical Storm,Cindy,17,1999-08-23T03:00:00Z,15.9N  38.2W,20,11,1,0,32
Tropical Storm,Cindy,18,1999-08-23T09:00:00Z,15.7N  37.5W,53,0,0,0,53
Tropical Storm,Cindy,18,1999-08-23T09:00:00Z,16.5N  42.0W,0,14,12,1,27
Tropical Storm,Cindy,18,1999-08-23T09:00:00Z,16.0N  39.5W,18,15,1,0,34
Tropical Storm,Cindy,19,1999-08-23T15:00:00Z,16.2N  39.7W,51,0,0,0,51
Tropical Storm,Cindy,19,1999-08-23T15:00:00Z,17.5N  45.0W,0,7,20,1,28
Tropical Storm,Cindy,19,1999-08-23T15:00:00Z,16.7N  42.0W,10,24,0,0,34
Tropical Storm,Cindy,20,1999-08-23T21:00:00Z,17.6N  41.0W,42,1,1,0,44
Tropical Storm,Cindy,20,1999-08-23T21:00:00Z,19.7N  46.6W,0,1,20,2,23
Tropical Storm,Cindy,20,1999-08-23T21:00:00Z,18.6N  43.8W,0,28,1,1,30
Tropical Storm,Cindy,21,1999-08-24T03:00:00Z,18.1N  42.7W,44,0,0,0,44
Tropical Storm,Cindy,21,1999-08-24T03:00:00Z,20.5N  48.5W,0,1,20,1,22
Tropical Storm,Cindy,21,1999-08-24T03:00:00Z,19.3N  45.5W,0,28,1,1,30
Tropical Storm,Cindy,22,1999-08-24T09:00:00Z,18.6N  43.6W,52,0,0,0,52
Tropical Storm,Cindy,22,1999-08-24T09:00:00Z,21.0N  49.2W,0,7,21,0,28
Tropical Storm,Cindy,22,1999-08-24T09:00:00Z,19.7N  46.3W,3,34,0,0,37
Tropical Storm,Cindy,23,1999-08-24T15:00:00Z,19.5N  46.8W,47,2,0,0,49
Tropical Storm,Cindy,23,1999-08-24T15:00:00Z,23.0N  53.0W,0,0,22,2,24
Tropical Storm,Cindy,23,1999-08-24T15:00:00Z,21.0N  50.0W,0,30,2,0,32
Tropical Storm,Cindy,24,1999-08-24T21:00:00Z,18.7N  48.7W,44,1,1,0,46
Tropical Storm,Cindy,24,1999-08-24T21:00:00Z,TAPA 171N 618W,0,0,0,3,3
Tropical Storm,Cindy,24,1999-08-24T21:00:00Z,20.3N  51.7W,0,28,2,0,30
Tropical Storm,Cindy,24,1999-08-24T21:00:00Z,TKPK 173N 627W,0,0,0,2,2
Tropical Storm,Cindy,24,1999-08-24T21:00:00Z,22.0N  55.0W,0,0,21,1,22
Tropical Storm,Cindy,24,1999-08-24T21:00:00Z,TNCM 181N 631W,0,0,0,3,3
Tropical Storm,Cindy,24,1999-08-24T21:00:00Z,TDPR 153N 614W,0,0,0,2,2
Tropical Storm,Cindy,24,1999-08-24T21:00:00Z,BERMUDA,0,0,0,3,3
Tropical Storm,Cindy,24,1999-08-24T21:00:00Z,TFFR 163N 615W,0,0,0,3,3
Tropical Storm,Cindy,25,1999-08-25T03:00:00Z,19.7N  49.6W,47,1,0,0,48
Tropical Storm,Cindy,25,1999-08-25T03:00:00Z,TAPA 171N 618W,0,0,0,2,2
Tropical Storm,Cindy,25,1999-08-25T03:00:00Z,21.5N  52.6W,0,31,1,0,32
Tropical Storm,Cindy,25,1999-08-25T03:00:00Z,TKPK 173N 627W,0,0,0,2,2
Tropical Storm,Cindy,25,1999-08-25T03:00:00Z,23.7N  55.5W,0,1,21,1,23
Tropical Storm,Cindy,25,1999-08-25T03:00:00Z,TNCM 181N 631W,0,0,0,2,2
Tropical Storm,Cindy,25,1999-08-25T03:00:00Z,TFFR 163N 615W,0,0,0,2,2
Tropical Storm,Cindy,25,1999-08-25T03:00:00Z,BERMUDA,0,0,0,6,6
Tropical Storm,Cindy,26,1999-08-25T09:00:00Z,20.7N  50.0W,46,0,0,0,46
Tropical Storm,Cindy,26,1999-08-25T09:00:00Z,TNCM 181N 631W,0,0,0,4,4
Tropical Storm,Cindy,26,1999-08-25T09:00:00Z,22.0N  53.0W,1,27,0,0,28
Tropical Storm,Cindy,26,1999-08-25T09:00:00Z,TISX 177N 648W,0,0,0,2,2
Tropical Storm,Cindy,26,1999-08-25T09:00:00Z,23.5N  55.5W,0,9,11,1,21
Tropical Storm,Cindy,26,1999-08-25T09:00:00Z,TIST 183N 650W,0,0,0,2,2
Tropical Storm,Cindy,26,1999-08-25T09:00:00Z,TFFR 163N 615W,0,0,0,2,2
Tropical Storm,Cindy,26,1999-08-25T09:00:00Z,BERMUDA,0,0,0,5,5
Tropical Storm,Cindy,26,1999-08-25T09:00:00Z,TAPA 171N 618W,0,0,0,3,3
Tropical Storm,Cindy,26,1999-08-25T09:00:00Z,ST CROIX VI,0,0,0,2,2
Tropical Storm,Cindy,26,1999-08-25T09:00:00Z,TKPK 173N 627W,0,0,0,3,3
Tropical Storm,Cindy,26,1999-08-25T09:00:00Z,ST THOMAS VI,0,0,0,2,2
Tropical Storm,Cindy,27,1999-08-25T15:00:00Z,21.7N  51.2W,52,0,0,0,52
Tropical Storm,Cindy,27,1999-08-25T15:00:00Z,25.0N  56.5W,0,10,12,1,23
Tropical Storm,Cindy,27,1999-08-25T15:00:00Z,23.3N  54.0W,7,24,1,0,32
Tropical Storm,Cindy,27,1999-08-25T15:00:00Z,BERMUDA,0,0,0,5,5
Tropical Storm,Cindy,28,1999-08-25T21:00:00Z,23.6N  52.0W,51,0,0,0,51
Tropical Storm,Cindy,28,1999-08-25T21:00:00Z,27.5N  57.5W,0,11,10,1,22
Tropical Storm,Cindy,28,1999-08-25T21:00:00Z,25.6N  54.7W,8,23,0,0,31
Tropical Storm,Cindy,28,1999-08-25T21:00:00Z,BERMUDA,0,0,0,10,10
Hurricane,Cindy,29,1999-08-26T03:00:00Z,25.0N  53.0W,49,0,0,0,49
Hurricane,Cindy,29,1999-08-26T03:00:00Z,28.2N  57.6W,0,18,3,1,22
Hurricane,Cindy,29,1999-08-26T03:00:00Z,26.5N  55.5W,14,15,1,0,30
Hurricane,Cindy,29,1999-08-26T03:00:00Z,BERMUDA,0,0,1,11,12
Hurricane,Cindy,30,1999-08-26T09:00:00Z,26.7N  54.0W,39,0,0,0,39
Hurricane,Cindy,30,1999-08-26T09:00:00Z,30.0N  57.5W,2,15,3,2,22
Hurricane,Cindy,30,1999-08-26T09:00:00Z,28.5N  56.0W,15,11,0,1,27
Hurricane,Cindy,30,1999-08-26T09:00:00Z,BERMUDA,0,0,2,8,10
Hurricane,Cindy,31,1999-08-26T15:00:00Z,28.7N  54.8W,41,1,0,0,42
Hurricane,Cindy,31,1999-08-26T15:00:00Z,YARMOUTH NS,0,0,0,2,2
Hurricane,Cindy,31,1999-08-26T15:00:00Z,30.1N  57.0W,12,14,1,0,27
Hurricane,Cindy,31,1999-08-26T15:00:00Z,HALIFAX NS,0,0,0,2,2
Hurricane,Cindy,31,1999-08-26T15:00:00Z,31.5N  58.5W,1,16,3,2,22
Hurricane,Cindy,31,1999-08-26T15:00:00Z,SABLE ISLAND NS,0,0,0,2,2
Hurricane,Cindy,31,1999-08-26T15:00:00Z,BERMUDA,0,0,3,8,11
Hurricane,Cindy,32,1999-08-26T21:00:00Z,30.0N  56.9W,43,0,0,0,43
Hurricane,Cindy,32,1999-08-26T21:00:00Z,33.0N  58.5W,6,12,2,2,22
Hurricane,Cindy,32,1999-08-26T21:00:00Z,31.8N  58.0W,21,5,1,0,27
Hurricane,Cindy,32,1999-08-26T21:00:00Z,BERMUDA,0,1,4,3,8
Hurricane,Cindy,33,1999-08-27T03:00:00Z,30.0N  56.4W,40,0,0,0,40
Hurricane,Cindy,33,1999-08-27T03:00:00Z,HALIFAX NS,0,0,0,2,2
Hurricane,Cindy,33,1999-08-27T03:00:00Z,31.8N  57.1W,19,6,0,1,26
Hurricane,Cindy,33,1999-08-27T03:00:00Z,SABLE ISLAND NS,0,0,0,4,4
Hurricane,Cindy,33,1999-08-27T03:00:00Z,33.7N  56.4W,1,11,5,2,19
Hurricane,Cindy,33,1999-08-27T03:00:00Z,EDDY POINT NS,0,0,0,2,2
Hurricane,Cindy,33,1999-08-27T03:00:00Z,BERMUDA,0,0,2,2,4
Hurricane,Cindy,34,1999-08-27T09:00:00Z,30.9N  58.6W,42,0,0,0,42
Hurricane,Cindy,34,1999-08-27T09:00:00Z,SABLE ISLAND NS,0,0,0,4,4
Hurricane,Cindy,34,1999-08-27T09:00:00Z,32.9N  58.9W,14,9,1,0,24
Hurricane,Cindy,34,1999-08-27T09:00:00Z,SYDNEY NS,0,0,0,2,2
Hurricane,Cindy,34,1999-08-27T09:00:00Z,35.0N  58.0W,0,7,8,3,18
Hurricane,Cindy,34,1999-08-27T09:00:00Z,EDDY POINT NS,0,0,0,2,2
Hurricane,Cindy,34,1999-08-27T09:00:00Z,BERMUDA,0,4,3,0,7
Hurricane,Cindy,34,1999-08-27T09:00:00Z,ILE ST PIERRE,0,0,0,2,2
Hurricane,Cindy,34,1999-08-27T09:00:00Z,HALIFAX NS,0,0,0,2,2
Hurricane,Cindy,34,1999-08-27T09:00:00Z,CAPE RACE NFLD,0,0,0,2,2
Hurricane,Cindy,35,1999-08-27T15:00:00Z,31.0N  58.7W,44,0,0,0,44
Hurricane,Cindy,35,1999-08-27T15:00:00Z,SYDNEY NS,0,0,0,2,2
Hurricane,Cindy,35,1999-08-27T15:00:00Z,33.4N  58.8W,9,16,1,0,26
Hurricane,Cindy,35,1999-08-27T15:00:00Z,EDDY POINT NS,0,0,0,2,2
Hurricane,Cindy,35,1999-08-27T15:00:00Z,35.5N  57.5W,0,7,10,2,19
Hurricane,Cindy,35,1999-08-27T15:00:00Z,ILE ST PIERRE,0,0,0,2,2
Hurricane,Cindy,35,1999-08-27T15:00:00Z,BERMUDA,0,3,1,0,4
Hurricane,Cindy,35,1999-08-27T15:00:00Z,CAPE RACE NFLD,0,0,0,2,2
Hurricane,Cindy,35,1999-08-27T15:00:00Z,SABLE ISLAND NS,0,0,0,4,4
Hurricane,Cindy,36,1999-08-27T21:00:00Z,31.7N  59.1W,42,0,0,0,42
Hurricane,Cindy,36,1999-08-27T21:00:00Z,EDDY POINT NS,0,0,0,2,2
Hurricane,Cindy,36,1999-08-27T21:00:00Z,34.1N  58.7W,11,13,1,0,25
Hurricane,Cindy,36,1999-08-27T21:00:00Z,BURGEO NFLD,0,0,0,2,2
Hurricane,Cindy,36,1999-08-27T21:00:00Z,36.5N  56.5W,0,3,13,3,19
Hurricane,Cindy,36,1999-08-27T21:00:00Z,ILE ST PIERRE,0,0,0,3,3
Hurricane,Cindy,36,1999-08-27T21:00:00Z,BERMUDA,0,3,1,0,4
Hurricane,Cindy,36,1999-08-27T21:00:00Z,CAPE RACE NFLD,0,0,0,4,4
Hurricane,Cindy,36,1999-08-27T21:00:00Z,SABLE ISLAND NS,0,0,0,5,5
Hurricane,Cindy,36,1999-08-27T21:00:00Z,HIBERNIA OILFLD,0,0,0,2,2
Hurricane,Cindy,36,1999-08-27T21:00:00Z,SYDNEY NS,0,0,0,2,2
Hurricane,Cindy,37,1999-08-28T03:00:00Z,31.5N  58.9W,40,0,0,0,40
Hurricane,Cindy,37,1999-08-28T03:00:00Z,SABLE ISLAND NS,0,0,0,3,3
Hurricane,Cindy,37,1999-08-28T03:00:00Z,33.6N  58.4W,13,11,1,0,25
Hurricane,Cindy,37,1999-08-28T03:00:00Z,ILE ST PIERRE,0,0,0,3,3
Hurricane,Cindy,37,1999-08-28T03:00:00Z,35.4N  56.3W,0,7,11,3,21
Hurricane,Cindy,37,1999-08-28T03:00:00Z,CAPE RACE NFLD,0,0,0,4,4
Hurricane,Cindy,37,1999-08-28T03:00:00Z,BERMUDA,0,2,2,0,4
Hurricane,Cindy,37,1999-08-28T03:00:00Z,HIBERNIA OILFLD,0,0,0,2,2
Hurricane,Cindy,38,1999-08-28T09:00:00Z,32.1N  59.2W,42,0,0,0,42
Hurricane,Cindy,38,1999-08-28T09:00:00Z,SYDNEY NS,0,0,0,2,2
Hurricane,Cindy,38,1999-08-28T09:00:00Z,34.2N  58.4W,10,14,2,0,26
Hurricane,Cindy,38,1999-08-28T09:00:00Z,BURGEO NFLD,0,0,0,2,2
Hurricane,Cindy,38,1999-08-28T09:00:00Z,36.5N  55.5W,0,2,14,4,20
Hurricane,Cindy,38,1999-08-28T09:00:00Z,ILE ST PIERRE,0,0,0,4,4
Hurricane,Cindy,38,1999-08-28T09:00:00Z,BERMUDA,0,2,0,0,2
Hurricane,Cindy,38,1999-08-28T09:00:00Z,CAPE RACE NFLD,0,0,0,6,6
Hurricane,Cindy,38,1999-08-28T09:00:00Z,SABLE ISLAND NS,0,0,0,4,4
Hurricane,Cindy,38,1999-08-28T09:00:00Z,HIBERNIA OILFLD,0,0,0,5,5
Hurricane,Cindy,39,1999-08-28T15:00:00Z,33.4N  58.7W,50,0,0,0,50
Hurricane,Cindy,39,1999-08-28T15:00:00Z,PTX BASQUES NFLD,0,0,0,2,2
Hurricane,Cindy,39,1999-08-28T15:00:00Z,35.4N  56.9W,6,22,2,0,30
Hurricane,Cindy,39,1999-08-28T15:00:00Z,BURGEO NFLD,0,0,0,3,3
Hurricane,Cindy,39,1999-08-28T15:00:00Z,38.0N  54.0W,0,0,15,4,19
Hurricane,Cindy,39,1999-08-28T15:00:00Z,ILE ST PIERRE,0,0,0,6,6
Hurricane,Cindy,39,1999-08-28T15:00:00Z,SABLE ISLAND NS,0,0,0,4,4
Hurricane,Cindy,39,1999-08-28T15:00:00Z,CAPE RACE NFLD,0,0,0,8,8
Hurricane,Cindy,39,1999-08-28T15:00:00Z,SYDNEY NS,0,0,0,2,2
Hurricane,Cindy,39,1999-08-28T15:00:00Z,HIBERNIA OILFLD,0,0,0,8,8
Hurricane,Cindy,40,1999-08-28T21:00:00Z,34.5N  57.9W,42,0,0,0,42
Hurricane,Cindy,40,1999-08-28T21:00:00Z,BURGEO NFLD,0,0,0,2,2
Hurricane,Cindy,40,1999-08-28T21:00:00Z,36.7N  55.6W,1,19,4,1,25
Hurricane,Cindy,40,1999-08-28T21:00:00Z,ILE ST PIERRE,0,0,0,4,4
Hurricane,Cindy,40,1999-08-28T21:00:00Z,39.5N  52.0W,0,0,13,4,17
Hurricane,Cindy,40,1999-08-28T21:00:00Z,CAPE RACE NFLD,0,0,0,7,7
Hurricane,Cindy,40,1999-08-28T21:00:00Z,SABLE ISLAND NS,0,0,1,2,3
Hurricane,Cindy,40,1999-08-28T21:00:00Z,HIBERNIA OILFLD,0,0,0,10,10
Hurricane,Cindy,41,1999-08-29T03:00:00Z,34.9N  56.8W,42,0,0,1,43
Hurricane,Cindy,41,1999-08-29T03:00:00Z,ILE ST PIERRE,0,0,0,3,3
Hurricane,Cindy,41,1999-08-29T03:00:00Z,37.2N  54.0W,1,20,4,0,25
Hurricane,Cindy,41,1999-08-29T03:00:00Z,CAPE RACE NFLD,0,0,1,5,6
Hurricane,Cindy,41,1999-08-29T03:00:00Z,40.0N  50.5W,0,0,13,4,17
Hurricane,Cindy,41,1999-08-29T03:00:00Z,HIBERNIA OILFLD,0,0,0,8,8
Hurricane,Cindy,42,1999-08-29T09:00:00Z,36.6N  55.0W,37,4,0,0,41
Hurricane,Cindy,42,1999-08-29T09:00:00Z,CAPE RACE NFLD,0,0,2,3,5
Hurricane,Cindy,42,1999-08-29T09:00:00Z,39.6N  51.7W,0,17,5,1,23
Hurricane,Cindy,42,1999-08-29T09:00:00Z,HIBERNIA OILFLD,0,0,2,6,8
Hurricane,Cindy,42,1999-08-29T09:00:00Z,42.1N  47.0W,0,0,12,3,15
Hurricane,Cindy,43,1999-08-29T15:00:00Z,37.8N  53.8W,31,3,0,0,34
Hurricane,Cindy,43,1999-08-29T15:00:00Z,CAPE RACE NFLD,0,0,3,1,4
Hurricane,Cindy,43,1999-08-29T15:00:00Z,40.0N  50.0W,0,15,3,0,18
Hurricane,Cindy,43,1999-08-29T15:00:00Z,HIBERNIA OILFLD,0,0,4,4,8
Hurricane,Cindy,43,1999-08-29T15:00:00Z,42.5N  45.0W,0,1,9,3,13
Hurricane,Cindy,44,1999-08-29T21:00:00Z,36.5N  54.5W,32,0,0,0,32
Hurricane,Cindy,44,1999-08-29T21:00:00Z,ILE ST PIERRE,0,0,2,0,2
Hurricane,Cindy,44,1999-08-29T21:00:00Z,39.0N  51.0W,2,15,2,0,19
Hurricane,Cindy,44,1999-08-29T21:00:00Z,CAPE RACE NFLD,0,0,4,2,6
Hurricane,Cindy,44,1999-08-29T21:00:00Z,42.0N  46.5W,0,1,10,3,14
Hurricane,Cindy,44,1999-08-29T21:00:00Z,HIBERNIA OILFLD,0,0,4,5,9
Hurricane,Cindy,45,1999-08-30T03:00:00Z,37.1N  51.1W,28,1,0,0,29
Hurricane,Cindy,45,1999-08-30T03:00:00Z,41.9N  43.5W,0,3,9,3,15
Hurricane,Cindy,45,1999-08-30T03:00:00Z,39.2N  47.9W,2,14,2,0,18
Hurricane,Cindy,45,1999-08-30T03:00:00Z,HIBERNIA OILFLD,0,0,2,3,5
Hurricane,Cindy,46,1999-08-30T09:00:00Z,38.0N  49.6W,25,2,0,0,27
Hurricane,Cindy,46,1999-08-30T09:00:00Z,CAPE RACE NFLD,0,0,1,1,2
Hurricane,Cindy,46,1999-08-30T09:00:00Z,40.6N  45.6W,1,14,2,1,18
Hurricane,Cindy,46,1999-08-30T09:00:00Z,HIBERNIA OILFLD,0,0,3,3,6
Hurricane,Cindy,46,1999-08-30T09:00:00Z,43.5N  40.5W,0,2,9,3,14
Hurricane,Cindy,47,1999-08-30T15:00:00Z,39.0N  49.0W,22,2,0,0,24
Hurricane,Cindy,47,1999-08-30T15:00:00Z,CAPE RACE NFLD,0,1,2,0,3
Hurricane,Cindy,47,1999-08-30T15:00:00Z,41.5N  45.0W,1,11,3,1,16
Hurricane,Cindy,47,1999-08-30T15:00:00Z,HIBERNIA OILFLD,0,2,4,1,7
Hurricane,Cindy,47,1999-08-30T15:00:00Z,45.0N  38.5W,0,0,8,3,11
Hurricane,Cindy,48,1999-08-30T21:00:00Z,41.0N  47.0W,15,3,0,1,19
Hurricane,Cindy,48,1999-08-30T21:00:00Z,CAPE RACE NFLD,1,1,1,0,3
Hurricane,Cindy,48,1999-08-30T21:00:00Z,44.0N  42.0W,0,9,3,0,12
Hurricane,Cindy,48,1999-08-30T21:00:00Z,HIBERNIA OILFLD,0,6,2,0,8
Hurricane,Cindy,48,1999-08-30T21:00:00Z,47.0N  37.0W,0,2,6,3,11
Hurricane,Cindy,49,1999-08-31T03:00:00Z,44.5N  43.0W,16,7,1,0,24
Hurricane,Cindy,49,1999-08-31T03:00:00Z,51.0N  29.0W,0,1,11,2,14
Hurricane,Cindy,49,1999-08-31T03:00:00Z,48.0N  36.5W,0,15,3,0,18
Hurricane,Cindy,49,1999-08-31T03:00:00Z,HIBERNIA OILFLD,4,4,1,0,9
Tropical Storm,Cindy,50,1999-08-31T09:00:00Z,44.0N  42.0W,17,4,1,0,22
Tropical Storm,Cindy,50,1999-08-31T09:00:00Z,CAPE RACE NFLD,0,1,1,0,2
Tropical Storm,Cindy,50,1999-08-31T09:00:00Z,44.7N  38.6W,2,13,2,1,18
Tropical Storm,Cindy,50,1999-08-31T09:00:00Z,HIBERNIA OILFLD,2,5,2,1,10
Tropical Storm,Cindy,50,1999-08-31T09:00:00Z,44.7N  35.3W,0,10,4,2,16
Tropical Depression,Five,2,1999-08-24T09:00:00Z,22.5N  71.4W,58,0,0,0,58
Tropical Depression,Five,2,1999-08-24T09:00:00Z,MIAMI FL,0,0,0,9,9
Tropical Depression,Five,2,1999-08-24T09:00:00Z,23.3N  72.7W,33,4,0,0,37
Tropical Depression,Five,2,1999-08-24T09:00:00Z,W PALM BEACH FL,0,0,0,11,11
Tropical Depression,Five,2,1999-08-24T09:00:00Z,24.5N  74.0W,3,17,8,1,29
Tropical Depression,Five,2,1999-08-24T09:00:00Z,FT PIERCE FL,0,0,0,11,11
Tropical Depression,Five,2,1999-08-24T09:00:00Z,MTPP 186N 724W,0,1,1,2,4
Tropical Depression,Five,2,1999-08-24T09:00:00Z,COCOA BEACH FL,0,0,0,10,10
Tropical Depression,Five,2,1999-08-24T09:00:00Z,MTCA 183N 738W,0,0,1,2,3
Tropical Depression,Five,2,1999-08-24T09:00:00Z,DAYTONA BEACH FL,0,0,0,8,8
Tropical Depression,Five,2,1999-08-24T09:00:00Z,MUGM 200N 751W,0,2,4,3,9
Tropical Depression,Five,2,1999-08-24T09:00:00Z,JACKSONVILLE FL,0,0,0,6,6
Tropical Depression,Five,2,1999-08-24T09:00:00Z,MUCM 214N 779W,0,0,1,6,7
Tropical Depression,Five,2,1999-08-24T09:00:00Z,SAVANNAH GA,0,0,0,5,5
Tropical Depression,Five,2,1999-08-24T09:00:00Z,MUCF 221N 805W,0,0,0,2,2
Tropical Depression,Five,2,1999-08-24T09:00:00Z,CHARLESTON SC,0,0,0,5,5
Tropical Depression,Five,2,1999-08-24T09:00:00Z,MDPP 198N 707W,14,0,0,1,15
Tropical Depression,Five,2,1999-08-24T09:00:00Z,MYRTLE BEACH SC,0,0,0,3,3
Tropical Depression,Five,2,1999-08-24T09:00:00Z,MBJT 215N 712W,49,0,0,0,49
Tropical Depression,Five,2,1999-08-24T09:00:00Z,WILMINGTON NC,0,0,0,2,2
Tropical Depression,Five,2,1999-08-24T09:00:00Z,MYMM 224N 730W,26,6,0,0,32
Tropical Depression,Five,2,1999-08-24T09:00:00Z,KEY WEST FL,0,0,0,3,3
Tropical Depression,Five,2,1999-08-24T09:00:00Z,MYSM 241N 745W,1,17,9,1,28
Tropical Depression,Five,2,1999-08-24T09:00:00Z,MARCO ISLAND FL,0,0,0,5,5
Tropical Depression,Five,2,1999-08-24T09:00:00Z,MYEG 235N 758W,0,6,12,3,21
Tropical Depression,Five,2,1999-08-24T09:00:00Z,FT MYERS FL,0,0,0,5,5
Tropical Depression,Five,2,1999-08-24T09:00:00Z,MYAK 241N 776W,0,0,6,9,15
Tropical Depression,Five,2,1999-08-24T09:00:00Z,VENICE FL,0,0,0,4,4
Tropical Depression,Five,2,1999-08-24T09:00:00Z,MYNN 251N 775W,0,0,7,10,17
Tropical Depression,Five,2,1999-08-24T09:00:00Z,TAMPA FL,0,0,0,5,5
Tropical Depression,Five,2,1999-08-24T09:00:00Z,MYGF 266N 787W,0,0,1,14,15
Tropical Depression,Five,2,1999-08-24T09:00:00Z,CEDAR KEY FL,0,0,0,4,4
Tropical Depression,Five,2,1999-08-24T09:00:00Z,MARATHON FL,0,0,0,5,5
Tropical Depression,Five,2,1999-08-24T09:00:00Z,ST MARKS FL,0,0,0,2,2
Tropical Depression,Five,3,1999-08-24T15:00:00Z,23.5N  73.5W,56,0,0,0,56
Tropical Depression,Five,3,1999-08-24T15:00:00Z,COCOA BEACH FL,0,0,3,13,16
Tropical Depression,Five,3,1999-08-24T15:00:00Z,24.5N  75.5W,11,26,0,0,37
Tropical Depression,Five,3,1999-08-24T15:00:00Z,DAYTONA BEACH FL,0,0,1,13,14
Tropical Depression,Five,3,1999-08-24T15:00:00Z,25.5N  76.5W,0,25,3,1,29
Tropical Depression,Five,3,1999-08-24T15:00:00Z,JACKSONVILLE FL,0,0,0,12,12
Tropical Depression,Five,3,1999-08-24T15:00:00Z,MUGM 200N 751W,0,2,2,2,6
Tropical Depression,Five,3,1999-08-24T15:00:00Z,SAVANNAH GA,0,0,0,9,9
Tropical Depression,Five,3,1999-08-24T15:00:00Z,MUCM 214N 779W,0,2,4,4,10
Tropical Depression,Five,3,1999-08-24T15:00:00Z,CHARLESTON SC,0,0,0,7,7
Tropical Depression,Five,3,1999-08-24T15:00:00Z,MUCF 221N 805W,0,0,1,4,5
Tropical Depression,Five,3,1999-08-24T15:00:00Z,MYRTLE BEACH SC,0,0,0,4,4
Tropical Depression,Five,3,1999-08-24T15:00:00Z,MUHA 230N 824W,0,0,0,3,3
Tropical Depression,Five,3,1999-08-24T15:00:00Z,WILMINGTON NC,0,0,0,2,2
Tropical Depression,Five,3,1999-08-24T15:00:00Z,MBJT 215N 712W,99,0,0,0,99
Tropical Depression,Five,3,1999-08-24T15:00:00Z,KEY WEST FL,0,0,1,7,8
Tropical Depression,Five,3,1999-08-24T15:00:00Z,MYMM 224N 730W,58,0,0,0,58
Tropical Depression,Five,3,1999-08-24T15:00:00Z,MARCO ISLAND FL,0,0,1,11,12
Tropical Depression,Five,3,1999-08-24T15:00:00Z,MYSM 241N 745W,32,10,0,0,42
Tropical Depression,Five,3,1999-08-24T15:00:00Z,FT MYERS FL,0,0,1,11,12
Tropical Depression,Five,3,1999-08-24T15:00:00Z,MYEG 235N 758W,9,24,0,1,34
Tropical Depression,Five,3,1999-08-24T15:00:00Z,VENICE FL,0,0,0,11,11
Tropical Depression,Five,3,1999-08-24T15:00:00Z,MYAK 241N 776W,0,15,6,2,23
Tropical Depression,Five,3,1999-08-24T15:00:00Z,TAMPA FL,0,0,0,11,11
Tropical Depression,Five,3,1999-08-24T15:00:00Z,MYNN 251N 775W,0,16,7,2,25
Tropical Depression,Five,3,1999-08-24T15:00:00Z,CEDAR KEY FL,0,0,0,10,10
Tropical Depression,Five,3,1999-08-24T15:00:00Z,MYGF 266N 787W,0,2,13,6,21
Tropical Depression,Five,3,1999-08-24T15:00:00Z,ST MARKS FL,0,0,0,7,7
Tropical Depression,Five,3,1999-08-24T15:00:00Z,MARATHON FL,0,0,2,9,11
Tropical Depression,Five,3,1999-08-24T15:00:00Z,APALACHICOLA FL,0,0,0,5,5
Tropical Depression,Five,3,1999-08-24T15:00:00Z,MIAMI FL,0,0,6,10,16
Tropical Depression,Five,3,1999-08-24T15:00:00Z,PANAMA CITY FL,0,0,0,4,4
Tropical Depression,Five,3,1999-08-24T15:00:00Z,W PALM BEACH FL,0,0,7,11,18
Tropical Depression,Five,3,1999-08-24T15:00:00Z,GULF 29N 85W,0,0,0,5,5
Tropical Depression,Five,3,1999-08-24T15:00:00Z,FT PIERCE FL,0,0,5,12,17
Tropical Storm,Dennis,4,1999-08-24T21:00:00Z,24.7N  74.0W,59,0,0,0,59
Tropical Storm,Dennis,4,1999-08-24T21:00:00Z,JACKSONVILLE FL,0,0,1,12,13
Tropical Storm,Dennis,4,1999-08-24T21:00:00Z,25.7N  75.5W,20,14,0,1,35
Tropical Storm,Dennis,4,1999-08-24T21:00:00Z,SAVANNAH GA,0,0,1,12,13
Tropical Storm,Dennis,4,1999-08-24T21:00:00Z,27.5N  77.0W,0,16,13,1,30
Tropical Storm,Dennis,4,1999-08-24T21:00:00Z,CHARLESTON SC,0,0,1,12,13
Tropical Storm,Dennis,4,1999-08-24T21:00:00Z,MUCM 214N 779W,0,0,1,1,2
Tropical Storm,Dennis,4,1999-08-24T21:00:00Z,MYRTLE BEACH SC,0,0,0,11,11
Tropical Storm,Dennis,4,1999-08-24T21:00:00Z,MBJT 215N 712W,2,0,0,1,3
Tropical Storm,Dennis,4,1999-08-24T21:00:00Z,WILMINGTON NC,0,0,0,8,8
Tropical Storm,Dennis,4,1999-08-24T21:00:00Z,MYMM 224N 730W,48,0,0,0,48
Tropical Storm,Dennis,4,1999-08-24T21:00:00Z,MOREHEAD CITY NC,0,0,0,6,6
Tropical Storm,Dennis,4,1999-08-24T21:00:00Z,MYSM 241N 745W,44,0,0,0,44
Tropical Storm,Dennis,4,1999-08-24T21:00:00Z,CAPE HATTERAS NC,0,0,0,3,3
Tropical Storm,Dennis,4,1999-08-24T21:00:00Z,MYEG 235N 758W,13,8,1,1,23
Tropical Storm,Dennis,4,1999-08-24T21:00:00Z,KEY WEST FL,0,0,0,3,3
Tropical Storm,Dennis,4,1999-08-24T21:00:00Z,MYAK 241N 776W,0,12,5,1,18
Tropical Storm,Dennis,4,1999-08-24T21:00:00Z,MARCO ISLAND FL,0,0,2,5,7
Tropical Storm,Dennis,4,1999-08-24T21:00:00Z,MYNN 251N 775W,1,16,6,1,24
Tropical Storm,Dennis,4,1999-08-24T21:00:00Z,FT MYERS FL,0,0,2,6,8
Tropical Storm,Dennis,4,1999-08-24T21:00:00Z,MYGF 266N 787W,0,5,15,2,22
Tropical Storm,Dennis,4,1999-08-24T21:00:00Z,VENICE FL,0,0,1,6,7
Tropical Storm,Dennis,4,1999-08-24T21:00:00Z,MARATHON FL,0,0,1,4,5
Tropical Storm,Dennis,4,1999-08-24T21:00:00Z,TAMPA FL,0,0,1,8,9
Tropical Storm,Dennis,4,1999-08-24T21:00:00Z,MIAMI FL,0,0,7,5,12
Tropical Storm,Dennis,4,1999-08-24T21:00:00Z,CEDAR KEY FL,0,0,0,9,9
Tropical Storm,Dennis,4,1999-08-24T21:00:00Z,W PALM BEACH FL,0,0,10,5,15
Tropical Storm,Dennis,4,1999-08-24T21:00:00Z,ST MARKS FL,0,0,0,6,6
Tropical Storm,Dennis,4,1999-08-24T21:00:00Z,FT PIERCE FL,0,0,9,7,16
Tropical Storm,Dennis,4,1999-08-24T21:00:00Z,APALACHICOLA FL,0,0,0,3,3
Tropical Storm,Dennis,4,1999-08-24T21:00:00Z,COCOA BEACH FL,0,0,8,8,16
Tropical Storm,Dennis,4,1999-08-24T21:00:00Z,PANAMA CITY FL,0,0,0,2,2
Tropical Storm,Dennis,4,1999-08-24T21:00:00Z,DAYTONA BEACH FL,0,0,4,11,15
Tropical Storm,Dennis,4,1999-08-24T21:00:00Z,GULF 29N 85W,0,0,0,3,3
Tropical Storm,Dennis,5,1999-08-25T03:00:00Z,24.3N  74.4W,55,0,0,0,55
Tropical Storm,Dennis,5,1999-08-25T03:00:00Z,JACKSONVILLE FL,0,0,1,12,13
Tropical Storm,Dennis,5,1999-08-25T03:00:00Z,25.9N  75.9W,16,23,0,0,39
Tropical Storm,Dennis,5,1999-08-25T03:00:00Z,SAVANNAH GA,0,0,0,13,13
Tropical Storm,Dennis,5,1999-08-25T03:00:00Z,27.5N  77.0W,0,20,9,1,30
Tropical Storm,Dennis,5,1999-08-25T03:00:00Z,CHARLESTON SC,0,0,1,13,14
Tropical Storm,Dennis,5,1999-08-25T03:00:00Z,MUCM 214N 779W,0,1,1,1,3
Tropical Storm,Dennis,5,1999-08-25T03:00:00Z,MYRTLE BEACH SC,0,0,0,12,12
Tropical Storm,Dennis,5,1999-08-25T03:00:00Z,MBJT 215N 712W,9,0,0,0,9
Tropical Storm,Dennis,5,1999-08-25T03:00:00Z,WILMINGTON NC,0,0,0,9,9
Tropical Storm,Dennis,5,1999-08-25T03:00:00Z,MYMM 224N 730W,57,0,0,0,57
Tropical Storm,Dennis,5,1999-08-25T03:00:00Z,MOREHEAD CITY NC,0,0,0,6,6
Tropical Storm,Dennis,5,1999-08-25T03:00:00Z,MYSM 241N 745W,53,1,0,0,54
Tropical Storm,Dennis,5,1999-08-25T03:00:00Z,CAPE HATTERAS NC,0,0,0,3,3
Tropical Storm,Dennis,5,1999-08-25T03:00:00Z,MYEG 235N 758W,27,7,0,0,34
Tropical Storm,Dennis,5,1999-08-25T03:00:00Z,KEY WEST FL,0,0,0,3,3
Tropical Storm,Dennis,5,1999-08-25T03:00:00Z,MYAK 241N 776W,2,17,2,1,22
Tropical Storm,Dennis,5,1999-08-25T03:00:00Z,MARCO ISLAND FL,0,0,1,5,6
Tropical Storm,Dennis,5,1999-08-25T03:00:00Z,MYNN 251N 775W,2,22,3,0,27
Tropical Storm,Dennis,5,1999-08-25T03:00:00Z,FT MYERS FL,0,0,1,6,7
Tropical Storm,Dennis,5,1999-08-25T03:00:00Z,MYGF 266N 787W,0,8,12,3,23
Tropical Storm,Dennis,5,1999-08-25T03:00:00Z,VENICE FL,0,0,0,6,6
Tropical Storm,Dennis,5,1999-08-25T03:00:00Z,MARATHON FL,0,0,1,4,5
Tropical Storm,Dennis,5,1999-08-25T03:00:00Z,TAMPA FL,0,0,0,8,8
Tropical Storm,Dennis,5,1999-08-25T03:00:00Z,MIAMI FL,0,0,7,5,12
Tropical Storm,Dennis,5,1999-08-25T03:00:00Z,CEDAR KEY FL,0,0,0,8,8
Tropical Storm,Dennis,5,1999-08-25T03:00:00Z,W PALM BEACH FL,0,1,9,6,16
Tropical Storm,Dennis,5,1999-08-25T03:00:00Z,ST MARKS FL,0,0,0,5,5
Tropical Storm,Dennis,5,1999-08-25T03:00:00Z,FT PIERCE FL,0,0,9,7,16
Tropical Storm,Dennis,5,1999-08-25T03:00:00Z,APALACHICOLA FL,0,0,0,3,3
Tropical Storm,Dennis,5,1999-08-25T03:00:00Z,COCOA BEACH FL,0,0,7,9,16
Tropical Storm,Dennis,5,1999-08-25T03:00:00Z,PANAMA CITY FL,0,0,0,2,2
Tropical Storm,Dennis,5,1999-08-25T03:00:00Z,DAYTONA BEACH FL,0,0,3,12,15
Tropical Storm,Dennis,5,1999-08-25T03:00:00Z,GULF 29N 85W,0,0,0,2,2
Tropical Storm,Dennis,6,1999-08-25T09:00:00Z,24.5N  75.4W,58,0,0,0,58
Tropical Storm,Dennis,6,1999-08-25T09:00:00Z,CHARLESTON SC,0,0,0,11,11
Tropical Storm,Dennis,6,1999-08-25T09:00:00Z,25.5N  76.5W,26,8,1,0,35
Tropical Storm,Dennis,6,1999-08-25T09:00:00Z,MYRTLE BEACH SC,0,0,0,9,9
Tropical Storm,Dennis,6,1999-08-25T09:00:00Z,27.0N  77.5W,1,16,8,2,27
Tropical Storm,Dennis,6,1999-08-25T09:00:00Z,WILMINGTON NC,0,0,0,6,6
Tropical Storm,Dennis,6,1999-08-25T09:00:00Z,MUCM 214N 779W,0,2,1,0,3
Tropical Storm,Dennis,6,1999-08-25T09:00:00Z,MOREHEAD CITY NC,0,0,0,4,4
Tropical Storm,Dennis,6,1999-08-25T09:00:00Z,MYMM 224N 730W,99,0,0,0,99
Tropical Storm,Dennis,6,1999-08-25T09:00:00Z,CAPE HATTERAS NC,0,0,0,2,2
Tropical Storm,Dennis,6,1999-08-25T09:00:00Z,MYSM 241N 745W,79,0,0,0,79
Tropical Storm,Dennis,6,1999-08-25T09:00:00Z,KEY WEST FL,0,0,2,3,5
Tropical Storm,Dennis,6,1999-08-25T09:00:00Z,MYEG 235N 758W,41,0,0,0,41
Tropical Storm,Dennis,6,1999-08-25T09:00:00Z,MARCO ISLAND FL,0,0,4,6,10
Tropical Storm,Dennis,6,1999-08-25T09:00:00Z,MYAK 241N 776W,6,14,1,1,22
Tropical Storm,Dennis,6,1999-08-25T09:00:00Z,FT MYERS FL,0,0,3,8,11
Tropical Storm,Dennis,6,1999-08-25T09:00:00Z,MYNN 251N 775W,6,19,1,1,27
Tropical Storm,Dennis,6,1999-08-25T09:00:00Z,VENICE FL,0,0,2,8,10
Tropical Storm,Dennis,6,1999-08-25T09:00:00Z,MYGF 266N 787W,0,9,12,2,23
Tropical Storm,Dennis,6,1999-08-25T09:00:00Z,TAMPA FL,0,0,2,9,11
Tropical Storm,Dennis,6,1999-08-25T09:00:00Z,MARATHON FL,0,0,4,4,8
Tropical Storm,Dennis,6,1999-08-25T09:00:00Z,CEDAR KEY FL,0,0,1,10,11
Tropical Storm,Dennis,6,1999-08-25T09:00:00Z,MIAMI FL,0,1,10,3,14
Tropical Storm,Dennis,6,1999-08-25T09:00:00Z,ST MARKS FL,0,0,0,8,8
Tropical Storm,Dennis,6,1999-08-25T09:00:00Z,W PALM BEACH FL,0,1,12,4,17
Tropical Storm,Dennis,6,1999-08-25T09:00:00Z,APALACHICOLA FL,0,0,0,6,6
Tropical Storm,Dennis,6,1999-08-25T09:00:00Z,FT PIERCE FL,0,0,11,6,17
Tropical Storm,Dennis,6,1999-08-25T09:00:00Z,PANAMA CITY FL,0,0,0,5,5
Tropical Storm,Dennis,6,1999-08-25T09:00:00Z,COCOA BEACH FL,0,0,8,9,17
Tropical Storm,Dennis,6,1999-08-25T09:00:00Z,PENSACOLA FL,0,0,0,3,3
Tropical Storm,Dennis,6,1999-08-25T09:00:00Z,DAYTONA BEACH FL,0,0,4,11,15
Tropical Storm,Dennis,6,1999-08-25T09:00:00Z,MOBILE AL,0,0,0,2,2
Tropical Storm,Dennis,6,1999-08-25T09:00:00Z,JACKSONVILLE FL,0,0,1,12,13
Tropical Storm,Dennis,6,1999-08-25T09:00:00Z,GULF 29N 85W,0,0,0,6,6
Tropical Storm,Dennis,6,1999-08-25T09:00:00Z,SAVANNAH GA,0,0,0,12,12
Tropical Storm,Dennis,6,1999-08-25T09:00:00Z,GULF 29N 87W,0,0,0,2,2
Tropical Storm,Dennis,7,1999-08-25T15:00:00Z,24.2N  75.0W,49,0,0,0,49
Tropical Storm,Dennis,7,1999-08-25T15:00:00Z,SAVANNAH GA,0,0,0,12,12
Tropical Storm,Dennis,7,1999-08-25T15:00:00Z,25.2N  76.0W,29,5,1,0,35
Tropical Storm,Dennis,7,1999-08-25T15:00:00Z,CHARLESTON SC,0,0,0,11,11
Tropical Storm,Dennis,7,1999-08-25T15:00:00Z,26.5N  77.5W,1,15,10,1,27
Tropical Storm,Dennis,7,1999-08-25T15:00:00Z,MYRTLE BEACH SC,0,0,0,9,9
Tropical Storm,Dennis,7,1999-08-25T15:00:00Z,MUCM 214N 779W,0,1,1,1,3
Tropical Storm,Dennis,7,1999-08-25T15:00:00Z,WILMINGTON NC,0,0,0,7,7
Tropical Storm,Dennis,7,1999-08-25T15:00:00Z,MUCF 221N 805W,0,0,1,1,2
Tropical Storm,Dennis,7,1999-08-25T15:00:00Z,MOREHEAD CITY NC,0,0,0,5,5
Tropical Storm,Dennis,7,1999-08-25T15:00:00Z,MUHA 230N 824W,0,0,0,2,2
Tropical Storm,Dennis,7,1999-08-25T15:00:00Z,CAPE HATTERAS NC,0,0,0,2,2
Tropical Storm,Dennis,7,1999-08-25T15:00:00Z,MYMM 224N 730W,99,0,0,0,99
Tropical Storm,Dennis,7,1999-08-25T15:00:00Z,KEY WEST FL,0,0,2,4,6
Tropical Storm,Dennis,7,1999-08-25T15:00:00Z,MYSM 241N 745W,57,0,0,0,57
Tropical Storm,Dennis,7,1999-08-25T15:00:00Z,MARCO ISLAND FL,0,0,4,7,11
Tropical Storm,Dennis,7,1999-08-25T15:00:00Z,MYEG 235N 758W,32,0,0,1,33
Tropical Storm,Dennis,7,1999-08-25T15:00:00Z,FT MYERS FL,0,0,3,8,11
Tropical Storm,Dennis,7,1999-08-25T15:00:00Z,MYAK 241N 776W,5,12,3,1,21
Tropical Storm,Dennis,7,1999-08-25T15:00:00Z,VENICE FL,0,0,2,8,10
Tropical Storm,Dennis,7,1999-08-25T15:00:00Z,MYNN 251N 775W,5,15,5,0,25
Tropical Storm,Dennis,7,1999-08-25T15:00:00Z,TAMPA FL,0,0,1,10,11
Tropical Storm,Dennis,7,1999-08-25T15:00:00Z,MYGF 266N 787W,0,5,15,2,22
Tropical Storm,Dennis,7,1999-08-25T15:00:00Z,CEDAR KEY FL,0,0,0,11,11
Tropical Storm,Dennis,7,1999-08-25T15:00:00Z,MARATHON FL,0,0,4,5,9
Tropical Storm,Dennis,7,1999-08-25T15:00:00Z,ST MARKS FL,0,0,0,9,9
Tropical Storm,Dennis,7,1999-08-25T15:00:00Z,MIAMI FL,0,0,10,5,15
Tropical Storm,Dennis,7,1999-08-25T15:00:00Z,APALACHICOLA FL,0,0,0,7,7
Tropical Storm,Dennis,7,1999-08-25T15:00:00Z,W PALM BEACH FL,0,0,12,5,17
Tropical Storm,Dennis,7,1999-08-25T15:00:00Z,PANAMA CITY FL,0,0,0,6,6
Tropical Storm,Dennis,7,1999-08-25T15:00:00Z,FT PIERCE FL,0,0,10,7,17
Tropical Storm,Dennis,7,1999-08-25T15:00:00Z,PENSACOLA FL,0,0,0,3,3
Tropical Storm,Dennis,7,1999-08-25T15:00:00Z,COCOA BEACH FL,0,0,7,9,16
Tropical Storm,Dennis,7,1999-08-25T15:00:00Z,MOBILE AL,0,0,0,2,2
Tropical Storm,Dennis,7,1999-08-25T15:00:00Z,DAYTONA BEACH FL,0,0,3,12,15
Tropical Storm,Dennis,7,1999-08-25T15:00:00Z,GULF 29N 85W,0,0,0,6,6
Tropical Storm,Dennis,7,1999-08-25T15:00:00Z,JACKSONVILLE FL,0,0,1,12,13
Tropical Storm,Dennis,7,1999-08-25T15:00:00Z,GULF 29N 87W,0,0,0,2,2
Tropical Storm,Dennis,8,1999-08-25T21:00:00Z,24.0N  74.0W,53,0,0,0,53
Tropical Storm,Dennis,8,1999-08-25T21:00:00Z,CHARLESTON SC,0,0,0,11,11
Tropical Storm,Dennis,8,1999-08-25T21:00:00Z,25.0N  75.0W,29,5,1,0,35
Tropical Storm,Dennis,8,1999-08-25T21:00:00Z,MYRTLE BEACH SC,0,0,0,9,9
Tropical Storm,Dennis,8,1999-08-25T21:00:00Z,26.5N  77.0W,0,13,17,1,31
Tropical Storm,Dennis,8,1999-08-25T21:00:00Z,WILMINGTON NC,0,0,0,6,6
Tropical Storm,Dennis,8,1999-08-25T21:00:00Z,MBJT 215N 712W,5,0,0,0,5
Tropical Storm,Dennis,8,1999-08-25T21:00:00Z,MOREHEAD CITY NC,0,0,0,4,4
Tropical Storm,Dennis,8,1999-08-25T21:00:00Z,MYMM 224N 730W,99,0,0,0,99
Tropical Storm,Dennis,8,1999-08-25T21:00:00Z,CAPE HATTERAS NC,0,0,0,2,2
Tropical Storm,Dennis,8,1999-08-25T21:00:00Z,MYSM 241N 745W,42,1,0,0,43
Tropical Storm,Dennis,8,1999-08-25T21:00:00Z,KEY WEST FL,0,0,1,3,4
Tropical Storm,Dennis,8,1999-08-25T21:00:00Z,MYEG 235N 758W,16,6,1,1,24
Tropical Storm,Dennis,8,1999-08-25T21:00:00Z,MARCO ISLAND FL,0,0,3,6,9
Tropical Storm,Dennis,8,1999-08-25T21:00:00Z,MYAK 241N 776W,0,9,9,1,19
Tropical Storm,Dennis,8,1999-08-25T21:00:00Z,FT MYERS FL,0,0,2,8,10
Tropical Storm,Dennis,8,1999-08-25T21:00:00Z,MYNN 251N 775W,0,12,13,0,25
Tropical Storm,Dennis,8,1999-08-25T21:00:00Z,VENICE FL,0,0,1,8,9
Tropical Storm,Dennis,8,1999-08-25T21:00:00Z,MYGF 266N 787W,0,2,18,2,22
Tropical Storm,Dennis,8,1999-08-25T21:00:00Z,TAMPA FL,0,0,1,10,11
Tropical Storm,Dennis,8,1999-08-25T21:00:00Z,MARATHON FL,0,0,2,5,7
Tropical Storm,Dennis,8,1999-08-25T21:00:00Z,CEDAR KEY FL,0,0,0,11,11
Tropical Storm,Dennis,8,1999-08-25T21:00:00Z,MIAMI FL,0,0,8,5,13
Tropical Storm,Dennis,8,1999-08-25T21:00:00Z,ST MARKS FL,0,0,0,8,8
Tropical Storm,Dennis,8,1999-08-25T21:00:00Z,W PALM BEACH FL,0,0,11,5,16
Tropical Storm,Dennis,8,1999-08-25T21:00:00Z,APALACHICOLA FL,0,0,0,6,6
Tropical Storm,Dennis,8,1999-08-25T21:00:00Z,FT PIERCE FL,0,0,9,8,17
Tropical Storm,Dennis,8,1999-08-25T21:00:00Z,PANAMA CITY FL,0,0,0,5,5
Tropical Storm,Dennis,8,1999-08-25T21:00:00Z,COCOA BEACH FL,0,0,6,10,16
Tropical Storm,Dennis,8,1999-08-25T21:00:00Z,PENSACOLA FL,0,0,0,3,3
Tropical Storm,Dennis,8,1999-08-25T21:00:00Z,DAYTONA BEACH FL,0,0,3,12,15
Tropical Storm,Dennis,8,1999-08-25T21:00:00Z,GULF 29N 85W,0,0,0,6,6
Tropical Storm,Dennis,8,1999-08-25T21:00:00Z,JACKSONVILLE FL,0,0,0,13,13
Tropical Storm,Dennis,8,1999-08-25T21:00:00Z,GULF 29N 87W,0,0,0,2,2
Tropical Storm,Dennis,8,1999-08-25T21:00:00Z,SAVANNAH GA,0,0,0,12,12
Tropical Storm,Dennis,9,1999-08-26T03:00:00Z,24.8N  74.3W,55,0,0,0,55
Tropical Storm,Dennis,9,1999-08-26T03:00:00Z,CHARLESTON SC,0,0,0,11,11
Tropical Storm,Dennis,9,1999-08-26T03:00:00Z,25.8N  75.5W,29,3,0,1,33
Tropical Storm,Dennis,9,1999-08-26T03:00:00Z,MYRTLE BEACH SC,0,0,0,10,10
Tropical Storm,Dennis,9,1999-08-26T03:00:00Z,27.0N  77.0W,2,17,6,1,26
Tropical Storm,Dennis,9,1999-08-26T03:00:00Z,WILMINGTON NC,0,0,0,8,8
Tropical Storm,Dennis,9,1999-08-26T03:00:00Z,MUCM 214N 779W,0,0,0,2,2
Tropical Storm,Dennis,9,1999-08-26T03:00:00Z,MOREHEAD CITY NC,0,0,0,6,6
Tropical Storm,Dennis,9,1999-08-26T03:00:00Z,MYMM 224N 730W,16,1,0,0,17
Tropical Storm,Dennis,9,1999-08-26T03:00:00Z,CAPE HATTERAS NC,0,0,0,4,4
Tropical Storm,Dennis,9,1999-08-26T03:00:00Z,MYSM 241N 745W,44,0,0,0,44
Tropical Storm,Dennis,9,1999-08-26T03:00:00Z,NORFOLK VA,0,0,0,2,2
Tropical Storm,Dennis,9,1999-08-26T03:00:00Z,MYEG 235N 758W,16,3,1,0,20
Tropical Storm,Dennis,9,1999-08-26T03:00:00Z,KEY WEST FL,0,0,1,4,5
Tropical Storm,Dennis,9,1999-08-26T03:00:00Z,MYAK 241N 776W,1,10,3,2,16
Tropical Storm,Dennis,9,1999-08-26T03:00:00Z,MARCO ISLAND FL,0,0,4,5,9
Tropical Storm,Dennis,9,1999-08-26T03:00:00Z,MYNN 251N 775W,2,14,4,1,21
Tropical Storm,Dennis,9,1999-08-26T03:00:00Z,FT MYERS FL,0,0,4,6,10
Tropical Storm,Dennis,9,1999-08-26T03:00:00Z,MYGF 266N 787W,0,7,12,2,21
Tropical Storm,Dennis,9,1999-08-26T03:00:00Z,VENICE FL,0,0,2,7,9
Tropical Storm,Dennis,9,1999-08-26T03:00:00Z,MARATHON FL,0,0,3,4,7
Tropical Storm,Dennis,9,1999-08-26T03:00:00Z,TAMPA FL,0,0,2,9,11
Tropical Storm,Dennis,9,1999-08-26T03:00:00Z,MIAMI FL,0,1,8,4,13
Tropical Storm,Dennis,9,1999-08-26T03:00:00Z,CEDAR KEY FL,0,0,1,9,10
Tropical Storm,Dennis,9,1999-08-26T03:00:00Z,W PALM BEACH FL,0,1,11,4,16
Tropical Storm,Dennis,9,1999-08-26T03:00:00Z,ST MARKS FL,0,0,0,8,8
Tropical Storm,Dennis,9,1999-08-26T03:00:00Z,FT PIERCE FL,0,1,10,5,16
Tropical Storm,Dennis,9,1999-08-26T03:00:00Z,APALACHICOLA FL,0,0,0,5,5
Tropical Storm,Dennis,9,1999-08-26T03:00:00Z,COCOA BEACH FL,0,0,9,7,16
Tropical Storm,Dennis,9,1999-08-26T03:00:00Z,PANAMA CITY FL,0,0,0,4,4
Tropical Storm,Dennis,9,1999-08-26T03:00:00Z,DAYTONA BEACH FL,0,0,5,10,15
Tropical Storm,Dennis,9,1999-08-26T03:00:00Z,PENSACOLA FL,0,0,0,2,2
Tropical Storm,Dennis,9,1999-08-26T03:00:00Z,JACKSONVILLE FL,0,0,1,12,13
Tropical Storm,Dennis,9,1999-08-26T03:00:00Z,GULF 29N 85W,0,0,0,5,5
Tropical Storm,Dennis,9,1999-08-26T03:00:00Z,SAVANNAH GA,0,0,0,12,12
Tropical Storm,Dennis,9,1999-08-26T03:00:00Z,GULF 29N 87W,0,0,0,2,2
Hurricane,Dennis,10,1999-08-26T09:00:00Z,24.9N  74.8W,54,0,0,0,54
Hurricane,Dennis,10,1999-08-26T09:00:00Z,CHARLESTON SC,0,0,0,12,12
Hurricane,Dennis,10,1999-08-26T09:00:00Z,26.0N  76.1W,25,8,1,0,34
Hurricane,Dennis,10,1999-08-26T09:00:00Z,MYRTLE BEACH SC,0,0,0,11,11
Hurricane,Dennis,10,1999-08-26T09:00:00Z,27.5N  77.5W,1,14,11,1,27
Hurricane,Dennis,10,1999-08-26T09:00:00Z,WILMINGTON NC,0,0,0,9,9
Hurricane,Dennis,10,1999-08-26T09:00:00Z,MYMM 224N 730W,12,0,0,0,12
Hurricane,Dennis,10,1999-08-26T09:00:00Z,MOREHEAD CITY NC,0,0,0,7,7
Hurricane,Dennis,10,1999-08-26T09:00:00Z,MYSM 241N 745W,55,0,0,0,55
Hurricane,Dennis,10,1999-08-26T09:00:00Z,CAPE HATTERAS NC,0,0,0,5,5
Hurricane,Dennis,10,1999-08-26T09:00:00Z,MYEG 235N 758W,23,1,1,0,25
Hurricane,Dennis,10,1999-08-26T09:00:00Z,NORFOLK VA,0,0,0,2,2
Hurricane,Dennis,10,1999-08-26T09:00:00Z,MYAK 241N 776W,5,12,1,1,19
Hurricane,Dennis,10,1999-08-26T09:00:00Z,KEY WEST FL,0,0,2,2,4
Hurricane,Dennis,10,1999-08-26T09:00:00Z,MYNN 251N 775W,7,15,2,0,24
Hurricane,Dennis,10,1999-08-26T09:00:00Z,MARCO ISLAND FL,0,0,4,5,9
Hurricane,Dennis,10,1999-08-26T09:00:00Z,MYGF 266N 787W,0,9,12,2,23
Hurricane,Dennis,10,1999-08-26T09:00:00Z,FT MYERS FL,0,0,4,6,10
Hurricane,Dennis,10,1999-08-26T09:00:00Z,MARATHON FL,0,0,4,3,7
Hurricane,Dennis,10,1999-08-26T09:00:00Z,VENICE FL,0,0,2,7,9
Hurricane,Dennis,10,1999-08-26T09:00:00Z,MIAMI FL,0,1,9,4,14
Hurricane,Dennis,10,1999-08-26T09:00:00Z,TAMPA FL,0,0,2,8,10
Hurricane,Dennis,10,1999-08-26T09:00:00Z,W PALM BEACH FL,0,1,12,3,16
Hurricane,Dennis,10,1999-08-26T09:00:00Z,CEDAR KEY FL,0,0,1,9,10
Hurricane,Dennis,10,1999-08-26T09:00:00Z,FT PIERCE FL,0,0,12,5,17
Hurricane,Dennis,10,1999-08-26T09:00:00Z,ST MARKS FL,0,0,0,7,7
Hurricane,Dennis,10,1999-08-26T09:00:00Z,COCOA BEACH FL,0,0,9,7,16
Hurricane,Dennis,10,1999-08-26T09:00:00Z,APALACHICOLA FL,0,0,0,5,5
Hurricane,Dennis,10,1999-08-26T09:00:00Z,DAYTONA BEACH FL,0,0,4,11,15
Hurricane,Dennis,10,1999-08-26T09:00:00Z,PANAMA CITY FL,0,0,0,4,4
Hurricane,Dennis,10,1999-08-26T09:00:00Z,JACKSONVILLE FL,0,0,1,12,13
Hurricane,Dennis,10,1999-08-26T09:00:00Z,PENSACOLA FL,0,0,0,2,2
Hurricane,Dennis,10,1999-08-26T09:00:00Z,SAVANNAH GA,0,0,0,12,12
Hurricane,Dennis,10,1999-08-26T09:00:00Z,GULF 29N 85W,0,0,0,4,4
Hurricane,Dennis,11,1999-08-26T15:00:00Z,25.5N  76.0W,58,0,0,0,58
Hurricane,Dennis,11,1999-08-26T15:00:00Z,CHARLESTON SC,0,0,3,14,17
Hurricane,Dennis,11,1999-08-26T15:00:00Z,27.5N  77.5W,5,31,1,0,37
Hurricane,Dennis,11,1999-08-26T15:00:00Z,MYRTLE BEACH SC,0,0,2,15,17
Hurricane,Dennis,11,1999-08-26T15:00:00Z,29.5N  78.0W,0,14,11,1,26
Hurricane,Dennis,11,1999-08-26T15:00:00Z,WILMINGTON NC,0,0,1,14,15
Hurricane,Dennis,11,1999-08-26T15:00:00Z,MYSM 241N 745W,99,0,0,0,99
Hurricane,Dennis,11,1999-08-26T15:00:00Z,MOREHEAD CITY NC,0,0,0,13,13
Hurricane,Dennis,11,1999-08-26T15:00:00Z,MYEG 235N 758W,37,0,0,0,37
Hurricane,Dennis,11,1999-08-26T15:00:00Z,CAPE HATTERAS NC,0,0,0,10,10
Hurricane,Dennis,11,1999-08-26T15:00:00Z,MYAK 241N 776W,16,7,1,0,24
Hurricane,Dennis,11,1999-08-26T15:00:00Z,NORFOLK VA,0,0,0,8,8
Hurricane,Dennis,11,1999-08-26T15:00:00Z,MYNN 251N 775W,22,12,0,0,34
Hurricane,Dennis,11,1999-08-26T15:00:00Z,OCEAN CITY MD,0,0,0,3,3
Hurricane,Dennis,11,1999-08-26T15:00:00Z,MYGF 266N 787W,1,25,1,0,27
Hurricane,Dennis,11,1999-08-26T15:00:00Z,MARCO ISLAND FL,0,1,2,2,5
Hurricane,Dennis,11,1999-08-26T15:00:00Z,MARATHON FL,0,1,1,0,2
Hurricane,Dennis,11,1999-08-26T15:00:00Z,FT MYERS FL,0,0,4,2,6
Hurricane,Dennis,11,1999-08-26T15:00:00Z,MIAMI FL,0,5,5,0,10
Hurricane,Dennis,11,1999-08-26T15:00:00Z,VENICE FL,0,0,2,3,5
Hurricane,Dennis,11,1999-08-26T15:00:00Z,W PALM BEACH FL,0,9,6,1,16
Hurricane,Dennis,11,1999-08-26T15:00:00Z,TAMPA FL,0,0,3,4,7
Hurricane,Dennis,11,1999-08-26T15:00:00Z,FT PIERCE FL,0,7,8,2,17
Hurricane,Dennis,11,1999-08-26T15:00:00Z,CEDAR KEY FL,0,0,2,6,8
Hurricane,Dennis,11,1999-08-26T15:00:00Z,COCOA BEACH FL,0,3,11,2,16
Hurricane,Dennis,11,1999-08-26T15:00:00Z,ST MARKS FL,0,0,0,6,6
Hurricane,Dennis,11,1999-08-26T15:00:00Z,DAYTONA BEACH FL,0,1,10,4,15
Hurricane,Dennis,11,1999-08-26T15:00:00Z,APALACHICOLA FL,0,0,0,3,3
Hurricane,Dennis,11,1999-08-26T15:00:00Z,JACKSONVILLE FL,0,0,6,8,14
Hurricane,Dennis,11,1999-08-26T15:00:00Z,PANAMA CITY FL,0,0,0,2,2
Hurricane,Dennis,11,1999-08-26T15:00:00Z,SAVANNAH GA,0,0,3,13,16
Hurricane,Dennis,11,1999-08-26T15:00:00Z,GULF 29N 85W,0,0,0,2,2
Hurricane,Dennis,12,1999-08-26T21:00:00Z,26.0N  76.5W,49,0,0,0,49
Hurricane,Dennis,12,1999-08-26T21:00:00Z,CHARLESTON SC,0,0,4,13,17
Hurricane,Dennis,12,1999-08-26T21:00:00Z,27.5N  77.5W,22,13,0,0,35
Hurricane,Dennis,12,1999-08-26T21:00:00Z,MYRTLE BEACH SC,0,0,3,13,16
Hurricane,Dennis,12,1999-08-26T21:00:00Z,29.5N  78.0W,0,16,10,1,27
Hurricane,Dennis,12,1999-08-26T21:00:00Z,WILMINGTON NC,0,0,1,14,15
Hurricane,Dennis,12,1999-08-26T21:00:00Z,MYSM 241N 745W,99,0,0,0,99
Hurricane,Dennis,12,1999-08-26T21:00:00Z,MOREHEAD CITY NC,0,0,1,12,13
Hurricane,Dennis,12,1999-08-26T21:00:00Z,MYEG 235N 758W,19,0,0,1,20
Hurricane,Dennis,12,1999-08-26T21:00:00Z,CAPE HATTERAS NC,0,0,0,10,10
Hurricane,Dennis,12,1999-08-26T21:00:00Z,MYAK 241N 776W,14,3,0,0,17
Hurricane,Dennis,12,1999-08-26T21:00:00Z,NORFOLK VA,0,0,0,7,7
Hurricane,Dennis,12,1999-08-26T21:00:00Z,MYNN 251N 775W,29,1,0,0,30
Hurricane,Dennis,12,1999-08-26T21:00:00Z,OCEAN CITY MD,0,0,0,3,3
Hurricane,Dennis,12,1999-08-26T21:00:00Z,MYGF 266N 787W,10,15,1,0,26
Hurricane,Dennis,12,1999-08-26T21:00:00Z,MARCO ISLAND FL,0,1,2,1,4
Hurricane,Dennis,12,1999-08-26T21:00:00Z,MARATHON FL,0,1,1,0,2
Hurricane,Dennis,12,1999-08-26T21:00:00Z,FT MYERS FL,0,1,2,2,5
Hurricane,Dennis,12,1999-08-26T21:00:00Z,MIAMI FL,0,6,3,1,10
Hurricane,Dennis,12,1999-08-26T21:00:00Z,VENICE FL,0,0,2,2,4
Hurricane,Dennis,12,1999-08-26T21:00:00Z,W PALM BEACH FL,0,10,4,1,15
Hurricane,Dennis,12,1999-08-26T21:00:00Z,TAMPA FL,0,0,3,4,7
Hurricane,Dennis,12,1999-08-26T21:00:00Z,FT PIERCE FL,0,8,7,2,17
Hurricane,Dennis,12,1999-08-26T21:00:00Z,CEDAR KEY FL,0,0,2,5,7
Hurricane,Dennis,12,1999-08-26T21:00:00Z,COCOA BEACH FL,0,4,10,2,16
Hurricane,Dennis,12,1999-08-26T21:00:00Z,ST MARKS FL,0,0,0,6,6
Hurricane,Dennis,12,1999-08-26T21:00:00Z,DAYTONA BEACH FL,0,1,10,4,15
Hurricane,Dennis,12,1999-08-26T21:00:00Z,APALACHICOLA FL,0,0,0,3,3
Hurricane,Dennis,12,1999-08-26T21:00:00Z,JACKSONVILLE FL,0,0,6,8,14
Hurricane,Dennis,12,1999-08-26T21:00:00Z,PANAMA CITY FL,0,0,0,2,2
Hurricane,Dennis,12,1999-08-26T21:00:00Z,SAVANNAH GA,0,0,4,12,16
Hurricane,Dennis,12,1999-08-26T21:00:00Z,GULF 29N 85W,0,0,0,2,2
Hurricane,Dennis,13,1999-08-27T03:00:00Z,26.3N  76.5W,54,0,0,0,54
Hurricane,Dennis,13,1999-08-27T03:00:00Z,WILMINGTON NC,0,0,0,13,13
Hurricane,Dennis,13,1999-08-27T03:00:00Z,27.3N  77.5W,31,2,0,0,33
Hurricane,Dennis,13,1999-08-27T03:00:00Z,MOREHEAD CITY NC,0,0,0,10,10
Hurricane,Dennis,13,1999-08-27T03:00:00Z,29.0N  78.5W,3,15,7,1,26
Hurricane,Dennis,13,1999-08-27T03:00:00Z,CAPE HATTERAS NC,0,0,0,7,7
Hurricane,Dennis,13,1999-08-27T03:00:00Z,MYSM 241N 745W,99,0,0,0,99
Hurricane,Dennis,13,1999-08-27T03:00:00Z,NORFOLK VA,0,0,0,6,6
Hurricane,Dennis,13,1999-08-27T03:00:00Z,MYEG 235N 758W,10,1,0,0,11
Hurricane,Dennis,13,1999-08-27T03:00:00Z,OCEAN CITY MD,0,0,0,2,2
Hurricane,Dennis,13,1999-08-27T03:00:00Z,MYAK 241N 776W,11,2,0,1,14
Hurricane,Dennis,13,1999-08-27T03:00:00Z,KEY WEST FL,0,0,1,1,2
Hurricane,Dennis,13,1999-08-27T03:00:00Z,MYNN 251N 775W,24,1,0,0,25
Hurricane,Dennis,13,1999-08-27T03:00:00Z,MARCO ISLAND FL,0,1,4,3,8
Hurricane,Dennis,13,1999-08-27T03:00:00Z,MYGF 266N 787W,13,10,1,0,24
Hurricane,Dennis,13,1999-08-27T03:00:00Z,FT MYERS FL,0,1,6,2,9
Hurricane,Dennis,13,1999-08-27T03:00:00Z,MARATHON FL,0,1,2,1,4
Hurricane,Dennis,13,1999-08-27T03:00:00Z,VENICE FL,0,1,4,4,9
Hurricane,Dennis,13,1999-08-27T03:00:00Z,MIAMI FL,0,8,3,2,13
Hurricane,Dennis,13,1999-08-27T03:00:00Z,TAMPA FL,0,1,6,4,11
Hurricane,Dennis,13,1999-08-27T03:00:00Z,W PALM BEACH FL,1,11,5,1,18
Hurricane,Dennis,13,1999-08-27T03:00:00Z,CEDAR KEY FL,0,0,6,6,12
Hurricane,Dennis,13,1999-08-27T03:00:00Z,FT PIERCE FL,0,12,6,2,20
Hurricane,Dennis,13,1999-08-27T03:00:00Z,ST MARKS FL,0,0,2,8,10
Hurricane,Dennis,13,1999-08-27T03:00:00Z,COCOA BEACH FL,0,8,10,2,20
Hurricane,Dennis,13,1999-08-27T03:00:00Z,APALACHICOLA FL,0,0,1,6,7
Hurricane,Dennis,13,1999-08-27T03:00:00Z,DAYTONA BEACH FL,0,3,12,3,18
Hurricane,Dennis,13,1999-08-27T03:00:00Z,PANAMA CITY FL,0,0,0,5,5
Hurricane,Dennis,13,1999-08-27T03:00:00Z,JACKSONVILLE FL,0,0,10,7,17
Hurricane,Dennis,13,1999-08-27T03:00:00Z,PENSACOLA FL,0,0,0,3,3
Hurricane,Dennis,13,1999-08-27T03:00:00Z,SAVANNAH GA,0,0,5,11,16
Hurricane,Dennis,13,1999-08-27T03:00:00Z,GULF 29N 85W,0,0,1,5,6
Hurricane,Dennis,13,1999-08-27T03:00:00Z,CHARLESTON SC,0,0,3,13,16
Hurricane,Dennis,13,1999-08-27T03:00:00Z,GULF 29N 87W,0,0,0,2,2
Hurricane,Dennis,13,1999-08-27T03:00:00Z,MYRTLE BEACH SC,0,0,1,13,14
Hurricane,Dennis,14,1999-08-27T09:00:00Z,26.4N  77.1W,60,0,0,0,60
Hurricane,Dennis,14,1999-08-27T09:00:00Z,WILMINGTON NC,0,0,0,12,12
Hurricane,Dennis,14,1999-08-27T09:00:00Z,27.4N  78.4W,23,11,1,0,35
Hurricane,Dennis,14,1999-08-27T09:00:00Z,MOREHEAD CITY NC,0,0,0,10,10
Hurricane,Dennis,14,1999-08-27T09:00:00Z,28.8N  79.0W,3,18,3,1,25
Hurricane,Dennis,14,1999-08-27T09:00:00Z,CAPE HATTERAS NC,0,0,0,7,7
Hurricane,Dennis,14,1999-08-27T09:00:00Z,MYSM 241N 745W,4,0,0,1,5
Hurricane,Dennis,14,1999-08-27T09:00:00Z,NORFOLK VA,0,0,0,5,5
Hurricane,Dennis,14,1999-08-27T09:00:00Z,MYEG 235N 758W,5,0,0,1,6
Hurricane,Dennis,14,1999-08-27T09:00:00Z,KEY WEST FL,0,1,3,0,4
Hurricane,Dennis,14,1999-08-27T09:00:00Z,MYAK 241N 776W,14,1,0,0,15
Hurricane,Dennis,14,1999-08-27T09:00:00Z,MARCO ISLAND FL,0,5,5,1,11
Hurricane,Dennis,14,1999-08-27T09:00:00Z,MYNN 251N 775W,30,1,0,0,31
Hurricane,Dennis,14,1999-08-27T09:00:00Z,FT MYERS FL,0,5,6,2,13
Hurricane,Dennis,14,1999-08-27T09:00:00Z,MYGF 266N 787W,22,10,1,0,33
Hurricane,Dennis,14,1999-08-27T09:00:00Z,VENICE FL,0,2,7,2,11
Hurricane,Dennis,14,1999-08-27T09:00:00Z,MARATHON FL,0,4,2,1,7
Hurricane,Dennis,14,1999-08-27T09:00:00Z,TAMPA FL,0,2,8,3,13
Hurricane,Dennis,14,1999-08-27T09:00:00Z,MIAMI FL,1,14,2,1,18
Hurricane,Dennis,14,1999-08-27T09:00:00Z,CEDAR KEY FL,0,0,7,6,13
Hurricane,Dennis,14,1999-08-27T09:00:00Z,W PALM BEACH FL,2,18,2,1,23
Hurricane,Dennis,14,1999-08-27T09:00:00Z,ST MARKS FL,0,0,2,8,10
Hurricane,Dennis,14,1999-08-27T09:00:00Z,FT PIERCE FL,1,17,3,1,22
Hurricane,Dennis,14,1999-08-27T09:00:00Z,APALACHICOLA FL,0,0,1,6,7
Hurricane,Dennis,14,1999-08-27T09:00:00Z,COCOA BEACH FL,0,13,6,2,21
Hurricane,Dennis,14,1999-08-27T09:00:00Z,PANAMA CITY FL,0,0,0,6,6
Hurricane,Dennis,14,1999-08-27T09:00:00Z,DAYTONA BEACH FL,0,4,11,3,18
Hurricane,Dennis,14,1999-08-27T09:00:00Z,PENSACOLA FL,0,0,0,3,3
Hurricane,Dennis,14,1999-08-27T09:00:00Z,JACKSONVILLE FL,0,0,8,8,16
Hurricane,Dennis,14,1999-08-27T09:00:00Z,MOBILE AL,0,0,0,2,2
Hurricane,Dennis,14,1999-08-27T09:00:00Z,SAVANNAH GA,0,0,3,13,16
Hurricane,Dennis,14,1999-08-27T09:00:00Z,GULF 29N 85W,0,0,1,5,6
Hurricane,Dennis,14,1999-08-27T09:00:00Z,CHARLESTON SC,0,0,2,13,15
Hurricane,Dennis,14,1999-08-27T09:00:00Z,GULF 29N 87W,0,0,0,2,2
Hurricane,Dennis,14,1999-08-27T09:00:00Z,MYRTLE BEACH SC,0,0,1,13,14
Hurricane,Dennis,15,1999-08-27T15:00:00Z,27.0N  78.0W,49,0,0,0,49
Hurricane,Dennis,15,1999-08-27T15:00:00Z,WILMINGTON NC,0,0,1,11,12
Hurricane,Dennis,15,1999-08-27T15:00:00Z,28.0N  79.0W,29,4,0,0,33
Hurricane,Dennis,15,1999-08-27T15:00:00Z,MOREHEAD CITY NC,0,0,0,9,9
Hurricane,Dennis,15,1999-08-27T15:00:00Z,29.5N  79.5W,7,14,4,1,26
Hurricane,Dennis,15,1999-08-27T15:00:00Z,CAPE HATTERAS NC,0,0,0,6,6
Hurricane,Dennis,15,1999-08-27T15:00:00Z,MYEG 235N 758W,1,0,0,1,2
Hurricane,Dennis,15,1999-08-27T15:00:00Z,NORFOLK VA,0,0,0,4,4
Hurricane,Dennis,15,1999-08-27T15:00:00Z,MYAK 241N 776W,10,1,0,0,11
Hurricane,Dennis,15,1999-08-27T15:00:00Z,KEY WEST FL,0,1,2,1,4
Hurricane,Dennis,15,1999-08-27T15:00:00Z,MYNN 251N 775W,31,0,0,0,31
Hurricane,Dennis,15,1999-08-27T15:00:00Z,MARCO ISLAND FL,1,6,3,1,11
Hurricane,Dennis,15,1999-08-27T15:00:00Z,MYGF 266N 787W,35,1,0,0,36
Hurricane,Dennis,15,1999-08-27T15:00:00Z,FT MYERS FL,0,7,4,2,13
Hurricane,Dennis,15,1999-08-27T15:00:00Z,MARATHON FL,1,3,2,1,7
Hurricane,Dennis,15,1999-08-27T15:00:00Z,VENICE FL,0,4,5,3,12
Hurricane,Dennis,15,1999-08-27T15:00:00Z,MIAMI FL,7,8,1,1,17
Hurricane,Dennis,15,1999-08-27T15:00:00Z,TAMPA FL,0,4,7,3,14
Hurricane,Dennis,15,1999-08-27T15:00:00Z,W PALM BEACH FL,13,9,1,0,23
Hurricane,Dennis,15,1999-08-27T15:00:00Z,CEDAR KEY FL,0,1,8,5,14
Hurricane,Dennis,15,1999-08-27T15:00:00Z,FT PIERCE FL,10,13,1,1,25
Hurricane,Dennis,15,1999-08-27T15:00:00Z,ST MARKS FL,0,0,3,8,11
Hurricane,Dennis,15,1999-08-27T15:00:00Z,COCOA BEACH FL,5,15,3,1,24
Hurricane,Dennis,15,1999-08-27T15:00:00Z,APALACHICOLA FL,0,0,1,7,8
Hurricane,Dennis,15,1999-08-27T15:00:00Z,DAYTONA BEACH FL,1,11,8,2,22
Hurricane,Dennis,15,1999-08-27T15:00:00Z,PANAMA CITY FL,0,0,1,5,6
Hurricane,Dennis,15,1999-08-27T15:00:00Z,JACKSONVILLE FL,0,2,12,5,19
Hurricane,Dennis,15,1999-08-27T15:00:00Z,PENSACOLA FL,0,0,0,3,3
Hurricane,Dennis,15,1999-08-27T15:00:00Z,SAVANNAH GA,0,0,9,9,18
Hurricane,Dennis,15,1999-08-27T15:00:00Z,MOBILE AL,0,0,0,2,2
Hurricane,Dennis,15,1999-08-27T15:00:00Z,CHARLESTON SC,0,0,7,10,17
Hurricane,Dennis,15,1999-08-27T15:00:00Z,GULF 29N 85W,0,0,1,6,7
Hurricane,Dennis,15,1999-08-27T15:00:00Z,MYRTLE BEACH SC,0,0,3,12,15
Hurricane,Dennis,15,1999-08-27T15:00:00Z,GULF 29N 87W,0,0,0,2,2
Hurricane,Dennis,16,1999-08-27T21:00:00Z,27.5N  78.5W,53,0,0,1,54
Hurricane,Dennis,16,1999-08-27T21:00:00Z,MOREHEAD CITY NC,0,0,1,8,9
Hurricane,Dennis,16,1999-08-27T21:00:00Z,28.5N  79.0W,35,1,0,0,36
Hurricane,Dennis,16,1999-08-27T21:00:00Z,CAPE HATTERAS NC,0,0,0,6,6
Hurricane,Dennis,16,1999-08-27T21:00:00Z,30.0N  79.5W,11,8,3,2,24
Hurricane,Dennis,16,1999-08-27T21:00:00Z,NORFOLK VA,0,0,0,5,5
Hurricane,Dennis,16,1999-08-27T21:00:00Z,MYAK 241N 776W,3,1,0,1,5
Hurricane,Dennis,16,1999-08-27T21:00:00Z,OCEAN CITY MD,0,0,0,2,2
Hurricane,Dennis,16,1999-08-27T21:00:00Z,MYNN 251N 775W,25,0,0,0,25
Hurricane,Dennis,16,1999-08-27T21:00:00Z,KEY WEST FL,0,1,0,2,3
Hurricane,Dennis,16,1999-08-27T21:00:00Z,MYGF 266N 787W,42,0,0,0,42
Hurricane,Dennis,16,1999-08-27T21:00:00Z,MARCO ISLAND FL,1,5,2,2,10
Hurricane,Dennis,16,1999-08-27T21:00:00Z,MARATHON FL,1,2,0,2,5
Hurricane,Dennis,16,1999-08-27T21:00:00Z,FT MYERS FL,1,7,2,2,12
Hurricane,Dennis,16,1999-08-27T21:00:00Z,MIAMI FL,10,4,0,1,15
Hurricane,Dennis,16,1999-08-27T21:00:00Z,VENICE FL,0,6,3,2,11
Hurricane,Dennis,16,1999-08-27T21:00:00Z,W PALM BEACH FL,19,3,0,1,23
Hurricane,Dennis,16,1999-08-27T21:00:00Z,TAMPA FL,0,7,5,3,15
Hurricane,Dennis,16,1999-08-27T21:00:00Z,FT PIERCE FL,19,4,1,0,24
Hurricane,Dennis,16,1999-08-27T21:00:00Z,CEDAR KEY FL,0,3,8,4,15
Hurricane,Dennis,16,1999-08-27T21:00:00Z,COCOA BEACH FL,13,8,1,1,23
Hurricane,Dennis,16,1999-08-27T21:00:00Z,ST MARKS FL,0,0,6,6,12
Hurricane,Dennis,16,1999-08-27T21:00:00Z,DAYTONA BEACH FL,3,12,4,2,21
Hurricane,Dennis,16,1999-08-27T21:00:00Z,APALACHICOLA FL,0,0,3,6,9
Hurricane,Dennis,16,1999-08-27T21:00:00Z,JACKSONVILLE FL,0,5,10,4,19
Hurricane,Dennis,16,1999-08-27T21:00:00Z,PANAMA CITY FL,0,0,2,5,7
Hurricane,Dennis,16,1999-08-27T21:00:00Z,SAVANNAH GA,0,1,9,7,17
Hurricane,Dennis,16,1999-08-27T21:00:00Z,PENSACOLA FL,0,0,0,4,4
Hurricane,Dennis,16,1999-08-27T21:00:00Z,CHARLESTON SC,0,0,7,9,16
Hurricane,Dennis,16,1999-08-27T21:00:00Z,MOBILE AL,0,0,0,2,2
Hurricane,Dennis,16,1999-08-27T21:00:00Z,MYRTLE BEACH SC,0,0,4,10,14
Hurricane,Dennis,16,1999-08-27T21:00:00Z,GULF 29N 85W,0,0,3,5,8
Hurricane,Dennis,16,1999-08-27T21:00:00Z,WILMINGTON NC,0,0,1,11,12
Hurricane,Dennis,16,1999-08-27T21:00:00Z,GULF 29N 87W,0,0,0,3,3
Hurricane,Dennis,17,1999-08-28T03:00:00Z,27.6N  78.2W,44,0,0,0,44
Hurricane,Dennis,17,1999-08-28T03:00:00Z,WILMINGTON NC,0,0,2,9,11
Hurricane,Dennis,17,1999-08-28T03:00:00Z,28.8N  78.9W,29,2,0,1,32
Hurricane,Dennis,17,1999-08-28T03:00:00Z,MOREHEAD CITY NC,0,0,0,8,8
Hurricane,Dennis,17,1999-08-28T03:00:00Z,30.0N  79.5W,10,12,2,1,25
Hurricane,Dennis,17,1999-08-28T03:00:00Z,CAPE HATTERAS NC,0,0,0,5,5
Hurricane,Dennis,17,1999-08-28T03:00:00Z,MYSM 241N 745W,0,0,0,2,2
Hurricane,Dennis,17,1999-08-28T03:00:00Z,NORFOLK VA,0,0,0,4,4
Hurricane,Dennis,17,1999-08-28T03:00:00Z,MYEG 235N 758W,0,0,0,2,2
Hurricane,Dennis,17,1999-08-28T03:00:00Z,KEY WEST FL,0,0,0,3,3
Hurricane,Dennis,17,1999-08-28T03:00:00Z,MYAK 241N 776W,3,1,0,2,6
Hurricane,Dennis,17,1999-08-28T03:00:00Z,MARCO ISLAND FL,1,3,1,3,8
Hurricane,Dennis,17,1999-08-28T03:00:00Z,MYNN 251N 775W,17,1,0,0,18
Hurricane,Dennis,17,1999-08-28T03:00:00Z,FT MYERS FL,1,4,2,3,10
Hurricane,Dennis,17,1999-08-28T03:00:00Z,MYGF 266N 787W,30,0,1,0,31
Hurricane,Dennis,17,1999-08-28T03:00:00Z,VENICE FL,0,4,3,3,10
Hurricane,Dennis,17,1999-08-28T03:00:00Z,MARATHON FL,0,1,1,2,4
Hurricane,Dennis,17,1999-08-28T03:00:00Z,TAMPA FL,0,6,4,3,13
Hurricane,Dennis,17,1999-08-28T03:00:00Z,MIAMI FL,7,3,1,2,13
Hurricane,Dennis,17,1999-08-28T03:00:00Z,CEDAR KEY FL,0,4,7,3,14
Hurricane,Dennis,17,1999-08-28T03:00:00Z,W PALM BEACH FL,15,3,1,1,20
Hurricane,Dennis,17,1999-08-28T03:00:00Z,ST MARKS FL,0,1,5,6,12
Hurricane,Dennis,17,1999-08-28T03:00:00Z,FT PIERCE FL,15,6,1,0,22
Hurricane,Dennis,17,1999-08-28T03:00:00Z,APALACHICOLA FL,0,0,3,6,9
Hurricane,Dennis,17,1999-08-28T03:00:00Z,COCOA BEACH FL,11,10,1,1,23
Hurricane,Dennis,17,1999-08-28T03:00:00Z,PANAMA CITY FL,0,0,2,5,7
Hurricane,Dennis,17,1999-08-28T03:00:00Z,DAYTONA BEACH FL,4,13,3,2,22
Hurricane,Dennis,17,1999-08-28T03:00:00Z,PENSACOLA FL,0,0,0,4,4
Hurricane,Dennis,17,1999-08-28T03:00:00Z,JACKSONVILLE FL,0,9,7,4,20
Hurricane,Dennis,17,1999-08-28T03:00:00Z,MOBILE AL,0,0,0,2,2
Hurricane,Dennis,17,1999-08-28T03:00:00Z,SAVANNAH GA,0,2,10,6,18
Hurricane,Dennis,17,1999-08-28T03:00:00Z,GULF 29N 85W,0,0,2,5,7
Hurricane,Dennis,17,1999-08-28T03:00:00Z,CHARLESTON SC,0,1,8,8,17
Hurricane,Dennis,17,1999-08-28T03:00:00Z,GULF 29N 87W,0,0,0,3,3
Hurricane,Dennis,17,1999-08-28T03:00:00Z,MYRTLE BEACH SC,0,0,4,10,14
Hurricane,Dennis,18,1999-08-28T09:00:00Z,27.8N  78.4W,43,0,0,0,43
Hurricane,Dennis,18,1999-08-28T09:00:00Z,MYRTLE BEACH SC,0,0,5,10,15
Hurricane,Dennis,18,1999-08-28T09:00:00Z,29.0N  79.0W,26,4,0,1,31
Hurricane,Dennis,18,1999-08-28T09:00:00Z,WILMINGTON NC,0,0,2,11,13
Hurricane,Dennis,18,1999-08-28T09:00:00Z,30.4N  79.0W,9,11,2,2,24
Hurricane,Dennis,18,1999-08-28T09:00:00Z,MOREHEAD CITY NC,0,0,1,10,11
Hurricane,Dennis,18,1999-08-28T09:00:00Z,MYSM 241N 745W,0,0,0,3,3
Hurricane,Dennis,18,1999-08-28T09:00:00Z,CAPE HATTERAS NC,0,0,0,8,8
Hurricane,Dennis,18,1999-08-28T09:00:00Z,MYEG 235N 758W,0,0,0,2,2
Hurricane,Dennis,18,1999-08-28T09:00:00Z,NORFOLK VA,0,0,0,6,6
Hurricane,Dennis,18,1999-08-28T09:00:00Z,MYAK 241N 776W,1,0,1,2,4
Hurricane,Dennis,18,1999-08-28T09:00:00Z,OCEAN CITY MD,0,0,0,3,3
Hurricane,Dennis,18,1999-08-28T09:00:00Z,MYNN 251N 775W,10,1,0,1,12
Hurricane,Dennis,18,1999-08-28T09:00:00Z,KEY WEST FL,0,0,1,1,2
Hurricane,Dennis,18,1999-08-28T09:00:00Z,MYGF 266N 787W,29,0,0,1,30
Hurricane,Dennis,18,1999-08-28T09:00:00Z,MARCO ISLAND FL,1,4,1,2,8
Hurricane,Dennis,18,1999-08-28T09:00:00Z,MARATHON FL,0,1,1,1,3
Hurricane,Dennis,18,1999-08-28T09:00:00Z,FT MYERS FL,2,5,1,2,10
Hurricane,Dennis,18,1999-08-28T09:00:00Z,MIAMI FL,8,3,1,1,13
Hurricane,Dennis,18,1999-08-28T09:00:00Z,VENICE FL,1,4,2,2,9
Hurricane,Dennis,18,1999-08-28T09:00:00Z,W PALM BEACH FL,18,2,0,1,21
Hurricane,Dennis,18,1999-08-28T09:00:00Z,TAMPA FL,1,6,3,3,13
Hurricane,Dennis,18,1999-08-28T09:00:00Z,FT PIERCE FL,20,3,1,0,24
Hurricane,Dennis,18,1999-08-28T09:00:00Z,CEDAR KEY FL,0,5,5,3,13
Hurricane,Dennis,18,1999-08-28T09:00:00Z,COCOA BEACH FL,16,7,1,0,24
Hurricane,Dennis,18,1999-08-28T09:00:00Z,ST MARKS FL,0,1,4,5,10
Hurricane,Dennis,18,1999-08-28T09:00:00Z,DAYTONA BEACH FL,6,12,2,2,22
Hurricane,Dennis,18,1999-08-28T09:00:00Z,APALACHICOLA FL,0,0,2,4,6
Hurricane,Dennis,18,1999-08-28T09:00:00Z,JACKSONVILLE FL,0,9,6,3,18
Hurricane,Dennis,18,1999-08-28T09:00:00Z,PANAMA CITY FL,0,0,1,4,5
Hurricane,Dennis,18,1999-08-28T09:00:00Z,SAVANNAH GA,0,2,9,6,17
Hurricane,Dennis,18,1999-08-28T09:00:00Z,PENSACOLA FL,0,0,0,2,2
Hurricane,Dennis,18,1999-08-28T09:00:00Z,CHARLESTON SC,0,1,8,8,17
Hurricane,Dennis,18,1999-08-28T09:00:00Z,GULF 29N 85W,0,0,2,3,5
Hurricane,Dennis,20,1999-08-28T21:00:00Z,29.8N  78.5W,44,0,0,0,44
Hurricane,Dennis,20,1999-08-28T21:00:00Z,WILMINGTON NC,1,5,5,6,17
Hurricane,Dennis,20,1999-08-28T21:00:00Z,31.0N  78.7W,30,1,1,0,32
Hurricane,Dennis,20,1999-08-28T21:00:00Z,MOREHEAD CITY NC,0,2,5,7,14
Hurricane,Dennis,20,1999-08-28T21:00:00Z,32.0N  78.5W,18,4,2,1,25
Hurricane,Dennis,20,1999-08-28T21:00:00Z,CAPE HATTERAS NC,0,0,3,8,11
Hurricane,Dennis,20,1999-08-28T21:00:00Z,MYSM 241N 745W,0,0,0,2,2
Hurricane,Dennis,20,1999-08-28T21:00:00Z,NORFOLK VA,0,0,1,9,10
Hurricane,Dennis,20,1999-08-28T21:00:00Z,MYEG 235N 758W,0,0,0,2,2
Hurricane,Dennis,20,1999-08-28T21:00:00Z,OCEAN CITY MD,0,0,0,6,6
Hurricane,Dennis,20,1999-08-28T21:00:00Z,MYAK 241N 776W,0,0,0,4,4
Hurricane,Dennis,20,1999-08-28T21:00:00Z,ATLANTIC CITY NJ,0,0,0,4,4
Hurricane,Dennis,20,1999-08-28T21:00:00Z,MYNN 251N 775W,0,1,1,4,6
Hurricane,Dennis,20,1999-08-28T21:00:00Z,NEW YORK CITY NY,0,0,0,2,2
Hurricane,Dennis,20,1999-08-28T21:00:00Z,MYGF 266N 787W,11,1,1,2,15
Hurricane,Dennis,20,1999-08-28T21:00:00Z,KEY WEST FL,0,0,0,3,3
Hurricane,Dennis,20,1999-08-28T21:00:00Z,MARATHON FL,0,0,0,4,4
Hurricane,Dennis,20,1999-08-28T21:00:00Z,MARCO ISLAND FL,0,1,0,5,6
Hurricane,Dennis,20,1999-08-28T21:00:00Z,MIAMI FL,1,1,1,4,7
Hurricane,Dennis,20,1999-08-28T21:00:00Z,FT MYERS FL,0,1,1,5,7
Hurricane,Dennis,20,1999-08-28T21:00:00Z,W PALM BEACH FL,6,2,1,3,12
Hurricane,Dennis,20,1999-08-28T21:00:00Z,VENICE FL,0,1,1,5,7
Hurricane,Dennis,20,1999-08-28T21:00:00Z,FT PIERCE FL,11,2,1,2,16
Hurricane,Dennis,20,1999-08-28T21:00:00Z,TAMPA FL,1,2,1,5,9
Hurricane,Dennis,20,1999-08-28T21:00:00Z,COCOA BEACH FL,13,3,0,2,18
Hurricane,Dennis,20,1999-08-28T21:00:00Z,CEDAR KEY FL,0,3,2,5,10
Hurricane,Dennis,20,1999-08-28T21:00:00Z,DAYTONA BEACH FL,11,5,1,2,19
Hurricane,Dennis,20,1999-08-28T21:00:00Z,ST MARKS FL,0,1,2,5,8
Hurricane,Dennis,20,1999-08-28T21:00:00Z,JACKSONVILLE FL,4,9,3,2,18
Hurricane,Dennis,20,1999-08-28T21:00:00Z,APALACHICOLA FL,0,0,1,4,5
Hurricane,Dennis,20,1999-08-28T21:00:00Z,SAVANNAH GA,3,11,3,3,20
Hurricane,Dennis,20,1999-08-28T21:00:00Z,PANAMA CITY FL,0,0,1,3,4
Hurricane,Dennis,20,1999-08-28T21:00:00Z,CHARLESTON SC,4,11,3,3,21
Hurricane,Dennis,20,1999-08-28T21:00:00Z,PENSACOLA FL,0,0,0,2,2
Hurricane,Dennis,20,1999-08-28T21:00:00Z,MYRTLE BEACH SC,2,9,4,4,19
Hurricane,Dennis,20,1999-08-28T21:00:00Z,GULF 29N 85W,0,0,1,3,4
Hurricane,Dennis,21,1999-08-29T03:00:00Z,30.9N  78.7W,51,0,1,0,52
Hurricane,Dennis,21,1999-08-29T03:00:00Z,NORFOLK VA,0,0,5,9,14
Hurricane,Dennis,21,1999-08-29T03:00:00Z,32.3N  78.7W,23,5,0,1,29
Hurricane,Dennis,21,1999-08-29T03:00:00Z,OCEAN CITY MD,0,0,1,10,11
Hurricane,Dennis,21,1999-08-29T03:00:00Z,33.5N  78.0W,4,14,3,2,23
Hurricane,Dennis,21,1999-08-29T03:00:00Z,ATLANTIC CITY NJ,0,0,0,9,9
Hurricane,Dennis,21,1999-08-29T03:00:00Z,MYAK 241N 776W,0,0,0,2,2
Hurricane,Dennis,21,1999-08-29T03:00:00Z,NEW YORK CITY NY,0,0,0,6,6
Hurricane,Dennis,21,1999-08-29T03:00:00Z,MYNN 251N 775W,0,0,0,3,3
Hurricane,Dennis,21,1999-08-29T03:00:00Z,MONTAUK POINT NY,0,0,0,4,4
Hurricane,Dennis,21,1999-08-29T03:00:00Z,MYGF 266N 787W,0,0,1,5,6
Hurricane,Dennis,21,1999-08-29T03:00:00Z,PROVIDENCE RI,0,0,0,3,3
Hurricane,Dennis,21,1999-08-29T03:00:00Z,MARATHON FL,0,0,0,2,2
Hurricane,Dennis,21,1999-08-29T03:00:00Z,NANTUCKET MA,0,0,0,2,2
Hurricane,Dennis,21,1999-08-29T03:00:00Z,MIAMI FL,0,0,0,3,3
Hurricane,Dennis,21,1999-08-29T03:00:00Z,HYANNIS MA,0,0,0,2,2
Hurricane,Dennis,21,1999-08-29T03:00:00Z,W PALM BEACH FL,0,0,1,4,5
Hurricane,Dennis,21,1999-08-29T03:00:00Z,BOSTON MA,0,0,0,2,2
Hurricane,Dennis,21,1999-08-29T03:00:00Z,FT PIERCE FL,3,1,0,4,8
Hurricane,Dennis,21,1999-08-29T03:00:00Z,MARCO ISLAND FL,0,0,0,3,3
Hurricane,Dennis,21,1999-08-29T03:00:00Z,COCOA BEACH FL,11,0,1,2,14
Hurricane,Dennis,21,1999-08-29T03:00:00Z,FT MYERS FL,0,0,0,3,3
Hurricane,Dennis,21,1999-08-29T03:00:00Z,DAYTONA BEACH FL,15,1,1,1,18
Hurricane,Dennis,21,1999-08-29T03:00:00Z,VENICE FL,0,0,0,3,3
Hurricane,Dennis,21,1999-08-29T03:00:00Z,JACKSONVILLE FL,13,3,1,2,19
Hurricane,Dennis,21,1999-08-29T03:00:00Z,TAMPA FL,0,1,0,4,5
Hurricane,Dennis,21,1999-08-29T03:00:00Z,SAVANNAH GA,11,10,1,1,23
Hurricane,Dennis,21,1999-08-29T03:00:00Z,CEDAR KEY FL,1,1,1,4,7
Hurricane,Dennis,21,1999-08-29T03:00:00Z,CHARLESTON SC,9,15,1,1,26
Hurricane,Dennis,21,1999-08-29T03:00:00Z,ST MARKS FL,0,1,1,3,5
Hurricane,Dennis,21,1999-08-29T03:00:00Z,MYRTLE BEACH SC,3,16,3,2,24
Hurricane,Dennis,21,1999-08-29T03:00:00Z,APALACHICOLA FL,0,0,0,3,3
Hurricane,Dennis,21,1999-08-29T03:00:00Z,WILMINGTON NC,1,11,6,3,21
Hurricane,Dennis,21,1999-08-29T03:00:00Z,PANAMA CITY FL,0,0,0,2,2
Hurricane,Dennis,21,1999-08-29T03:00:00Z,MOREHEAD CITY NC,0,5,9,5,19
Hurricane,Dennis,21,1999-08-29T03:00:00Z,GULF 29N 85W,0,0,0,2,2
Hurricane,Dennis,21,1999-08-29T03:00:00Z,CAPE HATTERAS NC,0,1,7,7,15
Hurricane,Dennis,22,1999-08-29T09:00:00Z,31.8N  78.7W,42,0,0,0,42
Hurricane,Dennis,22,1999-08-29T09:00:00Z,MOREHEAD CITY NC,2,12,8,2,24
Hurricane,Dennis,22,1999-08-29T09:00:00Z,33.0N  77.5W,19,7,1,1,28
Hurricane,Dennis,22,1999-08-29T09:00:00Z,CAPE HATTERAS NC,0,5,11,4,20
Hurricane,Dennis,22,1999-08-29T09:00:00Z,34.0N  75.5W,1,10,9,3,23
Hurricane,Dennis,22,1999-08-29T09:00:00Z,NORFOLK VA,0,1,10,6,17
Hurricane,Dennis,22,1999-08-29T09:00:00Z,MYGF 266N 787W,0,0,0,2,2
Hurricane,Dennis,22,1999-08-29T09:00:00Z,OCEAN CITY MD,0,0,3,11,14
Hurricane,Dennis,22,1999-08-29T09:00:00Z,FT PIERCE FL,1,0,0,1,2
Hurricane,Dennis,22,1999-08-29T09:00:00Z,ATLANTIC CITY NJ,0,0,1,10,11
Hurricane,Dennis,22,1999-08-29T09:00:00Z,COCOA BEACH FL,5,1,0,1,7
Hurricane,Dennis,22,1999-08-29T09:00:00Z,NEW YORK CITY NY,0,0,0,9,9
Hurricane,Dennis,22,1999-08-29T09:00:00Z,DAYTONA BEACH FL,16,0,1,0,17
Hurricane,Dennis,22,1999-08-29T09:00:00Z,MONTAUK POINT NY,0,0,0,7,7
Hurricane,Dennis,22,1999-08-29T09:00:00Z,JACKSONVILLE FL,14,1,0,1,16
Hurricane,Dennis,22,1999-08-29T09:00:00Z,PROVIDENCE RI,0,0,0,6,6
Hurricane,Dennis,22,1999-08-29T09:00:00Z,SAVANNAH GA,19,2,0,0,21
Hurricane,Dennis,22,1999-08-29T09:00:00Z,NANTUCKET MA,0,0,0,5,5
Hurricane,Dennis,22,1999-08-29T09:00:00Z,CHARLESTON SC,25,2,0,1,28
Hurricane,Dennis,22,1999-08-29T09:00:00Z,HYANNIS MA,0,0,0,4,4
Hurricane,Dennis,22,1999-08-29T09:00:00Z,MYRTLE BEACH SC,17,9,1,0,27
Hurricane,Dennis,22,1999-08-29T09:00:00Z,BOSTON MA,0,0,0,4,4
Hurricane,Dennis,22,1999-08-29T09:00:00Z,WILMINGTON NC,8,14,2,1,25
Hurricane,Dennis,22,1999-08-29T09:00:00Z,PORTLAND ME,0,0,0,3,3
Hurricane,Dennis,23,1999-08-29T15:00:00Z,33.0N  77.5W,35,0,0,1,36
Hurricane,Dennis,23,1999-08-29T15:00:00Z,NEW YORK CITY NY,0,0,1,8,9
Hurricane,Dennis,23,1999-08-29T15:00:00Z,34.0N  76.0W,12,10,2,1,25
Hurricane,Dennis,23,1999-08-29T15:00:00Z,MONTAUK POINT NY,0,0,0,9,9
Hurricane,Dennis,23,1999-08-29T15:00:00Z,34.7N  74.5W,1,12,4,3,20
Hurricane,Dennis,23,1999-08-29T15:00:00Z,PROVIDENCE RI,0,0,0,8,8
Hurricane,Dennis,23,1999-08-29T15:00:00Z,MYNN 251N 775W,0,0,0,2,2
Hurricane,Dennis,23,1999-08-29T15:00:00Z,NANTUCKET MA,0,0,0,8,8
Hurricane,Dennis,23,1999-08-29T15:00:00Z,MYGF 266N 787W,0,0,0,4,4
Hurricane,Dennis,23,1999-08-29T15:00:00Z,HYANNIS MA,0,0,0,8,8
Hurricane,Dennis,23,1999-08-29T15:00:00Z,BERMUDA,0,0,0,2,2
Hurricane,Dennis,23,1999-08-29T15:00:00Z,BOSTON MA,0,0,0,6,6
Hurricane,Dennis,23,1999-08-29T15:00:00Z,MARATHON FL,0,0,0,2,2
Hurricane,Dennis,23,1999-08-29T15:00:00Z,PORTLAND ME,0,0,0,5,5
Hurricane,Dennis,23,1999-08-29T15:00:00Z,MIAMI FL,0,0,0,3,3
Hurricane,Dennis,23,1999-08-29T15:00:00Z,BAR HARBOR ME,0,0,0,4,4
Hurricane,Dennis,23,1999-08-29T15:00:00Z,W PALM BEACH FL,0,0,0,4,4
Hurricane,Dennis,23,1999-08-29T15:00:00Z,EASTPORT ME,0,0,0,3,3
Hurricane,Dennis,23,1999-08-29T15:00:00Z,FT PIERCE FL,0,0,0,5,5
Hurricane,Dennis,23,1999-08-29T15:00:00Z,ST JOHN NB,0,0,0,3,3
Hurricane,Dennis,23,1999-08-29T15:00:00Z,COCOA BEACH FL,0,0,1,4,5
Hurricane,Dennis,23,1999-08-29T15:00:00Z,MONCTON NB,0,0,0,2,2
Hurricane,Dennis,23,1999-08-29T15:00:00Z,DAYTONA BEACH FL,1,1,0,5,7
Hurricane,Dennis,23,1999-08-29T15:00:00Z,YARMOUTH NS,0,0,0,4,4
Hurricane,Dennis,23,1999-08-29T15:00:00Z,JACKSONVILLE FL,7,0,1,3,11
Hurricane,Dennis,23,1999-08-29T15:00:00Z,HALIFAX NS,0,0,0,2,2
Hurricane,Dennis,23,1999-08-29T15:00:00Z,SAVANNAH GA,18,1,0,1,20
Hurricane,Dennis,23,1999-08-29T15:00:00Z,MARCO ISLAND FL,0,0,0,2,2
Hurricane,Dennis,23,1999-08-29T15:00:00Z,CHARLESTON SC,28,1,0,0,29
Hurricane,Dennis,23,1999-08-29T15:00:00Z,FT MYERS FL,0,0,0,3,3
Hurricane,Dennis,23,1999-08-29T15:00:00Z,MYRTLE BEACH SC,26,2,0,1,29
Hurricane,Dennis,23,1999-08-29T15:00:00Z,VENICE FL,0,0,0,3,3
Hurricane,Dennis,23,1999-08-29T15:00:00Z,WILMINGTON NC,18,6,1,1,26
Hurricane,Dennis,23,1999-08-29T15:00:00Z,TAMPA FL,0,0,0,4,4
Hurricane,Dennis,23,1999-08-29T15:00:00Z,MOREHEAD CITY NC,8,12,2,2,24
Hurricane,Dennis,23,1999-08-29T15:00:00Z,CEDAR KEY FL,0,0,0,4,4
Hurricane,Dennis,23,1999-08-29T15:00:00Z,CAPE HATTERAS NC,1,13,4,3,21
Hurricane,Dennis,23,1999-08-29T15:00:00Z,ST MARKS FL,0,0,0,3,3
Hurricane,Dennis,23,1999-08-29T15:00:00Z,NORFOLK VA,0,4,7,5,16
Hurricane,Dennis,23,1999-08-29T15:00:00Z,APALACHICOLA FL,0,0,0,2,2
Hurricane,Dennis,23,1999-08-29T15:00:00Z,OCEAN CITY MD,0,0,6,7,13
Hurricane,Dennis,23,1999-08-29T15:00:00Z,PANAMA CITY FL,0,0,0,2,2
Hurricane,Dennis,23,1999-08-29T15:00:00Z,ATLANTIC CITY NJ,0,0,2,9,11
Hurricane,Dennis,23,1999-08-29T15:00:00Z,GULF 29N 85W,0,0,0,2,2
Hurricane,Dennis,24,1999-08-29T21:00:00Z,34.0N  75.5W,27,1,0,0,28
Hurricane,Dennis,24,1999-08-29T21:00:00Z,OCEAN CITY MD,0,6,4,3,13
Hurricane,Dennis,24,1999-08-29T21:00:00Z,35.0N  74.0W,8,7,2,1,18
Hurricane,Dennis,24,1999-08-29T21:00:00Z,ATLANTIC CITY NJ,0,3,4,4,11
Hurricane,Dennis,24,1999-08-29T21:00:00Z,35.5N  72.5W,1,9,3,2,15
Hurricane,Dennis,24,1999-08-29T21:00:00Z,NEW YORK CITY NY,0,1,4,4,9
Hurricane,Dennis,24,1999-08-29T21:00:00Z,MYSM 241N 745W,0,0,1,2,3
Hurricane,Dennis,24,1999-08-29T21:00:00Z,MONTAUK POINT NY,0,1,3,5,9
Hurricane,Dennis,24,1999-08-29T21:00:00Z,MYEG 235N 758W,0,0,0,2,2
Hurricane,Dennis,24,1999-08-29T21:00:00Z,PROVIDENCE RI,0,0,3,5,8
Hurricane,Dennis,24,1999-08-29T21:00:00Z,MYAK 241N 776W,0,0,0,3,3
Hurricane,Dennis,24,1999-08-29T21:00:00Z,NANTUCKET MA,0,0,2,6,8
Hurricane,Dennis,24,1999-08-29T21:00:00Z,MYNN 251N 775W,0,0,1,3,4
Hurricane,Dennis,24,1999-08-29T21:00:00Z,HYANNIS MA,0,0,2,5,7
Hurricane,Dennis,24,1999-08-29T21:00:00Z,MYGF 266N 787W,0,0,1,3,4
Hurricane,Dennis,24,1999-08-29T21:00:00Z,BOSTON MA,0,0,2,5,7
Hurricane,Dennis,24,1999-08-29T21:00:00Z,BERMUDA,0,0,1,3,4
Hurricane,Dennis,24,1999-08-29T21:00:00Z,PORTLAND ME,0,0,1,4,5
Hurricane,Dennis,24,1999-08-29T21:00:00Z,MARATHON FL,0,0,0,2,2
Hurricane,Dennis,24,1999-08-29T21:00:00Z,BAR HARBOR ME,0,0,0,4,4
Hurricane,Dennis,24,1999-08-29T21:00:00Z,MIAMI FL,0,0,0,3,3
Hurricane,Dennis,24,1999-08-29T21:00:00Z,EASTPORT ME,0,0,0,3,3
Hurricane,Dennis,24,1999-08-29T21:00:00Z,W PALM BEACH FL,0,0,1,3,4
Hurricane,Dennis,24,1999-08-29T21:00:00Z,ST JOHN NB,0,0,0,3,3
Hurricane,Dennis,24,1999-08-29T21:00:00Z,FT PIERCE FL,0,0,1,3,4
Hurricane,Dennis,24,1999-08-29T21:00:00Z,MONCTON NB,0,0,0,2,2
Hurricane,Dennis,24,1999-08-29T21:00:00Z,COCOA BEACH FL,0,0,1,3,4
Hurricane,Dennis,24,1999-08-29T21:00:00Z,YARMOUTH NS,0,0,0,4,4
Hurricane,Dennis,24,1999-08-29T21:00:00Z,DAYTONA BEACH FL,0,0,1,3,4
Hurricane,Dennis,24,1999-08-29T21:00:00Z,HALIFAX NS,0,0,0,3,3
Hurricane,Dennis,24,1999-08-29T21:00:00Z,JACKSONVILLE FL,0,1,1,3,5
Hurricane,Dennis,24,1999-08-29T21:00:00Z,EDDY POINT NS,0,0,0,2,2
Hurricane,Dennis,24,1999-08-29T21:00:00Z,SAVANNAH GA,1,2,1,3,7
Hurricane,Dennis,24,1999-08-29T21:00:00Z,KEY WEST FL,0,0,0,2,2
Hurricane,Dennis,24,1999-08-29T21:00:00Z,CHARLESTON SC,27,0,0,0,27
Hurricane,Dennis,24,1999-08-29T21:00:00Z,MARCO ISLAND FL,0,0,0,2,2
Hurricane,Dennis,24,1999-08-29T21:00:00Z,MYRTLE BEACH SC,31,1,0,0,32
Hurricane,Dennis,24,1999-08-29T21:00:00Z,FT MYERS FL,0,0,0,2,2
Hurricane,Dennis,24,1999-08-29T21:00:00Z,WILMINGTON NC,28,1,0,0,29
Hurricane,Dennis,24,1999-08-29T21:00:00Z,VENICE FL,0,0,0,2,2
Hurricane,Dennis,24,1999-08-29T21:00:00Z,MOREHEAD CITY NC,24,1,0,0,25
Hurricane,Dennis,24,1999-08-29T21:00:00Z,TAMPA FL,0,0,0,3,3
Hurricane,Dennis,24,1999-08-29T21:00:00Z,CAPE HATTERAS NC,14,4,1,1,20
Hurricane,Dennis,24,1999-08-29T21:00:00Z,CEDAR KEY FL,0,0,0,2,2
Hurricane,Dennis,24,1999-08-29T21:00:00Z,NORFOLK VA,3,8,2,2,15
Hurricane,Dennis,24,1999-08-29T21:00:00Z,ST MARKS FL,0,0,0,2,2
Hurricane,Dennis,25,1999-08-30T03:00:00Z,34.7N  75.2W,29,1,0,0,30
Hurricane,Dennis,25,1999-08-30T03:00:00Z,OCEAN CITY MD,0,7,3,3,13
Hurricane,Dennis,25,1999-08-30T03:00:00Z,35.5N  73.5W,9,7,1,1,18
Hurricane,Dennis,25,1999-08-30T03:00:00Z,ATLANTIC CITY NJ,0,4,3,4,11
Hurricane,Dennis,25,1999-08-30T03:00:00Z,36.0N  72.0W,1,8,3,3,15
Hurricane,Dennis,25,1999-08-30T03:00:00Z,NEW YORK CITY NY,0,1,4,4,9
Hurricane,Dennis,25,1999-08-30T03:00:00Z,MYSM 241N 745W,0,0,0,2,2
Hurricane,Dennis,25,1999-08-30T03:00:00Z,MONTAUK POINT NY,0,0,3,5,8
Hurricane,Dennis,25,1999-08-30T03:00:00Z,BERMUDA,0,0,1,3,4
Hurricane,Dennis,25,1999-08-30T03:00:00Z,PROVIDENCE RI,0,0,2,5,7
Hurricane,Dennis,25,1999-08-30T03:00:00Z,SAVANNAH GA,0,1,0,1,2
Hurricane,Dennis,25,1999-08-30T03:00:00Z,NANTUCKET MA,0,0,2,5,7
Hurricane,Dennis,25,1999-08-30T03:00:00Z,CHARLESTON SC,28,0,0,0,28
Hurricane,Dennis,25,1999-08-30T03:00:00Z,HYANNIS MA,0,0,2,4,6
Hurricane,Dennis,25,1999-08-30T03:00:00Z,MYRTLE BEACH SC,60,0,0,0,60
Hurricane,Dennis,25,1999-08-30T03:00:00Z,BOSTON MA,0,0,1,5,6
Hurricane,Dennis,25,1999-08-30T03:00:00Z,WILMINGTON NC,45,0,0,0,45
Hurricane,Dennis,25,1999-08-30T03:00:00Z,PORTLAND ME,0,0,1,3,4
Hurricane,Dennis,25,1999-08-30T03:00:00Z,MOREHEAD CITY NC,36,0,0,0,36
Hurricane,Dennis,25,1999-08-30T03:00:00Z,BAR HARBOR ME,0,0,0,3,3
Hurricane,Dennis,25,1999-08-30T03:00:00Z,CAPE HATTERAS NC,23,1,1,0,25
Hurricane,Dennis,25,1999-08-30T03:00:00Z,EASTPORT ME,0,0,0,2,2
Hurricane,Dennis,25,1999-08-30T03:00:00Z,NORFOLK VA,4,8,2,1,15
Hurricane,Dennis,25,1999-08-30T03:00:00Z,YARMOUTH NS,0,0,0,2,2
Hurricane,Dennis,26,1999-08-30T09:00:00Z,35.0N  74.0W,29,0,0,1,30
Hurricane,Dennis,26,1999-08-30T09:00:00Z,NORFOLK VA,8,5,2,2,17
Hurricane,Dennis,26,1999-08-30T09:00:00Z,35.5N  72.5W,9,6,2,2,19
Hurricane,Dennis,26,1999-08-30T09:00:00Z,OCEAN CITY MD,1,6,4,2,13
Hurricane,Dennis,26,1999-08-30T09:00:00Z,35.5N  72.5W,9,6,2,2,19
Hurricane,Dennis,26,1999-08-30T09:00:00Z,ATLANTIC CITY NJ,0,3,4,4,11
Hurricane,Dennis,26,1999-08-30T09:00:00Z,BERMUDA,0,0,1,4,5
Hurricane,Dennis,26,1999-08-30T09:00:00Z,NEW YORK CITY NY,0,1,3,4,8
Hurricane,Dennis,26,1999-08-30T09:00:00Z,DAYTONA BEACH FL,0,0,0,2,2
Hurricane,Dennis,26,1999-08-30T09:00:00Z,MONTAUK POINT NY,0,0,2,5,7
Hurricane,Dennis,26,1999-08-30T09:00:00Z,JACKSONVILLE FL,0,0,0,2,2
Hurricane,Dennis,26,1999-08-30T09:00:00Z,PROVIDENCE RI,0,0,2,4,6
Hurricane,Dennis,26,1999-08-30T09:00:00Z,SAVANNAH GA,0,0,1,3,4
Hurricane,Dennis,26,1999-08-30T09:00:00Z,NANTUCKET MA,0,0,1,5,6
Hurricane,Dennis,26,1999-08-30T09:00:00Z,CHARLESTON SC,0,2,2,3,7
Hurricane,Dennis,26,1999-08-30T09:00:00Z,HYANNIS MA,0,0,1,4,5
Hurricane,Dennis,26,1999-08-30T09:00:00Z,MYRTLE BEACH SC,21,0,1,0,22
Hurricane,Dennis,26,1999-08-30T09:00:00Z,BOSTON MA,0,0,1,4,5
Hurricane,Dennis,26,1999-08-30T09:00:00Z,WILMINGTON NC,62,0,0,0,62
Hurricane,Dennis,26,1999-08-30T09:00:00Z,PORTLAND ME,0,0,0,3,3
Hurricane,Dennis,26,1999-08-30T09:00:00Z,MOREHEAD CITY NC,65,0,0,0,65
Hurricane,Dennis,26,1999-08-30T09:00:00Z,BAR HARBOR ME,0,0,0,2,2
Hurricane,Dennis,26,1999-08-30T09:00:00Z,CAPE HATTERAS NC,39,0,0,0,39
Hurricane,Dennis,27,1999-08-30T15:00:00Z,35.1N  73.5W,30,1,0,0,31
Hurricane,Dennis,27,1999-08-30T15:00:00Z,WILMINGTON NC,4,2,2,3,11
Hurricane,Dennis,27,1999-08-30T15:00:00Z,35.5N  73.0W,18,2,1,1,22
Hurricane,Dennis,27,1999-08-30T15:00:00Z,MOREHEAD CITY NC,48,0,0,0,48
Hurricane,Dennis,27,1999-08-30T15:00:00Z,35.5N  73.0W,18,2,1,1,22
Hurricane,Dennis,27,1999-08-30T15:00:00Z,CAPE HATTERAS NC,26,1,0,0,27
Hurricane,Dennis,27,1999-08-30T15:00:00Z,MYSM 241N 745W,0,0,0,2,2
Hurricane,Dennis,27,1999-08-30T15:00:00Z,NORFOLK VA,1,5,4,2,12
Hurricane,Dennis,27,1999-08-30T15:00:00Z,MYEG 235N 758W,0,0,0,2,2
Hurricane,Dennis,27,1999-08-30T15:00:00Z,OCEAN CITY MD,0,5,4,3,12
Hurricane,Dennis,27,1999-08-30T15:00:00Z,MYAK 241N 776W,0,0,0,2,2
Hurricane,Dennis,27,1999-08-30T15:00:00Z,ATLANTIC CITY NJ,0,3,3,4,10
Hurricane,Dennis,27,1999-08-30T15:00:00Z,MYNN 251N 775W,0,0,0,2,2
Hurricane,Dennis,27,1999-08-30T15:00:00Z,NEW YORK CITY NY,0,1,3,5,9
Hurricane,Dennis,27,1999-08-30T15:00:00Z,MYGF 266N 787W,0,0,0,3,3
Hurricane,Dennis,27,1999-08-30T15:00:00Z,MONTAUK POINT NY,0,1,2,5,8
Hurricane,Dennis,27,1999-08-30T15:00:00Z,BERMUDA,0,0,0,3,3
Hurricane,Dennis,27,1999-08-30T15:00:00Z,PROVIDENCE RI,0,0,2,5,7
Hurricane,Dennis,27,1999-08-30T15:00:00Z,W PALM BEACH FL,0,0,0,2,2
Hurricane,Dennis,27,1999-08-30T15:00:00Z,NANTUCKET MA,0,0,2,4,6
Hurricane,Dennis,27,1999-08-30T15:00:00Z,FT PIERCE FL,0,0,0,2,2
Hurricane,Dennis,27,1999-08-30T15:00:00Z,HYANNIS MA,0,0,2,4,6
Hurricane,Dennis,27,1999-08-30T15:00:00Z,COCOA BEACH FL,0,0,0,2,2
Hurricane,Dennis,27,1999-08-30T15:00:00Z,BOSTON MA,0,0,1,5,6
Hurricane,Dennis,27,1999-08-30T15:00:00Z,DAYTONA BEACH FL,0,0,0,2,2
Hurricane,Dennis,27,1999-08-30T15:00:00Z,PORTLAND ME,0,0,0,4,4
Hurricane,Dennis,27,1999-08-30T15:00:00Z,JACKSONVILLE FL,0,0,0,2,2
Hurricane,Dennis,27,1999-08-30T15:00:00Z,BAR HARBOR ME,0,0,0,3,3
Hurricane,Dennis,27,1999-08-30T15:00:00Z,SAVANNAH GA,0,0,0,3,3
Hurricane,Dennis,27,1999-08-30T15:00:00Z,EASTPORT ME,0,0,0,2,2
Hurricane,Dennis,27,1999-08-30T15:00:00Z,CHARLESTON SC,0,0,2,3,5
Hurricane,Dennis,27,1999-08-30T15:00:00Z,YARMOUTH NS,0,0,0,2,2
Hurricane,Dennis,27,1999-08-30T15:00:00Z,MYRTLE BEACH SC,0,2,2,4,8
Hurricane,Dennis,29,1999-08-31T03:00:00Z,36.4N  71.2W,37,0,0,0,37
Hurricane,Dennis,29,1999-08-31T03:00:00Z,MOREHEAD CITY NC,0,5,4,3,12
Hurricane,Dennis,29,1999-08-31T03:00:00Z,36.5N  71.6W,38,1,0,0,39
Hurricane,Dennis,29,1999-08-31T03:00:00Z,CAPE HATTERAS NC,4,6,3,2,15
Hurricane,Dennis,29,1999-08-31T03:00:00Z,36.5N  72.0W,41,0,0,0,41
Hurricane,Dennis,29,1999-08-31T03:00:00Z,NORFOLK VA,1,6,4,3,14
Hurricane,Dennis,29,1999-08-31T03:00:00Z,MYSM 241N 745W,0,0,0,2,2
Hurricane,Dennis,29,1999-08-31T03:00:00Z,OCEAN CITY MD,1,8,3,2,14
Hurricane,Dennis,29,1999-08-31T03:00:00Z,MYNN 251N 775W,0,0,0,2,2
Hurricane,Dennis,29,1999-08-31T03:00:00Z,ATLANTIC CITY NJ,0,6,4,3,13
Hurricane,Dennis,29,1999-08-31T03:00:00Z,MYGF 266N 787W,0,0,0,2,2
Hurricane,Dennis,29,1999-08-31T03:00:00Z,NEW YORK CITY NY,0,4,4,3,11
Hurricane,Dennis,29,1999-08-31T03:00:00Z,BERMUDA,0,0,1,3,4
Hurricane,Dennis,29,1999-08-31T03:00:00Z,MONTAUK POINT NY,0,3,3,4,10
Hurricane,Dennis,29,1999-08-31T03:00:00Z,W PALM BEACH FL,0,0,0,2,2
Hurricane,Dennis,29,1999-08-31T03:00:00Z,PROVIDENCE RI,0,2,3,4,9
Hurricane,Dennis,29,1999-08-31T03:00:00Z,FT PIERCE FL,0,0,0,2,2
Hurricane,Dennis,29,1999-08-31T03:00:00Z,NANTUCKET MA,0,2,3,3,8
Hurricane,Dennis,29,1999-08-31T03:00:00Z,COCOA BEACH FL,0,0,0,2,2
Hurricane,Dennis,29,1999-08-31T03:00:00Z,HYANNIS MA,0,1,3,4,8
Hurricane,Dennis,29,1999-08-31T03:00:00Z,DAYTONA BEACH FL,0,0,0,2,2
Hurricane,Dennis,29,1999-08-31T03:00:00Z,BOSTON MA,0,1,2,4,7
Hurricane,Dennis,29,1999-08-31T03:00:00Z,JACKSONVILLE FL,0,0,0,2,2
Hurricane,Dennis,29,1999-08-31T03:00:00Z,PORTLAND ME,0,0,1,4,5
Hurricane,Dennis,29,1999-08-31T03:00:00Z,SAVANNAH GA,0,0,0,4,4
Hurricane,Dennis,29,1999-08-31T03:00:00Z,BAR HARBOR ME,0,0,0,3,3
Hurricane,Dennis,29,1999-08-31T03:00:00Z,CHARLESTON SC,0,0,1,4,5
Hurricane,Dennis,29,1999-08-31T03:00:00Z,EASTPORT ME,0,0,0,2,2
Hurricane,Dennis,29,1999-08-31T03:00:00Z,MYRTLE BEACH SC,0,1,2,5,8
Hurricane,Dennis,29,1999-08-31T03:00:00Z,ST JOHN NB,0,0,0,2,2
Hurricane,Dennis,29,1999-08-31T03:00:00Z,WILMINGTON NC,0,2,4,4,10
Hurricane,Dennis,29,1999-08-31T03:00:00Z,YARMOUTH NS,0,0,0,3,3
Hurricane,Dennis,30,1999-08-31T09:00:00Z,36.0N  72.0W,99,0,0,0,99
Hurricane,Dennis,30,1999-08-31T09:00:00Z,NORFOLK VA,0,5,4,3,12
Hurricane,Dennis,30,1999-08-31T09:00:00Z,36.0N  72.5W,99,0,0,0,99
Hurricane,Dennis,30,1999-08-31T09:00:00Z,OCEAN CITY MD,1,4,4,3,12
Hurricane,Dennis,30,1999-08-31T09:00:00Z,35.8N  73.0W,99,0,0,0,99
Hurricane,Dennis,30,1999-08-31T09:00:00Z,ATLANTIC CITY NJ,0,3,3,4,10
Hurricane,Dennis,30,1999-08-31T09:00:00Z,MYSM 241N 745W,0,0,0,2,2
Hurricane,Dennis,30,1999-08-31T09:00:00Z,NEW YORK CITY NY,0,1,3,4,8
Hurricane,Dennis,30,1999-08-31T09:00:00Z,MYEG 235N 758W,0,0,0,2,2
Hurricane,Dennis,30,1999-08-31T09:00:00Z,MONTAUK POINT NY,0,2,2,3,7
Hurricane,Dennis,30,1999-08-31T09:00:00Z,MYAK 241N 776W,0,0,0,2,2
Hurricane,Dennis,30,1999-08-31T09:00:00Z,PROVIDENCE RI,0,1,2,3,6
Hurricane,Dennis,30,1999-08-31T09:00:00Z,MYNN 251N 775W,0,0,0,3,3
Hurricane,Dennis,30,1999-08-31T09:00:00Z,NANTUCKET MA,0,1,2,4,7
Hurricane,Dennis,30,1999-08-31T09:00:00Z,MYGF 266N 787W,0,0,0,4,4
Hurricane,Dennis,30,1999-08-31T09:00:00Z,HYANNIS MA,0,1,1,4,6
Hurricane,Dennis,30,1999-08-31T09:00:00Z,BERMUDA,0,0,0,3,3
Hurricane,Dennis,30,1999-08-31T09:00:00Z,BOSTON MA,0,0,2,3,5
Hurricane,Dennis,30,1999-08-31T09:00:00Z,MARATHON FL,0,0,0,2,2
Hurricane,Dennis,30,1999-08-31T09:00:00Z,PORTLAND ME,0,0,0,3,3
Hurricane,Dennis,30,1999-08-31T09:00:00Z,MIAMI FL,0,0,0,2,2
Hurricane,Dennis,30,1999-08-31T09:00:00Z,BAR HARBOR ME,0,0,0,2,2
Hurricane,Dennis,30,1999-08-31T09:00:00Z,W PALM BEACH FL,0,0,0,3,3
Hurricane,Dennis,30,1999-08-31T09:00:00Z,YARMOUTH NS,0,0,0,2,2
Hurricane,Dennis,30,1999-08-31T09:00:00Z,FT PIERCE FL,0,0,0,4,4
Hurricane,Dennis,30,1999-08-31T09:00:00Z,MARCO ISLAND FL,0,0,0,2,2
Hurricane,Dennis,30,1999-08-31T09:00:00Z,COCOA BEACH FL,0,0,0,4,4
Hurricane,Dennis,30,1999-08-31T09:00:00Z,FT MYERS FL,0,0,0,2,2
Hurricane,Dennis,30,1999-08-31T09:00:00Z,DAYTONA BEACH FL,0,0,0,4,4
Hurricane,Dennis,30,1999-08-31T09:00:00Z,VENICE FL,0,0,0,2,2
Hurricane,Dennis,30,1999-08-31T09:00:00Z,JACKSONVILLE FL,0,0,0,5,5
Hurricane,Dennis,30,1999-08-31T09:00:00Z,TAMPA FL,0,0,0,3,3
Hurricane,Dennis,30,1999-08-31T09:00:00Z,SAVANNAH GA,0,0,1,5,6
Hurricane,Dennis,30,1999-08-31T09:00:00Z,CEDAR KEY FL,0,0,0,3,3
Hurricane,Dennis,30,1999-08-31T09:00:00Z,CHARLESTON SC,0,0,2,5,7
Hurricane,Dennis,30,1999-08-31T09:00:00Z,ST MARKS FL,0,0,0,2,2
Hurricane,Dennis,30,1999-08-31T09:00:00Z,MYRTLE BEACH SC,0,1,3,5,9
Hurricane,Dennis,30,1999-08-31T09:00:00Z,APALACHICOLA FL,0,0,0,2,2
Hurricane,Dennis,30,1999-08-31T09:00:00Z,WILMINGTON NC,0,2,5,4,11
Hurricane,Dennis,30,1999-08-31T09:00:00Z,PANAMA CITY FL,0,0,0,2,2
Hurricane,Dennis,30,1999-08-31T09:00:00Z,MOREHEAD CITY NC,0,6,4,3,13
Hurricane,Dennis,30,1999-08-31T09:00:00Z,GULF 29N 85W,0,0,0,2,2
Hurricane,Dennis,30,1999-08-31T09:00:00Z,CAPE HATTERAS NC,3,7,3,3,16
Hurricane,Dennis,31,1999-08-31T15:00:00Z,35.5N  73.5W,99,0,0,0,99
Hurricane,Dennis,31,1999-08-31T15:00:00Z,MOREHEAD CITY NC,13,5,2,1,21
Hurricane,Dennis,31,1999-08-31T15:00:00Z,35.5N  73.5W,99,0,0,0,99
Hurricane,Dennis,31,1999-08-31T15:00:00Z,CAPE HATTERAS NC,24,2,1,0,27
Hurricane,Dennis,31,1999-08-31T15:00:00Z,35.0N  73.5W,99,0,0,0,99
Hurricane,Dennis,31,1999-08-31T15:00:00Z,NORFOLK VA,9,5,2,1,17
Hurricane,Dennis,31,1999-08-31T15:00:00Z,MYGF 266N 787W,0,0,0,2,2
Hurricane,Dennis,31,1999-08-31T15:00:00Z,OCEAN CITY MD,3,4,2,3,12
Hurricane,Dennis,31,1999-08-31T15:00:00Z,BERMUDA,0,0,0,4,4
Hurricane,Dennis,31,1999-08-31T15:00:00Z,ATLANTIC CITY NJ,0,1,2,4,7
Hurricane,Dennis,31,1999-08-31T15:00:00Z,W PALM BEACH FL,0,0,0,2,2
Hurricane,Dennis,31,1999-08-31T15:00:00Z,NEW YORK CITY NY,0,0,1,4,5
Hurricane,Dennis,31,1999-08-31T15:00:00Z,FT PIERCE FL,0,0,0,2,2
Hurricane,Dennis,31,1999-08-31T15:00:00Z,MONTAUK POINT NY,0,0,0,4,4
Hurricane,Dennis,31,1999-08-31T15:00:00Z,COCOA BEACH FL,0,0,0,3,3
Hurricane,Dennis,31,1999-08-31T15:00:00Z,PROVIDENCE RI,0,0,0,3,3
Hurricane,Dennis,31,1999-08-31T15:00:00Z,DAYTONA BEACH FL,0,0,0,3,3
Hurricane,Dennis,31,1999-08-31T15:00:00Z,NANTUCKET MA,0,0,0,3,3
Hurricane,Dennis,31,1999-08-31T15:00:00Z,JACKSONVILLE FL,0,0,1,3,4
Hurricane,Dennis,31,1999-08-31T15:00:00Z,HYANNIS MA,0,0,0,2,2
Hurricane,Dennis,31,1999-08-31T15:00:00Z,SAVANNAH GA,0,0,3,4,7
Hurricane,Dennis,31,1999-08-31T15:00:00Z,BOSTON MA,0,0,0,2,2
Hurricane,Dennis,31,1999-08-31T15:00:00Z,CHARLESTON SC,0,2,4,4,10
Hurricane,Dennis,31,1999-08-31T15:00:00Z,TAMPA FL,0,0,0,2,2
Hurricane,Dennis,31,1999-08-31T15:00:00Z,MYRTLE BEACH SC,1,5,4,3,13
Hurricane,Dennis,31,1999-08-31T15:00:00Z,CEDAR KEY FL,0,0,0,2,2
Hurricane,Dennis,31,1999-08-31T15:00:00Z,WILMINGTON NC,4,7,3,2,16
Hurricane,Dennis,31,1999-08-31T15:00:00Z,ST MARKS FL,0,0,0,2,2
Hurricane,Dennis,32,1999-08-31T21:00:00Z,35.0N  74.7W,99,0,0,0,99
Hurricane,Dennis,32,1999-08-31T21:00:00Z,ATLANTIC CITY NJ,0,3,3,3,9
Hurricane,Dennis,32,1999-08-31T21:00:00Z,34.9N  75.5W,47,0,0,0,47
Hurricane,Dennis,32,1999-08-31T21:00:00Z,NEW YORK CITY NY,0,1,2,3,6
Hurricane,Dennis,32,1999-08-31T21:00:00Z,34.7N  76.0W,34,1,0,0,35
Hurricane,Dennis,32,1999-08-31T21:00:00Z,MONTAUK POINT NY,0,0,1,3,4
Hurricane,Dennis,32,1999-08-31T21:00:00Z,MUHA 230N 824W,0,0,0,2,2
Hurricane,Dennis,32,1999-08-31T21:00:00Z,PROVIDENCE RI,0,0,1,2,3
Hurricane,Dennis,32,1999-08-31T21:00:00Z,MYAK 241N 776W,0,0,0,2,2
Hurricane,Dennis,32,1999-08-31T21:00:00Z,NANTUCKET MA,0,0,1,2,3
Hurricane,Dennis,32,1999-08-31T21:00:00Z,MYNN 251N 775W,0,0,0,3,3
Hurricane,Dennis,32,1999-08-31T21:00:00Z,HYANNIS MA,0,0,1,2,3
Hurricane,Dennis,32,1999-08-31T21:00:00Z,MYGF 266N 787W,0,0,1,4,5
Hurricane,Dennis,32,1999-08-31T21:00:00Z,BOSTON MA,0,0,0,3,3
Hurricane,Dennis,32,1999-08-31T21:00:00Z,MARATHON FL,0,0,0,3,3
Hurricane,Dennis,32,1999-08-31T21:00:00Z,KEY WEST FL,0,0,0,3,3
Hurricane,Dennis,32,1999-08-31T21:00:00Z,MIAMI FL,0,0,0,4,4
Hurricane,Dennis,32,1999-08-31T21:00:00Z,MARCO ISLAND FL,0,0,0,4,4
Hurricane,Dennis,32,1999-08-31T21:00:00Z,W PALM BEACH FL,0,0,1,4,5
Hurricane,Dennis,32,1999-08-31T21:00:00Z,FT MYERS FL,0,0,1,4,5
Hurricane,Dennis,32,1999-08-31T21:00:00Z,FT PIERCE FL,0,0,1,5,6
Hurricane,Dennis,32,1999-08-31T21:00:00Z,VENICE FL,0,0,1,4,5
Hurricane,Dennis,32,1999-08-31T21:00:00Z,COCOA BEACH FL,0,0,2,5,7
Hurricane,Dennis,32,1999-08-31T21:00:00Z,TAMPA FL,0,0,1,5,6
Hurricane,Dennis,32,1999-08-31T21:00:00Z,DAYTONA BEACH FL,0,0,3,5,8
Hurricane,Dennis,32,1999-08-31T21:00:00Z,CEDAR KEY FL,0,0,2,5,7
Hurricane,Dennis,32,1999-08-31T21:00:00Z,JACKSONVILLE FL,0,1,3,5,9
Hurricane,Dennis,32,1999-08-31T21:00:00Z,ST MARKS FL,0,0,1,5,6
Hurricane,Dennis,32,1999-08-31T21:00:00Z,SAVANNAH GA,0,2,5,4,11
Hurricane,Dennis,32,1999-08-31T21:00:00Z,APALACHICOLA FL,0,0,1,4,5
Hurricane,Dennis,32,1999-08-31T21:00:00Z,CHARLESTON SC,0,6,4,4,14
Hurricane,Dennis,32,1999-08-31T21:00:00Z,PANAMA CITY FL,0,0,1,3,4
Hurricane,Dennis,32,1999-08-31T21:00:00Z,MYRTLE BEACH SC,2,9,3,2,16
Hurricane,Dennis,32,1999-08-31T21:00:00Z,PENSACOLA FL,0,0,0,3,3
Hurricane,Dennis,32,1999-08-31T21:00:00Z,WILMINGTON NC,10,7,1,2,20
Hurricane,Dennis,32,1999-08-31T21:00:00Z,MOBILE AL,0,0,0,2,2
Hurricane,Dennis,32,1999-08-31T21:00:00Z,MOREHEAD CITY NC,26,1,0,1,28
Hurricane,Dennis,32,1999-08-31T21:00:00Z,GULFPORT MS,0,0,0,2,2
Hurricane,Dennis,32,1999-08-31T21:00:00Z,CAPE HATTERAS NC,44,0,0,0,44
Hurricane,Dennis,32,1999-08-31T21:00:00Z,GULF 29N 85W,0,0,1,4,5
Hurricane,Dennis,32,1999-08-31T21:00:00Z,NORFOLK VA,14,3,1,1,19
Hurricane,Dennis,32,1999-08-31T21:00:00Z,GULF 29N 87W,0,0,0,3,3
Hurricane,Dennis,32,1999-08-31T21:00:00Z,OCEAN CITY MD,2,6,2,3,13
Tropical Storm,Dennis,33,1999-09-01T03:00:00Z,35.1N  75.1W,99,0,0,0,99
Tropical Storm,Dennis,33,1999-09-01T03:00:00Z,ATLANTIC CITY NJ,0,1,2,3,6
Tropical Storm,Dennis,33,1999-09-01T03:00:00Z,35.0N  75.8W,53,0,0,0,53
Tropical Storm,Dennis,33,1999-09-01T03:00:00Z,NEW YORK CITY NY,0,0,1,3,4
Tropical Storm,Dennis,33,1999-09-01T03:00:00Z,34.5N  76.5W,30,1,0,0,31
Tropical Storm,Dennis,33,1999-09-01T03:00:00Z,MONTAUK POINT NY,0,0,1,2,3
Tropical Storm,Dennis,33,1999-09-01T03:00:00Z,MYSM 241N 745W,0,0,0,2,2
Tropical Storm,Dennis,33,1999-09-01T03:00:00Z,PROVIDENCE RI,0,0,0,2,2
Tropical Storm,Dennis,33,1999-09-01T03:00:00Z,MYAK 241N 776W,0,0,0,2,2
Tropical Storm,Dennis,33,1999-09-01T03:00:00Z,NANTUCKET MA,0,0,0,2,2
Tropical Storm,Dennis,33,1999-09-01T03:00:00Z,MYNN 251N 775W,0,0,0,3,3
Tropical Storm,Dennis,33,1999-09-01T03:00:00Z,HYANNIS MA,0,0,0,2,2
Tropical Storm,Dennis,33,1999-09-01T03:00:00Z,MYGF 266N 787W,0,0,0,5,5
Tropical Storm,Dennis,33,1999-09-01T03:00:00Z,KEY WEST FL,0,0,0,2,2
Tropical Storm,Dennis,33,1999-09-01T03:00:00Z,BERMUDA,0,0,0,2,2
Tropical Storm,Dennis,33,1999-09-01T03:00:00Z,MARCO ISLAND FL,0,0,0,4,4
Tropical Storm,Dennis,33,1999-09-01T03:00:00Z,MARATHON FL,0,0,0,2,2
Tropical Storm,Dennis,33,1999-09-01T03:00:00Z,FT MYERS FL,0,0,0,4,4
Tropical Storm,Dennis,33,1999-09-01T03:00:00Z,MIAMI FL,0,0,0,4,4
Tropical Storm,Dennis,33,1999-09-01T03:00:00Z,VENICE FL,0,0,1,4,5
Tropical Storm,Dennis,33,1999-09-01T03:00:00Z,W PALM BEACH FL,0,0,0,5,5
Tropical Storm,Dennis,33,1999-09-01T03:00:00Z,TAMPA FL,0,0,1,5,6
Tropical Storm,Dennis,33,1999-09-01T03:00:00Z,FT PIERCE FL,0,0,1,5,6
Tropical Storm,Dennis,33,1999-09-01T03:00:00Z,CEDAR KEY FL,0,0,2,5,7
Tropical Storm,Dennis,33,1999-09-01T03:00:00Z,COCOA BEACH FL,0,0,2,5,7
Tropical Storm,Dennis,33,1999-09-01T03:00:00Z,ST MARKS FL,0,0,2,5,7
Tropical Storm,Dennis,33,1999-09-01T03:00:00Z,DAYTONA BEACH FL,0,0,3,5,8
Tropical Storm,Dennis,33,1999-09-01T03:00:00Z,APALACHICOLA FL,0,0,1,5,6
Tropical Storm,Dennis,33,1999-09-01T03:00:00Z,JACKSONVILLE FL,0,1,4,5,10
Tropical Storm,Dennis,33,1999-09-01T03:00:00Z,PANAMA CITY FL,0,0,1,5,6
Tropical Storm,Dennis,33,1999-09-01T03:00:00Z,SAVANNAH GA,0,4,5,4,13
Tropical Storm,Dennis,33,1999-09-01T03:00:00Z,PENSACOLA FL,0,0,1,3,4
Tropical Storm,Dennis,33,1999-09-01T03:00:00Z,CHARLESTON SC,1,7,4,3,15
Tropical Storm,Dennis,33,1999-09-01T03:00:00Z,MOBILE AL,0,0,0,4,4
Tropical Storm,Dennis,33,1999-09-01T03:00:00Z,MYRTLE BEACH SC,6,8,2,2,18
Tropical Storm,Dennis,33,1999-09-01T03:00:00Z,GULFPORT MS,0,0,0,3,3
Tropical Storm,Dennis,33,1999-09-01T03:00:00Z,WILMINGTON NC,17,3,1,1,22
Tropical Storm,Dennis,33,1999-09-01T03:00:00Z,BURAS LA,0,0,0,2,2
Tropical Storm,Dennis,33,1999-09-01T03:00:00Z,MOREHEAD CITY NC,29,1,0,0,30
Tropical Storm,Dennis,33,1999-09-01T03:00:00Z,NEW ORLEANS LA,0,0,0,2,2
Tropical Storm,Dennis,33,1999-09-01T03:00:00Z,CAPE HATTERAS NC,59,0,0,0,59
Tropical Storm,Dennis,33,1999-09-01T03:00:00Z,GULF 29N 85W,0,0,1,4,5
Tropical Storm,Dennis,33,1999-09-01T03:00:00Z,NORFOLK VA,14,2,1,1,18
Tropical Storm,Dennis,33,1999-09-01T03:00:00Z,GULF 29N 87W,0,0,0,4,4
Tropical Storm,Dennis,33,1999-09-01T03:00:00Z,OCEAN CITY MD,1,4,3,2,10
Tropical Storm,Dennis,33,1999-09-01T03:00:00Z,GULF 28N 89W,0,0,0,2,2
Tropical Storm,Dennis,34,1999-09-01T09:00:00Z,34.8N  74.3W,99,0,0,0,99
Tropical Storm,Dennis,34,1999-09-01T09:00:00Z,CAPE HATTERAS NC,34,0,0,0,34
Tropical Storm,Dennis,34,1999-09-01T09:00:00Z,34.7N  75.0W,46,0,0,0,46
Tropical Storm,Dennis,34,1999-09-01T09:00:00Z,NORFOLK VA,9,5,2,1,17
Tropical Storm,Dennis,34,1999-09-01T09:00:00Z,34.5N  75.5W,39,0,0,0,39
Tropical Storm,Dennis,34,1999-09-01T09:00:00Z,OCEAN CITY MD,1,4,2,3,10
Tropical Storm,Dennis,34,1999-09-01T09:00:00Z,MYSM 241N 745W,0,0,0,2,2
Tropical Storm,Dennis,34,1999-09-01T09:00:00Z,ATLANTIC CITY NJ,0,1,1,3,5
Tropical Storm,Dennis,34,1999-09-01T09:00:00Z,MYEG 235N 758W,0,0,0,2,2
Tropical Storm,Dennis,34,1999-09-01T09:00:00Z,NEW YORK CITY NY,0,0,0,3,3
Tropical Storm,Dennis,34,1999-09-01T09:00:00Z,MYAK 241N 776W,0,0,0,2,2
Tropical Storm,Dennis,34,1999-09-01T09:00:00Z,MONTAUK POINT NY,0,0,0,2,2
Tropical Storm,Dennis,34,1999-09-01T09:00:00Z,MYNN 251N 775W,0,0,0,3,3
Tropical Storm,Dennis,34,1999-09-01T09:00:00Z,KEY WEST FL,0,0,0,2,2
Tropical Storm,Dennis,34,1999-09-01T09:00:00Z,MYGF 266N 787W,0,0,0,4,4
Tropical Storm,Dennis,34,1999-09-01T09:00:00Z,MARCO ISLAND FL,0,0,0,3,3
Tropical Storm,Dennis,34,1999-09-01T09:00:00Z,BERMUDA,0,0,0,2,2
Tropical Storm,Dennis,34,1999-09-01T09:00:00Z,FT MYERS FL,0,0,0,3,3
Tropical Storm,Dennis,34,1999-09-01T09:00:00Z,MARATHON FL,0,0,0,2,2
Tropical Storm,Dennis,34,1999-09-01T09:00:00Z,VENICE FL,0,0,0,3,3
Tropical Storm,Dennis,34,1999-09-01T09:00:00Z,MIAMI FL,0,0,0,3,3
Tropical Storm,Dennis,34,1999-09-01T09:00:00Z,TAMPA FL,0,0,0,4,4
Tropical Storm,Dennis,34,1999-09-01T09:00:00Z,W PALM BEACH FL,0,0,0,4,4
Tropical Storm,Dennis,34,1999-09-01T09:00:00Z,CEDAR KEY FL,0,0,0,5,5
Tropical Storm,Dennis,34,1999-09-01T09:00:00Z,FT PIERCE FL,0,0,0,5,5
Tropical Storm,Dennis,34,1999-09-01T09:00:00Z,ST MARKS FL,0,0,0,5,5
Tropical Storm,Dennis,34,1999-09-01T09:00:00Z,COCOA BEACH FL,0,0,0,5,5
Tropical Storm,Dennis,34,1999-09-01T09:00:00Z,APALACHICOLA FL,0,0,0,4,4
Tropical Storm,Dennis,34,1999-09-01T09:00:00Z,DAYTONA BEACH FL,0,0,1,5,6
Tropical Storm,Dennis,34,1999-09-01T09:00:00Z,PANAMA CITY FL,0,0,0,3,3
Tropical Storm,Dennis,34,1999-09-01T09:00:00Z,JACKSONVILLE FL,0,0,1,6,7
Tropical Storm,Dennis,34,1999-09-01T09:00:00Z,PENSACOLA FL,0,0,0,3,3
Tropical Storm,Dennis,34,1999-09-01T09:00:00Z,SAVANNAH GA,0,1,3,6,10
Tropical Storm,Dennis,34,1999-09-01T09:00:00Z,MOBILE AL,0,0,0,2,2
Tropical Storm,Dennis,34,1999-09-01T09:00:00Z,CHARLESTON SC,0,4,5,4,13
Tropical Storm,Dennis,34,1999-09-01T09:00:00Z,GULFPORT MS,0,0,0,2,2
Tropical Storm,Dennis,34,1999-09-01T09:00:00Z,MYRTLE BEACH SC,2,8,4,2,16
Tropical Storm,Dennis,34,1999-09-01T09:00:00Z,GULF 29N 85W,0,0,0,3,3
Tropical Storm,Dennis,34,1999-09-01T09:00:00Z,WILMINGTON NC,10,6,2,2,20
Tropical Storm,Dennis,34,1999-09-01T09:00:00Z,GULF 29N 87W,0,0,0,2,2
Tropical Storm,Dennis,34,1999-09-01T09:00:00Z,MOREHEAD CITY NC,23,2,1,0,26
Tropical Storm,Dennis,35,1999-09-01T15:00:00Z,34.9N  75.0W,73,0,0,0,73
Tropical Storm,Dennis,35,1999-09-01T15:00:00Z,ATLANTIC CITY NJ,0,1,2,3,6
Tropical Storm,Dennis,35,1999-09-01T15:00:00Z,34.5N  75.8W,41,0,0,0,41
Tropical Storm,Dennis,35,1999-09-01T15:00:00Z,NEW YORK CITY NY,0,0,1,3,4
Tropical Storm,Dennis,35,1999-09-01T15:00:00Z,34.0N  76.5W,25,1,1,0,27
Tropical Storm,Dennis,35,1999-09-01T15:00:00Z,MONTAUK POINT NY,0,0,1,2,3
Tropical Storm,Dennis,35,1999-09-01T15:00:00Z,MUHA 230N 824W,0,0,0,2,2
Tropical Storm,Dennis,35,1999-09-01T15:00:00Z,PROVIDENCE RI,0,0,0,2,2
Tropical Storm,Dennis,35,1999-09-01T15:00:00Z,MYSM 241N 745W,0,0,0,2,2
Tropical Storm,Dennis,35,1999-09-01T15:00:00Z,NANTUCKET MA,0,0,0,2,2
Tropical Storm,Dennis,35,1999-09-01T15:00:00Z,MYEG 235N 758W,0,0,0,2,2
Tropical Storm,Dennis,35,1999-09-01T15:00:00Z,HYANNIS MA,0,0,0,2,2
Tropical Storm,Dennis,35,1999-09-01T15:00:00Z,MYAK 241N 776W,0,0,0,3,3
Tropical Storm,Dennis,35,1999-09-01T15:00:00Z,KEY WEST FL,0,0,0,3,3
Tropical Storm,Dennis,35,1999-09-01T15:00:00Z,MYNN 251N 775W,0,0,0,4,4
Tropical Storm,Dennis,35,1999-09-01T15:00:00Z,MARCO ISLAND FL,0,0,1,4,5
Tropical Storm,Dennis,35,1999-09-01T15:00:00Z,MYGF 266N 787W,0,0,1,5,6
Tropical Storm,Dennis,35,1999-09-01T15:00:00Z,FT MYERS FL,0,0,1,5,6
Tropical Storm,Dennis,35,1999-09-01T15:00:00Z,MARATHON FL,0,0,0,3,3
Tropical Storm,Dennis,35,1999-09-01T15:00:00Z,VENICE FL,0,0,1,5,6
Tropical Storm,Dennis,35,1999-09-01T15:00:00Z,MIAMI FL,0,0,1,4,5
Tropical Storm,Dennis,35,1999-09-01T15:00:00Z,TAMPA FL,0,0,2,5,7
Tropical Storm,Dennis,35,1999-09-01T15:00:00Z,W PALM BEACH FL,0,0,1,5,6
Tropical Storm,Dennis,35,1999-09-01T15:00:00Z,CEDAR KEY FL,0,0,3,5,8
Tropical Storm,Dennis,35,1999-09-01T15:00:00Z,FT PIERCE FL,0,0,2,5,7
Tropical Storm,Dennis,35,1999-09-01T15:00:00Z,ST MARKS FL,0,0,2,6,8
Tropical Storm,Dennis,35,1999-09-01T15:00:00Z,COCOA BEACH FL,0,0,3,6,9
Tropical Storm,Dennis,35,1999-09-01T15:00:00Z,APALACHICOLA FL,0,0,2,4,6
Tropical Storm,Dennis,35,1999-09-01T15:00:00Z,DAYTONA BEACH FL,0,1,4,5,10
Tropical Storm,Dennis,35,1999-09-01T15:00:00Z,PANAMA CITY FL,0,0,1,5,6
Tropical Storm,Dennis,35,1999-09-01T15:00:00Z,JACKSONVILLE FL,0,2,4,5,11
Tropical Storm,Dennis,35,1999-09-01T15:00:00Z,PENSACOLA FL,0,0,0,4,4
Tropical Storm,Dennis,35,1999-09-01T15:00:00Z,SAVANNAH GA,0,4,5,4,13
Tropical Storm,Dennis,35,1999-09-01T15:00:00Z,MOBILE AL,0,0,0,3,3
Tropical Storm,Dennis,35,1999-09-01T15:00:00Z,CHARLESTON SC,1,8,3,3,15
Tropical Storm,Dennis,35,1999-09-01T15:00:00Z,GULFPORT MS,0,0,0,3,3
Tropical Storm,Dennis,35,1999-09-01T15:00:00Z,MYRTLE BEACH SC,5,8,3,2,18
Tropical Storm,Dennis,35,1999-09-01T15:00:00Z,BURAS LA,0,0,0,2,2
Tropical Storm,Dennis,35,1999-09-01T15:00:00Z,WILMINGTON NC,15,4,1,1,21
Tropical Storm,Dennis,35,1999-09-01T15:00:00Z,NEW ORLEANS LA,0,0,0,2,2
Tropical Storm,Dennis,35,1999-09-01T15:00:00Z,MOREHEAD CITY NC,27,1,0,1,29
Tropical Storm,Dennis,35,1999-09-01T15:00:00Z,GULF 29N 85W,0,0,1,5,6
Tropical Storm,Dennis,35,1999-09-01T15:00:00Z,CAPE HATTERAS NC,58,0,0,0,58
Tropical Storm,Dennis,35,1999-09-01T15:00:00Z,GULF 29N 87W,0,0,0,4,4
Tropical Storm,Dennis,35,1999-09-01T15:00:00Z,NORFOLK VA,13,2,2,1,18
Tropical Storm,Dennis,35,1999-09-01T15:00:00Z,GULF 28N 89W,0,0,0,2,2
Tropical Storm,Dennis,35,1999-09-01T15:00:00Z,OCEAN CITY MD,2,3,3,2,10
Tropical Storm,Dennis,36,1999-09-01T21:00:00Z,35.2N  75.2W,99,0,0,0,99
Tropical Storm,Dennis,36,1999-09-01T21:00:00Z,OCEAN CITY MD,4,4,2,3,13
Tropical Storm,Dennis,36,1999-09-01T21:00:00Z,34.8N  75.8W,44,0,0,0,44
Tropical Storm,Dennis,36,1999-09-01T21:00:00Z,ATLANTIC CITY NJ,0,2,3,3,8
Tropical Storm,Dennis,36,1999-09-01T21:00:00Z,34.5N  76.5W,30,1,0,0,31
Tropical Storm,Dennis,36,1999-09-01T21:00:00Z,NEW YORK CITY NY,0,0,2,4,6
Tropical Storm,Dennis,36,1999-09-01T21:00:00Z,MUCF 221N 805W,0,0,0,2,2
Tropical Storm,Dennis,36,1999-09-01T21:00:00Z,MONTAUK POINT NY,0,0,1,3,4
Tropical Storm,Dennis,36,1999-09-01T21:00:00Z,MUHA 230N 824W,0,0,0,2,2
Tropical Storm,Dennis,36,1999-09-01T21:00:00Z,PROVIDENCE RI,0,0,1,2,3
Tropical Storm,Dennis,36,1999-09-01T21:00:00Z,MYEG 235N 758W,0,0,0,2,2
Tropical Storm,Dennis,36,1999-09-01T21:00:00Z,NANTUCKET MA,0,0,0,3,3
Tropical Storm,Dennis,36,1999-09-01T21:00:00Z,MYAK 241N 776W,0,0,0,3,3
Tropical Storm,Dennis,36,1999-09-01T21:00:00Z,HYANNIS MA,0,0,0,3,3
Tropical Storm,Dennis,36,1999-09-01T21:00:00Z,MYNN 251N 775W,0,0,0,4,4
Tropical Storm,Dennis,36,1999-09-01T21:00:00Z,BOSTON MA,0,0,0,2,2
Tropical Storm,Dennis,36,1999-09-01T21:00:00Z,MYGF 266N 787W,0,0,1,5,6
Tropical Storm,Dennis,36,1999-09-01T21:00:00Z,KEY WEST FL,0,0,0,3,3
Tropical Storm,Dennis,36,1999-09-01T21:00:00Z,MARATHON FL,0,0,0,4,4
Tropical Storm,Dennis,36,1999-09-01T21:00:00Z,MARCO ISLAND FL,0,0,1,4,5
Tropical Storm,Dennis,36,1999-09-01T21:00:00Z,MIAMI FL,0,0,1,4,5
Tropical Storm,Dennis,36,1999-09-01T21:00:00Z,FT MYERS FL,0,0,1,4,5
Tropical Storm,Dennis,36,1999-09-01T21:00:00Z,W PALM BEACH FL,0,0,1,5,6
Tropical Storm,Dennis,36,1999-09-01T21:00:00Z,VENICE FL,0,0,1,5,6
Tropical Storm,Dennis,36,1999-09-01T21:00:00Z,FT PIERCE FL,0,0,2,5,7
Tropical Storm,Dennis,36,1999-09-01T21:00:00Z,TAMPA FL,0,0,1,5,6
Tropical Storm,Dennis,36,1999-09-01T21:00:00Z,COCOA BEACH FL,0,0,3,5,8
Tropical Storm,Dennis,36,1999-09-01T21:00:00Z,CEDAR KEY FL,0,0,2,5,7
Tropical Storm,Dennis,36,1999-09-01T21:00:00Z,DAYTONA BEACH FL,0,0,4,5,9
Tropical Storm,Dennis,36,1999-09-01T21:00:00Z,ST MARKS FL,0,0,1,5,6
Tropical Storm,Dennis,36,1999-09-01T21:00:00Z,JACKSONVILLE FL,0,1,4,4,9
Tropical Storm,Dennis,36,1999-09-01T21:00:00Z,APALACHICOLA FL,0,0,1,4,5
Tropical Storm,Dennis,36,1999-09-01T21:00:00Z,SAVANNAH GA,0,3,4,4,11
Tropical Storm,Dennis,36,1999-09-01T21:00:00Z,PANAMA CITY FL,0,0,0,4,4
Tropical Storm,Dennis,36,1999-09-01T21:00:00Z,CHARLESTON SC,0,7,4,3,14
Tropical Storm,Dennis,36,1999-09-01T21:00:00Z,PENSACOLA FL,0,0,0,3,3
Tropical Storm,Dennis,36,1999-09-01T21:00:00Z,MYRTLE BEACH SC,3,10,3,1,17
Tropical Storm,Dennis,36,1999-09-01T21:00:00Z,MOBILE AL,0,0,0,2,2
Tropical Storm,Dennis,36,1999-09-01T21:00:00Z,WILMINGTON NC,15,5,1,1,22
Tropical Storm,Dennis,36,1999-09-01T21:00:00Z,GULFPORT MS,0,0,0,2,2
Tropical Storm,Dennis,36,1999-09-01T21:00:00Z,MOREHEAD CITY NC,30,1,0,0,31
Tropical Storm,Dennis,36,1999-09-01T21:00:00Z,GULF 29N 85W,0,0,0,5,5
Tropical Storm,Dennis,36,1999-09-01T21:00:00Z,CAPE HATTERAS NC,61,0,0,0,61
Tropical Storm,Dennis,36,1999-09-01T21:00:00Z,GULF 29N 87W,0,0,0,3,3
Tropical Storm,Dennis,36,1999-09-01T21:00:00Z,NORFOLK VA,21,1,1,0,23
Tropical Storm,Dennis,37,1999-09-02T03:00:00Z,35.1N  75.0W,63,0,0,0,63
Tropical Storm,Dennis,37,1999-09-02T03:00:00Z,NEW YORK CITY NY,0,1,2,3,6
Tropical Storm,Dennis,37,1999-09-02T03:00:00Z,34.9N  75.7W,46,0,0,0,46
Tropical Storm,Dennis,37,1999-09-02T03:00:00Z,MONTAUK POINT NY,0,0,1,3,4
Tropical Storm,Dennis,37,1999-09-02T03:00:00Z,34.5N  76.5W,30,1,0,0,31
Tropical Storm,Dennis,37,1999-09-02T03:00:00Z,PROVIDENCE RI,0,0,1,2,3
Tropical Storm,Dennis,37,1999-09-02T03:00:00Z,MUHA 230N 824W,0,0,0,2,2
Tropical Storm,Dennis,37,1999-09-02T03:00:00Z,NANTUCKET MA,0,0,1,2,3
Tropical Storm,Dennis,37,1999-09-02T03:00:00Z,MYAK 241N 776W,0,0,0,2,2
Tropical Storm,Dennis,37,1999-09-02T03:00:00Z,HYANNIS MA,0,0,0,3,3
Tropical Storm,Dennis,37,1999-09-02T03:00:00Z,MYNN 251N 775W,0,0,0,3,3
Tropical Storm,Dennis,37,1999-09-02T03:00:00Z,BOSTON MA,0,0,0,2,2
Tropical Storm,Dennis,37,1999-09-02T03:00:00Z,MYGF 266N 787W,0,0,1,4,5
Tropical Storm,Dennis,37,1999-09-02T03:00:00Z,KEY WEST FL,0,0,0,3,3
Tropical Storm,Dennis,37,1999-09-02T03:00:00Z,MARATHON FL,0,0,0,3,3
Tropical Storm,Dennis,37,1999-09-02T03:00:00Z,MARCO ISLAND FL,0,0,0,4,4
Tropical Storm,Dennis,37,1999-09-02T03:00:00Z,MIAMI FL,0,0,0,4,4
Tropical Storm,Dennis,37,1999-09-02T03:00:00Z,FT MYERS FL,0,0,1,4,5
Tropical Storm,Dennis,37,1999-09-02T03:00:00Z,W PALM BEACH FL,0,0,1,4,5
Tropical Storm,Dennis,37,1999-09-02T03:00:00Z,VENICE FL,0,0,1,4,5
Tropical Storm,Dennis,37,1999-09-02T03:00:00Z,FT PIERCE FL,0,0,1,5,6
Tropical Storm,Dennis,37,1999-09-02T03:00:00Z,TAMPA FL,0,0,1,5,6
Tropical Storm,Dennis,37,1999-09-02T03:00:00Z,COCOA BEACH FL,0,0,2,5,7
Tropical Storm,Dennis,37,1999-09-02T03:00:00Z,CEDAR KEY FL,0,0,2,5,7
Tropical Storm,Dennis,37,1999-09-02T03:00:00Z,DAYTONA BEACH FL,0,0,3,5,8
Tropical Storm,Dennis,37,1999-09-02T03:00:00Z,ST MARKS FL,0,0,2,5,7
Tropical Storm,Dennis,37,1999-09-02T03:00:00Z,JACKSONVILLE FL,0,1,4,5,10
Tropical Storm,Dennis,37,1999-09-02T03:00:00Z,APALACHICOLA FL,0,0,1,5,6
Tropical Storm,Dennis,37,1999-09-02T03:00:00Z,SAVANNAH GA,0,3,5,4,12
Tropical Storm,Dennis,37,1999-09-02T03:00:00Z,PANAMA CITY FL,0,0,1,4,5
Tropical Storm,Dennis,37,1999-09-02T03:00:00Z,CHARLESTON SC,0,7,4,3,14
Tropical Storm,Dennis,37,1999-09-02T03:00:00Z,PENSACOLA FL,0,0,0,4,4
Tropical Storm,Dennis,37,1999-09-02T03:00:00Z,MYRTLE BEACH SC,4,9,2,2,17
Tropical Storm,Dennis,37,1999-09-02T03:00:00Z,MOBILE AL,0,0,0,3,3
Tropical Storm,Dennis,37,1999-09-02T03:00:00Z,WILMINGTON NC,14,5,1,1,21
Tropical Storm,Dennis,37,1999-09-02T03:00:00Z,GULFPORT MS,0,0,0,2,2
Tropical Storm,Dennis,37,1999-09-02T03:00:00Z,MOREHEAD CITY NC,29,1,0,0,30
Tropical Storm,Dennis,37,1999-09-02T03:00:00Z,BURAS LA,0,0,0,2,2
Tropical Storm,Dennis,37,1999-09-02T03:00:00Z,CAPE HATTERAS NC,47,1,0,0,48
Tropical Storm,Dennis,37,1999-09-02T03:00:00Z,NEW ORLEANS LA,0,0,0,2,2
Tropical Storm,Dennis,37,1999-09-02T03:00:00Z,NORFOLK VA,17,2,1,1,21
Tropical Storm,Dennis,37,1999-09-02T03:00:00Z,GULF 29N 85W,0,0,1,4,5
Tropical Storm,Dennis,37,1999-09-02T03:00:00Z,OCEAN CITY MD,3,5,3,2,13
Tropical Storm,Dennis,37,1999-09-02T03:00:00Z,GULF 29N 87W,0,0,0,4,4
Tropical Storm,Dennis,37,1999-09-02T03:00:00Z,ATLANTIC CITY NJ,0,3,3,3,9
Tropical Storm,Dennis,37,1999-09-02T03:00:00Z,GULF 28N 89W,0,0,0,2,2
Tropical Storm,Dennis,38,1999-09-02T09:00:00Z,35.0N  75.0W,55,0,0,0,55
Tropical Storm,Dennis,38,1999-09-02T09:00:00Z,CAPE HATTERAS NC,45,0,0,0,45
Tropical Storm,Dennis,38,1999-09-02T09:00:00Z,34.5N  75.5W,47,0,0,0,47
Tropical Storm,Dennis,38,1999-09-02T09:00:00Z,NORFOLK VA,13,2,1,1,17
Tropical Storm,Dennis,38,1999-09-02T09:00:00Z,34.0N  76.5W,31,1,0,0,32
Tropical Storm,Dennis,38,1999-09-02T09:00:00Z,OCEAN CITY MD,2,1,2,3,8
Tropical Storm,Dennis,38,1999-09-02T09:00:00Z,MYSM 241N 745W,0,0,0,2,2
Tropical Storm,Dennis,38,1999-09-02T09:00:00Z,ATLANTIC CITY NJ,0,0,1,3,4
Tropical Storm,Dennis,38,1999-09-02T09:00:00Z,MYEG 235N 758W,0,0,0,2,2
Tropical Storm,Dennis,38,1999-09-02T09:00:00Z,NEW YORK CITY NY,0,0,0,2,2
Tropical Storm,Dennis,38,1999-09-02T09:00:00Z,MYAK 241N 776W,0,0,0,2,2
Tropical Storm,Dennis,38,1999-09-02T09:00:00Z,KEY WEST FL,0,0,0,2,2
Tropical Storm,Dennis,38,1999-09-02T09:00:00Z,MYNN 251N 775W,0,0,0,3,3
Tropical Storm,Dennis,38,1999-09-02T09:00:00Z,MARCO ISLAND FL,0,0,0,3,3
Tropical Storm,Dennis,38,1999-09-02T09:00:00Z,MYGF 266N 787W,0,0,0,5,5
Tropical Storm,Dennis,38,1999-09-02T09:00:00Z,FT MYERS FL,0,0,0,3,3
Tropical Storm,Dennis,38,1999-09-02T09:00:00Z,MARATHON FL,0,0,0,2,2
Tropical Storm,Dennis,38,1999-09-02T09:00:00Z,VENICE FL,0,0,0,4,4
Tropical Storm,Dennis,38,1999-09-02T09:00:00Z,MIAMI FL,0,0,0,3,3
Tropical Storm,Dennis,38,1999-09-02T09:00:00Z,TAMPA FL,0,0,0,4,4
Tropical Storm,Dennis,38,1999-09-02T09:00:00Z,W PALM BEACH FL,0,0,0,4,4
Tropical Storm,Dennis,38,1999-09-02T09:00:00Z,CEDAR KEY FL,0,0,0,5,5
Tropical Storm,Dennis,38,1999-09-02T09:00:00Z,FT PIERCE FL,0,0,0,5,5
Tropical Storm,Dennis,38,1999-09-02T09:00:00Z,ST MARKS FL,0,0,1,4,5
Tropical Storm,Dennis,38,1999-09-02T09:00:00Z,COCOA BEACH FL,0,0,1,5,6
Tropical Storm,Dennis,38,1999-09-02T09:00:00Z,APALACHICOLA FL,0,0,0,4,4
Tropical Storm,Dennis,38,1999-09-02T09:00:00Z,DAYTONA BEACH FL,0,0,1,6,7
Tropical Storm,Dennis,38,1999-09-02T09:00:00Z,PANAMA CITY FL,0,0,0,4,4
Tropical Storm,Dennis,38,1999-09-02T09:00:00Z,JACKSONVILLE FL,0,0,3,5,8
Tropical Storm,Dennis,38,1999-09-02T09:00:00Z,PENSACOLA FL,0,0,0,3,3
Tropical Storm,Dennis,38,1999-09-02T09:00:00Z,SAVANNAH GA,0,2,5,5,12
Tropical Storm,Dennis,38,1999-09-02T09:00:00Z,MOBILE AL,0,0,0,2,2
Tropical Storm,Dennis,38,1999-09-02T09:00:00Z,CHARLESTON SC,1,7,4,3,15
Tropical Storm,Dennis,38,1999-09-02T09:00:00Z,GULFPORT MS,0,0,0,2,2
Tropical Storm,Dennis,38,1999-09-02T09:00:00Z,MYRTLE BEACH SC,7,8,3,1,19
Tropical Storm,Dennis,38,1999-09-02T09:00:00Z,GULF 29N 85W,0,0,0,4,4
Tropical Storm,Dennis,38,1999-09-02T09:00:00Z,WILMINGTON NC,18,4,1,1,24
Tropical Storm,Dennis,38,1999-09-02T09:00:00Z,GULF 29N 87W,0,0,0,2,2
Tropical Storm,Dennis,38,1999-09-02T09:00:00Z,MOREHEAD CITY NC,33,0,0,0,33
Tropical Storm,Dennis,39,1999-09-02T15:00:00Z,35.2N  74.4W,99,0,0,0,99
Tropical Storm,Dennis,39,1999-09-02T15:00:00Z,CAPE HATTERAS NC,39,0,0,0,39
Tropical Storm,Dennis,39,1999-09-02T15:00:00Z,34.9N  75.2W,47,0,0,0,47
Tropical Storm,Dennis,39,1999-09-02T15:00:00Z,NORFOLK VA,12,4,1,1,18
Tropical Storm,Dennis,39,1999-09-02T15:00:00Z,34.5N  76.0W,33,1,0,0,34
Tropical Storm,Dennis,39,1999-09-02T15:00:00Z,OCEAN CITY MD,2,3,2,3,10
Tropical Storm,Dennis,39,1999-09-02T15:00:00Z,MYSM 241N 745W,0,0,0,2,2
Tropical Storm,Dennis,39,1999-09-02T15:00:00Z,ATLANTIC CITY NJ,0,1,1,3,5
Tropical Storm,Dennis,39,1999-09-02T15:00:00Z,MYEG 235N 758W,0,0,0,2,2
Tropical Storm,Dennis,39,1999-09-02T15:00:00Z,NEW YORK CITY NY,0,0,0,3,3
Tropical Storm,Dennis,39,1999-09-02T15:00:00Z,MYAK 241N 776W,0,0,0,2,2
Tropical Storm,Dennis,39,1999-09-02T15:00:00Z,MONTAUK POINT NY,0,0,0,2,2
Tropical Storm,Dennis,39,1999-09-02T15:00:00Z,MYNN 251N 775W,0,0,0,3,3
Tropical Storm,Dennis,39,1999-09-02T15:00:00Z,KEY WEST FL,0,0,0,2,2
Tropical Storm,Dennis,39,1999-09-02T15:00:00Z,MYGF 266N 787W,0,0,0,4,4
Tropical Storm,Dennis,39,1999-09-02T15:00:00Z,MARCO ISLAND FL,0,0,0,3,3
Tropical Storm,Dennis,39,1999-09-02T15:00:00Z,MARATHON FL,0,0,0,2,2
Tropical Storm,Dennis,39,1999-09-02T15:00:00Z,FT MYERS FL,0,0,0,3,3
Tropical Storm,Dennis,39,1999-09-02T15:00:00Z,MIAMI FL,0,0,0,3,3
Tropical Storm,Dennis,39,1999-09-02T15:00:00Z,VENICE FL,0,0,0,3,3
Tropical Storm,Dennis,39,1999-09-02T15:00:00Z,W PALM BEACH FL,0,0,0,4,4
Tropical Storm,Dennis,39,1999-09-02T15:00:00Z,TAMPA FL,0,0,0,4,4
Tropical Storm,Dennis,39,1999-09-02T15:00:00Z,FT PIERCE FL,0,0,0,5,5
Tropical Storm,Dennis,39,1999-09-02T15:00:00Z,CEDAR KEY FL,0,0,0,5,5
Tropical Storm,Dennis,39,1999-09-02T15:00:00Z,COCOA BEACH FL,0,0,0,5,5
Tropical Storm,Dennis,39,1999-09-02T15:00:00Z,ST MARKS FL,0,0,0,5,5
Tropical Storm,Dennis,39,1999-09-02T15:00:00Z,DAYTONA BEACH FL,0,0,1,5,6
Tropical Storm,Dennis,39,1999-09-02T15:00:00Z,APALACHICOLA FL,0,0,0,4,4
Tropical Storm,Dennis,39,1999-09-02T15:00:00Z,JACKSONVILLE FL,0,0,2,5,7
Tropical Storm,Dennis,39,1999-09-02T15:00:00Z,PANAMA CITY FL,0,0,0,4,4
Tropical Storm,Dennis,39,1999-09-02T15:00:00Z,SAVANNAH GA,0,1,4,5,10
Tropical Storm,Dennis,39,1999-09-02T15:00:00Z,PENSACOLA FL,0,0,0,3,3
Tropical Storm,Dennis,39,1999-09-02T15:00:00Z,CHARLESTON SC,0,5,5,4,14
Tropical Storm,Dennis,39,1999-09-02T15:00:00Z,MOBILE AL,0,0,0,2,2
Tropical Storm,Dennis,39,1999-09-02T15:00:00Z,MYRTLE BEACH SC,3,9,3,2,17
Tropical Storm,Dennis,39,1999-09-02T15:00:00Z,GULFPORT MS,0,0,0,2,2
Tropical Storm,Dennis,39,1999-09-02T15:00:00Z,WILMINGTON NC,13,5,2,1,21
Tropical Storm,Dennis,39,1999-09-02T15:00:00Z,GULF 29N 85W,0,0,0,3,3
Tropical Storm,Dennis,39,1999-09-02T15:00:00Z,MOREHEAD CITY NC,27,1,0,1,29
Tropical Storm,Dennis,39,1999-09-02T15:00:00Z,GULF 29N 87W,0,0,0,2,2
Tropical Storm,Dennis,40,1999-09-02T21:00:00Z,34.4N  74.6W,99,0,0,0,99
Tropical Storm,Dennis,40,1999-09-02T21:00:00Z,CAPE HATTERAS NC,45,0,0,0,45
Tropical Storm,Dennis,40,1999-09-02T21:00:00Z,34.2N  75.1W,99,0,0,0,99
Tropical Storm,Dennis,40,1999-09-02T21:00:00Z,NORFOLK VA,7,5,2,2,16
Tropical Storm,Dennis,40,1999-09-02T21:00:00Z,34.0N  76.0W,39,0,0,0,39
Tropical Storm,Dennis,40,1999-09-02T21:00:00Z,OCEAN CITY MD,0,4,4,3,11
Tropical Storm,Dennis,40,1999-09-02T21:00:00Z,MUCF 221N 805W,0,0,0,2,2
Tropical Storm,Dennis,40,1999-09-02T21:00:00Z,ATLANTIC CITY NJ,0,1,3,3,7
Tropical Storm,Dennis,40,1999-09-02T21:00:00Z,MUHA 230N 824W,0,0,0,2,2
Tropical Storm,Dennis,40,1999-09-02T21:00:00Z,NEW YORK CITY NY,0,0,2,3,5
Tropical Storm,Dennis,40,1999-09-02T21:00:00Z,MYSM 241N 745W,0,0,0,3,3
Tropical Storm,Dennis,40,1999-09-02T21:00:00Z,MONTAUK POINT NY,0,0,0,3,3
Tropical Storm,Dennis,40,1999-09-02T21:00:00Z,MYEG 235N 758W,0,0,0,3,3
Tropical Storm,Dennis,40,1999-09-02T21:00:00Z,PROVIDENCE RI,0,0,0,3,3
Tropical Storm,Dennis,40,1999-09-02T21:00:00Z,MYAK 241N 776W,0,0,0,3,3
Tropical Storm,Dennis,40,1999-09-02T21:00:00Z,NANTUCKET MA,0,0,0,2,2
Tropical Storm,Dennis,40,1999-09-02T21:00:00Z,MYNN 251N 775W,0,0,1,3,4
Tropical Storm,Dennis,40,1999-09-02T21:00:00Z,HYANNIS MA,0,0,0,2,2
Tropical Storm,Dennis,40,1999-09-02T21:00:00Z,MYGF 266N 787W,0,0,2,4,6
Tropical Storm,Dennis,40,1999-09-02T21:00:00Z,BOSTON MA,0,0,0,2,2
Tropical Storm,Dennis,40,1999-09-02T21:00:00Z,MARATHON FL,0,0,0,3,3
Tropical Storm,Dennis,40,1999-09-02T21:00:00Z,KEY WEST FL,0,0,0,3,3
Tropical Storm,Dennis,40,1999-09-02T21:00:00Z,MIAMI FL,0,0,1,4,5
Tropical Storm,Dennis,40,1999-09-02T21:00:00Z,MARCO ISLAND FL,0,0,0,4,4
Tropical Storm,Dennis,40,1999-09-02T21:00:00Z,W PALM BEACH FL,0,0,1,5,6
Tropical Storm,Dennis,40,1999-09-02T21:00:00Z,FT MYERS FL,0,0,0,4,4
Tropical Storm,Dennis,40,1999-09-02T21:00:00Z,FT PIERCE FL,0,0,2,4,6
Tropical Storm,Dennis,40,1999-09-02T21:00:00Z,VENICE FL,0,0,0,4,4
Tropical Storm,Dennis,40,1999-09-02T21:00:00Z,COCOA BEACH FL,0,0,2,5,7
Tropical Storm,Dennis,40,1999-09-02T21:00:00Z,TAMPA FL,0,0,1,4,5
Tropical Storm,Dennis,40,1999-09-02T21:00:00Z,DAYTONA BEACH FL,0,0,2,5,7
Tropical Storm,Dennis,40,1999-09-02T21:00:00Z,CEDAR KEY FL,0,0,1,4,5
Tropical Storm,Dennis,40,1999-09-02T21:00:00Z,JACKSONVILLE FL,0,0,3,5,8
Tropical Storm,Dennis,40,1999-09-02T21:00:00Z,ST MARKS FL,0,0,0,4,4
Tropical Storm,Dennis,40,1999-09-02T21:00:00Z,SAVANNAH GA,0,1,4,5,10
Tropical Storm,Dennis,40,1999-09-02T21:00:00Z,APALACHICOLA FL,0,0,0,3,3
Tropical Storm,Dennis,40,1999-09-02T21:00:00Z,CHARLESTON SC,0,4,5,3,12
Tropical Storm,Dennis,40,1999-09-02T21:00:00Z,PANAMA CITY FL,0,0,0,3,3
Tropical Storm,Dennis,40,1999-09-02T21:00:00Z,MYRTLE BEACH SC,3,7,3,2,15
Tropical Storm,Dennis,40,1999-09-02T21:00:00Z,PENSACOLA FL,0,0,0,2,2
Tropical Storm,Dennis,40,1999-09-02T21:00:00Z,WILMINGTON NC,12,4,2,1,19
Tropical Storm,Dennis,40,1999-09-02T21:00:00Z,GULF 29N 85W,0,0,0,3,3
Tropical Storm,Dennis,40,1999-09-02T21:00:00Z,MOREHEAD CITY NC,26,1,0,0,27
Tropical Storm,Dennis,40,1999-09-02T21:00:00Z,GULF 29N 87W,0,0,0,2,2
Tropical Storm,Dennis,41,1999-09-03T03:00:00Z,33.5N  75.5W,59,0,0,0,59
Tropical Storm,Dennis,41,1999-09-03T03:00:00Z,NORFOLK VA,2,6,2,3,13
Tropical Storm,Dennis,41,1999-09-03T03:00:00Z,33.5N  76.3W,41,0,0,0,41
Tropical Storm,Dennis,41,1999-09-03T03:00:00Z,OCEAN CITY MD,0,2,2,4,8
Tropical Storm,Dennis,41,1999-09-03T03:00:00Z,33.5N  77.0W,30,0,0,1,31
Tropical Storm,Dennis,41,1999-09-03T03:00:00Z,ATLANTIC CITY NJ,0,0,2,4,6
Tropical Storm,Dennis,41,1999-09-03T03:00:00Z,MUCF 221N 805W,0,0,0,2,2
Tropical Storm,Dennis,41,1999-09-03T03:00:00Z,NEW YORK CITY NY,0,0,0,4,4
Tropical Storm,Dennis,41,1999-09-03T03:00:00Z,MUHA 230N 824W,0,0,0,2,2
Tropical Storm,Dennis,41,1999-09-03T03:00:00Z,MONTAUK POINT NY,0,0,0,3,3
Tropical Storm,Dennis,41,1999-09-03T03:00:00Z,MYSM 241N 745W,0,0,1,2,3
Tropical Storm,Dennis,41,1999-09-03T03:00:00Z,PROVIDENCE RI,0,0,0,2,2
Tropical Storm,Dennis,41,1999-09-03T03:00:00Z,MYEG 235N 758W,0,0,0,3,3
Tropical Storm,Dennis,41,1999-09-03T03:00:00Z,NANTUCKET MA,0,0,0,2,2
Tropical Storm,Dennis,41,1999-09-03T03:00:00Z,MYAK 241N 776W,0,0,1,3,4
Tropical Storm,Dennis,41,1999-09-03T03:00:00Z,HYANNIS MA,0,0,0,2,2
Tropical Storm,Dennis,41,1999-09-03T03:00:00Z,MYNN 251N 775W,0,0,2,3,5
Tropical Storm,Dennis,41,1999-09-03T03:00:00Z,BOSTON MA,0,0,0,2,2
Tropical Storm,Dennis,41,1999-09-03T03:00:00Z,MYGF 266N 787W,0,0,3,4,7
Tropical Storm,Dennis,41,1999-09-03T03:00:00Z,KEY WEST FL,0,0,0,3,3
Tropical Storm,Dennis,41,1999-09-03T03:00:00Z,MARATHON FL,0,0,0,3,3
Tropical Storm,Dennis,41,1999-09-03T03:00:00Z,MARCO ISLAND FL,0,0,1,3,4
Tropical Storm,Dennis,41,1999-09-03T03:00:00Z,MIAMI FL,0,0,1,4,5
Tropical Storm,Dennis,41,1999-09-03T03:00:00Z,FT MYERS FL,0,0,1,4,5
Tropical Storm,Dennis,41,1999-09-03T03:00:00Z,W PALM BEACH FL,0,0,2,4,6
Tropical Storm,Dennis,41,1999-09-03T03:00:00Z,VENICE FL,0,0,1,4,5
Tropical Storm,Dennis,41,1999-09-03T03:00:00Z,FT PIERCE FL,0,0,3,4,7
Tropical Storm,Dennis,41,1999-09-03T03:00:00Z,TAMPA FL,0,0,1,5,6
Tropical Storm,Dennis,41,1999-09-03T03:00:00Z,COCOA BEACH FL,0,0,3,5,8
Tropical Storm,Dennis,41,1999-09-03T03:00:00Z,CEDAR KEY FL,0,0,1,5,6
Tropical Storm,Dennis,41,1999-09-03T03:00:00Z,DAYTONA BEACH FL,0,1,3,5,9
Tropical Storm,Dennis,41,1999-09-03T03:00:00Z,ST MARKS FL,0,0,1,5,6
Tropical Storm,Dennis,41,1999-09-03T03:00:00Z,JACKSONVILLE FL,0,1,3,5,9
Tropical Storm,Dennis,41,1999-09-03T03:00:00Z,APALACHICOLA FL,0,0,0,4,4
Tropical Storm,Dennis,41,1999-09-03T03:00:00Z,SAVANNAH GA,0,3,4,4,11
Tropical Storm,Dennis,41,1999-09-03T03:00:00Z,PANAMA CITY FL,0,0,0,4,4
Tropical Storm,Dennis,41,1999-09-03T03:00:00Z,CHARLESTON SC,1,7,4,3,15
Tropical Storm,Dennis,41,1999-09-03T03:00:00Z,PENSACOLA FL,0,0,0,3,3
Tropical Storm,Dennis,41,1999-09-03T03:00:00Z,MYRTLE BEACH SC,6,8,2,2,18
Tropical Storm,Dennis,41,1999-09-03T03:00:00Z,MOBILE AL,0,0,0,2,2
Tropical Storm,Dennis,41,1999-09-03T03:00:00Z,WILMINGTON NC,15,4,1,1,21
Tropical Storm,Dennis,41,1999-09-03T03:00:00Z,GULF 29N 85W,0,0,0,4,4
Tropical Storm,Dennis,41,1999-09-03T03:00:00Z,MOREHEAD CITY NC,23,1,1,0,25
Tropical Storm,Dennis,41,1999-09-03T03:00:00Z,GULF 29N 87W,0,0,0,2,2
Tropical Storm,Dennis,41,1999-09-03T03:00:00Z,CAPE HATTERAS NC,21,1,0,1,23
Tropical Storm,Dennis,43,1999-09-03T15:00:00Z,32.9N  74.8W,99,0,0,0,99
Tropical Storm,Dennis,43,1999-09-03T15:00:00Z,CAPE HATTERAS NC,10,4,1,2,17
Tropical Storm,Dennis,43,1999-09-03T15:00:00Z,33.2N  75.6W,62,0,0,0,62
Tropical Storm,Dennis,43,1999-09-03T15:00:00Z,NORFOLK VA,0,4,4,3,11
Tropical Storm,Dennis,43,1999-09-03T15:00:00Z,34.0N  76.5W,22,2,0,1,25
Tropical Storm,Dennis,43,1999-09-03T15:00:00Z,OCEAN CITY MD,0,0,3,4,7
Tropical Storm,Dennis,43,1999-09-03T15:00:00Z,MYNN 251N 775W,0,0,0,2,2
Tropical Storm,Dennis,43,1999-09-03T15:00:00Z,ATLANTIC CITY NJ,0,0,1,4,5
Tropical Storm,Dennis,43,1999-09-03T15:00:00Z,MYGF 266N 787W,0,0,0,3,3
Tropical Storm,Dennis,43,1999-09-03T15:00:00Z,NEW YORK CITY NY,0,0,0,3,3
Tropical Storm,Dennis,43,1999-09-03T15:00:00Z,MIAMI FL,0,0,0,2,2
Tropical Storm,Dennis,43,1999-09-03T15:00:00Z,MONTAUK POINT NY,0,0,0,2,2
Tropical Storm,Dennis,43,1999-09-03T15:00:00Z,W PALM BEACH FL,0,0,0,2,2
Tropical Storm,Dennis,43,1999-09-03T15:00:00Z,FT MYERS FL,0,0,0,2,2
Tropical Storm,Dennis,43,1999-09-03T15:00:00Z,FT PIERCE FL,0,0,0,3,3
Tropical Storm,Dennis,43,1999-09-03T15:00:00Z,VENICE FL,0,0,0,2,2
Tropical Storm,Dennis,43,1999-09-03T15:00:00Z,COCOA BEACH FL,0,0,1,3,4
Tropical Storm,Dennis,43,1999-09-03T15:00:00Z,TAMPA FL,0,0,0,2,2
Tropical Storm,Dennis,43,1999-09-03T15:00:00Z,DAYTONA BEACH FL,0,0,1,4,5
Tropical Storm,Dennis,43,1999-09-03T15:00:00Z,CEDAR KEY FL,0,0,0,3,3
Tropical Storm,Dennis,43,1999-09-03T15:00:00Z,JACKSONVILLE FL,0,0,2,4,6
Tropical Storm,Dennis,43,1999-09-03T15:00:00Z,ST MARKS FL,0,0,0,3,3
Tropical Storm,Dennis,43,1999-09-03T15:00:00Z,SAVANNAH GA,0,2,4,4,10
Tropical Storm,Dennis,43,1999-09-03T15:00:00Z,APALACHICOLA FL,0,0,0,2,2
Tropical Storm,Dennis,43,1999-09-03T15:00:00Z,CHARLESTON SC,1,6,4,3,14
Tropical Storm,Dennis,43,1999-09-03T15:00:00Z,PANAMA CITY FL,0,0,0,2,2
Tropical Storm,Dennis,43,1999-09-03T15:00:00Z,MYRTLE BEACH SC,4,9,2,2,17
Tropical Storm,Dennis,43,1999-09-03T15:00:00Z,PENSACOLA FL,0,0,0,2,2
Tropical Storm,Dennis,43,1999-09-03T15:00:00Z,WILMINGTON NC,8,7,2,2,19
Tropical Storm,Dennis,43,1999-09-03T15:00:00Z,GULF 29N 85W,0,0,0,2,2
Tropical Storm,Dennis,43,1999-09-03T15:00:00Z,MOREHEAD CITY NC,13,4,2,1,20
Tropical Storm,Dennis,44,1999-09-03T21:00:00Z,33.6N  75.1W,99,0,0,0,99
Tropical Storm,Dennis,44,1999-09-03T21:00:00Z,MONTAUK POINT NY,0,0,0,5,5
Tropical Storm,Dennis,44,1999-09-03T21:00:00Z,34.1N  75.8W,37,0,0,0,37
Tropical Storm,Dennis,44,1999-09-03T21:00:00Z,PROVIDENCE RI,0,0,0,4,4
Tropical Storm,Dennis,44,1999-09-03T21:00:00Z,35.0N  76.5W,17,3,1,1,22
Tropical Storm,Dennis,44,1999-09-03T21:00:00Z,NANTUCKET MA,0,0,0,4,4
Tropical Storm,Dennis,44,1999-09-03T21:00:00Z,FT PIERCE FL,0,0,0,2,2
Tropical Storm,Dennis,44,1999-09-03T21:00:00Z,HYANNIS MA,0,0,0,3,3
Tropical Storm,Dennis,44,1999-09-03T21:00:00Z,COCOA BEACH FL,0,0,1,2,3
Tropical Storm,Dennis,44,1999-09-03T21:00:00Z,BOSTON MA,0,0,0,3,3
Tropical Storm,Dennis,44,1999-09-03T21:00:00Z,DAYTONA BEACH FL,0,0,2,2,4
Tropical Storm,Dennis,44,1999-09-03T21:00:00Z,PORTLAND ME,0,0,0,2,2
Tropical Storm,Dennis,44,1999-09-03T21:00:00Z,JACKSONVILLE FL,0,1,3,3,7
Tropical Storm,Dennis,44,1999-09-03T21:00:00Z,TAMPA FL,0,0,0,2,2
Tropical Storm,Dennis,44,1999-09-03T21:00:00Z,SAVANNAH GA,0,4,4,3,11
Tropical Storm,Dennis,44,1999-09-03T21:00:00Z,CEDAR KEY FL,0,0,1,2,3
Tropical Storm,Dennis,44,1999-09-03T21:00:00Z,CHARLESTON SC,1,8,4,2,15
Tropical Storm,Dennis,44,1999-09-03T21:00:00Z,ST MARKS FL,0,0,1,3,4
Tropical Storm,Dennis,44,1999-09-03T21:00:00Z,MYRTLE BEACH SC,6,9,2,1,18
Tropical Storm,Dennis,44,1999-09-03T21:00:00Z,APALACHICOLA FL,0,0,1,2,3
Tropical Storm,Dennis,44,1999-09-03T21:00:00Z,WILMINGTON NC,13,5,2,1,21
Tropical Storm,Dennis,44,1999-09-03T21:00:00Z,PANAMA CITY FL,0,0,1,2,3
Tropical Storm,Dennis,44,1999-09-03T21:00:00Z,MOREHEAD CITY NC,20,2,1,0,23
Tropical Storm,Dennis,44,1999-09-03T21:00:00Z,PENSACOLA FL,0,0,0,3,3
Tropical Storm,Dennis,44,1999-09-03T21:00:00Z,CAPE HATTERAS NC,17,2,1,1,21
Tropical Storm,Dennis,44,1999-09-03T21:00:00Z,MOBILE AL,0,0,0,2,2
Tropical Storm,Dennis,44,1999-09-03T21:00:00Z,NORFOLK VA,1,6,4,3,14
Tropical Storm,Dennis,44,1999-09-03T21:00:00Z,GULFPORT MS,0,0,0,2,2
Tropical Storm,Dennis,44,1999-09-03T21:00:00Z,OCEAN CITY MD,0,1,4,5,10
Tropical Storm,Dennis,44,1999-09-03T21:00:00Z,GULF 29N 85W,0,0,0,2,2
Tropical Storm,Dennis,44,1999-09-03T21:00:00Z,ATLANTIC CITY NJ,0,0,2,6,8
Tropical Storm,Dennis,44,1999-09-03T21:00:00Z,GULF 29N 87W,0,0,0,2,2
Tropical Storm,Dennis,44,1999-09-03T21:00:00Z,NEW YORK CITY NY,0,0,1,5,6
Tropical Storm,Dennis,45,1999-09-04T03:00:00Z,34.7N  76.0W,46,0,0,0,46
Tropical Storm,Dennis,45,1999-09-04T03:00:00Z,PROVIDENCE RI,0,0,1,5,6
Tropical Storm,Dennis,45,1999-09-04T03:00:00Z,36.3N  77.5W,15,8,0,1,24
Tropical Storm,Dennis,45,1999-09-04T03:00:00Z,NANTUCKET MA,0,0,1,4,5
Tropical Storm,Dennis,45,1999-09-04T03:00:00Z,37.5N  78.5W,1,12,3,2,18
Tropical Storm,Dennis,45,1999-09-04T03:00:00Z,HYANNIS MA,0,0,1,4,5
Tropical Storm,Dennis,45,1999-09-04T03:00:00Z,DAYTONA BEACH FL,0,0,1,1,2
Tropical Storm,Dennis,45,1999-09-04T03:00:00Z,BOSTON MA,0,0,1,4,5
Tropical Storm,Dennis,45,1999-09-04T03:00:00Z,JACKSONVILLE FL,0,1,1,3,5
Tropical Storm,Dennis,45,1999-09-04T03:00:00Z,PORTLAND ME,0,0,0,3,3
Tropical Storm,Dennis,45,1999-09-04T03:00:00Z,SAVANNAH GA,0,4,3,2,9
Tropical Storm,Dennis,45,1999-09-04T03:00:00Z,BAR HARBOR ME,0,0,0,2,2
Tropical Storm,Dennis,45,1999-09-04T03:00:00Z,CHARLESTON SC,1,10,1,2,14
Tropical Storm,Dennis,45,1999-09-04T03:00:00Z,YARMOUTH NS,0,0,0,2,2
Tropical Storm,Dennis,45,1999-09-04T03:00:00Z,MYRTLE BEACH SC,12,7,1,0,20
Tropical Storm,Dennis,45,1999-09-04T03:00:00Z,CEDAR KEY FL,0,0,0,2,2
Tropical Storm,Dennis,45,1999-09-04T03:00:00Z,WILMINGTON NC,27,1,1,0,29
Tropical Storm,Dennis,45,1999-09-04T03:00:00Z,ST MARKS FL,0,0,1,2,3
Tropical Storm,Dennis,45,1999-09-04T03:00:00Z,MOREHEAD CITY NC,40,0,0,0,40
Tropical Storm,Dennis,45,1999-09-04T03:00:00Z,APALACHICOLA FL,0,0,0,3,3
Tropical Storm,Dennis,45,1999-09-04T03:00:00Z,CAPE HATTERAS NC,35,0,0,0,35
Tropical Storm,Dennis,45,1999-09-04T03:00:00Z,PANAMA CITY FL,0,0,1,2,3
Tropical Storm,Dennis,45,1999-09-04T03:00:00Z,NORFOLK VA,9,10,1,1,21
Tropical Storm,Dennis,45,1999-09-04T03:00:00Z,PENSACOLA FL,0,0,0,3,3
Tropical Storm,Dennis,45,1999-09-04T03:00:00Z,OCEAN CITY MD,0,8,4,2,14
Tropical Storm,Dennis,45,1999-09-04T03:00:00Z,MOBILE AL,0,0,0,2,2
Tropical Storm,Dennis,45,1999-09-04T03:00:00Z,ATLANTIC CITY NJ,0,3,4,4,11
Tropical Storm,Dennis,45,1999-09-04T03:00:00Z,GULFPORT MS,0,0,0,2,2
Tropical Storm,Dennis,45,1999-09-04T03:00:00Z,NEW YORK CITY NY,0,1,3,5,9
Tropical Storm,Dennis,45,1999-09-04T03:00:00Z,GULF 29N 85W,0,0,0,2,2
Tropical Storm,Dennis,45,1999-09-04T03:00:00Z,MONTAUK POINT NY,0,0,2,5,7
Tropical Storm,Dennis,46,1999-09-04T09:00:00Z,35.0N  76.5W,46,0,0,0,46
Tropical Storm,Dennis,46,1999-09-04T09:00:00Z,ATLANTIC CITY NJ,0,2,5,4,11
Tropical Storm,Dennis,46,1999-09-04T09:00:00Z,36.0N  77.0W,26,1,1,0,28
Tropical Storm,Dennis,46,1999-09-04T09:00:00Z,NEW YORK CITY NY,0,0,4,5,9
Tropical Storm,Dennis,46,1999-09-04T09:00:00Z,37.5N  77.5W,5,8,3,2,18
Tropical Storm,Dennis,46,1999-09-04T09:00:00Z,MONTAUK POINT NY,0,0,2,5,7
Tropical Storm,Dennis,46,1999-09-04T09:00:00Z,JACKSONVILLE FL,0,0,1,1,2
Tropical Storm,Dennis,46,1999-09-04T09:00:00Z,PROVIDENCE RI,0,0,1,5,6
Tropical Storm,Dennis,46,1999-09-04T09:00:00Z,SAVANNAH GA,0,2,2,2,6
Tropical Storm,Dennis,46,1999-09-04T09:00:00Z,NANTUCKET MA,0,0,1,4,5
Tropical Storm,Dennis,46,1999-09-04T09:00:00Z,CHARLESTON SC,3,5,2,1,11
Tropical Storm,Dennis,46,1999-09-04T09:00:00Z,HYANNIS MA,0,0,1,4,5
Tropical Storm,Dennis,46,1999-09-04T09:00:00Z,MYRTLE BEACH SC,15,3,0,1,19
Tropical Storm,Dennis,46,1999-09-04T09:00:00Z,BOSTON MA,0,0,0,5,5
Tropical Storm,Dennis,46,1999-09-04T09:00:00Z,WILMINGTON NC,31,0,0,0,31
Tropical Storm,Dennis,46,1999-09-04T09:00:00Z,PORTLAND ME,0,0,0,3,3
Tropical Storm,Dennis,46,1999-09-04T09:00:00Z,MOREHEAD CITY NC,48,0,0,0,48
Tropical Storm,Dennis,46,1999-09-04T09:00:00Z,BAR HARBOR ME,0,0,0,2,2
Tropical Storm,Dennis,46,1999-09-04T09:00:00Z,CAPE HATTERAS NC,40,0,0,0,40
Tropical Storm,Dennis,46,1999-09-04T09:00:00Z,YARMOUTH NS,0,0,0,2,2
Tropical Storm,Dennis,46,1999-09-04T09:00:00Z,NORFOLK VA,13,4,2,1,20
Tropical Storm,Dennis,46,1999-09-04T09:00:00Z,ST MARKS FL,0,0,0,2,2
Tropical Storm,Dennis,46,1999-09-04T09:00:00Z,OCEAN CITY MD,1,6,4,3,14
Tropical Storm,Dennis,48,1999-09-04T21:00:00Z,37.7N  77.8W,46,1,0,0,47
Tropical Storm,Dennis,48,1999-09-04T21:00:00Z,HYANNIS MA,0,0,3,6,9
Tropical Storm,Dennis,48,1999-09-04T21:00:00Z,39.5N  77.8W,18,6,0,1,25
Tropical Storm,Dennis,48,1999-09-04T21:00:00Z,BOSTON MA,0,0,4,6,10
Tropical Storm,Dennis,48,1999-09-04T21:00:00Z,42.0N  77.0W,0,6,8,2,16
Tropical Storm,Dennis,48,1999-09-04T21:00:00Z,PORTLAND ME,0,0,2,7,9
Tropical Storm,Dennis,48,1999-09-04T21:00:00Z,MYRTLE BEACH SC,8,1,0,1,10
Tropical Storm,Dennis,48,1999-09-04T21:00:00Z,BAR HARBOR ME,0,0,1,7,8
Tropical Storm,Dennis,48,1999-09-04T21:00:00Z,WILMINGTON NC,39,0,0,0,39
Tropical Storm,Dennis,48,1999-09-04T21:00:00Z,EASTPORT ME,0,0,0,7,7
Tropical Storm,Dennis,48,1999-09-04T21:00:00Z,MOREHEAD CITY NC,99,0,0,0,99
Tropical Storm,Dennis,48,1999-09-04T21:00:00Z,ST JOHN NB,0,0,0,6,6
Tropical Storm,Dennis,48,1999-09-04T21:00:00Z,CAPE HATTERAS NC,99,0,0,0,99
Tropical Storm,Dennis,48,1999-09-04T21:00:00Z,MONCTON NB,0,0,0,5,5
Tropical Storm,Dennis,48,1999-09-04T21:00:00Z,NORFOLK VA,45,0,0,0,45
Tropical Storm,Dennis,48,1999-09-04T21:00:00Z,YARMOUTH NS,0,0,0,6,6
Tropical Storm,Dennis,48,1999-09-04T21:00:00Z,OCEAN CITY MD,10,5,2,0,17
Tropical Storm,Dennis,48,1999-09-04T21:00:00Z,HALIFAX NS,0,0,0,4,4
Tropical Storm,Dennis,48,1999-09-04T21:00:00Z,ATLANTIC CITY NJ,2,9,3,2,16
Tropical Storm,Dennis,48,1999-09-04T21:00:00Z,SABLE ISLAND NS,0,0,0,2,2
Tropical Storm,Dennis,48,1999-09-04T21:00:00Z,NEW YORK CITY NY,0,5,7,2,14
Tropical Storm,Dennis,48,1999-09-04T21:00:00Z,SYDNEY NS,0,0,0,2,2
Tropical Storm,Dennis,48,1999-09-04T21:00:00Z,MONTAUK POINT NY,0,1,6,4,11
Tropical Storm,Dennis,48,1999-09-04T21:00:00Z,EDDY POINT NS,0,0,0,3,3
Tropical Storm,Dennis,48,1999-09-04T21:00:00Z,PROVIDENCE RI,0,0,5,5,10
Tropical Storm,Dennis,48,1999-09-04T21:00:00Z,PTX BASQUES NFLD,0,0,0,2,2
Tropical Storm,Dennis,48,1999-09-04T21:00:00Z,NANTUCKET MA,0,0,3,6,9
Tropical Depression,Dennis,51,1999-09-05T15:00:00Z,38.5N  80.9W,42,0,0,0,42
Tropical Depression,Dennis,51,1999-09-05T15:00:00Z,NEW YORK CITY NY,0,1,6,0,7
Tropical Depression,Dennis,51,1999-09-05T15:00:00Z,40.7N  79.7W,4,18,1,0,23
Tropical Depression,Dennis,51,1999-09-05T15:00:00Z,MONTAUK POINT NY,0,0,4,0,4
Tropical Depression,Dennis,51,1999-09-05T15:00:00Z,43.5N  77.0W,0,2,12,0,14
Tropical Depression,Dennis,51,1999-09-05T15:00:00Z,PROVIDENCE RI,0,0,3,0,3
Tropical Depression,Dennis,51,1999-09-05T15:00:00Z,NORFOLK VA,0,2,1,0,3
Tropical Depression,Dennis,51,1999-09-05T15:00:00Z,HYANNIS MA,0,0,2,0,2
Tropical Depression,Dennis,51,1999-09-05T15:00:00Z,OCEAN CITY MD,0,1,4,0,5
Tropical Depression,Dennis,51,1999-09-05T15:00:00Z,BOSTON MA,0,0,3,0,3
Tropical Depression,Dennis,51,1999-09-05T15:00:00Z,ATLANTIC CITY NJ,0,1,6,0,7
Tropical Depression,Dennis,51,1999-09-05T15:00:00Z,PORTLAND ME,0,0,2,0,2
Tropical Storm,Emily,1,1999-08-24T21:00:00Z,12.7N  55.7W,46,0,0,0,46
Tropical Storm,Emily,1,1999-08-24T21:00:00Z,TFFR 163N 615W,0,0,6,11,17
Tropical Storm,Emily,1,1999-08-24T21:00:00Z,13.5N  57.0W,22,4,1,0,27
Tropical Storm,Emily,1,1999-08-24T21:00:00Z,TAPA 171N 618W,0,0,3,12,15
Tropical Storm,Emily,1,1999-08-24T21:00:00Z,14.0N  58.5W,3,14,3,3,23
Tropical Storm,Emily,1,1999-08-24T21:00:00Z,TKPK 173N 627W,0,0,1,13,14
Tropical Storm,Emily,1,1999-08-24T21:00:00Z,SVMG 110N 640W,0,0,1,6,7
Tropical Storm,Emily,1,1999-08-24T21:00:00Z,TNCM 181N 631W,0,0,0,12,12
Tropical Storm,Emily,1,1999-08-24T21:00:00Z,TTPP 106N 614W,0,1,5,5,11
Tropical Storm,Emily,1,1999-08-24T21:00:00Z,TISX 177N 648W,0,0,0,9,9
Tropical Storm,Emily,1,1999-08-24T21:00:00Z,TTPT 112N 608W,0,2,7,5,14
Tropical Storm,Emily,1,1999-08-24T21:00:00Z,TIST 183N 650W,0,0,0,8,8
Tropical Storm,Emily,1,1999-08-24T21:00:00Z,TGPY 120N 618W,0,1,6,7,14
Tropical Storm,Emily,1,1999-08-24T21:00:00Z,TJPS 180N 666W,0,0,0,4,4
Tropical Storm,Emily,1,1999-08-24T21:00:00Z,TBPB 131N 595W,1,10,7,3,21
Tropical Storm,Emily,1,1999-08-24T21:00:00Z,TJSJ 184N 661W,0,0,0,5,5
Tropical Storm,Emily,1,1999-08-24T21:00:00Z,TVSV 131N 612W,0,2,9,6,17
Tropical Storm,Emily,1,1999-08-24T21:00:00Z,ST CROIX VI,0,0,0,9,9
Tropical Storm,Emily,1,1999-08-24T21:00:00Z,TLPL 138N 610W,0,2,10,6,18
Tropical Storm,Emily,1,1999-08-24T21:00:00Z,ST THOMAS VI,0,0,0,8,8
Tropical Storm,Emily,1,1999-08-24T21:00:00Z,TFFF 146N 610W,0,2,9,7,18
Tropical Storm,Emily,1,1999-08-24T21:00:00Z,SAN JUAN PR,0,0,0,5,5
Tropical Storm,Emily,1,1999-08-24T21:00:00Z,TDPR 153N 614W,0,1,7,9,17
Tropical Storm,Emily,1,1999-08-24T21:00:00Z,PONCE PR,0,0,0,4,4
Tropical Storm,Emily,2,1999-08-25T03:00:00Z,14.0N  55.5W,57,0,0,0,57
Tropical Storm,Emily,2,1999-08-25T03:00:00Z,TFFR 163N 615W,0,3,7,7,17
Tropical Storm,Emily,2,1999-08-25T03:00:00Z,14.8N  56.8W,34,1,0,0,35
Tropical Storm,Emily,2,1999-08-25T03:00:00Z,TAPA 171N 618W,0,1,8,7,16
Tropical Storm,Emily,2,1999-08-25T03:00:00Z,15.5N  58.0W,10,12,2,1,25
Tropical Storm,Emily,2,1999-08-25T03:00:00Z,TKPK 173N 627W,0,0,5,9,14
Tropical Storm,Emily,2,1999-08-25T03:00:00Z,SVMG 110N 640W,0,0,1,3,4
Tropical Storm,Emily,2,1999-08-25T03:00:00Z,TNCM 181N 631W,0,0,3,10,13
Tropical Storm,Emily,2,1999-08-25T03:00:00Z,TTPP 106N 614W,0,0,3,4,7
Tropical Storm,Emily,2,1999-08-25T03:00:00Z,TISX 177N 648W,0,0,1,8,9
Tropical Storm,Emily,2,1999-08-25T03:00:00Z,TTPT 112N 608W,0,1,4,4,9
Tropical Storm,Emily,2,1999-08-25T03:00:00Z,TIST 183N 650W,0,0,1,7,8
Tropical Storm,Emily,2,1999-08-25T03:00:00Z,TGPY 120N 618W,0,1,4,5,10
Tropical Storm,Emily,2,1999-08-25T03:00:00Z,TJPS 180N 666W,0,0,0,5,5
Tropical Storm,Emily,2,1999-08-25T03:00:00Z,TBPB 131N 595W,0,10,4,3,17
Tropical Storm,Emily,2,1999-08-25T03:00:00Z,TJSJ 184N 661W,0,0,0,6,6
Tropical Storm,Emily,2,1999-08-25T03:00:00Z,TVSV 131N 612W,0,3,6,5,14
Tropical Storm,Emily,2,1999-08-25T03:00:00Z,ST CROIX VI,0,0,1,8,9
Tropical Storm,Emily,2,1999-08-25T03:00:00Z,TLPL 138N 610W,0,4,7,5,16
Tropical Storm,Emily,2,1999-08-25T03:00:00Z,ST THOMAS VI,0,0,1,7,8
Tropical Storm,Emily,2,1999-08-25T03:00:00Z,TFFF 146N 610W,0,5,7,5,17
Tropical Storm,Emily,2,1999-08-25T03:00:00Z,SAN JUAN PR,0,0,0,6,6
Tropical Storm,Emily,2,1999-08-25T03:00:00Z,TDPR 153N 614W,0,3,8,6,17
Tropical Storm,Emily,2,1999-08-25T03:00:00Z,PONCE PR,0,0,0,5,5
Tropical Storm,Emily,3,1999-08-25T09:00:00Z,14.5N  56.0W,54,0,0,0,54
Tropical Storm,Emily,3,1999-08-25T09:00:00Z,TFFR 163N 615W,0,4,9,5,18
Tropical Storm,Emily,3,1999-08-25T09:00:00Z,15.4N  57.1W,34,0,1,0,35
Tropical Storm,Emily,3,1999-08-25T09:00:00Z,TAPA 171N 618W,0,2,9,7,18
Tropical Storm,Emily,3,1999-08-25T09:00:00Z,16.5N  58.5W,6,14,2,2,24
Tropical Storm,Emily,3,1999-08-25T09:00:00Z,TKPK 173N 627W,0,1,6,9,16
Tropical Storm,Emily,3,1999-08-25T09:00:00Z,SVMG 110N 640W,0,0,0,2,2
Tropical Storm,Emily,3,1999-08-25T09:00:00Z,TNCM 181N 631W,0,0,5,10,15
Tropical Storm,Emily,3,1999-08-25T09:00:00Z,TTPP 106N 614W,0,0,1,2,3
Tropical Storm,Emily,3,1999-08-25T09:00:00Z,TISX 177N 648W,0,0,1,9,10
Tropical Storm,Emily,3,1999-08-25T09:00:00Z,TTPT 112N 608W,0,0,3,2,5
Tropical Storm,Emily,3,1999-08-25T09:00:00Z,TIST 183N 650W,0,0,1,9,10
Tropical Storm,Emily,3,1999-08-25T09:00:00Z,TGPY 120N 618W,0,0,3,4,7
Tropical Storm,Emily,3,1999-08-25T09:00:00Z,TJPS 180N 666W,0,0,0,5,5
Tropical Storm,Emily,3,1999-08-25T09:00:00Z,TBPB 131N 595W,0,8,4,2,14
Tropical Storm,Emily,3,1999-08-25T09:00:00Z,TJSJ 184N 661W,0,0,0,7,7
Tropical Storm,Emily,3,1999-08-25T09:00:00Z,TVSV 131N 612W,0,2,5,4,11
Tropical Storm,Emily,3,1999-08-25T09:00:00Z,ST CROIX VI,0,0,1,9,10
Tropical Storm,Emily,3,1999-08-25T09:00:00Z,TLPL 138N 610W,0,4,6,4,14
Tropical Storm,Emily,3,1999-08-25T09:00:00Z,ST THOMAS VI,0,0,1,9,10
Tropical Storm,Emily,3,1999-08-25T09:00:00Z,TFFF 146N 610W,0,5,7,4,16
Tropical Storm,Emily,3,1999-08-25T09:00:00Z,SAN JUAN PR,0,0,0,7,7
Tropical Storm,Emily,3,1999-08-25T09:00:00Z,TDPR 153N 614W,0,4,8,5,17
Tropical Storm,Emily,3,1999-08-25T09:00:00Z,PONCE PR,0,0,0,5,5
Tropical Storm,Emily,5,1999-08-25T21:00:00Z,14.8N  57.6W,60,0,0,0,60
Tropical Storm,Emily,5,1999-08-25T21:00:00Z,TNCM 181N 631W,0,3,11,5,19
Tropical Storm,Emily,5,1999-08-25T21:00:00Z,15.9N  59.2W,23,8,1,0,32
Tropical Storm,Emily,5,1999-08-25T21:00:00Z,TISX 177N 648W,0,0,7,9,16
Tropical Storm,Emily,5,1999-08-25T21:00:00Z,17.0N  61.0W,1,17,4,1,23
Tropical Storm,Emily,5,1999-08-25T21:00:00Z,TIST 183N 650W,0,0,6,10,16
Tropical Storm,Emily,5,1999-08-25T21:00:00Z,TTPT 112N 608W,0,1,1,0,2
Tropical Storm,Emily,5,1999-08-25T21:00:00Z,TJPS 180N 666W,0,0,1,12,13
Tropical Storm,Emily,5,1999-08-25T21:00:00Z,TGPY 120N 618W,0,1,2,1,4
Tropical Storm,Emily,5,1999-08-25T21:00:00Z,MDSD 185N 697W,0,0,0,6,6
Tropical Storm,Emily,5,1999-08-25T21:00:00Z,TBPB 131N 595W,3,11,1,0,15
Tropical Storm,Emily,5,1999-08-25T21:00:00Z,MDCB 176N 714W,0,0,0,3,3
Tropical Storm,Emily,5,1999-08-25T21:00:00Z,TVSV 131N 612W,0,5,4,1,10
Tropical Storm,Emily,5,1999-08-25T21:00:00Z,TJSJ 184N 661W,0,0,2,12,14
Tropical Storm,Emily,5,1999-08-25T21:00:00Z,TLPL 138N 610W,0,10,4,1,15
Tropical Storm,Emily,5,1999-08-25T21:00:00Z,MDPP 198N 707W,0,0,0,4,4
Tropical Storm,Emily,5,1999-08-25T21:00:00Z,TFFF 146N 610W,0,15,3,1,19
Tropical Storm,Emily,5,1999-08-25T21:00:00Z,MBJT 215N 712W,0,0,0,2,2
Tropical Storm,Emily,5,1999-08-25T21:00:00Z,TDPR 153N 614W,0,14,5,1,20
Tropical Storm,Emily,5,1999-08-25T21:00:00Z,ST CROIX VI,0,0,7,9,16
Tropical Storm,Emily,5,1999-08-25T21:00:00Z,TFFR 163N 615W,0,15,5,2,22
Tropical Storm,Emily,5,1999-08-25T21:00:00Z,ST THOMAS VI,0,0,6,10,16
Tropical Storm,Emily,5,1999-08-25T21:00:00Z,TAPA 171N 618W,0,12,7,2,21
Tropical Storm,Emily,5,1999-08-25T21:00:00Z,SAN JUAN PR,0,0,2,12,14
Tropical Storm,Emily,5,1999-08-25T21:00:00Z,TKPK 173N 627W,0,5,11,4,20
Tropical Storm,Emily,5,1999-08-25T21:00:00Z,PONCE PR,0,0,1,12,13
Tropical Storm,Emily,6,1999-08-26T03:00:00Z,15.3N  57.3W,65,0,0,0,65
Tropical Storm,Emily,6,1999-08-26T03:00:00Z,TNCM 181N 631W,0,4,10,5,19
Tropical Storm,Emily,6,1999-08-26T03:00:00Z,16.6N  58.8W,24,6,0,0,30
Tropical Storm,Emily,6,1999-08-26T03:00:00Z,TISX 177N 648W,0,0,7,8,15
Tropical Storm,Emily,6,1999-08-26T03:00:00Z,17.8N  60.5W,1,19,2,1,23
Tropical Storm,Emily,6,1999-08-26T03:00:00Z,TIST 183N 650W,0,0,6,10,16
Tropical Storm,Emily,6,1999-08-26T03:00:00Z,TTPT 112N 608W,0,0,1,1,2
Tropical Storm,Emily,6,1999-08-26T03:00:00Z,TJPS 180N 666W,0,0,1,11,12
Tropical Storm,Emily,6,1999-08-26T03:00:00Z,TGPY 120N 618W,0,0,2,2,4
Tropical Storm,Emily,6,1999-08-26T03:00:00Z,MDSD 185N 697W,0,0,0,5,5
Tropical Storm,Emily,6,1999-08-26T03:00:00Z,TBPB 131N 595W,1,6,2,0,9
Tropical Storm,Emily,6,1999-08-26T03:00:00Z,TJSJ 184N 661W,0,0,2,12,14
Tropical Storm,Emily,6,1999-08-26T03:00:00Z,TVSV 131N 612W,0,3,4,1,8
Tropical Storm,Emily,6,1999-08-26T03:00:00Z,MDPP 198N 707W,0,0,0,4,4
Tropical Storm,Emily,6,1999-08-26T03:00:00Z,TLPL 138N 610W,0,6,4,1,11
Tropical Storm,Emily,6,1999-08-26T03:00:00Z,MBJT 215N 712W,0,0,0,4,4
Tropical Storm,Emily,6,1999-08-26T03:00:00Z,TFFF 146N 610W,1,10,3,1,15
Tropical Storm,Emily,6,1999-08-26T03:00:00Z,ST CROIX VI,0,0,7,8,15
Tropical Storm,Emily,6,1999-08-26T03:00:00Z,TDPR 153N 614W,0,12,3,2,17
Tropical Storm,Emily,6,1999-08-26T03:00:00Z,ST THOMAS VI,0,0,6,10,16
Tropical Storm,Emily,6,1999-08-26T03:00:00Z,TFFR 163N 615W,0,14,4,1,19
Tropical Storm,Emily,6,1999-08-26T03:00:00Z,SAN JUAN PR,0,0,2,12,14
Tropical Storm,Emily,6,1999-08-26T03:00:00Z,TAPA 171N 618W,0,12,6,2,20
Tropical Storm,Emily,6,1999-08-26T03:00:00Z,PONCE PR,0,0,1,11,12
Tropical Storm,Emily,6,1999-08-26T03:00:00Z,TKPK 173N 627W,0,6,9,4,19
Tropical Storm,Emily,7,1999-08-26T09:00:00Z,16.4N  58.0W,54,0,0,0,54
Tropical Storm,Emily,7,1999-08-26T09:00:00Z,TISX 177N 648W,0,2,7,4,13
Tropical Storm,Emily,7,1999-08-26T09:00:00Z,18.0N  59.5W,23,6,1,0,30
Tropical Storm,Emily,7,1999-08-26T09:00:00Z,TIST 183N 650W,0,1,8,5,14
Tropical Storm,Emily,7,1999-08-26T09:00:00Z,19.5N  61.0W,1,18,2,1,22
Tropical Storm,Emily,7,1999-08-26T09:00:00Z,TJPS 180N 666W,0,0,4,6,10
Tropical Storm,Emily,7,1999-08-26T09:00:00Z,TBPB 131N 595W,3,3,1,0,7
Tropical Storm,Emily,7,1999-08-26T09:00:00Z,MDSD 185N 697W,0,0,0,4,4
Tropical Storm,Emily,7,1999-08-26T09:00:00Z,TVSV 131N 612W,0,2,2,0,4
Tropical Storm,Emily,7,1999-08-26T09:00:00Z,TJSJ 184N 661W,0,0,5,6,11
Tropical Storm,Emily,7,1999-08-26T09:00:00Z,TLPL 138N 610W,1,5,1,1,8
Tropical Storm,Emily,7,1999-08-26T09:00:00Z,MDPP 198N 707W,0,0,0,3,3
Tropical Storm,Emily,7,1999-08-26T09:00:00Z,TFFF 146N 610W,2,8,1,1,12
Tropical Storm,Emily,7,1999-08-26T09:00:00Z,MBJT 215N 712W,0,0,0,3,3
Tropical Storm,Emily,7,1999-08-26T09:00:00Z,TDPR 153N 614W,1,11,2,0,14
Tropical Storm,Emily,7,1999-08-26T09:00:00Z,ST CROIX VI,0,2,7,4,13
Tropical Storm,Emily,7,1999-08-26T09:00:00Z,TFFR 163N 615W,2,14,2,0,18
Tropical Storm,Emily,7,1999-08-26T09:00:00Z,ST THOMAS VI,0,1,8,5,14
Tropical Storm,Emily,7,1999-08-26T09:00:00Z,TAPA 171N 618W,1,16,2,0,19
Tropical Storm,Emily,7,1999-08-26T09:00:00Z,SAN JUAN PR,0,0,5,6,11
Tropical Storm,Emily,7,1999-08-26T09:00:00Z,TKPK 173N 627W,0,11,4,2,17
Tropical Storm,Emily,7,1999-08-26T09:00:00Z,PONCE PR,0,0,4,6,10
Tropical Storm,Emily,7,1999-08-26T09:00:00Z,TNCM 181N 631W,0,9,6,2,17
Tropical Storm,Emily,8,1999-08-26T15:00:00Z,17.5N  59.0W,59,0,0,0,59
Tropical Storm,Emily,8,1999-08-26T15:00:00Z,TJPS 180N 666W,0,0,4,6,10
Tropical Storm,Emily,8,1999-08-26T15:00:00Z,19.0N  60.5W,28,6,1,0,35
Tropical Storm,Emily,8,1999-08-26T15:00:00Z,MDSD 185N 697W,0,0,0,5,5
Tropical Storm,Emily,8,1999-08-26T15:00:00Z,20.5N  62.5W,0,19,4,1,24
Tropical Storm,Emily,8,1999-08-26T15:00:00Z,MDCB 176N 714W,0,0,0,2,2
Tropical Storm,Emily,8,1999-08-26T15:00:00Z,TLPL 138N 610W,0,1,0,1,2
Tropical Storm,Emily,8,1999-08-26T15:00:00Z,TJSJ 184N 661W,0,0,7,5,12
Tropical Storm,Emily,8,1999-08-26T15:00:00Z,TFFF 146N 610W,0,3,1,1,5
Tropical Storm,Emily,8,1999-08-26T15:00:00Z,MDPP 198N 707W,0,0,0,6,6
Tropical Storm,Emily,8,1999-08-26T15:00:00Z,TDPR 153N 614W,1,5,2,0,8
Tropical Storm,Emily,8,1999-08-26T15:00:00Z,MBJT 215N 712W,0,0,0,7,7
Tropical Storm,Emily,8,1999-08-26T15:00:00Z,TFFR 163N 615W,4,10,1,0,15
Tropical Storm,Emily,8,1999-08-26T15:00:00Z,MYMM 224N 730W,0,0,0,4,4
Tropical Storm,Emily,8,1999-08-26T15:00:00Z,TAPA 171N 618W,5,13,1,0,19
Tropical Storm,Emily,8,1999-08-26T15:00:00Z,MYSM 241N 745W,0,0,0,2,2
Tropical Storm,Emily,8,1999-08-26T15:00:00Z,TKPK 173N 627W,1,12,3,1,17
Tropical Storm,Emily,8,1999-08-26T15:00:00Z,ST CROIX VI,0,2,8,3,13
Tropical Storm,Emily,8,1999-08-26T15:00:00Z,TNCM 181N 631W,0,14,4,1,19
Tropical Storm,Emily,8,1999-08-26T15:00:00Z,ST THOMAS VI,0,2,9,3,14
Tropical Storm,Emily,8,1999-08-26T15:00:00Z,TISX 177N 648W,0,2,8,3,13
Tropical Storm,Emily,8,1999-08-26T15:00:00Z,SAN JUAN PR,0,0,7,5,12
Tropical Storm,Emily,8,1999-08-26T15:00:00Z,TIST 183N 650W,0,2,9,3,14
Tropical Storm,Emily,8,1999-08-26T15:00:00Z,PONCE PR,0,0,4,6,10
Tropical Depression,Emily,9,1999-08-26T21:00:00Z,19.3N  57.9W,36,1,0,0,37
Tropical Depression,Emily,9,1999-08-26T21:00:00Z,TJPS 180N 666W,0,0,0,5,5
Tropical Depression,Emily,9,1999-08-26T21:00:00Z,20.8N  59.3W,17,8,1,0,26
Tropical Depression,Emily,9,1999-08-26T21:00:00Z,MDSD 185N 697W,0,0,0,2,2
Tropical Depression,Emily,9,1999-08-26T21:00:00Z,22.5N  61.0W,1,13,7,1,22
Tropical Depression,Emily,9,1999-08-26T21:00:00Z,TJSJ 184N 661W,0,0,1,5,6
Tropical Depression,Emily,9,1999-08-26T21:00:00Z,TDPR 153N 614W,0,0,1,1,2
Tropical Depression,Emily,9,1999-08-26T21:00:00Z,MDPP 198N 707W,0,0,0,2,2
Tropical Depression,Emily,9,1999-08-26T21:00:00Z,TFFR 163N 615W,0,2,2,1,5
Tropical Depression,Emily,9,1999-08-26T21:00:00Z,MBJT 215N 712W,0,0,0,2,2
Tropical Depression,Emily,9,1999-08-26T21:00:00Z,TAPA 171N 618W,1,3,3,1,8
Tropical Depression,Emily,9,1999-08-26T21:00:00Z,BERMUDA,0,0,0,7,7
Tropical Depression,Emily,9,1999-08-26T21:00:00Z,TKPK 173N 627W,0,2,3,3,8
Tropical Depression,Emily,9,1999-08-26T21:00:00Z,ST CROIX VI,0,0,2,4,6
Tropical Depression,Emily,9,1999-08-26T21:00:00Z,TNCM 181N 631W,0,3,4,3,10
Tropical Depression,Emily,9,1999-08-26T21:00:00Z,ST THOMAS VI,0,0,2,6,8
Tropical Depression,Emily,9,1999-08-26T21:00:00Z,TISX 177N 648W,0,0,2,4,6
Tropical Depression,Emily,9,1999-08-26T21:00:00Z,SAN JUAN PR,0,0,1,5,6
Tropical Depression,Emily,9,1999-08-26T21:00:00Z,TIST 183N 650W,0,0,2,6,8
Tropical Depression,Emily,9,1999-08-26T21:00:00Z,PONCE PR,0,0,0,5,5
Tropical Depression,Emily,10,1999-08-27T03:00:00Z,19.7N  58.1W,37,0,0,0,37
Tropical Depression,Emily,10,1999-08-27T03:00:00Z,TJPS 180N 666W,0,0,0,4,4
Tropical Depression,Emily,10,1999-08-27T03:00:00Z,21.0N  59.4W,20,5,1,0,26
Tropical Depression,Emily,10,1999-08-27T03:00:00Z,MDSD 185N 697W,0,0,0,2,2
Tropical Depression,Emily,10,1999-08-27T03:00:00Z,22.3N  60.9W,3,15,3,1,22
Tropical Depression,Emily,10,1999-08-27T03:00:00Z,TJSJ 184N 661W,0,0,0,5,5
Tropical Depression,Emily,10,1999-08-27T03:00:00Z,TDPR 153N 614W,0,0,0,2,2
Tropical Depression,Emily,10,1999-08-27T03:00:00Z,MDPP 198N 707W,0,0,0,2,2
Tropical Depression,Emily,10,1999-08-27T03:00:00Z,TFFR 163N 615W,0,0,1,3,4
Tropical Depression,Emily,10,1999-08-27T03:00:00Z,MBJT 215N 712W,0,0,0,2,2
Tropical Depression,Emily,10,1999-08-27T03:00:00Z,TAPA 171N 618W,0,1,2,3,6
Tropical Depression,Emily,10,1999-08-27T03:00:00Z,BERMUDA,0,0,0,5,5
Tropical Depression,Emily,10,1999-08-27T03:00:00Z,TKPK 173N 627W,0,0,2,4,6
Tropical Depression,Emily,10,1999-08-27T03:00:00Z,ST CROIX VI,0,0,0,5,5
Tropical Depression,Emily,10,1999-08-27T03:00:00Z,TNCM 181N 631W,0,1,2,5,8
Tropical Depression,Emily,10,1999-08-27T03:00:00Z,ST THOMAS VI,0,0,1,5,6
Tropical Depression,Emily,10,1999-08-27T03:00:00Z,TISX 177N 648W,0,0,0,5,5
Tropical Depression,Emily,10,1999-08-27T03:00:00Z,SAN JUAN PR,0,0,0,5,5
Tropical Depression,Emily,10,1999-08-27T03:00:00Z,TIST 183N 650W,0,0,1,5,6
Tropical Depression,Emily,10,1999-08-27T03:00:00Z,PONCE PR,0,0,0,4,4
Tropical Depression,Emily,11,1999-08-27T09:00:00Z,22.4N  57.5W,31,1,0,0,32
Tropical Depression,Emily,11,1999-08-27T09:00:00Z,TIST 183N 650W,0,0,0,2,2
Tropical Depression,Emily,11,1999-08-27T09:00:00Z,24.3N  58.4W,5,17,1,0,23
Tropical Depression,Emily,11,1999-08-27T09:00:00Z,BERMUDA,0,0,0,9,9
Tropical Depression,Emily,11,1999-08-27T09:00:00Z,26.0N  60.0W,0,11,7,2,20
Tropical Depression,Emily,11,1999-08-27T09:00:00Z,ST THOMAS VI,0,0,0,2,2
Tropical Depression,Emily,11,1999-08-27T09:00:00Z,TNCM 181N 631W,0,0,1,1,2
Tropical Depression,Emily,12,1999-08-27T15:00:00Z,23.2N  57.7W,42,0,0,0,42
Tropical Depression,Emily,12,1999-08-27T15:00:00Z,26.5N  60.0W,0,16,4,1,21
Tropical Depression,Emily,12,1999-08-27T15:00:00Z,25.0N  58.8W,8,17,1,0,26
Tropical Depression,Emily,12,1999-08-27T15:00:00Z,BERMUDA,0,0,0,11,11
Tropical Storm,Emily,13,1999-08-27T21:00:00Z,23.8N  57.8W,36,0,0,0,36
Tropical Storm,Emily,13,1999-08-27T21:00:00Z,TJSJ 184N 661W,0,0,0,2,2
Tropical Storm,Emily,13,1999-08-27T21:00:00Z,25.3N  58.7W,11,13,1,1,26
Tropical Storm,Emily,13,1999-08-27T21:00:00Z,BERMUDA,0,0,1,8,9
Tropical Storm,Emily,13,1999-08-27T21:00:00Z,26.9N  59.7W,0,16,4,1,21
Tropical Storm,Emily,13,1999-08-27T21:00:00Z,ST THOMAS VI,0,0,0,2,2
Tropical Storm,Emily,13,1999-08-27T21:00:00Z,TNCM 181N 631W,0,0,1,1,2
Tropical Storm,Emily,13,1999-08-27T21:00:00Z,SAN JUAN PR,0,0,0,2,2
Tropical Storm,Emily,13,1999-08-27T21:00:00Z,TIST 183N 650W,0,0,0,2,2
Tropical Storm,Emily,14,1999-08-28T03:00:00Z,25.7N  55.7W,33,0,0,0,33
Tropical Storm,Emily,14,1999-08-28T03:00:00Z,HALIFAX NS,0,0,0,2,2
Tropical Storm,Emily,14,1999-08-28T03:00:00Z,28.1N  55.9W,7,12,1,1,21
Tropical Storm,Emily,14,1999-08-28T03:00:00Z,SABLE ISLAND NS,0,0,0,3,3
Tropical Storm,Emily,14,1999-08-28T03:00:00Z,30.4N  56.7W,0,11,4,2,17
Tropical Storm,Emily,14,1999-08-28T03:00:00Z,EDDY POINT NS,0,0,0,2,2
Tropical Storm,Emily,14,1999-08-28T03:00:00Z,BERMUDA,0,0,1,7,8
Tropical Storm,Emily,15,1999-08-28T09:00:00Z,27.9N  56.3W,33,1,0,0,34
Tropical Storm,Emily,15,1999-08-28T09:00:00Z,31.5N  55.0W,1,18,0,0,19
Tropical Depression,Seven,1,1999-09-05T21:00:00Z,23.3N  97.5W,49,0,0,0,49
Tropical Depression,Seven,1,1999-09-05T21:00:00Z,PORT O CONNOR TX,0,1,5,0,6
Tropical Depression,Seven,1,1999-09-05T21:00:00Z,24.2N  98.0W,28,1,0,0,29
Tropical Depression,Seven,1,1999-09-05T21:00:00Z,CORPUSCHRISTI TX,0,4,7,0,11
Tropical Depression,Seven,1,1999-09-05T21:00:00Z,25.0N  98.5W,15,7,2,0,24
Tropical Depression,Seven,1,1999-09-05T21:00:00Z,BROWNSVILLE TX,5,12,3,0,20
Tropical Depression,Seven,1,1999-09-05T21:00:00Z,MMSO 238N 982W,29,1,1,0,31
Tropical Depression,Seven,1,1999-09-05T21:00:00Z,GULF 28N 95W,0,0,4,0,4
Tropical Depression,Seven,1,1999-09-05T21:00:00Z,MMTM 222N 979W,55,0,0,0,55
Tropical Depression,Seven,1,1999-09-05T21:00:00Z,GULF 27N 96W,0,5,5,0,10
Tropical Depression,Seven,1,1999-09-05T21:00:00Z,MMTX 210N 974W,99,0,0,0,99
Tropical Depression,Seven,1,1999-09-05T21:00:00Z,GULF 25N 96W,11,7,2,0,20
Tropical Depression,Seven,1,1999-09-05T21:00:00Z,FREEPORT TX,0,0,2,0,2
Tropical Depression,Seven,2,1999-09-06T03:00:00Z,23.6N  97.1W,46,0,0,0,46
Tropical Depression,Seven,2,1999-09-06T03:00:00Z,PORT O CONNOR TX,0,0,3,0,3
Tropical Depression,Seven,2,1999-09-06T03:00:00Z,24.0N  97.8W,31,1,0,0,32
Tropical Depression,Seven,2,1999-09-06T03:00:00Z,CORPUSCHRISTI TX,0,3,5,0,8
Tropical Depression,Seven,2,1999-09-06T03:00:00Z,24.5N  98.5W,19,5,1,0,25
Tropical Depression,Seven,2,1999-09-06T03:00:00Z,BROWNSVILLE TX,8,9,3,0,20
Tropical Depression,Seven,2,1999-09-06T03:00:00Z,MMSO 238N 982W,27,1,1,0,29
Tropical Depression,Seven,2,1999-09-06T03:00:00Z,GULF 28N 95W,0,0,2,0,2
Tropical Depression,Seven,2,1999-09-06T03:00:00Z,MMTM 222N 979W,51,0,0,0,51
Tropical Depression,Seven,2,1999-09-06T03:00:00Z,GULF 27N 96W,0,4,5,0,9
Tropical Depression,Seven,2,1999-09-06T03:00:00Z,MMTX 210N 974W,17,0,1,0,18
Tropical Depression,Seven,2,1999-09-06T03:00:00Z,GULF 25N 96W,17,3,1,0,21
Tropical Depression,Seven,3,1999-09-06T09:00:00Z,24.3N  98.2W,56,0,0,0,56
Tropical Depression,Seven,3,1999-09-06T09:00:00Z,PORT O CONNOR TX,0,1,2,0,3
Tropical Depression,Seven,3,1999-09-06T09:00:00Z,24.8N  99.0W,32,1,0,0,33
Tropical Depression,Seven,3,1999-09-06T09:00:00Z,CORPUSCHRISTI TX,1,5,4,0,10
Tropical Depression,Seven,3,1999-09-06T09:00:00Z,25.0N  99.5W,24,3,1,0,28
Tropical Depression,Seven,3,1999-09-06T09:00:00Z,BROWNSVILLE TX,18,2,1,0,21
Tropical Depression,Seven,3,1999-09-06T09:00:00Z,MMSO 238N 982W,54,0,0,0,54
Tropical Depression,Seven,3,1999-09-06T09:00:00Z,GULF 27N 96W,0,2,3,0,5
Tropical Depression,Seven,3,1999-09-06T09:00:00Z,MMTM 222N 979W,99,0,0,0,99
Tropical Depression,Seven,3,1999-09-06T09:00:00Z,GULF 25N 96W,14,2,0,0,16
Tropical Depression,Seven,3,1999-09-06T09:00:00Z,MMTX 210N 974W,1,3,3,0,7
Tropical Depression,Seven,4,1999-09-06T15:00:00Z,25.6N 100.0W,43,0,0,0,43
Tropical Depression,Seven,4,1999-09-06T15:00:00Z,CORPUSCHRISTI TX,2,0,0,0,2
Tropical Depression,Seven,4,1999-09-06T15:00:00Z,0.0N   0.0W,99,0,0,0,99
Tropical Depression,Seven,4,1999-09-06T15:00:00Z,BROWNSVILLE TX,27,0,0,0,27
Tropical Depression,Seven,4,1999-09-06T15:00:00Z,0.0N   0.0W,99,0,0,0,99
Tropical Depression,Seven,4,1999-09-06T15:00:00Z,GULF 25N 96W,5,0,0,0,5
Tropical Depression,Seven,4,1999-09-06T15:00:00Z,MMSO 238N 982W,99,0,0,0,99
Tropical Depression,Seven,5,1999-09-06T21:00:00Z,24.3N  99.5W,46,0,0,0,46
Tropical Depression,Seven,5,1999-09-06T21:00:00Z,MMTM 222N 979W,7,0,0,0,7
Tropical Depression,Seven,5,1999-09-06T21:00:00Z,0.0N   0.0W,99,0,0,0,99
Tropical Depression,Seven,5,1999-09-06T21:00:00Z,BROWNSVILLE TX,14,0,0,0,14
Tropical Depression,Seven,5,1999-09-06T21:00:00Z,0.0N   0.0W,99,0,0,0,99
Tropical Depression,Seven,5,1999-09-06T21:00:00Z,GULF 25N 96W,4,0,0,0,4
Tropical Depression,Seven,5,1999-09-06T21:00:00Z,MMSO 238N 982W,99,0,0,0,99
Tropical Depression,Seven,8,1999-09-07T15:00:00Z,MMSO 238N 982W,2,0,0,0,2
Tropical Depression,Seven,8,1999-09-07T15:00:00Z,BROWNSVILLE TX,70,0,0,0,70
Tropical Depression,Eight,1,1999-09-07T21:00:00Z,15.3N  50.6W,56,0,0,0,56
Tropical Depression,Eight,1,1999-09-07T21:00:00Z,TAPA 171N 618W,0,0,0,13,13
Tropical Depression,Eight,1,1999-09-07T21:00:00Z,15.8N  53.0W,3,31,0,0,34
Tropical Depression,Eight,1,1999-09-07T21:00:00Z,TKPK 173N 627W,0,0,0,11,11
Tropical Depression,Eight,1,1999-09-07T21:00:00Z,16.5N  55.5W,0,12,14,0,26
Tropical Depression,Eight,1,1999-09-07T21:00:00Z,TNCM 181N 631W,0,0,0,11,11
Tropical Depression,Eight,1,1999-09-07T21:00:00Z,TTPT 112N 608W,0,0,0,2,2
Tropical Depression,Eight,1,1999-09-07T21:00:00Z,TISX 177N 648W,0,0,0,6,6
Tropical Depression,Eight,1,1999-09-07T21:00:00Z,TGPY 120N 618W,0,0,0,2,2
Tropical Depression,Eight,1,1999-09-07T21:00:00Z,TIST 183N 650W,0,0,0,6,6
Tropical Depression,Eight,1,1999-09-07T21:00:00Z,TBPB 131N 595W,0,0,1,7,8
Tropical Depression,Eight,1,1999-09-07T21:00:00Z,TJPS 180N 666W,0,0,0,2,2
Tropical Depression,Eight,1,1999-09-07T21:00:00Z,TVSV 131N 612W,0,0,0,6,6
Tropical Depression,Eight,1,1999-09-07T21:00:00Z,TJSJ 184N 661W,0,0,0,3,3
Tropical Depression,Eight,1,1999-09-07T21:00:00Z,TLPL 138N 610W,0,0,0,8,8
Tropical Depression,Eight,1,1999-09-07T21:00:00Z,ST CROIX VI,0,0,0,6,6
Tropical Depression,Eight,1,1999-09-07T21:00:00Z,TFFF 146N 610W,0,0,1,9,10
Tropical Depression,Eight,1,1999-09-07T21:00:00Z,ST THOMAS VI,0,0,0,6,6
Tropical Depression,Eight,1,1999-09-07T21:00:00Z,TDPR 153N 614W,0,0,1,10,11
Tropical Depression,Eight,1,1999-09-07T21:00:00Z,SAN JUAN PR,0,0,0,3,3
Tropical Depression,Eight,1,1999-09-07T21:00:00Z,TFFR 163N 615W,0,0,1,12,13
Tropical Depression,Eight,1,1999-09-07T21:00:00Z,PONCE PR,0,0,0,2,2
Tropical Depression,Eight,2,1999-09-08T03:00:00Z,16.5N  52.0W,41,0,0,0,41
Tropical Depression,Eight,2,1999-09-08T03:00:00Z,TKPK 173N 627W,0,0,1,12,13
Tropical Depression,Eight,2,1999-09-08T03:00:00Z,17.0N  54.5W,6,22,1,0,29
Tropical Depression,Eight,2,1999-09-08T03:00:00Z,TNCM 181N 631W,0,0,1,12,13
Tropical Depression,Eight,2,1999-09-08T03:00:00Z,18.0N  57.0W,0,10,12,1,23
Tropical Depression,Eight,2,1999-09-08T03:00:00Z,TISX 177N 648W,0,0,0,8,8
Tropical Depression,Eight,2,1999-09-08T03:00:00Z,TGPY 120N 618W,0,0,0,2,2
Tropical Depression,Eight,2,1999-09-08T03:00:00Z,TIST 183N 650W,0,0,0,8,8
Tropical Depression,Eight,2,1999-09-08T03:00:00Z,TBPB 131N 595W,0,0,3,4,7
Tropical Depression,Eight,2,1999-09-08T03:00:00Z,TJPS 180N 666W,0,0,0,4,4
Tropical Depression,Eight,2,1999-09-08T03:00:00Z,TVSV 131N 612W,0,0,1,4,5
Tropical Depression,Eight,2,1999-09-08T03:00:00Z,TJSJ 184N 661W,0,0,0,5,5
Tropical Depression,Eight,2,1999-09-08T03:00:00Z,TLPL 138N 610W,0,0,1,6,7
Tropical Depression,Eight,2,1999-09-08T03:00:00Z,ST CROIX VI,0,0,0,8,8
Tropical Depression,Eight,2,1999-09-08T03:00:00Z,TFFF 146N 610W,0,0,2,8,10
Tropical Depression,Eight,2,1999-09-08T03:00:00Z,ST THOMAS VI,0,0,0,8,8
Tropical Depression,Eight,2,1999-09-08T03:00:00Z,TDPR 153N 614W,0,0,2,9,11
Tropical Depression,Eight,2,1999-09-08T03:00:00Z,SAN JUAN PR,0,0,0,5,5
Tropical Depression,Eight,2,1999-09-08T03:00:00Z,TFFR 163N 615W,0,0,3,10,13
Tropical Depression,Eight,2,1999-09-08T03:00:00Z,PONCE PR,0,0,0,4,4
Tropical Depression,Eight,2,1999-09-08T03:00:00Z,TAPA 171N 618W,0,0,2,12,14
Tropical Storm,Floyd,3,1999-09-08T09:00:00Z,17.0N  53.8W,43,0,0,0,43
Tropical Storm,Floyd,3,1999-09-08T09:00:00Z,TKPK 173N 627W,0,0,2,10,12
Tropical Storm,Floyd,3,1999-09-08T09:00:00Z,18.0N  56.0W,8,19,1,0,28
Tropical Storm,Floyd,3,1999-09-08T09:00:00Z,TNCM 181N 631W,0,0,2,11,13
Tropical Storm,Floyd,3,1999-09-08T09:00:00Z,19.0N  58.0W,0,14,7,2,23
Tropical Storm,Floyd,3,1999-09-08T09:00:00Z,TISX 177N 648W,0,0,0,8,8
Tropical Storm,Floyd,3,1999-09-08T09:00:00Z,TBPB 131N 595W,0,0,2,2,4
Tropical Storm,Floyd,3,1999-09-08T09:00:00Z,TIST 183N 650W,0,0,0,9,9
Tropical Storm,Floyd,3,1999-09-08T09:00:00Z,TVSV 131N 612W,0,0,1,2,3
Tropical Storm,Floyd,3,1999-09-08T09:00:00Z,TJPS 180N 666W,0,0,0,4,4
Tropical Storm,Floyd,3,1999-09-08T09:00:00Z,TLPL 138N 610W,0,0,1,4,5
Tropical Storm,Floyd,3,1999-09-08T09:00:00Z,TJSJ 184N 661W,0,0,0,6,6
Tropical Storm,Floyd,3,1999-09-08T09:00:00Z,TFFF 146N 610W,0,0,3,5,8
Tropical Storm,Floyd,3,1999-09-08T09:00:00Z,ST CROIX VI,0,0,0,8,8
Tropical Storm,Floyd,3,1999-09-08T09:00:00Z,TDPR 153N 614W,0,0,3,6,9
Tropical Storm,Floyd,3,1999-09-08T09:00:00Z,ST THOMAS VI,0,0,0,9,9
Tropical Storm,Floyd,3,1999-09-08T09:00:00Z,TFFR 163N 615W,0,0,5,7,12
Tropical Storm,Floyd,3,1999-09-08T09:00:00Z,SAN JUAN PR,0,0,0,6,6
Tropical Storm,Floyd,3,1999-09-08T09:00:00Z,TAPA 171N 618W,0,0,5,9,14
Tropical Storm,Floyd,3,1999-09-08T09:00:00Z,PONCE PR,0,0,0,4,4
Tropical Storm,Floyd,4,1999-09-08T15:00:00Z,17.2N  54.5W,45,0,0,0,45
Tropical Storm,Floyd,4,1999-09-08T15:00:00Z,TKPK 173N 627W,0,0,3,8,11
Tropical Storm,Floyd,4,1999-09-08T15:00:00Z,18.3N  56.6W,6,22,0,0,28
Tropical Storm,Floyd,4,1999-09-08T15:00:00Z,TNCM 181N 631W,0,0,3,10,13
Tropical Storm,Floyd,4,1999-09-08T15:00:00Z,19.5N  58.5W,0,12,9,2,23
Tropical Storm,Floyd,4,1999-09-08T15:00:00Z,TISX 177N 648W,0,0,0,8,8
Tropical Storm,Floyd,4,1999-09-08T15:00:00Z,TBPB 131N 595W,0,0,2,1,3
Tropical Storm,Floyd,4,1999-09-08T15:00:00Z,TIST 183N 650W,0,0,0,8,8
Tropical Storm,Floyd,4,1999-09-08T15:00:00Z,TVSV 131N 612W,0,0,1,1,2
Tropical Storm,Floyd,4,1999-09-08T15:00:00Z,TJPS 180N 666W,0,0,0,4,4
Tropical Storm,Floyd,4,1999-09-08T15:00:00Z,TLPL 138N 610W,0,0,1,3,4
Tropical Storm,Floyd,4,1999-09-08T15:00:00Z,TJSJ 184N 661W,0,0,0,6,6
Tropical Storm,Floyd,4,1999-09-08T15:00:00Z,TFFF 146N 610W,0,0,3,3,6
Tropical Storm,Floyd,4,1999-09-08T15:00:00Z,ST CROIX VI,0,0,0,8,8
Tropical Storm,Floyd,4,1999-09-08T15:00:00Z,TDPR 153N 614W,0,0,4,4,8
Tropical Storm,Floyd,4,1999-09-08T15:00:00Z,ST THOMAS VI,0,0,0,8,8
Tropical Storm,Floyd,4,1999-09-08T15:00:00Z,TFFR 163N 615W,0,0,6,5,11
Tropical Storm,Floyd,4,1999-09-08T15:00:00Z,SAN JUAN PR,0,0,0,6,6
Tropical Storm,Floyd,4,1999-09-08T15:00:00Z,TAPA 171N 618W,0,0,6,7,13
Tropical Storm,Floyd,4,1999-09-08T15:00:00Z,PONCE PR,0,0,0,4,4
Tropical Storm,Floyd,5,1999-09-08T21:00:00Z,18.5N  56.1W,41,0,0,0,41
Tropical Storm,Floyd,5,1999-09-08T21:00:00Z,TKPK 173N 627W,0,1,5,6,12
Tropical Storm,Floyd,5,1999-09-08T21:00:00Z,19.5N  57.9W,13,14,1,0,28
Tropical Storm,Floyd,5,1999-09-08T21:00:00Z,TNCM 181N 631W,0,0,6,7,13
Tropical Storm,Floyd,5,1999-09-08T21:00:00Z,20.5N  59.5W,1,15,5,2,23
Tropical Storm,Floyd,5,1999-09-08T21:00:00Z,TISX 177N 648W,0,0,1,6,7
Tropical Storm,Floyd,5,1999-09-08T21:00:00Z,TBPB 131N 595W,0,0,1,1,2
Tropical Storm,Floyd,5,1999-09-08T21:00:00Z,TIST 183N 650W,0,0,1,7,8
Tropical Storm,Floyd,5,1999-09-08T21:00:00Z,TVSV 131N 612W,0,0,0,2,2
Tropical Storm,Floyd,5,1999-09-08T21:00:00Z,TJPS 180N 666W,0,0,0,4,4
Tropical Storm,Floyd,5,1999-09-08T21:00:00Z,TLPL 138N 610W,0,0,1,2,3
Tropical Storm,Floyd,5,1999-09-08T21:00:00Z,TJSJ 184N 661W,0,0,0,5,5
Tropical Storm,Floyd,5,1999-09-08T21:00:00Z,TFFF 146N 610W,0,1,2,3,6
Tropical Storm,Floyd,5,1999-09-08T21:00:00Z,ST CROIX VI,0,0,1,6,7
Tropical Storm,Floyd,5,1999-09-08T21:00:00Z,TDPR 153N 614W,0,1,3,4,8
Tropical Storm,Floyd,5,1999-09-08T21:00:00Z,ST THOMAS VI,0,0,1,7,8
Tropical Storm,Floyd,5,1999-09-08T21:00:00Z,TFFR 163N 615W,0,2,5,4,11
Tropical Storm,Floyd,5,1999-09-08T21:00:00Z,SAN JUAN PR,0,0,0,5,5
Tropical Storm,Floyd,5,1999-09-08T21:00:00Z,TAPA 171N 618W,0,2,7,4,13
Tropical Storm,Floyd,5,1999-09-08T21:00:00Z,PONCE PR,0,0,0,4,4
Tropical Storm,Floyd,6,1999-09-09T03:00:00Z,18.3N  58.0W,47,0,0,0,47
Tropical Storm,Floyd,6,1999-09-09T03:00:00Z,TISX 177N 648W,0,0,7,6,13
Tropical Storm,Floyd,6,1999-09-09T03:00:00Z,19.5N  60.0W,4,25,1,0,30
Tropical Storm,Floyd,6,1999-09-09T03:00:00Z,TIST 183N 650W,0,0,8,6,14
Tropical Storm,Floyd,6,1999-09-09T03:00:00Z,20.5N  61.7W,0,16,6,1,23
Tropical Storm,Floyd,6,1999-09-09T03:00:00Z,TJPS 180N 666W,0,0,2,8,10
Tropical Storm,Floyd,6,1999-09-09T03:00:00Z,TBPB 131N 595W,0,1,0,1,2
Tropical Storm,Floyd,6,1999-09-09T03:00:00Z,MDSD 185N 697W,0,0,0,4,4
Tropical Storm,Floyd,6,1999-09-09T03:00:00Z,TLPL 138N 610W,0,1,1,1,3
Tropical Storm,Floyd,6,1999-09-09T03:00:00Z,TJSJ 184N 661W,0,0,4,8,12
Tropical Storm,Floyd,6,1999-09-09T03:00:00Z,TFFF 146N 610W,0,4,2,1,7
Tropical Storm,Floyd,6,1999-09-09T03:00:00Z,MDPP 198N 707W,0,0,0,3,3
Tropical Storm,Floyd,6,1999-09-09T03:00:00Z,TDPR 153N 614W,0,6,2,1,9
Tropical Storm,Floyd,6,1999-09-09T03:00:00Z,MBJT 215N 712W,0,0,0,3,3
Tropical Storm,Floyd,6,1999-09-09T03:00:00Z,TFFR 163N 615W,0,10,3,1,14
Tropical Storm,Floyd,6,1999-09-09T03:00:00Z,ST CROIX VI,0,0,7,6,13
Tropical Storm,Floyd,6,1999-09-09T03:00:00Z,TAPA 171N 618W,0,12,4,1,17
Tropical Storm,Floyd,6,1999-09-09T03:00:00Z,ST THOMAS VI,0,0,8,6,14
Tropical Storm,Floyd,6,1999-09-09T03:00:00Z,TKPK 173N 627W,0,7,6,3,16
Tropical Storm,Floyd,6,1999-09-09T03:00:00Z,SAN JUAN PR,0,0,4,8,12
Tropical Storm,Floyd,6,1999-09-09T03:00:00Z,TNCM 181N 631W,0,5,10,3,18
Tropical Storm,Floyd,6,1999-09-09T03:00:00Z,PONCE PR,0,0,2,8,10
Tropical Storm,Floyd,7,1999-09-09T09:00:00Z,19.1N  58.6W,41,0,0,0,41
Tropical Storm,Floyd,7,1999-09-09T09:00:00Z,TIST 183N 650W,0,1,6,5,12
Tropical Storm,Floyd,7,1999-09-09T09:00:00Z,20.5N  60.5W,9,18,1,0,28
Tropical Storm,Floyd,7,1999-09-09T09:00:00Z,TJPS 180N 666W,0,0,2,6,8
Tropical Storm,Floyd,7,1999-09-09T09:00:00Z,21.5N  62.0W,0,17,5,1,23
Tropical Storm,Floyd,7,1999-09-09T09:00:00Z,MDSD 185N 697W,0,0,0,2,2
Tropical Storm,Floyd,7,1999-09-09T09:00:00Z,TLPL 138N 610W,0,0,1,1,2
Tropical Storm,Floyd,7,1999-09-09T09:00:00Z,TJSJ 184N 661W,0,0,3,7,10
Tropical Storm,Floyd,7,1999-09-09T09:00:00Z,TFFF 146N 610W,0,1,2,1,4
Tropical Storm,Floyd,7,1999-09-09T09:00:00Z,MDPP 198N 707W,0,0,0,2,2
Tropical Storm,Floyd,7,1999-09-09T09:00:00Z,TDPR 153N 614W,0,3,2,1,6
Tropical Storm,Floyd,7,1999-09-09T09:00:00Z,MBJT 215N 712W,0,0,0,2,2
Tropical Storm,Floyd,7,1999-09-09T09:00:00Z,TFFR 163N 615W,1,6,3,1,11
Tropical Storm,Floyd,7,1999-09-09T09:00:00Z,ST CROIX VI,0,1,5,5,11
Tropical Storm,Floyd,7,1999-09-09T09:00:00Z,TAPA 171N 618W,1,9,3,2,15
Tropical Storm,Floyd,7,1999-09-09T09:00:00Z,ST THOMAS VI,0,1,6,5,12
Tropical Storm,Floyd,7,1999-09-09T09:00:00Z,TKPK 173N 627W,0,7,4,3,14
Tropical Storm,Floyd,7,1999-09-09T09:00:00Z,SAN JUAN PR,0,0,3,7,10
Tropical Storm,Floyd,7,1999-09-09T09:00:00Z,TNCM 181N 631W,0,7,6,3,16
Tropical Storm,Floyd,7,1999-09-09T09:00:00Z,PONCE PR,0,0,2,6,8
Tropical Storm,Floyd,7,1999-09-09T09:00:00Z,TISX 177N 648W,0,1,5,5,11
Tropical Storm,Floyd,8,1999-09-09T15:00:00Z,18.5N  59.4W,40,1,0,0,41
Tropical Storm,Floyd,8,1999-09-09T15:00:00Z,TIST 183N 650W,0,4,9,4,17
Tropical Storm,Floyd,8,1999-09-09T15:00:00Z,19.6N  61.2W,14,13,1,0,28
Tropical Storm,Floyd,8,1999-09-09T15:00:00Z,TJPS 180N 666W,0,0,5,7,12
Tropical Storm,Floyd,8,1999-09-09T15:00:00Z,21.0N  63.0W,0,15,7,2,24
Tropical Storm,Floyd,8,1999-09-09T15:00:00Z,MDSD 185N 697W,0,0,0,5,5
Tropical Storm,Floyd,8,1999-09-09T15:00:00Z,TLPL 138N 610W,0,1,1,1,3
Tropical Storm,Floyd,8,1999-09-09T15:00:00Z,TJSJ 184N 661W,0,1,7,6,14
Tropical Storm,Floyd,8,1999-09-09T15:00:00Z,TFFF 146N 610W,1,4,1,1,7
Tropical Storm,Floyd,8,1999-09-09T15:00:00Z,MDPP 198N 707W,0,0,0,4,4
Tropical Storm,Floyd,8,1999-09-09T15:00:00Z,TDPR 153N 614W,2,7,1,1,11
Tropical Storm,Floyd,8,1999-09-09T15:00:00Z,MBJT 215N 712W,0,0,0,4,4
Tropical Storm,Floyd,8,1999-09-09T15:00:00Z,TFFR 163N 615W,5,10,1,1,17
Tropical Storm,Floyd,8,1999-09-09T15:00:00Z,ST CROIX VI,0,4,8,3,15
Tropical Storm,Floyd,8,1999-09-09T15:00:00Z,TAPA 171N 618W,6,13,1,1,21
Tropical Storm,Floyd,8,1999-09-09T15:00:00Z,ST THOMAS VI,0,4,9,4,17
Tropical Storm,Floyd,8,1999-09-09T15:00:00Z,TKPK 173N 627W,2,13,3,1,19
Tropical Storm,Floyd,8,1999-09-09T15:00:00Z,SAN JUAN PR,0,1,7,6,14
Tropical Storm,Floyd,8,1999-09-09T15:00:00Z,TNCM 181N 631W,1,15,4,1,21
Tropical Storm,Floyd,8,1999-09-09T15:00:00Z,PONCE PR,0,0,5,7,12
Tropical Storm,Floyd,8,1999-09-09T15:00:00Z,TISX 177N 648W,0,4,8,3,15
Tropical Storm,Floyd,9,1999-09-09T21:00:00Z,19.8N  60.6W,41,0,0,0,41
Tropical Storm,Floyd,9,1999-09-09T21:00:00Z,TJPS 180N 666W,0,1,5,5,11
Tropical Storm,Floyd,9,1999-09-09T21:00:00Z,21.0N  62.4W,11,17,1,0,29
Tropical Storm,Floyd,9,1999-09-09T21:00:00Z,MDSD 185N 697W,0,0,0,6,6
Tropical Storm,Floyd,9,1999-09-09T21:00:00Z,22.0N  64.0W,0,17,4,2,23
Tropical Storm,Floyd,9,1999-09-09T21:00:00Z,MDCB 176N 714W,0,0,0,2,2
Tropical Storm,Floyd,9,1999-09-09T21:00:00Z,TFFF 146N 610W,0,1,0,1,2
Tropical Storm,Floyd,9,1999-09-09T21:00:00Z,TJSJ 184N 661W,0,2,7,4,13
Tropical Storm,Floyd,9,1999-09-09T21:00:00Z,TDPR 153N 614W,1,2,0,1,4
Tropical Storm,Floyd,9,1999-09-09T21:00:00Z,MDPP 198N 707W,0,0,0,5,5
Tropical Storm,Floyd,9,1999-09-09T21:00:00Z,TFFR 163N 615W,6,4,1,0,11
Tropical Storm,Floyd,9,1999-09-09T21:00:00Z,MBJT 215N 712W,0,0,0,6,6
Tropical Storm,Floyd,9,1999-09-09T21:00:00Z,TAPA 171N 618W,10,6,0,1,17
Tropical Storm,Floyd,9,1999-09-09T21:00:00Z,MYMM 224N 730W,0,0,0,3,3
Tropical Storm,Floyd,9,1999-09-09T21:00:00Z,TKPK 173N 627W,4,10,1,1,16
Tropical Storm,Floyd,9,1999-09-09T21:00:00Z,ST CROIX VI,0,6,5,2,13
Tropical Storm,Floyd,9,1999-09-09T21:00:00Z,TNCM 181N 631W,4,13,1,1,19
Tropical Storm,Floyd,9,1999-09-09T21:00:00Z,ST THOMAS VI,0,7,5,3,15
Tropical Storm,Floyd,9,1999-09-09T21:00:00Z,TISX 177N 648W,0,6,5,2,13
Tropical Storm,Floyd,9,1999-09-09T21:00:00Z,SAN JUAN PR,0,2,7,4,13
Tropical Storm,Floyd,9,1999-09-09T21:00:00Z,TIST 183N 650W,0,7,5,3,15
Tropical Storm,Floyd,9,1999-09-09T21:00:00Z,PONCE PR,0,1,5,5,11
Tropical Storm,Floyd,10,1999-09-10T03:00:00Z,20.0N  61.0W,52,0,0,0,52
Tropical Storm,Floyd,10,1999-09-10T03:00:00Z,MTPP 186N 724W,0,0,0,3,3
Tropical Storm,Floyd,10,1999-09-10T03:00:00Z,21.2N  62.7W,25,8,0,0,33
Tropical Storm,Floyd,10,1999-09-10T03:00:00Z,TJSJ 184N 661W,0,2,5,3,10
Tropical Storm,Floyd,10,1999-09-10T03:00:00Z,22.5N  64.5W,1,19,3,1,24
Tropical Storm,Floyd,10,1999-09-10T03:00:00Z,MDPP 198N 707W,0,0,0,8,8
Tropical Storm,Floyd,10,1999-09-10T03:00:00Z,TFFR 163N 615W,1,2,1,0,4
Tropical Storm,Floyd,10,1999-09-10T03:00:00Z,MBJT 215N 712W,0,0,0,10,10
Tropical Storm,Floyd,10,1999-09-10T03:00:00Z,TAPA 171N 618W,3,6,0,1,10
Tropical Storm,Floyd,10,1999-09-10T03:00:00Z,MYMM 224N 730W,0,0,0,7,7
Tropical Storm,Floyd,10,1999-09-10T03:00:00Z,TKPK 173N 627W,1,7,1,1,10
Tropical Storm,Floyd,10,1999-09-10T03:00:00Z,MYSM 241N 745W,0,0,0,4,4
Tropical Storm,Floyd,10,1999-09-10T03:00:00Z,TNCM 181N 631W,3,10,1,1,15
Tropical Storm,Floyd,10,1999-09-10T03:00:00Z,MYEG 235N 758W,0,0,0,2,2
Tropical Storm,Floyd,10,1999-09-10T03:00:00Z,TISX 177N 648W,0,3,4,2,9
Tropical Storm,Floyd,10,1999-09-10T03:00:00Z,ST CROIX VI,0,3,4,2,9
Tropical Storm,Floyd,10,1999-09-10T03:00:00Z,TIST 183N 650W,0,5,5,1,11
Tropical Storm,Floyd,10,1999-09-10T03:00:00Z,ST THOMAS VI,0,5,5,1,11
Tropical Storm,Floyd,10,1999-09-10T03:00:00Z,TJPS 180N 666W,0,1,3,4,8
Tropical Storm,Floyd,10,1999-09-10T03:00:00Z,SAN JUAN PR,0,2,5,3,10
Tropical Storm,Floyd,10,1999-09-10T03:00:00Z,MDSD 185N 697W,0,0,0,6,6
Tropical Storm,Floyd,10,1999-09-10T03:00:00Z,PONCE PR,0,1,3,4,8
Tropical Storm,Floyd,10,1999-09-10T03:00:00Z,MDCB 176N 714W,0,0,0,2,2
Tropical Storm,Floyd,11,1999-09-10T09:00:00Z,20.6N  61.8W,56,0,0,0,56
Tropical Storm,Floyd,11,1999-09-10T09:00:00Z,MUGM 200N 751W,0,0,0,2,2
Tropical Storm,Floyd,11,1999-09-10T09:00:00Z,21.7N  63.6W,28,5,0,0,33
Tropical Storm,Floyd,11,1999-09-10T09:00:00Z,TJSJ 184N 661W,0,1,5,3,9
Tropical Storm,Floyd,11,1999-09-10T09:00:00Z,22.5N  65.5W,2,18,3,1,24
Tropical Storm,Floyd,11,1999-09-10T09:00:00Z,MDPP 198N 707W,0,0,1,7,8
Tropical Storm,Floyd,11,1999-09-10T09:00:00Z,TAPA 171N 618W,0,2,1,1,4
Tropical Storm,Floyd,11,1999-09-10T09:00:00Z,MBJT 215N 712W,0,0,2,9,11
Tropical Storm,Floyd,11,1999-09-10T09:00:00Z,TKPK 173N 627W,0,3,1,1,5
Tropical Storm,Floyd,11,1999-09-10T09:00:00Z,MYMM 224N 730W,0,0,0,9,9
Tropical Storm,Floyd,11,1999-09-10T09:00:00Z,TNCM 181N 631W,1,7,1,1,10
Tropical Storm,Floyd,11,1999-09-10T09:00:00Z,MYSM 241N 745W,0,0,0,6,6
Tropical Storm,Floyd,11,1999-09-10T09:00:00Z,TISX 177N 648W,0,2,3,1,6
Tropical Storm,Floyd,11,1999-09-10T09:00:00Z,MYEG 235N 758W,0,0,0,3,3
Tropical Storm,Floyd,11,1999-09-10T09:00:00Z,TIST 183N 650W,0,3,4,2,9
Tropical Storm,Floyd,11,1999-09-10T09:00:00Z,ST CROIX VI,0,2,3,1,6
Tropical Storm,Floyd,11,1999-09-10T09:00:00Z,TJPS 180N 666W,0,0,4,3,7
Tropical Storm,Floyd,11,1999-09-10T09:00:00Z,ST THOMAS VI,0,3,4,2,9
Tropical Storm,Floyd,11,1999-09-10T09:00:00Z,MDSD 185N 697W,0,0,1,5,6
Tropical Storm,Floyd,11,1999-09-10T09:00:00Z,SAN JUAN PR,0,1,5,3,9
Tropical Storm,Floyd,11,1999-09-10T09:00:00Z,MDCB 176N 714W,0,0,0,2,2
Tropical Storm,Floyd,11,1999-09-10T09:00:00Z,PONCE PR,0,0,4,3,7
Tropical Storm,Floyd,11,1999-09-10T09:00:00Z,MTPP 186N 724W,0,0,0,3,3
Hurricane,Floyd,12,1999-09-10T15:00:00Z,20.8N  62.0W,57,0,0,1,58
Hurricane,Floyd,12,1999-09-10T15:00:00Z,MUGM 200N 751W,0,0,0,2,2
Hurricane,Floyd,12,1999-09-10T15:00:00Z,21.9N  63.9W,21,10,0,0,31
Hurricane,Floyd,12,1999-09-10T15:00:00Z,TJSJ 184N 661W,0,2,4,1,7
Hurricane,Floyd,12,1999-09-10T15:00:00Z,23.0N  66.0W,1,16,5,2,24
Hurricane,Floyd,12,1999-09-10T15:00:00Z,MDPP 198N 707W,0,0,1,7,8
Hurricane,Floyd,12,1999-09-10T15:00:00Z,TAPA 171N 618W,0,2,0,0,2
Hurricane,Floyd,12,1999-09-10T15:00:00Z,MBJT 215N 712W,0,0,2,9,11
Hurricane,Floyd,12,1999-09-10T15:00:00Z,TKPK 173N 627W,0,2,1,0,3
Hurricane,Floyd,12,1999-09-10T15:00:00Z,MYMM 224N 730W,0,0,0,9,9
Hurricane,Floyd,12,1999-09-10T15:00:00Z,TNCM 181N 631W,2,5,1,1,9
Hurricane,Floyd,12,1999-09-10T15:00:00Z,MYSM 241N 745W,0,0,0,7,7
Hurricane,Floyd,12,1999-09-10T15:00:00Z,TISX 177N 648W,0,2,2,1,5
Hurricane,Floyd,12,1999-09-10T15:00:00Z,MYEG 235N 758W,0,0,0,4,4
Hurricane,Floyd,12,1999-09-10T15:00:00Z,TIST 183N 650W,0,4,3,1,8
Hurricane,Floyd,12,1999-09-10T15:00:00Z,MYNN 251N 775W,0,0,0,2,2
Hurricane,Floyd,12,1999-09-10T15:00:00Z,TJPS 180N 666W,0,1,2,2,5
Hurricane,Floyd,12,1999-09-10T15:00:00Z,ST CROIX VI,0,2,2,1,5
Hurricane,Floyd,12,1999-09-10T15:00:00Z,MDSD 185N 697W,0,0,1,4,5
Hurricane,Floyd,12,1999-09-10T15:00:00Z,ST THOMAS VI,0,4,3,1,8
Hurricane,Floyd,12,1999-09-10T15:00:00Z,MDCB 176N 714W,0,0,0,2,2
Hurricane,Floyd,12,1999-09-10T15:00:00Z,SAN JUAN PR,0,2,4,1,7
Hurricane,Floyd,12,1999-09-10T15:00:00Z,MTPP 186N 724W,0,0,0,3,3
Hurricane,Floyd,12,1999-09-10T15:00:00Z,PONCE PR,0,1,2,2,5
Hurricane,Floyd,12,1999-09-10T15:00:00Z,MTCA 183N 738W,0,0,0,2,2
Hurricane,Floyd,13,1999-09-10T21:00:00Z,22.5N  62.8W,48,0,0,0,48
Hurricane,Floyd,13,1999-09-10T21:00:00Z,MDPP 198N 707W,0,0,2,5,7
Hurricane,Floyd,13,1999-09-10T21:00:00Z,23.4N  64.7W,22,5,1,0,28
Hurricane,Floyd,13,1999-09-10T21:00:00Z,MBJT 215N 712W,0,0,4,7,11
Hurricane,Floyd,13,1999-09-10T21:00:00Z,24.0N  67.0W,1,15,3,2,21
Hurricane,Floyd,13,1999-09-10T21:00:00Z,MYMM 224N 730W,0,0,1,9,10
Hurricane,Floyd,13,1999-09-10T21:00:00Z,TNCM 181N 631W,0,1,0,1,2
Hurricane,Floyd,13,1999-09-10T21:00:00Z,MYSM 241N 745W,0,0,1,9,10
Hurricane,Floyd,13,1999-09-10T21:00:00Z,TISX 177N 648W,0,0,1,1,2
Hurricane,Floyd,13,1999-09-10T21:00:00Z,MYEG 235N 758W,0,0,0,7,7
Hurricane,Floyd,13,1999-09-10T21:00:00Z,TIST 183N 650W,0,1,1,1,3
Hurricane,Floyd,13,1999-09-10T21:00:00Z,MYAK 241N 776W,0,0,0,4,4
Hurricane,Floyd,13,1999-09-10T21:00:00Z,TJPS 180N 666W,0,0,1,2,3
Hurricane,Floyd,13,1999-09-10T21:00:00Z,MYNN 251N 775W,0,0,0,5,5
Hurricane,Floyd,13,1999-09-10T21:00:00Z,MDSD 185N 697W,0,0,1,3,4
Hurricane,Floyd,13,1999-09-10T21:00:00Z,MYGF 266N 787W,0,0,0,3,3
Hurricane,Floyd,13,1999-09-10T21:00:00Z,MDCB 176N 714W,0,0,0,2,2
Hurricane,Floyd,13,1999-09-10T21:00:00Z,BERMUDA,0,0,0,2,2
Hurricane,Floyd,13,1999-09-10T21:00:00Z,MTPP 186N 724W,0,0,0,3,3
Hurricane,Floyd,13,1999-09-10T21:00:00Z,ST CROIX VI,0,0,1,1,2
Hurricane,Floyd,13,1999-09-10T21:00:00Z,MTCA 183N 738W,0,0,0,2,2
Hurricane,Floyd,13,1999-09-10T21:00:00Z,ST THOMAS VI,0,1,1,1,3
Hurricane,Floyd,13,1999-09-10T21:00:00Z,MUGM 200N 751W,0,0,0,3,3
Hurricane,Floyd,13,1999-09-10T21:00:00Z,SAN JUAN PR,0,1,1,2,4
Hurricane,Floyd,13,1999-09-10T21:00:00Z,MUCM 214N 779W,0,0,0,2,2
Hurricane,Floyd,13,1999-09-10T21:00:00Z,PONCE PR,0,0,1,2,3
Hurricane,Floyd,13,1999-09-10T21:00:00Z,TJSJ 184N 661W,0,1,1,2,4
Hurricane,Floyd,13,1999-09-10T21:00:00Z,W PALM BEACH FL,0,0,0,2,2
Hurricane,Floyd,14,1999-09-11T03:00:00Z,22.7N  63.6W,50,0,0,0,50
Hurricane,Floyd,14,1999-09-11T03:00:00Z,MYMM 224N 730W,0,0,3,9,12
Hurricane,Floyd,14,1999-09-11T03:00:00Z,23.5N  65.5W,21,6,1,0,28
Hurricane,Floyd,14,1999-09-11T03:00:00Z,MYSM 241N 745W,0,0,2,11,13
Hurricane,Floyd,14,1999-09-11T03:00:00Z,24.0N  68.0W,0,14,5,1,20
Hurricane,Floyd,14,1999-09-11T03:00:00Z,MYEG 235N 758W,0,0,0,10,10
Hurricane,Floyd,14,1999-09-11T03:00:00Z,TNCM 181N 631W,0,1,1,0,2
Hurricane,Floyd,14,1999-09-11T03:00:00Z,MYAK 241N 776W,0,0,0,7,7
Hurricane,Floyd,14,1999-09-11T03:00:00Z,TISX 177N 648W,0,1,0,1,2
Hurricane,Floyd,14,1999-09-11T03:00:00Z,MYNN 251N 775W,0,0,0,8,8
Hurricane,Floyd,14,1999-09-11T03:00:00Z,TIST 183N 650W,0,2,1,0,3
Hurricane,Floyd,14,1999-09-11T03:00:00Z,MYGF 266N 787W,0,0,0,6,6
Hurricane,Floyd,14,1999-09-11T03:00:00Z,TJPS 180N 666W,0,1,1,1,3
Hurricane,Floyd,14,1999-09-11T03:00:00Z,ST CROIX VI,0,1,0,1,2
Hurricane,Floyd,14,1999-09-11T03:00:00Z,MDSD 185N 697W,0,0,2,3,5
Hurricane,Floyd,14,1999-09-11T03:00:00Z,ST THOMAS VI,0,2,1,0,3
Hurricane,Floyd,14,1999-09-11T03:00:00Z,MDCB 176N 714W,0,0,0,3,3
Hurricane,Floyd,14,1999-09-11T03:00:00Z,SAN JUAN PR,0,1,2,1,4
Hurricane,Floyd,14,1999-09-11T03:00:00Z,MTPP 186N 724W,0,0,1,3,4
Hurricane,Floyd,14,1999-09-11T03:00:00Z,PONCE PR,0,1,1,1,3
Hurricane,Floyd,14,1999-09-11T03:00:00Z,MTCA 183N 738W,0,0,0,3,3
Hurricane,Floyd,14,1999-09-11T03:00:00Z,MARATHON FL,0,0,0,2,2
Hurricane,Floyd,14,1999-09-11T03:00:00Z,MUGM 200N 751W,0,0,0,5,5
Hurricane,Floyd,14,1999-09-11T03:00:00Z,MIAMI FL,0,0,0,3,3
Hurricane,Floyd,14,1999-09-11T03:00:00Z,MUCM 214N 779W,0,0,0,4,4
Hurricane,Floyd,14,1999-09-11T03:00:00Z,W PALM BEACH FL,0,0,0,3,3
Hurricane,Floyd,14,1999-09-11T03:00:00Z,TJSJ 184N 661W,0,1,2,1,4
Hurricane,Floyd,14,1999-09-11T03:00:00Z,FT PIERCE FL,0,0,0,3,3
Hurricane,Floyd,14,1999-09-11T03:00:00Z,MDPP 198N 707W,0,0,3,5,8
Hurricane,Floyd,14,1999-09-11T03:00:00Z,COCOA BEACH FL,0,0,0,2,2
Hurricane,Floyd,14,1999-09-11T03:00:00Z,MBJT 215N 712W,0,0,6,6,12
Hurricane,Floyd,15,1999-09-11T09:00:00Z,23.3N  64.4W,48,0,0,0,48
Hurricane,Floyd,15,1999-09-11T09:00:00Z,MYEG 235N 758W,0,0,1,10,11
Hurricane,Floyd,15,1999-09-11T09:00:00Z,24.0N  66.5W,20,8,1,0,29
Hurricane,Floyd,15,1999-09-11T09:00:00Z,MYAK 241N 776W,0,0,0,9,9
Hurricane,Floyd,15,1999-09-11T09:00:00Z,24.5N  69.0W,0,15,5,2,22
Hurricane,Floyd,15,1999-09-11T09:00:00Z,MYNN 251N 775W,0,0,0,10,10
Hurricane,Floyd,15,1999-09-11T09:00:00Z,MDSD 185N 697W,0,0,0,2,2
Hurricane,Floyd,15,1999-09-11T09:00:00Z,MYGF 266N 787W,0,0,0,7,7
Hurricane,Floyd,15,1999-09-11T09:00:00Z,MTPP 186N 724W,0,0,0,2,2
Hurricane,Floyd,15,1999-09-11T09:00:00Z,MARATHON FL,0,0,0,3,3
Hurricane,Floyd,15,1999-09-11T09:00:00Z,MTCA 183N 738W,0,0,0,2,2
Hurricane,Floyd,15,1999-09-11T09:00:00Z,MIAMI FL,0,0,0,4,4
Hurricane,Floyd,15,1999-09-11T09:00:00Z,MUGM 200N 751W,0,0,0,5,5
Hurricane,Floyd,15,1999-09-11T09:00:00Z,W PALM BEACH FL,0,0,0,5,5
Hurricane,Floyd,15,1999-09-11T09:00:00Z,MUCM 214N 779W,0,0,0,5,5
Hurricane,Floyd,15,1999-09-11T09:00:00Z,FT PIERCE FL,0,0,0,4,4
Hurricane,Floyd,15,1999-09-11T09:00:00Z,MUCF 221N 805W,0,0,0,2,2
Hurricane,Floyd,15,1999-09-11T09:00:00Z,COCOA BEACH FL,0,0,0,3,3
Hurricane,Floyd,15,1999-09-11T09:00:00Z,MDPP 198N 707W,0,0,1,4,5
Hurricane,Floyd,15,1999-09-11T09:00:00Z,DAYTONA BEACH FL,0,0,0,2,2
Hurricane,Floyd,15,1999-09-11T09:00:00Z,MBJT 215N 712W,0,0,5,6,11
Hurricane,Floyd,15,1999-09-11T09:00:00Z,KEY WEST FL,0,0,0,2,2
Hurricane,Floyd,15,1999-09-11T09:00:00Z,MYMM 224N 730W,0,0,3,9,12
Hurricane,Floyd,15,1999-09-11T09:00:00Z,MARCO ISLAND FL,0,0,0,2,2
Hurricane,Floyd,15,1999-09-11T09:00:00Z,MYSM 241N 745W,0,0,2,12,14
Hurricane,Floyd,15,1999-09-11T09:00:00Z,FT MYERS FL,0,0,0,2,2
Hurricane,Floyd,16,1999-09-11T15:00:00Z,23.7N  65.4W,48,0,0,0,48
Hurricane,Floyd,16,1999-09-11T15:00:00Z,MYGF 266N 787W,0,0,0,9,9
Hurricane,Floyd,16,1999-09-11T15:00:00Z,24.5N  67.7W,19,9,0,0,28
Hurricane,Floyd,16,1999-09-11T15:00:00Z,MARATHON FL,0,0,0,4,4
Hurricane,Floyd,16,1999-09-11T15:00:00Z,25.0N  70.0W,0,16,3,2,21
Hurricane,Floyd,16,1999-09-11T15:00:00Z,MIAMI FL,0,0,0,6,6
Hurricane,Floyd,16,1999-09-11T15:00:00Z,MDSD 185N 697W,0,0,1,2,3
Hurricane,Floyd,16,1999-09-11T15:00:00Z,W PALM BEACH FL,0,0,0,6,6
Hurricane,Floyd,16,1999-09-11T15:00:00Z,MDCB 176N 714W,0,0,0,2,2
Hurricane,Floyd,16,1999-09-11T15:00:00Z,FT PIERCE FL,0,0,0,6,6
Hurricane,Floyd,16,1999-09-11T15:00:00Z,MTPP 186N 724W,0,0,1,2,3
Hurricane,Floyd,16,1999-09-11T15:00:00Z,COCOA BEACH FL,0,0,0,5,5
Hurricane,Floyd,16,1999-09-11T15:00:00Z,MTCA 183N 738W,0,0,0,2,2
Hurricane,Floyd,16,1999-09-11T15:00:00Z,DAYTONA BEACH FL,0,0,0,3,3
Hurricane,Floyd,16,1999-09-11T15:00:00Z,MUGM 200N 751W,0,0,0,5,5
Hurricane,Floyd,16,1999-09-11T15:00:00Z,JACKSONVILLE FL,0,0,0,2,2
Hurricane,Floyd,16,1999-09-11T15:00:00Z,MUCM 214N 779W,0,0,0,5,5
Hurricane,Floyd,16,1999-09-11T15:00:00Z,CHARLESTON SC,0,0,0,2,2
Hurricane,Floyd,16,1999-09-11T15:00:00Z,MUCF 221N 805W,0,0,0,3,3
Hurricane,Floyd,16,1999-09-11T15:00:00Z,MYRTLE BEACH SC,0,0,0,2,2
Hurricane,Floyd,16,1999-09-11T15:00:00Z,MDPP 198N 707W,0,0,3,3,6
Hurricane,Floyd,16,1999-09-11T15:00:00Z,WILMINGTON NC,0,0,0,2,2
Hurricane,Floyd,16,1999-09-11T15:00:00Z,MBJT 215N 712W,0,2,6,3,11
Hurricane,Floyd,16,1999-09-11T15:00:00Z,MOREHEAD CITY NC,0,0,0,2,2
Hurricane,Floyd,16,1999-09-11T15:00:00Z,MYMM 224N 730W,0,0,6,7,13
Hurricane,Floyd,16,1999-09-11T15:00:00Z,KEY WEST FL,0,0,0,3,3
Hurricane,Floyd,16,1999-09-11T15:00:00Z,MYSM 241N 745W,0,0,5,9,14
Hurricane,Floyd,16,1999-09-11T15:00:00Z,MARCO ISLAND FL,0,0,0,3,3
Hurricane,Floyd,16,1999-09-11T15:00:00Z,MYEG 235N 758W,0,0,2,10,12
Hurricane,Floyd,16,1999-09-11T15:00:00Z,FT MYERS FL,0,0,0,3,3
Hurricane,Floyd,16,1999-09-11T15:00:00Z,MYAK 241N 776W,0,0,0,10,10
Hurricane,Floyd,16,1999-09-11T15:00:00Z,VENICE FL,0,0,0,2,2
Hurricane,Floyd,16,1999-09-11T15:00:00Z,MYNN 251N 775W,0,0,1,10,11
Hurricane,Floyd,16,1999-09-11T15:00:00Z,TAMPA FL,0,0,0,2,2
Hurricane,Floyd,17,1999-09-11T21:00:00Z,23.9N  67.1W,42,0,0,0,42
Hurricane,Floyd,17,1999-09-11T21:00:00Z,MARATHON FL,0,0,0,8,8
Hurricane,Floyd,17,1999-09-11T21:00:00Z,24.4N  69.2W,15,11,1,0,27
Hurricane,Floyd,17,1999-09-11T21:00:00Z,MIAMI FL,0,0,0,10,10
Hurricane,Floyd,17,1999-09-11T21:00:00Z,25.0N  71.5W,0,13,7,1,21
Hurricane,Floyd,17,1999-09-11T21:00:00Z,W PALM BEACH FL,0,0,0,11,11
Hurricane,Floyd,17,1999-09-11T21:00:00Z,MUGM 200N 751W,0,0,0,2,2
Hurricane,Floyd,17,1999-09-11T21:00:00Z,FT PIERCE FL,0,0,0,10,10
Hurricane,Floyd,17,1999-09-11T21:00:00Z,MUCM 214N 779W,0,0,0,5,5
Hurricane,Floyd,17,1999-09-11T21:00:00Z,COCOA BEACH FL,0,0,0,9,9
Hurricane,Floyd,17,1999-09-11T21:00:00Z,MUCF 221N 805W,0,0,0,4,4
Hurricane,Floyd,17,1999-09-11T21:00:00Z,DAYTONA BEACH FL,0,0,0,6,6
Hurricane,Floyd,17,1999-09-11T21:00:00Z,MUHA 230N 824W,0,0,0,3,3
Hurricane,Floyd,17,1999-09-11T21:00:00Z,JACKSONVILLE FL,0,0,0,3,3
Hurricane,Floyd,17,1999-09-11T21:00:00Z,MBJT 215N 712W,0,4,4,1,9
Hurricane,Floyd,17,1999-09-11T21:00:00Z,SAVANNAH GA,0,0,0,2,2
Hurricane,Floyd,17,1999-09-11T21:00:00Z,MYMM 224N 730W,0,2,7,3,12
Hurricane,Floyd,17,1999-09-11T21:00:00Z,KEY WEST FL,0,0,0,6,6
Hurricane,Floyd,17,1999-09-11T21:00:00Z,MYSM 241N 745W,0,1,8,7,16
Hurricane,Floyd,17,1999-09-11T21:00:00Z,MARCO ISLAND FL,0,0,0,7,7
Hurricane,Floyd,17,1999-09-11T21:00:00Z,MYEG 235N 758W,0,0,4,9,13
Hurricane,Floyd,17,1999-09-11T21:00:00Z,FT MYERS FL,0,0,0,7,7
Hurricane,Floyd,17,1999-09-11T21:00:00Z,MYAK 241N 776W,0,0,1,11,12
Hurricane,Floyd,17,1999-09-11T21:00:00Z,VENICE FL,0,0,0,6,6
Hurricane,Floyd,17,1999-09-11T21:00:00Z,MYNN 251N 775W,0,0,1,13,14
Hurricane,Floyd,17,1999-09-11T21:00:00Z,TAMPA FL,0,0,0,5,5
Hurricane,Floyd,17,1999-09-11T21:00:00Z,MYGF 266N 787W,0,0,0,13,13
Hurricane,Floyd,17,1999-09-11T21:00:00Z,CEDAR KEY FL,0,0,0,3,3
Hurricane,Floyd,18,1999-09-12T03:00:00Z,23.2N  68.3W,41,0,0,0,41
Hurricane,Floyd,18,1999-09-12T03:00:00Z,W PALM BEACH FL,0,0,0,14,14
Hurricane,Floyd,18,1999-09-12T03:00:00Z,23.5N  70.5W,14,13,0,1,28
Hurricane,Floyd,18,1999-09-12T03:00:00Z,FT PIERCE FL,0,0,0,14,14
Hurricane,Floyd,18,1999-09-12T03:00:00Z,24.5N  73.5W,0,9,14,1,24
Hurricane,Floyd,18,1999-09-12T03:00:00Z,COCOA BEACH FL,0,0,0,13,13
Hurricane,Floyd,18,1999-09-12T03:00:00Z,MDSD 185N 697W,0,1,1,0,2
Hurricane,Floyd,18,1999-09-12T03:00:00Z,DAYTONA BEACH FL,0,0,0,11,11
Hurricane,Floyd,18,1999-09-12T03:00:00Z,MTPP 186N 724W,0,1,1,0,2
Hurricane,Floyd,18,1999-09-12T03:00:00Z,JACKSONVILLE FL,0,0,0,8,8
Hurricane,Floyd,18,1999-09-12T03:00:00Z,MUGM 200N 751W,0,0,3,3,6
Hurricane,Floyd,18,1999-09-12T03:00:00Z,SAVANNAH GA,0,0,0,6,6
Hurricane,Floyd,18,1999-09-12T03:00:00Z,MUCM 214N 779W,0,0,1,7,8
Hurricane,Floyd,18,1999-09-12T03:00:00Z,CHARLESTON SC,0,0,0,5,5
Hurricane,Floyd,18,1999-09-12T03:00:00Z,MUCF 221N 805W,0,0,0,7,7
Hurricane,Floyd,18,1999-09-12T03:00:00Z,MYRTLE BEACH SC,0,0,0,4,4
Hurricane,Floyd,18,1999-09-12T03:00:00Z,MUSN 216N 826W,0,0,0,2,2
Hurricane,Floyd,18,1999-09-12T03:00:00Z,WILMINGTON NC,0,0,0,3,3
Hurricane,Floyd,18,1999-09-12T03:00:00Z,MUHA 230N 824W,0,0,0,5,5
Hurricane,Floyd,18,1999-09-12T03:00:00Z,MOREHEAD CITY NC,0,0,0,2,2
Hurricane,Floyd,18,1999-09-12T03:00:00Z,MDPP 198N 707W,1,6,2,0,9
Hurricane,Floyd,18,1999-09-12T03:00:00Z,KEY WEST FL,0,0,0,9,9
Hurricane,Floyd,18,1999-09-12T03:00:00Z,MBJT 215N 712W,3,13,3,0,19
Hurricane,Floyd,18,1999-09-12T03:00:00Z,MARCO ISLAND FL,0,0,0,11,11
Hurricane,Floyd,18,1999-09-12T03:00:00Z,MYMM 224N 730W,0,11,9,1,21
Hurricane,Floyd,18,1999-09-12T03:00:00Z,FT MYERS FL,0,0,0,11,11
Hurricane,Floyd,18,1999-09-12T03:00:00Z,MYSM 241N 745W,0,3,16,2,21
Hurricane,Floyd,18,1999-09-12T03:00:00Z,VENICE FL,0,0,0,9,9
Hurricane,Floyd,18,1999-09-12T03:00:00Z,MYEG 235N 758W,0,0,13,4,17
Hurricane,Floyd,18,1999-09-12T03:00:00Z,TAMPA FL,0,0,0,9,9
Hurricane,Floyd,18,1999-09-12T03:00:00Z,MYAK 241N 776W,0,0,5,11,16
Hurricane,Floyd,18,1999-09-12T03:00:00Z,CEDAR KEY FL,0,0,0,7,7
Hurricane,Floyd,18,1999-09-12T03:00:00Z,MYNN 251N 775W,0,0,5,12,17
Hurricane,Floyd,18,1999-09-12T03:00:00Z,ST MARKS FL,0,0,0,4,4
Hurricane,Floyd,18,1999-09-12T03:00:00Z,MYGF 266N 787W,0,0,1,15,16
Hurricane,Floyd,18,1999-09-12T03:00:00Z,APALACHICOLA FL,0,0,0,3,3
Hurricane,Floyd,18,1999-09-12T03:00:00Z,MARATHON FL,0,0,0,11,11
Hurricane,Floyd,18,1999-09-12T03:00:00Z,PANAMA CITY FL,0,0,0,2,2
Hurricane,Floyd,18,1999-09-12T03:00:00Z,MIAMI FL,0,0,0,13,13
Hurricane,Floyd,18,1999-09-12T03:00:00Z,GULF 29N 85W,0,0,0,3,3
Hurricane,Floyd,19,1999-09-12T09:00:00Z,23.4N  70.1W,53,0,0,0,53
Hurricane,Floyd,19,1999-09-12T09:00:00Z,COCOA BEACH FL,0,0,0,16,16
Hurricane,Floyd,19,1999-09-12T09:00:00Z,24.1N  72.6W,4,34,0,0,38
Hurricane,Floyd,19,1999-09-12T09:00:00Z,DAYTONA BEACH FL,0,0,0,14,14
Hurricane,Floyd,19,1999-09-12T09:00:00Z,25.0N  75.0W,0,9,18,1,28
Hurricane,Floyd,19,1999-09-12T09:00:00Z,JACKSONVILLE FL,0,0,0,10,10
Hurricane,Floyd,19,1999-09-12T09:00:00Z,MUGM 200N 751W,0,0,1,1,2
Hurricane,Floyd,19,1999-09-12T09:00:00Z,SAVANNAH GA,0,0,0,6,6
Hurricane,Floyd,19,1999-09-12T09:00:00Z,MUCM 214N 779W,0,0,1,5,6
Hurricane,Floyd,19,1999-09-12T09:00:00Z,CHARLESTON SC,0,0,0,4,4
Hurricane,Floyd,19,1999-09-12T09:00:00Z,MUCF 221N 805W,0,0,0,5,5
Hurricane,Floyd,19,1999-09-12T09:00:00Z,MYRTLE BEACH SC,0,0,0,2,2
Hurricane,Floyd,19,1999-09-12T09:00:00Z,MUHA 230N 824W,0,0,0,5,5
Hurricane,Floyd,19,1999-09-12T09:00:00Z,KEY WEST FL,0,0,0,10,10
Hurricane,Floyd,19,1999-09-12T09:00:00Z,MBJT 215N 712W,7,11,0,1,19
Hurricane,Floyd,19,1999-09-12T09:00:00Z,MARCO ISLAND FL,0,0,0,13,13
Hurricane,Floyd,19,1999-09-12T09:00:00Z,MYMM 224N 730W,1,21,1,0,23
Hurricane,Floyd,19,1999-09-12T09:00:00Z,FT MYERS FL,0,0,0,14,14
Hurricane,Floyd,19,1999-09-12T09:00:00Z,MYSM 241N 745W,0,17,11,0,28
Hurricane,Floyd,19,1999-09-12T09:00:00Z,VENICE FL,0,0,0,13,13
Hurricane,Floyd,19,1999-09-12T09:00:00Z,MYEG 235N 758W,0,3,17,1,21
Hurricane,Floyd,19,1999-09-12T09:00:00Z,TAMPA FL,0,0,0,13,13
Hurricane,Floyd,19,1999-09-12T09:00:00Z,MYAK 241N 776W,0,0,11,8,19
Hurricane,Floyd,19,1999-09-12T09:00:00Z,CEDAR KEY FL,0,0,0,11,11
Hurricane,Floyd,19,1999-09-12T09:00:00Z,MYNN 251N 775W,0,0,14,7,21
Hurricane,Floyd,19,1999-09-12T09:00:00Z,ST MARKS FL,0,0,0,7,7
Hurricane,Floyd,19,1999-09-12T09:00:00Z,MYGF 266N 787W,0,0,4,16,20
Hurricane,Floyd,19,1999-09-12T09:00:00Z,APALACHICOLA FL,0,0,0,6,6
Hurricane,Floyd,19,1999-09-12T09:00:00Z,MARATHON FL,0,0,0,12,12
Hurricane,Floyd,19,1999-09-12T09:00:00Z,PANAMA CITY FL,0,0,0,5,5
Hurricane,Floyd,19,1999-09-12T09:00:00Z,MIAMI FL,0,0,1,15,16
Hurricane,Floyd,19,1999-09-12T09:00:00Z,PENSACOLA FL,0,0,0,2,2
Hurricane,Floyd,19,1999-09-12T09:00:00Z,W PALM BEACH FL,0,0,1,16,17
Hurricane,Floyd,19,1999-09-12T09:00:00Z,GULF 29N 85W,0,0,0,7,7
Hurricane,Floyd,19,1999-09-12T09:00:00Z,FT PIERCE FL,0,0,0,17,17
Hurricane,Floyd,19,1999-09-12T09:00:00Z,GULF 29N 87W,0,0,0,3,3
Hurricane,Floyd,20,1999-09-12T15:00:00Z,23.7N  70.8W,51,0,0,0,51
Hurricane,Floyd,20,1999-09-12T15:00:00Z,JACKSONVILLE FL,0,0,0,15,15
Hurricane,Floyd,20,1999-09-12T15:00:00Z,24.5N  73.5W,3,35,0,0,38
Hurricane,Floyd,20,1999-09-12T15:00:00Z,SAVANNAH GA,0,0,0,11,11
Hurricane,Floyd,20,1999-09-12T15:00:00Z,25.5N  76.0W,0,7,22,1,30
Hurricane,Floyd,20,1999-09-12T15:00:00Z,CHARLESTON SC,0,0,0,7,7
Hurricane,Floyd,20,1999-09-12T15:00:00Z,MUCM 214N 779W,0,0,1,3,4
Hurricane,Floyd,20,1999-09-12T15:00:00Z,MYRTLE BEACH SC,0,0,0,4,4
Hurricane,Floyd,20,1999-09-12T15:00:00Z,MUCF 221N 805W,0,0,0,3,3
Hurricane,Floyd,20,1999-09-12T15:00:00Z,WILMINGTON NC,0,0,0,2,2
Hurricane,Floyd,20,1999-09-12T15:00:00Z,MUHA 230N 824W,0,0,0,3,3
Hurricane,Floyd,20,1999-09-12T15:00:00Z,KEY WEST FL,0,0,0,9,9
Hurricane,Floyd,20,1999-09-12T15:00:00Z,MBJT 215N 712W,10,4,0,0,14
Hurricane,Floyd,20,1999-09-12T15:00:00Z,MARCO ISLAND FL,0,0,0,14,14
Hurricane,Floyd,20,1999-09-12T15:00:00Z,MYMM 224N 730W,6,19,0,0,25
Hurricane,Floyd,20,1999-09-12T15:00:00Z,FT MYERS FL,0,0,0,14,14
Hurricane,Floyd,20,1999-09-12T15:00:00Z,MYSM 241N 745W,0,28,4,1,33
Hurricane,Floyd,20,1999-09-12T15:00:00Z,VENICE FL,0,0,0,14,14
Hurricane,Floyd,20,1999-09-12T15:00:00Z,MYEG 235N 758W,0,9,13,1,23
Hurricane,Floyd,20,1999-09-12T15:00:00Z,TAMPA FL,0,0,0,15,15
Hurricane,Floyd,20,1999-09-12T15:00:00Z,MYAK 241N 776W,0,0,15,4,19
Hurricane,Floyd,20,1999-09-12T15:00:00Z,CEDAR KEY FL,0,0,0,14,14
Hurricane,Floyd,20,1999-09-12T15:00:00Z,MYNN 251N 775W,0,1,19,4,24
Hurricane,Floyd,20,1999-09-12T15:00:00Z,ST MARKS FL,0,0,0,11,11
Hurricane,Floyd,20,1999-09-12T15:00:00Z,MYGF 266N 787W,0,0,11,12,23
Hurricane,Floyd,20,1999-09-12T15:00:00Z,APALACHICOLA FL,0,0,0,9,9
Hurricane,Floyd,20,1999-09-12T15:00:00Z,MARATHON FL,0,0,0,11,11
Hurricane,Floyd,20,1999-09-12T15:00:00Z,PANAMA CITY FL,0,0,0,7,7
Hurricane,Floyd,20,1999-09-12T15:00:00Z,MIAMI FL,0,0,2,15,17
Hurricane,Floyd,20,1999-09-12T15:00:00Z,PENSACOLA FL,0,0,0,4,4
Hurricane,Floyd,20,1999-09-12T15:00:00Z,W PALM BEACH FL,0,0,3,16,19
Hurricane,Floyd,20,1999-09-12T15:00:00Z,MOBILE AL,0,0,0,2,2
Hurricane,Floyd,20,1999-09-12T15:00:00Z,FT PIERCE FL,0,0,1,19,20
Hurricane,Floyd,20,1999-09-12T15:00:00Z,GULF 29N 85W,0,0,0,9,9
Hurricane,Floyd,20,1999-09-12T15:00:00Z,COCOA BEACH FL,0,0,1,18,19
Hurricane,Floyd,20,1999-09-12T15:00:00Z,GULF 29N 87W,0,0,0,4,4
Hurricane,Floyd,20,1999-09-12T15:00:00Z,DAYTONA BEACH FL,0,0,0,17,17
Hurricane,Floyd,21,1999-09-12T21:00:00Z,24.4N  72.7W,54,0,0,0,54
Hurricane,Floyd,21,1999-09-12T21:00:00Z,JACKSONVILLE FL,0,0,1,15,16
Hurricane,Floyd,21,1999-09-12T21:00:00Z,25.2N  75.2W,4,34,0,0,38
Hurricane,Floyd,21,1999-09-12T21:00:00Z,SAVANNAH GA,0,0,0,12,12
Hurricane,Floyd,21,1999-09-12T21:00:00Z,26.5N  77.5W,0,9,19,1,29
Hurricane,Floyd,21,1999-09-12T21:00:00Z,CHARLESTON SC,0,0,0,9,9
Hurricane,Floyd,21,1999-09-12T21:00:00Z,MUCM 214N 779W,0,0,2,2,4
Hurricane,Floyd,21,1999-09-12T21:00:00Z,MYRTLE BEACH SC,0,0,0,6,6
Hurricane,Floyd,21,1999-09-12T21:00:00Z,MUCF 221N 805W,0,0,1,3,4
Hurricane,Floyd,21,1999-09-12T21:00:00Z,WILMINGTON NC,0,0,0,3,3
Hurricane,Floyd,21,1999-09-12T21:00:00Z,MUHA 230N 824W,0,0,0,4,4
Hurricane,Floyd,21,1999-09-12T21:00:00Z,KEY WEST FL,0,0,1,9,10
Hurricane,Floyd,21,1999-09-12T21:00:00Z,MBJT 215N 712W,8,1,0,0,9
Hurricane,Floyd,21,1999-09-12T21:00:00Z,MARCO ISLAND FL,0,0,3,12,15
Hurricane,Floyd,21,1999-09-12T21:00:00Z,MYMM 224N 730W,19,6,0,1,26
Hurricane,Floyd,21,1999-09-12T21:00:00Z,FT MYERS FL,0,0,3,12,15
Hurricane,Floyd,21,1999-09-12T21:00:00Z,MYSM 241N 745W,13,25,0,0,38
Hurricane,Floyd,21,1999-09-12T21:00:00Z,VENICE FL,0,0,1,14,15
Hurricane,Floyd,21,1999-09-12T21:00:00Z,MYEG 235N 758W,0,23,2,0,25
Hurricane,Floyd,21,1999-09-12T21:00:00Z,TAMPA FL,0,0,1,15,16
Hurricane,Floyd,21,1999-09-12T21:00:00Z,MYAK 241N 776W,0,8,12,1,21
Hurricane,Floyd,21,1999-09-12T21:00:00Z,CEDAR KEY FL,0,0,0,15,15
Hurricane,Floyd,21,1999-09-12T21:00:00Z,MYNN 251N 775W,0,12,14,1,27
Hurricane,Floyd,21,1999-09-12T21:00:00Z,ST MARKS FL,0,0,0,12,12
Hurricane,Floyd,21,1999-09-12T21:00:00Z,MYGF 266N 787W,0,2,20,3,25
Hurricane,Floyd,21,1999-09-12T21:00:00Z,APALACHICOLA FL,0,0,0,10,10
Hurricane,Floyd,21,1999-09-12T21:00:00Z,MARATHON FL,0,0,4,8,12
Hurricane,Floyd,21,1999-09-12T21:00:00Z,PANAMA CITY FL,0,0,0,9,9
Hurricane,Floyd,21,1999-09-12T21:00:00Z,MIAMI FL,0,0,10,8,18
Hurricane,Floyd,21,1999-09-12T21:00:00Z,PENSACOLA FL,0,0,0,5,5
Hurricane,Floyd,21,1999-09-12T21:00:00Z,W PALM BEACH FL,0,0,13,8,21
Hurricane,Floyd,21,1999-09-12T21:00:00Z,MOBILE AL,0,0,0,3,3
Hurricane,Floyd,21,1999-09-12T21:00:00Z,FT PIERCE FL,0,0,11,10,21
Hurricane,Floyd,21,1999-09-12T21:00:00Z,GULFPORT MS,0,0,0,2,2
Hurricane,Floyd,21,1999-09-12T21:00:00Z,COCOA BEACH FL,0,0,7,13,20
Hurricane,Floyd,21,1999-09-12T21:00:00Z,GULF 29N 85W,0,0,0,10,10
Hurricane,Floyd,21,1999-09-12T21:00:00Z,DAYTONA BEACH FL,0,0,3,15,18
Hurricane,Floyd,21,1999-09-12T21:00:00Z,GULF 29N 87W,0,0,0,5,5
Hurricane,Floyd,22,1999-09-13T03:00:00Z,24.8N  73.8W,54,0,0,0,54
Hurricane,Floyd,22,1999-09-13T03:00:00Z,SAVANNAH GA,0,0,0,14,14
Hurricane,Floyd,22,1999-09-13T03:00:00Z,25.9N  76.3W,4,35,0,0,39
Hurricane,Floyd,22,1999-09-13T03:00:00Z,CHARLESTON SC,0,0,0,11,11
Hurricane,Floyd,22,1999-09-13T03:00:00Z,27.2N  78.3W,0,12,15,1,28
Hurricane,Floyd,22,1999-09-13T03:00:00Z,MYRTLE BEACH SC,0,0,0,7,7
Hurricane,Floyd,22,1999-09-13T03:00:00Z,MUCF 221N 805W,0,0,1,1,2
Hurricane,Floyd,22,1999-09-13T03:00:00Z,WILMINGTON NC,0,0,0,4,4
Hurricane,Floyd,22,1999-09-13T03:00:00Z,MUHA 230N 824W,0,0,1,1,2
Hurricane,Floyd,22,1999-09-13T03:00:00Z,MOREHEAD CITY NC,0,0,0,2,2
Hurricane,Floyd,22,1999-09-13T03:00:00Z,MBJT 215N 712W,2,0,0,0,2
Hurricane,Floyd,22,1999-09-13T03:00:00Z,KEY WEST FL,0,0,4,5,9
Hurricane,Floyd,22,1999-09-13T03:00:00Z,MYMM 224N 730W,17,1,0,0,18
Hurricane,Floyd,22,1999-09-13T03:00:00Z,MARCO ISLAND FL,0,0,8,7,15
Hurricane,Floyd,22,1999-09-13T03:00:00Z,MYSM 241N 745W,39,4,0,0,43
Hurricane,Floyd,22,1999-09-13T03:00:00Z,FT MYERS FL,0,0,7,9,16
Hurricane,Floyd,22,1999-09-13T03:00:00Z,MYEG 235N 758W,6,20,0,0,26
Hurricane,Floyd,22,1999-09-13T03:00:00Z,VENICE FL,0,0,4,11,15
Hurricane,Floyd,22,1999-09-13T03:00:00Z,MYAK 241N 776W,0,19,3,0,22
Hurricane,Floyd,22,1999-09-13T03:00:00Z,TAMPA FL,0,0,3,14,17
Hurricane,Floyd,22,1999-09-13T03:00:00Z,MYNN 251N 775W,0,27,2,1,30
Hurricane,Floyd,22,1999-09-13T03:00:00Z,CEDAR KEY FL,0,0,1,15,16
Hurricane,Floyd,22,1999-09-13T03:00:00Z,MYGF 266N 787W,0,11,16,0,27
Hurricane,Floyd,22,1999-09-13T03:00:00Z,ST MARKS FL,0,0,0,13,13
Hurricane,Floyd,22,1999-09-13T03:00:00Z,MARATHON FL,0,0,8,4,12
Hurricane,Floyd,22,1999-09-13T03:00:00Z,APALACHICOLA FL,0,0,0,11,11
Hurricane,Floyd,22,1999-09-13T03:00:00Z,MIAMI FL,0,1,16,2,19
Hurricane,Floyd,22,1999-09-13T03:00:00Z,PANAMA CITY FL,0,0,0,10,10
Hurricane,Floyd,22,1999-09-13T03:00:00Z,W PALM BEACH FL,0,1,18,3,22
Hurricane,Floyd,22,1999-09-13T03:00:00Z,PENSACOLA FL,0,0,0,6,6
Hurricane,Floyd,22,1999-09-13T03:00:00Z,FT PIERCE FL,0,0,18,4,22
Hurricane,Floyd,22,1999-09-13T03:00:00Z,MOBILE AL,0,0,0,3,3
Hurricane,Floyd,22,1999-09-13T03:00:00Z,COCOA BEACH FL,0,0,14,7,21
Hurricane,Floyd,22,1999-09-13T03:00:00Z,GULFPORT MS,0,0,0,2,2
Hurricane,Floyd,22,1999-09-13T03:00:00Z,DAYTONA BEACH FL,0,0,7,13,20
Hurricane,Floyd,22,1999-09-13T03:00:00Z,GULF 29N 85W,0,0,0,11,11
Hurricane,Floyd,22,1999-09-13T03:00:00Z,JACKSONVILLE FL,0,0,1,16,17
Hurricane,Floyd,22,1999-09-13T03:00:00Z,GULF 29N 87W,0,0,0,5,5
Hurricane,Floyd,23,1999-09-13T09:00:00Z,24.8N  75.0W,47,1,0,0,48
Hurricane,Floyd,23,1999-09-13T09:00:00Z,WILMINGTON NC,0,0,0,7,7
Hurricane,Floyd,23,1999-09-13T09:00:00Z,25.8N  77.2W,7,27,1,0,35
Hurricane,Floyd,23,1999-09-13T09:00:00Z,MOREHEAD CITY NC,0,0,0,4,4
Hurricane,Floyd,23,1999-09-13T09:00:00Z,27.5N  79.0W,0,7,18,1,26
Hurricane,Floyd,23,1999-09-13T09:00:00Z,CAPE HATTERAS NC,0,0,0,2,2
Hurricane,Floyd,23,1999-09-13T09:00:00Z,MYMM 224N 730W,33,0,0,0,33
Hurricane,Floyd,23,1999-09-13T09:00:00Z,KEY WEST FL,0,0,4,2,6
Hurricane,Floyd,23,1999-09-13T09:00:00Z,MYSM 241N 745W,50,0,0,0,50
Hurricane,Floyd,23,1999-09-13T09:00:00Z,MARCO ISLAND FL,0,0,9,3,12
Hurricane,Floyd,23,1999-09-13T09:00:00Z,MYEG 235N 758W,24,5,0,1,30
Hurricane,Floyd,23,1999-09-13T09:00:00Z,FT MYERS FL,0,0,9,5,14
Hurricane,Floyd,23,1999-09-13T09:00:00Z,MYAK 241N 776W,3,20,1,0,24
Hurricane,Floyd,23,1999-09-13T09:00:00Z,VENICE FL,0,0,6,7,13
Hurricane,Floyd,23,1999-09-13T09:00:00Z,MYNN 251N 775W,4,26,1,0,31
Hurricane,Floyd,23,1999-09-13T09:00:00Z,TAMPA FL,0,0,6,9,15
Hurricane,Floyd,23,1999-09-13T09:00:00Z,MYGF 266N 787W,0,16,12,0,28
Hurricane,Floyd,23,1999-09-13T09:00:00Z,CEDAR KEY FL,0,0,3,12,15
Hurricane,Floyd,23,1999-09-13T09:00:00Z,MARATHON FL,0,1,6,2,9
Hurricane,Floyd,23,1999-09-13T09:00:00Z,ST MARKS FL,0,0,0,13,13
Hurricane,Floyd,23,1999-09-13T09:00:00Z,MIAMI FL,0,3,14,1,18
Hurricane,Floyd,23,1999-09-13T09:00:00Z,APALACHICOLA FL,0,0,0,11,11
Hurricane,Floyd,23,1999-09-13T09:00:00Z,W PALM BEACH FL,0,3,17,1,21
Hurricane,Floyd,23,1999-09-13T09:00:00Z,PANAMA CITY FL,0,0,0,10,10
Hurricane,Floyd,23,1999-09-13T09:00:00Z,FT PIERCE FL,0,1,18,2,21
Hurricane,Floyd,23,1999-09-13T09:00:00Z,PENSACOLA FL,0,0,0,7,7
Hurricane,Floyd,23,1999-09-13T09:00:00Z,COCOA BEACH FL,0,0,16,4,20
Hurricane,Floyd,23,1999-09-13T09:00:00Z,MOBILE AL,0,0,0,5,5
Hurricane,Floyd,23,1999-09-13T09:00:00Z,DAYTONA BEACH FL,0,0,10,9,19
Hurricane,Floyd,23,1999-09-13T09:00:00Z,GULFPORT MS,0,0,0,3,3
Hurricane,Floyd,23,1999-09-13T09:00:00Z,JACKSONVILLE FL,0,0,3,14,17
Hurricane,Floyd,23,1999-09-13T09:00:00Z,BURAS LA,0,0,0,2,2
Hurricane,Floyd,23,1999-09-13T09:00:00Z,SAVANNAH GA,0,0,1,14,15
Hurricane,Floyd,23,1999-09-13T09:00:00Z,NEW ORLEANS LA,0,0,0,2,2
Hurricane,Floyd,23,1999-09-13T09:00:00Z,CHARLESTON SC,0,0,0,13,13
Hurricane,Floyd,23,1999-09-13T09:00:00Z,GULF 29N 85W,0,0,0,10,10
Hurricane,Floyd,23,1999-09-13T09:00:00Z,MYRTLE BEACH SC,0,0,0,10,10
Hurricane,Floyd,23,1999-09-13T09:00:00Z,GULF 29N 87W,0,0,0,5,5
Hurricane,Floyd,24,1999-09-13T15:00:00Z,25.5N  76.5W,49,0,1,0,50
Hurricane,Floyd,24,1999-09-13T15:00:00Z,MYRTLE BEACH SC,0,0,2,15,17
Hurricane,Floyd,24,1999-09-13T15:00:00Z,27.3N  78.8W,2,33,1,0,36
Hurricane,Floyd,24,1999-09-13T15:00:00Z,WILMINGTON NC,0,0,1,14,15
Hurricane,Floyd,24,1999-09-13T15:00:00Z,29.6N  80.3W,0,5,21,1,27
Hurricane,Floyd,24,1999-09-13T15:00:00Z,MOREHEAD CITY NC,0,0,0,12,12
Hurricane,Floyd,24,1999-09-13T15:00:00Z,MYMM 224N 730W,19,0,0,0,19
Hurricane,Floyd,24,1999-09-13T15:00:00Z,CAPE HATTERAS NC,0,0,0,9,9
Hurricane,Floyd,24,1999-09-13T15:00:00Z,MYSM 241N 745W,66,0,0,0,66
Hurricane,Floyd,24,1999-09-13T15:00:00Z,NORFOLK VA,0,0,0,7,7
Hurricane,Floyd,24,1999-09-13T15:00:00Z,MYEG 235N 758W,35,0,0,0,35
Hurricane,Floyd,24,1999-09-13T15:00:00Z,OCEAN CITY MD,0,0,0,2,2
Hurricane,Floyd,24,1999-09-13T15:00:00Z,MYAK 241N 776W,18,7,0,0,25
Hurricane,Floyd,24,1999-09-13T15:00:00Z,KEY WEST FL,0,1,2,0,3
Hurricane,Floyd,24,1999-09-13T15:00:00Z,MYNN 251N 775W,30,9,0,0,39
Hurricane,Floyd,24,1999-09-13T15:00:00Z,MARCO ISLAND FL,0,5,6,1,12
Hurricane,Floyd,24,1999-09-13T15:00:00Z,MYGF 266N 787W,4,32,1,0,37
Hurricane,Floyd,24,1999-09-13T15:00:00Z,FT MYERS FL,0,4,10,0,14
Hurricane,Floyd,24,1999-09-13T15:00:00Z,MARATHON FL,0,4,2,0,6
Hurricane,Floyd,24,1999-09-13T15:00:00Z,VENICE FL,0,2,10,1,13
Hurricane,Floyd,24,1999-09-13T15:00:00Z,MIAMI FL,0,17,3,0,20
Hurricane,Floyd,24,1999-09-13T15:00:00Z,TAMPA FL,0,1,14,1,16
Hurricane,Floyd,24,1999-09-13T15:00:00Z,W PALM BEACH FL,0,23,4,0,27
Hurricane,Floyd,24,1999-09-13T15:00:00Z,CEDAR KEY FL,0,0,13,3,16
Hurricane,Floyd,24,1999-09-13T15:00:00Z,FT PIERCE FL,0,20,8,0,28
Hurricane,Floyd,24,1999-09-13T15:00:00Z,ST MARKS FL,0,0,5,8,13
Hurricane,Floyd,24,1999-09-13T15:00:00Z,COCOA BEACH FL,0,13,14,0,27
Hurricane,Floyd,24,1999-09-13T15:00:00Z,APALACHICOLA FL,0,0,3,6,9
Hurricane,Floyd,24,1999-09-13T15:00:00Z,DAYTONA BEACH FL,0,4,20,1,25
Hurricane,Floyd,24,1999-09-13T15:00:00Z,PANAMA CITY FL,0,0,1,6,7
Hurricane,Floyd,24,1999-09-13T15:00:00Z,JACKSONVILLE FL,0,0,18,4,22
Hurricane,Floyd,24,1999-09-13T15:00:00Z,PENSACOLA FL,0,0,0,3,3
Hurricane,Floyd,24,1999-09-13T15:00:00Z,SAVANNAH GA,0,0,10,11,21
Hurricane,Floyd,24,1999-09-13T15:00:00Z,GULF 29N 85W,0,0,3,4,7
Hurricane,Floyd,24,1999-09-13T15:00:00Z,CHARLESTON SC,0,0,6,14,20
Hurricane,Floyd,24,1999-09-13T15:00:00Z,GULF 29N 87W,0,0,0,2,2
Hurricane,Floyd,25,1999-09-13T21:00:00Z,26.2N  78.3W,51,0,0,0,51
Hurricane,Floyd,25,1999-09-13T21:00:00Z,WILMINGTON NC,0,0,3,15,18
Hurricane,Floyd,25,1999-09-13T21:00:00Z,28.4N  79.9W,5,31,0,0,36
Hurricane,Floyd,25,1999-09-13T21:00:00Z,MOREHEAD CITY NC,0,0,1,15,16
Hurricane,Floyd,25,1999-09-13T21:00:00Z,30.9N  80.5W,0,8,18,0,26
Hurricane,Floyd,25,1999-09-13T21:00:00Z,CAPE HATTERAS NC,0,0,0,14,14
Hurricane,Floyd,25,1999-09-13T21:00:00Z,MYSM 241N 745W,99,0,0,0,99
Hurricane,Floyd,25,1999-09-13T21:00:00Z,NORFOLK VA,0,0,0,13,13
Hurricane,Floyd,25,1999-09-13T21:00:00Z,MYEG 235N 758W,62,0,0,0,62
Hurricane,Floyd,25,1999-09-13T21:00:00Z,OCEAN CITY MD,0,0,0,9,9
Hurricane,Floyd,25,1999-09-13T21:00:00Z,MYAK 241N 776W,44,0,0,0,44
Hurricane,Floyd,25,1999-09-13T21:00:00Z,ATLANTIC CITY NJ,0,0,0,5,5
Hurricane,Floyd,25,1999-09-13T21:00:00Z,MYNN 251N 775W,59,0,0,0,59
Hurricane,Floyd,25,1999-09-13T21:00:00Z,NEW YORK CITY NY,0,0,0,2,2
Hurricane,Floyd,25,1999-09-13T21:00:00Z,MYGF 266N 787W,44,3,0,0,47
Hurricane,Floyd,25,1999-09-13T21:00:00Z,KEY WEST FL,0,2,1,0,3
Hurricane,Floyd,25,1999-09-13T21:00:00Z,MARATHON FL,1,6,1,0,8
Hurricane,Floyd,25,1999-09-13T21:00:00Z,MARCO ISLAND FL,0,12,1,0,13
Hurricane,Floyd,25,1999-09-13T21:00:00Z,MIAMI FL,10,16,0,1,27
Hurricane,Floyd,25,1999-09-13T21:00:00Z,FT MYERS FL,0,12,3,0,15
Hurricane,Floyd,25,1999-09-13T21:00:00Z,W PALM BEACH FL,14,20,1,0,35
Hurricane,Floyd,25,1999-09-13T21:00:00Z,VENICE FL,0,7,5,1,13
Hurricane,Floyd,25,1999-09-13T21:00:00Z,FT PIERCE FL,7,27,0,0,34
Hurricane,Floyd,25,1999-09-13T21:00:00Z,TAMPA FL,0,7,9,0,16
Hurricane,Floyd,25,1999-09-13T21:00:00Z,COCOA BEACH FL,2,29,1,0,32
Hurricane,Floyd,25,1999-09-13T21:00:00Z,CEDAR KEY FL,0,2,13,0,15
Hurricane,Floyd,25,1999-09-13T21:00:00Z,DAYTONA BEACH FL,0,19,8,1,28
Hurricane,Floyd,25,1999-09-13T21:00:00Z,ST MARKS FL,0,0,7,4,11
Hurricane,Floyd,25,1999-09-13T21:00:00Z,JACKSONVILLE FL,0,4,18,1,23
Hurricane,Floyd,25,1999-09-13T21:00:00Z,APALACHICOLA FL,0,0,3,3,6
Hurricane,Floyd,25,1999-09-13T21:00:00Z,SAVANNAH GA,0,1,16,5,22
Hurricane,Floyd,25,1999-09-13T21:00:00Z,PANAMA CITY FL,0,0,2,3,5
Hurricane,Floyd,25,1999-09-13T21:00:00Z,CHARLESTON SC,0,0,14,8,22
Hurricane,Floyd,25,1999-09-13T21:00:00Z,PENSACOLA FL,0,0,0,2,2
Hurricane,Floyd,25,1999-09-13T21:00:00Z,MYRTLE BEACH SC,0,0,8,12,20
Hurricane,Floyd,25,1999-09-13T21:00:00Z,GULF 29N 85W,0,0,3,2,5
Hurricane,Floyd,26,1999-09-14T03:00:00Z,27.0N  79.0W,52,0,0,0,52
Hurricane,Floyd,26,1999-09-14T03:00:00Z,MIAMI FL,19,5,0,0,24
Hurricane,Floyd,26,1999-09-14T03:00:00Z,29.0N  80.5W,6,32,0,1,39
Hurricane,Floyd,26,1999-09-14T03:00:00Z,W PALM BEACH FL,32,6,0,0,38
Hurricane,Floyd,26,1999-09-14T03:00:00Z,31.5N  80.5W,0,11,18,1,30
Hurricane,Floyd,26,1999-09-14T03:00:00Z,FT PIERCE FL,26,14,0,0,40
Hurricane,Floyd,26,1999-09-14T03:00:00Z,MYSM 241N 745W,99,0,0,0,99
Hurricane,Floyd,26,1999-09-14T03:00:00Z,COCOA BEACH FL,12,26,1,0,39
Hurricane,Floyd,26,1999-09-14T03:00:00Z,MYEG 235N 758W,44,0,0,0,44
Hurricane,Floyd,26,1999-09-14T03:00:00Z,DAYTONA BEACH FL,1,33,1,0,35
Hurricane,Floyd,26,1999-09-14T03:00:00Z,MYAK 241N 776W,46,0,0,0,46
Hurricane,Floyd,26,1999-09-14T03:00:00Z,JACKSONVILLE FL,0,18,11,0,29
Hurricane,Floyd,26,1999-09-14T03:00:00Z,MYNN 251N 775W,66,0,0,0,66
Hurricane,Floyd,26,1999-09-14T03:00:00Z,SAVANNAH GA,0,4,22,2,28
Hurricane,Floyd,26,1999-09-14T03:00:00Z,MYGF 266N 787W,57,0,0,0,57
Hurricane,Floyd,26,1999-09-14T03:00:00Z,CHARLESTON SC,0,1,20,6,27
Hurricane,Floyd,26,1999-09-14T03:00:00Z,MARATHON FL,1,2,0,0,3
Hurricane,Floyd,27,1999-09-14T09:00:00Z,27.6N  79.3W,56,0,0,0,56
Hurricane,Floyd,27,1999-09-14T09:00:00Z,29.7N  80.5W,9,32,1,0,42
Hurricane,Floyd,27,1999-09-14T09:00:00Z,MOREHEAD CITY NC,0,0,2,16,18
Hurricane,Floyd,27,1999-09-14T09:00:00Z,32.5N  80.5W,0,7,25,1,33
Hurricane,Floyd,27,1999-09-14T09:00:00Z,CAPE HATTERAS NC,0,0,0,15,15
Hurricane,Floyd,27,1999-09-14T09:00:00Z,MYAK 241N 776W,16,0,0,0,16
Hurricane,Floyd,27,1999-09-14T09:00:00Z,NORFOLK VA,0,0,0,17,17
Hurricane,Floyd,27,1999-09-14T09:00:00Z,MYNN 251N 775W,66,0,0,0,66
Hurricane,Floyd,27,1999-09-14T09:00:00Z,OCEAN CITY MD,0,0,0,13,13
Hurricane,Floyd,27,1999-09-14T09:00:00Z,MYGF 266N 787W,62,0,0,0,62
Hurricane,Floyd,27,1999-09-14T09:00:00Z,ATLANTIC CITY NJ,0,0,0,10,10
Hurricane,Floyd,27,1999-09-14T09:00:00Z,MIAMI FL,21,1,0,0,22
Hurricane,Floyd,27,1999-09-14T09:00:00Z,NEW YORK CITY NY,0,0,0,6,6
Hurricane,Floyd,27,1999-09-14T09:00:00Z,W PALM BEACH FL,39,1,0,0,40
Hurricane,Floyd,27,1999-09-14T09:00:00Z,MONTAUK POINT NY,0,0,0,2,2
Hurricane,Floyd,27,1999-09-14T09:00:00Z,FT PIERCE FL,40,3,0,1,44
Hurricane,Floyd,27,1999-09-14T09:00:00Z,MARCO ISLAND FL,4,3,0,0,7
Hurricane,Floyd,27,1999-09-14T09:00:00Z,COCOA BEACH FL,31,11,0,0,42
Hurricane,Floyd,27,1999-09-14T09:00:00Z,FT MYERS FL,5,7,0,0,12
Hurricane,Floyd,27,1999-09-14T09:00:00Z,DAYTONA BEACH FL,8,31,0,0,39
Hurricane,Floyd,27,1999-09-14T09:00:00Z,VENICE FL,2,7,0,0,9
Hurricane,Floyd,27,1999-09-14T09:00:00Z,JACKSONVILLE FL,0,28,6,0,34
Hurricane,Floyd,27,1999-09-14T09:00:00Z,TAMPA FL,1,15,1,0,17
Hurricane,Floyd,27,1999-09-14T09:00:00Z,SAVANNAH GA,0,11,22,0,33
Hurricane,Floyd,27,1999-09-14T09:00:00Z,CEDAR KEY FL,0,14,3,0,17
Hurricane,Floyd,27,1999-09-14T09:00:00Z,CHARLESTON SC,0,3,26,2,31
Hurricane,Floyd,27,1999-09-14T09:00:00Z,ST MARKS FL,0,3,5,0,8
Hurricane,Floyd,27,1999-09-14T09:00:00Z,MYRTLE BEACH SC,0,0,18,9,27
Hurricane,Floyd,27,1999-09-14T09:00:00Z,APALACHICOLA FL,0,1,1,0,2
Hurricane,Floyd,27,1999-09-14T09:00:00Z,WILMINGTON NC,0,0,7,16,23
Hurricane,Floyd,28,1999-09-14T15:00:00Z,28.0N  80.0W,53,1,0,0,54
Hurricane,Floyd,28,1999-09-14T15:00:00Z,CAPE HATTERAS NC,0,0,3,13,16
Hurricane,Floyd,28,1999-09-14T15:00:00Z,31.0N  81.0W,1,40,1,0,42
Hurricane,Floyd,28,1999-09-14T15:00:00Z,NORFOLK VA,0,0,1,18,19
Hurricane,Floyd,28,1999-09-14T15:00:00Z,34.0N  80.0W,0,3,26,1,30
Hurricane,Floyd,28,1999-09-14T15:00:00Z,OCEAN CITY MD,0,0,0,16,16
Hurricane,Floyd,28,1999-09-14T15:00:00Z,MYAK 241N 776W,6,0,0,0,6
Hurricane,Floyd,28,1999-09-14T15:00:00Z,ATLANTIC CITY NJ,0,0,0,15,15
Hurricane,Floyd,28,1999-09-14T15:00:00Z,MYNN 251N 775W,99,0,0,0,99
Hurricane,Floyd,28,1999-09-14T15:00:00Z,NEW YORK CITY NY,0,0,0,12,12
Hurricane,Floyd,28,1999-09-14T15:00:00Z,MYGF 266N 787W,78,0,0,0,78
Hurricane,Floyd,28,1999-09-14T15:00:00Z,MONTAUK POINT NY,0,0,0,6,6
Hurricane,Floyd,28,1999-09-14T15:00:00Z,MARATHON FL,4,0,0,0,4
Hurricane,Floyd,28,1999-09-14T15:00:00Z,PROVIDENCE RI,0,0,0,4,4
Hurricane,Floyd,28,1999-09-14T15:00:00Z,MIAMI FL,32,0,0,0,32
Hurricane,Floyd,28,1999-09-14T15:00:00Z,NANTUCKET MA,0,0,0,2,2
Hurricane,Floyd,28,1999-09-14T15:00:00Z,W PALM BEACH FL,47,1,0,0,48
Hurricane,Floyd,28,1999-09-14T15:00:00Z,HYANNIS MA,0,0,0,2,2
Hurricane,Floyd,28,1999-09-14T15:00:00Z,FT PIERCE FL,49,2,0,0,51
Hurricane,Floyd,28,1999-09-14T15:00:00Z,BOSTON MA,0,0,0,2,2
Hurricane,Floyd,28,1999-09-14T15:00:00Z,COCOA BEACH FL,44,6,0,0,50
Hurricane,Floyd,28,1999-09-14T15:00:00Z,MARCO ISLAND FL,11,4,0,0,15
Hurricane,Floyd,28,1999-09-14T15:00:00Z,DAYTONA BEACH FL,20,27,1,0,48
Hurricane,Floyd,28,1999-09-14T15:00:00Z,FT MYERS FL,13,7,0,0,20
Hurricane,Floyd,28,1999-09-14T15:00:00Z,JACKSONVILLE FL,1,38,1,0,40
Hurricane,Floyd,28,1999-09-14T15:00:00Z,VENICE FL,5,9,0,0,14
Hurricane,Floyd,28,1999-09-14T15:00:00Z,SAVANNAH GA,0,27,9,0,36
Hurricane,Floyd,28,1999-09-14T15:00:00Z,TAMPA FL,5,18,0,0,23
Hurricane,Floyd,28,1999-09-14T15:00:00Z,CHARLESTON SC,0,15,19,0,34
Hurricane,Floyd,28,1999-09-14T15:00:00Z,CEDAR KEY FL,1,19,1,0,21
Hurricane,Floyd,28,1999-09-14T15:00:00Z,MYRTLE BEACH SC,0,4,24,1,29
Hurricane,Floyd,28,1999-09-14T15:00:00Z,ST MARKS FL,0,6,4,0,10
Hurricane,Floyd,28,1999-09-14T15:00:00Z,WILMINGTON NC,0,1,18,5,24
Hurricane,Floyd,28,1999-09-14T15:00:00Z,APALACHICOLA FL,0,1,1,0,2
Hurricane,Floyd,28,1999-09-14T15:00:00Z,MOREHEAD CITY NC,0,0,10,9,19
Hurricane,Floyd,28,1999-09-14T15:00:00Z,GULF 29N 85W,0,1,1,0,2
Hurricane,Floyd,29,1999-09-14T21:00:00Z,29.3N  80.5W,53,4,0,0,57
Hurricane,Floyd,29,1999-09-14T21:00:00Z,ATLANTIC CITY NJ,0,0,1,20,21
Hurricane,Floyd,29,1999-09-14T21:00:00Z,33.0N  80.0W,1,40,2,0,43
Hurricane,Floyd,29,1999-09-14T21:00:00Z,NEW YORK CITY NY,0,0,0,19,19
Hurricane,Floyd,29,1999-09-14T21:00:00Z,36.0N  78.5W,0,4,25,1,30
Hurricane,Floyd,29,1999-09-14T21:00:00Z,MONTAUK POINT NY,0,0,0,16,16
Hurricane,Floyd,29,1999-09-14T21:00:00Z,MYNN 251N 775W,99,0,0,0,99
Hurricane,Floyd,29,1999-09-14T21:00:00Z,PROVIDENCE RI,0,0,0,15,15
Hurricane,Floyd,29,1999-09-14T21:00:00Z,MYGF 266N 787W,63,0,0,0,63
Hurricane,Floyd,29,1999-09-14T21:00:00Z,NANTUCKET MA,0,0,0,13,13
Hurricane,Floyd,29,1999-09-14T21:00:00Z,MIAMI FL,9,0,0,0,9
Hurricane,Floyd,29,1999-09-14T21:00:00Z,HYANNIS MA,0,0,0,13,13
Hurricane,Floyd,29,1999-09-14T21:00:00Z,W PALM BEACH FL,38,0,0,0,38
Hurricane,Floyd,29,1999-09-14T21:00:00Z,BOSTON MA,0,0,0,14,14
Hurricane,Floyd,29,1999-09-14T21:00:00Z,FT PIERCE FL,49,0,0,0,49
Hurricane,Floyd,29,1999-09-14T21:00:00Z,PORTLAND ME,0,0,0,11,11
Hurricane,Floyd,29,1999-09-14T21:00:00Z,COCOA BEACH FL,52,1,0,0,53
Hurricane,Floyd,29,1999-09-14T21:00:00Z,BAR HARBOR ME,0,0,0,7,7
Hurricane,Floyd,29,1999-09-14T21:00:00Z,DAYTONA BEACH FL,46,6,0,0,52
Hurricane,Floyd,29,1999-09-14T21:00:00Z,EASTPORT ME,0,0,0,4,4
Hurricane,Floyd,29,1999-09-14T21:00:00Z,JACKSONVILLE FL,18,26,0,0,44
Hurricane,Floyd,29,1999-09-14T21:00:00Z,ST JOHN NB,0,0,0,2,2
Hurricane,Floyd,29,1999-09-14T21:00:00Z,SAVANNAH GA,2,39,1,0,42
Hurricane,Floyd,29,1999-09-14T21:00:00Z,YARMOUTH NS,0,0,0,3,3
Hurricane,Floyd,29,1999-09-14T21:00:00Z,CHARLESTON SC,1,41,1,0,43
Hurricane,Floyd,29,1999-09-14T21:00:00Z,MARCO ISLAND FL,3,0,0,0,3
Hurricane,Floyd,29,1999-09-14T21:00:00Z,MYRTLE BEACH SC,0,32,6,0,38
Hurricane,Floyd,29,1999-09-14T21:00:00Z,FT MYERS FL,7,1,0,0,8
Hurricane,Floyd,29,1999-09-14T21:00:00Z,WILMINGTON NC,0,19,13,0,32
Hurricane,Floyd,29,1999-09-14T21:00:00Z,VENICE FL,7,1,0,0,8
Hurricane,Floyd,29,1999-09-14T21:00:00Z,MOREHEAD CITY NC,0,6,18,2,26
Hurricane,Floyd,29,1999-09-14T21:00:00Z,TAMPA FL,15,5,0,0,20
Hurricane,Floyd,29,1999-09-14T21:00:00Z,CAPE HATTERAS NC,0,1,16,4,21
Hurricane,Floyd,29,1999-09-14T21:00:00Z,CEDAR KEY FL,8,10,0,0,18
Hurricane,Floyd,29,1999-09-14T21:00:00Z,NORFOLK VA,0,0,17,8,25
Hurricane,Floyd,29,1999-09-14T21:00:00Z,ST MARKS FL,0,3,0,0,3
Hurricane,Floyd,29,1999-09-14T21:00:00Z,OCEAN CITY MD,0,0,5,17,22
Hurricane,Floyd,30,1999-09-15T03:00:00Z,31.2N  79.2W,43,1,0,0,44
Hurricane,Floyd,30,1999-09-15T03:00:00Z,OCEAN CITY MD,0,0,11,9,20
Hurricane,Floyd,30,1999-09-15T03:00:00Z,34.3N  78.7W,2,27,3,0,32
Hurricane,Floyd,30,1999-09-15T03:00:00Z,ATLANTIC CITY NJ,0,0,5,14,19
Hurricane,Floyd,30,1999-09-15T03:00:00Z,38.0N  77.0W,0,0,18,4,22
Hurricane,Floyd,30,1999-09-15T03:00:00Z,NEW YORK CITY NY,0,0,1,17,18
Hurricane,Floyd,30,1999-09-15T03:00:00Z,MYGF 266N 787W,12,0,0,0,12
Hurricane,Floyd,30,1999-09-15T03:00:00Z,MONTAUK POINT NY,0,0,0,17,17
Hurricane,Floyd,30,1999-09-15T03:00:00Z,FT PIERCE FL,10,0,0,0,10
Hurricane,Floyd,30,1999-09-15T03:00:00Z,PROVIDENCE RI,0,0,0,16,16
Hurricane,Floyd,30,1999-09-15T03:00:00Z,COCOA BEACH FL,20,0,0,0,20
Hurricane,Floyd,30,1999-09-15T03:00:00Z,NANTUCKET MA,0,0,0,15,15
Hurricane,Floyd,30,1999-09-15T03:00:00Z,DAYTONA BEACH FL,23,0,0,0,23
Hurricane,Floyd,30,1999-09-15T03:00:00Z,HYANNIS MA,0,0,0,15,15
Hurricane,Floyd,30,1999-09-15T03:00:00Z,JACKSONVILLE FL,17,3,0,0,20
Hurricane,Floyd,30,1999-09-15T03:00:00Z,BOSTON MA,0,0,0,16,16
Hurricane,Floyd,30,1999-09-15T03:00:00Z,SAVANNAH GA,17,10,0,0,27
Hurricane,Floyd,30,1999-09-15T03:00:00Z,PORTLAND ME,0,0,0,15,15
Hurricane,Floyd,30,1999-09-15T03:00:00Z,CHARLESTON SC,17,17,0,1,35
Hurricane,Floyd,30,1999-09-15T03:00:00Z,BAR HARBOR ME,0,0,0,11,11
Hurricane,Floyd,30,1999-09-15T03:00:00Z,MYRTLE BEACH SC,6,26,1,1,34
Hurricane,Floyd,30,1999-09-15T03:00:00Z,EASTPORT ME,0,0,0,8,8
Hurricane,Floyd,30,1999-09-15T03:00:00Z,WILMINGTON NC,1,25,5,0,31
Hurricane,Floyd,30,1999-09-15T03:00:00Z,ST JOHN NB,0,0,0,5,5
Hurricane,Floyd,30,1999-09-15T03:00:00Z,MOREHEAD CITY NC,0,15,11,0,26
Hurricane,Floyd,30,1999-09-15T03:00:00Z,MONCTON NB,0,0,0,3,3
Hurricane,Floyd,30,1999-09-15T03:00:00Z,CAPE HATTERAS NC,0,4,16,1,21
Hurricane,Floyd,30,1999-09-15T03:00:00Z,YARMOUTH NS,0,0,0,6,6
Hurricane,Floyd,30,1999-09-15T03:00:00Z,NORFOLK VA,0,1,19,2,22
Hurricane,Floyd,30,1999-09-15T03:00:00Z,HALIFAX NS,0,0,0,2,2
Hurricane,Floyd,31,1999-09-15T09:00:00Z,33.2N  79.1W,38,2,0,0,40
Hurricane,Floyd,31,1999-09-15T09:00:00Z,PROVIDENCE RI,0,0,3,13,16
Hurricane,Floyd,31,1999-09-15T09:00:00Z,36.3N  78.0W,0,26,6,0,32
Hurricane,Floyd,31,1999-09-15T09:00:00Z,NANTUCKET MA,0,0,2,12,14
Hurricane,Floyd,31,1999-09-15T09:00:00Z,40.0N  75.0W,0,0,18,3,21
Hurricane,Floyd,31,1999-09-15T09:00:00Z,HYANNIS MA,0,0,2,12,14
Hurricane,Floyd,31,1999-09-15T09:00:00Z,COCOA BEACH FL,5,0,0,1,6
Hurricane,Floyd,31,1999-09-15T09:00:00Z,BOSTON MA,0,0,2,13,15
Hurricane,Floyd,31,1999-09-15T09:00:00Z,DAYTONA BEACH FL,20,0,0,0,20
Hurricane,Floyd,31,1999-09-15T09:00:00Z,PORTLAND ME,0,0,1,14,15
Hurricane,Floyd,31,1999-09-15T09:00:00Z,JACKSONVILLE FL,25,0,0,0,25
Hurricane,Floyd,31,1999-09-15T09:00:00Z,BAR HARBOR ME,0,0,0,12,12
Hurricane,Floyd,31,1999-09-15T09:00:00Z,SAVANNAH GA,36,1,0,0,37
Hurricane,Floyd,31,1999-09-15T09:00:00Z,EASTPORT ME,0,0,0,11,11
Hurricane,Floyd,31,1999-09-15T09:00:00Z,CHARLESTON SC,41,1,0,0,42
Hurricane,Floyd,31,1999-09-15T09:00:00Z,ST JOHN NB,0,0,0,10,10
Hurricane,Floyd,31,1999-09-15T09:00:00Z,MYRTLE BEACH SC,30,7,0,0,37
Hurricane,Floyd,31,1999-09-15T09:00:00Z,MONCTON NB,0,0,0,9,9
Hurricane,Floyd,31,1999-09-15T09:00:00Z,WILMINGTON NC,15,17,1,0,33
Hurricane,Floyd,31,1999-09-15T09:00:00Z,YARMOUTH NS,0,0,0,9,9
Hurricane,Floyd,31,1999-09-15T09:00:00Z,MOREHEAD CITY NC,5,19,3,1,28
Hurricane,Floyd,31,1999-09-15T09:00:00Z,HALIFAX NS,0,0,0,7,7
Hurricane,Floyd,31,1999-09-15T09:00:00Z,CAPE HATTERAS NC,1,13,8,0,22
Hurricane,Floyd,31,1999-09-15T09:00:00Z,SABLE ISLAND NS,0,0,0,2,2
Hurricane,Floyd,31,1999-09-15T09:00:00Z,NORFOLK VA,0,11,15,0,26
Hurricane,Floyd,31,1999-09-15T09:00:00Z,SYDNEY NS,0,0,0,3,3
Hurricane,Floyd,31,1999-09-15T09:00:00Z,OCEAN CITY MD,0,2,19,1,22
Hurricane,Floyd,31,1999-09-15T09:00:00Z,EDDY POINT NS,0,0,0,4,4
Hurricane,Floyd,31,1999-09-15T09:00:00Z,ATLANTIC CITY NJ,0,0,17,4,21
Hurricane,Floyd,31,1999-09-15T09:00:00Z,PTX BASQUES NFLD,0,0,0,3,3
Hurricane,Floyd,31,1999-09-15T09:00:00Z,NEW YORK CITY NY,0,0,12,7,19
Hurricane,Floyd,31,1999-09-15T09:00:00Z,BURGEO NFLD,0,0,0,2,2
Hurricane,Floyd,31,1999-09-15T09:00:00Z,MONTAUK POINT NY,0,0,5,11,16
Hurricane,Floyd,32,1999-09-15T15:00:00Z,35.0N  78.7W,28,2,0,0,30
Hurricane,Floyd,32,1999-09-15T15:00:00Z,PROVIDENCE RI,0,1,8,5,14
Hurricane,Floyd,32,1999-09-15T15:00:00Z,38.7N  76.4W,0,14,3,1,18
Hurricane,Floyd,32,1999-09-15T15:00:00Z,NANTUCKET MA,0,0,7,6,13
Hurricane,Floyd,32,1999-09-15T15:00:00Z,41.7N  73.3W,0,2,10,3,15
Hurricane,Floyd,32,1999-09-15T15:00:00Z,HYANNIS MA,0,0,7,7,14
Hurricane,Floyd,32,1999-09-15T15:00:00Z,COCOA BEACH FL,3,0,0,0,3
Hurricane,Floyd,32,1999-09-15T15:00:00Z,BOSTON MA,0,0,7,7,14
Hurricane,Floyd,32,1999-09-15T15:00:00Z,DAYTONA BEACH FL,12,0,0,0,12
Hurricane,Floyd,32,1999-09-15T15:00:00Z,PORTLAND ME,0,0,5,9,14
Hurricane,Floyd,32,1999-09-15T15:00:00Z,JACKSONVILLE FL,12,1,0,0,13
Hurricane,Floyd,32,1999-09-15T15:00:00Z,BAR HARBOR ME,0,0,2,11,13
Hurricane,Floyd,32,1999-09-15T15:00:00Z,SAVANNAH GA,43,0,0,0,43
Hurricane,Floyd,32,1999-09-15T15:00:00Z,EASTPORT ME,0,0,1,12,13
Hurricane,Floyd,32,1999-09-15T15:00:00Z,CHARLESTON SC,57,0,0,0,57
Hurricane,Floyd,32,1999-09-15T15:00:00Z,ST JOHN NB,0,0,1,11,12
Hurricane,Floyd,32,1999-09-15T15:00:00Z,MYRTLE BEACH SC,43,0,0,0,43
Hurricane,Floyd,32,1999-09-15T15:00:00Z,MONCTON NB,0,0,0,11,11
Hurricane,Floyd,32,1999-09-15T15:00:00Z,WILMINGTON NC,29,1,0,0,30
Hurricane,Floyd,32,1999-09-15T15:00:00Z,YARMOUTH NS,0,0,1,11,12
Hurricane,Floyd,32,1999-09-15T15:00:00Z,MOREHEAD CITY NC,15,7,0,0,22
Hurricane,Floyd,32,1999-09-15T15:00:00Z,HALIFAX NS,0,0,0,10,10
Hurricane,Floyd,32,1999-09-15T15:00:00Z,CAPE HATTERAS NC,4,12,1,0,17
Hurricane,Floyd,32,1999-09-15T15:00:00Z,SABLE ISLAND NS,0,0,0,6,6
Hurricane,Floyd,32,1999-09-15T15:00:00Z,NORFOLK VA,1,16,1,1,19
Hurricane,Floyd,32,1999-09-15T15:00:00Z,SYDNEY NS,0,0,0,7,7
Hurricane,Floyd,32,1999-09-15T15:00:00Z,OCEAN CITY MD,0,12,4,0,16
Hurricane,Floyd,32,1999-09-15T15:00:00Z,EDDY POINT NS,0,0,0,8,8
Hurricane,Floyd,32,1999-09-15T15:00:00Z,ATLANTIC CITY NJ,0,8,7,1,16
Hurricane,Floyd,32,1999-09-15T15:00:00Z,PTX BASQUES NFLD,0,0,0,6,6
Hurricane,Floyd,32,1999-09-15T15:00:00Z,NEW YORK CITY NY,0,4,9,2,15
Hurricane,Floyd,32,1999-09-15T15:00:00Z,BURGEO NFLD,0,0,0,4,4
Hurricane,Floyd,32,1999-09-15T15:00:00Z,MONTAUK POINT NY,0,1,9,4,14
Hurricane,Floyd,32,1999-09-15T15:00:00Z,ILE ST PIERRE,0,0,0,3,3
Hurricane,Floyd,33,1999-09-15T21:00:00Z,36.5N  77.1W,24,3,0,0,27
Hurricane,Floyd,33,1999-09-15T21:00:00Z,BOSTON MA,0,0,8,4,12
Hurricane,Floyd,33,1999-09-15T21:00:00Z,39.4N  75.0W,0,11,3,1,15
Hurricane,Floyd,33,1999-09-15T21:00:00Z,PORTLAND ME,0,0,5,7,12
Hurricane,Floyd,33,1999-09-15T21:00:00Z,42.5N  71.5W,0,1,7,4,12
Hurricane,Floyd,33,1999-09-15T21:00:00Z,BAR HARBOR ME,0,0,2,10,12
Hurricane,Floyd,33,1999-09-15T21:00:00Z,SAVANNAH GA,3,0,0,0,3
Hurricane,Floyd,33,1999-09-15T21:00:00Z,EASTPORT ME,0,0,1,11,12
Hurricane,Floyd,33,1999-09-15T21:00:00Z,CHARLESTON SC,57,0,0,0,57
Hurricane,Floyd,33,1999-09-15T21:00:00Z,ST JOHN NB,0,0,1,10,11
Hurricane,Floyd,33,1999-09-15T21:00:00Z,MYRTLE BEACH SC,70,0,0,0,70
Hurricane,Floyd,33,1999-09-15T21:00:00Z,MONCTON NB,0,0,0,11,11
Hurricane,Floyd,33,1999-09-15T21:00:00Z,WILMINGTON NC,61,0,0,0,61
Hurricane,Floyd,33,1999-09-15T21:00:00Z,YARMOUTH NS,0,0,1,10,11
Hurricane,Floyd,33,1999-09-15T21:00:00Z,MOREHEAD CITY NC,38,0,0,0,38
Hurricane,Floyd,33,1999-09-15T21:00:00Z,HALIFAX NS,0,0,0,11,11
Hurricane,Floyd,33,1999-09-15T21:00:00Z,CAPE HATTERAS NC,18,4,0,0,22
Hurricane,Floyd,33,1999-09-15T21:00:00Z,SABLE ISLAND NS,0,0,0,9,9
Hurricane,Floyd,33,1999-09-15T21:00:00Z,NORFOLK VA,12,9,0,0,21
Hurricane,Floyd,33,1999-09-15T21:00:00Z,SYDNEY NS,0,0,0,10,10
Hurricane,Floyd,33,1999-09-15T21:00:00Z,OCEAN CITY MD,0,14,2,0,16
Hurricane,Floyd,33,1999-09-15T21:00:00Z,EDDY POINT NS,0,0,0,11,11
Hurricane,Floyd,33,1999-09-15T21:00:00Z,ATLANTIC CITY NJ,0,10,4,0,14
Hurricane,Floyd,33,1999-09-15T21:00:00Z,PTX BASQUES NFLD,0,0,0,10,10
Hurricane,Floyd,33,1999-09-15T21:00:00Z,NEW YORK CITY NY,0,5,7,1,13
Hurricane,Floyd,33,1999-09-15T21:00:00Z,BURGEO NFLD,0,0,0,9,9
Hurricane,Floyd,33,1999-09-15T21:00:00Z,MONTAUK POINT NY,0,2,8,2,12
Hurricane,Floyd,33,1999-09-15T21:00:00Z,ILE ST PIERRE,0,0,0,8,8
Hurricane,Floyd,33,1999-09-15T21:00:00Z,PROVIDENCE RI,0,1,8,3,12
Hurricane,Floyd,33,1999-09-15T21:00:00Z,CAPE RACE NFLD,0,0,0,5,5
Hurricane,Floyd,33,1999-09-15T21:00:00Z,NANTUCKET MA,0,0,7,5,12
Hurricane,Floyd,33,1999-09-15T21:00:00Z,HIBERNIA OILFLD,0,0,0,2,2
Hurricane,Floyd,33,1999-09-15T21:00:00Z,HYANNIS MA,0,0,7,5,12
Hurricane,Floyd,34,1999-09-16T03:00:00Z,38.5N  75.0W,23,5,0,0,28
Hurricane,Floyd,34,1999-09-16T03:00:00Z,BOSTON MA,0,11,9,0,20
Hurricane,Floyd,34,1999-09-16T03:00:00Z,41.5N  71.5W,0,16,5,0,21
Hurricane,Floyd,34,1999-09-16T03:00:00Z,PORTLAND ME,0,5,13,0,18
Hurricane,Floyd,34,1999-09-16T03:00:00Z,45.0N  65.0W,0,0,11,4,15
Hurricane,Floyd,34,1999-09-16T03:00:00Z,BAR HARBOR ME,0,1,15,1,17
Hurricane,Floyd,34,1999-09-16T03:00:00Z,CHARLESTON SC,35,0,0,0,35
Hurricane,Floyd,34,1999-09-16T03:00:00Z,EASTPORT ME,0,0,14,2,16
Hurricane,Floyd,34,1999-09-16T03:00:00Z,MYRTLE BEACH SC,99,0,0,0,99
Hurricane,Floyd,34,1999-09-16T03:00:00Z,ST JOHN NB,0,0,12,3,15
Hurricane,Floyd,34,1999-09-16T03:00:00Z,WILMINGTON NC,77,0,0,0,77
Hurricane,Floyd,34,1999-09-16T03:00:00Z,MONCTON NB,0,0,9,6,15
Hurricane,Floyd,34,1999-09-16T03:00:00Z,MOREHEAD CITY NC,68,0,0,0,68
Hurricane,Floyd,34,1999-09-16T03:00:00Z,YARMOUTH NS,0,1,13,2,16
Hurricane,Floyd,34,1999-09-16T03:00:00Z,CAPE HATTERAS NC,51,0,0,0,51
Hurricane,Floyd,34,1999-09-16T03:00:00Z,HALIFAX NS,0,0,9,6,15
Hurricane,Floyd,34,1999-09-16T03:00:00Z,NORFOLK VA,40,1,0,0,41
Hurricane,Floyd,34,1999-09-16T03:00:00Z,SABLE ISLAND NS,0,0,4,9,13
Hurricane,Floyd,34,1999-09-16T03:00:00Z,OCEAN CITY MD,26,3,0,0,29
Hurricane,Floyd,34,1999-09-16T03:00:00Z,SYDNEY NS,0,0,3,11,14
Hurricane,Floyd,34,1999-09-16T03:00:00Z,ATLANTIC CITY NJ,12,12,0,0,24
Hurricane,Floyd,34,1999-09-16T03:00:00Z,EDDY POINT NS,0,0,5,9,14
Hurricane,Floyd,34,1999-09-16T03:00:00Z,NEW YORK CITY NY,3,18,1,0,22
Hurricane,Floyd,34,1999-09-16T03:00:00Z,PTX BASQUES NFLD,0,0,1,12,13
Hurricane,Floyd,34,1999-09-16T03:00:00Z,MONTAUK POINT NY,0,18,4,0,22
Hurricane,Floyd,34,1999-09-16T03:00:00Z,BURGEO NFLD,0,0,1,12,13
Hurricane,Floyd,34,1999-09-16T03:00:00Z,PROVIDENCE RI,0,15,6,0,21
Hurricane,Floyd,34,1999-09-16T03:00:00Z,ILE ST PIERRE,0,0,0,12,12
Hurricane,Floyd,34,1999-09-16T03:00:00Z,NANTUCKET MA,0,13,8,0,21
Hurricane,Floyd,34,1999-09-16T03:00:00Z,CAPE RACE NFLD,0,0,0,11,11
Hurricane,Floyd,34,1999-09-16T03:00:00Z,HYANNIS MA,0,12,9,0,21
Hurricane,Floyd,34,1999-09-16T03:00:00Z,HIBERNIA OILFLD,0,0,0,8,8
Hurricane,Floyd,35,1999-09-16T09:00:00Z,40.9N  71.9W,19,5,0,0,24
Hurricane,Floyd,35,1999-09-16T09:00:00Z,PORTLAND ME,1,16,0,0,17
Hurricane,Floyd,35,1999-09-16T09:00:00Z,44.0N  66.2W,0,11,4,0,15
Hurricane,Floyd,35,1999-09-16T09:00:00Z,BAR HARBOR ME,0,14,1,1,16
Hurricane,Floyd,35,1999-09-16T09:00:00Z,46.0N  59.0W,0,0,8,3,11
Hurricane,Floyd,35,1999-09-16T09:00:00Z,EASTPORT ME,0,11,3,1,15
Hurricane,Floyd,35,1999-09-16T09:00:00Z,MYRTLE BEACH SC,99,0,0,0,99
Hurricane,Floyd,35,1999-09-16T09:00:00Z,ST JOHN NB,0,8,6,0,14
Hurricane,Floyd,35,1999-09-16T09:00:00Z,WILMINGTON NC,99,0,0,0,99
Hurricane,Floyd,35,1999-09-16T09:00:00Z,MONCTON NB,0,4,8,1,13
Hurricane,Floyd,35,1999-09-16T09:00:00Z,MOREHEAD CITY NC,99,0,0,0,99
Hurricane,Floyd,35,1999-09-16T09:00:00Z,YARMOUTH NS,0,11,4,0,15
Hurricane,Floyd,35,1999-09-16T09:00:00Z,CAPE HATTERAS NC,64,0,0,0,64
Hurricane,Floyd,35,1999-09-16T09:00:00Z,HALIFAX NS,0,5,8,0,13
Hurricane,Floyd,35,1999-09-16T09:00:00Z,NORFOLK VA,60,0,0,0,60
Hurricane,Floyd,35,1999-09-16T09:00:00Z,SABLE ISLAND NS,0,1,9,1,11
Hurricane,Floyd,35,1999-09-16T09:00:00Z,OCEAN CITY MD,44,0,0,0,44
Hurricane,Floyd,35,1999-09-16T09:00:00Z,SYDNEY NS,0,0,9,2,11
Hurricane,Floyd,35,1999-09-16T09:00:00Z,ATLANTIC CITY NJ,33,0,0,0,33
Hurricane,Floyd,35,1999-09-16T09:00:00Z,EDDY POINT NS,0,1,10,1,12
Hurricane,Floyd,35,1999-09-16T09:00:00Z,NEW YORK CITY NY,25,1,0,0,26
Hurricane,Floyd,35,1999-09-16T09:00:00Z,PTX BASQUES NFLD,0,0,7,3,10
Hurricane,Floyd,35,1999-09-16T09:00:00Z,MONTAUK POINT NY,18,5,0,0,23
Hurricane,Floyd,35,1999-09-16T09:00:00Z,BURGEO NFLD,0,0,5,5,10
Hurricane,Floyd,35,1999-09-16T09:00:00Z,PROVIDENCE RI,12,9,0,0,21
Hurricane,Floyd,35,1999-09-16T09:00:00Z,ILE ST PIERRE,0,0,4,6,10
Hurricane,Floyd,35,1999-09-16T09:00:00Z,NANTUCKET MA,8,12,0,0,20
Hurricane,Floyd,35,1999-09-16T09:00:00Z,CAPE RACE NFLD,0,0,2,8,10
Hurricane,Floyd,35,1999-09-16T09:00:00Z,HYANNIS MA,7,13,0,0,20
Hurricane,Floyd,35,1999-09-16T09:00:00Z,HIBERNIA OILFLD,0,0,0,9,9
Hurricane,Floyd,35,1999-09-16T09:00:00Z,BOSTON MA,6,14,0,0,20
Hurricane,Floyd,36,1999-09-16T15:00:00Z,43.5N  68.0W,19,5,0,0,24
Hurricane,Floyd,36,1999-09-16T15:00:00Z,EASTPORT ME,7,12,0,0,19
Hurricane,Floyd,36,1999-09-16T15:00:00Z,46.5N  61.0W,0,12,3,0,15
Hurricane,Floyd,36,1999-09-16T15:00:00Z,ST JOHN NB,3,15,0,0,18
Hurricane,Floyd,36,1999-09-16T15:00:00Z,49.0N  50.0W,0,0,6,4,10
Hurricane,Floyd,36,1999-09-16T15:00:00Z,MONCTON NB,1,15,1,0,17
Hurricane,Floyd,36,1999-09-16T15:00:00Z,OCEAN CITY MD,67,0,0,0,67
Hurricane,Floyd,36,1999-09-16T15:00:00Z,YARMOUTH NS,10,11,0,0,21
Hurricane,Floyd,36,1999-09-16T15:00:00Z,ATLANTIC CITY NJ,53,0,0,0,53
Hurricane,Floyd,36,1999-09-16T15:00:00Z,HALIFAX NS,2,15,1,0,18
Hurricane,Floyd,36,1999-09-16T15:00:00Z,NEW YORK CITY NY,42,0,0,0,42
Hurricane,Floyd,36,1999-09-16T15:00:00Z,SABLE ISLAND NS,0,12,2,0,14
Hurricane,Floyd,36,1999-09-16T15:00:00Z,MONTAUK POINT NY,39,0,0,0,39
Hurricane,Floyd,36,1999-09-16T15:00:00Z,SYDNEY NS,0,11,4,0,15
Hurricane,Floyd,36,1999-09-16T15:00:00Z,PROVIDENCE RI,34,1,0,0,35
Hurricane,Floyd,36,1999-09-16T15:00:00Z,EDDY POINT NS,0,13,3,0,16
Hurricane,Floyd,36,1999-09-16T15:00:00Z,NANTUCKET MA,33,0,0,0,33
Hurricane,Floyd,36,1999-09-16T15:00:00Z,PTX BASQUES NFLD,0,6,7,1,14
Hurricane,Floyd,36,1999-09-16T15:00:00Z,HYANNIS MA,33,0,0,0,33
Hurricane,Floyd,36,1999-09-16T15:00:00Z,BURGEO NFLD,0,4,8,0,12
Hurricane,Floyd,36,1999-09-16T15:00:00Z,BOSTON MA,31,0,0,0,31
Hurricane,Floyd,36,1999-09-16T15:00:00Z,ILE ST PIERRE,0,3,8,1,12
Hurricane,Floyd,36,1999-09-16T15:00:00Z,PORTLAND ME,22,2,0,0,24
Hurricane,Floyd,36,1999-09-16T15:00:00Z,CAPE RACE NFLD,0,1,8,1,10
Hurricane,Floyd,36,1999-09-16T15:00:00Z,BAR HARBOR ME,14,7,0,0,21
Hurricane,Floyd,36,1999-09-16T15:00:00Z,HIBERNIA OILFLD,0,0,6,3,9
Tropical Storm,Floyd,37,1999-09-16T21:00:00Z,45.4N  65.0W,20,5,0,0,25
Tropical Storm,Floyd,37,1999-09-16T21:00:00Z,EASTPORT ME,28,1,0,0,29
Tropical Storm,Floyd,37,1999-09-16T21:00:00Z,48.5N  57.5W,0,11,4,0,15
Tropical Storm,Floyd,37,1999-09-16T21:00:00Z,ST JOHN NB,24,3,0,0,27
Tropical Storm,Floyd,37,1999-09-16T21:00:00Z,49.5N  48.5W,0,0,8,3,11
Tropical Storm,Floyd,37,1999-09-16T21:00:00Z,MONCTON NB,15,8,0,0,23
Tropical Storm,Floyd,37,1999-09-16T21:00:00Z,OCEAN CITY MD,99,0,0,0,99
Tropical Storm,Floyd,37,1999-09-16T21:00:00Z,YARMOUTH NS,29,0,0,0,29
Tropical Storm,Floyd,37,1999-09-16T21:00:00Z,ATLANTIC CITY NJ,99,0,0,0,99
Tropical Storm,Floyd,37,1999-09-16T21:00:00Z,HALIFAX NS,17,6,0,0,23
Tropical Storm,Floyd,37,1999-09-16T21:00:00Z,NEW YORK CITY NY,68,0,0,0,68
Tropical Storm,Floyd,37,1999-09-16T21:00:00Z,SABLE ISLAND NS,3,11,1,0,15
Tropical Storm,Floyd,37,1999-09-16T21:00:00Z,MONTAUK POINT NY,62,0,0,0,62
Tropical Storm,Floyd,37,1999-09-16T21:00:00Z,SYDNEY NS,2,15,0,0,17
Tropical Storm,Floyd,37,1999-09-16T21:00:00Z,PROVIDENCE RI,55,0,0,0,55
Tropical Storm,Floyd,37,1999-09-16T21:00:00Z,EDDY POINT NS,5,14,0,0,19
Tropical Storm,Floyd,37,1999-09-16T21:00:00Z,NANTUCKET MA,45,0,0,0,45
Tropical Storm,Floyd,37,1999-09-16T21:00:00Z,PTX BASQUES NFLD,0,15,1,0,16
Tropical Storm,Floyd,37,1999-09-16T21:00:00Z,HYANNIS MA,48,1,0,0,49
Tropical Storm,Floyd,37,1999-09-16T21:00:00Z,BURGEO NFLD,0,13,2,0,15
Tropical Storm,Floyd,37,1999-09-16T21:00:00Z,BOSTON MA,49,0,0,0,49
Tropical Storm,Floyd,37,1999-09-16T21:00:00Z,ILE ST PIERRE,0,10,3,1,14
Tropical Storm,Floyd,37,1999-09-16T21:00:00Z,PORTLAND ME,38,0,0,0,38
Tropical Storm,Floyd,37,1999-09-16T21:00:00Z,CAPE RACE NFLD,0,5,6,1,12
Tropical Storm,Floyd,37,1999-09-16T21:00:00Z,BAR HARBOR ME,33,0,0,0,33
Tropical Storm,Floyd,37,1999-09-16T21:00:00Z,HIBERNIA OILFLD,0,0,7,3,10
Tropical Storm,Floyd,38,1999-09-17T03:00:00Z,48.0N  60.0W,19,5,0,0,24
Tropical Storm,Floyd,38,1999-09-17T03:00:00Z,ST JOHN NB,40,0,0,0,40
Tropical Storm,Floyd,38,1999-09-17T03:00:00Z,49.5N  52.0W,0,12,2,0,14
Tropical Storm,Floyd,38,1999-09-17T03:00:00Z,MONCTON NB,36,0,0,0,36
Tropical Storm,Floyd,38,1999-09-17T03:00:00Z,50.0N  44.0W,0,1,7,3,11
Tropical Storm,Floyd,38,1999-09-17T03:00:00Z,YARMOUTH NS,34,0,0,0,34
Tropical Storm,Floyd,38,1999-09-17T03:00:00Z,ATLANTIC CITY NJ,46,0,0,0,46
Tropical Storm,Floyd,38,1999-09-17T03:00:00Z,HALIFAX NS,26,0,0,0,26
Tropical Storm,Floyd,38,1999-09-17T03:00:00Z,NEW YORK CITY NY,99,0,0,0,99
Tropical Storm,Floyd,38,1999-09-17T03:00:00Z,SABLE ISLAND NS,9,2,0,0,11
Tropical Storm,Floyd,38,1999-09-17T03:00:00Z,MONTAUK POINT NY,99,0,0,0,99
Tropical Storm,Floyd,38,1999-09-17T03:00:00Z,SYDNEY NS,21,2,1,0,24
Tropical Storm,Floyd,38,1999-09-17T03:00:00Z,PROVIDENCE RI,99,0,0,0,99
Tropical Storm,Floyd,38,1999-09-17T03:00:00Z,EDDY POINT NS,23,1,0,0,24
Tropical Storm,Floyd,38,1999-09-17T03:00:00Z,NANTUCKET MA,42,0,0,0,42
Tropical Storm,Floyd,38,1999-09-17T03:00:00Z,PTX BASQUES NFLD,17,6,0,0,23
Tropical Storm,Floyd,38,1999-09-17T03:00:00Z,HYANNIS MA,59,0,0,0,59
Tropical Storm,Floyd,38,1999-09-17T03:00:00Z,BURGEO NFLD,10,11,0,0,21
Tropical Storm,Floyd,38,1999-09-17T03:00:00Z,BOSTON MA,78,0,0,0,78
Tropical Storm,Floyd,38,1999-09-17T03:00:00Z,ILE ST PIERRE,6,11,0,1,18
Tropical Storm,Floyd,38,1999-09-17T03:00:00Z,PORTLAND ME,60,0,0,0,60
Tropical Storm,Floyd,38,1999-09-17T03:00:00Z,CAPE RACE NFLD,1,12,1,0,14
Tropical Storm,Floyd,38,1999-09-17T03:00:00Z,BAR HARBOR ME,52,0,0,0,52
Tropical Storm,Floyd,38,1999-09-17T03:00:00Z,HIBERNIA OILFLD,0,5,6,0,11
Tropical Storm,Floyd,38,1999-09-17T03:00:00Z,EASTPORT ME,45,0,0,0,45
Tropical Storm,Floyd,39,1999-09-17T09:00:00Z,48.5N  61.5W,21,6,0,0,27
Tropical Storm,Floyd,39,1999-09-17T09:00:00Z,MONCTON NB,36,0,0,0,36
Tropical Storm,Floyd,39,1999-09-17T09:00:00Z,50.0N  51.0W,0,10,3,0,13
Tropical Storm,Floyd,39,1999-09-17T09:00:00Z,YARMOUTH NS,35,0,0,0,35
Tropical Storm,Floyd,39,1999-09-17T09:00:00Z,50.0N  43.5W,0,1,7,3,11
Tropical Storm,Floyd,39,1999-09-17T09:00:00Z,HALIFAX NS,24,0,0,0,24
Tropical Storm,Floyd,39,1999-09-17T09:00:00Z,MONTAUK POINT NY,29,0,0,0,29
Tropical Storm,Floyd,39,1999-09-17T09:00:00Z,SABLE ISLAND NS,7,2,0,0,9
Tropical Storm,Floyd,39,1999-09-17T09:00:00Z,PROVIDENCE RI,99,0,0,0,99
Tropical Storm,Floyd,39,1999-09-17T09:00:00Z,SYDNEY NS,17,5,0,0,22
Tropical Storm,Floyd,39,1999-09-17T09:00:00Z,NANTUCKET MA,10,0,0,0,10
Tropical Storm,Floyd,39,1999-09-17T09:00:00Z,EDDY POINT NS,20,2,0,0,22
Tropical Storm,Floyd,39,1999-09-17T09:00:00Z,HYANNIS MA,54,0,0,0,54
Tropical Storm,Floyd,39,1999-09-17T09:00:00Z,PTX BASQUES NFLD,13,10,0,0,23
Tropical Storm,Floyd,39,1999-09-17T09:00:00Z,BOSTON MA,99,0,0,0,99
Tropical Storm,Floyd,39,1999-09-17T09:00:00Z,BURGEO NFLD,6,13,0,1,20
Tropical Storm,Floyd,39,1999-09-17T09:00:00Z,PORTLAND ME,99,0,0,0,99
Tropical Storm,Floyd,39,1999-09-17T09:00:00Z,ILE ST PIERRE,3,12,0,0,15
Tropical Storm,Floyd,39,1999-09-17T09:00:00Z,BAR HARBOR ME,65,0,0,0,65
Tropical Storm,Floyd,39,1999-09-17T09:00:00Z,CAPE RACE NFLD,0,11,0,1,12
Tropical Storm,Floyd,39,1999-09-17T09:00:00Z,EASTPORT ME,52,0,0,0,52
Tropical Storm,Floyd,39,1999-09-17T09:00:00Z,HIBERNIA OILFLD,0,5,5,1,11
Tropical Storm,Floyd,39,1999-09-17T09:00:00Z,ST JOHN NB,44,0,0,0,44
Tropical Depression,Nine,1,1999-09-11T15:00:00Z,13.0N  30.3W,44,1,0,0,45
Tropical Depression,Nine,1,1999-09-11T15:00:00Z,14.0N  37.0W,0,0,21,2,23
Tropical Depression,Nine,1,1999-09-11T15:00:00Z,13.6N  33.5W,0,29,1,0,30
Tropical Depression,Nine,2,1999-09-11T21:00:00Z,13.8N  32.5W,44,2,0,0,46
Tropical Depression,Nine,2,1999-09-11T21:00:00Z,14.5N  39.0W,0,0,22,1,23
Tropical Depression,Nine,2,1999-09-11T21:00:00Z,14.3N  35.5W,0,30,1,0,31
Tropical Depression,Nine,3,1999-09-12T03:00:00Z,13.5N  34.5W,46,1,0,0,47
Tropical Depression,Nine,3,1999-09-12T03:00:00Z,14.0N  40.5W,0,2,19,1,22
Tropical Depression,Nine,3,1999-09-12T03:00:00Z,13.8N  37.5W,0,30,0,0,30
Tropical Depression,Nine,4,1999-09-12T09:00:00Z,13.6N  35.9W,47,1,0,0,48
Tropical Depression,Nine,4,1999-09-12T09:00:00Z,14.0N  42.0W,0,2,20,1,23
Tropical Depression,Nine,4,1999-09-12T09:00:00Z,13.8N  38.9W,0,30,1,0,31
Tropical Storm,Gert,5,1999-09-12T15:00:00Z,14.2N  39.0W,46,2,0,0,48
Tropical Storm,Gert,5,1999-09-12T15:00:00Z,14.5N  45.0W,0,5,15,2,22
Tropical Storm,Gert,5,1999-09-12T15:00:00Z,14.3N  42.5W,0,29,1,0,30
Tropical Storm,Gert,6,1999-09-12T21:00:00Z,15.0N  41.0W,43,2,0,0,45
Tropical Storm,Gert,6,1999-09-12T21:00:00Z,15.5N  47.5W,0,1,21,1,23
Tropical Storm,Gert,6,1999-09-12T21:00:00Z,15.0N  44.0W,0,29,1,0,30
Tropical Storm,Gert,7,1999-09-13T03:00:00Z,15.7N  42.0W,46,0,0,1,47
Tropical Storm,Gert,7,1999-09-13T03:00:00Z,16.5N  48.0W,0,2,19,1,22
Tropical Storm,Gert,7,1999-09-13T03:00:00Z,16.0N  45.0W,0,29,1,0,30
Tropical Storm,Gert,8,1999-09-13T09:00:00Z,16.0N  43.9W,48,1,0,0,49
Tropical Storm,Gert,8,1999-09-13T09:00:00Z,TFFF 146N 610W,0,0,0,2,2
Tropical Storm,Gert,8,1999-09-13T09:00:00Z,16.5N  47.3W,0,30,0,1,31
Tropical Storm,Gert,8,1999-09-13T09:00:00Z,TDPR 153N 614W,0,0,0,2,2
Tropical Storm,Gert,8,1999-09-13T09:00:00Z,17.0N  50.0W,0,3,18,1,22
Tropical Storm,Gert,8,1999-09-13T09:00:00Z,TFFR 163N 615W,0,0,0,2,2
Tropical Storm,Gert,8,1999-09-13T09:00:00Z,TBPB 131N 595W,0,0,0,3,3
Tropical Storm,Gert,8,1999-09-13T09:00:00Z,TAPA 171N 618W,0,0,0,2,2
Hurricane,Gert,9,1999-09-13T15:00:00Z,16.8N  45.5W,43,1,0,0,44
Hurricane,Gert,9,1999-09-13T15:00:00Z,TLPL 138N 610W,0,0,0,6,6
Hurricane,Gert,9,1999-09-13T15:00:00Z,17.0N  48.5W,0,28,1,0,29
Hurricane,Gert,9,1999-09-13T15:00:00Z,TFFF 146N 610W,0,0,0,7,7
Hurricane,Gert,9,1999-09-13T15:00:00Z,17.0N  51.5W,0,2,19,2,23
Hurricane,Gert,9,1999-09-13T15:00:00Z,TDPR 153N 614W,0,0,0,6,6
Hurricane,Gert,9,1999-09-13T15:00:00Z,TTPT 112N 608W,0,0,0,3,3
Hurricane,Gert,9,1999-09-13T15:00:00Z,TFFR 163N 615W,0,0,0,7,7
Hurricane,Gert,9,1999-09-13T15:00:00Z,TGPY 120N 618W,0,0,0,2,2
Hurricane,Gert,9,1999-09-13T15:00:00Z,TAPA 171N 618W,0,0,0,7,7
Hurricane,Gert,9,1999-09-13T15:00:00Z,TBPB 131N 595W,0,0,0,8,8
Hurricane,Gert,9,1999-09-13T15:00:00Z,TKPK 173N 627W,0,0,0,4,4
Hurricane,Gert,9,1999-09-13T15:00:00Z,TVSV 131N 612W,0,0,0,4,4
Hurricane,Gert,9,1999-09-13T15:00:00Z,TNCM 181N 631W,0,0,0,4,4
Hurricane,Gert,10,1999-09-13T21:00:00Z,16.0N  47.5W,44,1,0,1,46
Hurricane,Gert,10,1999-09-13T21:00:00Z,TDPR 153N 614W,0,0,0,7,7
Hurricane,Gert,10,1999-09-13T21:00:00Z,16.3N  50.5W,0,29,1,0,30
Hurricane,Gert,10,1999-09-13T21:00:00Z,TFFR 163N 615W,0,0,0,8,8
Hurricane,Gert,10,1999-09-13T21:00:00Z,16.5N  53.0W,0,5,16,1,22
Hurricane,Gert,10,1999-09-13T21:00:00Z,TAPA 171N 618W,0,0,0,8,8
Hurricane,Gert,10,1999-09-13T21:00:00Z,TTPT 112N 608W,0,0,0,3,3
Hurricane,Gert,10,1999-09-13T21:00:00Z,TKPK 173N 627W,0,0,0,6,6
Hurricane,Gert,10,1999-09-13T21:00:00Z,TGPY 120N 618W,0,0,0,2,2
Hurricane,Gert,10,1999-09-13T21:00:00Z,TNCM 181N 631W,0,0,0,6,6
Hurricane,Gert,10,1999-09-13T21:00:00Z,TBPB 131N 595W,0,0,0,8,8
Hurricane,Gert,10,1999-09-13T21:00:00Z,TISX 177N 648W,0,0,0,2,2
Hurricane,Gert,10,1999-09-13T21:00:00Z,TVSV 131N 612W,0,0,0,5,5
Hurricane,Gert,10,1999-09-13T21:00:00Z,TIST 183N 650W,0,0,0,2,2
Hurricane,Gert,10,1999-09-13T21:00:00Z,TLPL 138N 610W,0,0,0,6,6
Hurricane,Gert,10,1999-09-13T21:00:00Z,ST CROIX VI,0,0,0,2,2
Hurricane,Gert,10,1999-09-13T21:00:00Z,TFFF 146N 610W,0,0,0,7,7
Hurricane,Gert,10,1999-09-13T21:00:00Z,ST THOMAS VI,0,0,0,2,2
Hurricane,Gert,11,1999-09-14T03:00:00Z,17.1N  47.9W,44,1,0,0,45
Hurricane,Gert,11,1999-09-14T03:00:00Z,TDPR 153N 614W,0,0,0,9,9
Hurricane,Gert,11,1999-09-14T03:00:00Z,17.5N  51.1W,0,28,1,0,29
Hurricane,Gert,11,1999-09-14T03:00:00Z,TFFR 163N 615W,0,0,0,10,10
Hurricane,Gert,11,1999-09-14T03:00:00Z,17.9N  53.9W,0,2,19,1,22
Hurricane,Gert,11,1999-09-14T03:00:00Z,TAPA 171N 618W,0,0,0,10,10
Hurricane,Gert,11,1999-09-14T03:00:00Z,TTPP 106N 614W,0,0,0,2,2
Hurricane,Gert,11,1999-09-14T03:00:00Z,TKPK 173N 627W,0,0,0,8,8
Hurricane,Gert,11,1999-09-14T03:00:00Z,TTPT 112N 608W,0,0,0,4,4
Hurricane,Gert,11,1999-09-14T03:00:00Z,TNCM 181N 631W,0,0,0,7,7
Hurricane,Gert,11,1999-09-14T03:00:00Z,TGPY 120N 618W,0,0,0,3,3
Hurricane,Gert,11,1999-09-14T03:00:00Z,TISX 177N 648W,0,0,0,3,3
Hurricane,Gert,11,1999-09-14T03:00:00Z,TBPB 131N 595W,0,0,0,9,9
Hurricane,Gert,11,1999-09-14T03:00:00Z,TIST 183N 650W,0,0,0,3,3
Hurricane,Gert,11,1999-09-14T03:00:00Z,TVSV 131N 612W,0,0,0,6,6
Hurricane,Gert,11,1999-09-14T03:00:00Z,ST CROIX VI,0,0,0,3,3
Hurricane,Gert,11,1999-09-14T03:00:00Z,TLPL 138N 610W,0,0,0,7,7
Hurricane,Gert,11,1999-09-14T03:00:00Z,ST THOMAS VI,0,0,0,3,3
Hurricane,Gert,11,1999-09-14T03:00:00Z,TFFF 146N 610W,0,0,0,9,9
Hurricane,Gert,12,1999-09-14T09:00:00Z,17.7N  48.6W,43,1,0,0,44
Hurricane,Gert,12,1999-09-14T09:00:00Z,TAPA 171N 618W,0,0,0,12,12
Hurricane,Gert,12,1999-09-14T09:00:00Z,18.1N  51.5W,0,28,1,1,30
Hurricane,Gert,12,1999-09-14T09:00:00Z,TKPK 173N 627W,0,0,0,10,10
Hurricane,Gert,12,1999-09-14T09:00:00Z,18.5N  54.5W,0,1,20,1,22
Hurricane,Gert,12,1999-09-14T09:00:00Z,TNCM 181N 631W,0,0,0,10,10
Hurricane,Gert,12,1999-09-14T09:00:00Z,TTPP 106N 614W,0,0,0,3,3
Hurricane,Gert,12,1999-09-14T09:00:00Z,TISX 177N 648W,0,0,0,5,5
Hurricane,Gert,12,1999-09-14T09:00:00Z,TTPT 112N 608W,0,0,0,5,5
Hurricane,Gert,12,1999-09-14T09:00:00Z,TIST 183N 650W,0,0,0,5,5
Hurricane,Gert,12,1999-09-14T09:00:00Z,TGPY 120N 618W,0,0,0,4,4
Hurricane,Gert,12,1999-09-14T09:00:00Z,TJPS 180N 666W,0,0,0,2,2
Hurricane,Gert,12,1999-09-14T09:00:00Z,TBPB 131N 595W,0,0,0,10,10
Hurricane,Gert,12,1999-09-14T09:00:00Z,TJSJ 184N 661W,0,0,0,3,3
Hurricane,Gert,12,1999-09-14T09:00:00Z,TVSV 131N 612W,0,0,0,7,7
Hurricane,Gert,12,1999-09-14T09:00:00Z,ST CROIX VI,0,0,0,5,5
Hurricane,Gert,12,1999-09-14T09:00:00Z,TLPL 138N 610W,0,0,0,9,9
Hurricane,Gert,12,1999-09-14T09:00:00Z,ST THOMAS VI,0,0,0,5,5
Hurricane,Gert,12,1999-09-14T09:00:00Z,TFFF 146N 610W,0,0,0,10,10
Hurricane,Gert,12,1999-09-14T09:00:00Z,SAN JUAN PR,0,0,0,3,3
Hurricane,Gert,12,1999-09-14T09:00:00Z,TDPR 153N 614W,0,0,0,11,11
Hurricane,Gert,12,1999-09-14T09:00:00Z,PONCE PR,0,0,0,2,2
Hurricane,Gert,12,1999-09-14T09:00:00Z,TFFR 163N 615W,0,0,0,12,12
Hurricane,Gert,13,1999-09-14T15:00:00Z,18.1N  50.4W,46,0,0,0,46
Hurricane,Gert,13,1999-09-14T15:00:00Z,TAPA 171N 618W,0,0,0,13,13
Hurricane,Gert,13,1999-09-14T15:00:00Z,18.7N  53.0W,1,28,0,0,29
Hurricane,Gert,13,1999-09-14T15:00:00Z,TKPK 173N 627W,0,0,0,11,11
Hurricane,Gert,13,1999-09-14T15:00:00Z,19.1N  55.7W,0,3,19,1,23
Hurricane,Gert,13,1999-09-14T15:00:00Z,TNCM 181N 631W,0,0,0,11,11
Hurricane,Gert,13,1999-09-14T15:00:00Z,TTPP 106N 614W,0,0,0,2,2
Hurricane,Gert,13,1999-09-14T15:00:00Z,TISX 177N 648W,0,0,0,7,7
Hurricane,Gert,13,1999-09-14T15:00:00Z,TTPT 112N 608W,0,0,0,3,3
Hurricane,Gert,13,1999-09-14T15:00:00Z,TIST 183N 650W,0,0,0,7,7
Hurricane,Gert,13,1999-09-14T15:00:00Z,TGPY 120N 618W,0,0,0,4,4
Hurricane,Gert,13,1999-09-14T15:00:00Z,TJPS 180N 666W,0,0,0,3,3
Hurricane,Gert,13,1999-09-14T15:00:00Z,TBPB 131N 595W,0,0,1,8,9
Hurricane,Gert,13,1999-09-14T15:00:00Z,TJSJ 184N 661W,0,0,0,4,4
Hurricane,Gert,13,1999-09-14T15:00:00Z,TVSV 131N 612W,0,0,0,6,6
Hurricane,Gert,13,1999-09-14T15:00:00Z,ST CROIX VI,0,0,0,7,7
Hurricane,Gert,13,1999-09-14T15:00:00Z,TLPL 138N 610W,0,0,0,8,8
Hurricane,Gert,13,1999-09-14T15:00:00Z,ST THOMAS VI,0,0,0,7,7
Hurricane,Gert,13,1999-09-14T15:00:00Z,TFFF 146N 610W,0,0,0,10,10
Hurricane,Gert,13,1999-09-14T15:00:00Z,SAN JUAN PR,0,0,0,4,4
Hurricane,Gert,13,1999-09-14T15:00:00Z,TDPR 153N 614W,0,0,0,11,11
Hurricane,Gert,13,1999-09-14T15:00:00Z,PONCE PR,0,0,0,3,3
Hurricane,Gert,13,1999-09-14T15:00:00Z,TFFR 163N 615W,0,0,0,12,12
Hurricane,Gert,14,1999-09-14T21:00:00Z,18.0N  51.0W,51,0,0,0,51
Hurricane,Gert,14,1999-09-14T21:00:00Z,TKPK 173N 627W,0,0,0,10,10
Hurricane,Gert,14,1999-09-14T21:00:00Z,18.5N  53.4W,2,29,0,0,31
Hurricane,Gert,14,1999-09-14T21:00:00Z,TNCM 181N 631W,0,0,0,10,10
Hurricane,Gert,14,1999-09-14T21:00:00Z,19.0N  56.0W,0,10,12,1,23
Hurricane,Gert,14,1999-09-14T21:00:00Z,TISX 177N 648W,0,0,0,6,6
Hurricane,Gert,14,1999-09-14T21:00:00Z,TBPB 131N 595W,0,0,0,3,3
Hurricane,Gert,14,1999-09-14T21:00:00Z,TIST 183N 650W,0,0,0,6,6
Hurricane,Gert,14,1999-09-14T21:00:00Z,TVSV 131N 612W,0,0,0,2,2
Hurricane,Gert,14,1999-09-14T21:00:00Z,TJPS 180N 666W,0,0,0,2,2
Hurricane,Gert,14,1999-09-14T21:00:00Z,TLPL 138N 610W,0,0,0,4,4
Hurricane,Gert,14,1999-09-14T21:00:00Z,TJSJ 184N 661W,0,0,0,4,4
Hurricane,Gert,14,1999-09-14T21:00:00Z,TFFF 146N 610W,0,0,0,6,6
Hurricane,Gert,14,1999-09-14T21:00:00Z,ST CROIX VI,0,0,0,6,6
Hurricane,Gert,14,1999-09-14T21:00:00Z,TDPR 153N 614W,0,0,0,7,7
Hurricane,Gert,14,1999-09-14T21:00:00Z,ST THOMAS VI,0,0,0,6,6
Hurricane,Gert,14,1999-09-14T21:00:00Z,TFFR 163N 615W,0,0,1,9,10
Hurricane,Gert,14,1999-09-14T21:00:00Z,SAN JUAN PR,0,0,0,4,4
Hurricane,Gert,14,1999-09-14T21:00:00Z,TAPA 171N 618W,0,0,1,10,11
Hurricane,Gert,14,1999-09-14T21:00:00Z,PONCE PR,0,0,0,2,2
Hurricane,Gert,15,1999-09-15T03:00:00Z,18.0N  51.5W,54,0,0,0,54
Hurricane,Gert,15,1999-09-15T03:00:00Z,TNCM 181N 631W,0,0,0,7,7
Hurricane,Gert,15,1999-09-15T03:00:00Z,18.6N  53.8W,5,27,1,0,33
Hurricane,Gert,15,1999-09-15T03:00:00Z,TISX 177N 648W,0,0,0,3,3
Hurricane,Gert,15,1999-09-15T03:00:00Z,19.5N  56.0W,0,13,10,1,24
Hurricane,Gert,15,1999-09-15T03:00:00Z,TIST 183N 650W,0,0,0,3,3
Hurricane,Gert,15,1999-09-15T03:00:00Z,TDPR 153N 614W,0,0,0,2,2
Hurricane,Gert,15,1999-09-15T03:00:00Z,TJSJ 184N 661W,0,0,0,2,2
Hurricane,Gert,15,1999-09-15T03:00:00Z,TFFR 163N 615W,0,0,0,5,5
Hurricane,Gert,15,1999-09-15T03:00:00Z,ST CROIX VI,0,0,0,3,3
Hurricane,Gert,15,1999-09-15T03:00:00Z,TAPA 171N 618W,0,0,1,5,6
Hurricane,Gert,15,1999-09-15T03:00:00Z,ST THOMAS VI,0,0,0,3,3
Hurricane,Gert,15,1999-09-15T03:00:00Z,TKPK 173N 627W,0,0,0,6,6
Hurricane,Gert,15,1999-09-15T03:00:00Z,SAN JUAN PR,0,0,0,2,2
Hurricane,Gert,16,1999-09-15T09:00:00Z,18.5N  52.4W,56,0,0,0,56
Hurricane,Gert,16,1999-09-15T09:00:00Z,TNCM 181N 631W,0,0,0,5,5
Hurricane,Gert,16,1999-09-15T09:00:00Z,19.4N  54.7W,4,30,0,0,34
Hurricane,Gert,16,1999-09-15T09:00:00Z,TISX 177N 648W,0,0,0,2,2
Hurricane,Gert,16,1999-09-15T09:00:00Z,20.5N  57.0W,0,11,14,0,25
Hurricane,Gert,16,1999-09-15T09:00:00Z,TIST 183N 650W,0,0,0,2,2
Hurricane,Gert,16,1999-09-15T09:00:00Z,TFFR 163N 615W,0,0,0,2,2
Hurricane,Gert,16,1999-09-15T09:00:00Z,ST CROIX VI,0,0,0,2,2
Hurricane,Gert,16,1999-09-15T09:00:00Z,TAPA 171N 618W,0,0,1,3,4
Hurricane,Gert,16,1999-09-15T09:00:00Z,ST THOMAS VI,0,0,0,2,2
Hurricane,Gert,16,1999-09-15T09:00:00Z,TKPK 173N 627W,0,0,0,3,3
Hurricane,Gert,17,1999-09-15T15:00:00Z,18.5N  53.5W,53,0,0,0,53
Hurricane,Gert,17,1999-09-15T15:00:00Z,TISX 177N 648W,0,0,0,2,2
Hurricane,Gert,17,1999-09-15T15:00:00Z,19.5N  55.5W,5,26,0,0,31
Hurricane,Gert,17,1999-09-15T15:00:00Z,TIST 183N 650W,0,0,0,3,3
Hurricane,Gert,17,1999-09-15T15:00:00Z,20.5N  57.5W,0,14,9,1,24
Hurricane,Gert,17,1999-09-15T15:00:00Z,TJSJ 184N 661W,0,0,0,2,2
Hurricane,Gert,17,1999-09-15T15:00:00Z,TFFR 163N 615W,0,0,1,2,3
Hurricane,Gert,17,1999-09-15T15:00:00Z,ST CROIX VI,0,0,0,2,2
Hurricane,Gert,17,1999-09-15T15:00:00Z,TAPA 171N 618W,0,0,1,4,5
Hurricane,Gert,17,1999-09-15T15:00:00Z,ST THOMAS VI,0,0,0,3,3
Hurricane,Gert,17,1999-09-15T15:00:00Z,TKPK 173N 627W,0,0,1,3,4
Hurricane,Gert,17,1999-09-15T15:00:00Z,SAN JUAN PR,0,0,0,2,2
Hurricane,Gert,17,1999-09-15T15:00:00Z,TNCM 181N 631W,0,0,1,5,6
Hurricane,Gert,18,1999-09-15T21:00:00Z,18.5N  54.5W,53,0,0,0,53
Hurricane,Gert,18,1999-09-15T21:00:00Z,TNCM 181N 631W,0,0,1,7,8
Hurricane,Gert,18,1999-09-15T21:00:00Z,19.2N  56.0W,17,16,0,0,33
Hurricane,Gert,18,1999-09-15T21:00:00Z,TISX 177N 648W,0,0,0,4,4
Hurricane,Gert,18,1999-09-15T21:00:00Z,20.5N  58.0W,0,13,11,2,26
Hurricane,Gert,18,1999-09-15T21:00:00Z,TIST 183N 650W,0,0,0,4,4
Hurricane,Gert,18,1999-09-15T21:00:00Z,TFFF 146N 610W,0,0,0,2,2
Hurricane,Gert,18,1999-09-15T21:00:00Z,TJSJ 184N 661W,0,0,0,2,2
Hurricane,Gert,18,1999-09-15T21:00:00Z,TDPR 153N 614W,0,0,1,3,4
Hurricane,Gert,18,1999-09-15T21:00:00Z,ST CROIX VI,0,0,0,4,4
Hurricane,Gert,18,1999-09-15T21:00:00Z,TFFR 163N 615W,0,0,2,4,6
Hurricane,Gert,18,1999-09-15T21:00:00Z,ST THOMAS VI,0,0,0,4,4
Hurricane,Gert,18,1999-09-15T21:00:00Z,TAPA 171N 618W,0,0,2,6,8
Hurricane,Gert,18,1999-09-15T21:00:00Z,SAN JUAN PR,0,0,0,2,2
Hurricane,Gert,18,1999-09-15T21:00:00Z,TKPK 173N 627W,0,0,1,6,7
Hurricane,Gert,19,1999-09-16T03:00:00Z,18.4N  54.5W,55,0,0,0,55
Hurricane,Gert,19,1999-09-16T03:00:00Z,TNCM 181N 631W,0,0,2,3,5
Hurricane,Gert,19,1999-09-16T03:00:00Z,19.6N  56.6W,5,29,0,0,34
Hurricane,Gert,19,1999-09-16T03:00:00Z,TISX 177N 648W,0,0,0,2,2
Hurricane,Gert,19,1999-09-16T03:00:00Z,21.0N  58.5W,0,13,10,1,24
Hurricane,Gert,19,1999-09-16T03:00:00Z,TIST 183N 650W,0,0,0,2,2
Hurricane,Gert,19,1999-09-16T03:00:00Z,TFFR 163N 615W,0,0,1,2,3
Hurricane,Gert,19,1999-09-16T03:00:00Z,ST CROIX VI,0,0,0,2,2
Hurricane,Gert,19,1999-09-16T03:00:00Z,TAPA 171N 618W,0,0,2,2,4
Hurricane,Gert,19,1999-09-16T03:00:00Z,ST THOMAS VI,0,0,0,2,2
Hurricane,Gert,19,1999-09-16T03:00:00Z,TKPK 173N 627W,0,0,1,3,4
Hurricane,Gert,20,1999-09-16T09:00:00Z,19.4N  55.2W,53,0,0,0,53
Hurricane,Gert,20,1999-09-16T09:00:00Z,TAPA 171N 618W,0,0,1,1,2
Hurricane,Gert,20,1999-09-16T09:00:00Z,20.8N  56.9W,10,21,0,1,32
Hurricane,Gert,20,1999-09-16T09:00:00Z,TNCM 181N 631W,0,0,1,2,3
Hurricane,Gert,20,1999-09-16T09:00:00Z,22.5N  58.5W,0,13,9,1,23
Hurricane,Gert,21,1999-09-16T15:00:00Z,19.5N  55.5W,44,0,0,0,44
Hurricane,Gert,21,1999-09-16T15:00:00Z,TKPK 173N 627W,0,0,1,1,2
Hurricane,Gert,21,1999-09-16T15:00:00Z,20.5N  57.0W,19,9,0,1,29
Hurricane,Gert,21,1999-09-16T15:00:00Z,TNCM 181N 631W,0,0,1,2,3
Hurricane,Gert,21,1999-09-16T15:00:00Z,22.5N  58.5W,1,14,8,2,25
Hurricane,Gert,21,1999-09-16T15:00:00Z,BERMUDA,0,0,0,4,4
Hurricane,Gert,21,1999-09-16T15:00:00Z,TAPA 171N 618W,0,0,1,2,3
Hurricane,Gert,22,1999-09-16T21:00:00Z,20.5N  57.0W,51,0,0,0,51
Hurricane,Gert,22,1999-09-16T21:00:00Z,TNCM 181N 631W,0,0,1,1,2
Hurricane,Gert,22,1999-09-16T21:00:00Z,22.0N  58.5W,22,9,1,0,32
Hurricane,Gert,22,1999-09-16T21:00:00Z,BERMUDA,0,0,0,2,2
Hurricane,Gert,22,1999-09-16T21:00:00Z,23.5N  60.0W,1,17,5,1,24
Hurricane,Gert,23,1999-09-17T03:00:00Z,21.5N  57.4W,58,0,0,0,58
Hurricane,Gert,23,1999-09-17T03:00:00Z,24.5N  60.0W,3,16,4,1,24
Hurricane,Gert,23,1999-09-17T03:00:00Z,22.8N  58.7W,33,3,0,0,36
Hurricane,Gert,23,1999-09-17T03:00:00Z,BERMUDA,0,0,0,5,5
Hurricane,Gert,24,1999-09-17T09:00:00Z,21.4N  58.4W,53,0,0,0,53
Hurricane,Gert,24,1999-09-17T09:00:00Z,24.5N  61.5W,1,15,7,1,24
Hurricane,Gert,24,1999-09-17T09:00:00Z,22.8N  60.0W,22,9,0,0,31
Hurricane,Gert,24,1999-09-17T09:00:00Z,BERMUDA,0,0,0,7,7
Hurricane,Gert,25,1999-09-17T15:00:00Z,22.0N  58.5W,45,0,0,0,45
Hurricane,Gert,25,1999-09-17T15:00:00Z,TIST 183N 650W,0,0,0,2,2
Hurricane,Gert,25,1999-09-17T15:00:00Z,23.5N  60.0W,18,9,1,0,28
Hurricane,Gert,25,1999-09-17T15:00:00Z,BERMUDA,0,0,0,8,8
Hurricane,Gert,25,1999-09-17T15:00:00Z,24.5N  61.5W,2,17,2,2,23
Hurricane,Gert,25,1999-09-17T15:00:00Z,ST THOMAS VI,0,0,0,2,2
Hurricane,Gert,25,1999-09-17T15:00:00Z,TNCM 181N 631W,0,0,1,1,2
Hurricane,Gert,26,1999-09-17T21:00:00Z,22.5N  59.0W,49,0,0,0,49
Hurricane,Gert,26,1999-09-17T21:00:00Z,25.5N  62.0W,1,18,3,1,23
Hurricane,Gert,26,1999-09-17T21:00:00Z,24.0N  60.5W,20,9,0,0,29
Hurricane,Gert,26,1999-09-17T21:00:00Z,BERMUDA,0,0,1,7,8
Hurricane,Gert,27,1999-09-18T03:00:00Z,23.3N  59.0W,51,0,0,0,51
Hurricane,Gert,27,1999-09-18T03:00:00Z,25.8N  61.8W,7,15,1,1,24
Hurricane,Gert,27,1999-09-18T03:00:00Z,24.6N  60.4W,28,3,0,0,31
Hurricane,Gert,27,1999-09-18T03:00:00Z,BERMUDA,0,0,1,9,10
Hurricane,Gert,28,1999-09-18T09:00:00Z,24.8N  59.1W,42,0,0,0,42
Hurricane,Gert,28,1999-09-18T09:00:00Z,27.5N  62.0W,2,16,2,2,22
Hurricane,Gert,28,1999-09-18T09:00:00Z,26.2N  60.4W,18,8,1,0,27
Hurricane,Gert,28,1999-09-18T09:00:00Z,BERMUDA,0,0,3,10,13
Hurricane,Gert,29,1999-09-18T15:00:00Z,25.0N  60.0W,41,0,0,0,41
Hurricane,Gert,29,1999-09-18T15:00:00Z,28.0N  63.0W,3,15,2,2,22
Hurricane,Gert,29,1999-09-18T15:00:00Z,26.5N  61.5W,20,5,1,0,26
Hurricane,Gert,29,1999-09-18T15:00:00Z,BERMUDA,0,1,5,8,14
Hurricane,Gert,30,1999-09-18T21:00:00Z,25.5N  60.0W,48,0,0,0,48
Hurricane,Gert,30,1999-09-18T21:00:00Z,27.5N  62.0W,16,5,2,1,24
Hurricane,Gert,30,1999-09-18T21:00:00Z,26.5N  61.0W,29,0,1,0,30
Hurricane,Gert,30,1999-09-18T21:00:00Z,BERMUDA,0,0,3,9,12
Hurricane,Gert,31,1999-09-19T03:00:00Z,26.3N  59.9W,44,0,0,0,44
Hurricane,Gert,31,1999-09-19T03:00:00Z,29.5N  61.5W,6,8,4,2,20
Hurricane,Gert,31,1999-09-19T03:00:00Z,27.5N  60.7W,24,2,0,1,27
Hurricane,Gert,31,1999-09-19T03:00:00Z,BERMUDA,0,1,7,7,15
Hurricane,Gert,32,1999-09-19T09:00:00Z,26.4N  61.0W,40,0,0,0,40
Hurricane,Gert,32,1999-09-19T09:00:00Z,29.5N  63.0W,4,13,3,1,21
Hurricane,Gert,32,1999-09-19T09:00:00Z,27.9N  62.0W,22,3,0,1,26
Hurricane,Gert,32,1999-09-19T09:00:00Z,BERMUDA,0,2,9,6,17
Hurricane,Gert,33,1999-09-19T15:00:00Z,27.3N  61.5W,39,0,0,0,39
Hurricane,Gert,33,1999-09-19T15:00:00Z,31.0N  62.5W,2,13,4,1,20
Hurricane,Gert,33,1999-09-19T15:00:00Z,29.0N  62.5W,19,5,1,0,25
Hurricane,Gert,33,1999-09-19T15:00:00Z,BERMUDA,0,6,8,4,18
Hurricane,Gert,34,1999-09-19T21:00:00Z,28.5N  63.0W,43,0,0,0,43
Hurricane,Gert,34,1999-09-19T21:00:00Z,NANTUCKET MA,0,0,0,3,3
Hurricane,Gert,34,1999-09-19T21:00:00Z,30.5N  63.0W,18,6,1,0,25
Hurricane,Gert,34,1999-09-19T21:00:00Z,HYANNIS MA,0,0,0,2,2
Hurricane,Gert,34,1999-09-19T21:00:00Z,32.5N  62.5W,1,10,6,2,19
Hurricane,Gert,34,1999-09-19T21:00:00Z,YARMOUTH NS,0,0,0,2,2
Hurricane,Gert,34,1999-09-19T21:00:00Z,BERMUDA,2,12,4,1,19
Hurricane,Gert,34,1999-09-19T21:00:00Z,HALIFAX NS,0,0,0,2,2
Hurricane,Gert,34,1999-09-19T21:00:00Z,MONTAUK POINT NY,0,0,0,2,2
Hurricane,Gert,34,1999-09-19T21:00:00Z,SABLE ISLAND NS,0,0,0,2,2
Hurricane,Gert,34,1999-09-19T21:00:00Z,PROVIDENCE RI,0,0,0,2,2
Hurricane,Gert,35,1999-09-20T03:00:00Z,29.3N  62.8W,43,0,0,0,43
Hurricane,Gert,35,1999-09-20T03:00:00Z,BAR HARBOR ME,0,0,0,3,3
Hurricane,Gert,35,1999-09-20T03:00:00Z,31.5N  62.8W,12,12,1,0,25
Hurricane,Gert,35,1999-09-20T03:00:00Z,EASTPORT ME,0,0,0,4,4
Hurricane,Gert,35,1999-09-20T03:00:00Z,34.0N  62.0W,0,6,11,2,19
Hurricane,Gert,35,1999-09-20T03:00:00Z,ST JOHN NB,0,0,0,4,4
Hurricane,Gert,35,1999-09-20T03:00:00Z,BERMUDA,3,16,2,1,22
Hurricane,Gert,35,1999-09-20T03:00:00Z,MONCTON NB,0,0,0,3,3
Hurricane,Gert,35,1999-09-20T03:00:00Z,MONTAUK POINT NY,0,0,0,2,2
Hurricane,Gert,35,1999-09-20T03:00:00Z,YARMOUTH NS,0,0,0,6,6
Hurricane,Gert,35,1999-09-20T03:00:00Z,PROVIDENCE RI,0,0,0,2,2
Hurricane,Gert,35,1999-09-20T03:00:00Z,HALIFAX NS,0,0,0,6,6
Hurricane,Gert,35,1999-09-20T03:00:00Z,NANTUCKET MA,0,0,0,4,4
Hurricane,Gert,35,1999-09-20T03:00:00Z,SABLE ISLAND NS,0,0,0,7,7
Hurricane,Gert,35,1999-09-20T03:00:00Z,HYANNIS MA,0,0,0,3,3
Hurricane,Gert,35,1999-09-20T03:00:00Z,SYDNEY NS,0,0,0,3,3
Hurricane,Gert,35,1999-09-20T03:00:00Z,BOSTON MA,0,0,0,2,2
Hurricane,Gert,35,1999-09-20T03:00:00Z,EDDY POINT NS,0,0,0,5,5
Hurricane,Gert,35,1999-09-20T03:00:00Z,PORTLAND ME,0,0,0,2,2
Hurricane,Gert,35,1999-09-20T03:00:00Z,PTX BASQUES NFLD,0,0,0,2,2
Hurricane,Gert,36,1999-09-20T09:00:00Z,30.5N  63.2W,43,0,0,0,43
Hurricane,Gert,36,1999-09-20T09:00:00Z,ST JOHN NB,0,0,0,6,6
Hurricane,Gert,36,1999-09-20T09:00:00Z,32.8N  62.9W,8,19,1,0,28
Hurricane,Gert,36,1999-09-20T09:00:00Z,MONCTON NB,0,0,0,6,6
Hurricane,Gert,36,1999-09-20T09:00:00Z,35.5N  61.5W,0,1,15,3,19
Hurricane,Gert,36,1999-09-20T09:00:00Z,YARMOUTH NS,0,0,0,7,7
Hurricane,Gert,36,1999-09-20T09:00:00Z,BERMUDA,7,21,0,0,28
Hurricane,Gert,36,1999-09-20T09:00:00Z,HALIFAX NS,0,0,0,8,8
Hurricane,Gert,36,1999-09-20T09:00:00Z,PROVIDENCE RI,0,0,0,2,2
Hurricane,Gert,36,1999-09-20T09:00:00Z,SABLE ISLAND NS,0,0,0,10,10
Hurricane,Gert,36,1999-09-20T09:00:00Z,NANTUCKET MA,0,0,0,3,3
Hurricane,Gert,36,1999-09-20T09:00:00Z,SYDNEY NS,0,0,0,7,7
Hurricane,Gert,36,1999-09-20T09:00:00Z,HYANNIS MA,0,0,0,3,3
Hurricane,Gert,36,1999-09-20T09:00:00Z,EDDY POINT NS,0,0,0,8,8
Hurricane,Gert,36,1999-09-20T09:00:00Z,BOSTON MA,0,0,0,2,2
Hurricane,Gert,36,1999-09-20T09:00:00Z,PTX BASQUES NFLD,0,0,0,6,6
Hurricane,Gert,36,1999-09-20T09:00:00Z,PORTLAND ME,0,0,0,3,3
Hurricane,Gert,36,1999-09-20T09:00:00Z,BURGEO NFLD,0,0,0,5,5
Hurricane,Gert,36,1999-09-20T09:00:00Z,BAR HARBOR ME,0,0,0,4,4
Hurricane,Gert,36,1999-09-20T09:00:00Z,ILE ST PIERRE,0,0,0,5,5
Hurricane,Gert,36,1999-09-20T09:00:00Z,EASTPORT ME,0,0,0,5,5
Hurricane,Gert,36,1999-09-20T09:00:00Z,CAPE RACE NFLD,0,0,0,3,3
Hurricane,Gert,37,1999-09-20T15:00:00Z,31.1N  63.4W,50,0,0,0,50
Hurricane,Gert,37,1999-09-20T15:00:00Z,HALIFAX NS,0,0,0,8,8
Hurricane,Gert,37,1999-09-20T15:00:00Z,33.0N  63.0W,13,15,1,0,29
Hurricane,Gert,37,1999-09-20T15:00:00Z,SABLE ISLAND NS,0,0,0,11,11
Hurricane,Gert,37,1999-09-20T15:00:00Z,36.0N  61.5W,0,1,15,4,20
Hurricane,Gert,37,1999-09-20T15:00:00Z,SYDNEY NS,0,0,0,9,9
Hurricane,Gert,37,1999-09-20T15:00:00Z,BERMUDA,14,16,0,0,30
Hurricane,Gert,37,1999-09-20T15:00:00Z,EDDY POINT NS,0,0,0,9,9
Hurricane,Gert,37,1999-09-20T15:00:00Z,BAR HARBOR ME,0,0,0,3,3
Hurricane,Gert,37,1999-09-20T15:00:00Z,PTX BASQUES NFLD,0,0,0,8,8
Hurricane,Gert,37,1999-09-20T15:00:00Z,EASTPORT ME,0,0,0,4,4
Hurricane,Gert,37,1999-09-20T15:00:00Z,BURGEO NFLD,0,0,0,8,8
Hurricane,Gert,37,1999-09-20T15:00:00Z,ST JOHN NB,0,0,0,5,5
Hurricane,Gert,37,1999-09-20T15:00:00Z,ILE ST PIERRE,0,0,0,8,8
Hurricane,Gert,37,1999-09-20T15:00:00Z,MONCTON NB,0,0,0,6,6
Hurricane,Gert,37,1999-09-20T15:00:00Z,CAPE RACE NFLD,0,0,0,7,7
Hurricane,Gert,37,1999-09-20T15:00:00Z,YARMOUTH NS,0,0,0,6,6
Hurricane,Gert,37,1999-09-20T15:00:00Z,HIBERNIA OILFLD,0,0,0,2,2
Hurricane,Gert,38,1999-09-20T21:00:00Z,31.8N  63.6W,51,0,0,0,51
Hurricane,Gert,38,1999-09-20T21:00:00Z,SABLE ISLAND NS,0,0,0,13,13
Hurricane,Gert,38,1999-09-20T21:00:00Z,34.2N  62.6W,6,22,2,0,30
Hurricane,Gert,38,1999-09-20T21:00:00Z,SYDNEY NS,0,0,0,10,10
Hurricane,Gert,38,1999-09-20T21:00:00Z,37.7N  60.1W,0,0,15,5,20
Hurricane,Gert,38,1999-09-20T21:00:00Z,EDDY POINT NS,0,0,0,10,10
Hurricane,Gert,38,1999-09-20T21:00:00Z,BERMUDA,33,6,0,0,39
Hurricane,Gert,38,1999-09-20T21:00:00Z,PTX BASQUES NFLD,0,0,0,9,9
Hurricane,Gert,38,1999-09-20T21:00:00Z,EASTPORT ME,0,0,0,2,2
Hurricane,Gert,38,1999-09-20T21:00:00Z,BURGEO NFLD,0,0,0,10,10
Hurricane,Gert,38,1999-09-20T21:00:00Z,ST JOHN NB,0,0,0,3,3
Hurricane,Gert,38,1999-09-20T21:00:00Z,ILE ST PIERRE,0,0,0,11,11
Hurricane,Gert,38,1999-09-20T21:00:00Z,MONCTON NB,0,0,0,4,4
Hurricane,Gert,38,1999-09-20T21:00:00Z,CAPE RACE NFLD,0,0,0,11,11
Hurricane,Gert,38,1999-09-20T21:00:00Z,YARMOUTH NS,0,0,0,4,4
Hurricane,Gert,38,1999-09-20T21:00:00Z,HIBERNIA OILFLD,0,0,0,7,7
Hurricane,Gert,38,1999-09-20T21:00:00Z,HALIFAX NS,0,0,0,8,8
Hurricane,Gert,39,1999-09-21T03:00:00Z,33.0N  62.8W,41,0,0,0,41
Hurricane,Gert,39,1999-09-21T03:00:00Z,SABLE ISLAND NS,0,0,3,9,12
Hurricane,Gert,39,1999-09-21T03:00:00Z,36.0N  61.2W,1,20,5,0,26
Hurricane,Gert,39,1999-09-21T03:00:00Z,SYDNEY NS,0,0,0,9,9
Hurricane,Gert,39,1999-09-21T03:00:00Z,40.0N  57.8W,0,0,12,5,17
Hurricane,Gert,39,1999-09-21T03:00:00Z,EDDY POINT NS,0,0,1,8,9
Hurricane,Gert,39,1999-09-21T03:00:00Z,BERMUDA,32,0,0,0,32
Hurricane,Gert,39,1999-09-21T03:00:00Z,PTX BASQUES NFLD,0,0,0,8,8
Hurricane,Gert,39,1999-09-21T03:00:00Z,ST JOHN NB,0,0,0,2,2
Hurricane,Gert,39,1999-09-21T03:00:00Z,BURGEO NFLD,0,0,0,10,10
Hurricane,Gert,39,1999-09-21T03:00:00Z,MONCTON NB,0,0,0,3,3
Hurricane,Gert,39,1999-09-21T03:00:00Z,ILE ST PIERRE,0,0,0,11,11
Hurricane,Gert,39,1999-09-21T03:00:00Z,YARMOUTH NS,0,0,1,2,3
Hurricane,Gert,39,1999-09-21T03:00:00Z,CAPE RACE NFLD,0,0,0,12,12
Hurricane,Gert,39,1999-09-21T03:00:00Z,HALIFAX NS,0,0,1,5,6
Hurricane,Gert,39,1999-09-21T03:00:00Z,HIBERNIA OILFLD,0,0,0,10,10
Hurricane,Gert,40,1999-09-21T09:00:00Z,34.1N  62.0W,39,0,0,0,39
Hurricane,Gert,40,1999-09-21T09:00:00Z,HALIFAX NS,0,0,6,3,9
Hurricane,Gert,40,1999-09-21T09:00:00Z,37.4N  60.7W,2,19,4,0,25
Hurricane,Gert,40,1999-09-21T09:00:00Z,SABLE ISLAND NS,0,1,11,3,15
Hurricane,Gert,40,1999-09-21T09:00:00Z,42.6N  56.6W,0,1,12,3,16
Hurricane,Gert,40,1999-09-21T09:00:00Z,SYDNEY NS,0,0,6,7,13
Hurricane,Gert,40,1999-09-21T09:00:00Z,BERMUDA,29,1,0,0,30
Hurricane,Gert,40,1999-09-21T09:00:00Z,EDDY POINT NS,0,0,7,5,12
Hurricane,Gert,40,1999-09-21T09:00:00Z,BAR HARBOR ME,0,0,1,1,2
Hurricane,Gert,40,1999-09-21T09:00:00Z,PTX BASQUES NFLD,0,0,4,8,12
Hurricane,Gert,40,1999-09-21T09:00:00Z,EASTPORT ME,0,0,1,2,3
Hurricane,Gert,40,1999-09-21T09:00:00Z,BURGEO NFLD,0,0,4,9,13
Hurricane,Gert,40,1999-09-21T09:00:00Z,ST JOHN NB,0,0,2,3,5
Hurricane,Gert,40,1999-09-21T09:00:00Z,ILE ST PIERRE,0,0,5,9,14
Hurricane,Gert,40,1999-09-21T09:00:00Z,MONCTON NB,0,0,2,4,6
Hurricane,Gert,40,1999-09-21T09:00:00Z,CAPE RACE NFLD,0,0,3,10,13
Hurricane,Gert,40,1999-09-21T09:00:00Z,YARMOUTH NS,0,0,3,2,5
Hurricane,Gert,40,1999-09-21T09:00:00Z,HIBERNIA OILFLD,0,0,0,9,9
Hurricane,Gert,41,1999-09-21T15:00:00Z,36.5N  61.0W,30,2,0,0,32
Hurricane,Gert,41,1999-09-21T15:00:00Z,SABLE ISLAND NS,0,2,10,1,13
Hurricane,Gert,41,1999-09-21T15:00:00Z,40.0N  58.5W,0,14,5,0,19
Hurricane,Gert,41,1999-09-21T15:00:00Z,SYDNEY NS,0,0,7,3,10
Hurricane,Gert,41,1999-09-21T15:00:00Z,45.0N  54.5W,0,0,9,4,13
Hurricane,Gert,41,1999-09-21T15:00:00Z,EDDY POINT NS,0,1,6,3,10
Hurricane,Gert,41,1999-09-21T15:00:00Z,BERMUDA,21,0,0,0,21
Hurricane,Gert,41,1999-09-21T15:00:00Z,PTX BASQUES NFLD,0,0,5,5,10
Hurricane,Gert,41,1999-09-21T15:00:00Z,EASTPORT ME,0,0,2,0,2
Hurricane,Gert,41,1999-09-21T15:00:00Z,BURGEO NFLD,0,0,6,5,11
Hurricane,Gert,41,1999-09-21T15:00:00Z,ST JOHN NB,0,0,2,1,3
Hurricane,Gert,41,1999-09-21T15:00:00Z,ILE ST PIERRE,0,0,7,5,12
Hurricane,Gert,41,1999-09-21T15:00:00Z,MONCTON NB,0,0,3,2,5
Hurricane,Gert,41,1999-09-21T15:00:00Z,CAPE RACE NFLD,0,0,6,6,12
Hurricane,Gert,41,1999-09-21T15:00:00Z,YARMOUTH NS,0,1,2,1,4
Hurricane,Gert,41,1999-09-21T15:00:00Z,HIBERNIA OILFLD,0,0,2,8,10
Hurricane,Gert,41,1999-09-21T15:00:00Z,HALIFAX NS,0,1,5,2,8
Hurricane,Gert,42,1999-09-21T21:00:00Z,40.0N  58.5W,22,3,0,0,25
Hurricane,Gert,42,1999-09-21T21:00:00Z,SYDNEY NS,0,6,3,0,9
Hurricane,Gert,42,1999-09-21T21:00:00Z,44.0N  55.5W,0,11,2,0,13
Hurricane,Gert,42,1999-09-21T21:00:00Z,EDDY POINT NS,0,6,2,0,8
Hurricane,Gert,42,1999-09-21T21:00:00Z,48.0N  52.0W,0,1,7,2,10
Hurricane,Gert,42,1999-09-21T21:00:00Z,PTX BASQUES NFLD,0,4,4,1,9
Hurricane,Gert,42,1999-09-21T21:00:00Z,ST JOHN NB,0,1,1,0,2
Hurricane,Gert,42,1999-09-21T21:00:00Z,BURGEO NFLD,0,4,5,1,10
Hurricane,Gert,42,1999-09-21T21:00:00Z,MONCTON NB,0,2,1,0,3
Hurricane,Gert,42,1999-09-21T21:00:00Z,ILE ST PIERRE,0,5,5,1,11
Hurricane,Gert,42,1999-09-21T21:00:00Z,HALIFAX NS,0,4,1,0,5
Hurricane,Gert,42,1999-09-21T21:00:00Z,CAPE RACE NFLD,0,3,7,1,11
Hurricane,Gert,42,1999-09-21T21:00:00Z,SABLE ISLAND NS,1,10,1,0,12
Hurricane,Gert,42,1999-09-21T21:00:00Z,HIBERNIA OILFLD,0,0,5,4,9
Hurricane,Gert,43,1999-09-22T03:00:00Z,42.0N  57.0W,16,4,0,0,20
Hurricane,Gert,43,1999-09-22T03:00:00Z,EDDY POINT NS,1,7,1,0,9
Hurricane,Gert,43,1999-09-22T03:00:00Z,46.0N  54.0W,0,11,2,0,13
Hurricane,Gert,43,1999-09-22T03:00:00Z,PTX BASQUES NFLD,0,8,2,0,10
Hurricane,Gert,43,1999-09-22T03:00:00Z,49.2N  50.0W,0,2,7,2,11
Hurricane,Gert,43,1999-09-22T03:00:00Z,BURGEO NFLD,0,9,2,0,11
Hurricane,Gert,43,1999-09-22T03:00:00Z,MONCTON NB,0,2,1,0,3
Hurricane,Gert,43,1999-09-22T03:00:00Z,ILE ST PIERRE,0,11,1,1,13
Hurricane,Gert,43,1999-09-22T03:00:00Z,HALIFAX NS,1,4,0,0,5
Hurricane,Gert,43,1999-09-22T03:00:00Z,CAPE RACE NFLD,0,9,3,1,13
Hurricane,Gert,43,1999-09-22T03:00:00Z,SABLE ISLAND NS,6,7,0,0,13
Hurricane,Gert,43,1999-09-22T03:00:00Z,HIBERNIA OILFLD,0,2,6,2,10
Hurricane,Gert,43,1999-09-22T03:00:00Z,SYDNEY NS,1,8,1,0,10
Hurricane,Gert,44,1999-09-22T09:00:00Z,45.2N  55.0W,15,7,0,0,22
Hurricane,Gert,44,1999-09-22T09:00:00Z,EDDY POINT NS,5,4,0,0,9
Hurricane,Gert,44,1999-09-22T09:00:00Z,49.5N  50.5W,0,13,5,0,18
Hurricane,Gert,44,1999-09-22T09:00:00Z,PTX BASQUES NFLD,2,11,0,0,13
Hurricane,Gert,44,1999-09-22T09:00:00Z,55.5N  45.0W,0,0,10,0,10
Hurricane,Gert,44,1999-09-22T09:00:00Z,BURGEO NFLD,3,13,0,0,16
Hurricane,Gert,44,1999-09-22T09:00:00Z,MONCTON NB,0,2,0,0,2
Hurricane,Gert,44,1999-09-22T09:00:00Z,ILE ST PIERRE,6,13,0,0,19
Hurricane,Gert,44,1999-09-22T09:00:00Z,HALIFAX NS,2,1,0,0,3
Hurricane,Gert,44,1999-09-22T09:00:00Z,CAPE RACE NFLD,4,16,0,0,20
Hurricane,Gert,44,1999-09-22T09:00:00Z,SABLE ISLAND NS,15,2,0,0,17
Hurricane,Gert,44,1999-09-22T09:00:00Z,HIBERNIA OILFLD,0,14,2,0,16
Hurricane,Gert,44,1999-09-22T09:00:00Z,SYDNEY NS,5,7,0,0,12
Hurricane,Gert,45,1999-09-22T15:00:00Z,48.0N  51.5W,14,7,0,0,21
Hurricane,Gert,45,1999-09-22T15:00:00Z,PTX BASQUES NFLD,7,2,0,0,9
Hurricane,Gert,45,1999-09-22T15:00:00Z,51.0N  46.0W,0,14,3,0,17
Hurricane,Gert,45,1999-09-22T15:00:00Z,BURGEO NFLD,12,2,0,0,14
Hurricane,Gert,45,1999-09-22T15:00:00Z,52.5N  39.0W,0,4,9,0,13
Hurricane,Gert,45,1999-09-22T15:00:00Z,ILE ST PIERRE,20,1,0,0,21
Hurricane,Gert,45,1999-09-22T15:00:00Z,SABLE ISLAND NS,15,0,0,0,15
Hurricane,Gert,45,1999-09-22T15:00:00Z,CAPE RACE NFLD,23,2,0,0,25
Hurricane,Gert,45,1999-09-22T15:00:00Z,SYDNEY NS,7,0,0,0,7
Hurricane,Gert,45,1999-09-22T15:00:00Z,HIBERNIA OILFLD,9,10,0,0,19
Hurricane,Gert,45,1999-09-22T15:00:00Z,EDDY POINT NS,4,0,0,0,4
Hurricane,Gert,46,1999-09-22T21:00:00Z,48.5N  49.0W,13,0,0,0,13
Hurricane,Gert,46,1999-09-22T21:00:00Z,ILE ST PIERRE,11,0,0,0,11
Hurricane,Gert,46,1999-09-22T21:00:00Z,51.5N 410.0W,0,8,0,0,8
Hurricane,Gert,46,1999-09-22T21:00:00Z,CAPE RACE NFLD,21,0,0,0,21
Hurricane,Gert,46,1999-09-22T21:00:00Z,BURGEO NFLD,4,0,0,0,4
Hurricane,Gert,46,1999-09-22T21:00:00Z,HIBERNIA OILFLD,14,0,0,0,14
Hurricane,Gert,47,1999-09-23T03:00:00Z,51.5N  48.0W,16,4,0,0,20
Hurricane,Gert,47,1999-09-23T03:00:00Z,CAPE RACE NFLD,43,0,0,0,43
Hurricane,Gert,47,1999-09-23T03:00:00Z,56.0N  43.0W,0,12,0,0,12
Hurricane,Gert,47,1999-09-23T03:00:00Z,HIBERNIA OILFLD,24,0,0,0,24
Tropical Storm,Gert,48,1999-09-23T09:00:00Z,53.6N  48.3W,17,0,0,0,17
Tropical Storm,Gert,48,1999-09-23T09:00:00Z,HIBERNIA OILFLD,32,0,0,0,32
Tropical Storm,Gert,48,1999-09-23T09:00:00Z,CAPE RACE NFLD,50,0,0,0,50
Tropical Depression,Ten,1,1999-09-19T10:00:00Z,26.2N  88.2W,42,0,0,0,42
Tropical Depression,Ten,1,1999-09-19T10:00:00Z,CAPE HATTERAS NC,0,0,0,5,5
Tropical Depression,Ten,1,1999-09-19T10:00:00Z,27.5N  87.4W,17,6,1,1,25
Tropical Depression,Ten,1,1999-09-19T10:00:00Z,NORFOLK VA,0,0,0,4,4
Tropical Depression,Ten,1,1999-09-19T10:00:00Z,28.5N  85.5W,2,10,7,2,21
Tropical Depression,Ten,1,1999-09-19T10:00:00Z,OCEAN CITY MD,0,0,0,2,2
Tropical Depression,Ten,1,1999-09-19T10:00:00Z,MUCF 221N 805W,0,0,0,3,3
Tropical Depression,Ten,1,1999-09-19T10:00:00Z,KEY WEST FL,0,0,1,8,9
Tropical Depression,Ten,1,1999-09-19T10:00:00Z,MUSN 216N 826W,0,0,0,3,3
Tropical Depression,Ten,1,1999-09-19T10:00:00Z,MARCO ISLAND FL,0,0,2,10,12
Tropical Depression,Ten,1,1999-09-19T10:00:00Z,MUHA 230N 824W,0,0,1,5,6
Tropical Depression,Ten,1,1999-09-19T10:00:00Z,FT MYERS FL,0,0,3,10,13
Tropical Depression,Ten,1,1999-09-19T10:00:00Z,MUAN 219N 850W,0,1,1,2,4
Tropical Depression,Ten,1,1999-09-19T10:00:00Z,VENICE FL,0,1,5,8,14
Tropical Depression,Ten,1,1999-09-19T10:00:00Z,MYEG 235N 758W,0,0,0,2,2
Tropical Depression,Ten,1,1999-09-19T10:00:00Z,TAMPA FL,0,0,6,10,16
Tropical Depression,Ten,1,1999-09-19T10:00:00Z,MYAK 241N 776W,0,0,0,4,4
Tropical Depression,Ten,1,1999-09-19T10:00:00Z,CEDAR KEY FL,0,0,8,9,17
Tropical Depression,Ten,1,1999-09-19T10:00:00Z,MYNN 251N 775W,0,0,0,5,5
Tropical Depression,Ten,1,1999-09-19T10:00:00Z,ST MARKS FL,0,1,11,6,18
Tropical Depression,Ten,1,1999-09-19T10:00:00Z,MYGF 266N 787W,0,0,0,9,9
Tropical Depression,Ten,1,1999-09-19T10:00:00Z,APALACHICOLA FL,0,5,11,3,19
Tropical Depression,Ten,1,1999-09-19T10:00:00Z,MARATHON FL,0,0,1,7,8
Tropical Depression,Ten,1,1999-09-19T10:00:00Z,PANAMA CITY FL,0,6,11,3,20
Tropical Depression,Ten,1,1999-09-19T10:00:00Z,MIAMI FL,0,0,0,9,9
Tropical Depression,Ten,1,1999-09-19T10:00:00Z,PENSACOLA FL,0,10,8,1,19
Tropical Depression,Ten,1,1999-09-19T10:00:00Z,W PALM BEACH FL,0,0,0,11,11
Tropical Depression,Ten,1,1999-09-19T10:00:00Z,MOBILE AL,1,10,5,2,18
Tropical Depression,Ten,1,1999-09-19T10:00:00Z,FT PIERCE FL,0,0,1,11,12
Tropical Depression,Ten,1,1999-09-19T10:00:00Z,GULFPORT MS,1,11,4,1,17
Tropical Depression,Ten,1,1999-09-19T10:00:00Z,COCOA BEACH FL,0,0,1,12,13
Tropical Depression,Ten,1,1999-09-19T10:00:00Z,BURAS LA,5,11,2,0,18
Tropical Depression,Ten,1,1999-09-19T10:00:00Z,DAYTONA BEACH FL,0,0,2,12,14
Tropical Depression,Ten,1,1999-09-19T10:00:00Z,NEW ORLEANS LA,2,9,2,1,14
Tropical Depression,Ten,1,1999-09-19T10:00:00Z,JACKSONVILLE FL,0,0,2,13,15
Tropical Depression,Ten,1,1999-09-19T10:00:00Z,NEW IBERIA LA,1,3,2,1,7
Tropical Depression,Ten,1,1999-09-19T10:00:00Z,SAVANNAH GA,0,0,1,13,14
Tropical Depression,Ten,1,1999-09-19T10:00:00Z,GULF 29N 85W,1,6,10,3,20
Tropical Depression,Ten,1,1999-09-19T10:00:00Z,CHARLESTON SC,0,0,0,12,12
Tropical Depression,Ten,1,1999-09-19T10:00:00Z,GULF 29N 87W,4,13,4,1,22
Tropical Depression,Ten,1,1999-09-19T10:00:00Z,MYRTLE BEACH SC,0,0,0,10,10
Tropical Depression,Ten,1,1999-09-19T10:00:00Z,GULF 28N 89W,16,6,1,1,24
Tropical Depression,Ten,1,1999-09-19T10:00:00Z,WILMINGTON NC,0,0,0,9,9
Tropical Depression,Ten,1,1999-09-19T10:00:00Z,GULF 28N 91W,8,5,1,0,14
Tropical Depression,Ten,1,1999-09-19T10:00:00Z,MOREHEAD CITY NC,0,0,0,7,7
Tropical Depression,Ten,1,1999-09-19T10:00:00Z,GULF 28N 93W,1,1,1,0,3
Tropical Depression,Ten,2,1999-09-19T15:00:00Z,28.0N  86.5W,34,0,0,0,34
Tropical Depression,Ten,2,1999-09-19T15:00:00Z,MOREHEAD CITY NC,0,0,0,10,10
Tropical Depression,Ten,2,1999-09-19T15:00:00Z,28.5N  85.1W,17,4,2,0,23
Tropical Depression,Ten,2,1999-09-19T15:00:00Z,CAPE HATTERAS NC,0,0,0,9,9
Tropical Depression,Ten,2,1999-09-19T15:00:00Z,29.2N  83.1W,1,11,5,2,19
Tropical Depression,Ten,2,1999-09-19T15:00:00Z,NORFOLK VA,0,0,0,8,8
Tropical Depression,Ten,2,1999-09-19T15:00:00Z,MUCM 214N 779W,0,0,0,2,2
Tropical Depression,Ten,2,1999-09-19T15:00:00Z,OCEAN CITY MD,0,0,0,6,6
Tropical Depression,Ten,2,1999-09-19T15:00:00Z,MUCF 221N 805W,0,0,1,4,5
Tropical Depression,Ten,2,1999-09-19T15:00:00Z,ATLANTIC CITY NJ,0,0,0,4,4
Tropical Depression,Ten,2,1999-09-19T15:00:00Z,MUSN 216N 826W,0,0,2,3,5
Tropical Depression,Ten,2,1999-09-19T15:00:00Z,NEW YORK CITY NY,0,0,0,2,2
Tropical Depression,Ten,2,1999-09-19T15:00:00Z,MUHA 230N 824W,0,1,3,4,8
Tropical Depression,Ten,2,1999-09-19T15:00:00Z,KEY WEST FL,0,1,6,4,11
Tropical Depression,Ten,2,1999-09-19T15:00:00Z,MUAN 219N 850W,0,1,3,2,6
Tropical Depression,Ten,2,1999-09-19T15:00:00Z,MARCO ISLAND FL,0,3,7,4,14
Tropical Depression,Ten,2,1999-09-19T15:00:00Z,MMCZ 205N 869W,0,0,1,2,3
Tropical Depression,Ten,2,1999-09-19T15:00:00Z,FT MYERS FL,1,4,7,3,15
Tropical Depression,Ten,2,1999-09-19T15:00:00Z,MYSM 241N 745W,0,0,0,3,3
Tropical Depression,Ten,2,1999-09-19T15:00:00Z,VENICE FL,2,7,5,3,17
Tropical Depression,Ten,2,1999-09-19T15:00:00Z,MYEG 235N 758W,0,0,0,3,3
Tropical Depression,Ten,2,1999-09-19T15:00:00Z,TAMPA FL,2,7,6,3,18
Tropical Depression,Ten,2,1999-09-19T15:00:00Z,MYAK 241N 776W,0,0,0,6,6
Tropical Depression,Ten,2,1999-09-19T15:00:00Z,CEDAR KEY FL,2,10,5,2,19
Tropical Depression,Ten,2,1999-09-19T15:00:00Z,MYNN 251N 775W,0,0,0,7,7
Tropical Depression,Ten,2,1999-09-19T15:00:00Z,ST MARKS FL,2,12,4,2,20
Tropical Depression,Ten,2,1999-09-19T15:00:00Z,MYGF 266N 787W,0,0,2,9,11
Tropical Depression,Ten,2,1999-09-19T15:00:00Z,APALACHICOLA FL,8,10,2,1,21
Tropical Depression,Ten,2,1999-09-19T15:00:00Z,MARATHON FL,0,1,4,6,11
Tropical Depression,Ten,2,1999-09-19T15:00:00Z,PANAMA CITY FL,8,10,2,1,21
Tropical Depression,Ten,2,1999-09-19T15:00:00Z,MIAMI FL,0,0,5,7,12
Tropical Depression,Ten,2,1999-09-19T15:00:00Z,PENSACOLA FL,7,8,1,1,17
Tropical Depression,Ten,2,1999-09-19T15:00:00Z,W PALM BEACH FL,0,1,5,7,13
Tropical Depression,Ten,2,1999-09-19T15:00:00Z,MOBILE AL,5,6,1,0,12
Tropical Depression,Ten,2,1999-09-19T15:00:00Z,FT PIERCE FL,0,1,7,6,14
Tropical Depression,Ten,2,1999-09-19T15:00:00Z,GULFPORT MS,5,4,1,0,10
Tropical Depression,Ten,2,1999-09-19T15:00:00Z,COCOA BEACH FL,0,2,7,6,15
Tropical Depression,Ten,2,1999-09-19T15:00:00Z,BURAS LA,9,2,1,0,12
Tropical Depression,Ten,2,1999-09-19T15:00:00Z,DAYTONA BEACH FL,0,3,9,5,17
Tropical Depression,Ten,2,1999-09-19T15:00:00Z,NEW ORLEANS LA,3,2,0,1,6
Tropical Depression,Ten,2,1999-09-19T15:00:00Z,JACKSONVILLE FL,0,4,9,4,17
Tropical Depression,Ten,2,1999-09-19T15:00:00Z,GULF 29N 85W,14,6,2,1,23
Tropical Depression,Ten,2,1999-09-19T15:00:00Z,SAVANNAH GA,0,1,9,6,16
Tropical Depression,Ten,2,1999-09-19T15:00:00Z,GULF 29N 87W,24,1,0,1,26
Tropical Depression,Ten,2,1999-09-19T15:00:00Z,CHARLESTON SC,0,0,6,8,14
Tropical Depression,Ten,2,1999-09-19T15:00:00Z,GULF 28N 89W,25,1,0,0,26
Tropical Depression,Ten,2,1999-09-19T15:00:00Z,MYRTLE BEACH SC,0,0,3,10,13
Tropical Depression,Ten,2,1999-09-19T15:00:00Z,GULF 28N 91W,2,1,1,0,4
Tropical Depression,Ten,2,1999-09-19T15:00:00Z,WILMINGTON NC,0,0,1,11,12
Tropical Depression,Ten,3,1999-09-19T21:00:00Z,27.4N  86.8W,46,0,0,0,46
Tropical Depression,Ten,3,1999-09-19T21:00:00Z,OCEAN CITY MD,0,0,0,7,7
Tropical Depression,Ten,3,1999-09-19T21:00:00Z,28.1N  85.2W,11,13,4,0,28
Tropical Depression,Ten,3,1999-09-19T21:00:00Z,ATLANTIC CITY NJ,0,0,0,5,5
Tropical Depression,Ten,3,1999-09-19T21:00:00Z,29.5N  82.5W,0,5,17,2,24
Tropical Depression,Ten,3,1999-09-19T21:00:00Z,NEW YORK CITY NY,0,0,0,3,3
Tropical Depression,Ten,3,1999-09-19T21:00:00Z,MUCF 221N 805W,0,0,0,2,2
Tropical Depression,Ten,3,1999-09-19T21:00:00Z,MONTAUK POINT NY,0,0,0,2,2
Tropical Depression,Ten,3,1999-09-19T21:00:00Z,MUHA 230N 824W,0,0,1,3,4
Tropical Depression,Ten,3,1999-09-19T21:00:00Z,PROVIDENCE RI,0,0,0,2,2
Tropical Depression,Ten,3,1999-09-19T21:00:00Z,MUAN 219N 850W,0,0,1,1,2
Tropical Depression,Ten,3,1999-09-19T21:00:00Z,NANTUCKET MA,0,0,0,2,2
Tropical Depression,Ten,3,1999-09-19T21:00:00Z,MYSM 241N 745W,0,0,0,2,2
Tropical Depression,Ten,3,1999-09-19T21:00:00Z,KEY WEST FL,0,1,3,5,9
Tropical Depression,Ten,3,1999-09-19T21:00:00Z,MYEG 235N 758W,0,0,0,2,2
Tropical Depression,Ten,3,1999-09-19T21:00:00Z,MARCO ISLAND FL,0,1,9,4,14
Tropical Depression,Ten,3,1999-09-19T21:00:00Z,MYAK 241N 776W,0,0,0,4,4
Tropical Depression,Ten,3,1999-09-19T21:00:00Z,FT MYERS FL,0,3,10,4,17
Tropical Depression,Ten,3,1999-09-19T21:00:00Z,MYNN 251N 775W,0,0,0,6,6
Tropical Depression,Ten,3,1999-09-19T21:00:00Z,VENICE FL,1,5,12,2,20
Tropical Depression,Ten,3,1999-09-19T21:00:00Z,MYGF 266N 787W,0,0,1,10,11
Tropical Depression,Ten,3,1999-09-19T21:00:00Z,TAMPA FL,0,6,15,1,22
Tropical Depression,Ten,3,1999-09-19T21:00:00Z,MARATHON FL,0,0,3,6,9
Tropical Depression,Ten,3,1999-09-19T21:00:00Z,CEDAR KEY FL,0,9,15,1,25
Tropical Depression,Ten,3,1999-09-19T21:00:00Z,MIAMI FL,0,0,3,9,12
Tropical Depression,Ten,3,1999-09-19T21:00:00Z,ST MARKS FL,0,12,12,1,25
Tropical Depression,Ten,3,1999-09-19T21:00:00Z,W PALM BEACH FL,0,0,4,10,14
Tropical Depression,Ten,3,1999-09-19T21:00:00Z,APALACHICOLA FL,3,16,7,0,26
Tropical Depression,Ten,3,1999-09-19T21:00:00Z,FT PIERCE FL,0,0,7,9,16
Tropical Depression,Ten,3,1999-09-19T21:00:00Z,PANAMA CITY FL,3,16,5,0,24
Tropical Depression,Ten,3,1999-09-19T21:00:00Z,COCOA BEACH FL,0,0,10,9,19
Tropical Depression,Ten,3,1999-09-19T21:00:00Z,PENSACOLA FL,3,12,3,0,18
Tropical Depression,Ten,3,1999-09-19T21:00:00Z,DAYTONA BEACH FL,0,1,14,6,21
Tropical Depression,Ten,3,1999-09-19T21:00:00Z,MOBILE AL,3,8,1,1,13
Tropical Depression,Ten,3,1999-09-19T21:00:00Z,JACKSONVILLE FL,0,1,16,5,22
Tropical Depression,Ten,3,1999-09-19T21:00:00Z,GULFPORT MS,4,5,1,1,11
Tropical Depression,Ten,3,1999-09-19T21:00:00Z,SAVANNAH GA,0,0,11,9,20
Tropical Depression,Ten,3,1999-09-19T21:00:00Z,BURAS LA,9,3,0,0,12
Tropical Depression,Ten,3,1999-09-19T21:00:00Z,CHARLESTON SC,0,0,4,14,18
Tropical Depression,Ten,3,1999-09-19T21:00:00Z,NEW ORLEANS LA,3,3,0,0,6
Tropical Depression,Ten,3,1999-09-19T21:00:00Z,MYRTLE BEACH SC,0,0,1,15,16
Tropical Depression,Ten,3,1999-09-19T21:00:00Z,GULF 29N 85W,5,17,5,0,27
Tropical Depression,Ten,3,1999-09-19T21:00:00Z,WILMINGTON NC,0,0,0,15,15
Tropical Depression,Ten,3,1999-09-19T21:00:00Z,GULF 29N 87W,16,8,1,0,25
Tropical Depression,Ten,3,1999-09-19T21:00:00Z,MOREHEAD CITY NC,0,0,0,14,14
Tropical Depression,Ten,3,1999-09-19T21:00:00Z,GULF 28N 89W,23,1,0,0,24
Tropical Depression,Ten,3,1999-09-19T21:00:00Z,CAPE HATTERAS NC,0,0,0,13,13
Tropical Depression,Ten,3,1999-09-19T21:00:00Z,GULF 28N 91W,4,1,1,0,6
Tropical Depression,Ten,3,1999-09-19T21:00:00Z,NORFOLK VA,0,0,0,10,10
Tropical Storm,Harvey,4,1999-09-20T03:00:00Z,26.7N  86.7W,80,0,0,0,80
Tropical Storm,Harvey,4,1999-09-20T03:00:00Z,NORFOLK VA,0,0,0,9,9
Tropical Storm,Harvey,4,1999-09-20T03:00:00Z,27.6N  85.0W,20,12,1,0,33
Tropical Storm,Harvey,4,1999-09-20T03:00:00Z,OCEAN CITY MD,0,0,0,6,6
Tropical Storm,Harvey,4,1999-09-20T03:00:00Z,28.8N  82.3W,1,12,12,3,28
Tropical Storm,Harvey,4,1999-09-20T03:00:00Z,ATLANTIC CITY NJ,0,0,0,3,3
Tropical Storm,Harvey,4,1999-09-20T03:00:00Z,MYNN 251N 775W,0,0,0,3,3
Tropical Storm,Harvey,4,1999-09-20T03:00:00Z,NEW YORK CITY NY,0,0,0,2,2
Tropical Storm,Harvey,4,1999-09-20T03:00:00Z,MYGF 266N 787W,0,0,0,11,11
Tropical Storm,Harvey,4,1999-09-20T03:00:00Z,KEY WEST FL,0,0,1,4,5
Tropical Storm,Harvey,4,1999-09-20T03:00:00Z,BERMUDA,0,0,0,4,4
Tropical Storm,Harvey,4,1999-09-20T03:00:00Z,MARCO ISLAND FL,0,0,6,8,14
Tropical Storm,Harvey,4,1999-09-20T03:00:00Z,MARATHON FL,0,0,1,4,5
Tropical Storm,Harvey,4,1999-09-20T03:00:00Z,FT MYERS FL,0,1,11,6,18
Tropical Storm,Harvey,4,1999-09-20T03:00:00Z,MIAMI FL,0,0,1,9,10
Tropical Storm,Harvey,4,1999-09-20T03:00:00Z,VENICE FL,0,6,13,4,23
Tropical Storm,Harvey,4,1999-09-20T03:00:00Z,W PALM BEACH FL,0,0,3,11,14
Tropical Storm,Harvey,4,1999-09-20T03:00:00Z,TAMPA FL,1,10,13,3,27
Tropical Storm,Harvey,4,1999-09-20T03:00:00Z,FT PIERCE FL,0,0,7,11,18
Tropical Storm,Harvey,4,1999-09-20T03:00:00Z,CEDAR KEY FL,2,18,9,1,30
Tropical Storm,Harvey,4,1999-09-20T03:00:00Z,COCOA BEACH FL,0,1,12,9,22
Tropical Storm,Harvey,4,1999-09-20T03:00:00Z,ST MARKS FL,3,16,5,1,25
Tropical Storm,Harvey,4,1999-09-20T03:00:00Z,DAYTONA BEACH FL,0,4,17,5,26
Tropical Storm,Harvey,4,1999-09-20T03:00:00Z,APALACHICOLA FL,8,14,3,0,25
Tropical Storm,Harvey,4,1999-09-20T03:00:00Z,JACKSONVILLE FL,0,9,14,4,27
Tropical Storm,Harvey,4,1999-09-20T03:00:00Z,PANAMA CITY FL,6,11,3,1,21
Tropical Storm,Harvey,4,1999-09-20T03:00:00Z,SAVANNAH GA,0,3,11,8,22
Tropical Storm,Harvey,4,1999-09-20T03:00:00Z,PENSACOLA FL,1,2,2,3,8
Tropical Storm,Harvey,4,1999-09-20T03:00:00Z,CHARLESTON SC,0,1,8,11,20
Tropical Storm,Harvey,4,1999-09-20T03:00:00Z,MOBILE AL,0,0,1,1,2
Tropical Storm,Harvey,4,1999-09-20T03:00:00Z,MYRTLE BEACH SC,0,0,4,14,18
Tropical Storm,Harvey,4,1999-09-20T03:00:00Z,GULF 29N 85W,13,15,2,0,30
Tropical Storm,Harvey,4,1999-09-20T03:00:00Z,WILMINGTON NC,0,0,2,15,17
Tropical Storm,Harvey,4,1999-09-20T03:00:00Z,GULF 29N 87W,12,6,1,0,19
Tropical Storm,Harvey,4,1999-09-20T03:00:00Z,MOREHEAD CITY NC,0,0,1,15,16
Tropical Storm,Harvey,4,1999-09-20T03:00:00Z,GULF 28N 89W,5,3,2,1,11
Tropical Storm,Harvey,4,1999-09-20T03:00:00Z,CAPE HATTERAS NC,0,0,0,15,15
Tropical Storm,Harvey,5,1999-09-20T09:00:00Z,26.8N  85.6W,33,0,0,0,33
Tropical Storm,Harvey,5,1999-09-20T09:00:00Z,NEW YORK CITY NY,0,0,0,5,5
Tropical Storm,Harvey,5,1999-09-20T09:00:00Z,27.9N  83.4W,10,14,1,0,25
Tropical Storm,Harvey,5,1999-09-20T09:00:00Z,MONTAUK POINT NY,0,0,0,5,5
Tropical Storm,Harvey,5,1999-09-20T09:00:00Z,29.5N  80.0W,0,6,13,2,21
Tropical Storm,Harvey,5,1999-09-20T09:00:00Z,PROVIDENCE RI,0,0,0,4,4
Tropical Storm,Harvey,5,1999-09-20T09:00:00Z,MUHA 230N 824W,0,1,1,1,3
Tropical Storm,Harvey,5,1999-09-20T09:00:00Z,NANTUCKET MA,0,0,0,4,4
Tropical Storm,Harvey,5,1999-09-20T09:00:00Z,MYAK 241N 776W,0,0,1,2,3
Tropical Storm,Harvey,5,1999-09-20T09:00:00Z,HYANNIS MA,0,0,0,4,4
Tropical Storm,Harvey,5,1999-09-20T09:00:00Z,MYNN 251N 775W,0,0,2,3,5
Tropical Storm,Harvey,5,1999-09-20T09:00:00Z,BOSTON MA,0,0,0,3,3
Tropical Storm,Harvey,5,1999-09-20T09:00:00Z,MYGF 266N 787W,0,1,8,4,13
Tropical Storm,Harvey,5,1999-09-20T09:00:00Z,PORTLAND ME,0,0,0,2,2
Tropical Storm,Harvey,5,1999-09-20T09:00:00Z,BERMUDA,0,0,0,6,6
Tropical Storm,Harvey,5,1999-09-20T09:00:00Z,KEY WEST FL,0,3,5,1,9
Tropical Storm,Harvey,5,1999-09-20T09:00:00Z,MARATHON FL,0,2,5,2,9
Tropical Storm,Harvey,5,1999-09-20T09:00:00Z,MARCO ISLAND FL,1,9,6,0,16
Tropical Storm,Harvey,5,1999-09-20T09:00:00Z,MIAMI FL,0,3,8,2,13
Tropical Storm,Harvey,5,1999-09-20T09:00:00Z,FT MYERS FL,1,13,5,0,19
Tropical Storm,Harvey,5,1999-09-20T09:00:00Z,W PALM BEACH FL,0,4,10,2,16
Tropical Storm,Harvey,5,1999-09-20T09:00:00Z,VENICE FL,4,15,3,0,22
Tropical Storm,Harvey,5,1999-09-20T09:00:00Z,FT PIERCE FL,0,7,10,2,19
Tropical Storm,Harvey,5,1999-09-20T09:00:00Z,TAMPA FL,3,17,3,0,23
Tropical Storm,Harvey,5,1999-09-20T09:00:00Z,COCOA BEACH FL,0,10,9,2,21
Tropical Storm,Harvey,5,1999-09-20T09:00:00Z,CEDAR KEY FL,3,17,3,0,23
Tropical Storm,Harvey,5,1999-09-20T09:00:00Z,DAYTONA BEACH FL,0,12,9,1,22
Tropical Storm,Harvey,5,1999-09-20T09:00:00Z,ST MARKS FL,2,12,4,1,19
Tropical Storm,Harvey,5,1999-09-20T09:00:00Z,JACKSONVILLE FL,0,9,10,1,20
Tropical Storm,Harvey,5,1999-09-20T09:00:00Z,APALACHICOLA FL,5,11,3,0,19
Tropical Storm,Harvey,5,1999-09-20T09:00:00Z,SAVANNAH GA,0,2,11,4,17
Tropical Storm,Harvey,5,1999-09-20T09:00:00Z,PANAMA CITY FL,3,10,3,0,16
Tropical Storm,Harvey,5,1999-09-20T09:00:00Z,CHARLESTON SC,0,0,9,7,16
Tropical Storm,Harvey,5,1999-09-20T09:00:00Z,PENSACOLA FL,0,4,4,1,9
Tropical Storm,Harvey,5,1999-09-20T09:00:00Z,MYRTLE BEACH SC,0,0,5,10,15
Tropical Storm,Harvey,5,1999-09-20T09:00:00Z,MOBILE AL,0,1,2,0,3
Tropical Storm,Harvey,5,1999-09-20T09:00:00Z,WILMINGTON NC,0,0,3,12,15
Tropical Storm,Harvey,5,1999-09-20T09:00:00Z,GULFPORT MS,0,1,1,0,2
Tropical Storm,Harvey,5,1999-09-20T09:00:00Z,MOREHEAD CITY NC,0,0,2,12,14
Tropical Storm,Harvey,5,1999-09-20T09:00:00Z,BURAS LA,0,1,1,0,2
Tropical Storm,Harvey,5,1999-09-20T09:00:00Z,CAPE HATTERAS NC,0,0,1,13,14
Tropical Storm,Harvey,5,1999-09-20T09:00:00Z,GULF 29N 85W,12,9,1,0,22
Tropical Storm,Harvey,5,1999-09-20T09:00:00Z,NORFOLK VA,0,0,0,11,11
Tropical Storm,Harvey,5,1999-09-20T09:00:00Z,GULF 29N 87W,10,5,1,0,16
Tropical Storm,Harvey,5,1999-09-20T09:00:00Z,OCEAN CITY MD,0,0,0,9,9
Tropical Storm,Harvey,5,1999-09-20T09:00:00Z,GULF 28N 89W,6,3,1,0,10
Tropical Storm,Harvey,5,1999-09-20T09:00:00Z,ATLANTIC CITY NJ,0,0,0,7,7
Tropical Storm,Harvey,6,1999-09-20T15:00:00Z,27.9N  83.3W,35,1,0,0,36
Tropical Storm,Harvey,6,1999-09-20T15:00:00Z,NEW YORK CITY NY,0,0,0,3,3
Tropical Storm,Harvey,6,1999-09-20T15:00:00Z,28.7N  81.0W,11,13,2,1,27
Tropical Storm,Harvey,6,1999-09-20T15:00:00Z,MONTAUK POINT NY,0,0,0,3,3
Tropical Storm,Harvey,6,1999-09-20T15:00:00Z,31.0N  77.0W,0,3,16,2,21
Tropical Storm,Harvey,6,1999-09-20T15:00:00Z,PROVIDENCE RI,0,0,0,3,3
Tropical Storm,Harvey,6,1999-09-20T15:00:00Z,MYAK 241N 776W,0,0,1,1,2
Tropical Storm,Harvey,6,1999-09-20T15:00:00Z,NANTUCKET MA,0,0,0,4,4
Tropical Storm,Harvey,6,1999-09-20T15:00:00Z,MYNN 251N 775W,0,2,2,1,5
Tropical Storm,Harvey,6,1999-09-20T15:00:00Z,HYANNIS MA,0,0,0,3,3
Tropical Storm,Harvey,6,1999-09-20T15:00:00Z,MYGF 266N 787W,1,11,4,1,17
Tropical Storm,Harvey,6,1999-09-20T15:00:00Z,BOSTON MA,0,0,0,2,2
Tropical Storm,Harvey,6,1999-09-20T15:00:00Z,BERMUDA,0,0,0,8,8
Tropical Storm,Harvey,6,1999-09-20T15:00:00Z,KEY WEST FL,3,4,2,0,9
Tropical Storm,Harvey,6,1999-09-20T15:00:00Z,MARATHON FL,2,5,2,0,9
Tropical Storm,Harvey,6,1999-09-20T15:00:00Z,MARCO ISLAND FL,14,5,1,0,20
Tropical Storm,Harvey,6,1999-09-20T15:00:00Z,MIAMI FL,4,9,2,1,16
Tropical Storm,Harvey,6,1999-09-20T15:00:00Z,FT MYERS FL,21,3,0,0,24
Tropical Storm,Harvey,6,1999-09-20T15:00:00Z,W PALM BEACH FL,6,12,2,0,20
Tropical Storm,Harvey,6,1999-09-20T15:00:00Z,VENICE FL,29,1,0,0,30
Tropical Storm,Harvey,6,1999-09-20T15:00:00Z,FT PIERCE FL,8,14,2,0,24
Tropical Storm,Harvey,6,1999-09-20T15:00:00Z,TAMPA FL,28,2,0,0,30
Tropical Storm,Harvey,6,1999-09-20T15:00:00Z,COCOA BEACH FL,10,14,2,0,26
Tropical Storm,Harvey,6,1999-09-20T15:00:00Z,CEDAR KEY FL,20,4,1,0,25
Tropical Storm,Harvey,6,1999-09-20T15:00:00Z,DAYTONA BEACH FL,8,14,4,0,26
Tropical Storm,Harvey,6,1999-09-20T15:00:00Z,ST MARKS FL,8,6,4,0,18
Tropical Storm,Harvey,6,1999-09-20T15:00:00Z,JACKSONVILLE FL,2,12,7,0,21
Tropical Storm,Harvey,6,1999-09-20T15:00:00Z,APALACHICOLA FL,13,4,1,1,19
Tropical Storm,Harvey,6,1999-09-20T15:00:00Z,SAVANNAH GA,0,3,10,2,15
Tropical Storm,Harvey,6,1999-09-20T15:00:00Z,PANAMA CITY FL,7,5,3,0,15
Tropical Storm,Harvey,6,1999-09-20T15:00:00Z,CHARLESTON SC,0,1,9,4,14
Tropical Storm,Harvey,6,1999-09-20T15:00:00Z,PENSACOLA FL,1,2,3,0,6
Tropical Storm,Harvey,6,1999-09-20T15:00:00Z,MYRTLE BEACH SC,0,0,6,7,13
Tropical Storm,Harvey,6,1999-09-20T15:00:00Z,MOBILE AL,0,1,1,1,3
Tropical Storm,Harvey,6,1999-09-20T15:00:00Z,WILMINGTON NC,0,0,4,9,13
Tropical Storm,Harvey,6,1999-09-20T15:00:00Z,GULFPORT MS,0,1,0,1,2
Tropical Storm,Harvey,6,1999-09-20T15:00:00Z,MOREHEAD CITY NC,0,0,3,10,13
Tropical Storm,Harvey,6,1999-09-20T15:00:00Z,BURAS LA,0,1,0,1,2
Tropical Storm,Harvey,6,1999-09-20T15:00:00Z,CAPE HATTERAS NC,0,0,2,10,12
Tropical Storm,Harvey,6,1999-09-20T15:00:00Z,GULF 29N 85W,22,1,1,0,24
Tropical Storm,Harvey,6,1999-09-20T15:00:00Z,NORFOLK VA,0,0,0,8,8
Tropical Storm,Harvey,6,1999-09-20T15:00:00Z,GULF 29N 87W,9,3,2,0,14
Tropical Storm,Harvey,6,1999-09-20T15:00:00Z,OCEAN CITY MD,0,0,0,6,6
Tropical Storm,Harvey,6,1999-09-20T15:00:00Z,GULF 28N 89W,1,2,1,0,4
Tropical Storm,Harvey,6,1999-09-20T15:00:00Z,ATLANTIC CITY NJ,0,0,0,4,4
Tropical Storm,Harvey,7,1999-09-20T21:00:00Z,27.9N  82.2W,31,2,0,0,33
Tropical Storm,Harvey,7,1999-09-20T21:00:00Z,NEW YORK CITY NY,0,0,0,5,5
Tropical Storm,Harvey,7,1999-09-20T21:00:00Z,29.5N  79.0W,2,22,5,0,29
Tropical Storm,Harvey,7,1999-09-20T21:00:00Z,MONTAUK POINT NY,0,0,0,6,6
Tropical Storm,Harvey,7,1999-09-20T21:00:00Z,32.5N  74.0W,0,1,18,2,21
Tropical Storm,Harvey,7,1999-09-20T21:00:00Z,PROVIDENCE RI,0,0,0,5,5
Tropical Storm,Harvey,7,1999-09-20T21:00:00Z,MYNN 251N 775W,0,1,1,0,2
Tropical Storm,Harvey,7,1999-09-20T21:00:00Z,NANTUCKET MA,0,0,0,6,6
Tropical Storm,Harvey,7,1999-09-20T21:00:00Z,MYGF 266N 787W,1,12,3,0,16
Tropical Storm,Harvey,7,1999-09-20T21:00:00Z,HYANNIS MA,0,0,0,6,6
Tropical Storm,Harvey,7,1999-09-20T21:00:00Z,BERMUDA,0,0,1,9,10
Tropical Storm,Harvey,7,1999-09-20T21:00:00Z,BOSTON MA,0,0,0,4,4
Tropical Storm,Harvey,7,1999-09-20T21:00:00Z,MARATHON FL,3,4,1,0,8
Tropical Storm,Harvey,7,1999-09-20T21:00:00Z,PORTLAND ME,0,0,0,2,2
Tropical Storm,Harvey,7,1999-09-20T21:00:00Z,MIAMI FL,4,10,1,0,15
Tropical Storm,Harvey,7,1999-09-20T21:00:00Z,BAR HARBOR ME,0,0,0,2,2
Tropical Storm,Harvey,7,1999-09-20T21:00:00Z,W PALM BEACH FL,6,14,1,1,22
Tropical Storm,Harvey,7,1999-09-20T21:00:00Z,EASTPORT ME,0,0,0,2,2
Tropical Storm,Harvey,7,1999-09-20T21:00:00Z,FT PIERCE FL,11,15,1,0,27
Tropical Storm,Harvey,7,1999-09-20T21:00:00Z,YARMOUTH NS,0,0,0,3,3
Tropical Storm,Harvey,7,1999-09-20T21:00:00Z,COCOA BEACH FL,15,14,1,0,30
Tropical Storm,Harvey,7,1999-09-20T21:00:00Z,HALIFAX NS,0,0,0,2,2
Tropical Storm,Harvey,7,1999-09-20T21:00:00Z,DAYTONA BEACH FL,16,12,2,0,30
Tropical Storm,Harvey,7,1999-09-20T21:00:00Z,SABLE ISLAND NS,0,0,0,2,2
Tropical Storm,Harvey,7,1999-09-20T21:00:00Z,JACKSONVILLE FL,7,13,3,1,24
Tropical Storm,Harvey,7,1999-09-20T21:00:00Z,KEY WEST FL,5,3,0,0,8
Tropical Storm,Harvey,7,1999-09-20T21:00:00Z,SAVANNAH GA,1,5,9,0,15
Tropical Storm,Harvey,7,1999-09-20T21:00:00Z,MARCO ISLAND FL,18,4,0,0,22
Tropical Storm,Harvey,7,1999-09-20T21:00:00Z,CHARLESTON SC,0,3,10,1,14
Tropical Storm,Harvey,7,1999-09-20T21:00:00Z,FT MYERS FL,25,3,0,0,28
Tropical Storm,Harvey,7,1999-09-20T21:00:00Z,MYRTLE BEACH SC,0,1,9,3,13
Tropical Storm,Harvey,7,1999-09-20T21:00:00Z,VENICE FL,34,0,0,0,34
Tropical Storm,Harvey,7,1999-09-20T21:00:00Z,WILMINGTON NC,0,0,8,5,13
Tropical Storm,Harvey,7,1999-09-20T21:00:00Z,TAMPA FL,33,1,0,0,34
Tropical Storm,Harvey,7,1999-09-20T21:00:00Z,MOREHEAD CITY NC,0,0,8,6,14
Tropical Storm,Harvey,7,1999-09-20T21:00:00Z,CEDAR KEY FL,25,2,0,1,28
Tropical Storm,Harvey,7,1999-09-20T21:00:00Z,CAPE HATTERAS NC,0,0,6,8,14
Tropical Storm,Harvey,7,1999-09-20T21:00:00Z,ST MARKS FL,7,5,3,0,15
Tropical Storm,Harvey,7,1999-09-20T21:00:00Z,NORFOLK VA,0,0,1,9,10
Tropical Storm,Harvey,7,1999-09-20T21:00:00Z,APALACHICOLA FL,7,4,2,0,13
Tropical Storm,Harvey,7,1999-09-20T21:00:00Z,OCEAN CITY MD,0,0,0,8,8
Tropical Storm,Harvey,7,1999-09-20T21:00:00Z,PANAMA CITY FL,1,3,1,0,5
Tropical Storm,Harvey,7,1999-09-20T21:00:00Z,ATLANTIC CITY NJ,0,0,0,6,6
Tropical Storm,Harvey,7,1999-09-20T21:00:00Z,GULF 29N 85W,20,1,0,0,21
Tropical Storm,Harvey,8,1999-09-21T03:00:00Z,28.4N  78.7W,33,3,1,0,37
Tropical Storm,Harvey,8,1999-09-21T03:00:00Z,NANTUCKET MA,0,0,0,6,6
Tropical Storm,Harvey,8,1999-09-21T03:00:00Z,31.5N  74.5W,0,19,6,0,25
Tropical Storm,Harvey,8,1999-09-21T03:00:00Z,HYANNIS MA,0,0,0,5,5
Tropical Storm,Harvey,8,1999-09-21T03:00:00Z,36.0N  68.0W,0,0,12,4,16
Tropical Storm,Harvey,8,1999-09-21T03:00:00Z,BOSTON MA,0,0,0,3,3
Tropical Storm,Harvey,8,1999-09-21T03:00:00Z,MYAK 241N 776W,1,2,0,0,3
Tropical Storm,Harvey,8,1999-09-21T03:00:00Z,PORTLAND ME,0,0,0,3,3
Tropical Storm,Harvey,8,1999-09-21T03:00:00Z,MYNN 251N 775W,4,5,0,0,9
Tropical Storm,Harvey,8,1999-09-21T03:00:00Z,BAR HARBOR ME,0,0,0,3,3
Tropical Storm,Harvey,8,1999-09-21T03:00:00Z,MYGF 266N 787W,30,3,0,0,33
Tropical Storm,Harvey,8,1999-09-21T03:00:00Z,EASTPORT ME,0,0,0,4,4
Tropical Storm,Harvey,8,1999-09-21T03:00:00Z,BERMUDA,0,0,6,3,9
Tropical Storm,Harvey,8,1999-09-21T03:00:00Z,ST JOHN NB,0,0,0,4,4
Tropical Storm,Harvey,8,1999-09-21T03:00:00Z,MARATHON FL,16,1,0,0,17
Tropical Storm,Harvey,8,1999-09-21T03:00:00Z,MONCTON NB,0,0,0,3,3
Tropical Storm,Harvey,8,1999-09-21T03:00:00Z,MIAMI FL,34,0,0,0,34
Tropical Storm,Harvey,8,1999-09-21T03:00:00Z,YARMOUTH NS,0,0,0,6,6
Tropical Storm,Harvey,8,1999-09-21T03:00:00Z,W PALM BEACH FL,43,0,0,0,43
Tropical Storm,Harvey,8,1999-09-21T03:00:00Z,HALIFAX NS,0,0,0,6,6
Tropical Storm,Harvey,8,1999-09-21T03:00:00Z,FT PIERCE FL,46,0,0,0,46
Tropical Storm,Harvey,8,1999-09-21T03:00:00Z,SABLE ISLAND NS,0,0,0,9,9
Tropical Storm,Harvey,8,1999-09-21T03:00:00Z,COCOA BEACH FL,39,0,0,0,39
Tropical Storm,Harvey,8,1999-09-21T03:00:00Z,SYDNEY NS,0,0,0,5,5
Tropical Storm,Harvey,8,1999-09-21T03:00:00Z,DAYTONA BEACH FL,11,2,0,0,13
Tropical Storm,Harvey,8,1999-09-21T03:00:00Z,EDDY POINT NS,0,0,0,6,6
Tropical Storm,Harvey,8,1999-09-21T03:00:00Z,MYRTLE BEACH SC,0,1,1,0,2
Tropical Storm,Harvey,8,1999-09-21T03:00:00Z,PTX BASQUES NFLD,0,0,0,3,3
Tropical Storm,Harvey,8,1999-09-21T03:00:00Z,WILMINGTON NC,0,1,1,1,3
Tropical Storm,Harvey,8,1999-09-21T03:00:00Z,BURGEO NFLD,0,0,0,3,3
Tropical Storm,Harvey,8,1999-09-21T03:00:00Z,MOREHEAD CITY NC,0,1,3,1,5
Tropical Storm,Harvey,8,1999-09-21T03:00:00Z,ILE ST PIERRE,0,0,0,4,4
Tropical Storm,Harvey,8,1999-09-21T03:00:00Z,CAPE HATTERAS NC,0,1,4,1,6
Tropical Storm,Harvey,8,1999-09-21T03:00:00Z,CAPE RACE NFLD,0,0,0,4,4
Tropical Storm,Harvey,8,1999-09-21T03:00:00Z,NORFOLK VA,0,0,1,1,2
Tropical Storm,Harvey,8,1999-09-21T03:00:00Z,HIBERNIA OILFLD,0,0,0,2,2
Tropical Storm,Harvey,8,1999-09-21T03:00:00Z,OCEAN CITY MD,0,0,1,2,3
Tropical Storm,Harvey,8,1999-09-21T03:00:00Z,KEY WEST FL,13,0,0,0,13
Tropical Storm,Harvey,8,1999-09-21T03:00:00Z,ATLANTIC CITY NJ,0,0,0,2,2
Tropical Storm,Harvey,8,1999-09-21T03:00:00Z,MARCO ISLAND FL,51,0,0,0,51
Tropical Storm,Harvey,8,1999-09-21T03:00:00Z,NEW YORK CITY NY,0,0,0,2,2
Tropical Storm,Harvey,8,1999-09-21T03:00:00Z,FT MYERS FL,62,0,0,0,62
Tropical Storm,Harvey,8,1999-09-21T03:00:00Z,MONTAUK POINT NY,0,0,0,4,4
Tropical Storm,Harvey,8,1999-09-21T03:00:00Z,VENICE FL,71,0,0,0,71
Tropical Storm,Harvey,8,1999-09-21T03:00:00Z,PROVIDENCE RI,0,0,0,4,4
Tropical Storm,Harvey,8,1999-09-21T03:00:00Z,TAMPA FL,45,0,0,0,45
Tropical Storm,Harvey,9,1999-09-21T09:00:00Z,26.6N  79.1W,38,3,0,0,41
Tropical Storm,Harvey,9,1999-09-21T09:00:00Z,MONTAUK POINT NY,0,0,0,7,7
Tropical Storm,Harvey,9,1999-09-21T09:00:00Z,29.1N  75.4W,0,24,5,0,29
Tropical Storm,Harvey,9,1999-09-21T09:00:00Z,PROVIDENCE RI,0,0,0,7,7
Tropical Storm,Harvey,9,1999-09-21T09:00:00Z,33.0N  71.0W,0,0,17,4,21
Tropical Storm,Harvey,9,1999-09-21T09:00:00Z,NANTUCKET MA,0,0,0,9,9
Tropical Storm,Harvey,9,1999-09-21T09:00:00Z,MYSM 241N 745W,0,2,0,0,2
Tropical Storm,Harvey,9,1999-09-21T09:00:00Z,HYANNIS MA,0,0,0,9,9
Tropical Storm,Harvey,9,1999-09-21T09:00:00Z,MYEG 235N 758W,0,2,0,0,2
Tropical Storm,Harvey,9,1999-09-21T09:00:00Z,BOSTON MA,0,0,0,7,7
Tropical Storm,Harvey,9,1999-09-21T09:00:00Z,MYAK 241N 776W,5,4,0,0,9
Tropical Storm,Harvey,9,1999-09-21T09:00:00Z,PORTLAND ME,0,0,0,6,6
Tropical Storm,Harvey,9,1999-09-21T09:00:00Z,MYNN 251N 775W,14,9,0,0,23
Tropical Storm,Harvey,9,1999-09-21T09:00:00Z,BAR HARBOR ME,0,0,0,7,7
Tropical Storm,Harvey,9,1999-09-21T09:00:00Z,MYGF 266N 787W,35,5,0,0,40
Tropical Storm,Harvey,9,1999-09-21T09:00:00Z,EASTPORT ME,0,0,0,7,7
Tropical Storm,Harvey,9,1999-09-21T09:00:00Z,BERMUDA,0,0,2,9,11
Tropical Storm,Harvey,9,1999-09-21T09:00:00Z,ST JOHN NB,0,0,0,7,7
Tropical Storm,Harvey,9,1999-09-21T09:00:00Z,MARATHON FL,41,0,0,0,41
Tropical Storm,Harvey,9,1999-09-21T09:00:00Z,MONCTON NB,0,0,0,6,6
Tropical Storm,Harvey,9,1999-09-21T09:00:00Z,MIAMI FL,49,0,0,0,49
Tropical Storm,Harvey,9,1999-09-21T09:00:00Z,YARMOUTH NS,0,0,0,9,9
Tropical Storm,Harvey,9,1999-09-21T09:00:00Z,W PALM BEACH FL,44,1,0,0,45
Tropical Storm,Harvey,9,1999-09-21T09:00:00Z,HALIFAX NS,0,0,0,9,9
Tropical Storm,Harvey,9,1999-09-21T09:00:00Z,FT PIERCE FL,33,3,1,0,37
Tropical Storm,Harvey,9,1999-09-21T09:00:00Z,SABLE ISLAND NS,0,0,0,9,9
Tropical Storm,Harvey,9,1999-09-21T09:00:00Z,COCOA BEACH FL,18,10,0,0,28
Tropical Storm,Harvey,9,1999-09-21T09:00:00Z,SYDNEY NS,0,0,0,6,6
Tropical Storm,Harvey,9,1999-09-21T09:00:00Z,DAYTONA BEACH FL,4,11,1,0,16
Tropical Storm,Harvey,9,1999-09-21T09:00:00Z,EDDY POINT NS,0,0,0,7,7
Tropical Storm,Harvey,9,1999-09-21T09:00:00Z,JACKSONVILLE FL,0,4,0,0,4
Tropical Storm,Harvey,9,1999-09-21T09:00:00Z,PTX BASQUES NFLD,0,0,0,4,4
Tropical Storm,Harvey,9,1999-09-21T09:00:00Z,SAVANNAH GA,0,1,2,0,3
Tropical Storm,Harvey,9,1999-09-21T09:00:00Z,BURGEO NFLD,0,0,0,4,4
Tropical Storm,Harvey,9,1999-09-21T09:00:00Z,CHARLESTON SC,0,1,3,0,4
Tropical Storm,Harvey,9,1999-09-21T09:00:00Z,ILE ST PIERRE,0,0,0,4,4
Tropical Storm,Harvey,9,1999-09-21T09:00:00Z,MYRTLE BEACH SC,0,1,4,1,6
Tropical Storm,Harvey,9,1999-09-21T09:00:00Z,CAPE RACE NFLD,0,0,0,2,2
Tropical Storm,Harvey,9,1999-09-21T09:00:00Z,WILMINGTON NC,0,0,6,1,7
Tropical Storm,Harvey,9,1999-09-21T09:00:00Z,KEY WEST FL,41,0,0,0,41
Tropical Storm,Harvey,9,1999-09-21T09:00:00Z,MOREHEAD CITY NC,0,0,8,2,10
Tropical Storm,Harvey,9,1999-09-21T09:00:00Z,MARCO ISLAND FL,57,0,0,0,57
Tropical Storm,Harvey,9,1999-09-21T09:00:00Z,CAPE HATTERAS NC,0,0,8,4,12
Tropical Storm,Harvey,9,1999-09-21T09:00:00Z,FT MYERS FL,49,0,0,0,49
Tropical Storm,Harvey,9,1999-09-21T09:00:00Z,NORFOLK VA,0,0,3,4,7
Tropical Storm,Harvey,9,1999-09-21T09:00:00Z,VENICE FL,41,0,0,0,41
Tropical Storm,Harvey,9,1999-09-21T09:00:00Z,OCEAN CITY MD,0,0,1,5,6
Tropical Storm,Harvey,9,1999-09-21T09:00:00Z,TAMPA FL,11,4,0,0,15
Tropical Storm,Harvey,9,1999-09-21T09:00:00Z,ATLANTIC CITY NJ,0,0,0,5,5
Tropical Storm,Harvey,9,1999-09-21T09:00:00Z,CEDAR KEY FL,1,2,0,0,3
Tropical Storm,Harvey,9,1999-09-21T09:00:00Z,NEW YORK CITY NY,0,0,0,5,5
Tropical Storm,Harvey,10,1999-09-21T15:00:00Z,26.5N  78.5W,41,13,0,0,54
Tropical Storm,Harvey,10,1999-09-21T15:00:00Z,BOSTON MA,0,0,0,4,4
Tropical Storm,Harvey,10,1999-09-21T15:00:00Z,31.0N  72.5W,0,24,12,0,36
Tropical Storm,Harvey,10,1999-09-21T15:00:00Z,PORTLAND ME,0,0,0,4,4
Tropical Storm,Harvey,10,1999-09-21T15:00:00Z,35.5N  66.5W,0,0,16,7,23
Tropical Storm,Harvey,10,1999-09-21T15:00:00Z,BAR HARBOR ME,0,0,0,7,7
Tropical Storm,Harvey,10,1999-09-21T15:00:00Z,MUCF 221N 805W,2,0,0,0,2
Tropical Storm,Harvey,10,1999-09-21T15:00:00Z,EASTPORT ME,0,0,0,8,8
Tropical Storm,Harvey,10,1999-09-21T15:00:00Z,MUHA 230N 824W,4,0,0,0,4
Tropical Storm,Harvey,10,1999-09-21T15:00:00Z,ST JOHN NB,0,0,0,9,9
Tropical Storm,Harvey,10,1999-09-21T15:00:00Z,MYEG 235N 758W,0,2,0,0,2
Tropical Storm,Harvey,10,1999-09-21T15:00:00Z,MONCTON NB,0,0,0,9,9
Tropical Storm,Harvey,10,1999-09-21T15:00:00Z,MYAK 241N 776W,13,7,0,0,20
Tropical Storm,Harvey,10,1999-09-21T15:00:00Z,YARMOUTH NS,0,0,0,10,10
Tropical Storm,Harvey,10,1999-09-21T15:00:00Z,MYNN 251N 775W,23,14,0,0,37
Tropical Storm,Harvey,10,1999-09-21T15:00:00Z,HALIFAX NS,0,0,0,12,12
Tropical Storm,Harvey,10,1999-09-21T15:00:00Z,MYGF 266N 787W,42,12,0,0,54
Tropical Storm,Harvey,10,1999-09-21T15:00:00Z,SABLE ISLAND NS,0,0,0,14,14
Tropical Storm,Harvey,10,1999-09-21T15:00:00Z,BERMUDA,0,0,5,7,12
Tropical Storm,Harvey,10,1999-09-21T15:00:00Z,SYDNEY NS,0,0,0,12,12
Tropical Storm,Harvey,10,1999-09-21T15:00:00Z,MARATHON FL,65,0,0,0,65
Tropical Storm,Harvey,10,1999-09-21T15:00:00Z,EDDY POINT NS,0,0,0,12,12
Tropical Storm,Harvey,10,1999-09-21T15:00:00Z,MIAMI FL,57,1,0,0,58
Tropical Storm,Harvey,10,1999-09-21T15:00:00Z,PTX BASQUES NFLD,0,0,0,10,10
Tropical Storm,Harvey,10,1999-09-21T15:00:00Z,W PALM BEACH FL,44,4,0,0,48
Tropical Storm,Harvey,10,1999-09-21T15:00:00Z,BURGEO NFLD,0,0,0,11,11
Tropical Storm,Harvey,10,1999-09-21T15:00:00Z,FT PIERCE FL,28,6,0,0,34
Tropical Storm,Harvey,10,1999-09-21T15:00:00Z,ILE ST PIERRE,0,0,0,11,11
Tropical Storm,Harvey,10,1999-09-21T15:00:00Z,COCOA BEACH FL,12,4,0,0,16
Tropical Storm,Harvey,10,1999-09-21T15:00:00Z,CAPE RACE NFLD,0,0,0,10,10
Tropical Storm,Harvey,10,1999-09-21T15:00:00Z,DAYTONA BEACH FL,1,1,0,0,2
Tropical Storm,Harvey,10,1999-09-21T15:00:00Z,HIBERNIA OILFLD,0,0,0,4,4
Tropical Storm,Harvey,10,1999-09-21T15:00:00Z,CAPE HATTERAS NC,0,1,2,0,3
Tropical Storm,Harvey,10,1999-09-21T15:00:00Z,KEY WEST FL,64,0,0,0,64
Tropical Storm,Harvey,10,1999-09-21T15:00:00Z,MONTAUK POINT NY,0,0,1,3,4
Tropical Storm,Harvey,10,1999-09-21T15:00:00Z,MARCO ISLAND FL,99,0,0,0,99
Tropical Storm,Harvey,10,1999-09-21T15:00:00Z,PROVIDENCE RI,0,0,1,3,4
Tropical Storm,Harvey,10,1999-09-21T15:00:00Z,FT MYERS FL,99,0,0,0,99
Tropical Storm,Harvey,10,1999-09-21T15:00:00Z,NANTUCKET MA,0,0,1,6,7
Tropical Storm,Harvey,10,1999-09-21T15:00:00Z,VENICE FL,15,0,0,0,15
Tropical Storm,Harvey,10,1999-09-21T15:00:00Z,HYANNIS MA,0,0,1,5,6
Tropical Storm,Harvey,10,1999-09-21T15:00:00Z,TAMPA FL,2,0,0,0,2
Tropical Storm,Harvey,11,1999-09-21T21:00:00Z,28.5N  75.5W,27,0,0,0,27
Tropical Storm,Harvey,11,1999-09-21T21:00:00Z,FT PIERCE FL,31,0,0,0,31
Tropical Storm,Harvey,11,1999-09-21T21:00:00Z,MYAK 241N 776W,6,0,0,0,6
Tropical Storm,Harvey,11,1999-09-21T21:00:00Z,COCOA BEACH FL,2,0,0,0,2
Tropical Storm,Harvey,11,1999-09-21T21:00:00Z,MYNN 251N 775W,33,0,0,0,33
Tropical Storm,Harvey,11,1999-09-21T21:00:00Z,KEY WEST FL,26,0,0,0,26
Tropical Storm,Harvey,11,1999-09-21T21:00:00Z,MYGF 266N 787W,75,0,0,0,75
Tropical Storm,Harvey,11,1999-09-21T21:00:00Z,MARCO ISLAND FL,99,0,0,0,99
Tropical Storm,Harvey,11,1999-09-21T21:00:00Z,MARATHON FL,76,0,0,0,76
Tropical Storm,Harvey,11,1999-09-21T21:00:00Z,FT MYERS FL,99,0,0,0,99
Tropical Storm,Harvey,11,1999-09-21T21:00:00Z,MIAMI FL,99,0,0,0,99
Tropical Storm,Harvey,11,1999-09-21T21:00:00Z,VENICE FL,2,0,0,0,2
Tropical Storm,Harvey,11,1999-09-21T21:00:00Z,W PALM BEACH FL,99,0,0,0,99
Tropical Storm,Harvey,12,1999-09-22T03:00:00Z,MYGF 266N 787W,99,0,0,0,99
Tropical Storm,Harvey,12,1999-09-22T03:00:00Z,W PALM BEACH FL,4,0,0,0,4
Tropical Depression,Eleven,1,1999-10-04T21:00:00Z,18.8N  94.1W,99,0,0,0,99
Tropical Depression,Eleven,1,1999-10-04T21:00:00Z,MMMD 210N 897W,0,0,1,5,6
Tropical Depression,Eleven,1,1999-10-04T21:00:00Z,18.9N  94.3W,99,0,0,0,99
Tropical Depression,Eleven,1,1999-10-04T21:00:00Z,GALVESTON TX,0,0,0,2,2
Tropical Depression,Eleven,1,1999-10-04T21:00:00Z,19.0N  94.5W,99,0,0,0,99
Tropical Depression,Eleven,1,1999-10-04T21:00:00Z,FREEPORT TX,0,0,0,2,2
Tropical Depression,Eleven,1,1999-10-04T21:00:00Z,MMCZ 205N 869W,0,0,0,2,2
Tropical Depression,Eleven,1,1999-10-04T21:00:00Z,PORT O CONNOR TX,0,0,0,3,3
Tropical Depression,Eleven,1,1999-10-04T21:00:00Z,MZBZ 175N 883W,0,0,0,3,3
Tropical Depression,Eleven,1,1999-10-04T21:00:00Z,CORPUSCHRISTI TX,0,0,0,3,3
Tropical Depression,Eleven,1,1999-10-04T21:00:00Z,MGPB 157N 886W,0,0,0,3,3
Tropical Depression,Eleven,1,1999-10-04T21:00:00Z,BROWNSVILLE TX,0,0,1,5,6
Tropical Depression,Eleven,1,1999-10-04T21:00:00Z,MMSO 238N 982W,0,0,3,6,9
Tropical Depression,Eleven,1,1999-10-04T21:00:00Z,GULF 28N 91W,0,0,0,2,2
Tropical Depression,Eleven,1,1999-10-04T21:00:00Z,MMTM 222N 979W,0,2,4,6,12
Tropical Depression,Eleven,1,1999-10-04T21:00:00Z,GULF 28N 93W,0,0,0,3,3
Tropical Depression,Eleven,1,1999-10-04T21:00:00Z,MMTX 210N 974W,1,4,4,5,14
Tropical Depression,Eleven,1,1999-10-04T21:00:00Z,GULF 28N 95W,0,0,0,3,3
Tropical Depression,Eleven,1,1999-10-04T21:00:00Z,MMVR 192N 961W,14,3,2,2,21
Tropical Depression,Eleven,1,1999-10-04T21:00:00Z,GULF 27N 96W,0,0,1,4,5
Tropical Depression,Eleven,1,1999-10-04T21:00:00Z,MMFR 185N 926W,76,0,0,0,76
Tropical Depression,Eleven,1,1999-10-04T21:00:00Z,GULF 25N 96W,0,0,3,6,9
Tropical Depression,Eleven,2,1999-10-05T03:00:00Z,19.0N  94.1W,99,0,0,0,99
Tropical Depression,Eleven,2,1999-10-05T03:00:00Z,MMTM 222N 979W,0,1,4,7,12
Tropical Depression,Eleven,2,1999-10-05T03:00:00Z,19.0N  94.5W,99,0,0,0,99
Tropical Depression,Eleven,2,1999-10-05T03:00:00Z,MMTX 210N 974W,0,5,5,5,15
Tropical Depression,Eleven,2,1999-10-05T03:00:00Z,19.3N  95.0W,99,0,0,0,99
Tropical Depression,Eleven,2,1999-10-05T03:00:00Z,MMVR 192N 961W,11,6,3,1,21
Tropical Depression,Eleven,2,1999-10-05T03:00:00Z,MUAN 219N 850W,0,0,0,2,2
Tropical Depression,Eleven,2,1999-10-05T03:00:00Z,MMFR 185N 926W,24,1,0,1,26
Tropical Depression,Eleven,2,1999-10-05T03:00:00Z,MMCZ 205N 869W,0,0,1,3,4
Tropical Depression,Eleven,2,1999-10-05T03:00:00Z,MMMD 210N 897W,0,2,4,4,10
Tropical Depression,Eleven,2,1999-10-05T03:00:00Z,MZBZ 175N 883W,0,0,0,4,4
Tropical Depression,Eleven,2,1999-10-05T03:00:00Z,BROWNSVILLE TX,0,0,0,4,4
Tropical Depression,Eleven,2,1999-10-05T03:00:00Z,MGPB 157N 886W,0,0,0,3,3
Tropical Depression,Eleven,2,1999-10-05T03:00:00Z,GULF 27N 96W,0,0,0,2,2
Tropical Depression,Eleven,2,1999-10-05T03:00:00Z,MMSO 238N 982W,0,0,1,6,7
Tropical Depression,Eleven,2,1999-10-05T03:00:00Z,GULF 25N 96W,0,0,1,5,6
Tropical Depression,Eleven,4,1999-10-05T15:00:00Z,19.9N  95.0W,99,0,0,0,99
Tropical Depression,Eleven,4,1999-10-05T15:00:00Z,PORT ARTHUR TX,0,0,0,2,2
Tropical Depression,Eleven,4,1999-10-05T15:00:00Z,20.3N  95.2W,99,0,0,0,99
Tropical Depression,Eleven,4,1999-10-05T15:00:00Z,GALVESTON TX,0,0,0,2,2
Tropical Depression,Eleven,4,1999-10-05T15:00:00Z,20.5N  95.5W,32,1,0,0,33
Tropical Depression,Eleven,4,1999-10-05T15:00:00Z,FREEPORT TX,0,0,0,3,3
Tropical Depression,Eleven,4,1999-10-05T15:00:00Z,MMCZ 205N 869W,0,0,0,3,3
Tropical Depression,Eleven,4,1999-10-05T15:00:00Z,PORT O CONNOR TX,0,0,0,4,4
Tropical Depression,Eleven,4,1999-10-05T15:00:00Z,MZBZ 175N 883W,0,0,1,3,4
Tropical Depression,Eleven,4,1999-10-05T15:00:00Z,CORPUSCHRISTI TX,0,0,0,5,5
Tropical Depression,Eleven,4,1999-10-05T15:00:00Z,MGPB 157N 886W,0,0,0,3,3
Tropical Depression,Eleven,4,1999-10-05T15:00:00Z,BROWNSVILLE TX,0,0,2,7,9
Tropical Depression,Eleven,4,1999-10-05T15:00:00Z,MMSO 238N 982W,0,2,5,6,13
Tropical Depression,Eleven,4,1999-10-05T15:00:00Z,GULF 28N 91W,0,0,0,2,2
Tropical Depression,Eleven,4,1999-10-05T15:00:00Z,MMTM 222N 979W,1,7,5,4,17
Tropical Depression,Eleven,4,1999-10-05T15:00:00Z,GULF 28N 93W,0,0,0,3,3
Tropical Depression,Eleven,4,1999-10-05T15:00:00Z,MMTX 210N 974W,6,7,4,2,19
Tropical Depression,Eleven,4,1999-10-05T15:00:00Z,GULF 28N 95W,0,0,0,4,4
Tropical Depression,Eleven,4,1999-10-05T15:00:00Z,MMVR 192N 961W,25,1,0,1,27
Tropical Depression,Eleven,4,1999-10-05T15:00:00Z,GULF 27N 96W,0,0,0,6,6
Tropical Depression,Eleven,4,1999-10-05T15:00:00Z,MMFR 185N 926W,8,5,2,2,17
Tropical Depression,Eleven,4,1999-10-05T15:00:00Z,GULF 25N 96W,0,1,3,7,11
Tropical Depression,Eleven,4,1999-10-05T15:00:00Z,MMMD 210N 897W,0,1,2,5,8
Tropical Depression,Eleven,5,1999-10-05T21:00:00Z,20.4N  95.7W,99,0,0,0,99
Tropical Depression,Eleven,5,1999-10-05T21:00:00Z,PORT ARTHUR TX,0,0,0,2,2
Tropical Depression,Eleven,5,1999-10-05T21:00:00Z,20.9N  95.9W,42,0,0,0,42
Tropical Depression,Eleven,5,1999-10-05T21:00:00Z,GALVESTON TX,0,0,0,3,3
Tropical Depression,Eleven,5,1999-10-05T21:00:00Z,21.5N  96.0W,27,1,1,0,29
Tropical Depression,Eleven,5,1999-10-05T21:00:00Z,FREEPORT TX,0,0,0,4,4
Tropical Depression,Eleven,5,1999-10-05T21:00:00Z,MMCZ 205N 869W,0,0,0,3,3
Tropical Depression,Eleven,5,1999-10-05T21:00:00Z,PORT O CONNOR TX,0,0,0,6,6
Tropical Depression,Eleven,5,1999-10-05T21:00:00Z,MZBZ 175N 883W,0,0,0,3,3
Tropical Depression,Eleven,5,1999-10-05T21:00:00Z,CORPUSCHRISTI TX,0,0,0,7,7
Tropical Depression,Eleven,5,1999-10-05T21:00:00Z,MMSO 238N 982W,0,4,6,5,15
Tropical Depression,Eleven,5,1999-10-05T21:00:00Z,BROWNSVILLE TX,0,0,4,7,11
Tropical Depression,Eleven,5,1999-10-05T21:00:00Z,MMTM 222N 979W,1,11,3,3,18
Tropical Depression,Eleven,5,1999-10-05T21:00:00Z,GULF 28N 91W,0,0,0,3,3
Tropical Depression,Eleven,5,1999-10-05T21:00:00Z,MMTX 210N 974W,12,6,2,1,21
Tropical Depression,Eleven,5,1999-10-05T21:00:00Z,GULF 28N 93W,0,0,0,4,4
Tropical Depression,Eleven,5,1999-10-05T21:00:00Z,MMVR 192N 961W,99,0,0,0,99
Tropical Depression,Eleven,5,1999-10-05T21:00:00Z,GULF 28N 95W,0,0,0,6,6
Tropical Depression,Eleven,5,1999-10-05T21:00:00Z,MMFR 185N 926W,0,3,4,4,11
Tropical Depression,Eleven,5,1999-10-05T21:00:00Z,GULF 27N 96W,0,0,1,8,9
Tropical Depression,Eleven,5,1999-10-05T21:00:00Z,MMMD 210N 897W,0,0,3,5,8
Tropical Depression,Eleven,5,1999-10-05T21:00:00Z,GULF 25N 96W,0,2,6,6,14
Tropical Depression,Eleven,6,1999-10-06T03:00:00Z,20.2N  95.3W,99,0,0,0,99
Tropical Depression,Eleven,6,1999-10-06T03:00:00Z,PORT ARTHUR TX,0,0,0,3,3
Tropical Depression,Eleven,6,1999-10-06T03:00:00Z,20.5N  95.5W,99,0,0,0,99
Tropical Depression,Eleven,6,1999-10-06T03:00:00Z,GALVESTON TX,0,0,0,5,5
Tropical Depression,Eleven,6,1999-10-06T03:00:00Z,21.5N  96.0W,21,3,1,1,26
Tropical Depression,Eleven,6,1999-10-06T03:00:00Z,FREEPORT TX,0,0,0,6,6
Tropical Depression,Eleven,6,1999-10-06T03:00:00Z,MZBZ 175N 883W,0,0,0,2,2
Tropical Depression,Eleven,6,1999-10-06T03:00:00Z,PORT O CONNOR TX,0,0,0,8,8
Tropical Depression,Eleven,6,1999-10-06T03:00:00Z,MMSO 238N 982W,0,3,7,6,16
Tropical Depression,Eleven,6,1999-10-06T03:00:00Z,CORPUSCHRISTI TX,0,0,1,8,9
Tropical Depression,Eleven,6,1999-10-06T03:00:00Z,MMTM 222N 979W,2,7,5,4,18
Tropical Depression,Eleven,6,1999-10-06T03:00:00Z,BROWNSVILLE TX,0,0,5,8,13
Tropical Depression,Eleven,6,1999-10-06T03:00:00Z,MMTX 210N 974W,11,5,2,2,20
Tropical Depression,Eleven,6,1999-10-06T03:00:00Z,GULF 28N 91W,0,0,0,3,3
Tropical Depression,Eleven,6,1999-10-06T03:00:00Z,MMVR 192N 961W,49,0,0,0,49
Tropical Depression,Eleven,6,1999-10-06T03:00:00Z,GULF 28N 93W,0,0,0,5,5
Tropical Depression,Eleven,6,1999-10-06T03:00:00Z,MMFR 185N 926W,3,7,2,2,14
Tropical Depression,Eleven,6,1999-10-06T03:00:00Z,GULF 28N 95W,0,0,1,7,8
Tropical Depression,Eleven,6,1999-10-06T03:00:00Z,MMMD 210N 897W,0,0,2,4,6
Tropical Depression,Eleven,6,1999-10-06T03:00:00Z,GULF 27N 96W,0,0,2,8,10
Tropical Depression,Eleven,6,1999-10-06T03:00:00Z,NEW IBERIA LA,0,0,0,2,2
Tropical Depression,Eleven,6,1999-10-06T03:00:00Z,GULF 25N 96W,0,1,7,7,15
Tropical Depression,Eleven,7,1999-10-06T09:00:00Z,20.2N  95.5W,99,0,0,0,99
Tropical Depression,Eleven,7,1999-10-06T09:00:00Z,GALVESTON TX,0,0,0,4,4
Tropical Depression,Eleven,7,1999-10-06T09:00:00Z,20.5N  95.7W,41,0,0,0,41
Tropical Depression,Eleven,7,1999-10-06T09:00:00Z,FREEPORT TX,0,0,0,5,5
Tropical Depression,Eleven,7,1999-10-06T09:00:00Z,21.5N  96.0W,22,3,1,1,27
Tropical Depression,Eleven,7,1999-10-06T09:00:00Z,PORT O CONNOR TX,0,0,0,7,7
Tropical Depression,Eleven,7,1999-10-06T09:00:00Z,MMSO 238N 982W,0,5,6,5,16
Tropical Depression,Eleven,7,1999-10-06T09:00:00Z,CORPUSCHRISTI TX,0,0,1,8,9
Tropical Depression,Eleven,7,1999-10-06T09:00:00Z,MMTM 222N 979W,3,9,3,3,18
Tropical Depression,Eleven,7,1999-10-06T09:00:00Z,BROWNSVILLE TX,0,0,5,8,13
Tropical Depression,Eleven,7,1999-10-06T09:00:00Z,MMTX 210N 974W,12,5,2,2,21
Tropical Depression,Eleven,7,1999-10-06T09:00:00Z,GULF 28N 91W,0,0,0,2,2
Tropical Depression,Eleven,7,1999-10-06T09:00:00Z,MMVR 192N 961W,99,0,0,0,99
Tropical Depression,Eleven,7,1999-10-06T09:00:00Z,GULF 28N 93W,0,0,0,4,4
Tropical Depression,Eleven,7,1999-10-06T09:00:00Z,MMFR 185N 926W,5,5,2,2,14
Tropical Depression,Eleven,7,1999-10-06T09:00:00Z,GULF 28N 95W,0,0,0,7,7
Tropical Depression,Eleven,7,1999-10-06T09:00:00Z,MMMD 210N 897W,0,0,1,4,5
Tropical Depression,Eleven,7,1999-10-06T09:00:00Z,GULF 27N 96W,0,0,1,9,10
Tropical Depression,Eleven,7,1999-10-06T09:00:00Z,PORT ARTHUR TX,0,0,0,3,3
Tropical Depression,Eleven,7,1999-10-06T09:00:00Z,GULF 25N 96W,0,1,7,7,15
Tropical Depression,Eleven,8,1999-10-06T15:00:00Z,21.5N  96.5W,49,0,0,0,49
Tropical Depression,Eleven,8,1999-10-06T15:00:00Z,GALVESTON TX,0,0,0,5,5
Tropical Depression,Eleven,8,1999-10-06T15:00:00Z,22.2N  96.9W,31,1,1,0,33
Tropical Depression,Eleven,8,1999-10-06T15:00:00Z,FREEPORT TX,0,0,0,7,7
Tropical Depression,Eleven,8,1999-10-06T15:00:00Z,23.0N  97.0W,18,6,1,1,26
Tropical Depression,Eleven,8,1999-10-06T15:00:00Z,PORT O CONNOR TX,0,0,1,8,9
Tropical Depression,Eleven,8,1999-10-06T15:00:00Z,MMSO 238N 982W,3,13,3,2,21
Tropical Depression,Eleven,8,1999-10-06T15:00:00Z,CORPUSCHRISTI TX,0,0,2,9,11
Tropical Depression,Eleven,8,1999-10-06T15:00:00Z,MMTM 222N 979W,20,3,1,1,25
Tropical Depression,Eleven,8,1999-10-06T15:00:00Z,BROWNSVILLE TX,0,2,7,7,16
Tropical Depression,Eleven,8,1999-10-06T15:00:00Z,MMTX 210N 974W,29,0,0,1,30
Tropical Depression,Eleven,8,1999-10-06T15:00:00Z,GULF 28N 91W,0,0,0,3,3
Tropical Depression,Eleven,8,1999-10-06T15:00:00Z,MMVR 192N 961W,17,0,1,0,18
Tropical Depression,Eleven,8,1999-10-06T15:00:00Z,GULF 28N 93W,0,0,0,5,5
Tropical Depression,Eleven,8,1999-10-06T15:00:00Z,MMFR 185N 926W,0,1,1,2,4
Tropical Depression,Eleven,8,1999-10-06T15:00:00Z,GULF 28N 95W,0,0,1,7,8
Tropical Depression,Eleven,8,1999-10-06T15:00:00Z,MMMD 210N 897W,0,0,1,3,4
Tropical Depression,Eleven,8,1999-10-06T15:00:00Z,GULF 27N 96W,0,0,3,9,12
Tropical Depression,Eleven,8,1999-10-06T15:00:00Z,NEW IBERIA LA,0,0,0,2,2
Tropical Depression,Eleven,8,1999-10-06T15:00:00Z,GULF 25N 96W,0,6,6,5,17
Tropical Depression,Eleven,8,1999-10-06T15:00:00Z,PORT ARTHUR TX,0,0,0,3,3
Tropical Depression,Twelve,2,1999-10-06T09:00:00Z,16.5N  47.8W,67,0,0,0,67
Tropical Depression,Twelve,2,1999-10-06T09:00:00Z,18.5N  50.0W,15,6,2,1,24
Tropical Depression,Twelve,2,1999-10-06T09:00:00Z,17.2N  48.7W,38,0,1,0,39
Tropical Depression,Twelve,3,1999-10-06T15:00:00Z,15.9N  48.4W,68,0,0,0,68
Tropical Depression,Twelve,3,1999-10-06T15:00:00Z,17.5N  51.0W,17,6,1,1,25
Tropical Depression,Twelve,3,1999-10-06T15:00:00Z,16.6N  49.6W,42,0,0,0,42
Tropical Depression,Twelve,4,1999-10-06T21:00:00Z,16.1N  47.6W,50,0,0,0,50
Tropical Depression,Twelve,4,1999-10-06T21:00:00Z,17.5N  50.0W,15,5,1,2,23
Tropical Depression,Twelve,4,1999-10-06T21:00:00Z,16.7N  48.7W,30,0,1,0,31
Tropical Depression,Twelve,5,1999-10-07T03:00:00Z,16.7N  48.0W,51,0,0,0,51
Tropical Depression,Twelve,5,1999-10-07T03:00:00Z,17.7N  49.8W,21,2,1,1,25
Tropical Depression,Twelve,5,1999-10-07T03:00:00Z,17.2N  48.9W,32,0,0,1,33
Tropical Depression,Twelve,6,1999-10-07T09:00:00Z,16.5N  48.6W,57,0,0,0,57
Tropical Depression,Twelve,6,1999-10-07T09:00:00Z,17.3N  50.4W,23,2,0,1,26
Tropical Depression,Twelve,6,1999-10-07T09:00:00Z,16.9N  49.5W,35,0,0,0,35
Tropical Depression,Twelve,7,1999-10-07T15:00:00Z,16.4N  47.9W,99,0,0,0,99
Tropical Depression,Twelve,7,1999-10-07T15:00:00Z,17.0N  49.5W,25,1,1,0,27
Tropical Depression,Twelve,7,1999-10-07T15:00:00Z,16.7N  48.5W,40,0,0,0,40
Tropical Depression,Twelve,8,1999-10-07T21:00:00Z,16.6N  48.1W,99,0,0,0,99
Tropical Depression,Twelve,8,1999-10-07T21:00:00Z,17.5N  49.5W,23,2,1,1,27
Tropical Depression,Twelve,8,1999-10-07T21:00:00Z,16.9N  48.6W,49,0,0,0,49
Tropical Depression,Twelve,9,1999-10-08T03:00:00Z,17.5N  49.0W,51,0,0,0,51
Tropical Depression,Twelve,9,1999-10-08T03:00:00Z,18.5N  51.0W,20,2,1,1,24
Tropical Depression,Twelve,9,1999-10-08T03:00:00Z,18.0N  50.0W,31,0,0,1,32
Tropical Depression,Twelve,10,1999-10-08T09:00:00Z,17.2N  48.9W,60,0,0,0,60
Tropical Depression,Twelve,10,1999-10-08T09:00:00Z,18.0N  50.5W,23,1,1,1,26
Tropical Depression,Twelve,10,1999-10-08T09:00:00Z,17.5N  49.5W,37,1,0,0,38
Tropical Depression,Twelve,11,1999-10-08T15:00:00Z,16.7N  48.3W,99,0,0,0,99
Tropical Depression,Twelve,11,1999-10-08T15:00:00Z,17.5N  50.0W,17,3,2,1,23
Tropical Depression,Twelve,11,1999-10-08T15:00:00Z,17.0N  49.0W,29,1,0,0,30
Tropical Depression,Twelve,11,1999-10-08T15:00:00Z,TBPB 131N 595W,0,0,0,2,2
Tropical Storm,Irene,1,1999-10-13T15:00:00Z,20.0N  84.5W,57,0,0,0,57
Tropical Storm,Irene,1,1999-10-13T15:00:00Z,SAVANNAH GA,0,0,0,4,4
Tropical Storm,Irene,1,1999-10-13T15:00:00Z,21.5N  84.5W,31,4,0,0,35
Tropical Storm,Irene,1,1999-10-13T15:00:00Z,CHARLESTON SC,0,0,0,2,2
Tropical Storm,Irene,1,1999-10-13T15:00:00Z,23.0N  84.5W,5,19,2,1,27
Tropical Storm,Irene,1,1999-10-13T15:00:00Z,KEY WEST FL,0,0,6,8,14
Tropical Storm,Irene,1,1999-10-13T15:00:00Z,MKJS 185N 779W,0,0,0,2,2
Tropical Storm,Irene,1,1999-10-13T15:00:00Z,MARCO ISLAND FL,0,0,2,10,12
Tropical Storm,Irene,1,1999-10-13T15:00:00Z,MWCG 193N 814W,5,4,1,2,12
Tropical Storm,Irene,1,1999-10-13T15:00:00Z,FT MYERS FL,0,0,2,10,12
Tropical Storm,Irene,1,1999-10-13T15:00:00Z,MUCM 214N 779W,0,0,0,3,3
Tropical Storm,Irene,1,1999-10-13T15:00:00Z,VENICE FL,0,0,2,11,13
Tropical Storm,Irene,1,1999-10-13T15:00:00Z,MUCF 221N 805W,0,0,4,6,10
Tropical Storm,Irene,1,1999-10-13T15:00:00Z,TAMPA FL,0,0,1,10,11
Tropical Storm,Irene,1,1999-10-13T15:00:00Z,MUSN 216N 826W,8,9,2,2,21
Tropical Storm,Irene,1,1999-10-13T15:00:00Z,CEDAR KEY FL,0,0,0,10,10
Tropical Storm,Irene,1,1999-10-13T15:00:00Z,MUHA 230N 824W,0,7,7,3,17
Tropical Storm,Irene,1,1999-10-13T15:00:00Z,ST MARKS FL,0,0,0,9,9
Tropical Storm,Irene,1,1999-10-13T15:00:00Z,MUAN 219N 850W,23,10,0,0,33
Tropical Storm,Irene,1,1999-10-13T15:00:00Z,APALACHICOLA FL,0,0,1,9,10
Tropical Storm,Irene,1,1999-10-13T15:00:00Z,MMCZ 205N 869W,5,7,2,2,16
Tropical Storm,Irene,1,1999-10-13T15:00:00Z,PANAMA CITY FL,0,0,1,9,10
Tropical Storm,Irene,1,1999-10-13T15:00:00Z,MHNJ 165N 859W,0,0,0,2,2
Tropical Storm,Irene,1,1999-10-13T15:00:00Z,PENSACOLA FL,0,0,0,8,8
Tropical Storm,Irene,1,1999-10-13T15:00:00Z,MYAK 241N 776W,0,0,0,4,4
Tropical Storm,Irene,1,1999-10-13T15:00:00Z,MOBILE AL,0,0,0,7,7
Tropical Storm,Irene,1,1999-10-13T15:00:00Z,MYNN 251N 775W,0,0,0,4,4
Tropical Storm,Irene,1,1999-10-13T15:00:00Z,GULFPORT MS,0,0,0,6,6
Tropical Storm,Irene,1,1999-10-13T15:00:00Z,MYGF 266N 787W,0,0,0,5,5
Tropical Storm,Irene,1,1999-10-13T15:00:00Z,BURAS LA,0,0,0,6,6
Tropical Storm,Irene,1,1999-10-13T15:00:00Z,MMMD 210N 897W,0,0,1,3,4
Tropical Storm,Irene,1,1999-10-13T15:00:00Z,NEW ORLEANS LA,0,0,0,5,5
Tropical Storm,Irene,1,1999-10-13T15:00:00Z,MARATHON FL,0,0,3,9,12
Tropical Storm,Irene,1,1999-10-13T15:00:00Z,NEW IBERIA LA,0,0,0,2,2
Tropical Storm,Irene,1,1999-10-13T15:00:00Z,MIAMI FL,0,0,1,8,9
Tropical Storm,Irene,1,1999-10-13T15:00:00Z,GULF 29N 85W,0,0,2,10,12
Tropical Storm,Irene,1,1999-10-13T15:00:00Z,W PALM BEACH FL,0,0,0,8,8
Tropical Storm,Irene,1,1999-10-13T15:00:00Z,GULF 29N 87W,0,0,2,9,11
Tropical Storm,Irene,1,1999-10-13T15:00:00Z,FT PIERCE FL,0,0,0,8,8
Tropical Storm,Irene,1,1999-10-13T15:00:00Z,GULF 28N 89W,0,0,2,7,9
Tropical Storm,Irene,1,1999-10-13T15:00:00Z,COCOA BEACH FL,0,0,0,8,8
Tropical Storm,Irene,1,1999-10-13T15:00:00Z,GULF 28N 91W,0,0,0,5,5
Tropical Storm,Irene,1,1999-10-13T15:00:00Z,DAYTONA BEACH FL,0,0,0,7,7
Tropical Storm,Irene,1,1999-10-13T15:00:00Z,GULF 28N 93W,0,0,0,2,2
Tropical Storm,Irene,1,1999-10-13T15:00:00Z,JACKSONVILLE FL,0,0,0,6,6
Tropical Storm,Irene,2,1999-10-13T21:00:00Z,22.5N  83.8W,31,1,1,0,33
Tropical Storm,Irene,2,1999-10-13T21:00:00Z,SAVANNAH GA,0,0,0,5,5
Tropical Storm,Irene,2,1999-10-13T21:00:00Z,23.5N  83.5W,17,7,1,1,26
Tropical Storm,Irene,2,1999-10-13T21:00:00Z,CHARLESTON SC,0,0,0,3,3
Tropical Storm,Irene,2,1999-10-13T21:00:00Z,24.5N  83.5W,4,14,3,2,23
Tropical Storm,Irene,2,1999-10-13T21:00:00Z,MYRTLE BEACH SC,0,0,0,2,2
Tropical Storm,Irene,2,1999-10-13T21:00:00Z,MKJS 185N 779W,0,0,0,2,2
Tropical Storm,Irene,2,1999-10-13T21:00:00Z,KEY WEST FL,1,8,5,4,18
Tropical Storm,Irene,2,1999-10-13T21:00:00Z,MWCG 193N 814W,3,1,2,3,9
Tropical Storm,Irene,2,1999-10-13T21:00:00Z,MARCO ISLAND FL,0,2,6,7,15
Tropical Storm,Irene,2,1999-10-13T21:00:00Z,MUCM 214N 779W,0,0,0,4,4
Tropical Storm,Irene,2,1999-10-13T21:00:00Z,FT MYERS FL,0,1,6,7,14
Tropical Storm,Irene,2,1999-10-13T21:00:00Z,MUCF 221N 805W,5,3,3,3,14
Tropical Storm,Irene,2,1999-10-13T21:00:00Z,VENICE FL,0,1,6,8,15
Tropical Storm,Irene,2,1999-10-13T21:00:00Z,MUSN 216N 826W,33,1,0,0,34
Tropical Storm,Irene,2,1999-10-13T21:00:00Z,TAMPA FL,0,0,4,9,13
Tropical Storm,Irene,2,1999-10-13T21:00:00Z,MUHA 230N 824W,16,4,2,1,23
Tropical Storm,Irene,2,1999-10-13T21:00:00Z,CEDAR KEY FL,0,0,2,10,12
Tropical Storm,Irene,2,1999-10-13T21:00:00Z,MUAN 219N 850W,34,0,0,0,34
Tropical Storm,Irene,2,1999-10-13T21:00:00Z,ST MARKS FL,0,0,1,9,10
Tropical Storm,Irene,2,1999-10-13T21:00:00Z,MMCZ 205N 869W,2,1,1,3,7
Tropical Storm,Irene,2,1999-10-13T21:00:00Z,APALACHICOLA FL,0,0,2,9,11
Tropical Storm,Irene,2,1999-10-13T21:00:00Z,MYEG 235N 758W,0,0,0,2,2
Tropical Storm,Irene,2,1999-10-13T21:00:00Z,PANAMA CITY FL,0,0,2,8,10
Tropical Storm,Irene,2,1999-10-13T21:00:00Z,MYAK 241N 776W,0,0,0,5,5
Tropical Storm,Irene,2,1999-10-13T21:00:00Z,PENSACOLA FL,0,0,1,7,8
Tropical Storm,Irene,2,1999-10-13T21:00:00Z,MYNN 251N 775W,0,0,0,5,5
Tropical Storm,Irene,2,1999-10-13T21:00:00Z,MOBILE AL,0,0,0,6,6
Tropical Storm,Irene,2,1999-10-13T21:00:00Z,MYGF 266N 787W,0,0,0,7,7
Tropical Storm,Irene,2,1999-10-13T21:00:00Z,GULFPORT MS,0,0,0,5,5
Tropical Storm,Irene,2,1999-10-13T21:00:00Z,MMMD 210N 897W,0,0,0,2,2
Tropical Storm,Irene,2,1999-10-13T21:00:00Z,BURAS LA,0,0,0,5,5
Tropical Storm,Irene,2,1999-10-13T21:00:00Z,MARATHON FL,0,4,5,6,15
Tropical Storm,Irene,2,1999-10-13T21:00:00Z,NEW ORLEANS LA,0,0,0,4,4
Tropical Storm,Irene,2,1999-10-13T21:00:00Z,MIAMI FL,0,0,3,8,11
Tropical Storm,Irene,2,1999-10-13T21:00:00Z,NEW IBERIA LA,0,0,0,2,2
Tropical Storm,Irene,2,1999-10-13T21:00:00Z,W PALM BEACH FL,0,0,1,9,10
Tropical Storm,Irene,2,1999-10-13T21:00:00Z,GULF 29N 85W,0,0,4,9,13
Tropical Storm,Irene,2,1999-10-13T21:00:00Z,FT PIERCE FL,0,0,1,9,10
Tropical Storm,Irene,2,1999-10-13T21:00:00Z,GULF 29N 87W,0,0,3,8,11
Tropical Storm,Irene,2,1999-10-13T21:00:00Z,COCOA BEACH FL,0,0,1,8,9
Tropical Storm,Irene,2,1999-10-13T21:00:00Z,GULF 28N 89W,0,0,1,6,7
Tropical Storm,Irene,2,1999-10-13T21:00:00Z,DAYTONA BEACH FL,0,0,0,9,9
Tropical Storm,Irene,2,1999-10-13T21:00:00Z,GULF 28N 91W,0,0,0,3,3
Tropical Storm,Irene,2,1999-10-13T21:00:00Z,JACKSONVILLE FL,0,0,0,8,8
Tropical Storm,Irene,3,1999-10-14T03:00:00Z,23.3N  83.5W,33,1,0,0,34
Tropical Storm,Irene,3,1999-10-14T03:00:00Z,SAVANNAH GA,0,0,1,6,7
Tropical Storm,Irene,3,1999-10-14T03:00:00Z,24.5N  83.4W,16,5,1,1,23
Tropical Storm,Irene,3,1999-10-14T03:00:00Z,CHARLESTON SC,0,0,0,4,4
Tropical Storm,Irene,3,1999-10-14T03:00:00Z,26.0N  83.0W,2,11,4,2,19
Tropical Storm,Irene,3,1999-10-14T03:00:00Z,MYRTLE BEACH SC,0,0,0,3,3
Tropical Storm,Irene,3,1999-10-14T03:00:00Z,MKJS 185N 779W,0,0,0,2,2
Tropical Storm,Irene,3,1999-10-14T03:00:00Z,WILMINGTON NC,0,0,0,2,2
Tropical Storm,Irene,3,1999-10-14T03:00:00Z,MWCG 193N 814W,1,2,1,2,6
Tropical Storm,Irene,3,1999-10-14T03:00:00Z,KEY WEST FL,5,8,3,2,18
Tropical Storm,Irene,3,1999-10-14T03:00:00Z,MUCM 214N 779W,0,0,1,3,4
Tropical Storm,Irene,3,1999-10-14T03:00:00Z,MARCO ISLAND FL,0,7,6,3,16
Tropical Storm,Irene,3,1999-10-14T03:00:00Z,MUCF 221N 805W,7,3,1,2,13
Tropical Storm,Irene,3,1999-10-14T03:00:00Z,FT MYERS FL,0,5,7,4,16
Tropical Storm,Irene,3,1999-10-14T03:00:00Z,MUSN 216N 826W,99,0,0,0,99
Tropical Storm,Irene,3,1999-10-14T03:00:00Z,VENICE FL,0,6,7,3,16
Tropical Storm,Irene,3,1999-10-14T03:00:00Z,MUHA 230N 824W,25,1,0,0,26
Tropical Storm,Irene,3,1999-10-14T03:00:00Z,TAMPA FL,0,2,8,5,15
Tropical Storm,Irene,3,1999-10-14T03:00:00Z,MUAN 219N 850W,31,0,0,0,31
Tropical Storm,Irene,3,1999-10-14T03:00:00Z,CEDAR KEY FL,0,1,7,5,13
Tropical Storm,Irene,3,1999-10-14T03:00:00Z,MMCZ 205N 869W,0,0,1,3,4
Tropical Storm,Irene,3,1999-10-14T03:00:00Z,ST MARKS FL,0,0,6,6,12
Tropical Storm,Irene,3,1999-10-14T03:00:00Z,MYSM 241N 745W,0,0,0,2,2
Tropical Storm,Irene,3,1999-10-14T03:00:00Z,APALACHICOLA FL,0,1,7,5,13
Tropical Storm,Irene,3,1999-10-14T03:00:00Z,MYEG 235N 758W,0,0,0,3,3
Tropical Storm,Irene,3,1999-10-14T03:00:00Z,PANAMA CITY FL,0,1,6,5,12
Tropical Storm,Irene,3,1999-10-14T03:00:00Z,MYAK 241N 776W,0,0,1,5,6
Tropical Storm,Irene,3,1999-10-14T03:00:00Z,PENSACOLA FL,0,0,4,5,9
Tropical Storm,Irene,3,1999-10-14T03:00:00Z,MYNN 251N 775W,0,0,1,5,6
Tropical Storm,Irene,3,1999-10-14T03:00:00Z,MOBILE AL,0,0,2,5,7
Tropical Storm,Irene,3,1999-10-14T03:00:00Z,MYGF 266N 787W,0,0,2,6,8
Tropical Storm,Irene,3,1999-10-14T03:00:00Z,GULFPORT MS,0,0,1,5,6
Tropical Storm,Irene,3,1999-10-14T03:00:00Z,MARATHON FL,1,7,4,3,15
Tropical Storm,Irene,3,1999-10-14T03:00:00Z,BURAS LA,0,0,1,5,6
Tropical Storm,Irene,3,1999-10-14T03:00:00Z,MIAMI FL,0,2,6,4,12
Tropical Storm,Irene,3,1999-10-14T03:00:00Z,NEW ORLEANS LA,0,0,0,4,4
Tropical Storm,Irene,3,1999-10-14T03:00:00Z,W PALM BEACH FL,0,1,5,5,11
Tropical Storm,Irene,3,1999-10-14T03:00:00Z,NEW IBERIA LA,0,0,0,2,2
Tropical Storm,Irene,3,1999-10-14T03:00:00Z,FT PIERCE FL,0,0,5,6,11
Tropical Storm,Irene,3,1999-10-14T03:00:00Z,GULF 29N 85W,0,3,7,4,14
Tropical Storm,Irene,3,1999-10-14T03:00:00Z,COCOA BEACH FL,0,0,5,6,11
Tropical Storm,Irene,3,1999-10-14T03:00:00Z,GULF 29N 87W,0,2,5,5,12
Tropical Storm,Irene,3,1999-10-14T03:00:00Z,DAYTONA BEACH FL,0,0,4,7,11
Tropical Storm,Irene,3,1999-10-14T03:00:00Z,GULF 28N 89W,0,0,3,4,7
Tropical Storm,Irene,3,1999-10-14T03:00:00Z,JACKSONVILLE FL,0,0,3,7,10
Tropical Storm,Irene,3,1999-10-14T03:00:00Z,GULF 28N 91W,0,0,0,3,3
Hurricane,Irene,4,1999-10-14T09:00:00Z,23.7N  83.8W,30,0,1,0,31
Hurricane,Irene,4,1999-10-14T09:00:00Z,CHARLESTON SC,0,0,0,6,6
Hurricane,Irene,4,1999-10-14T09:00:00Z,24.9N  83.7W,17,6,1,1,25
Hurricane,Irene,4,1999-10-14T09:00:00Z,MYRTLE BEACH SC,0,0,0,4,4
Hurricane,Irene,4,1999-10-14T09:00:00Z,26.0N  83.5W,3,14,3,2,22
Hurricane,Irene,4,1999-10-14T09:00:00Z,WILMINGTON NC,0,0,0,2,2
Hurricane,Irene,4,1999-10-14T09:00:00Z,MWCG 193N 814W,0,0,1,3,4
Hurricane,Irene,4,1999-10-14T09:00:00Z,KEY WEST FL,8,7,2,2,19
Hurricane,Irene,4,1999-10-14T09:00:00Z,MUCM 214N 779W,0,0,0,3,3
Hurricane,Irene,4,1999-10-14T09:00:00Z,MARCO ISLAND FL,1,7,5,4,17
Hurricane,Irene,4,1999-10-14T09:00:00Z,MUCF 221N 805W,6,2,2,2,12
Hurricane,Irene,4,1999-10-14T09:00:00Z,FT MYERS FL,0,6,6,5,17
Hurricane,Irene,4,1999-10-14T09:00:00Z,MUSN 216N 826W,65,0,0,0,65
Hurricane,Irene,4,1999-10-14T09:00:00Z,VENICE FL,0,6,7,5,18
Hurricane,Irene,4,1999-10-14T09:00:00Z,MUHA 230N 824W,23,1,1,1,26
Hurricane,Irene,4,1999-10-14T09:00:00Z,TAMPA FL,0,2,8,6,16
Hurricane,Irene,4,1999-10-14T09:00:00Z,MUAN 219N 850W,33,0,0,0,33
Hurricane,Irene,4,1999-10-14T09:00:00Z,CEDAR KEY FL,0,0,8,7,15
Hurricane,Irene,4,1999-10-14T09:00:00Z,MMCZ 205N 869W,0,0,0,2,2
Hurricane,Irene,4,1999-10-14T09:00:00Z,ST MARKS FL,0,0,6,8,14
Hurricane,Irene,4,1999-10-14T09:00:00Z,MYEG 235N 758W,0,0,0,2,2
Hurricane,Irene,4,1999-10-14T09:00:00Z,APALACHICOLA FL,0,1,7,7,15
Hurricane,Irene,4,1999-10-14T09:00:00Z,MYAK 241N 776W,0,0,0,5,5
Hurricane,Irene,4,1999-10-14T09:00:00Z,PANAMA CITY FL,0,0,7,7,14
Hurricane,Irene,4,1999-10-14T09:00:00Z,MYNN 251N 775W,0,0,0,5,5
Hurricane,Irene,4,1999-10-14T09:00:00Z,PENSACOLA FL,0,0,3,7,10
Hurricane,Irene,4,1999-10-14T09:00:00Z,MYGF 266N 787W,0,0,1,7,8
Hurricane,Irene,4,1999-10-14T09:00:00Z,MOBILE AL,0,0,2,6,8
Hurricane,Irene,4,1999-10-14T09:00:00Z,MARATHON FL,3,7,3,3,16
Hurricane,Irene,4,1999-10-14T09:00:00Z,GULFPORT MS,0,0,1,5,6
Hurricane,Irene,4,1999-10-14T09:00:00Z,MIAMI FL,0,2,4,7,13
Hurricane,Irene,4,1999-10-14T09:00:00Z,BURAS LA,0,0,1,4,5
Hurricane,Irene,4,1999-10-14T09:00:00Z,W PALM BEACH FL,0,0,4,7,11
Hurricane,Irene,4,1999-10-14T09:00:00Z,NEW ORLEANS LA,0,0,0,3,3
Hurricane,Irene,4,1999-10-14T09:00:00Z,FT PIERCE FL,0,0,3,9,12
Hurricane,Irene,4,1999-10-14T09:00:00Z,GULF 29N 85W,0,2,9,5,16
Hurricane,Irene,4,1999-10-14T09:00:00Z,COCOA BEACH FL,0,0,3,9,12
Hurricane,Irene,4,1999-10-14T09:00:00Z,GULF 29N 87W,0,1,6,6,13
Hurricane,Irene,4,1999-10-14T09:00:00Z,DAYTONA BEACH FL,0,0,2,10,12
Hurricane,Irene,4,1999-10-14T09:00:00Z,GULF 28N 89W,0,0,2,5,7
Hurricane,Irene,4,1999-10-14T09:00:00Z,JACKSONVILLE FL,0,0,1,10,11
Hurricane,Irene,4,1999-10-14T09:00:00Z,GULF 28N 91W,0,0,0,2,2
Hurricane,Irene,4,1999-10-14T09:00:00Z,SAVANNAH GA,0,0,0,8,8
Hurricane,Irene,5,1999-10-14T15:00:00Z,24.0N  83.5W,32,0,1,0,33
Hurricane,Irene,5,1999-10-14T15:00:00Z,MYRTLE BEACH SC,0,0,0,6,6
Hurricane,Irene,5,1999-10-14T15:00:00Z,25.5N  83.2W,11,13,1,1,26
Hurricane,Irene,5,1999-10-14T15:00:00Z,WILMINGTON NC,0,0,0,4,4
Hurricane,Irene,5,1999-10-14T15:00:00Z,27.0N  83.0W,0,15,5,2,22
Hurricane,Irene,5,1999-10-14T15:00:00Z,MOREHEAD CITY NC,0,0,0,3,3
Hurricane,Irene,5,1999-10-14T15:00:00Z,MWCG 193N 814W,0,0,0,2,2
Hurricane,Irene,5,1999-10-14T15:00:00Z,CAPE HATTERAS NC,0,0,0,2,2
Hurricane,Irene,5,1999-10-14T15:00:00Z,MUCM 214N 779W,0,0,0,2,2
Hurricane,Irene,5,1999-10-14T15:00:00Z,KEY WEST FL,13,7,2,0,22
Hurricane,Irene,5,1999-10-14T15:00:00Z,MUCF 221N 805W,8,1,1,1,11
Hurricane,Irene,5,1999-10-14T15:00:00Z,MARCO ISLAND FL,1,14,3,2,20
Hurricane,Irene,5,1999-10-14T15:00:00Z,MUSN 216N 826W,99,0,0,0,99
Hurricane,Irene,5,1999-10-14T15:00:00Z,FT MYERS FL,0,13,5,2,20
Hurricane,Irene,5,1999-10-14T15:00:00Z,MUHA 230N 824W,35,1,0,0,36
Hurricane,Irene,5,1999-10-14T15:00:00Z,VENICE FL,0,13,6,2,21
Hurricane,Irene,5,1999-10-14T15:00:00Z,MUAN 219N 850W,19,0,0,1,20
Hurricane,Irene,5,1999-10-14T15:00:00Z,TAMPA FL,0,6,10,3,19
Hurricane,Irene,5,1999-10-14T15:00:00Z,MMCZ 205N 869W,0,0,0,2,2
Hurricane,Irene,5,1999-10-14T15:00:00Z,CEDAR KEY FL,0,2,11,5,18
Hurricane,Irene,5,1999-10-14T15:00:00Z,MYAK 241N 776W,0,0,1,3,4
Hurricane,Irene,5,1999-10-14T15:00:00Z,ST MARKS FL,0,0,9,6,15
Hurricane,Irene,5,1999-10-14T15:00:00Z,MYNN 251N 775W,0,0,1,4,5
Hurricane,Irene,5,1999-10-14T15:00:00Z,APALACHICOLA FL,0,1,9,6,16
Hurricane,Irene,5,1999-10-14T15:00:00Z,MYGF 266N 787W,0,0,3,6,9
Hurricane,Irene,5,1999-10-14T15:00:00Z,PANAMA CITY FL,0,1,7,6,14
Hurricane,Irene,5,1999-10-14T15:00:00Z,MARATHON FL,5,10,2,1,18
Hurricane,Irene,5,1999-10-14T15:00:00Z,PENSACOLA FL,0,0,3,7,10
Hurricane,Irene,5,1999-10-14T15:00:00Z,MIAMI FL,0,6,5,4,15
Hurricane,Irene,5,1999-10-14T15:00:00Z,MOBILE AL,0,0,1,6,7
Hurricane,Irene,5,1999-10-14T15:00:00Z,W PALM BEACH FL,0,2,7,5,14
Hurricane,Irene,5,1999-10-14T15:00:00Z,GULFPORT MS,0,0,1,4,5
Hurricane,Irene,5,1999-10-14T15:00:00Z,FT PIERCE FL,0,1,7,6,14
Hurricane,Irene,5,1999-10-14T15:00:00Z,BURAS LA,0,0,0,5,5
Hurricane,Irene,5,1999-10-14T15:00:00Z,COCOA BEACH FL,0,1,7,6,14
Hurricane,Irene,5,1999-10-14T15:00:00Z,NEW ORLEANS LA,0,0,0,3,3
Hurricane,Irene,5,1999-10-14T15:00:00Z,DAYTONA BEACH FL,0,0,7,8,15
Hurricane,Irene,5,1999-10-14T15:00:00Z,GULF 29N 85W,0,3,10,4,17
Hurricane,Irene,5,1999-10-14T15:00:00Z,JACKSONVILLE FL,0,0,5,9,14
Hurricane,Irene,5,1999-10-14T15:00:00Z,GULF 29N 87W,0,1,5,6,12
Hurricane,Irene,5,1999-10-14T15:00:00Z,SAVANNAH GA,0,0,1,10,11
Hurricane,Irene,5,1999-10-14T15:00:00Z,GULF 28N 89W,0,0,1,5,6
Hurricane,Irene,5,1999-10-14T15:00:00Z,CHARLESTON SC,0,0,0,8,8
Hurricane,Irene,5,1999-10-14T15:00:00Z,GULF 28N 91W,0,0,0,2,2
Hurricane,Irene,6,1999-10-14T21:00:00Z,25.0N  81.7W,37,1,0,0,38
Hurricane,Irene,6,1999-10-14T21:00:00Z,NEW YORK CITY NY,0,0,0,3,3
Hurricane,Irene,6,1999-10-14T21:00:00Z,27.0N  81.5W,8,17,1,0,26
Hurricane,Irene,6,1999-10-14T21:00:00Z,MONTAUK POINT NY,0,0,0,2,2
Hurricane,Irene,6,1999-10-14T21:00:00Z,29.0N  81.3W,0,10,8,2,20
Hurricane,Irene,6,1999-10-14T21:00:00Z,PROVIDENCE RI,0,0,0,2,2
Hurricane,Irene,6,1999-10-14T21:00:00Z,MUCF 221N 805W,27,0,0,0,27
Hurricane,Irene,6,1999-10-14T21:00:00Z,NANTUCKET MA,0,0,0,2,2
Hurricane,Irene,6,1999-10-14T21:00:00Z,MUSN 216N 826W,99,0,0,0,99
Hurricane,Irene,6,1999-10-14T21:00:00Z,KEY WEST FL,45,0,0,0,45
Hurricane,Irene,6,1999-10-14T21:00:00Z,MUHA 230N 824W,99,0,0,0,99
Hurricane,Irene,6,1999-10-14T21:00:00Z,MARCO ISLAND FL,25,6,0,0,31
Hurricane,Irene,6,1999-10-14T21:00:00Z,MUAN 219N 850W,1,0,1,2,4
Hurricane,Irene,6,1999-10-14T21:00:00Z,FT MYERS FL,16,12,1,0,29
Hurricane,Irene,6,1999-10-14T21:00:00Z,MYAK 241N 776W,2,4,0,1,7
Hurricane,Irene,6,1999-10-14T21:00:00Z,VENICE FL,9,16,1,1,27
Hurricane,Irene,6,1999-10-14T21:00:00Z,MYNN 251N 775W,1,4,2,2,9
Hurricane,Irene,6,1999-10-14T21:00:00Z,TAMPA FL,2,18,2,1,23
Hurricane,Irene,6,1999-10-14T21:00:00Z,MYGF 266N 787W,1,10,3,1,15
Hurricane,Irene,6,1999-10-14T21:00:00Z,CEDAR KEY FL,0,11,7,2,20
Hurricane,Irene,6,1999-10-14T21:00:00Z,MARATHON FL,38,0,0,0,38
Hurricane,Irene,6,1999-10-14T21:00:00Z,ST MARKS FL,0,3,10,4,17
Hurricane,Irene,6,1999-10-14T21:00:00Z,MIAMI FL,18,7,0,1,26
Hurricane,Irene,6,1999-10-14T21:00:00Z,APALACHICOLA FL,0,4,8,4,16
Hurricane,Irene,6,1999-10-14T21:00:00Z,W PALM BEACH FL,6,14,1,1,22
Hurricane,Irene,6,1999-10-14T21:00:00Z,PANAMA CITY FL,0,2,8,5,15
Hurricane,Irene,6,1999-10-14T21:00:00Z,FT PIERCE FL,2,15,3,1,21
Hurricane,Irene,6,1999-10-14T21:00:00Z,PENSACOLA FL,0,0,5,6,11
Hurricane,Irene,6,1999-10-14T21:00:00Z,COCOA BEACH FL,0,14,5,1,20
Hurricane,Irene,6,1999-10-14T21:00:00Z,MOBILE AL,0,0,2,7,9
Hurricane,Irene,6,1999-10-14T21:00:00Z,DAYTONA BEACH FL,0,8,9,2,19
Hurricane,Irene,6,1999-10-14T21:00:00Z,GULFPORT MS,0,0,1,7,8
Hurricane,Irene,6,1999-10-14T21:00:00Z,JACKSONVILLE FL,0,2,11,4,17
Hurricane,Irene,6,1999-10-14T21:00:00Z,BURAS LA,0,0,1,6,7
Hurricane,Irene,6,1999-10-14T21:00:00Z,SAVANNAH GA,0,0,7,8,15
Hurricane,Irene,6,1999-10-14T21:00:00Z,NEW ORLEANS LA,0,0,0,6,6
Hurricane,Irene,6,1999-10-14T21:00:00Z,CHARLESTON SC,0,0,4,9,13
Hurricane,Irene,6,1999-10-14T21:00:00Z,NEW IBERIA LA,0,0,0,4,4
Hurricane,Irene,6,1999-10-14T21:00:00Z,MYRTLE BEACH SC,0,0,1,11,12
Hurricane,Irene,6,1999-10-14T21:00:00Z,PORT ARTHUR TX,0,0,0,2,2
Hurricane,Irene,6,1999-10-14T21:00:00Z,WILMINGTON NC,0,0,1,10,11
Hurricane,Irene,6,1999-10-14T21:00:00Z,GULF 29N 85W,0,7,7,3,17
Hurricane,Irene,6,1999-10-14T21:00:00Z,MOREHEAD CITY NC,0,0,0,9,9
Hurricane,Irene,6,1999-10-14T21:00:00Z,GULF 29N 87W,0,1,7,5,13
Hurricane,Irene,6,1999-10-14T21:00:00Z,CAPE HATTERAS NC,0,0,0,8,8
Hurricane,Irene,6,1999-10-14T21:00:00Z,GULF 28N 89W,0,0,2,6,8
Hurricane,Irene,6,1999-10-14T21:00:00Z,NORFOLK VA,0,0,0,7,7
Hurricane,Irene,6,1999-10-14T21:00:00Z,GULF 28N 91W,0,0,0,5,5
Hurricane,Irene,6,1999-10-14T21:00:00Z,OCEAN CITY MD,0,0,0,5,5
Hurricane,Irene,6,1999-10-14T21:00:00Z,GULF 28N 93W,0,0,0,3,3
Hurricane,Irene,6,1999-10-14T21:00:00Z,ATLANTIC CITY NJ,0,0,0,4,4
Hurricane,Irene,7,1999-10-15T03:00:00Z,26.0N  82.6W,46,0,0,0,46
Hurricane,Irene,7,1999-10-15T03:00:00Z,OCEAN CITY MD,0,0,0,5,5
Hurricane,Irene,7,1999-10-15T03:00:00Z,27.5N  82.5W,18,10,1,0,29
Hurricane,Irene,7,1999-10-15T03:00:00Z,ATLANTIC CITY NJ,0,0,0,5,5
Hurricane,Irene,7,1999-10-15T03:00:00Z,29.5N  82.0W,0,11,8,2,21
Hurricane,Irene,7,1999-10-15T03:00:00Z,NEW YORK CITY NY,0,0,0,3,3
Hurricane,Irene,7,1999-10-15T03:00:00Z,MUCF 221N 805W,0,0,0,2,2
Hurricane,Irene,7,1999-10-15T03:00:00Z,MONTAUK POINT NY,0,0,0,2,2
Hurricane,Irene,7,1999-10-15T03:00:00Z,MUSN 216N 826W,0,0,0,2,2
Hurricane,Irene,7,1999-10-15T03:00:00Z,PROVIDENCE RI,0,0,0,2,2
Hurricane,Irene,7,1999-10-15T03:00:00Z,MUHA 230N 824W,99,0,0,0,99
Hurricane,Irene,7,1999-10-15T03:00:00Z,KEY WEST FL,71,0,0,0,71
Hurricane,Irene,7,1999-10-15T03:00:00Z,MUAN 219N 850W,0,0,1,2,3
Hurricane,Irene,7,1999-10-15T03:00:00Z,MARCO ISLAND FL,40,0,0,0,40
Hurricane,Irene,7,1999-10-15T03:00:00Z,MMCZ 205N 869W,0,0,0,2,2
Hurricane,Irene,7,1999-10-15T03:00:00Z,FT MYERS FL,32,1,1,0,34
Hurricane,Irene,7,1999-10-15T03:00:00Z,MYAK 241N 776W,0,0,0,2,2
Hurricane,Irene,7,1999-10-15T03:00:00Z,VENICE FL,25,7,0,0,32
Hurricane,Irene,7,1999-10-15T03:00:00Z,MYNN 251N 775W,0,0,1,3,4
Hurricane,Irene,7,1999-10-15T03:00:00Z,TAMPA FL,9,16,1,0,26
Hurricane,Irene,7,1999-10-15T03:00:00Z,MYGF 266N 787W,3,4,3,2,12
Hurricane,Irene,7,1999-10-15T03:00:00Z,CEDAR KEY FL,0,16,5,2,23
Hurricane,Irene,7,1999-10-15T03:00:00Z,MARATHON FL,41,0,0,0,41
Hurricane,Irene,7,1999-10-15T03:00:00Z,ST MARKS FL,0,5,11,3,19
Hurricane,Irene,7,1999-10-15T03:00:00Z,MIAMI FL,20,1,1,0,22
Hurricane,Irene,7,1999-10-15T03:00:00Z,APALACHICOLA FL,0,6,10,3,19
Hurricane,Irene,7,1999-10-15T03:00:00Z,W PALM BEACH FL,14,4,1,1,20
Hurricane,Irene,7,1999-10-15T03:00:00Z,PANAMA CITY FL,0,3,10,4,17
Hurricane,Irene,7,1999-10-15T03:00:00Z,FT PIERCE FL,9,8,2,1,20
Hurricane,Irene,7,1999-10-15T03:00:00Z,PENSACOLA FL,0,0,7,6,13
Hurricane,Irene,7,1999-10-15T03:00:00Z,COCOA BEACH FL,3,13,3,1,20
Hurricane,Irene,7,1999-10-15T03:00:00Z,MOBILE AL,0,0,3,7,10
Hurricane,Irene,7,1999-10-15T03:00:00Z,DAYTONA BEACH FL,0,11,7,2,20
Hurricane,Irene,7,1999-10-15T03:00:00Z,GULFPORT MS,0,0,2,7,9
Hurricane,Irene,7,1999-10-15T03:00:00Z,JACKSONVILLE FL,0,3,12,4,19
Hurricane,Irene,7,1999-10-15T03:00:00Z,BURAS LA,0,0,2,6,8
Hurricane,Irene,7,1999-10-15T03:00:00Z,SAVANNAH GA,0,0,9,7,16
Hurricane,Irene,7,1999-10-15T03:00:00Z,NEW ORLEANS LA,0,0,1,5,6
Hurricane,Irene,7,1999-10-15T03:00:00Z,CHARLESTON SC,0,0,5,9,14
Hurricane,Irene,7,1999-10-15T03:00:00Z,NEW IBERIA LA,0,0,0,4,4
Hurricane,Irene,7,1999-10-15T03:00:00Z,MYRTLE BEACH SC,0,0,2,10,12
Hurricane,Irene,7,1999-10-15T03:00:00Z,GULF 29N 85W,0,12,6,2,20
Hurricane,Irene,7,1999-10-15T03:00:00Z,WILMINGTON NC,0,0,1,9,10
Hurricane,Irene,7,1999-10-15T03:00:00Z,GULF 29N 87W,0,4,7,4,15
Hurricane,Irene,7,1999-10-15T03:00:00Z,MOREHEAD CITY NC,0,0,0,9,9
Hurricane,Irene,7,1999-10-15T03:00:00Z,GULF 28N 89W,0,1,3,5,9
Hurricane,Irene,7,1999-10-15T03:00:00Z,CAPE HATTERAS NC,0,0,0,7,7
Hurricane,Irene,7,1999-10-15T03:00:00Z,GULF 28N 91W,0,0,1,4,5
Hurricane,Irene,7,1999-10-15T03:00:00Z,NORFOLK VA,0,0,0,7,7
Hurricane,Irene,7,1999-10-15T03:00:00Z,GULF 28N 93W,0,0,0,2,2
Hurricane,Irene,8,1999-10-15T09:00:00Z,26.5N  82.2W,45,0,0,0,45
Hurricane,Irene,8,1999-10-15T09:00:00Z,PROVIDENCE RI,0,0,0,3,3
Hurricane,Irene,8,1999-10-15T09:00:00Z,28.2N  82.0W,13,14,1,1,29
Hurricane,Irene,8,1999-10-15T09:00:00Z,NANTUCKET MA,0,0,0,2,2
Hurricane,Irene,8,1999-10-15T09:00:00Z,30.5N  81.5W,0,8,11,2,21
Hurricane,Irene,8,1999-10-15T09:00:00Z,HYANNIS MA,0,0,0,2,2
Hurricane,Irene,8,1999-10-15T09:00:00Z,MUHA 230N 824W,99,0,0,0,99
Hurricane,Irene,8,1999-10-15T09:00:00Z,BOSTON MA,0,0,0,3,3
Hurricane,Irene,8,1999-10-15T09:00:00Z,MUAN 219N 850W,0,0,0,2,2
Hurricane,Irene,8,1999-10-15T09:00:00Z,PORTLAND ME,0,0,0,2,2
Hurricane,Irene,8,1999-10-15T09:00:00Z,MYAK 241N 776W,0,0,0,2,2
Hurricane,Irene,8,1999-10-15T09:00:00Z,KEY WEST FL,99,0,0,0,99
Hurricane,Irene,8,1999-10-15T09:00:00Z,MYNN 251N 775W,0,1,0,2,3
Hurricane,Irene,8,1999-10-15T09:00:00Z,MARCO ISLAND FL,52,0,0,0,52
Hurricane,Irene,8,1999-10-15T09:00:00Z,MYGF 266N 787W,6,4,1,2,13
Hurricane,Irene,8,1999-10-15T09:00:00Z,FT MYERS FL,42,0,0,0,42
Hurricane,Irene,8,1999-10-15T09:00:00Z,MARATHON FL,63,0,0,0,63
Hurricane,Irene,8,1999-10-15T09:00:00Z,VENICE FL,35,2,0,0,37
Hurricane,Irene,8,1999-10-15T09:00:00Z,MIAMI FL,27,1,0,0,28
Hurricane,Irene,8,1999-10-15T09:00:00Z,TAMPA FL,17,13,0,0,30
Hurricane,Irene,8,1999-10-15T09:00:00Z,W PALM BEACH FL,22,2,0,0,24
Hurricane,Irene,8,1999-10-15T09:00:00Z,CEDAR KEY FL,2,20,3,0,25
Hurricane,Irene,8,1999-10-15T09:00:00Z,FT PIERCE FL,17,6,0,1,24
Hurricane,Irene,8,1999-10-15T09:00:00Z,ST MARKS FL,0,9,10,2,21
Hurricane,Irene,8,1999-10-15T09:00:00Z,COCOA BEACH FL,9,13,1,0,23
Hurricane,Irene,8,1999-10-15T09:00:00Z,APALACHICOLA FL,0,10,8,2,20
Hurricane,Irene,8,1999-10-15T09:00:00Z,DAYTONA BEACH FL,1,17,4,1,23
Hurricane,Irene,8,1999-10-15T09:00:00Z,PANAMA CITY FL,0,6,9,2,17
Hurricane,Irene,8,1999-10-15T09:00:00Z,JACKSONVILLE FL,0,8,11,2,21
Hurricane,Irene,8,1999-10-15T09:00:00Z,PENSACOLA FL,0,1,7,4,12
Hurricane,Irene,8,1999-10-15T09:00:00Z,SAVANNAH GA,0,1,12,5,18
Hurricane,Irene,8,1999-10-15T09:00:00Z,MOBILE AL,0,0,4,5,9
Hurricane,Irene,8,1999-10-15T09:00:00Z,CHARLESTON SC,0,0,8,8,16
Hurricane,Irene,8,1999-10-15T09:00:00Z,GULFPORT MS,0,0,2,6,8
Hurricane,Irene,8,1999-10-15T09:00:00Z,MYRTLE BEACH SC,0,0,4,10,14
Hurricane,Irene,8,1999-10-15T09:00:00Z,BURAS LA,0,0,2,4,6
Hurricane,Irene,8,1999-10-15T09:00:00Z,WILMINGTON NC,0,0,2,10,12
Hurricane,Irene,8,1999-10-15T09:00:00Z,NEW ORLEANS LA,0,0,1,4,5
Hurricane,Irene,8,1999-10-15T09:00:00Z,MOREHEAD CITY NC,0,0,1,9,10
Hurricane,Irene,8,1999-10-15T09:00:00Z,NEW IBERIA LA,0,0,0,3,3
Hurricane,Irene,8,1999-10-15T09:00:00Z,CAPE HATTERAS NC,0,0,0,9,9
Hurricane,Irene,8,1999-10-15T09:00:00Z,GULF 29N 85W,1,15,3,2,21
Hurricane,Irene,8,1999-10-15T09:00:00Z,NORFOLK VA,0,0,0,9,9
Hurricane,Irene,8,1999-10-15T09:00:00Z,GULF 29N 87W,0,4,7,3,14
Hurricane,Irene,8,1999-10-15T09:00:00Z,OCEAN CITY MD,0,0,0,7,7
Hurricane,Irene,8,1999-10-15T09:00:00Z,GULF 28N 89W,0,1,2,4,7
Hurricane,Irene,8,1999-10-15T09:00:00Z,ATLANTIC CITY NJ,0,0,0,6,6
Hurricane,Irene,8,1999-10-15T09:00:00Z,GULF 28N 91W,0,0,0,3,3
Hurricane,Irene,8,1999-10-15T09:00:00Z,NEW YORK CITY NY,0,0,0,5,5
Hurricane,Irene,8,1999-10-15T09:00:00Z,GULF 28N 93W,0,0,0,2,2
Hurricane,Irene,8,1999-10-15T09:00:00Z,MONTAUK POINT NY,0,0,0,4,4
Hurricane,Irene,9,1999-10-15T12:00:00Z,26.5N  82.2W,45,0,0,0,45
Hurricane,Irene,9,1999-10-15T12:00:00Z,PROVIDENCE RI,0,0,0,3,3
Hurricane,Irene,9,1999-10-15T12:00:00Z,28.2N  82.0W,13,14,1,1,29
Hurricane,Irene,9,1999-10-15T12:00:00Z,NANTUCKET MA,0,0,0,2,2
Hurricane,Irene,9,1999-10-15T12:00:00Z,30.5N  81.5W,0,8,11,2,21
Hurricane,Irene,9,1999-10-15T12:00:00Z,HYANNIS MA,0,0,0,2,2
Hurricane,Irene,9,1999-10-15T12:00:00Z,MUHA 230N 824W,99,0,0,0,99
Hurricane,Irene,9,1999-10-15T12:00:00Z,BOSTON MA,0,0,0,3,3
Hurricane,Irene,9,1999-10-15T12:00:00Z,MUAN 219N 850W,0,0,0,2,2
Hurricane,Irene,9,1999-10-15T12:00:00Z,PORTLAND ME,0,0,0,2,2
Hurricane,Irene,9,1999-10-15T12:00:00Z,MYAK 241N 776W,0,0,0,2,2
Hurricane,Irene,9,1999-10-15T12:00:00Z,KEY WEST FL,99,0,0,0,99
Hurricane,Irene,9,1999-10-15T12:00:00Z,MYNN 251N 775W,0,1,0,2,3
Hurricane,Irene,9,1999-10-15T12:00:00Z,MARCO ISLAND FL,52,0,0,0,52
Hurricane,Irene,9,1999-10-15T12:00:00Z,MYGF 266N 787W,6,4,1,2,13
Hurricane,Irene,9,1999-10-15T12:00:00Z,FT MYERS FL,42,0,0,0,42
Hurricane,Irene,9,1999-10-15T12:00:00Z,MARATHON FL,63,0,0,0,63
Hurricane,Irene,9,1999-10-15T12:00:00Z,VENICE FL,35,2,0,0,37
Hurricane,Irene,9,1999-10-15T12:00:00Z,MIAMI FL,27,1,0,0,28
Hurricane,Irene,9,1999-10-15T12:00:00Z,TAMPA FL,17,13,0,0,30
Hurricane,Irene,9,1999-10-15T12:00:00Z,W PALM BEACH FL,22,2,0,0,24
Hurricane,Irene,9,1999-10-15T12:00:00Z,CEDAR KEY FL,2,20,3,0,25
Hurricane,Irene,9,1999-10-15T12:00:00Z,FT PIERCE FL,17,6,0,1,24
Hurricane,Irene,9,1999-10-15T12:00:00Z,ST MARKS FL,0,9,10,2,21
Hurricane,Irene,9,1999-10-15T12:00:00Z,COCOA BEACH FL,9,13,1,0,23
Hurricane,Irene,9,1999-10-15T12:00:00Z,APALACHICOLA FL,0,10,8,2,20
Hurricane,Irene,9,1999-10-15T12:00:00Z,DAYTONA BEACH FL,1,17,4,1,23
Hurricane,Irene,9,1999-10-15T12:00:00Z,PANAMA CITY FL,0,6,9,2,17
Hurricane,Irene,9,1999-10-15T12:00:00Z,JACKSONVILLE FL,0,8,11,2,21
Hurricane,Irene,9,1999-10-15T12:00:00Z,PENSACOLA FL,0,1,7,4,12
Hurricane,Irene,9,1999-10-15T12:00:00Z,SAVANNAH GA,0,1,12,5,18
Hurricane,Irene,9,1999-10-15T12:00:00Z,MOBILE AL,0,0,4,5,9
Hurricane,Irene,9,1999-10-15T12:00:00Z,CHARLESTON SC,0,0,8,8,16
Hurricane,Irene,9,1999-10-15T12:00:00Z,GULFPORT MS,0,0,2,6,8
Hurricane,Irene,9,1999-10-15T12:00:00Z,MYRTLE BEACH SC,0,0,4,10,14
Hurricane,Irene,9,1999-10-15T12:00:00Z,BURAS LA,0,0,2,4,6
Hurricane,Irene,9,1999-10-15T12:00:00Z,WILMINGTON NC,0,0,2,10,12
Hurricane,Irene,9,1999-10-15T12:00:00Z,NEW ORLEANS LA,0,0,1,4,5
Hurricane,Irene,9,1999-10-15T12:00:00Z,MOREHEAD CITY NC,0,0,1,9,10
Hurricane,Irene,9,1999-10-15T12:00:00Z,NEW IBERIA LA,0,0,0,3,3
Hurricane,Irene,9,1999-10-15T12:00:00Z,CAPE HATTERAS NC,0,0,0,9,9
Hurricane,Irene,9,1999-10-15T12:00:00Z,GULF 29N 85W,1,15,3,2,21
Hurricane,Irene,9,1999-10-15T12:00:00Z,NORFOLK VA,0,0,0,9,9
Hurricane,Irene,9,1999-10-15T12:00:00Z,GULF 29N 87W,0,4,7,3,14
Hurricane,Irene,9,1999-10-15T12:00:00Z,OCEAN CITY MD,0,0,0,7,7
Hurricane,Irene,9,1999-10-15T12:00:00Z,GULF 28N 89W,0,1,2,4,7
Hurricane,Irene,9,1999-10-15T12:00:00Z,ATLANTIC CITY NJ,0,0,0,6,6
Hurricane,Irene,9,1999-10-15T12:00:00Z,GULF 28N 91W,0,0,0,3,3
Hurricane,Irene,9,1999-10-15T12:00:00Z,NEW YORK CITY NY,0,0,0,5,5
Hurricane,Irene,9,1999-10-15T12:00:00Z,GULF 28N 93W,0,0,0,2,2
Hurricane,Irene,9,1999-10-15T12:00:00Z,MONTAUK POINT NY,0,0,0,4,4
Hurricane,Irene,10,1999-10-15T15:00:00Z,27.2N  81.3W,35,0,0,0,35
Hurricane,Irene,10,1999-10-15T15:00:00Z,NANTUCKET MA,0,0,0,5,5
Hurricane,Irene,10,1999-10-15T15:00:00Z,29.2N  81.0W,5,18,1,0,24
Hurricane,Irene,10,1999-10-15T15:00:00Z,HYANNIS MA,0,0,0,5,5
Hurricane,Irene,10,1999-10-15T15:00:00Z,32.0N  80.5W,0,5,12,2,19
Hurricane,Irene,10,1999-10-15T15:00:00Z,BOSTON MA,0,0,0,5,5
Hurricane,Irene,10,1999-10-15T15:00:00Z,MUHA 230N 824W,0,1,0,1,2
Hurricane,Irene,10,1999-10-15T15:00:00Z,PORTLAND ME,0,0,0,4,4
Hurricane,Irene,10,1999-10-15T15:00:00Z,MYNN 251N 775W,1,1,1,1,4
Hurricane,Irene,10,1999-10-15T15:00:00Z,BAR HARBOR ME,0,0,0,3,3
Hurricane,Irene,10,1999-10-15T15:00:00Z,MYGF 266N 787W,12,2,0,1,15
Hurricane,Irene,10,1999-10-15T15:00:00Z,EASTPORT ME,0,0,0,2,2
Hurricane,Irene,10,1999-10-15T15:00:00Z,MARATHON FL,99,0,0,0,99
Hurricane,Irene,10,1999-10-15T15:00:00Z,YARMOUTH NS,0,0,0,2,2
Hurricane,Irene,10,1999-10-15T15:00:00Z,MIAMI FL,44,0,0,0,44
Hurricane,Irene,10,1999-10-15T15:00:00Z,KEY WEST FL,99,0,0,0,99
Hurricane,Irene,10,1999-10-15T15:00:00Z,W PALM BEACH FL,28,1,0,0,29
Hurricane,Irene,10,1999-10-15T15:00:00Z,MARCO ISLAND FL,61,0,0,0,61
Hurricane,Irene,10,1999-10-15T15:00:00Z,FT PIERCE FL,23,2,1,0,26
Hurricane,Irene,10,1999-10-15T15:00:00Z,FT MYERS FL,48,0,0,0,48
Hurricane,Irene,10,1999-10-15T15:00:00Z,COCOA BEACH FL,16,8,1,0,25
Hurricane,Irene,10,1999-10-15T15:00:00Z,VENICE FL,37,1,0,0,38
Hurricane,Irene,10,1999-10-15T15:00:00Z,DAYTONA BEACH FL,5,18,1,0,24
Hurricane,Irene,10,1999-10-15T15:00:00Z,TAMPA FL,27,3,0,0,30
Hurricane,Irene,10,1999-10-15T15:00:00Z,JACKSONVILLE FL,0,18,4,1,23
Hurricane,Irene,10,1999-10-15T15:00:00Z,CEDAR KEY FL,9,14,1,0,24
Hurricane,Irene,10,1999-10-15T15:00:00Z,SAVANNAH GA,0,6,12,2,20
Hurricane,Irene,10,1999-10-15T15:00:00Z,ST MARKS FL,1,12,4,1,18
Hurricane,Irene,10,1999-10-15T15:00:00Z,CHARLESTON SC,0,1,13,4,18
Hurricane,Irene,10,1999-10-15T15:00:00Z,APALACHICOLA FL,1,9,4,1,15
Hurricane,Irene,10,1999-10-15T15:00:00Z,MYRTLE BEACH SC,0,0,9,7,16
Hurricane,Irene,10,1999-10-15T15:00:00Z,PANAMA CITY FL,0,6,4,2,12
Hurricane,Irene,10,1999-10-15T15:00:00Z,WILMINGTON NC,0,0,4,10,14
Hurricane,Irene,10,1999-10-15T15:00:00Z,PENSACOLA FL,0,0,3,4,7
Hurricane,Irene,10,1999-10-15T15:00:00Z,MOREHEAD CITY NC,0,0,2,11,13
Hurricane,Irene,10,1999-10-15T15:00:00Z,MOBILE AL,0,0,1,4,5
Hurricane,Irene,10,1999-10-15T15:00:00Z,CAPE HATTERAS NC,0,0,1,10,11
Hurricane,Irene,10,1999-10-15T15:00:00Z,GULFPORT MS,0,0,0,4,4
Hurricane,Irene,10,1999-10-15T15:00:00Z,NORFOLK VA,0,0,0,12,12
Hurricane,Irene,10,1999-10-15T15:00:00Z,BURAS LA,0,0,0,3,3
Hurricane,Irene,10,1999-10-15T15:00:00Z,OCEAN CITY MD,0,0,0,11,11
Hurricane,Irene,10,1999-10-15T15:00:00Z,NEW ORLEANS LA,0,0,0,2,2
Hurricane,Irene,10,1999-10-15T15:00:00Z,ATLANTIC CITY NJ,0,0,0,10,10
Hurricane,Irene,10,1999-10-15T15:00:00Z,GULF 29N 85W,3,9,2,1,15
Hurricane,Irene,10,1999-10-15T15:00:00Z,NEW YORK CITY NY,0,0,0,8,8
Hurricane,Irene,10,1999-10-15T15:00:00Z,GULF 29N 87W,0,1,2,3,6
Hurricane,Irene,10,1999-10-15T15:00:00Z,MONTAUK POINT NY,0,0,0,7,7
Hurricane,Irene,10,1999-10-15T15:00:00Z,GULF 28N 89W,0,0,0,2,2
Hurricane,Irene,10,1999-10-15T15:00:00Z,PROVIDENCE RI,0,0,0,6,6
Hurricane,Irene,11,1999-10-15T21:00:00Z,28.6N  81.4W,38,1,0,0,39
Hurricane,Irene,11,1999-10-15T21:00:00Z,MONTAUK POINT NY,0,0,0,8,8
Hurricane,Irene,11,1999-10-15T21:00:00Z,30.6N  81.1W,8,11,2,0,21
Hurricane,Irene,11,1999-10-15T21:00:00Z,PROVIDENCE RI,0,0,0,7,7
Hurricane,Irene,11,1999-10-15T21:00:00Z,33.5N  80.0W,0,6,9,2,17
Hurricane,Irene,11,1999-10-15T21:00:00Z,NANTUCKET MA,0,0,0,6,6
Hurricane,Irene,11,1999-10-15T21:00:00Z,MYNN 251N 775W,0,1,0,1,2
Hurricane,Irene,11,1999-10-15T21:00:00Z,HYANNIS MA,0,0,0,6,6
Hurricane,Irene,11,1999-10-15T21:00:00Z,MYGF 266N 787W,10,2,0,0,12
Hurricane,Irene,11,1999-10-15T21:00:00Z,BOSTON MA,0,0,0,6,6
Hurricane,Irene,11,1999-10-15T21:00:00Z,MARATHON FL,99,0,0,0,99
Hurricane,Irene,11,1999-10-15T21:00:00Z,PORTLAND ME,0,0,0,4,4
Hurricane,Irene,11,1999-10-15T21:00:00Z,MIAMI FL,99,0,0,0,99
Hurricane,Irene,11,1999-10-15T21:00:00Z,BAR HARBOR ME,0,0,0,2,2
Hurricane,Irene,11,1999-10-15T21:00:00Z,W PALM BEACH FL,50,0,0,0,50
Hurricane,Irene,11,1999-10-15T21:00:00Z,KEY WEST FL,99,0,0,0,99
Hurricane,Irene,11,1999-10-15T21:00:00Z,FT PIERCE FL,42,0,0,1,43
Hurricane,Irene,11,1999-10-15T21:00:00Z,MARCO ISLAND FL,99,0,0,0,99
Hurricane,Irene,11,1999-10-15T21:00:00Z,COCOA BEACH FL,38,0,0,0,38
Hurricane,Irene,11,1999-10-15T21:00:00Z,FT MYERS FL,62,0,0,0,62
Hurricane,Irene,11,1999-10-15T21:00:00Z,DAYTONA BEACH FL,29,1,0,0,30
Hurricane,Irene,11,1999-10-15T21:00:00Z,VENICE FL,44,0,0,0,44
Hurricane,Irene,11,1999-10-15T21:00:00Z,JACKSONVILLE FL,13,9,1,0,23
Hurricane,Irene,11,1999-10-15T21:00:00Z,TAMPA FL,40,0,0,1,41
Hurricane,Irene,11,1999-10-15T21:00:00Z,SAVANNAH GA,1,13,4,1,19
Hurricane,Irene,11,1999-10-15T21:00:00Z,CEDAR KEY FL,27,1,0,0,28
Hurricane,Irene,11,1999-10-15T21:00:00Z,CHARLESTON SC,0,8,8,2,18
Hurricane,Irene,11,1999-10-15T21:00:00Z,ST MARKS FL,7,9,2,0,18
Hurricane,Irene,11,1999-10-15T21:00:00Z,MYRTLE BEACH SC,0,3,10,3,16
Hurricane,Irene,11,1999-10-15T21:00:00Z,APALACHICOLA FL,4,8,2,0,14
Hurricane,Irene,11,1999-10-15T21:00:00Z,WILMINGTON NC,0,1,9,5,15
Hurricane,Irene,11,1999-10-15T21:00:00Z,PANAMA CITY FL,1,8,2,1,12
Hurricane,Irene,11,1999-10-15T21:00:00Z,MOREHEAD CITY NC,0,0,6,8,14
Hurricane,Irene,11,1999-10-15T21:00:00Z,PENSACOLA FL,0,3,3,1,7
Hurricane,Irene,11,1999-10-15T21:00:00Z,CAPE HATTERAS NC,0,0,3,10,13
Hurricane,Irene,11,1999-10-15T21:00:00Z,MOBILE AL,0,1,1,1,3
Hurricane,Irene,11,1999-10-15T21:00:00Z,NORFOLK VA,0,0,3,11,14
Hurricane,Irene,11,1999-10-15T21:00:00Z,GULFPORT MS,0,0,1,1,2
Hurricane,Irene,11,1999-10-15T21:00:00Z,OCEAN CITY MD,0,0,1,12,13
Hurricane,Irene,11,1999-10-15T21:00:00Z,GULF 29N 85W,5,7,1,1,14
Hurricane,Irene,11,1999-10-15T21:00:00Z,ATLANTIC CITY NJ,0,0,0,12,12
Hurricane,Irene,11,1999-10-15T21:00:00Z,GULF 29N 87W,0,2,3,0,5
Hurricane,Irene,11,1999-10-15T21:00:00Z,NEW YORK CITY NY,0,0,0,11,11
Hurricane,Irene,12,1999-10-16T03:00:00Z,30.0N  79.7W,31,1,0,0,32
Hurricane,Irene,12,1999-10-16T03:00:00Z,NEW YORK CITY NY,0,0,0,8,8
Hurricane,Irene,12,1999-10-16T03:00:00Z,32.0N  79.5W,8,8,1,1,18
Hurricane,Irene,12,1999-10-16T03:00:00Z,MONTAUK POINT NY,0,0,0,7,7
Hurricane,Irene,12,1999-10-16T03:00:00Z,35.0N  77.5W,0,3,6,3,12
Hurricane,Irene,12,1999-10-16T03:00:00Z,PROVIDENCE RI,0,0,0,7,7
Hurricane,Irene,12,1999-10-16T03:00:00Z,MYAK 241N 776W,0,1,0,1,2
Hurricane,Irene,12,1999-10-16T03:00:00Z,NANTUCKET MA,0,0,0,6,6
Hurricane,Irene,12,1999-10-16T03:00:00Z,MYNN 251N 775W,0,2,1,1,4
Hurricane,Irene,12,1999-10-16T03:00:00Z,HYANNIS MA,0,0,0,6,6
Hurricane,Irene,12,1999-10-16T03:00:00Z,MYGF 266N 787W,87,0,0,0,87
Hurricane,Irene,12,1999-10-16T03:00:00Z,BOSTON MA,0,0,0,6,6
Hurricane,Irene,12,1999-10-16T03:00:00Z,BERMUDA,0,0,0,2,2
Hurricane,Irene,12,1999-10-16T03:00:00Z,PORTLAND ME,0,0,0,5,5
Hurricane,Irene,12,1999-10-16T03:00:00Z,MARATHON FL,0,2,0,0,2
Hurricane,Irene,12,1999-10-16T03:00:00Z,BAR HARBOR ME,0,0,0,3,3
Hurricane,Irene,12,1999-10-16T03:00:00Z,MIAMI FL,99,0,0,0,99
Hurricane,Irene,12,1999-10-16T03:00:00Z,EASTPORT ME,0,0,0,2,2
Hurricane,Irene,12,1999-10-16T03:00:00Z,W PALM BEACH FL,99,0,0,0,99
Hurricane,Irene,12,1999-10-16T03:00:00Z,ST JOHN NB,0,0,0,2,2
Hurricane,Irene,12,1999-10-16T03:00:00Z,FT PIERCE FL,99,0,0,0,99
Hurricane,Irene,12,1999-10-16T03:00:00Z,YARMOUTH NS,0,0,0,2,2
Hurricane,Irene,12,1999-10-16T03:00:00Z,COCOA BEACH FL,72,0,0,1,73
Hurricane,Irene,12,1999-10-16T03:00:00Z,KEY WEST FL,0,1,0,1,2
Hurricane,Irene,12,1999-10-16T03:00:00Z,DAYTONA BEACH FL,40,0,0,0,40
Hurricane,Irene,12,1999-10-16T03:00:00Z,MARCO ISLAND FL,99,0,0,0,99
Hurricane,Irene,12,1999-10-16T03:00:00Z,JACKSONVILLE FL,20,2,0,0,22
Hurricane,Irene,12,1999-10-16T03:00:00Z,FT MYERS FL,82,0,0,0,82
Hurricane,Irene,12,1999-10-16T03:00:00Z,SAVANNAH GA,6,9,2,0,17
Hurricane,Irene,12,1999-10-16T03:00:00Z,VENICE FL,45,0,0,0,45
Hurricane,Irene,12,1999-10-16T03:00:00Z,CHARLESTON SC,2,11,2,0,15
Hurricane,Irene,12,1999-10-16T03:00:00Z,TAMPA FL,35,0,0,0,35
Hurricane,Irene,12,1999-10-16T03:00:00Z,MYRTLE BEACH SC,0,9,4,1,14
Hurricane,Irene,12,1999-10-16T03:00:00Z,CEDAR KEY FL,16,1,1,0,18
Hurricane,Irene,12,1999-10-16T03:00:00Z,WILMINGTON NC,0,6,5,2,13
Hurricane,Irene,12,1999-10-16T03:00:00Z,ST MARKS FL,3,5,1,1,10
Hurricane,Irene,12,1999-10-16T03:00:00Z,MOREHEAD CITY NC,0,3,6,3,12
Hurricane,Irene,12,1999-10-16T03:00:00Z,APALACHICOLA FL,1,4,1,0,6
Hurricane,Irene,12,1999-10-16T03:00:00Z,CAPE HATTERAS NC,0,1,5,5,11
Hurricane,Irene,12,1999-10-16T03:00:00Z,PANAMA CITY FL,0,3,2,0,5
Hurricane,Irene,12,1999-10-16T03:00:00Z,NORFOLK VA,0,0,5,6,11
Hurricane,Irene,12,1999-10-16T03:00:00Z,PENSACOLA FL,0,1,0,1,2
Hurricane,Irene,12,1999-10-16T03:00:00Z,OCEAN CITY MD,0,0,2,8,10
Hurricane,Irene,12,1999-10-16T03:00:00Z,GULF 29N 85W,1,3,1,1,6
Hurricane,Irene,12,1999-10-16T03:00:00Z,ATLANTIC CITY NJ,0,0,1,8,9
Hurricane,Irene,13,1999-10-16T09:00:00Z,30.9N  79.4W,32,0,0,0,32
Hurricane,Irene,13,1999-10-16T09:00:00Z,PROVIDENCE RI,0,0,0,9,9
Hurricane,Irene,13,1999-10-16T09:00:00Z,33.2N  78.5W,3,12,1,1,17
Hurricane,Irene,13,1999-10-16T09:00:00Z,NANTUCKET MA,0,0,0,9,9
Hurricane,Irene,13,1999-10-16T09:00:00Z,36.0N  76.0W,0,2,7,3,12
Hurricane,Irene,13,1999-10-16T09:00:00Z,HYANNIS MA,0,0,0,9,9
Hurricane,Irene,13,1999-10-16T09:00:00Z,MYNN 251N 775W,0,1,1,0,2
Hurricane,Irene,13,1999-10-16T09:00:00Z,BOSTON MA,0,0,0,8,8
Hurricane,Irene,13,1999-10-16T09:00:00Z,MYGF 266N 787W,82,0,0,0,82
Hurricane,Irene,13,1999-10-16T09:00:00Z,PORTLAND ME,0,0,0,8,8
Hurricane,Irene,13,1999-10-16T09:00:00Z,BERMUDA,0,0,0,3,3
Hurricane,Irene,13,1999-10-16T09:00:00Z,BAR HARBOR ME,0,0,0,6,6
Hurricane,Irene,13,1999-10-16T09:00:00Z,MIAMI FL,2,1,1,0,4
Hurricane,Irene,13,1999-10-16T09:00:00Z,EASTPORT ME,0,0,0,5,5
Hurricane,Irene,13,1999-10-16T09:00:00Z,W PALM BEACH FL,99,0,0,0,99
Hurricane,Irene,13,1999-10-16T09:00:00Z,ST JOHN NB,0,0,0,5,5
Hurricane,Irene,13,1999-10-16T09:00:00Z,FT PIERCE FL,99,0,0,0,99
Hurricane,Irene,13,1999-10-16T09:00:00Z,MONCTON NB,0,0,0,3,3
Hurricane,Irene,13,1999-10-16T09:00:00Z,COCOA BEACH FL,99,0,0,0,99
Hurricane,Irene,13,1999-10-16T09:00:00Z,YARMOUTH NS,0,0,0,5,5
Hurricane,Irene,13,1999-10-16T09:00:00Z,DAYTONA BEACH FL,56,0,0,0,56
Hurricane,Irene,13,1999-10-16T09:00:00Z,HALIFAX NS,0,0,0,3,3
Hurricane,Irene,13,1999-10-16T09:00:00Z,JACKSONVILLE FL,24,1,0,0,25
Hurricane,Irene,13,1999-10-16T09:00:00Z,SABLE ISLAND NS,0,0,0,2,2
Hurricane,Irene,13,1999-10-16T09:00:00Z,SAVANNAH GA,12,7,0,0,19
Hurricane,Irene,13,1999-10-16T09:00:00Z,EDDY POINT NS,0,0,0,2,2
Hurricane,Irene,13,1999-10-16T09:00:00Z,CHARLESTON SC,6,11,1,0,18
Hurricane,Irene,13,1999-10-16T09:00:00Z,MARCO ISLAND FL,0,2,0,0,2
Hurricane,Irene,13,1999-10-16T09:00:00Z,MYRTLE BEACH SC,1,13,1,1,16
Hurricane,Irene,13,1999-10-16T09:00:00Z,FT MYERS FL,2,2,0,0,4
Hurricane,Irene,13,1999-10-16T09:00:00Z,WILMINGTON NC,0,10,3,1,14
Hurricane,Irene,13,1999-10-16T09:00:00Z,VENICE FL,3,2,0,0,5
Hurricane,Irene,13,1999-10-16T09:00:00Z,MOREHEAD CITY NC,0,6,5,2,13
Hurricane,Irene,13,1999-10-16T09:00:00Z,TAMPA FL,27,0,0,0,27
Hurricane,Irene,13,1999-10-16T09:00:00Z,CAPE HATTERAS NC,0,3,6,3,12
Hurricane,Irene,13,1999-10-16T09:00:00Z,CEDAR KEY FL,15,0,0,1,16
Hurricane,Irene,13,1999-10-16T09:00:00Z,NORFOLK VA,0,1,7,3,11
Hurricane,Irene,13,1999-10-16T09:00:00Z,ST MARKS FL,2,4,1,0,7
Hurricane,Irene,13,1999-10-16T09:00:00Z,OCEAN CITY MD,0,0,5,6,11
Hurricane,Irene,13,1999-10-16T09:00:00Z,APALACHICOLA FL,1,1,1,0,3
Hurricane,Irene,13,1999-10-16T09:00:00Z,ATLANTIC CITY NJ,0,0,3,7,10
Hurricane,Irene,13,1999-10-16T09:00:00Z,PANAMA CITY FL,0,1,1,0,2
Hurricane,Irene,13,1999-10-16T09:00:00Z,NEW YORK CITY NY,0,0,1,9,10
Hurricane,Irene,13,1999-10-16T09:00:00Z,GULF 29N 85W,0,2,0,0,2
Hurricane,Irene,13,1999-10-16T09:00:00Z,MONTAUK POINT NY,0,0,0,9,9
Hurricane,Irene,14,1999-10-16T15:00:00Z,31.8N  79.7W,30,0,0,0,30
Hurricane,Irene,14,1999-10-16T15:00:00Z,HYANNIS MA,0,0,6,9,15
Hurricane,Irene,14,1999-10-16T15:00:00Z,34.0N  78.5W,4,13,5,0,22
Hurricane,Irene,14,1999-10-16T15:00:00Z,BOSTON MA,0,0,5,9,14
Hurricane,Irene,14,1999-10-16T15:00:00Z,39.0N  71.0W,0,0,9,7,16
Hurricane,Irene,14,1999-10-16T15:00:00Z,PORTLAND ME,0,0,3,10,13
Hurricane,Irene,14,1999-10-16T15:00:00Z,MYGF 266N 787W,6,1,1,0,8
Hurricane,Irene,14,1999-10-16T15:00:00Z,BAR HARBOR ME,0,0,2,11,13
Hurricane,Irene,14,1999-10-16T15:00:00Z,BERMUDA,0,0,0,2,2
Hurricane,Irene,14,1999-10-16T15:00:00Z,EASTPORT ME,0,0,1,13,14
Hurricane,Irene,14,1999-10-16T15:00:00Z,W PALM BEACH FL,99,0,0,0,99
Hurricane,Irene,14,1999-10-16T15:00:00Z,ST JOHN NB,0,0,1,13,14
Hurricane,Irene,14,1999-10-16T15:00:00Z,FT PIERCE FL,99,0,0,0,99
Hurricane,Irene,14,1999-10-16T15:00:00Z,MONCTON NB,0,0,0,13,13
Hurricane,Irene,14,1999-10-16T15:00:00Z,COCOA BEACH FL,99,0,0,0,99
Hurricane,Irene,14,1999-10-16T15:00:00Z,YARMOUTH NS,0,0,1,14,15
Hurricane,Irene,14,1999-10-16T15:00:00Z,DAYTONA BEACH FL,52,0,0,0,52
Hurricane,Irene,14,1999-10-16T15:00:00Z,HALIFAX NS,0,0,0,15,15
Hurricane,Irene,14,1999-10-16T15:00:00Z,JACKSONVILLE FL,30,0,0,1,31
Hurricane,Irene,14,1999-10-16T15:00:00Z,SABLE ISLAND NS,0,0,0,14,14
Hurricane,Irene,14,1999-10-16T15:00:00Z,SAVANNAH GA,24,1,0,0,25
Hurricane,Irene,14,1999-10-16T15:00:00Z,SYDNEY NS,0,0,0,14,14
Hurricane,Irene,14,1999-10-16T15:00:00Z,CHARLESTON SC,18,4,2,0,24
Hurricane,Irene,14,1999-10-16T15:00:00Z,EDDY POINT NS,0,0,0,14,14
Hurricane,Irene,14,1999-10-16T15:00:00Z,MYRTLE BEACH SC,7,11,5,0,23
Hurricane,Irene,14,1999-10-16T15:00:00Z,PTX BASQUES NFLD,0,0,0,13,13
Hurricane,Irene,14,1999-10-16T15:00:00Z,WILMINGTON NC,2,12,8,0,22
Hurricane,Irene,14,1999-10-16T15:00:00Z,BURGEO NFLD,0,0,0,13,13
Hurricane,Irene,14,1999-10-16T15:00:00Z,MOREHEAD CITY NC,0,10,10,0,20
Hurricane,Irene,14,1999-10-16T15:00:00Z,ILE ST PIERRE,0,0,0,13,13
Hurricane,Irene,14,1999-10-16T15:00:00Z,CAPE HATTERAS NC,0,5,13,0,18
Hurricane,Irene,14,1999-10-16T15:00:00Z,CAPE RACE NFLD,0,0,0,11,11
Hurricane,Irene,14,1999-10-16T15:00:00Z,NORFOLK VA,0,4,13,1,18
Hurricane,Irene,14,1999-10-16T15:00:00Z,HIBERNIA OILFLD,0,0,0,6,6
Hurricane,Irene,14,1999-10-16T15:00:00Z,OCEAN CITY MD,0,1,13,2,16
Hurricane,Irene,14,1999-10-16T15:00:00Z,FT MYERS FL,1,1,0,0,2
Hurricane,Irene,14,1999-10-16T15:00:00Z,ATLANTIC CITY NJ,0,0,12,3,15
Hurricane,Irene,14,1999-10-16T15:00:00Z,VENICE FL,1,1,0,0,2
Hurricane,Irene,14,1999-10-16T15:00:00Z,NEW YORK CITY NY,0,0,10,4,14
Hurricane,Irene,14,1999-10-16T15:00:00Z,TAMPA FL,10,0,1,0,11
Hurricane,Irene,14,1999-10-16T15:00:00Z,MONTAUK POINT NY,0,0,8,7,15
Hurricane,Irene,14,1999-10-16T15:00:00Z,CEDAR KEY FL,7,2,1,0,10
Hurricane,Irene,14,1999-10-16T15:00:00Z,PROVIDENCE RI,0,0,7,8,15
Hurricane,Irene,14,1999-10-16T15:00:00Z,ST MARKS FL,1,3,1,0,5
Hurricane,Irene,14,1999-10-16T15:00:00Z,NANTUCKET MA,0,0,6,10,16
Hurricane,Irene,14,1999-10-16T15:00:00Z,APALACHICOLA FL,0,1,1,0,2
Hurricane,Irene,15,1999-10-16T21:00:00Z,32.6N  79.4W,35,2,0,0,37
Hurricane,Irene,15,1999-10-16T21:00:00Z,NANTUCKET MA,0,0,14,4,18
Hurricane,Irene,15,1999-10-16T21:00:00Z,36.4N  75.4W,0,15,7,0,22
Hurricane,Irene,15,1999-10-16T21:00:00Z,HYANNIS MA,0,0,13,4,17
Hurricane,Irene,15,1999-10-16T21:00:00Z,41.5N  68.0W,0,0,10,7,17
Hurricane,Irene,15,1999-10-16T21:00:00Z,BOSTON MA,0,0,13,4,17
Hurricane,Irene,15,1999-10-16T21:00:00Z,FT PIERCE FL,11,0,0,0,11
Hurricane,Irene,15,1999-10-16T21:00:00Z,PORTLAND ME,0,0,10,5,15
Hurricane,Irene,15,1999-10-16T21:00:00Z,COCOA BEACH FL,99,0,0,0,99
Hurricane,Irene,15,1999-10-16T21:00:00Z,BAR HARBOR ME,0,0,7,8,15
Hurricane,Irene,15,1999-10-16T21:00:00Z,DAYTONA BEACH FL,99,0,0,0,99
Hurricane,Irene,15,1999-10-16T21:00:00Z,EASTPORT ME,0,0,5,10,15
Hurricane,Irene,15,1999-10-16T21:00:00Z,JACKSONVILLE FL,24,1,0,0,25
Hurricane,Irene,15,1999-10-16T21:00:00Z,ST JOHN NB,0,0,4,11,15
Hurricane,Irene,15,1999-10-16T21:00:00Z,SAVANNAH GA,33,0,0,0,33
Hurricane,Irene,15,1999-10-16T21:00:00Z,MONCTON NB,0,0,2,13,15
Hurricane,Irene,15,1999-10-16T21:00:00Z,CHARLESTON SC,34,2,0,0,36
Hurricane,Irene,15,1999-10-16T21:00:00Z,YARMOUTH NS,0,0,5,11,16
Hurricane,Irene,15,1999-10-16T21:00:00Z,MYRTLE BEACH SC,18,13,0,0,31
Hurricane,Irene,15,1999-10-16T21:00:00Z,HALIFAX NS,0,0,2,14,16
Hurricane,Irene,15,1999-10-16T21:00:00Z,WILMINGTON NC,5,21,1,0,27
Hurricane,Irene,15,1999-10-16T21:00:00Z,SABLE ISLAND NS,0,0,0,14,14
Hurricane,Irene,15,1999-10-16T21:00:00Z,MOREHEAD CITY NC,1,21,2,0,24
Hurricane,Irene,15,1999-10-16T21:00:00Z,SYDNEY NS,0,0,0,15,15
Hurricane,Irene,15,1999-10-16T21:00:00Z,CAPE HATTERAS NC,0,17,5,0,22
Hurricane,Irene,15,1999-10-16T21:00:00Z,EDDY POINT NS,0,0,1,14,15
Hurricane,Irene,15,1999-10-16T21:00:00Z,NORFOLK VA,0,16,6,0,22
Hurricane,Irene,15,1999-10-16T21:00:00Z,PTX BASQUES NFLD,0,0,0,15,15
Hurricane,Irene,15,1999-10-16T21:00:00Z,OCEAN CITY MD,0,9,11,1,21
Hurricane,Irene,15,1999-10-16T21:00:00Z,BURGEO NFLD,0,0,0,15,15
Hurricane,Irene,15,1999-10-16T21:00:00Z,ATLANTIC CITY NJ,0,5,14,0,19
Hurricane,Irene,15,1999-10-16T21:00:00Z,ILE ST PIERRE,0,0,0,14,14
Hurricane,Irene,15,1999-10-16T21:00:00Z,NEW YORK CITY NY,0,2,15,1,18
Hurricane,Irene,15,1999-10-16T21:00:00Z,CAPE RACE NFLD,0,0,0,12,12
Hurricane,Irene,15,1999-10-16T21:00:00Z,MONTAUK POINT NY,0,1,14,3,18
Hurricane,Irene,15,1999-10-16T21:00:00Z,HIBERNIA OILFLD,0,0,0,9,9
Hurricane,Irene,15,1999-10-16T21:00:00Z,PROVIDENCE RI,0,0,14,3,17
Hurricane,Irene,16,1999-10-17T03:00:00Z,34.5N  77.5W,31,7,0,0,38
Hurricane,Irene,16,1999-10-17T03:00:00Z,NANTUCKET MA,0,1,10,1,12
Hurricane,Irene,16,1999-10-17T03:00:00Z,38.0N  72.5W,0,11,6,0,17
Hurricane,Irene,16,1999-10-17T03:00:00Z,HYANNIS MA,0,1,10,1,12
Hurricane,Irene,16,1999-10-17T03:00:00Z,42.0N  66.0W,0,0,6,5,11
Hurricane,Irene,16,1999-10-17T03:00:00Z,BOSTON MA,0,1,8,2,11
Hurricane,Irene,16,1999-10-17T03:00:00Z,BERMUDA,0,0,1,1,2
Hurricane,Irene,16,1999-10-17T03:00:00Z,PORTLAND ME,0,0,7,2,9
Hurricane,Irene,16,1999-10-17T03:00:00Z,DAYTONA BEACH FL,74,0,0,0,74
Hurricane,Irene,16,1999-10-17T03:00:00Z,BAR HARBOR ME,0,0,5,3,8
Hurricane,Irene,16,1999-10-17T03:00:00Z,JACKSONVILLE FL,64,0,0,0,64
Hurricane,Irene,16,1999-10-17T03:00:00Z,EASTPORT ME,0,0,3,5,8
Hurricane,Irene,16,1999-10-17T03:00:00Z,SAVANNAH GA,38,0,0,0,38
Hurricane,Irene,16,1999-10-17T03:00:00Z,ST JOHN NB,0,0,2,6,8
Hurricane,Irene,16,1999-10-17T03:00:00Z,CHARLESTON SC,46,0,0,0,46
Hurricane,Irene,16,1999-10-17T03:00:00Z,MONCTON NB,0,0,1,7,8
Hurricane,Irene,16,1999-10-17T03:00:00Z,MYRTLE BEACH SC,44,1,0,0,45
Hurricane,Irene,16,1999-10-17T03:00:00Z,YARMOUTH NS,0,0,4,6,10
Hurricane,Irene,16,1999-10-17T03:00:00Z,WILMINGTON NC,36,4,0,0,40
Hurricane,Irene,16,1999-10-17T03:00:00Z,HALIFAX NS,0,0,1,8,9
Hurricane,Irene,16,1999-10-17T03:00:00Z,MOREHEAD CITY NC,21,13,0,0,34
Hurricane,Irene,16,1999-10-17T03:00:00Z,SABLE ISLAND NS,0,0,0,9,9
Hurricane,Irene,16,1999-10-17T03:00:00Z,CAPE HATTERAS NC,6,21,0,0,27
Hurricane,Irene,16,1999-10-17T03:00:00Z,SYDNEY NS,0,0,0,9,9
Hurricane,Irene,16,1999-10-17T03:00:00Z,NORFOLK VA,1,21,0,0,22
Hurricane,Irene,16,1999-10-17T03:00:00Z,EDDY POINT NS,0,0,0,9,9
Hurricane,Irene,16,1999-10-17T03:00:00Z,OCEAN CITY MD,0,15,2,0,17
Hurricane,Irene,16,1999-10-17T03:00:00Z,PTX BASQUES NFLD,0,0,0,8,8
Hurricane,Irene,16,1999-10-17T03:00:00Z,ATLANTIC CITY NJ,0,9,5,0,14
Hurricane,Irene,16,1999-10-17T03:00:00Z,BURGEO NFLD,0,0,0,8,8
Hurricane,Irene,16,1999-10-17T03:00:00Z,NEW YORK CITY NY,0,5,7,0,12
Hurricane,Irene,16,1999-10-17T03:00:00Z,ILE ST PIERRE,0,0,0,9,9
Hurricane,Irene,16,1999-10-17T03:00:00Z,MONTAUK POINT NY,0,2,10,0,12
Hurricane,Irene,16,1999-10-17T03:00:00Z,CAPE RACE NFLD,0,0,0,8,8
Hurricane,Irene,16,1999-10-17T03:00:00Z,PROVIDENCE RI,0,1,10,1,12
Hurricane,Irene,16,1999-10-17T03:00:00Z,HIBERNIA OILFLD,0,0,0,7,7
Hurricane,Irene,17,1999-10-17T09:00:00Z,34.8N  77.4W,32,10,0,0,42
Hurricane,Irene,17,1999-10-17T09:00:00Z,PROVIDENCE RI,0,4,7,0,11
Hurricane,Irene,17,1999-10-17T09:00:00Z,39.0N  70.5W,0,9,7,0,16
Hurricane,Irene,17,1999-10-17T09:00:00Z,NANTUCKET MA,0,4,8,0,12
Hurricane,Irene,17,1999-10-17T09:00:00Z,44.0N  61.0W,0,0,5,0,5
Hurricane,Irene,17,1999-10-17T09:00:00Z,HYANNIS MA,0,3,8,0,11
Hurricane,Irene,17,1999-10-17T09:00:00Z,JACKSONVILLE FL,75,0,0,0,75
Hurricane,Irene,17,1999-10-17T09:00:00Z,BOSTON MA,0,2,7,0,9
Hurricane,Irene,17,1999-10-17T09:00:00Z,SAVANNAH GA,55,0,0,0,55
Hurricane,Irene,17,1999-10-17T09:00:00Z,PORTLAND ME,0,1,6,0,7
Hurricane,Irene,17,1999-10-17T09:00:00Z,CHARLESTON SC,53,0,0,0,53
Hurricane,Irene,17,1999-10-17T09:00:00Z,BAR HARBOR ME,0,0,7,0,7
Hurricane,Irene,17,1999-10-17T09:00:00Z,MYRTLE BEACH SC,49,1,0,0,50
Hurricane,Irene,17,1999-10-17T09:00:00Z,EASTPORT ME,0,0,6,0,6
Hurricane,Irene,17,1999-10-17T09:00:00Z,WILMINGTON NC,40,6,0,0,46
Hurricane,Irene,17,1999-10-17T09:00:00Z,ST JOHN NB,0,0,6,0,6
Hurricane,Irene,17,1999-10-17T09:00:00Z,MOREHEAD CITY NC,24,15,0,0,39
Hurricane,Irene,17,1999-10-17T09:00:00Z,MONCTON NB,0,0,5,0,5
Hurricane,Irene,17,1999-10-17T09:00:00Z,CAPE HATTERAS NC,7,23,0,0,30
Hurricane,Irene,17,1999-10-17T09:00:00Z,YARMOUTH NS,0,0,8,0,8
Hurricane,Irene,17,1999-10-17T09:00:00Z,NORFOLK VA,2,21,1,0,24
Hurricane,Irene,17,1999-10-17T09:00:00Z,HALIFAX NS,0,0,6,0,6
Hurricane,Irene,17,1999-10-17T09:00:00Z,OCEAN CITY MD,0,16,1,0,17
Hurricane,Irene,17,1999-10-17T09:00:00Z,SABLE ISLAND NS,0,0,4,0,4
Hurricane,Irene,17,1999-10-17T09:00:00Z,ATLANTIC CITY NJ,0,11,2,0,13
Hurricane,Irene,17,1999-10-17T09:00:00Z,SYDNEY NS,0,0,2,0,2
Hurricane,Irene,17,1999-10-17T09:00:00Z,NEW YORK CITY NY,0,8,3,0,11
Hurricane,Irene,17,1999-10-17T09:00:00Z,EDDY POINT NS,0,0,4,0,4
Hurricane,Irene,17,1999-10-17T09:00:00Z,MONTAUK POINT NY,0,6,6,0,12
Hurricane,Irene,18,1999-10-17T15:00:00Z,37.0N  74.2W,20,12,0,0,32
Hurricane,Irene,18,1999-10-17T15:00:00Z,HYANNIS MA,0,10,1,0,11
Hurricane,Irene,18,1999-10-17T15:00:00Z,41.0N  66.0W,0,8,6,0,14
Hurricane,Irene,18,1999-10-17T15:00:00Z,BOSTON MA,0,7,1,0,8
Hurricane,Irene,18,1999-10-17T15:00:00Z,47.0N  55.0W,0,0,5,0,5
Hurricane,Irene,18,1999-10-17T15:00:00Z,PORTLAND ME,0,4,2,0,6
Hurricane,Irene,18,1999-10-17T15:00:00Z,SAVANNAH GA,99,0,0,0,99
Hurricane,Irene,18,1999-10-17T15:00:00Z,BAR HARBOR ME,0,3,4,0,7
Hurricane,Irene,18,1999-10-17T15:00:00Z,CHARLESTON SC,81,0,0,0,81
Hurricane,Irene,18,1999-10-17T15:00:00Z,EASTPORT ME,0,2,5,0,7
Hurricane,Irene,18,1999-10-17T15:00:00Z,MYRTLE BEACH SC,74,0,0,0,74
Hurricane,Irene,18,1999-10-17T15:00:00Z,ST JOHN NB,0,1,6,0,7
Hurricane,Irene,18,1999-10-17T15:00:00Z,WILMINGTON NC,66,0,0,0,66
Hurricane,Irene,18,1999-10-17T15:00:00Z,MONCTON NB,0,1,6,0,7
Hurricane,Irene,18,1999-10-17T15:00:00Z,MOREHEAD CITY NC,57,0,0,0,57
Hurricane,Irene,18,1999-10-17T15:00:00Z,YARMOUTH NS,0,3,7,0,10
Hurricane,Irene,18,1999-10-17T15:00:00Z,CAPE HATTERAS NC,45,1,0,0,46
Hurricane,Irene,18,1999-10-17T15:00:00Z,HALIFAX NS,0,1,8,0,9
Hurricane,Irene,18,1999-10-17T15:00:00Z,NORFOLK VA,29,3,0,0,32
Hurricane,Irene,18,1999-10-17T15:00:00Z,SABLE ISLAND NS,0,0,9,0,9
Hurricane,Irene,18,1999-10-17T15:00:00Z,OCEAN CITY MD,11,9,0,0,20
Hurricane,Irene,18,1999-10-17T15:00:00Z,SYDNEY NS,0,0,8,0,8
Hurricane,Irene,18,1999-10-17T15:00:00Z,ATLANTIC CITY NJ,3,10,0,0,13
Hurricane,Irene,18,1999-10-17T15:00:00Z,EDDY POINT NS,0,0,9,0,9
Hurricane,Irene,18,1999-10-17T15:00:00Z,NEW YORK CITY NY,0,10,0,0,10
Hurricane,Irene,18,1999-10-17T15:00:00Z,PTX BASQUES NFLD,0,0,6,0,6
Hurricane,Irene,18,1999-10-17T15:00:00Z,MONTAUK POINT NY,0,11,1,0,12
Hurricane,Irene,18,1999-10-17T15:00:00Z,BURGEO NFLD,0,0,6,0,6
Hurricane,Irene,18,1999-10-17T15:00:00Z,PROVIDENCE RI,0,9,1,0,10
Hurricane,Irene,18,1999-10-17T15:00:00Z,ILE ST PIERRE,0,0,6,0,6
Hurricane,Irene,18,1999-10-17T15:00:00Z,NANTUCKET MA,0,12,1,0,13
Hurricane,Irene,18,1999-10-17T15:00:00Z,CAPE RACE NFLD,0,0,3,0,3
Hurricane,Irene,19,1999-10-17T21:00:00Z,37.0N  72.9W,19,12,0,0,31
Hurricane,Irene,19,1999-10-17T21:00:00Z,MONTAUK POINT NY,0,7,0,0,7
Hurricane,Irene,19,1999-10-17T21:00:00Z,40.5N  64.0W,0,8,0,0,8
Hurricane,Irene,19,1999-10-17T21:00:00Z,PROVIDENCE RI,0,6,0,0,6
Hurricane,Irene,19,1999-10-17T21:00:00Z,SAVANNAH GA,4,0,0,0,4
Hurricane,Irene,19,1999-10-17T21:00:00Z,NANTUCKET MA,0,9,0,0,9
Hurricane,Irene,19,1999-10-17T21:00:00Z,CHARLESTON SC,99,0,0,0,99
Hurricane,Irene,19,1999-10-17T21:00:00Z,HYANNIS MA,0,7,0,0,7
Hurricane,Irene,19,1999-10-17T21:00:00Z,MYRTLE BEACH SC,75,0,0,0,75
Hurricane,Irene,19,1999-10-17T21:00:00Z,BOSTON MA,0,4,0,0,4
Hurricane,Irene,19,1999-10-17T21:00:00Z,WILMINGTON NC,68,0,0,0,68
Hurricane,Irene,19,1999-10-17T21:00:00Z,PORTLAND ME,0,2,0,0,2
Hurricane,Irene,19,1999-10-17T21:00:00Z,MOREHEAD CITY NC,62,0,0,0,62
Hurricane,Irene,19,1999-10-17T21:00:00Z,BAR HARBOR ME,0,2,0,0,2
Hurricane,Irene,19,1999-10-17T21:00:00Z,CAPE HATTERAS NC,52,0,0,0,52
Hurricane,Irene,19,1999-10-17T21:00:00Z,EASTPORT ME,0,2,0,0,2
Hurricane,Irene,19,1999-10-17T21:00:00Z,NORFOLK VA,22,1,0,0,23
Hurricane,Irene,19,1999-10-17T21:00:00Z,ST JOHN NB,0,2,0,0,2
Hurricane,Irene,19,1999-10-17T21:00:00Z,OCEAN CITY MD,9,4,0,0,13
Hurricane,Irene,19,1999-10-17T21:00:00Z,YARMOUTH NS,0,4,0,0,4
Hurricane,Irene,19,1999-10-17T21:00:00Z,ATLANTIC CITY NJ,3,4,0,0,7
Hurricane,Irene,19,1999-10-17T21:00:00Z,HALIFAX NS,0,2,0,0,2
Hurricane,Irene,19,1999-10-17T21:00:00Z,NEW YORK CITY NY,0,4,0,0,4
Hurricane,Irene,20,1999-10-18T03:00:00Z,40.3N  64.5W,15,7,0,0,22
Hurricane,Irene,20,1999-10-18T03:00:00Z,BOSTON MA,3,0,0,0,3
Hurricane,Irene,20,1999-10-18T03:00:00Z,44.0N  54.5W,0,9,0,0,9
Hurricane,Irene,20,1999-10-18T03:00:00Z,PORTLAND ME,2,0,0,0,2
Hurricane,Irene,20,1999-10-18T03:00:00Z,CHARLESTON SC,2,0,0,0,2
Hurricane,Irene,20,1999-10-18T03:00:00Z,BAR HARBOR ME,2,2,0,0,4
Hurricane,Irene,20,1999-10-18T03:00:00Z,MYRTLE BEACH SC,99,0,0,0,99
Hurricane,Irene,20,1999-10-18T03:00:00Z,EASTPORT ME,2,3,0,0,5
Hurricane,Irene,20,1999-10-18T03:00:00Z,WILMINGTON NC,99,0,0,0,99
Hurricane,Irene,20,1999-10-18T03:00:00Z,ST JOHN NB,1,4,0,0,5
Hurricane,Irene,20,1999-10-18T03:00:00Z,MOREHEAD CITY NC,99,0,0,0,99
Hurricane,Irene,20,1999-10-18T03:00:00Z,MONCTON NB,0,5,0,0,5
Hurricane,Irene,20,1999-10-18T03:00:00Z,CAPE HATTERAS NC,63,0,0,0,63
Hurricane,Irene,20,1999-10-18T03:00:00Z,YARMOUTH NS,4,5,0,0,9
Hurricane,Irene,20,1999-10-18T03:00:00Z,NORFOLK VA,15,0,0,0,15
Hurricane,Irene,20,1999-10-18T03:00:00Z,HALIFAX NS,1,9,0,0,10
Hurricane,Irene,20,1999-10-18T03:00:00Z,OCEAN CITY MD,9,0,0,0,9
Hurricane,Irene,20,1999-10-18T03:00:00Z,SABLE ISLAND NS,0,14,0,0,14
Hurricane,Irene,20,1999-10-18T03:00:00Z,ATLANTIC CITY NJ,4,0,0,0,4
Hurricane,Irene,20,1999-10-18T03:00:00Z,SYDNEY NS,0,9,0,0,9
Hurricane,Irene,20,1999-10-18T03:00:00Z,NEW YORK CITY NY,3,0,0,0,3
Hurricane,Irene,20,1999-10-18T03:00:00Z,EDDY POINT NS,0,10,0,0,10
Hurricane,Irene,20,1999-10-18T03:00:00Z,MONTAUK POINT NY,5,0,0,0,5
Hurricane,Irene,20,1999-10-18T03:00:00Z,PTX BASQUES NFLD,0,6,0,0,6
Hurricane,Irene,20,1999-10-18T03:00:00Z,PROVIDENCE RI,4,0,0,0,4
Hurricane,Irene,20,1999-10-18T03:00:00Z,BURGEO NFLD,0,6,0,0,6
Hurricane,Irene,20,1999-10-18T03:00:00Z,NANTUCKET MA,8,0,0,0,8
Hurricane,Irene,20,1999-10-18T03:00:00Z,ILE ST PIERRE,0,7,0,0,7
Hurricane,Irene,20,1999-10-18T03:00:00Z,HYANNIS MA,7,0,0,0,7
Hurricane,Irene,20,1999-10-18T03:00:00Z,CAPE RACE NFLD,0,4,0,0,4
Hurricane,Irene,21,1999-10-18T09:00:00Z,41.5N  59.0W,15,0,0,0,15
Hurricane,Irene,21,1999-10-18T09:00:00Z,HALIFAX NS,4,0,0,0,4
Hurricane,Irene,21,1999-10-18T09:00:00Z,MOREHEAD CITY NC,73,0,0,0,73
Hurricane,Irene,21,1999-10-18T09:00:00Z,SABLE ISLAND NS,8,0,0,0,8
Hurricane,Irene,21,1999-10-18T09:00:00Z,CAPE HATTERAS NC,99,0,0,0,99
Hurricane,Irene,21,1999-10-18T09:00:00Z,SYDNEY NS,2,0,0,0,2
Hurricane,Irene,21,1999-10-18T09:00:00Z,NANTUCKET MA,2,0,0,0,2
Hurricane,Irene,21,1999-10-18T09:00:00Z,EDDY POINT NS,3,0,0,0,3
Hurricane,Irene,21,1999-10-18T09:00:00Z,YARMOUTH NS,3,0,0,0,3
Hurricane,Irene,22,1999-10-18T15:00:00Z,46.0N  50.0W,14,6,0,0,20
Hurricane,Irene,22,1999-10-18T15:00:00Z,EDDY POINT NS,4,0,0,0,4
Hurricane,Irene,22,1999-10-18T15:00:00Z,50.0N  37.0W,0,9,4,0,13
Hurricane,Irene,22,1999-10-18T15:00:00Z,PTX BASQUES NFLD,2,0,0,0,2
Hurricane,Irene,22,1999-10-18T15:00:00Z,51.0N  30.0W,0,1,7,0,8
Hurricane,Irene,22,1999-10-18T15:00:00Z,BURGEO NFLD,4,0,0,0,4
Hurricane,Irene,22,1999-10-18T15:00:00Z,HALIFAX NS,2,0,0,0,2
Hurricane,Irene,22,1999-10-18T15:00:00Z,ILE ST PIERRE,9,0,0,0,9
Hurricane,Irene,22,1999-10-18T15:00:00Z,SABLE ISLAND NS,16,0,0,0,16
Hurricane,Irene,22,1999-10-18T15:00:00Z,CAPE RACE NFLD,16,1,0,0,17
Hurricane,Irene,22,1999-10-18T15:00:00Z,SYDNEY NS,4,0,0,0,4
Hurricane,Irene,22,1999-10-18T15:00:00Z,HIBERNIA OILFLD,6,12,0,0,18
Hurricane,Irene,23,1999-10-18T21:00:00Z,50.0N  43.5W,17,6,0,0,23
Hurricane,Irene,23,1999-10-18T21:00:00Z,EDDY POINT NS,2,0,0,0,2
Hurricane,Irene,23,1999-10-18T21:00:00Z,51.5N  36.0W,0,11,2,0,13
Hurricane,Irene,23,1999-10-18T21:00:00Z,BURGEO NFLD,3,0,0,0,3
Hurricane,Irene,23,1999-10-18T21:00:00Z,51.5N  31.0W,0,3,5,0,8
Hurricane,Irene,23,1999-10-18T21:00:00Z,ILE ST PIERRE,13,0,0,0,13
Hurricane,Irene,23,1999-10-18T21:00:00Z,SABLE ISLAND NS,25,0,0,0,25
Hurricane,Irene,23,1999-10-18T21:00:00Z,CAPE RACE NFLD,26,0,0,0,26
Hurricane,Irene,23,1999-10-18T21:00:00Z,SYDNEY NS,2,0,0,0,2
Hurricane,Irene,23,1999-10-18T21:00:00Z,HIBERNIA OILFLD,23,0,0,0,23
Hurricane,Irene,24,1999-10-19T03:00:00Z,51.0N  37.0W,24,3,0,0,27
Hurricane,Irene,24,1999-10-19T03:00:00Z,SABLE ISLAND NS,3,0,0,0,3
Hurricane,Irene,24,1999-10-19T03:00:00Z,51.0N  32.0W,6,11,2,0,19
Hurricane,Irene,24,1999-10-19T03:00:00Z,CAPE RACE NFLD,12,0,0,0,12
Hurricane,Irene,24,1999-10-19T03:00:00Z,51.0N  29.0W,1,10,3,0,14
Hurricane,Irene,24,1999-10-19T03:00:00Z,HIBERNIA OILFLD,35,0,0,0,35
Tropical Depression,Fourteen,1,1999-10-17T21:00:00Z,10.5N  55.3W,53,0,0,0,53
Tropical Depression,Fourteen,1,1999-10-17T21:00:00Z,TFFR 163N 615W,0,0,3,11,14
Tropical Depression,Fourteen,1,1999-10-17T21:00:00Z,11.0N  57.5W,3,29,0,0,32
Tropical Depression,Fourteen,1,1999-10-17T21:00:00Z,TAPA 171N 618W,0,0,1,11,12
Tropical Depression,Fourteen,1,1999-10-17T21:00:00Z,12.0N  60.0W,0,9,15,1,25
Tropical Depression,Fourteen,1,1999-10-17T21:00:00Z,TKPK 173N 627W,0,0,0,11,11
Tropical Depression,Fourteen,1,1999-10-17T21:00:00Z,TNCC 122N 690W,0,0,0,4,4
Tropical Depression,Fourteen,1,1999-10-17T21:00:00Z,TNCM 181N 631W,0,0,0,9,9
Tropical Depression,Fourteen,1,1999-10-17T21:00:00Z,SVMG 110N 640W,0,0,4,10,14
Tropical Depression,Fourteen,1,1999-10-17T21:00:00Z,TISX 177N 648W,0,0,0,10,10
Tropical Depression,Fourteen,1,1999-10-17T21:00:00Z,TTPP 106N 614W,0,2,14,2,18
Tropical Depression,Fourteen,1,1999-10-17T21:00:00Z,TIST 183N 650W,0,0,0,8,8
Tropical Depression,Fourteen,1,1999-10-17T21:00:00Z,TTPT 112N 608W,0,4,16,2,22
Tropical Depression,Fourteen,1,1999-10-17T21:00:00Z,TJPS 180N 666W,0,0,0,7,7
Tropical Depression,Fourteen,1,1999-10-17T21:00:00Z,TGPY 120N 618W,0,1,15,4,20
Tropical Depression,Fourteen,1,1999-10-17T21:00:00Z,TJSJ 184N 661W,0,0,0,6,6
Tropical Depression,Fourteen,1,1999-10-17T21:00:00Z,TBPB 131N 595W,0,7,15,2,24
Tropical Depression,Fourteen,1,1999-10-17T21:00:00Z,ST CROIX VI,0,0,0,10,10
Tropical Depression,Fourteen,1,1999-10-17T21:00:00Z,TVSV 131N 612W,0,1,16,4,21
Tropical Depression,Fourteen,1,1999-10-17T21:00:00Z,ST THOMAS VI,0,0,0,8,8
Tropical Depression,Fourteen,1,1999-10-17T21:00:00Z,TLPL 138N 610W,0,1,14,5,20
Tropical Depression,Fourteen,1,1999-10-17T21:00:00Z,SAN JUAN PR,0,0,0,6,6
Tropical Depression,Fourteen,1,1999-10-17T21:00:00Z,TFFF 146N 610W,0,0,11,7,18
Tropical Depression,Fourteen,1,1999-10-17T21:00:00Z,PONCE PR,0,0,0,7,7
Tropical Depression,Fourteen,1,1999-10-17T21:00:00Z,TDPR 153N 614W,0,0,7,9,16
Tropical Depression,Fourteen,2,1999-10-18T03:00:00Z,10.9N  56.5W,55,0,0,0,55
Tropical Depression,Fourteen,2,1999-10-18T03:00:00Z,TFFR 163N 615W,0,0,8,8,16
Tropical Depression,Fourteen,2,1999-10-18T03:00:00Z,11.7N  58.7W,3,32,0,0,35
Tropical Depression,Fourteen,2,1999-10-18T03:00:00Z,TAPA 171N 618W,0,0,4,9,13
Tropical Depression,Fourteen,2,1999-10-18T03:00:00Z,12.5N  60.5W,0,18,6,1,25
Tropical Depression,Fourteen,2,1999-10-18T03:00:00Z,TKPK 173N 627W,0,0,2,12,14
Tropical Depression,Fourteen,2,1999-10-18T03:00:00Z,TNCC 122N 690W,0,0,0,4,4
Tropical Depression,Fourteen,2,1999-10-18T03:00:00Z,TNCM 181N 631W,0,0,1,11,12
Tropical Depression,Fourteen,2,1999-10-18T03:00:00Z,SVMG 110N 640W,0,0,7,7,14
Tropical Depression,Fourteen,2,1999-10-18T03:00:00Z,TISX 177N 648W,0,0,0,13,13
Tropical Depression,Fourteen,2,1999-10-18T03:00:00Z,TTPP 106N 614W,0,8,9,2,19
Tropical Depression,Fourteen,2,1999-10-18T03:00:00Z,TIST 183N 650W,0,0,0,11,11
Tropical Depression,Fourteen,2,1999-10-18T03:00:00Z,TTPT 112N 608W,0,16,6,1,23
Tropical Depression,Fourteen,2,1999-10-18T03:00:00Z,TJPS 180N 666W,0,0,0,11,11
Tropical Depression,Fourteen,2,1999-10-18T03:00:00Z,TGPY 120N 618W,0,6,13,2,21
Tropical Depression,Fourteen,2,1999-10-18T03:00:00Z,MDSD 185N 697W,0,0,0,3,3
Tropical Depression,Fourteen,2,1999-10-18T03:00:00Z,TBPB 131N 595W,0,23,3,0,26
Tropical Depression,Fourteen,2,1999-10-18T03:00:00Z,TJSJ 184N 661W,0,0,0,10,10
Tropical Depression,Fourteen,2,1999-10-18T03:00:00Z,TVSV 131N 612W,0,9,12,2,23
Tropical Depression,Fourteen,2,1999-10-18T03:00:00Z,ST CROIX VI,0,0,0,13,13
Tropical Depression,Fourteen,2,1999-10-18T03:00:00Z,TLPL 138N 610W,0,8,12,2,22
Tropical Depression,Fourteen,2,1999-10-18T03:00:00Z,ST THOMAS VI,0,0,0,11,11
Tropical Depression,Fourteen,2,1999-10-18T03:00:00Z,TFFF 146N 610W,0,4,12,4,20
Tropical Depression,Fourteen,2,1999-10-18T03:00:00Z,SAN JUAN PR,0,0,0,10,10
Tropical Depression,Fourteen,2,1999-10-18T03:00:00Z,TDPR 153N 614W,0,1,12,5,18
Tropical Depression,Fourteen,2,1999-10-18T03:00:00Z,PONCE PR,0,0,0,11,11
Tropical Storm,Jose,3,1999-10-18T09:00:00Z,11.2N  56.3W,41,0,0,0,41
Tropical Storm,Jose,3,1999-10-18T09:00:00Z,TAPA 171N 618W,0,0,5,9,14
Tropical Storm,Jose,3,1999-10-18T09:00:00Z,11.9N  58.3W,13,14,1,0,28
Tropical Storm,Jose,3,1999-10-18T09:00:00Z,TKPK 173N 627W,0,0,3,11,14
Tropical Storm,Jose,3,1999-10-18T09:00:00Z,13.0N  60.5W,0,12,10,2,24
Tropical Storm,Jose,3,1999-10-18T09:00:00Z,TNCM 181N 631W,0,0,1,11,12
Tropical Storm,Jose,3,1999-10-18T09:00:00Z,TNCC 122N 690W,0,0,0,5,5
Tropical Storm,Jose,3,1999-10-18T09:00:00Z,TISX 177N 648W,0,0,1,12,13
Tropical Storm,Jose,3,1999-10-18T09:00:00Z,SVMG 110N 640W,0,0,6,8,14
Tropical Storm,Jose,3,1999-10-18T09:00:00Z,TIST 183N 650W,0,0,0,12,12
Tropical Storm,Jose,3,1999-10-18T09:00:00Z,TTPP 106N 614W,0,6,11,2,19
Tropical Storm,Jose,3,1999-10-18T09:00:00Z,TJPS 180N 666W,0,0,0,11,11
Tropical Storm,Jose,3,1999-10-18T09:00:00Z,TTPT 112N 608W,0,11,10,1,22
Tropical Storm,Jose,3,1999-10-18T09:00:00Z,MDSD 185N 697W,0,0,0,4,4
Tropical Storm,Jose,3,1999-10-18T09:00:00Z,TGPY 120N 618W,0,4,14,3,21
Tropical Storm,Jose,3,1999-10-18T09:00:00Z,MDCB 176N 714W,0,0,0,2,2
Tropical Storm,Jose,3,1999-10-18T09:00:00Z,TBPB 131N 595W,1,17,6,1,25
Tropical Storm,Jose,3,1999-10-18T09:00:00Z,TJSJ 184N 661W,0,0,0,11,11
Tropical Storm,Jose,3,1999-10-18T09:00:00Z,TVSV 131N 612W,0,7,13,2,22
Tropical Storm,Jose,3,1999-10-18T09:00:00Z,MDPP 198N 707W,0,0,0,2,2
Tropical Storm,Jose,3,1999-10-18T09:00:00Z,TLPL 138N 610W,0,6,13,3,22
Tropical Storm,Jose,3,1999-10-18T09:00:00Z,ST CROIX VI,0,0,1,12,13
Tropical Storm,Jose,3,1999-10-18T09:00:00Z,TFFF 146N 610W,0,4,13,3,20
Tropical Storm,Jose,3,1999-10-18T09:00:00Z,ST THOMAS VI,0,0,0,12,12
Tropical Storm,Jose,3,1999-10-18T09:00:00Z,TDPR 153N 614W,0,1,13,5,19
Tropical Storm,Jose,3,1999-10-18T09:00:00Z,SAN JUAN PR,0,0,0,11,11
Tropical Storm,Jose,3,1999-10-18T09:00:00Z,TFFR 163N 615W,0,0,9,7,16
Tropical Storm,Jose,3,1999-10-18T09:00:00Z,PONCE PR,0,0,0,11,11
Tropical Storm,Jose,4,1999-10-18T15:00:00Z,11.8N  57.5W,49,0,0,0,49
Tropical Storm,Jose,4,1999-10-18T15:00:00Z,TAPA 171N 618W,0,1,11,5,17
Tropical Storm,Jose,4,1999-10-18T15:00:00Z,12.6N  59.4W,22,10,0,0,32
Tropical Storm,Jose,4,1999-10-18T15:00:00Z,TKPK 173N 627W,0,0,9,8,17
Tropical Storm,Jose,4,1999-10-18T15:00:00Z,14.0N  61.5W,1,16,7,1,25
Tropical Storm,Jose,4,1999-10-18T15:00:00Z,TNCM 181N 631W,0,0,5,10,15
Tropical Storm,Jose,4,1999-10-18T15:00:00Z,TNCC 122N 690W,0,0,0,5,5
Tropical Storm,Jose,4,1999-10-18T15:00:00Z,TISX 177N 648W,0,0,3,13,16
Tropical Storm,Jose,4,1999-10-18T15:00:00Z,SVMG 110N 640W,0,1,7,4,12
Tropical Storm,Jose,4,1999-10-18T15:00:00Z,TIST 183N 650W,0,0,2,13,15
Tropical Storm,Jose,4,1999-10-18T15:00:00Z,TTPP 106N 614W,0,11,5,1,17
Tropical Storm,Jose,4,1999-10-18T15:00:00Z,TJPS 180N 666W,0,0,0,14,14
Tropical Storm,Jose,4,1999-10-18T15:00:00Z,TTPT 112N 608W,2,17,2,1,22
Tropical Storm,Jose,4,1999-10-18T15:00:00Z,MDSD 185N 697W,0,0,0,6,6
Tropical Storm,Jose,4,1999-10-18T15:00:00Z,TGPY 120N 618W,0,15,6,1,22
Tropical Storm,Jose,4,1999-10-18T15:00:00Z,MDCB 176N 714W,0,0,0,3,3
Tropical Storm,Jose,4,1999-10-18T15:00:00Z,TBPB 131N 595W,17,13,0,0,30
Tropical Storm,Jose,4,1999-10-18T15:00:00Z,TJSJ 184N 661W,0,0,1,13,14
Tropical Storm,Jose,4,1999-10-18T15:00:00Z,TVSV 131N 612W,2,19,4,1,26
Tropical Storm,Jose,4,1999-10-18T15:00:00Z,MDPP 198N 707W,0,0,0,2,2
Tropical Storm,Jose,4,1999-10-18T15:00:00Z,TLPL 138N 610W,2,19,5,0,26
Tropical Storm,Jose,4,1999-10-18T15:00:00Z,ST CROIX VI,0,0,3,13,16
Tropical Storm,Jose,4,1999-10-18T15:00:00Z,TFFF 146N 610W,1,16,7,0,24
Tropical Storm,Jose,4,1999-10-18T15:00:00Z,ST THOMAS VI,0,0,2,13,15
Tropical Storm,Jose,4,1999-10-18T15:00:00Z,TDPR 153N 614W,0,10,11,1,22
Tropical Storm,Jose,4,1999-10-18T15:00:00Z,SAN JUAN PR,0,0,1,13,14
Tropical Storm,Jose,4,1999-10-18T15:00:00Z,TFFR 163N 615W,0,4,12,3,19
Tropical Storm,Jose,4,1999-10-18T15:00:00Z,PONCE PR,0,0,0,14,14
Tropical Storm,Jose,5,1999-10-18T21:00:00Z,13.9N  58.8W,56,0,0,0,56
Tropical Storm,Jose,5,1999-10-18T21:00:00Z,TNCM 181N 631W,0,6,11,3,20
Tropical Storm,Jose,5,1999-10-18T21:00:00Z,14.9N  60.8W,23,10,0,0,33
Tropical Storm,Jose,5,1999-10-18T21:00:00Z,TISX 177N 648W,0,2,12,5,19
Tropical Storm,Jose,5,1999-10-18T21:00:00Z,16.0N  63.0W,0,16,7,1,24
Tropical Storm,Jose,5,1999-10-18T21:00:00Z,TIST 183N 650W,0,1,11,6,18
Tropical Storm,Jose,5,1999-10-18T21:00:00Z,TNCC 122N 690W,0,0,0,3,3
Tropical Storm,Jose,5,1999-10-18T21:00:00Z,TJPS 180N 666W,0,0,6,11,17
Tropical Storm,Jose,5,1999-10-18T21:00:00Z,SVMG 110N 640W,0,0,2,2,4
Tropical Storm,Jose,5,1999-10-18T21:00:00Z,MDSD 185N 697W,0,0,0,11,11
Tropical Storm,Jose,5,1999-10-18T21:00:00Z,TTPP 106N 614W,0,2,2,0,4
Tropical Storm,Jose,5,1999-10-18T21:00:00Z,MDCB 176N 714W,0,0,0,7,7
Tropical Storm,Jose,5,1999-10-18T21:00:00Z,TTPT 112N 608W,0,6,2,0,8
Tropical Storm,Jose,5,1999-10-18T21:00:00Z,MTPP 186N 724W,0,0,0,5,5
Tropical Storm,Jose,5,1999-10-18T21:00:00Z,TGPY 120N 618W,0,8,3,1,12
Tropical Storm,Jose,5,1999-10-18T21:00:00Z,MTCA 183N 738W,0,0,0,2,2
Tropical Storm,Jose,5,1999-10-18T21:00:00Z,TBPB 131N 595W,34,1,0,0,35
Tropical Storm,Jose,5,1999-10-18T21:00:00Z,TJSJ 184N 661W,0,0,8,9,17
Tropical Storm,Jose,5,1999-10-18T21:00:00Z,TVSV 131N 612W,5,16,0,1,22
Tropical Storm,Jose,5,1999-10-18T21:00:00Z,MDPP 198N 707W,0,0,0,8,8
Tropical Storm,Jose,5,1999-10-18T21:00:00Z,TLPL 138N 610W,13,14,0,1,28
Tropical Storm,Jose,5,1999-10-18T21:00:00Z,MBJT 215N 712W,0,0,0,5,5
Tropical Storm,Jose,5,1999-10-18T21:00:00Z,TFFF 146N 610W,18,12,1,0,31
Tropical Storm,Jose,5,1999-10-18T21:00:00Z,MYMM 224N 730W,0,0,0,2,2
Tropical Storm,Jose,5,1999-10-18T21:00:00Z,TDPR 153N 614W,10,18,0,1,29
Tropical Storm,Jose,5,1999-10-18T21:00:00Z,ST CROIX VI,0,2,12,5,19
Tropical Storm,Jose,5,1999-10-18T21:00:00Z,TFFR 163N 615W,4,20,1,1,26
Tropical Storm,Jose,5,1999-10-18T21:00:00Z,ST THOMAS VI,0,1,11,6,18
Tropical Storm,Jose,5,1999-10-18T21:00:00Z,TAPA 171N 618W,1,16,5,1,23
Tropical Storm,Jose,5,1999-10-18T21:00:00Z,SAN JUAN PR,0,0,8,9,17
Tropical Storm,Jose,5,1999-10-18T21:00:00Z,TKPK 173N 627W,0,12,8,2,22
Tropical Storm,Jose,5,1999-10-18T21:00:00Z,PONCE PR,0,0,6,11,17
Tropical Storm,Jose,6,1999-10-19T03:00:00Z,15.1N  60.2W,56,0,0,0,56
Tropical Storm,Jose,6,1999-10-19T03:00:00Z,TIST 183N 650W,0,8,9,4,21
Tropical Storm,Jose,6,1999-10-19T03:00:00Z,16.2N  62.2W,19,12,1,0,32
Tropical Storm,Jose,6,1999-10-19T03:00:00Z,TJPS 180N 666W,0,2,10,6,18
Tropical Storm,Jose,6,1999-10-19T03:00:00Z,17.3N  64.0W,1,18,3,2,24
Tropical Storm,Jose,6,1999-10-19T03:00:00Z,MDSD 185N 697W,0,0,1,12,13
Tropical Storm,Jose,6,1999-10-19T03:00:00Z,TNCC 122N 690W,0,0,0,2,2
Tropical Storm,Jose,6,1999-10-19T03:00:00Z,MDCB 176N 714W,0,0,0,8,8
Tropical Storm,Jose,6,1999-10-19T03:00:00Z,TTPT 112N 608W,0,1,0,1,2
Tropical Storm,Jose,6,1999-10-19T03:00:00Z,MTPP 186N 724W,0,0,0,7,7
Tropical Storm,Jose,6,1999-10-19T03:00:00Z,TGPY 120N 618W,0,3,2,0,5
Tropical Storm,Jose,6,1999-10-19T03:00:00Z,MTCA 183N 738W,0,0,0,3,3
Tropical Storm,Jose,6,1999-10-19T03:00:00Z,TBPB 131N 595W,41,0,0,0,41
Tropical Storm,Jose,6,1999-10-19T03:00:00Z,MUGM 200N 751W,0,0,0,2,2
Tropical Storm,Jose,6,1999-10-19T03:00:00Z,TVSV 131N 612W,8,7,0,1,16
Tropical Storm,Jose,6,1999-10-19T03:00:00Z,TJSJ 184N 661W,0,3,11,5,19
Tropical Storm,Jose,6,1999-10-19T03:00:00Z,TLPL 138N 610W,24,2,0,0,26
Tropical Storm,Jose,6,1999-10-19T03:00:00Z,MDPP 198N 707W,0,0,0,11,11
Tropical Storm,Jose,6,1999-10-19T03:00:00Z,TFFF 146N 610W,37,0,0,0,37
Tropical Storm,Jose,6,1999-10-19T03:00:00Z,MBJT 215N 712W,0,0,0,9,9
Tropical Storm,Jose,6,1999-10-19T03:00:00Z,TDPR 153N 614W,35,2,0,0,37
Tropical Storm,Jose,6,1999-10-19T03:00:00Z,MYMM 224N 730W,0,0,0,4,4
Tropical Storm,Jose,6,1999-10-19T03:00:00Z,TFFR 163N 615W,29,6,0,0,35
Tropical Storm,Jose,6,1999-10-19T03:00:00Z,ST CROIX VI,0,12,7,2,21
Tropical Storm,Jose,6,1999-10-19T03:00:00Z,TAPA 171N 618W,16,13,0,0,29
Tropical Storm,Jose,6,1999-10-19T03:00:00Z,ST THOMAS VI,0,8,9,4,21
Tropical Storm,Jose,6,1999-10-19T03:00:00Z,TKPK 173N 627W,6,19,1,1,27
Tropical Storm,Jose,6,1999-10-19T03:00:00Z,SAN JUAN PR,0,3,11,5,19
Tropical Storm,Jose,6,1999-10-19T03:00:00Z,TNCM 181N 631W,1,18,3,1,23
Tropical Storm,Jose,6,1999-10-19T03:00:00Z,PONCE PR,0,2,10,6,18
Tropical Storm,Jose,6,1999-10-19T03:00:00Z,TISX 177N 648W,0,12,7,2,21
Tropical Storm,Jose,7,1999-10-19T09:00:00Z,16.0N  61.0W,51,0,0,0,51
Tropical Storm,Jose,7,1999-10-19T09:00:00Z,MDSD 185N 697W,0,0,4,10,14
Tropical Storm,Jose,7,1999-10-19T09:00:00Z,17.2N  63.0W,21,11,0,0,32
Tropical Storm,Jose,7,1999-10-19T09:00:00Z,MDCB 176N 714W,0,0,1,8,9
Tropical Storm,Jose,7,1999-10-19T09:00:00Z,18.5N  65.0W,1,17,5,1,24
Tropical Storm,Jose,7,1999-10-19T09:00:00Z,MTPP 186N 724W,0,0,0,8,8
Tropical Storm,Jose,7,1999-10-19T09:00:00Z,TGPY 120N 618W,0,1,1,0,2
Tropical Storm,Jose,7,1999-10-19T09:00:00Z,MTCA 183N 738W,0,0,0,4,4
Tropical Storm,Jose,7,1999-10-19T09:00:00Z,TBPB 131N 595W,11,1,0,0,12
Tropical Storm,Jose,7,1999-10-19T09:00:00Z,MUGM 200N 751W,0,0,0,3,3
Tropical Storm,Jose,7,1999-10-19T09:00:00Z,TVSV 131N 612W,2,5,1,0,8
Tropical Storm,Jose,7,1999-10-19T09:00:00Z,TJSJ 184N 661W,0,10,9,2,21
Tropical Storm,Jose,7,1999-10-19T09:00:00Z,TLPL 138N 610W,15,3,0,0,18
Tropical Storm,Jose,7,1999-10-19T09:00:00Z,MDPP 198N 707W,0,0,2,11,13
Tropical Storm,Jose,7,1999-10-19T09:00:00Z,TFFF 146N 610W,34,0,0,0,34
Tropical Storm,Jose,7,1999-10-19T09:00:00Z,MBJT 215N 712W,0,0,1,11,12
Tropical Storm,Jose,7,1999-10-19T09:00:00Z,TDPR 153N 614W,40,0,0,0,40
Tropical Storm,Jose,7,1999-10-19T09:00:00Z,MYMM 224N 730W,0,0,0,8,8
Tropical Storm,Jose,7,1999-10-19T09:00:00Z,TFFR 163N 615W,46,0,0,0,46
Tropical Storm,Jose,7,1999-10-19T09:00:00Z,MYSM 241N 745W,0,0,0,4,4
Tropical Storm,Jose,7,1999-10-19T09:00:00Z,TAPA 171N 618W,38,2,0,0,40
Tropical Storm,Jose,7,1999-10-19T09:00:00Z,MYEG 235N 758W,0,0,0,2,2
Tropical Storm,Jose,7,1999-10-19T09:00:00Z,TKPK 173N 627W,25,9,0,0,34
Tropical Storm,Jose,7,1999-10-19T09:00:00Z,ST CROIX VI,1,19,3,1,24
Tropical Storm,Jose,7,1999-10-19T09:00:00Z,TNCM 181N 631W,12,17,0,1,30
Tropical Storm,Jose,7,1999-10-19T09:00:00Z,ST THOMAS VI,1,17,5,1,24
Tropical Storm,Jose,7,1999-10-19T09:00:00Z,TISX 177N 648W,1,19,3,1,24
Tropical Storm,Jose,7,1999-10-19T09:00:00Z,SAN JUAN PR,0,10,9,2,21
Tropical Storm,Jose,7,1999-10-19T09:00:00Z,TIST 183N 650W,1,17,5,1,24
Tropical Storm,Jose,7,1999-10-19T09:00:00Z,PONCE PR,0,6,11,3,20
Tropical Storm,Jose,7,1999-10-19T09:00:00Z,TJPS 180N 666W,0,6,11,3,20
Hurricane,Jose,8,1999-10-19T15:00:00Z,16.2N  61.8W,56,0,0,0,56
Hurricane,Jose,8,1999-10-19T15:00:00Z,MDCB 176N 714W,0,0,2,9,11
Hurricane,Jose,8,1999-10-19T15:00:00Z,17.5N  64.0W,16,17,0,0,33
Hurricane,Jose,8,1999-10-19T15:00:00Z,MTPP 186N 724W,0,0,1,10,11
Hurricane,Jose,8,1999-10-19T15:00:00Z,18.5N  66.0W,0,18,5,1,24
Hurricane,Jose,8,1999-10-19T15:00:00Z,MTCA 183N 738W,0,0,0,7,7
Hurricane,Jose,8,1999-10-19T15:00:00Z,TBPB 131N 595W,33,0,0,0,33
Hurricane,Jose,8,1999-10-19T15:00:00Z,MKJP 179N 768W,0,0,0,2,2
Hurricane,Jose,8,1999-10-19T15:00:00Z,TVSV 131N 612W,5,3,0,0,8
Hurricane,Jose,8,1999-10-19T15:00:00Z,MUGM 200N 751W,0,0,0,6,6
Hurricane,Jose,8,1999-10-19T15:00:00Z,TLPL 138N 610W,28,0,0,0,28
Hurricane,Jose,8,1999-10-19T15:00:00Z,TJSJ 184N 661W,0,18,4,1,23
Hurricane,Jose,8,1999-10-19T15:00:00Z,TFFF 146N 610W,53,0,0,0,53
Hurricane,Jose,8,1999-10-19T15:00:00Z,MDPP 198N 707W,0,0,4,11,15
Hurricane,Jose,8,1999-10-19T15:00:00Z,TDPR 153N 614W,57,0,0,0,57
Hurricane,Jose,8,1999-10-19T15:00:00Z,MBJT 215N 712W,0,0,1,13,14
Hurricane,Jose,8,1999-10-19T15:00:00Z,TFFR 163N 615W,59,0,0,0,59
Hurricane,Jose,8,1999-10-19T15:00:00Z,MYMM 224N 730W,0,0,0,11,11
Hurricane,Jose,8,1999-10-19T15:00:00Z,TAPA 171N 618W,46,0,0,1,47
Hurricane,Jose,8,1999-10-19T15:00:00Z,MYSM 241N 745W,0,0,0,6,6
Hurricane,Jose,8,1999-10-19T15:00:00Z,TKPK 173N 627W,38,3,0,0,41
Hurricane,Jose,8,1999-10-19T15:00:00Z,MYEG 235N 758W,0,0,0,4,4
Hurricane,Jose,8,1999-10-19T15:00:00Z,TNCM 181N 631W,22,12,0,0,34
Hurricane,Jose,8,1999-10-19T15:00:00Z,ST CROIX VI,5,23,0,0,28
Hurricane,Jose,8,1999-10-19T15:00:00Z,TISX 177N 648W,5,23,0,0,28
Hurricane,Jose,8,1999-10-19T15:00:00Z,ST THOMAS VI,3,23,1,0,27
Hurricane,Jose,8,1999-10-19T15:00:00Z,TIST 183N 650W,3,23,1,0,27
Hurricane,Jose,8,1999-10-19T15:00:00Z,SAN JUAN PR,0,18,4,1,23
Hurricane,Jose,8,1999-10-19T15:00:00Z,TJPS 180N 666W,0,13,7,2,22
Hurricane,Jose,8,1999-10-19T15:00:00Z,PONCE PR,0,13,7,2,22
Hurricane,Jose,8,1999-10-19T15:00:00Z,MDSD 185N 697W,0,0,8,8,16
Hurricane,Jose,9,1999-10-19T21:00:00Z,17.2N  63.0W,50,0,0,0,50
Hurricane,Jose,9,1999-10-19T21:00:00Z,MDCB 176N 714W,0,0,3,7,10
Hurricane,Jose,9,1999-10-19T21:00:00Z,18.0N  65.0W,19,11,1,0,31
Hurricane,Jose,9,1999-10-19T21:00:00Z,MTPP 186N 724W,0,0,1,8,9
Hurricane,Jose,9,1999-10-19T21:00:00Z,19.3N  66.5W,1,20,2,1,24
Hurricane,Jose,9,1999-10-19T21:00:00Z,MTCA 183N 738W,0,0,0,6,6
Hurricane,Jose,9,1999-10-19T21:00:00Z,TBPB 131N 595W,4,0,0,0,4
Hurricane,Jose,9,1999-10-19T21:00:00Z,MUGM 200N 751W,0,0,0,5,5
Hurricane,Jose,9,1999-10-19T21:00:00Z,TLPL 138N 610W,2,0,0,0,2
Hurricane,Jose,9,1999-10-19T21:00:00Z,TJSJ 184N 661W,4,20,1,1,26
Hurricane,Jose,9,1999-10-19T21:00:00Z,TFFF 146N 610W,39,0,0,0,39
Hurricane,Jose,9,1999-10-19T21:00:00Z,MDPP 198N 707W,0,0,6,9,15
Hurricane,Jose,9,1999-10-19T21:00:00Z,TDPR 153N 614W,61,0,0,0,61
Hurricane,Jose,9,1999-10-19T21:00:00Z,MBJT 215N 712W,0,0,3,12,15
Hurricane,Jose,9,1999-10-19T21:00:00Z,TFFR 163N 615W,75,0,0,0,75
Hurricane,Jose,9,1999-10-19T21:00:00Z,MYMM 224N 730W,0,0,0,11,11
Hurricane,Jose,9,1999-10-19T21:00:00Z,TAPA 171N 618W,61,0,0,0,61
Hurricane,Jose,9,1999-10-19T21:00:00Z,MYSM 241N 745W,0,0,0,7,7
Hurricane,Jose,9,1999-10-19T21:00:00Z,TKPK 173N 627W,53,0,0,0,53
Hurricane,Jose,9,1999-10-19T21:00:00Z,MYEG 235N 758W,0,0,0,4,4
Hurricane,Jose,9,1999-10-19T21:00:00Z,TNCM 181N 631W,42,0,0,0,42
Hurricane,Jose,9,1999-10-19T21:00:00Z,ST CROIX VI,23,9,0,0,32
Hurricane,Jose,9,1999-10-19T21:00:00Z,TISX 177N 648W,23,9,0,0,32
Hurricane,Jose,9,1999-10-19T21:00:00Z,ST THOMAS VI,18,12,1,0,31
Hurricane,Jose,9,1999-10-19T21:00:00Z,TIST 183N 650W,18,12,1,0,31
Hurricane,Jose,9,1999-10-19T21:00:00Z,SAN JUAN PR,4,20,1,1,26
Hurricane,Jose,9,1999-10-19T21:00:00Z,TJPS 180N 666W,2,19,2,1,24
Hurricane,Jose,9,1999-10-19T21:00:00Z,PONCE PR,2,19,2,1,24
Hurricane,Jose,9,1999-10-19T21:00:00Z,MDSD 185N 697W,0,2,8,6,16
Hurricane,Jose,10,1999-10-20T03:00:00Z,17.8N  63.5W,51,0,0,0,51
Hurricane,Jose,10,1999-10-20T03:00:00Z,MTPP 186N 724W,0,0,1,6,7
Hurricane,Jose,10,1999-10-20T03:00:00Z,18.8N  65.5W,23,9,0,0,32
Hurricane,Jose,10,1999-10-20T03:00:00Z,MTCA 183N 738W,0,0,0,3,3
Hurricane,Jose,10,1999-10-20T03:00:00Z,20.3N  67.0W,2,18,3,1,24
Hurricane,Jose,10,1999-10-20T03:00:00Z,MUGM 200N 751W,0,0,0,3,3
Hurricane,Jose,10,1999-10-20T03:00:00Z,TFFF 146N 610W,6,1,0,0,7
Hurricane,Jose,10,1999-10-20T03:00:00Z,TJSJ 184N 661W,12,15,1,0,28
Hurricane,Jose,10,1999-10-20T03:00:00Z,TDPR 153N 614W,38,0,0,0,38
Hurricane,Jose,10,1999-10-20T03:00:00Z,MDPP 198N 707W,0,1,7,6,14
Hurricane,Jose,10,1999-10-20T03:00:00Z,TFFR 163N 615W,78,0,0,0,78
Hurricane,Jose,10,1999-10-20T03:00:00Z,MBJT 215N 712W,0,0,6,9,15
Hurricane,Jose,10,1999-10-20T03:00:00Z,TAPA 171N 618W,81,0,0,0,81
Hurricane,Jose,10,1999-10-20T03:00:00Z,MYMM 224N 730W,0,0,1,10,11
Hurricane,Jose,10,1999-10-20T03:00:00Z,TKPK 173N 627W,63,0,0,0,63
Hurricane,Jose,10,1999-10-20T03:00:00Z,MYSM 241N 745W,0,0,0,7,7
Hurricane,Jose,10,1999-10-20T03:00:00Z,TNCM 181N 631W,52,0,0,0,52
Hurricane,Jose,10,1999-10-20T03:00:00Z,MYEG 235N 758W,0,0,0,4,4
Hurricane,Jose,10,1999-10-20T03:00:00Z,TISX 177N 648W,32,3,0,0,35
Hurricane,Jose,10,1999-10-20T03:00:00Z,ST CROIX VI,32,3,0,0,35
Hurricane,Jose,10,1999-10-20T03:00:00Z,TIST 183N 650W,32,3,1,0,36
Hurricane,Jose,10,1999-10-20T03:00:00Z,ST THOMAS VI,32,3,1,0,36
Hurricane,Jose,10,1999-10-20T03:00:00Z,TJPS 180N 666W,5,17,1,1,24
Hurricane,Jose,10,1999-10-20T03:00:00Z,SAN JUAN PR,12,15,1,0,28
Hurricane,Jose,10,1999-10-20T03:00:00Z,MDSD 185N 697W,0,3,8,3,14
Hurricane,Jose,10,1999-10-20T03:00:00Z,PONCE PR,5,17,1,1,24
Hurricane,Jose,10,1999-10-20T03:00:00Z,MDCB 176N 714W,0,0,2,5,7
Hurricane,Jose,11,1999-10-20T09:00:00Z,18.8N  63.8W,57,0,0,0,57
Hurricane,Jose,11,1999-10-20T09:00:00Z,MTPP 186N 724W,0,0,2,3,5
Hurricane,Jose,11,1999-10-20T09:00:00Z,20.0N  65.3W,32,3,0,0,35
Hurricane,Jose,11,1999-10-20T09:00:00Z,MTCA 183N 738W,0,0,0,2,2
Hurricane,Jose,11,1999-10-20T09:00:00Z,21.5N  66.5W,6,15,2,1,24
Hurricane,Jose,11,1999-10-20T09:00:00Z,MUGM 200N 751W,0,0,0,2,2
Hurricane,Jose,11,1999-10-20T09:00:00Z,TFFF 146N 610W,2,0,0,0,2
Hurricane,Jose,11,1999-10-20T09:00:00Z,TJSJ 184N 661W,14,9,0,1,24
Hurricane,Jose,11,1999-10-20T09:00:00Z,TDPR 153N 614W,36,0,0,0,36
Hurricane,Jose,11,1999-10-20T09:00:00Z,MDPP 198N 707W,0,2,6,3,11
Hurricane,Jose,11,1999-10-20T09:00:00Z,TFFR 163N 615W,99,0,0,0,99
Hurricane,Jose,11,1999-10-20T09:00:00Z,MBJT 215N 712W,0,1,6,6,13
Hurricane,Jose,11,1999-10-20T09:00:00Z,TAPA 171N 618W,85,0,0,0,85
Hurricane,Jose,11,1999-10-20T09:00:00Z,MYMM 224N 730W,0,0,2,7,9
Hurricane,Jose,11,1999-10-20T09:00:00Z,TKPK 173N 627W,64,0,0,0,64
Hurricane,Jose,11,1999-10-20T09:00:00Z,MYSM 241N 745W,0,0,0,6,6
Hurricane,Jose,11,1999-10-20T09:00:00Z,TNCM 181N 631W,69,0,0,0,69
Hurricane,Jose,11,1999-10-20T09:00:00Z,MYEG 235N 758W,0,0,0,3,3
Hurricane,Jose,11,1999-10-20T09:00:00Z,TISX 177N 648W,29,0,0,1,30
Hurricane,Jose,11,1999-10-20T09:00:00Z,BERMUDA,0,0,0,2,2
Hurricane,Jose,11,1999-10-20T09:00:00Z,TIST 183N 650W,33,1,0,0,34
Hurricane,Jose,11,1999-10-20T09:00:00Z,ST CROIX VI,29,0,0,1,30
Hurricane,Jose,11,1999-10-20T09:00:00Z,TJPS 180N 666W,5,12,1,1,19
Hurricane,Jose,11,1999-10-20T09:00:00Z,ST THOMAS VI,33,1,0,0,34
Hurricane,Jose,11,1999-10-20T09:00:00Z,MDSD 185N 697W,0,3,6,2,11
Hurricane,Jose,11,1999-10-20T09:00:00Z,SAN JUAN PR,14,9,0,1,24
Hurricane,Jose,11,1999-10-20T09:00:00Z,MDCB 176N 714W,0,0,3,2,5
Hurricane,Jose,11,1999-10-20T09:00:00Z,PONCE PR,5,12,1,1,19
Hurricane,Jose,12,1999-10-20T15:00:00Z,19.5N  64.5W,55,0,0,0,55
Hurricane,Jose,12,1999-10-20T15:00:00Z,MDSD 185N 697W,0,3,4,1,8
Hurricane,Jose,12,1999-10-20T15:00:00Z,21.0N  66.0W,24,9,1,0,34
Hurricane,Jose,12,1999-10-20T15:00:00Z,TJSJ 184N 661W,20,3,0,0,23
Hurricane,Jose,12,1999-10-20T15:00:00Z,23.5N  67.0W,0,18,5,1,24
Hurricane,Jose,12,1999-10-20T15:00:00Z,MDPP 198N 707W,0,2,5,1,8
Hurricane,Jose,12,1999-10-20T15:00:00Z,TDPR 153N 614W,13,0,0,0,13
Hurricane,Jose,12,1999-10-20T15:00:00Z,MBJT 215N 712W,0,1,7,2,10
Hurricane,Jose,12,1999-10-20T15:00:00Z,TFFR 163N 615W,99,0,0,0,99
Hurricane,Jose,12,1999-10-20T15:00:00Z,MYMM 224N 730W,0,0,2,3,5
Hurricane,Jose,12,1999-10-20T15:00:00Z,TAPA 171N 618W,99,0,0,0,99
Hurricane,Jose,12,1999-10-20T15:00:00Z,MYSM 241N 745W,0,0,0,2,2
Hurricane,Jose,12,1999-10-20T15:00:00Z,TKPK 173N 627W,81,0,0,0,81
Hurricane,Jose,12,1999-10-20T15:00:00Z,BERMUDA,0,0,0,10,10
Hurricane,Jose,12,1999-10-20T15:00:00Z,TNCM 181N 631W,82,0,0,0,82
Hurricane,Jose,12,1999-10-20T15:00:00Z,ST CROIX VI,36,0,0,0,36
Hurricane,Jose,12,1999-10-20T15:00:00Z,TISX 177N 648W,36,0,0,0,36
Hurricane,Jose,12,1999-10-20T15:00:00Z,ST THOMAS VI,43,0,0,0,43
Hurricane,Jose,12,1999-10-20T15:00:00Z,TIST 183N 650W,43,0,0,0,43
Hurricane,Jose,12,1999-10-20T15:00:00Z,SAN JUAN PR,20,3,0,0,23
Hurricane,Jose,12,1999-10-20T15:00:00Z,TJPS 180N 666W,6,8,1,0,15
Hurricane,Jose,12,1999-10-20T15:00:00Z,PONCE PR,6,8,1,0,15
Hurricane,Jose,13,1999-10-20T21:00:00Z,19.5N  65.2W,52,0,0,0,52
Hurricane,Jose,13,1999-10-20T21:00:00Z,TJSJ 184N 661W,32,0,0,0,32
Hurricane,Jose,13,1999-10-20T21:00:00Z,21.5N  66.5W,15,17,0,1,33
Hurricane,Jose,13,1999-10-20T21:00:00Z,MDPP 198N 707W,0,3,4,1,8
Hurricane,Jose,13,1999-10-20T21:00:00Z,23.5N  67.0W,0,20,3,1,24
Hurricane,Jose,13,1999-10-20T21:00:00Z,MBJT 215N 712W,0,3,5,2,10
Hurricane,Jose,13,1999-10-20T21:00:00Z,TFFR 163N 615W,99,0,0,0,99
Hurricane,Jose,13,1999-10-20T21:00:00Z,MYMM 224N 730W,0,0,2,2,4
Hurricane,Jose,13,1999-10-20T21:00:00Z,TAPA 171N 618W,99,0,0,0,99
Hurricane,Jose,13,1999-10-20T21:00:00Z,MYSM 241N 745W,0,0,0,2,2
Hurricane,Jose,13,1999-10-20T21:00:00Z,TKPK 173N 627W,99,0,0,0,99
Hurricane,Jose,13,1999-10-20T21:00:00Z,BERMUDA,0,0,0,14,14
Hurricane,Jose,13,1999-10-20T21:00:00Z,TNCM 181N 631W,99,0,0,0,99
Hurricane,Jose,13,1999-10-20T21:00:00Z,ST CROIX VI,45,0,0,0,45
Hurricane,Jose,13,1999-10-20T21:00:00Z,TISX 177N 648W,45,0,0,0,45
Hurricane,Jose,13,1999-10-20T21:00:00Z,ST THOMAS VI,51,0,0,0,51
Hurricane,Jose,13,1999-10-20T21:00:00Z,TIST 183N 650W,51,0,0,0,51
Hurricane,Jose,13,1999-10-20T21:00:00Z,SAN JUAN PR,32,0,0,0,32
Hurricane,Jose,13,1999-10-20T21:00:00Z,TJPS 180N 666W,17,3,0,0,20
Hurricane,Jose,13,1999-10-20T21:00:00Z,PONCE PR,17,3,0,0,20
Hurricane,Jose,13,1999-10-20T21:00:00Z,MDSD 185N 697W,0,3,3,1,7
Hurricane,Jose,14,1999-10-21T03:00:00Z,19.7N  65.5W,56,0,0,0,56
Hurricane,Jose,14,1999-10-21T03:00:00Z,TJSJ 184N 661W,36,0,1,0,37
Hurricane,Jose,14,1999-10-21T03:00:00Z,21.6N  66.7W,25,8,1,0,34
Hurricane,Jose,14,1999-10-21T03:00:00Z,MDPP 198N 707W,0,3,4,0,7
Hurricane,Jose,14,1999-10-21T03:00:00Z,25.0N  67.0W,0,11,13,2,26
Hurricane,Jose,14,1999-10-21T03:00:00Z,MBJT 215N 712W,0,4,5,1,10
Hurricane,Jose,14,1999-10-21T03:00:00Z,TAPA 171N 618W,10,0,0,0,10
Hurricane,Jose,14,1999-10-21T03:00:00Z,MYMM 224N 730W,0,0,2,1,3
Hurricane,Jose,14,1999-10-21T03:00:00Z,TKPK 173N 627W,99,0,0,0,99
Hurricane,Jose,14,1999-10-21T03:00:00Z,BERMUDA,0,0,0,22,22
Hurricane,Jose,14,1999-10-21T03:00:00Z,TNCM 181N 631W,99,0,0,0,99
Hurricane,Jose,14,1999-10-21T03:00:00Z,ST CROIX VI,52,0,0,0,52
Hurricane,Jose,14,1999-10-21T03:00:00Z,TISX 177N 648W,52,0,0,0,52
Hurricane,Jose,14,1999-10-21T03:00:00Z,ST THOMAS VI,60,0,0,0,60
Hurricane,Jose,14,1999-10-21T03:00:00Z,TIST 183N 650W,60,0,0,0,60
Hurricane,Jose,14,1999-10-21T03:00:00Z,SAN JUAN PR,36,0,1,0,37
Hurricane,Jose,14,1999-10-21T03:00:00Z,TJPS 180N 666W,18,2,0,0,20
Hurricane,Jose,14,1999-10-21T03:00:00Z,PONCE PR,18,2,0,0,20
Hurricane,Jose,14,1999-10-21T03:00:00Z,MDSD 185N 697W,0,4,2,0,6
Hurricane,Jose,15,1999-10-21T09:00:00Z,21.4N  67.2W,53,0,0,0,53
Hurricane,Jose,15,1999-10-21T09:00:00Z,NANTUCKET MA,0,0,0,3,3
Hurricane,Jose,15,1999-10-21T09:00:00Z,23.8N  67.5W,8,33,4,0,45
Hurricane,Jose,15,1999-10-21T09:00:00Z,HYANNIS MA,0,0,0,3,3
Hurricane,Jose,15,1999-10-21T09:00:00Z,28.0N  67.0W,0,1,34,5,40
Hurricane,Jose,15,1999-10-21T09:00:00Z,BOSTON MA,0,0,0,2,2
Hurricane,Jose,15,1999-10-21T09:00:00Z,TNCM 181N 631W,99,0,0,0,99
Hurricane,Jose,15,1999-10-21T09:00:00Z,PORTLAND ME,0,0,0,2,2
Hurricane,Jose,15,1999-10-21T09:00:00Z,TISX 177N 648W,99,0,0,0,99
Hurricane,Jose,15,1999-10-21T09:00:00Z,BAR HARBOR ME,0,0,0,5,5
Hurricane,Jose,15,1999-10-21T09:00:00Z,TIST 183N 650W,99,0,0,0,99
Hurricane,Jose,15,1999-10-21T09:00:00Z,EASTPORT ME,0,0,0,6,6
Hurricane,Jose,15,1999-10-21T09:00:00Z,TJPS 180N 666W,15,0,0,0,15
Hurricane,Jose,15,1999-10-21T09:00:00Z,ST JOHN NB,0,0,0,7,7
Hurricane,Jose,15,1999-10-21T09:00:00Z,TJSJ 184N 661W,54,0,0,0,54
Hurricane,Jose,15,1999-10-21T09:00:00Z,MONCTON NB,0,0,0,6,6
Hurricane,Jose,15,1999-10-21T09:00:00Z,MBJT 215N 712W,0,2,0,0,2
Hurricane,Jose,15,1999-10-21T09:00:00Z,YARMOUTH NS,0,0,0,11,11
Hurricane,Jose,15,1999-10-21T09:00:00Z,BERMUDA,0,0,1,31,32
Hurricane,Jose,15,1999-10-21T09:00:00Z,HALIFAX NS,0,0,0,11,11
Hurricane,Jose,15,1999-10-21T09:00:00Z,ST CROIX VI,99,0,0,0,99
Hurricane,Jose,15,1999-10-21T09:00:00Z,SABLE ISLAND NS,0,0,0,8,8
Hurricane,Jose,15,1999-10-21T09:00:00Z,ST THOMAS VI,99,0,0,0,99
Hurricane,Jose,15,1999-10-21T09:00:00Z,SYDNEY NS,0,0,0,3,3
Hurricane,Jose,15,1999-10-21T09:00:00Z,SAN JUAN PR,54,0,0,0,54
Hurricane,Jose,15,1999-10-21T09:00:00Z,EDDY POINT NS,0,0,0,6,6
Hurricane,Jose,15,1999-10-21T09:00:00Z,PONCE PR,15,0,0,0,15
Tropical Storm,Jose,16,1999-10-21T15:00:00Z,20.6N  67.2W,47,2,0,0,49
Tropical Storm,Jose,16,1999-10-21T15:00:00Z,SAN JUAN PR,99,0,0,0,99
Tropical Storm,Jose,16,1999-10-21T15:00:00Z,24.0N  67.5W,1,39,5,0,45
Tropical Storm,Jose,16,1999-10-21T15:00:00Z,PONCE PR,37,0,0,0,37
Tropical Storm,Jose,16,1999-10-21T15:00:00Z,29.0N  66.5W,0,0,28,6,34
Tropical Storm,Jose,16,1999-10-21T15:00:00Z,NANTUCKET MA,0,0,0,2,2
Tropical Storm,Jose,16,1999-10-21T15:00:00Z,TNCM 181N 631W,3,0,0,0,3
Tropical Storm,Jose,16,1999-10-21T15:00:00Z,HYANNIS MA,0,0,0,2,2
Tropical Storm,Jose,16,1999-10-21T15:00:00Z,TISX 177N 648W,99,0,0,0,99
Tropical Storm,Jose,16,1999-10-21T15:00:00Z,BAR HARBOR ME,0,0,0,2,2
Tropical Storm,Jose,16,1999-10-21T15:00:00Z,TIST 183N 650W,99,0,0,0,99
Tropical Storm,Jose,16,1999-10-21T15:00:00Z,EASTPORT ME,0,0,0,3,3
Tropical Storm,Jose,16,1999-10-21T15:00:00Z,TJPS 180N 666W,37,0,0,0,37
Tropical Storm,Jose,16,1999-10-21T15:00:00Z,ST JOHN NB,0,0,0,3,3
Tropical Storm,Jose,16,1999-10-21T15:00:00Z,MDSD 185N 697W,3,1,0,0,4
Tropical Storm,Jose,16,1999-10-21T15:00:00Z,MONCTON NB,0,0,0,3,3
Tropical Storm,Jose,16,1999-10-21T15:00:00Z,TJSJ 184N 661W,99,0,0,0,99
Tropical Storm,Jose,16,1999-10-21T15:00:00Z,YARMOUTH NS,0,0,0,5,5
Tropical Storm,Jose,16,1999-10-21T15:00:00Z,MDPP 198N 707W,1,2,0,0,3
Tropical Storm,Jose,16,1999-10-21T15:00:00Z,HALIFAX NS,0,0,0,6,6
Tropical Storm,Jose,16,1999-10-21T15:00:00Z,MBJT 215N 712W,0,3,1,0,4
Tropical Storm,Jose,16,1999-10-21T15:00:00Z,SABLE ISLAND NS,0,0,0,8,8
Tropical Storm,Jose,16,1999-10-21T15:00:00Z,BERMUDA,0,0,3,24,27
Tropical Storm,Jose,16,1999-10-21T15:00:00Z,SYDNEY NS,0,0,0,3,3
Tropical Storm,Jose,16,1999-10-21T15:00:00Z,ST CROIX VI,99,0,0,0,99
Tropical Storm,Jose,16,1999-10-21T15:00:00Z,EDDY POINT NS,0,0,0,5,5
Tropical Storm,Jose,16,1999-10-21T15:00:00Z,ST THOMAS VI,99,0,0,0,99
Tropical Storm,Jose,16,1999-10-21T15:00:00Z,PTX BASQUES NFLD,0,0,0,2,2
Tropical Storm,Jose,17,1999-10-21T21:00:00Z,22.7N  67.1W,46,4,0,0,50
Tropical Storm,Jose,17,1999-10-21T21:00:00Z,EASTPORT ME,0,0,0,2,2
Tropical Storm,Jose,17,1999-10-21T21:00:00Z,26.0N  66.9W,1,33,6,0,40
Tropical Storm,Jose,17,1999-10-21T21:00:00Z,ST JOHN NB,0,0,0,3,3
Tropical Storm,Jose,17,1999-10-21T21:00:00Z,30.0N  65.0W,0,0,23,10,33
Tropical Storm,Jose,17,1999-10-21T21:00:00Z,MONCTON NB,0,0,0,4,4
Tropical Storm,Jose,17,1999-10-21T21:00:00Z,TISX 177N 648W,6,0,0,0,6
Tropical Storm,Jose,17,1999-10-21T21:00:00Z,YARMOUTH NS,0,0,0,4,4
Tropical Storm,Jose,17,1999-10-21T21:00:00Z,TIST 183N 650W,99,0,0,0,99
Tropical Storm,Jose,17,1999-10-21T21:00:00Z,HALIFAX NS,0,0,0,8,8
Tropical Storm,Jose,17,1999-10-21T21:00:00Z,TJPS 180N 666W,18,0,0,0,18
Tropical Storm,Jose,17,1999-10-21T21:00:00Z,SABLE ISLAND NS,0,0,0,15,15
Tropical Storm,Jose,17,1999-10-21T21:00:00Z,TJSJ 184N 661W,99,0,0,0,99
Tropical Storm,Jose,17,1999-10-21T21:00:00Z,SYDNEY NS,0,0,0,10,10
Tropical Storm,Jose,17,1999-10-21T21:00:00Z,BERMUDA,0,0,6,23,29
Tropical Storm,Jose,17,1999-10-21T21:00:00Z,EDDY POINT NS,0,0,0,11,11
Tropical Storm,Jose,17,1999-10-21T21:00:00Z,ST CROIX VI,6,0,0,0,6
Tropical Storm,Jose,17,1999-10-21T21:00:00Z,PTX BASQUES NFLD,0,0,0,7,7
Tropical Storm,Jose,17,1999-10-21T21:00:00Z,ST THOMAS VI,99,0,0,0,99
Tropical Storm,Jose,17,1999-10-21T21:00:00Z,BURGEO NFLD,0,0,0,7,7
Tropical Storm,Jose,17,1999-10-21T21:00:00Z,SAN JUAN PR,99,0,0,0,99
Tropical Storm,Jose,17,1999-10-21T21:00:00Z,ILE ST PIERRE,0,0,0,8,8
Tropical Storm,Jose,17,1999-10-21T21:00:00Z,PONCE PR,18,0,0,0,18
Tropical Storm,Jose,17,1999-10-21T21:00:00Z,CAPE RACE NFLD,0,0,0,4,4
Tropical Storm,Jose,18,1999-10-22T03:00:00Z,23.5N  67.0W,34,8,0,0,42
Tropical Storm,Jose,18,1999-10-22T03:00:00Z,MONCTON NB,0,0,0,4,4
Tropical Storm,Jose,18,1999-10-22T03:00:00Z,27.0N  65.5W,0,27,9,0,36
Tropical Storm,Jose,18,1999-10-22T03:00:00Z,YARMOUTH NS,0,0,0,3,3
Tropical Storm,Jose,18,1999-10-22T03:00:00Z,31.5N  63.0W,0,0,18,10,28
Tropical Storm,Jose,18,1999-10-22T03:00:00Z,HALIFAX NS,0,0,0,7,7
Tropical Storm,Jose,18,1999-10-22T03:00:00Z,TIST 183N 650W,18,0,0,0,18
Tropical Storm,Jose,18,1999-10-22T03:00:00Z,SABLE ISLAND NS,0,0,0,13,13
Tropical Storm,Jose,18,1999-10-22T03:00:00Z,TJPS 180N 666W,96,0,0,0,96
Tropical Storm,Jose,18,1999-10-22T03:00:00Z,SYDNEY NS,0,0,0,9,9
Tropical Storm,Jose,18,1999-10-22T03:00:00Z,TJSJ 184N 661W,99,0,0,0,99
Tropical Storm,Jose,18,1999-10-22T03:00:00Z,EDDY POINT NS,0,0,0,9,9
Tropical Storm,Jose,18,1999-10-22T03:00:00Z,BERMUDA,0,0,18,8,26
Tropical Storm,Jose,18,1999-10-22T03:00:00Z,PTX BASQUES NFLD,0,0,0,8,8
Tropical Storm,Jose,18,1999-10-22T03:00:00Z,ST THOMAS VI,18,0,0,0,18
Tropical Storm,Jose,18,1999-10-22T03:00:00Z,BURGEO NFLD,0,0,0,9,9
Tropical Storm,Jose,18,1999-10-22T03:00:00Z,SAN JUAN PR,99,0,0,0,99
Tropical Storm,Jose,18,1999-10-22T03:00:00Z,ILE ST PIERRE,0,0,0,10,10
Tropical Storm,Jose,18,1999-10-22T03:00:00Z,PONCE PR,96,0,0,0,96
Tropical Storm,Jose,18,1999-10-22T03:00:00Z,CAPE RACE NFLD,0,0,0,8,8
Tropical Storm,Jose,18,1999-10-22T03:00:00Z,EASTPORT ME,0,0,0,2,2
Tropical Storm,Jose,18,1999-10-22T03:00:00Z,HIBERNIA OILFLD,0,0,0,3,3
Tropical Storm,Jose,18,1999-10-22T03:00:00Z,ST JOHN NB,0,0,0,3,3
Tropical Storm,Jose,19,1999-10-22T09:00:00Z,23.7N  66.6W,34,11,0,0,45
Tropical Storm,Jose,19,1999-10-22T09:00:00Z,HALIFAX NS,0,0,0,4,4
Tropical Storm,Jose,19,1999-10-22T09:00:00Z,28.0N  65.0W,0,26,14,0,40
Tropical Storm,Jose,19,1999-10-22T09:00:00Z,SABLE ISLAND NS,0,0,0,14,14
Tropical Storm,Jose,19,1999-10-22T09:00:00Z,34.0N  61.0W,0,0,16,12,28
Tropical Storm,Jose,19,1999-10-22T09:00:00Z,SYDNEY NS,0,0,0,10,10
Tropical Storm,Jose,19,1999-10-22T09:00:00Z,TJPS 180N 666W,37,0,0,0,37
Tropical Storm,Jose,19,1999-10-22T09:00:00Z,EDDY POINT NS,0,0,0,8,8
Tropical Storm,Jose,19,1999-10-22T09:00:00Z,TJSJ 184N 661W,45,0,0,0,45
Tropical Storm,Jose,19,1999-10-22T09:00:00Z,PTX BASQUES NFLD,0,0,0,9,9
Tropical Storm,Jose,19,1999-10-22T09:00:00Z,BERMUDA,0,0,25,1,26
Tropical Storm,Jose,19,1999-10-22T09:00:00Z,BURGEO NFLD,0,0,0,12,12
Tropical Storm,Jose,19,1999-10-22T09:00:00Z,SAN JUAN PR,45,0,0,0,45
Tropical Storm,Jose,19,1999-10-22T09:00:00Z,ILE ST PIERRE,0,0,0,14,14
Tropical Storm,Jose,19,1999-10-22T09:00:00Z,PONCE PR,37,0,0,0,37
Tropical Storm,Jose,19,1999-10-22T09:00:00Z,CAPE RACE NFLD,0,0,0,14,14
Tropical Storm,Jose,19,1999-10-22T09:00:00Z,MONCTON NB,0,0,0,2,2
Tropical Storm,Jose,19,1999-10-22T09:00:00Z,HIBERNIA OILFLD,0,0,0,8,8
Tropical Storm,Jose,20,1999-10-22T15:00:00Z,25.0N  65.5W,35,14,1,0,50
Tropical Storm,Jose,20,1999-10-22T15:00:00Z,SYDNEY NS,0,0,0,4,4
Tropical Storm,Jose,20,1999-10-22T15:00:00Z,30.0N  63.0W,0,24,15,0,39
Tropical Storm,Jose,20,1999-10-22T15:00:00Z,EDDY POINT NS,0,0,0,2,2
Tropical Storm,Jose,20,1999-10-22T15:00:00Z,37.0N  58.0W,0,0,15,12,27
Tropical Storm,Jose,20,1999-10-22T15:00:00Z,PTX BASQUES NFLD,0,0,0,4,4
Tropical Storm,Jose,20,1999-10-22T15:00:00Z,TJSJ 184N 661W,3,0,0,0,3
Tropical Storm,Jose,20,1999-10-22T15:00:00Z,BURGEO NFLD,0,0,0,7,7
Tropical Storm,Jose,20,1999-10-22T15:00:00Z,BERMUDA,0,5,11,0,16
Tropical Storm,Jose,20,1999-10-22T15:00:00Z,ILE ST PIERRE,0,0,0,12,12
Tropical Storm,Jose,20,1999-10-22T15:00:00Z,SAN JUAN PR,3,0,0,0,3
Tropical Storm,Jose,20,1999-10-22T15:00:00Z,CAPE RACE NFLD,0,0,0,17,17
Tropical Storm,Jose,20,1999-10-22T15:00:00Z,SABLE ISLAND NS,0,0,0,7,7
Tropical Storm,Jose,20,1999-10-22T15:00:00Z,HIBERNIA OILFLD,0,0,0,15,15
Tropical Storm,Jose,21,1999-10-22T21:00:00Z,26.0N  64.5W,29,12,0,0,41
Tropical Storm,Jose,21,1999-10-22T21:00:00Z,EDDY POINT NS,0,0,1,3,4
Tropical Storm,Jose,21,1999-10-22T21:00:00Z,32.0N  61.0W,0,14,10,0,24
Tropical Storm,Jose,21,1999-10-22T21:00:00Z,PTX BASQUES NFLD,0,0,0,5,5
Tropical Storm,Jose,21,1999-10-22T21:00:00Z,40.0N  55.0W,0,0,11,7,18
Tropical Storm,Jose,21,1999-10-22T21:00:00Z,BURGEO NFLD,0,0,0,8,8
Tropical Storm,Jose,21,1999-10-22T21:00:00Z,BERMUDA,0,9,2,0,11
Tropical Storm,Jose,21,1999-10-22T21:00:00Z,ILE ST PIERRE,0,0,1,10,11
Tropical Storm,Jose,21,1999-10-22T21:00:00Z,HALIFAX NS,0,0,0,2,2
Tropical Storm,Jose,21,1999-10-22T21:00:00Z,CAPE RACE NFLD,0,0,1,14,15
Tropical Storm,Jose,21,1999-10-22T21:00:00Z,SABLE ISLAND NS,0,0,2,6,8
Tropical Storm,Jose,21,1999-10-22T21:00:00Z,HIBERNIA OILFLD,0,0,0,14,14
Tropical Storm,Jose,21,1999-10-22T21:00:00Z,SYDNEY NS,0,0,1,4,5
Tropical Storm,Jose,22,1999-10-23T03:00:00Z,28.0N  63.5W,26,13,0,0,39
Tropical Storm,Jose,22,1999-10-23T03:00:00Z,HALIFAX NS,0,0,2,0,2
Tropical Storm,Jose,22,1999-10-23T03:00:00Z,34.3N  61.0W,0,12,10,0,22
Tropical Storm,Jose,22,1999-10-23T03:00:00Z,SABLE ISLAND NS,0,0,5,0,5
Tropical Storm,Jose,22,1999-10-23T03:00:00Z,42.0N  56.0W,0,0,9,0,9
Tropical Storm,Jose,22,1999-10-23T03:00:00Z,SYDNEY NS,0,0,2,0,2
Tropical Storm,Jose,22,1999-10-23T03:00:00Z,BERMUDA,0,16,1,0,17
Tropical Storm,Jose,22,1999-10-23T03:00:00Z,EDDY POINT NS,0,0,2,0,2
Tropical Storm,Jose,23,1999-10-23T09:00:00Z,29.6N  62.3W,30,10,0,0,40
Tropical Storm,Jose,23,1999-10-23T09:00:00Z,SYDNEY NS,0,0,5,0,5
Tropical Storm,Jose,23,1999-10-23T09:00:00Z,35.5N  60.0W,0,14,8,0,22
Tropical Storm,Jose,23,1999-10-23T09:00:00Z,EDDY POINT NS,0,0,4,0,4
Tropical Storm,Jose,23,1999-10-23T09:00:00Z,45.0N  54.5W,0,0,8,0,8
Tropical Storm,Jose,23,1999-10-23T09:00:00Z,PTX BASQUES NFLD,0,0,3,0,3
Tropical Storm,Jose,23,1999-10-23T09:00:00Z,BERMUDA,1,12,0,0,13
Tropical Storm,Jose,23,1999-10-23T09:00:00Z,BURGEO NFLD,0,0,4,0,4
Tropical Storm,Jose,23,1999-10-23T09:00:00Z,HALIFAX NS,0,0,2,0,2
Tropical Storm,Jose,23,1999-10-23T09:00:00Z,ILE ST PIERRE,0,0,6,0,6
Tropical Storm,Jose,23,1999-10-23T09:00:00Z,SABLE ISLAND NS,0,0,8,0,8
Tropical Storm,Jose,23,1999-10-23T09:00:00Z,CAPE RACE NFLD,0,0,4,0,4
Tropical Storm,Jose,24,1999-10-23T15:00:00Z,30.1N  62.1W,24,8,0,0,32
Tropical Storm,Jose,24,1999-10-23T15:00:00Z,SYDNEY NS,0,0,3,0,3
Tropical Storm,Jose,24,1999-10-23T15:00:00Z,35.9N  59.5W,0,11,7,0,18
Tropical Storm,Jose,24,1999-10-23T15:00:00Z,EDDY POINT NS,0,0,3,0,3
Tropical Storm,Jose,24,1999-10-23T15:00:00Z,44.0N  53.0W,0,0,6,0,6
Tropical Storm,Jose,24,1999-10-23T15:00:00Z,PTX BASQUES NFLD,0,0,2,0,2
Tropical Storm,Jose,24,1999-10-23T15:00:00Z,BERMUDA,4,11,0,0,15
Tropical Storm,Jose,24,1999-10-23T15:00:00Z,BURGEO NFLD,0,0,2,0,2
Tropical Storm,Jose,24,1999-10-23T15:00:00Z,HALIFAX NS,0,0,2,0,2
Tropical Storm,Jose,24,1999-10-23T15:00:00Z,ILE ST PIERRE,0,0,3,0,3
Tropical Storm,Jose,24,1999-10-23T15:00:00Z,SABLE ISLAND NS,0,0,5,0,5
Tropical Storm,Jose,24,1999-10-23T15:00:00Z,CAPE RACE NFLD,0,0,3,0,3
Tropical Storm,Jose,25,1999-10-23T21:00:00Z,32.5N  60.4W,19,9,0,0,28
Tropical Storm,Jose,25,1999-10-23T21:00:00Z,BERMUDA,9,1,0,0,10
Tropical Storm,Jose,25,1999-10-23T21:00:00Z,40.0N  56.0W,0,9,0,0,9
Tropical Storm,Jose,25,1999-10-23T21:00:00Z,SABLE ISLAND NS,0,2,0,0,2
Tropical Storm,Jose,26,1999-10-24T03:00:00Z,35.1N  58.7W,14,8,0,0,22
Tropical Storm,Jose,26,1999-10-24T03:00:00Z,EDDY POINT NS,0,2,0,0,2
Tropical Storm,Jose,26,1999-10-24T03:00:00Z,43.0N  53.5W,0,8,0,0,8
Tropical Storm,Jose,26,1999-10-24T03:00:00Z,PTX BASQUES NFLD,0,2,0,0,2
Tropical Storm,Jose,26,1999-10-24T03:00:00Z,BERMUDA,7,1,0,0,8
Tropical Storm,Jose,26,1999-10-24T03:00:00Z,BURGEO NFLD,0,2,0,0,2
Tropical Storm,Jose,26,1999-10-24T03:00:00Z,SABLE ISLAND NS,0,4,0,0,4
Tropical Storm,Jose,26,1999-10-24T03:00:00Z,ILE ST PIERRE,0,3,0,0,3
Tropical Storm,Jose,26,1999-10-24T03:00:00Z,SYDNEY NS,0,2,0,0,2
Tropical Storm,Jose,26,1999-10-24T03:00:00Z,CAPE RACE NFLD,0,2,0,0,2
Tropical Storm,Jose,27,1999-10-24T09:00:00Z,38.5N  56.0W,9,7,0,0,16
Tropical Storm,Jose,27,1999-10-24T09:00:00Z,PTX BASQUES NFLD,0,3,0,0,3
Tropical Storm,Jose,27,1999-10-24T09:00:00Z,47.1N  50.0W,0,8,0,0,8
Tropical Storm,Jose,27,1999-10-24T09:00:00Z,BURGEO NFLD,0,5,0,0,5
Tropical Storm,Jose,27,1999-10-24T09:00:00Z,SABLE ISLAND NS,0,5,0,0,5
Tropical Storm,Jose,27,1999-10-24T09:00:00Z,ILE ST PIERRE,0,7,0,0,7
Tropical Storm,Jose,27,1999-10-24T09:00:00Z,SYDNEY NS,0,3,0,0,3
Tropical Storm,Jose,27,1999-10-24T09:00:00Z,CAPE RACE NFLD,0,9,0,0,9
Tropical Storm,Jose,27,1999-10-24T09:00:00Z,EDDY POINT NS,0,2,0,0,2
Tropical Storm,Jose,27,1999-10-24T09:00:00Z,HIBERNIA OILFLD,0,6,0,0,6
Hurricane,Jose,28,1999-10-24T15:00:00Z,41.0N  52.5W,14,5,0,0,19
Hurricane,Jose,28,1999-10-24T15:00:00Z,CAPE RACE NFLD,0,7,0,0,7
Hurricane,Jose,28,1999-10-24T15:00:00Z,48.0N  45.0W,0,9,0,0,9
Hurricane,Jose,28,1999-10-24T15:00:00Z,HIBERNIA OILFLD,0,11,0,0,11
Hurricane,Jose,28,1999-10-24T15:00:00Z,ILE ST PIERRE,0,3,0,0,3
Hurricane,Jose,29,1999-10-24T21:00:00Z,45.0N  49.0W,13,0,0,0,13
Hurricane,Jose,29,1999-10-24T21:00:00Z,HIBERNIA OILFLD,2,0,0,0,2
Hurricane,Jose,29,1999-10-24T21:00:00Z,CAPE RACE NFLD,6,0,0,0,6
Tropical Depression,Fifteen,2,1999-10-29T03:00:00Z,12.0N  83.5W,56,0,0,0,56
Tropical Depression,Fifteen,2,1999-10-29T03:00:00Z,MNBL 120N 839W,44,0,0,0,44
Tropical Depression,Fifteen,2,1999-10-29T03:00:00Z,12.5N  85.0W,21,13,0,0,34
Tropical Depression,Fifteen,2,1999-10-29T03:00:00Z,SKSP 126N 817W,99,0,0,0,99
Tropical Depression,Fifteen,2,1999-10-29T03:00:00Z,13.0N  87.0W,0,14,14,1,29
Tropical Depression,Fifteen,2,1999-10-29T03:00:00Z,MRLM 100N 831W,13,2,0,1,16
Tropical Depression,Fifteen,2,1999-10-29T03:00:00Z,MZBZ 175N 883W,0,0,3,9,12
Tropical Depression,Fifteen,2,1999-10-29T03:00:00Z,MMVR 192N 961W,0,0,0,4,4
Tropical Depression,Fifteen,2,1999-10-29T03:00:00Z,MGPB 157N 886W,0,0,11,8,19
Tropical Depression,Fifteen,2,1999-10-29T03:00:00Z,MMFR 185N 926W,0,0,0,10,10
Tropical Depression,Fifteen,2,1999-10-29T03:00:00Z,MHNJ 165N 859W,0,2,7,4,13
Tropical Depression,Fifteen,2,1999-10-29T03:00:00Z,MMMD 210N 897W,0,0,0,2,2
Tropical Depression,Fifteen,2,1999-10-29T03:00:00Z,MNPC 141N 834W,22,3,1,0,26
Tropical Depression,Fifteen,3,1999-10-29T09:00:00Z,12.5N  84.0W,54,0,0,0,54
Tropical Depression,Fifteen,3,1999-10-29T09:00:00Z,MHNJ 165N 859W,0,6,10,4,20
Tropical Depression,Fifteen,3,1999-10-29T09:00:00Z,13.2N  85.0W,28,5,1,0,34
Tropical Depression,Fifteen,3,1999-10-29T09:00:00Z,MNPC 141N 834W,33,0,1,0,34
Tropical Depression,Fifteen,3,1999-10-29T09:00:00Z,14.0N  86.0W,4,18,3,2,27
Tropical Depression,Fifteen,3,1999-10-29T09:00:00Z,MNBL 120N 839W,53,0,0,0,53
Tropical Depression,Fifteen,3,1999-10-29T09:00:00Z,MUAN 219N 850W,0,0,0,2,2
Tropical Depression,Fifteen,3,1999-10-29T09:00:00Z,SKSP 126N 817W,99,0,0,0,99
Tropical Depression,Fifteen,3,1999-10-29T09:00:00Z,MMCZ 205N 869W,0,0,0,8,8
Tropical Depression,Fifteen,3,1999-10-29T09:00:00Z,MRLM 100N 831W,14,1,0,1,16
Tropical Depression,Fifteen,3,1999-10-29T09:00:00Z,MZBZ 175N 883W,0,0,5,12,17
Tropical Depression,Fifteen,3,1999-10-29T09:00:00Z,MMFR 185N 926W,0,0,0,7,7
Tropical Depression,Fifteen,3,1999-10-29T09:00:00Z,MGPB 157N 886W,0,0,9,9,18
Tropical Depression,Fifteen,3,1999-10-29T09:00:00Z,MMMD 210N 897W,0,0,0,7,7
Tropical Depression,Fifteen,4,1999-10-29T15:00:00Z,14.4N  84.1W,62,0,0,0,62
Tropical Depression,Fifteen,4,1999-10-29T15:00:00Z,MGPB 157N 886W,0,2,9,8,19
Tropical Depression,Fifteen,4,1999-10-29T15:00:00Z,15.0N  85.0W,30,4,1,0,35
Tropical Depression,Fifteen,4,1999-10-29T15:00:00Z,MHNJ 165N 859W,3,16,7,1,27
Tropical Depression,Fifteen,4,1999-10-29T15:00:00Z,16.0N  86.0W,5,17,5,1,28
Tropical Depression,Fifteen,4,1999-10-29T15:00:00Z,MNPC 141N 834W,76,0,0,0,76
Tropical Depression,Fifteen,4,1999-10-29T15:00:00Z,MWCG 193N 814W,0,0,1,1,2
Tropical Depression,Fifteen,4,1999-10-29T15:00:00Z,MNBL 120N 839W,25,0,1,0,26
Tropical Depression,Fifteen,4,1999-10-29T15:00:00Z,MUSN 216N 826W,0,0,0,2,2
Tropical Depression,Fifteen,4,1999-10-29T15:00:00Z,SKSP 126N 817W,99,0,0,0,99
Tropical Depression,Fifteen,4,1999-10-29T15:00:00Z,MUAN 219N 850W,0,0,1,5,6
Tropical Depression,Fifteen,4,1999-10-29T15:00:00Z,MRLM 100N 831W,0,0,1,2,3
Tropical Depression,Fifteen,4,1999-10-29T15:00:00Z,MMCZ 205N 869W,0,0,4,10,14
Tropical Depression,Fifteen,4,1999-10-29T15:00:00Z,MMFR 185N 926W,0,0,0,6,6
Tropical Depression,Fifteen,4,1999-10-29T15:00:00Z,MZBZ 175N 883W,0,1,10,9,20
Tropical Depression,Fifteen,4,1999-10-29T15:00:00Z,MMMD 210N 897W,0,0,0,11,11
Tropical Storm,Katrina,5,1999-10-29T21:00:00Z,15.5N  85.7W,50,0,0,0,50
Tropical Storm,Katrina,5,1999-10-29T21:00:00Z,MGPB 157N 886W,2,10,3,3,18
Tropical Storm,Katrina,5,1999-10-29T21:00:00Z,16.4N  86.7W,29,2,1,0,32
Tropical Storm,Katrina,5,1999-10-29T21:00:00Z,MHNJ 165N 859W,36,0,0,1,37
Tropical Storm,Katrina,5,1999-10-29T21:00:00Z,17.1N  87.3W,10,13,1,1,25
Tropical Storm,Katrina,5,1999-10-29T21:00:00Z,MNPC 141N 834W,99,0,0,0,99
Tropical Storm,Katrina,5,1999-10-29T21:00:00Z,MWCG 193N 814W,0,0,1,5,6
Tropical Storm,Katrina,5,1999-10-29T21:00:00Z,MNBL 120N 839W,22,0,0,0,22
Tropical Storm,Katrina,5,1999-10-29T21:00:00Z,MUCF 221N 805W,0,0,0,2,2
Tropical Storm,Katrina,5,1999-10-29T21:00:00Z,SKSP 126N 817W,1,0,1,2,4
Tropical Storm,Katrina,5,1999-10-29T21:00:00Z,MUSN 216N 826W,0,0,0,5,5
Tropical Storm,Katrina,5,1999-10-29T21:00:00Z,MMTX 210N 974W,0,0,0,2,2
Tropical Storm,Katrina,5,1999-10-29T21:00:00Z,MUHA 230N 824W,0,0,0,3,3
Tropical Storm,Katrina,5,1999-10-29T21:00:00Z,MMVR 192N 961W,0,0,0,3,3
Tropical Storm,Katrina,5,1999-10-29T21:00:00Z,MUAN 219N 850W,0,0,1,7,8
Tropical Storm,Katrina,5,1999-10-29T21:00:00Z,MMFR 185N 926W,0,0,4,6,10
Tropical Storm,Katrina,5,1999-10-29T21:00:00Z,MMCZ 205N 869W,0,2,6,6,14
Tropical Storm,Katrina,5,1999-10-29T21:00:00Z,MMMD 210N 897W,0,1,5,7,13
Tropical Storm,Katrina,5,1999-10-29T21:00:00Z,MZBZ 175N 883W,1,16,2,2,21
Tropical Depression,Katrina,6,1999-10-30T03:00:00Z,15.5N  86.0W,52,0,0,0,52
Tropical Depression,Katrina,6,1999-10-30T03:00:00Z,SKSP 126N 817W,0,0,0,2,2
Tropical Depression,Katrina,6,1999-10-30T03:00:00Z,16.5N  87.0W,25,5,0,0,30
Tropical Depression,Katrina,6,1999-10-30T03:00:00Z,MMSO 238N 982W,0,0,0,2,2
Tropical Depression,Katrina,6,1999-10-30T03:00:00Z,18.0N  87.5W,3,15,3,1,22
Tropical Depression,Katrina,6,1999-10-30T03:00:00Z,MMTM 222N 979W,0,0,0,2,2
Tropical Depression,Katrina,6,1999-10-30T03:00:00Z,MKJS 185N 779W,0,0,0,2,2
Tropical Depression,Katrina,6,1999-10-30T03:00:00Z,MMTX 210N 974W,0,0,0,2,2
Tropical Depression,Katrina,6,1999-10-30T03:00:00Z,MWCG 193N 814W,0,0,1,6,7
Tropical Depression,Katrina,6,1999-10-30T03:00:00Z,MMVR 192N 961W,0,0,0,3,3
Tropical Depression,Katrina,6,1999-10-30T03:00:00Z,MUCF 221N 805W,0,0,0,3,3
Tropical Depression,Katrina,6,1999-10-30T03:00:00Z,MMFR 185N 926W,0,1,5,4,10
Tropical Depression,Katrina,6,1999-10-30T03:00:00Z,MUSN 216N 826W,0,0,0,6,6
Tropical Depression,Katrina,6,1999-10-30T03:00:00Z,MMMD 210N 897W,0,0,6,8,14
Tropical Depression,Katrina,6,1999-10-30T03:00:00Z,MUHA 230N 824W,0,0,0,4,4
Tropical Depression,Katrina,6,1999-10-30T03:00:00Z,KEY WEST FL,0,0,0,2,2
Tropical Depression,Katrina,6,1999-10-30T03:00:00Z,MUAN 219N 850W,0,0,1,9,10
Tropical Depression,Katrina,6,1999-10-30T03:00:00Z,BROWNSVILLE TX,0,0,0,2,2
Tropical Depression,Katrina,6,1999-10-30T03:00:00Z,MMCZ 205N 869W,0,0,7,8,15
Tropical Depression,Katrina,6,1999-10-30T03:00:00Z,GULF 28N 89W,0,0,0,2,2
Tropical Depression,Katrina,6,1999-10-30T03:00:00Z,MZBZ 175N 883W,3,17,2,1,23
Tropical Depression,Katrina,6,1999-10-30T03:00:00Z,GULF 28N 91W,0,0,0,2,2
Tropical Depression,Katrina,6,1999-10-30T03:00:00Z,MGPB 157N 886W,5,10,2,1,18
Tropical Depression,Katrina,6,1999-10-30T03:00:00Z,GULF 28N 93W,0,0,0,2,2
Tropical Depression,Katrina,6,1999-10-30T03:00:00Z,MHNJ 165N 859W,33,1,0,0,34
Tropical Depression,Katrina,6,1999-10-30T03:00:00Z,GULF 28N 95W,0,0,0,2,2
Tropical Depression,Katrina,6,1999-10-30T03:00:00Z,MNPC 141N 834W,99,0,0,0,99
Tropical Depression,Katrina,6,1999-10-30T03:00:00Z,GULF 27N 96W,0,0,0,2,2
Tropical Depression,Katrina,6,1999-10-30T03:00:00Z,MNBL 120N 839W,33,1,0,0,34
Tropical Depression,Katrina,6,1999-10-30T03:00:00Z,GULF 25N 96W,0,0,0,3,3
Tropical Depression,Katrina,7,1999-10-30T09:00:00Z,16.6N  87.1W,49,0,0,0,49
Tropical Depression,Katrina,7,1999-10-30T09:00:00Z,FT MYERS FL,0,0,0,2,2
Tropical Depression,Katrina,7,1999-10-30T09:00:00Z,18.4N  87.9W,16,14,0,1,31
Tropical Depression,Katrina,7,1999-10-30T09:00:00Z,VENICE FL,0,0,0,2,2
Tropical Depression,Katrina,7,1999-10-30T09:00:00Z,19.9N  88.2W,1,20,2,1,24
Tropical Depression,Katrina,7,1999-10-30T09:00:00Z,GULFPORT MS,0,0,0,2,2
Tropical Depression,Katrina,7,1999-10-30T09:00:00Z,MWCG 193N 814W,0,0,2,4,6
Tropical Depression,Katrina,7,1999-10-30T09:00:00Z,BURAS LA,0,0,0,3,3
Tropical Depression,Katrina,7,1999-10-30T09:00:00Z,MUCF 221N 805W,0,0,0,4,4
Tropical Depression,Katrina,7,1999-10-30T09:00:00Z,NEW ORLEANS LA,0,0,0,2,2
Tropical Depression,Katrina,7,1999-10-30T09:00:00Z,MUSN 216N 826W,0,0,2,6,8
Tropical Depression,Katrina,7,1999-10-30T09:00:00Z,NEW IBERIA LA,0,0,0,2,2
Tropical Depression,Katrina,7,1999-10-30T09:00:00Z,MUHA 230N 824W,0,0,1,5,6
Tropical Depression,Katrina,7,1999-10-30T09:00:00Z,PORT ARTHUR TX,0,0,0,2,2
Tropical Depression,Katrina,7,1999-10-30T09:00:00Z,MUAN 219N 850W,0,1,7,6,14
Tropical Depression,Katrina,7,1999-10-30T09:00:00Z,GALVESTON TX,0,0,0,2,2
Tropical Depression,Katrina,7,1999-10-30T09:00:00Z,MMCZ 205N 869W,0,15,4,2,21
Tropical Depression,Katrina,7,1999-10-30T09:00:00Z,FREEPORT TX,0,0,0,2,2
Tropical Depression,Katrina,7,1999-10-30T09:00:00Z,MZBZ 175N 883W,22,7,0,0,29
Tropical Depression,Katrina,7,1999-10-30T09:00:00Z,PORT O CONNOR TX,0,0,0,2,2
Tropical Depression,Katrina,7,1999-10-30T09:00:00Z,MGPB 157N 886W,18,2,0,0,20
Tropical Depression,Katrina,7,1999-10-30T09:00:00Z,BROWNSVILLE TX,0,0,0,2,2
Tropical Depression,Katrina,7,1999-10-30T09:00:00Z,MHNJ 165N 859W,60,0,0,0,60
Tropical Depression,Katrina,7,1999-10-30T09:00:00Z,GULF 29N 85W,0,0,0,2,2
Tropical Depression,Katrina,7,1999-10-30T09:00:00Z,MNPC 141N 834W,99,0,0,0,99
Tropical Depression,Katrina,7,1999-10-30T09:00:00Z,GULF 29N 87W,0,0,0,3,3
Tropical Depression,Katrina,7,1999-10-30T09:00:00Z,MMVR 192N 961W,0,0,0,2,2
Tropical Depression,Katrina,7,1999-10-30T09:00:00Z,GULF 28N 89W,0,0,0,5,5
Tropical Depression,Katrina,7,1999-10-30T09:00:00Z,MMFR 185N 926W,0,1,2,4,7
Tropical Depression,Katrina,7,1999-10-30T09:00:00Z,GULF 28N 91W,0,0,0,5,5
Tropical Depression,Katrina,7,1999-10-30T09:00:00Z,MMMD 210N 897W,0,8,7,4,19
Tropical Depression,Katrina,7,1999-10-30T09:00:00Z,GULF 28N 93W,0,0,0,4,4
Tropical Depression,Katrina,7,1999-10-30T09:00:00Z,MARATHON FL,0,0,0,3,3
Tropical Depression,Katrina,7,1999-10-30T09:00:00Z,GULF 28N 95W,0,0,0,3,3
Tropical Depression,Katrina,7,1999-10-30T09:00:00Z,KEY WEST FL,0,0,0,4,4
Tropical Depression,Katrina,7,1999-10-30T09:00:00Z,GULF 27N 96W,0,0,0,3,3
Tropical Depression,Katrina,7,1999-10-30T09:00:00Z,MARCO ISLAND FL,0,0,0,2,2
Tropical Depression,Katrina,7,1999-10-30T09:00:00Z,GULF 25N 96W,0,0,0,4,4
Tropical Depression,Katrina,8,1999-10-30T15:00:00Z,15.6N  86.9W,48,0,0,0,48
Tropical Depression,Katrina,8,1999-10-30T15:00:00Z,VENICE FL,0,0,0,3,3
Tropical Depression,Katrina,8,1999-10-30T15:00:00Z,17.0N  88.0W,18,9,1,0,28
Tropical Depression,Katrina,8,1999-10-30T15:00:00Z,TAMPA FL,0,0,0,2,2
Tropical Depression,Katrina,8,1999-10-30T15:00:00Z,19.0N  88.5W,0,15,5,2,22
Tropical Depression,Katrina,8,1999-10-30T15:00:00Z,APALACHICOLA FL,0,0,0,2,2
Tropical Depression,Katrina,8,1999-10-30T15:00:00Z,MWCG 193N 814W,0,0,1,5,6
Tropical Depression,Katrina,8,1999-10-30T15:00:00Z,PANAMA CITY FL,0,0,0,2,2
Tropical Depression,Katrina,8,1999-10-30T15:00:00Z,MUCF 221N 805W,0,0,0,4,4
Tropical Depression,Katrina,8,1999-10-30T15:00:00Z,PENSACOLA FL,0,0,0,2,2
Tropical Depression,Katrina,8,1999-10-30T15:00:00Z,MUSN 216N 826W,0,0,1,7,8
Tropical Depression,Katrina,8,1999-10-30T15:00:00Z,MOBILE AL,0,0,0,2,2
Tropical Depression,Katrina,8,1999-10-30T15:00:00Z,MUHA 230N 824W,0,0,0,6,6
Tropical Depression,Katrina,8,1999-10-30T15:00:00Z,GULFPORT MS,0,0,0,3,3
Tropical Depression,Katrina,8,1999-10-30T15:00:00Z,MUAN 219N 850W,0,0,3,9,12
Tropical Depression,Katrina,8,1999-10-30T15:00:00Z,BURAS LA,0,0,0,4,4
Tropical Depression,Katrina,8,1999-10-30T15:00:00Z,MMCZ 205N 869W,0,3,10,4,17
Tropical Depression,Katrina,8,1999-10-30T15:00:00Z,NEW ORLEANS LA,0,0,0,3,3
Tropical Depression,Katrina,8,1999-10-30T15:00:00Z,MZBZ 175N 883W,9,15,1,1,26
Tropical Depression,Katrina,8,1999-10-30T15:00:00Z,NEW IBERIA LA,0,0,0,3,3
Tropical Depression,Katrina,8,1999-10-30T15:00:00Z,MGPB 157N 886W,18,5,0,1,24
Tropical Depression,Katrina,8,1999-10-30T15:00:00Z,PORT ARTHUR TX,0,0,0,2,2
Tropical Depression,Katrina,8,1999-10-30T15:00:00Z,MHNJ 165N 859W,35,1,0,0,36
Tropical Depression,Katrina,8,1999-10-30T15:00:00Z,GALVESTON TX,0,0,0,2,2
Tropical Depression,Katrina,8,1999-10-30T15:00:00Z,MNPC 141N 834W,21,0,0,0,21
Tropical Depression,Katrina,8,1999-10-30T15:00:00Z,FREEPORT TX,0,0,0,2,2
Tropical Depression,Katrina,8,1999-10-30T15:00:00Z,MMSO 238N 982W,0,0,0,2,2
Tropical Depression,Katrina,8,1999-10-30T15:00:00Z,PORT O CONNOR TX,0,0,0,2,2
Tropical Depression,Katrina,8,1999-10-30T15:00:00Z,MMTM 222N 979W,0,0,0,2,2
Tropical Depression,Katrina,8,1999-10-30T15:00:00Z,BROWNSVILLE TX,0,0,0,2,2
Tropical Depression,Katrina,8,1999-10-30T15:00:00Z,MMTX 210N 974W,0,0,0,2,2
Tropical Depression,Katrina,8,1999-10-30T15:00:00Z,GULF 29N 85W,0,0,0,3,3
Tropical Depression,Katrina,8,1999-10-30T15:00:00Z,MMVR 192N 961W,0,0,0,3,3
Tropical Depression,Katrina,8,1999-10-30T15:00:00Z,GULF 29N 87W,0,0,0,4,4
Tropical Depression,Katrina,8,1999-10-30T15:00:00Z,MMFR 185N 926W,0,2,6,3,11
Tropical Depression,Katrina,8,1999-10-30T15:00:00Z,GULF 28N 89W,0,0,0,6,6
Tropical Depression,Katrina,8,1999-10-30T15:00:00Z,MMMD 210N 897W,0,2,11,4,17
Tropical Depression,Katrina,8,1999-10-30T15:00:00Z,GULF 28N 91W,0,0,0,6,6
Tropical Depression,Katrina,8,1999-10-30T15:00:00Z,MARATHON FL,0,0,0,3,3
Tropical Depression,Katrina,8,1999-10-30T15:00:00Z,GULF 28N 93W,0,0,0,5,5
Tropical Depression,Katrina,8,1999-10-30T15:00:00Z,MIAMI FL,0,0,0,2,2
Tropical Depression,Katrina,8,1999-10-30T15:00:00Z,GULF 28N 95W,0,0,0,3,3
Tropical Depression,Katrina,8,1999-10-30T15:00:00Z,KEY WEST FL,0,0,0,4,4
Tropical Depression,Katrina,8,1999-10-30T15:00:00Z,GULF 27N 96W,0,0,0,3,3
Tropical Depression,Katrina,8,1999-10-30T15:00:00Z,MARCO ISLAND FL,0,0,0,3,3
Tropical Depression,Katrina,8,1999-10-30T15:00:00Z,GULF 25N 96W,0,0,0,4,4
Tropical Depression,Katrina,8,1999-10-30T15:00:00Z,FT MYERS FL,0,0,0,2,2
Tropical Depression,Katrina,9,1999-10-30T21:00:00Z,16.5N  87.9W,49,0,0,0,49
Tropical Depression,Katrina,9,1999-10-30T21:00:00Z,TAMPA FL,0,0,0,2,2
Tropical Depression,Katrina,9,1999-10-30T21:00:00Z,18.0N  88.5W,23,7,0,0,30
Tropical Depression,Katrina,9,1999-10-30T21:00:00Z,CEDAR KEY FL,0,0,0,2,2
Tropical Depression,Katrina,9,1999-10-30T21:00:00Z,20.0N  88.5W,1,14,5,2,22
Tropical Depression,Katrina,9,1999-10-30T21:00:00Z,ST MARKS FL,0,0,0,2,2
Tropical Depression,Katrina,9,1999-10-30T21:00:00Z,MWCG 193N 814W,0,0,1,5,6
Tropical Depression,Katrina,9,1999-10-30T21:00:00Z,APALACHICOLA FL,0,0,0,2,2
Tropical Depression,Katrina,9,1999-10-30T21:00:00Z,MUCF 221N 805W,0,0,0,4,4
Tropical Depression,Katrina,9,1999-10-30T21:00:00Z,PANAMA CITY FL,0,0,0,2,2
Tropical Depression,Katrina,9,1999-10-30T21:00:00Z,MUSN 216N 826W,0,0,1,7,8
Tropical Depression,Katrina,9,1999-10-30T21:00:00Z,PENSACOLA FL,0,0,0,3,3
Tropical Depression,Katrina,9,1999-10-30T21:00:00Z,MUHA 230N 824W,0,0,0,7,7
Tropical Depression,Katrina,9,1999-10-30T21:00:00Z,MOBILE AL,0,0,0,3,3
Tropical Depression,Katrina,9,1999-10-30T21:00:00Z,MUAN 219N 850W,0,0,6,7,13
Tropical Depression,Katrina,9,1999-10-30T21:00:00Z,GULFPORT MS,0,0,0,3,3
Tropical Depression,Katrina,9,1999-10-30T21:00:00Z,MMCZ 205N 869W,0,8,8,3,19
Tropical Depression,Katrina,9,1999-10-30T21:00:00Z,BURAS LA,0,0,0,4,4
Tropical Depression,Katrina,9,1999-10-30T21:00:00Z,MZBZ 175N 883W,33,2,0,0,35
Tropical Depression,Katrina,9,1999-10-30T21:00:00Z,NEW ORLEANS LA,0,0,0,3,3
Tropical Depression,Katrina,9,1999-10-30T21:00:00Z,MGPB 157N 886W,31,0,0,0,31
Tropical Depression,Katrina,9,1999-10-30T21:00:00Z,NEW IBERIA LA,0,0,0,3,3
Tropical Depression,Katrina,9,1999-10-30T21:00:00Z,MHNJ 165N 859W,60,0,0,0,60
Tropical Depression,Katrina,9,1999-10-30T21:00:00Z,PORT ARTHUR TX,0,0,0,2,2
Tropical Depression,Katrina,9,1999-10-30T21:00:00Z,MNPC 141N 834W,0,0,1,1,2
Tropical Depression,Katrina,9,1999-10-30T21:00:00Z,GALVESTON TX,0,0,0,2,2
Tropical Depression,Katrina,9,1999-10-30T21:00:00Z,MMSO 238N 982W,0,0,0,2,2
Tropical Depression,Katrina,9,1999-10-30T21:00:00Z,FREEPORT TX,0,0,0,2,2
Tropical Depression,Katrina,9,1999-10-30T21:00:00Z,MMTM 222N 979W,0,0,0,2,2
Tropical Depression,Katrina,9,1999-10-30T21:00:00Z,PORT O CONNOR TX,0,0,0,2,2
Tropical Depression,Katrina,9,1999-10-30T21:00:00Z,MMTX 210N 974W,0,0,0,2,2
Tropical Depression,Katrina,9,1999-10-30T21:00:00Z,BROWNSVILLE TX,0,0,0,2,2
Tropical Depression,Katrina,9,1999-10-30T21:00:00Z,MMVR 192N 961W,0,0,0,2,2
Tropical Depression,Katrina,9,1999-10-30T21:00:00Z,GULF 29N 85W,0,0,0,3,3
Tropical Depression,Katrina,9,1999-10-30T21:00:00Z,MMFR 185N 926W,0,3,5,2,10
Tropical Depression,Katrina,9,1999-10-30T21:00:00Z,GULF 29N 87W,0,0,0,4,4
Tropical Depression,Katrina,9,1999-10-30T21:00:00Z,MMMD 210N 897W,0,7,9,3,19
Tropical Depression,Katrina,9,1999-10-30T21:00:00Z,GULF 28N 89W,0,0,0,7,7
Tropical Depression,Katrina,9,1999-10-30T21:00:00Z,MARATHON FL,0,0,0,4,4
Tropical Depression,Katrina,9,1999-10-30T21:00:00Z,GULF 28N 91W,0,0,0,6,6
Tropical Depression,Katrina,9,1999-10-30T21:00:00Z,MIAMI FL,0,0,0,2,2
Tropical Depression,Katrina,9,1999-10-30T21:00:00Z,GULF 28N 93W,0,0,0,5,5
Tropical Depression,Katrina,9,1999-10-30T21:00:00Z,KEY WEST FL,0,0,0,5,5
Tropical Depression,Katrina,9,1999-10-30T21:00:00Z,GULF 28N 95W,0,0,0,3,3
Tropical Depression,Katrina,9,1999-10-30T21:00:00Z,MARCO ISLAND FL,0,0,0,3,3
Tropical Depression,Katrina,9,1999-10-30T21:00:00Z,GULF 27N 96W,0,0,0,3,3
Tropical Depression,Katrina,9,1999-10-30T21:00:00Z,FT MYERS FL,0,0,0,3,3
Tropical Depression,Katrina,9,1999-10-30T21:00:00Z,GULF 25N 96W,0,0,0,4,4
Tropical Depression,Katrina,9,1999-10-30T21:00:00Z,VENICE FL,0,0,0,3,3
Tropical Depression,Katrina,10,1999-10-31T03:00:00Z,19.4N  88.5W,44,0,0,0,44
Tropical Depression,Katrina,10,1999-10-31T03:00:00Z,KEY WEST FL,0,0,1,9,10
Tropical Depression,Katrina,10,1999-10-31T03:00:00Z,21.2N  88.3W,15,14,0,0,29
Tropical Depression,Katrina,10,1999-10-31T03:00:00Z,MARCO ISLAND FL,0,0,0,10,10
Tropical Depression,Katrina,10,1999-10-31T03:00:00Z,23.5N  87.5W,0,10,11,1,22
Tropical Depression,Katrina,10,1999-10-31T03:00:00Z,FT MYERS FL,0,0,0,10,10
Tropical Depression,Katrina,10,1999-10-31T03:00:00Z,MWCG 193N 814W,0,0,0,3,3
Tropical Depression,Katrina,10,1999-10-31T03:00:00Z,VENICE FL,0,0,0,11,11
Tropical Depression,Katrina,10,1999-10-31T03:00:00Z,MUCM 214N 779W,0,0,0,2,2
Tropical Depression,Katrina,10,1999-10-31T03:00:00Z,TAMPA FL,0,0,0,10,10
Tropical Depression,Katrina,10,1999-10-31T03:00:00Z,MUCF 221N 805W,0,0,0,6,6
Tropical Depression,Katrina,10,1999-10-31T03:00:00Z,CEDAR KEY FL,0,0,0,10,10
Tropical Depression,Katrina,10,1999-10-31T03:00:00Z,MUSN 216N 826W,0,0,3,6,9
Tropical Depression,Katrina,10,1999-10-31T03:00:00Z,ST MARKS FL,0,0,0,10,10
Tropical Depression,Katrina,10,1999-10-31T03:00:00Z,MUHA 230N 824W,0,0,2,8,10
Tropical Depression,Katrina,10,1999-10-31T03:00:00Z,APALACHICOLA FL,0,0,0,11,11
Tropical Depression,Katrina,10,1999-10-31T03:00:00Z,MUAN 219N 850W,0,5,9,2,16
Tropical Depression,Katrina,10,1999-10-31T03:00:00Z,PANAMA CITY FL,0,0,0,11,11
Tropical Depression,Katrina,10,1999-10-31T03:00:00Z,MMCZ 205N 869W,14,10,1,0,25
Tropical Depression,Katrina,10,1999-10-31T03:00:00Z,PENSACOLA FL,0,0,0,11,11
Tropical Depression,Katrina,10,1999-10-31T03:00:00Z,MZBZ 175N 883W,71,0,0,0,71
Tropical Depression,Katrina,10,1999-10-31T03:00:00Z,MOBILE AL,0,0,0,10,10
Tropical Depression,Katrina,10,1999-10-31T03:00:00Z,MHNJ 165N 859W,53,0,0,0,53
Tropical Depression,Katrina,10,1999-10-31T03:00:00Z,GULFPORT MS,0,0,0,10,10
Tropical Depression,Katrina,10,1999-10-31T03:00:00Z,MYAK 241N 776W,0,0,0,3,3
Tropical Depression,Katrina,10,1999-10-31T03:00:00Z,BURAS LA,0,0,1,10,11
Tropical Depression,Katrina,10,1999-10-31T03:00:00Z,MYNN 251N 775W,0,0,0,3,3
Tropical Depression,Katrina,10,1999-10-31T03:00:00Z,NEW ORLEANS LA,0,0,0,9,9
Tropical Depression,Katrina,10,1999-10-31T03:00:00Z,MYGF 266N 787W,0,0,0,5,5
Tropical Depression,Katrina,10,1999-10-31T03:00:00Z,NEW IBERIA LA,0,0,0,7,7
Tropical Depression,Katrina,10,1999-10-31T03:00:00Z,MMMD 210N 897W,18,9,0,0,27
Tropical Depression,Katrina,10,1999-10-31T03:00:00Z,PORT ARTHUR TX,0,0,0,4,4
Tropical Depression,Katrina,10,1999-10-31T03:00:00Z,MARATHON FL,0,0,0,9,9
Tropical Depression,Katrina,10,1999-10-31T03:00:00Z,GALVESTON TX,0,0,0,3,3
Tropical Depression,Katrina,10,1999-10-31T03:00:00Z,MIAMI FL,0,0,0,7,7
Tropical Depression,Katrina,10,1999-10-31T03:00:00Z,FREEPORT TX,0,0,0,2,2
Tropical Depression,Katrina,10,1999-10-31T03:00:00Z,W PALM BEACH FL,0,0,0,7,7
Tropical Depression,Katrina,10,1999-10-31T03:00:00Z,GULF 29N 85W,0,0,0,12,12
Tropical Depression,Katrina,10,1999-10-31T03:00:00Z,FT PIERCE FL,0,0,0,7,7
Tropical Depression,Katrina,10,1999-10-31T03:00:00Z,GULF 29N 87W,0,0,1,12,13
Tropical Depression,Katrina,10,1999-10-31T03:00:00Z,COCOA BEACH FL,0,0,0,7,7
Tropical Depression,Katrina,10,1999-10-31T03:00:00Z,GULF 28N 89W,0,0,4,10,14
Tropical Depression,Katrina,10,1999-10-31T03:00:00Z,DAYTONA BEACH FL,0,0,0,7,7
Tropical Depression,Katrina,10,1999-10-31T03:00:00Z,GULF 28N 91W,0,0,3,8,11
Tropical Depression,Katrina,10,1999-10-31T03:00:00Z,JACKSONVILLE FL,0,0,0,7,7
Tropical Depression,Katrina,10,1999-10-31T03:00:00Z,GULF 28N 93W,0,0,1,5,6
Tropical Depression,Katrina,10,1999-10-31T03:00:00Z,SAVANNAH GA,0,0,0,4,4
Tropical Depression,Katrina,10,1999-10-31T03:00:00Z,GULF 28N 95W,0,0,0,2,2
Tropical Depression,Katrina,10,1999-10-31T03:00:00Z,CHARLESTON SC,0,0,0,2,2
Tropical Depression,Katrina,11,1999-10-31T09:00:00Z,24.1N  89.0W,34,2,0,0,36
Tropical Depression,Katrina,11,1999-10-31T09:00:00Z,MOREHEAD CITY NC,0,0,0,8,8
Tropical Depression,Katrina,11,1999-10-31T09:00:00Z,26.9N  87.3W,1,23,2,1,27
Tropical Depression,Katrina,11,1999-10-31T09:00:00Z,CAPE HATTERAS NC,0,0,0,7,7
Tropical Depression,Katrina,11,1999-10-31T09:00:00Z,29.4N  84.5W,0,1,16,2,19
Tropical Depression,Katrina,11,1999-10-31T09:00:00Z,NORFOLK VA,0,0,0,6,6
Tropical Depression,Katrina,11,1999-10-31T09:00:00Z,MUCF 221N 805W,0,0,1,2,3
Tropical Depression,Katrina,11,1999-10-31T09:00:00Z,OCEAN CITY MD,0,0,0,4,4
Tropical Depression,Katrina,11,1999-10-31T09:00:00Z,MUSN 216N 826W,0,0,1,2,3
Tropical Depression,Katrina,11,1999-10-31T09:00:00Z,ATLANTIC CITY NJ,0,0,0,3,3
Tropical Depression,Katrina,11,1999-10-31T09:00:00Z,MUHA 230N 824W,0,0,3,3,6
Tropical Depression,Katrina,11,1999-10-31T09:00:00Z,NEW YORK CITY NY,0,0,0,2,2
Tropical Depression,Katrina,11,1999-10-31T09:00:00Z,MUAN 219N 850W,1,3,2,1,7
Tropical Depression,Katrina,11,1999-10-31T09:00:00Z,KEY WEST FL,0,0,5,4,9
Tropical Depression,Katrina,11,1999-10-31T09:00:00Z,MMCZ 205N 869W,20,0,0,0,20
Tropical Depression,Katrina,11,1999-10-31T09:00:00Z,MARCO ISLAND FL,0,0,7,5,12
Tropical Depression,Katrina,11,1999-10-31T09:00:00Z,MZBZ 175N 883W,99,0,0,0,99
Tropical Depression,Katrina,11,1999-10-31T09:00:00Z,FT MYERS FL,0,0,8,5,13
Tropical Depression,Katrina,11,1999-10-31T09:00:00Z,MYSM 241N 745W,0,0,0,2,2
Tropical Depression,Katrina,11,1999-10-31T09:00:00Z,VENICE FL,0,0,11,4,15
Tropical Depression,Katrina,11,1999-10-31T09:00:00Z,MYEG 235N 758W,0,0,0,2,2
Tropical Depression,Katrina,11,1999-10-31T09:00:00Z,TAMPA FL,0,0,11,5,16
Tropical Depression,Katrina,11,1999-10-31T09:00:00Z,MYAK 241N 776W,0,0,0,4,4
Tropical Depression,Katrina,11,1999-10-31T09:00:00Z,CEDAR KEY FL,0,0,12,5,17
Tropical Depression,Katrina,11,1999-10-31T09:00:00Z,MYNN 251N 775W,0,0,0,5,5
Tropical Depression,Katrina,11,1999-10-31T09:00:00Z,ST MARKS FL,0,0,14,4,18
Tropical Depression,Katrina,11,1999-10-31T09:00:00Z,MYGF 266N 787W,0,0,1,8,9
Tropical Depression,Katrina,11,1999-10-31T09:00:00Z,APALACHICOLA FL,0,1,16,2,19
Tropical Depression,Katrina,11,1999-10-31T09:00:00Z,MMMD 210N 897W,62,0,0,0,62
Tropical Depression,Katrina,11,1999-10-31T09:00:00Z,PANAMA CITY FL,0,1,16,2,19
Tropical Depression,Katrina,11,1999-10-31T09:00:00Z,MARATHON FL,0,0,4,5,9
Tropical Depression,Katrina,11,1999-10-31T09:00:00Z,PENSACOLA FL,0,2,14,1,17
Tropical Depression,Katrina,11,1999-10-31T09:00:00Z,MIAMI FL,0,0,3,7,10
Tropical Depression,Katrina,11,1999-10-31T09:00:00Z,MOBILE AL,0,2,12,1,15
Tropical Depression,Katrina,11,1999-10-31T09:00:00Z,W PALM BEACH FL,0,0,3,8,11
Tropical Depression,Katrina,11,1999-10-31T09:00:00Z,GULFPORT MS,0,4,9,1,14
Tropical Depression,Katrina,11,1999-10-31T09:00:00Z,FT PIERCE FL,0,0,3,9,12
Tropical Depression,Katrina,11,1999-10-31T09:00:00Z,BURAS LA,0,9,7,0,16
Tropical Depression,Katrina,11,1999-10-31T09:00:00Z,COCOA BEACH FL,0,0,4,9,13
Tropical Depression,Katrina,11,1999-10-31T09:00:00Z,NEW ORLEANS LA,0,4,7,0,11
Tropical Depression,Katrina,11,1999-10-31T09:00:00Z,DAYTONA BEACH FL,0,0,5,10,15
Tropical Depression,Katrina,11,1999-10-31T09:00:00Z,NEW IBERIA LA,0,2,2,1,5
Tropical Depression,Katrina,11,1999-10-31T09:00:00Z,JACKSONVILLE FL,0,0,5,10,15
Tropical Depression,Katrina,11,1999-10-31T09:00:00Z,GULF 29N 85W,0,2,17,1,20
Tropical Depression,Katrina,11,1999-10-31T09:00:00Z,SAVANNAH GA,0,0,2,12,14
Tropical Depression,Katrina,11,1999-10-31T09:00:00Z,GULF 29N 87W,0,8,13,1,22
Tropical Depression,Katrina,11,1999-10-31T09:00:00Z,CHARLESTON SC,0,0,0,12,12
Tropical Depression,Katrina,11,1999-10-31T09:00:00Z,GULF 28N 89W,0,19,3,1,23
Tropical Depression,Katrina,11,1999-10-31T09:00:00Z,MYRTLE BEACH SC,0,0,0,11,11
Tropical Depression,Katrina,11,1999-10-31T09:00:00Z,GULF 28N 91W,0,12,2,0,14
Tropical Depression,Katrina,11,1999-10-31T09:00:00Z,WILMINGTON NC,0,0,0,10,10
Tropical Depression,Katrina,11,1999-10-31T09:00:00Z,GULF 28N 93W,0,2,1,0,3
Tropical Depression,Katrina,12,1999-10-31T15:00:00Z,25.0N  87.3W,33,3,0,0,36
Tropical Depression,Katrina,12,1999-10-31T15:00:00Z,ATLANTIC CITY NJ,0,0,0,11,11
Tropical Depression,Katrina,12,1999-10-31T15:00:00Z,28.0N  84.5W,0,23,4,0,27
Tropical Depression,Katrina,12,1999-10-31T15:00:00Z,NEW YORK CITY NY,0,0,0,10,10
Tropical Depression,Katrina,12,1999-10-31T15:00:00Z,31.0N  79.5W,0,0,17,2,19
Tropical Depression,Katrina,12,1999-10-31T15:00:00Z,MONTAUK POINT NY,0,0,0,10,10
Tropical Depression,Katrina,12,1999-10-31T15:00:00Z,MUCF 221N 805W,0,0,2,0,2
Tropical Depression,Katrina,12,1999-10-31T15:00:00Z,PROVIDENCE RI,0,0,0,9,9
Tropical Depression,Katrina,12,1999-10-31T15:00:00Z,MUSN 216N 826W,0,2,0,0,2
Tropical Depression,Katrina,12,1999-10-31T15:00:00Z,NANTUCKET MA,0,0,0,9,9
Tropical Depression,Katrina,12,1999-10-31T15:00:00Z,MUHA 230N 824W,0,5,2,0,7
Tropical Depression,Katrina,12,1999-10-31T15:00:00Z,HYANNIS MA,0,0,0,8,8
Tropical Depression,Katrina,12,1999-10-31T15:00:00Z,MUAN 219N 850W,9,4,0,0,13
Tropical Depression,Katrina,12,1999-10-31T15:00:00Z,BOSTON MA,0,0,0,8,8
Tropical Depression,Katrina,12,1999-10-31T15:00:00Z,MMCZ 205N 869W,60,0,0,0,60
Tropical Depression,Katrina,12,1999-10-31T15:00:00Z,PORTLAND ME,0,0,0,6,6
Tropical Depression,Katrina,12,1999-10-31T15:00:00Z,MZBZ 175N 883W,2,0,0,0,2
Tropical Depression,Katrina,12,1999-10-31T15:00:00Z,BAR HARBOR ME,0,0,0,4,4
Tropical Depression,Katrina,12,1999-10-31T15:00:00Z,MYSM 241N 745W,0,0,0,3,3
Tropical Depression,Katrina,12,1999-10-31T15:00:00Z,EASTPORT ME,0,0,0,3,3
Tropical Depression,Katrina,12,1999-10-31T15:00:00Z,MYEG 235N 758W,0,0,1,1,2
Tropical Depression,Katrina,12,1999-10-31T15:00:00Z,ST JOHN NB,0,0,0,2,2
Tropical Depression,Katrina,12,1999-10-31T15:00:00Z,MYAK 241N 776W,0,0,3,2,5
Tropical Depression,Katrina,12,1999-10-31T15:00:00Z,YARMOUTH NS,0,0,0,3,3
Tropical Depression,Katrina,12,1999-10-31T15:00:00Z,MYNN 251N 775W,0,0,4,3,7
Tropical Depression,Katrina,12,1999-10-31T15:00:00Z,KEY WEST FL,0,6,6,0,12
Tropical Depression,Katrina,12,1999-10-31T15:00:00Z,MYGF 266N 787W,0,0,10,3,13
Tropical Depression,Katrina,12,1999-10-31T15:00:00Z,MARCO ISLAND FL,0,7,11,0,18
Tropical Depression,Katrina,12,1999-10-31T15:00:00Z,MMMD 210N 897W,47,0,0,0,47
Tropical Depression,Katrina,12,1999-10-31T15:00:00Z,FT MYERS FL,0,9,11,0,20
Tropical Depression,Katrina,12,1999-10-31T15:00:00Z,BERMUDA,0,0,0,3,3
Tropical Depression,Katrina,12,1999-10-31T15:00:00Z,VENICE FL,0,13,10,0,23
Tropical Depression,Katrina,12,1999-10-31T15:00:00Z,MARATHON FL,0,3,8,0,11
Tropical Depression,Katrina,12,1999-10-31T15:00:00Z,TAMPA FL,0,11,13,0,24
Tropical Depression,Katrina,12,1999-10-31T15:00:00Z,MIAMI FL,0,2,11,0,13
Tropical Depression,Katrina,12,1999-10-31T15:00:00Z,CEDAR KEY FL,0,11,13,1,25
Tropical Depression,Katrina,12,1999-10-31T15:00:00Z,W PALM BEACH FL,0,1,14,1,16
Tropical Depression,Katrina,12,1999-10-31T15:00:00Z,ST MARKS FL,0,12,10,0,22
Tropical Depression,Katrina,12,1999-10-31T15:00:00Z,FT PIERCE FL,0,2,15,1,18
Tropical Depression,Katrina,12,1999-10-31T15:00:00Z,APALACHICOLA FL,0,16,7,0,23
Tropical Depression,Katrina,12,1999-10-31T15:00:00Z,COCOA BEACH FL,0,2,17,1,20
Tropical Depression,Katrina,12,1999-10-31T15:00:00Z,PANAMA CITY FL,0,15,6,0,21
Tropical Depression,Katrina,12,1999-10-31T15:00:00Z,DAYTONA BEACH FL,0,2,19,1,22
Tropical Depression,Katrina,12,1999-10-31T15:00:00Z,PENSACOLA FL,0,10,3,0,13
Tropical Depression,Katrina,12,1999-10-31T15:00:00Z,JACKSONVILLE FL,0,2,19,1,22
Tropical Depression,Katrina,12,1999-10-31T15:00:00Z,MOBILE AL,0,5,2,0,7
Tropical Depression,Katrina,12,1999-10-31T15:00:00Z,SAVANNAH GA,0,0,17,2,19
Tropical Depression,Katrina,12,1999-10-31T15:00:00Z,GULFPORT MS,0,4,0,0,4
Tropical Depression,Katrina,12,1999-10-31T15:00:00Z,CHARLESTON SC,0,0,14,4,18
Tropical Depression,Katrina,12,1999-10-31T15:00:00Z,BURAS LA,0,4,1,0,5
Tropical Depression,Katrina,12,1999-10-31T15:00:00Z,MYRTLE BEACH SC,0,0,9,8,17
Tropical Depression,Katrina,12,1999-10-31T15:00:00Z,NEW ORLEANS LA,0,2,0,0,2
Tropical Depression,Katrina,12,1999-10-31T15:00:00Z,WILMINGTON NC,0,0,6,11,17
Tropical Depression,Katrina,12,1999-10-31T15:00:00Z,GULF 29N 85W,0,20,5,0,25
Tropical Depression,Katrina,12,1999-10-31T15:00:00Z,MOREHEAD CITY NC,0,0,3,13,16
Tropical Depression,Katrina,12,1999-10-31T15:00:00Z,GULF 29N 87W,1,18,1,0,20
Tropical Depression,Katrina,12,1999-10-31T15:00:00Z,CAPE HATTERAS NC,0,0,1,15,16
Tropical Depression,Katrina,12,1999-10-31T15:00:00Z,GULF 28N 89W,3,10,1,0,14
Tropical Depression,Katrina,12,1999-10-31T15:00:00Z,NORFOLK VA,0,0,1,13,14
Tropical Depression,Katrina,12,1999-10-31T15:00:00Z,GULF 28N 91W,0,2,0,0,2
Tropical Depression,Katrina,12,1999-10-31T15:00:00Z,OCEAN CITY MD,0,0,0,13,13
Tropical Depression,Katrina,13,1999-10-31T21:00:00Z,22.4N  89.9W,34,1,1,0,36
Tropical Depression,Katrina,13,1999-10-31T21:00:00Z,CAPE HATTERAS NC,0,0,0,12,12
Tropical Depression,Katrina,13,1999-10-31T21:00:00Z,25.0N  87.8W,0,27,4,0,31
Tropical Depression,Katrina,13,1999-10-31T21:00:00Z,NORFOLK VA,0,0,0,10,10
Tropical Depression,Katrina,13,1999-10-31T21:00:00Z,27.5N  84.0W,0,0,20,5,25
Tropical Depression,Katrina,13,1999-10-31T21:00:00Z,OCEAN CITY MD,0,0,0,7,7
Tropical Depression,Katrina,13,1999-10-31T21:00:00Z,MUHA 230N 824W,0,0,4,1,5
Tropical Depression,Katrina,13,1999-10-31T21:00:00Z,ATLANTIC CITY NJ,0,0,0,4,4
Tropical Depression,Katrina,13,1999-10-31T21:00:00Z,MUAN 219N 850W,0,5,1,0,6
Tropical Depression,Katrina,13,1999-10-31T21:00:00Z,NEW YORK CITY NY,0,0,0,3,3
Tropical Depression,Katrina,13,1999-10-31T21:00:00Z,MMCZ 205N 869W,8,2,0,0,10
Tropical Depression,Katrina,13,1999-10-31T21:00:00Z,MONTAUK POINT NY,0,0,0,2,2
Tropical Depression,Katrina,13,1999-10-31T21:00:00Z,MYSM 241N 745W,0,0,0,2,2
Tropical Depression,Katrina,13,1999-10-31T21:00:00Z,KEY WEST FL,0,0,8,3,11
Tropical Depression,Katrina,13,1999-10-31T21:00:00Z,MYEG 235N 758W,0,0,0,2,2
Tropical Depression,Katrina,13,1999-10-31T21:00:00Z,MARCO ISLAND FL,0,0,10,8,18
Tropical Depression,Katrina,13,1999-10-31T21:00:00Z,MYAK 241N 776W,0,0,0,4,4
Tropical Depression,Katrina,13,1999-10-31T21:00:00Z,FT MYERS FL,0,0,11,9,20
Tropical Depression,Katrina,13,1999-10-31T21:00:00Z,MYNN 251N 775W,0,0,0,6,6
Tropical Depression,Katrina,13,1999-10-31T21:00:00Z,VENICE FL,0,0,13,9,22
Tropical Depression,Katrina,13,1999-10-31T21:00:00Z,MYGF 266N 787W,0,0,1,12,13
Tropical Depression,Katrina,13,1999-10-31T21:00:00Z,TAMPA FL,0,0,10,12,22
Tropical Depression,Katrina,13,1999-10-31T21:00:00Z,MMMD 210N 897W,65,0,0,0,65
Tropical Depression,Katrina,13,1999-10-31T21:00:00Z,CEDAR KEY FL,0,0,8,14,22
Tropical Depression,Katrina,13,1999-10-31T21:00:00Z,BERMUDA,0,0,0,2,2
Tropical Depression,Katrina,13,1999-10-31T21:00:00Z,ST MARKS FL,0,0,7,13,20
Tropical Depression,Katrina,13,1999-10-31T21:00:00Z,MARATHON FL,0,0,6,4,10
Tropical Depression,Katrina,13,1999-10-31T21:00:00Z,APALACHICOLA FL,0,0,12,9,21
Tropical Depression,Katrina,13,1999-10-31T21:00:00Z,MIAMI FL,0,0,4,10,14
Tropical Depression,Katrina,13,1999-10-31T21:00:00Z,PANAMA CITY FL,0,0,11,8,19
Tropical Depression,Katrina,13,1999-10-31T21:00:00Z,W PALM BEACH FL,0,0,3,13,16
Tropical Depression,Katrina,13,1999-10-31T21:00:00Z,PENSACOLA FL,0,0,8,5,13
Tropical Depression,Katrina,13,1999-10-31T21:00:00Z,FT PIERCE FL,0,0,3,15,18
Tropical Depression,Katrina,13,1999-10-31T21:00:00Z,MOBILE AL,0,0,6,2,8
Tropical Depression,Katrina,13,1999-10-31T21:00:00Z,COCOA BEACH FL,0,0,2,18,20
Tropical Depression,Katrina,13,1999-10-31T21:00:00Z,GULFPORT MS,0,0,6,1,7
Tropical Depression,Katrina,13,1999-10-31T21:00:00Z,DAYTONA BEACH FL,0,0,2,19,21
Tropical Depression,Katrina,13,1999-10-31T21:00:00Z,BURAS LA,0,0,9,0,9
Tropical Depression,Katrina,13,1999-10-31T21:00:00Z,JACKSONVILLE FL,0,0,1,19,20
Tropical Depression,Katrina,13,1999-10-31T21:00:00Z,NEW ORLEANS LA,0,0,4,1,5
Tropical Depression,Katrina,13,1999-10-31T21:00:00Z,SAVANNAH GA,0,0,0,17,17
Tropical Depression,Katrina,13,1999-10-31T21:00:00Z,GULF 29N 85W,0,0,16,7,23
Tropical Depression,Katrina,13,1999-10-31T21:00:00Z,CHARLESTON SC,0,0,0,16,16
Tropical Depression,Katrina,13,1999-10-31T21:00:00Z,GULF 29N 87W,0,0,18,2,20
Tropical Depression,Katrina,13,1999-10-31T21:00:00Z,MYRTLE BEACH SC,0,0,0,15,15
Tropical Depression,Katrina,13,1999-10-31T21:00:00Z,GULF 28N 89W,0,4,15,0,19
Tropical Depression,Katrina,13,1999-10-31T21:00:00Z,WILMINGTON NC,0,0,0,14,14
Tropical Depression,Katrina,13,1999-10-31T21:00:00Z,GULF 28N 91W,0,3,5,0,8
Tropical Depression,Katrina,13,1999-10-31T21:00:00Z,MOREHEAD CITY NC,0,0,0,14,14
Tropical Depression,Katrina,14,1999-11-01T03:00:00Z,23.3N  89.0W,34,8,0,0,42
Tropical Depression,Katrina,14,1999-11-01T03:00:00Z,MARCO ISLAND FL,0,0,18,0,18
Tropical Depression,Katrina,14,1999-11-01T03:00:00Z,26.0N  86.0W,0,27,8,0,35
Tropical Depression,Katrina,14,1999-11-01T03:00:00Z,FT MYERS FL,0,0,21,0,21
Tropical Depression,Katrina,14,1999-11-01T03:00:00Z,29.0N  81.5W,0,0,18,0,18
Tropical Depression,Katrina,14,1999-11-01T03:00:00Z,VENICE FL,0,1,24,0,25
Tropical Depression,Katrina,14,1999-11-01T03:00:00Z,MUHA 230N 824W,0,1,3,0,4
Tropical Depression,Katrina,14,1999-11-01T03:00:00Z,TAMPA FL,0,0,25,0,25
Tropical Depression,Katrina,14,1999-11-01T03:00:00Z,MUAN 219N 850W,1,4,0,0,5
Tropical Depression,Katrina,14,1999-11-01T03:00:00Z,CEDAR KEY FL,0,0,23,0,23
Tropical Depression,Katrina,14,1999-11-01T03:00:00Z,MMCZ 205N 869W,3,0,0,0,3
Tropical Depression,Katrina,14,1999-11-01T03:00:00Z,ST MARKS FL,0,0,18,0,18
Tropical Depression,Katrina,14,1999-11-01T03:00:00Z,MYGF 266N 787W,0,0,5,0,5
Tropical Depression,Katrina,14,1999-11-01T03:00:00Z,APALACHICOLA FL,0,0,20,0,20
Tropical Depression,Katrina,14,1999-11-01T03:00:00Z,MMMD 210N 897W,99,0,0,0,99
Tropical Depression,Katrina,14,1999-11-01T03:00:00Z,PANAMA CITY FL,0,0,17,0,17
Tropical Depression,Katrina,14,1999-11-01T03:00:00Z,MARATHON FL,0,0,9,0,9
Tropical Depression,Katrina,14,1999-11-01T03:00:00Z,PENSACOLA FL,0,0,8,0,8
Tropical Depression,Katrina,14,1999-11-01T03:00:00Z,MIAMI FL,0,0,10,0,10
Tropical Depression,Katrina,14,1999-11-01T03:00:00Z,MOBILE AL,0,0,4,0,4
Tropical Depression,Katrina,14,1999-11-01T03:00:00Z,W PALM BEACH FL,0,0,12,0,12
Tropical Depression,Katrina,14,1999-11-01T03:00:00Z,GULFPORT MS,0,0,2,0,2
Tropical Depression,Katrina,14,1999-11-01T03:00:00Z,FT PIERCE FL,0,0,13,0,13
Tropical Depression,Katrina,14,1999-11-01T03:00:00Z,BURAS LA,0,1,2,0,3
Tropical Depression,Katrina,14,1999-11-01T03:00:00Z,COCOA BEACH FL,0,0,15,0,15
Tropical Depression,Katrina,14,1999-11-01T03:00:00Z,GULF 29N 85W,0,1,23,0,24
Tropical Depression,Katrina,14,1999-11-01T03:00:00Z,DAYTONA BEACH FL,0,0,15,0,15
Tropical Depression,Katrina,14,1999-11-01T03:00:00Z,GULF 29N 87W,0,2,16,0,18
Tropical Depression,Katrina,14,1999-11-01T03:00:00Z,JACKSONVILLE FL,0,0,12,0,12
Tropical Depression,Katrina,14,1999-11-01T03:00:00Z,GULF 28N 89W,0,6,5,0,11
Tropical Depression,Katrina,14,1999-11-01T03:00:00Z,SAVANNAH GA,0,0,4,0,4
Tropical Depression,Katrina,14,1999-11-01T03:00:00Z,GULF 28N 91W,0,1,1,0,2
Tropical Depression,Katrina,14,1999-11-01T03:00:00Z,KEY WEST FL,0,1,10,0,11
Tropical Depression,Katrina,15,1999-11-01T09:00:00Z,22.5N  87.3W,33,0,0,0,33
Tropical Depression,Katrina,15,1999-11-01T09:00:00Z,MUAN 219N 850W,7,16,0,0,23
Tropical Depression,Katrina,15,1999-11-01T09:00:00Z,23.4N  84.9W,4,18,0,0,22
Tropical Depression,Katrina,15,1999-11-01T09:00:00Z,MMCZ 205N 869W,22,2,0,0,24
Tropical Depression,Katrina,15,1999-11-01T09:00:00Z,MUSN 216N 826W,0,5,0,0,5
Tropical Depression,Katrina,15,1999-11-01T09:00:00Z,MMMD 210N 897W,99,0,0,0,99
Tropical Depression,Katrina,15,1999-11-01T09:00:00Z,MUHA 230N 824W,0,5,0,0,5
Tropical Depression,Katrina,15,1999-11-01T09:00:00Z,KEY WEST FL,0,2,0,0,2
Tropical Depression,Katrina,16,1999-11-01T15:00:00Z,22.6N  86.2W,34,1,0,0,35
Tropical Depression,Katrina,16,1999-11-01T15:00:00Z,MIAMI FL,0,7,0,0,7
Tropical Depression,Katrina,16,1999-11-01T15:00:00Z,23.5N  83.5W,7,17,0,0,24
Tropical Depression,Katrina,16,1999-11-01T15:00:00Z,W PALM BEACH FL,0,4,0,0,4
Tropical Depression,Katrina,16,1999-11-01T15:00:00Z,MUCF 221N 805W,0,6,0,0,6
Tropical Depression,Katrina,16,1999-11-01T15:00:00Z,FT PIERCE FL,0,3,0,0,3
Tropical Depression,Katrina,16,1999-11-01T15:00:00Z,MUSN 216N 826W,2,14,0,0,16
Tropical Depression,Katrina,16,1999-11-01T15:00:00Z,COCOA BEACH FL,0,2,0,0,2
Tropical Depression,Katrina,16,1999-11-01T15:00:00Z,MUHA 230N 824W,2,18,0,0,20
Tropical Depression,Katrina,16,1999-11-01T15:00:00Z,KEY WEST FL,0,17,0,0,17
Tropical Depression,Katrina,16,1999-11-01T15:00:00Z,MUAN 219N 850W,25,4,0,0,29
Tropical Depression,Katrina,16,1999-11-01T15:00:00Z,MARCO ISLAND FL,0,11,0,0,11
Tropical Depression,Katrina,16,1999-11-01T15:00:00Z,MMCZ 205N 869W,37,0,0,0,37
Tropical Depression,Katrina,16,1999-11-01T15:00:00Z,FT MYERS FL,0,8,0,0,8
Tropical Depression,Katrina,16,1999-11-01T15:00:00Z,MYGF 266N 787W,0,2,0,0,2
Tropical Depression,Katrina,16,1999-11-01T15:00:00Z,VENICE FL,0,6,0,0,6
Tropical Depression,Katrina,16,1999-11-01T15:00:00Z,MMMD 210N 897W,99,0,0,0,99
Tropical Depression,Katrina,16,1999-11-01T15:00:00Z,TAMPA FL,0,3,0,0,3
Tropical Depression,Katrina,16,1999-11-01T15:00:00Z,MARATHON FL,0,13,0,0,13
Tropical Depression,Test,1,1999-11-13T21:00:00Z,15.7N  80.0W,46,0,0,0,46
Tropical Depression,Test,1,1999-11-13T21:00:00Z,MUCF 221N 805W,0,0,1,5,6
Tropical Depression,Test,1,1999-11-13T21:00:00Z,15.8N  78.8W,26,2,1,0,29
Tropical Depression,Test,1,1999-11-13T21:00:00Z,MUSN 216N 826W,0,0,1,3,4
Tropical Depression,Test,1,1999-11-13T21:00:00Z,16.0N  77.5W,6,11,3,2,22
Tropical Depression,Test,1,1999-11-13T21:00:00Z,MUHA 230N 824W,0,0,0,2,2
Tropical Depression,Test,1,1999-11-13T21:00:00Z,SKPG 125N 717W,0,0,0,8,8
Tropical Depression,Test,1,1999-11-13T21:00:00Z,MNPC 141N 834W,0,1,1,1,3
Tropical Depression,Test,1,1999-11-13T21:00:00Z,TNCC 122N 690W,0,0,0,4,4
Tropical Depression,Test,1,1999-11-13T21:00:00Z,SKSP 126N 817W,0,0,2,1,3
Tropical Depression,Test,1,1999-11-13T21:00:00Z,TJPS 180N 666W,0,0,0,2,2
Tropical Depression,Test,1,1999-11-13T21:00:00Z,TJSJ 184N 661W,0,0,0,2,2
Tropical Depression,Test,1,1999-11-13T21:00:00Z,MDSD 185N 697W,0,0,0,7,7
Tropical Depression,Test,1,1999-11-13T21:00:00Z,MDPP 198N 707W,0,0,0,7,7
Tropical Depression,Test,1,1999-11-13T21:00:00Z,MDCB 176N 714W,0,0,0,10,10
Tropical Depression,Test,1,1999-11-13T21:00:00Z,MBJT 215N 712W,0,0,0,5,5
Tropical Depression,Test,1,1999-11-13T21:00:00Z,MTPP 186N 724W,0,0,0,11,11
Tropical Depression,Test,1,1999-11-13T21:00:00Z,MYMM 224N 730W,0,0,0,6,6
Tropical Depression,Test,1,1999-11-13T21:00:00Z,MTCA 183N 738W,0,0,1,12,13
Tropical Depression,Test,1,1999-11-13T21:00:00Z,MYSM 241N 745W,0,0,0,4,4
Tropical Depression,Test,1,1999-11-13T21:00:00Z,MKJP 179N 768W,0,2,9,6,17
Tropical Depression,Test,1,1999-11-13T21:00:00Z,MYEG 235N 758W,0,0,0,5,5
Tropical Depression,Test,1,1999-11-13T21:00:00Z,MKJS 185N 779W,0,4,8,5,17
Tropical Depression,Test,1,1999-11-13T21:00:00Z,MYAK 241N 776W,0,0,0,4,4
Tropical Depression,Test,1,1999-11-13T21:00:00Z,MWCG 193N 814W,0,5,5,2,12
Tropical Depression,Test,1,1999-11-13T21:00:00Z,MYNN 251N 775W,0,0,0,2,2
Tropical Depression,Test,1,1999-11-13T21:00:00Z,MUGM 200N 751W,0,0,1,11,12
Tropical Depression,Test,1,1999-11-13T21:00:00Z,SAN JUAN PR,0,0,0,2,2
Tropical Depression,Test,1,1999-11-13T21:00:00Z,MUCM 214N 779W,0,0,1,8,9
Tropical Depression,Test,1,1999-11-13T21:00:00Z,PONCE PR,0,0,0,2,2
Tropical Depression,Sixteen,2,1999-11-14T03:00:00Z,16.0N  77.7W,33,1,0,0,34
Tropical Depression,Sixteen,2,1999-11-14T03:00:00Z,MDCB 176N 714W,0,0,5,10,15
Tropical Depression,Sixteen,2,1999-11-14T03:00:00Z,16.3N  75.9W,13,10,2,1,26
Tropical Depression,Sixteen,2,1999-11-14T03:00:00Z,MTPP 186N 724W,0,0,3,11,14
Tropical Depression,Sixteen,2,1999-11-14T03:00:00Z,16.7N  74.0W,1,8,9,3,21
Tropical Depression,Sixteen,2,1999-11-14T03:00:00Z,MTCA 183N 738W,0,1,7,7,15
Tropical Depression,Sixteen,2,1999-11-14T03:00:00Z,SKPG 125N 717W,0,0,5,5,10
Tropical Depression,Sixteen,2,1999-11-14T03:00:00Z,MKJP 179N 768W,5,6,4,3,18
Tropical Depression,Sixteen,2,1999-11-14T03:00:00Z,TNCC 122N 690W,0,0,1,7,8
Tropical Depression,Sixteen,2,1999-11-14T03:00:00Z,MKJS 185N 779W,2,4,4,4,14
Tropical Depression,Sixteen,2,1999-11-14T03:00:00Z,SVMG 110N 640W,0,0,0,2,2
Tropical Depression,Sixteen,2,1999-11-14T03:00:00Z,MWCG 193N 814W,0,0,1,3,4
Tropical Depression,Sixteen,2,1999-11-14T03:00:00Z,TGPY 120N 618W,0,0,0,2,2
Tropical Depression,Sixteen,2,1999-11-14T03:00:00Z,MUGM 200N 751W,0,0,1,9,10
Tropical Depression,Sixteen,2,1999-11-14T03:00:00Z,TVSV 131N 612W,0,0,0,2,2
Tropical Depression,Sixteen,2,1999-11-14T03:00:00Z,MUCM 214N 779W,0,0,0,5,5
Tropical Depression,Sixteen,2,1999-11-14T03:00:00Z,TLPL 138N 610W,0,0,0,2,2
Tropical Depression,Sixteen,2,1999-11-14T03:00:00Z,MUCF 221N 805W,0,0,0,2,2
Tropical Depression,Sixteen,2,1999-11-14T03:00:00Z,TFFF 146N 610W,0,0,0,2,2
Tropical Depression,Sixteen,2,1999-11-14T03:00:00Z,TJSJ 184N 661W,0,0,0,6,6
Tropical Depression,Sixteen,2,1999-11-14T03:00:00Z,TDPR 153N 614W,0,0,0,2,2
Tropical Depression,Sixteen,2,1999-11-14T03:00:00Z,MDPP 198N 707W,0,0,0,9,9
Tropical Depression,Sixteen,2,1999-11-14T03:00:00Z,TFFR 163N 615W,0,0,0,2,2
Tropical Depression,Sixteen,2,1999-11-14T03:00:00Z,MBJT 215N 712W,0,0,0,6,6
Tropical Depression,Sixteen,2,1999-11-14T03:00:00Z,TAPA 171N 618W,0,0,0,2,2
Tropical Depression,Sixteen,2,1999-11-14T03:00:00Z,MYMM 224N 730W,0,0,0,4,4
Tropical Depression,Sixteen,2,1999-11-14T03:00:00Z,TKPK 173N 627W,0,0,0,3,3
Tropical Depression,Sixteen,2,1999-11-14T03:00:00Z,MYSM 241N 745W,0,0,0,2,2
Tropical Depression,Sixteen,2,1999-11-14T03:00:00Z,TNCM 181N 631W,0,0,0,3,3
Tropical Depression,Sixteen,2,1999-11-14T03:00:00Z,MYEG 235N 758W,0,0,0,2,2
Tropical Depression,Sixteen,2,1999-11-14T03:00:00Z,TISX 177N 648W,0,0,0,5,5
Tropical Depression,Sixteen,2,1999-11-14T03:00:00Z,ST CROIX VI,0,0,0,5,5
Tropical Depression,Sixteen,2,1999-11-14T03:00:00Z,TIST 183N 650W,0,0,0,5,5
Tropical Depression,Sixteen,2,1999-11-14T03:00:00Z,ST THOMAS VI,0,0,0,5,5
Tropical Depression,Sixteen,2,1999-11-14T03:00:00Z,TJPS 180N 666W,0,0,0,7,7
Tropical Depression,Sixteen,2,1999-11-14T03:00:00Z,SAN JUAN PR,0,0,0,6,6
Tropical Depression,Sixteen,2,1999-11-14T03:00:00Z,MDSD 185N 697W,0,0,1,10,11
Tropical Depression,Sixteen,2,1999-11-14T03:00:00Z,PONCE PR,0,0,0,7,7
Tropical Depression,Sixteen,3,1999-11-14T09:00:00Z,16.2N  76.5W,34,0,0,0,34
Tropical Depression,Sixteen,3,1999-11-14T09:00:00Z,MDCB 176N 714W,0,4,8,5,17
Tropical Depression,Sixteen,3,1999-11-14T09:00:00Z,16.5N  74.5W,9,11,2,1,23
Tropical Depression,Sixteen,3,1999-11-14T09:00:00Z,MTPP 186N 724W,0,5,6,5,16
Tropical Depression,Sixteen,3,1999-11-14T09:00:00Z,17.0N  72.5W,0,10,6,3,19
Tropical Depression,Sixteen,3,1999-11-14T09:00:00Z,MTCA 183N 738W,1,9,4,4,18
Tropical Depression,Sixteen,3,1999-11-14T09:00:00Z,SKPG 125N 717W,0,1,6,4,11
Tropical Depression,Sixteen,3,1999-11-14T09:00:00Z,MKJP 179N 768W,12,5,1,1,19
Tropical Depression,Sixteen,3,1999-11-14T09:00:00Z,TNCC 122N 690W,0,0,2,7,9
Tropical Depression,Sixteen,3,1999-11-14T09:00:00Z,MKJS 185N 779W,3,5,3,2,13
Tropical Depression,Sixteen,3,1999-11-14T09:00:00Z,SVMG 110N 640W,0,0,0,3,3
Tropical Depression,Sixteen,3,1999-11-14T09:00:00Z,MWCG 193N 814W,0,0,1,3,4
Tropical Depression,Sixteen,3,1999-11-14T09:00:00Z,TTPT 112N 608W,0,0,0,2,2
Tropical Depression,Sixteen,3,1999-11-14T09:00:00Z,MUGM 200N 751W,0,3,5,4,12
Tropical Depression,Sixteen,3,1999-11-14T09:00:00Z,TGPY 120N 618W,0,0,0,3,3
Tropical Depression,Sixteen,3,1999-11-14T09:00:00Z,MUCM 214N 779W,0,0,1,5,6
Tropical Depression,Sixteen,3,1999-11-14T09:00:00Z,TBPB 131N 595W,0,0,0,2,2
Tropical Depression,Sixteen,3,1999-11-14T09:00:00Z,MUCF 221N 805W,0,0,0,2,2
Tropical Depression,Sixteen,3,1999-11-14T09:00:00Z,TVSV 131N 612W,0,0,0,3,3
Tropical Depression,Sixteen,3,1999-11-14T09:00:00Z,TJSJ 184N 661W,0,0,1,8,9
Tropical Depression,Sixteen,3,1999-11-14T09:00:00Z,TLPL 138N 610W,0,0,0,3,3
Tropical Depression,Sixteen,3,1999-11-14T09:00:00Z,MDPP 198N 707W,0,0,5,7,12
Tropical Depression,Sixteen,3,1999-11-14T09:00:00Z,TFFF 146N 610W,0,0,0,3,3
Tropical Depression,Sixteen,3,1999-11-14T09:00:00Z,MBJT 215N 712W,0,0,2,6,8
Tropical Depression,Sixteen,3,1999-11-14T09:00:00Z,TDPR 153N 614W,0,0,0,4,4
Tropical Depression,Sixteen,3,1999-11-14T09:00:00Z,MYMM 224N 730W,0,0,1,5,6
Tropical Depression,Sixteen,3,1999-11-14T09:00:00Z,TFFR 163N 615W,0,0,0,4,4
Tropical Depression,Sixteen,3,1999-11-14T09:00:00Z,MYSM 241N 745W,0,0,0,3,3
Tropical Depression,Sixteen,3,1999-11-14T09:00:00Z,TAPA 171N 618W,0,0,0,4,4
Tropical Depression,Sixteen,3,1999-11-14T09:00:00Z,MYEG 235N 758W,0,0,0,3,3
Tropical Depression,Sixteen,3,1999-11-14T09:00:00Z,TKPK 173N 627W,0,0,0,5,5
Tropical Depression,Sixteen,3,1999-11-14T09:00:00Z,MYAK 241N 776W,0,0,0,2,2
Tropical Depression,Sixteen,3,1999-11-14T09:00:00Z,TNCM 181N 631W,0,0,0,5,5
Tropical Depression,Sixteen,3,1999-11-14T09:00:00Z,ST CROIX VI,0,0,0,8,8
Tropical Depression,Sixteen,3,1999-11-14T09:00:00Z,TISX 177N 648W,0,0,0,8,8
Tropical Depression,Sixteen,3,1999-11-14T09:00:00Z,ST THOMAS VI,0,0,0,8,8
Tropical Depression,Sixteen,3,1999-11-14T09:00:00Z,TIST 183N 650W,0,0,0,8,8
Tropical Depression,Sixteen,3,1999-11-14T09:00:00Z,SAN JUAN PR,0,0,1,8,9
Tropical Depression,Sixteen,3,1999-11-14T09:00:00Z,TJPS 180N 666W,0,0,1,9,10
Tropical Depression,Sixteen,3,1999-11-14T09:00:00Z,PONCE PR,0,0,1,9,10
Tropical Depression,Sixteen,3,1999-11-14T09:00:00Z,MDSD 185N 697W,0,0,6,8,14
Tropical Depression,Sixteen,4,1999-11-14T15:00:00Z,16.2N  76.4W,32,0,1,0,33
Tropical Depression,Sixteen,4,1999-11-14T15:00:00Z,TJPS 180N 666W,0,0,3,10,13
Tropical Depression,Sixteen,4,1999-11-14T15:00:00Z,16.5N  74.0W,6,14,2,0,22
Tropical Depression,Sixteen,4,1999-11-14T15:00:00Z,MDSD 185N 697W,0,1,8,6,15
Tropical Depression,Sixteen,4,1999-11-14T15:00:00Z,17.0N  71.2W,0,7,8,3,18
Tropical Depression,Sixteen,4,1999-11-14T15:00:00Z,MDCB 176N 714W,0,6,8,4,18
Tropical Depression,Sixteen,4,1999-11-14T15:00:00Z,SKPG 125N 717W,0,2,6,4,12
Tropical Depression,Sixteen,4,1999-11-14T15:00:00Z,MTPP 186N 724W,0,5,8,3,16
Tropical Depression,Sixteen,4,1999-11-14T15:00:00Z,TNCC 122N 690W,0,0,4,5,9
Tropical Depression,Sixteen,4,1999-11-14T15:00:00Z,MTCA 183N 738W,1,9,5,2,17
Tropical Depression,Sixteen,4,1999-11-14T15:00:00Z,SVMG 110N 640W,0,0,0,4,4
Tropical Depression,Sixteen,4,1999-11-14T15:00:00Z,MKJP 179N 768W,9,7,1,0,17
Tropical Depression,Sixteen,4,1999-11-14T15:00:00Z,TTPP 106N 614W,0,0,0,2,2
Tropical Depression,Sixteen,4,1999-11-14T15:00:00Z,MKJS 185N 779W,2,6,1,1,10
Tropical Depression,Sixteen,4,1999-11-14T15:00:00Z,TTPT 112N 608W,0,0,0,2,2
Tropical Depression,Sixteen,4,1999-11-14T15:00:00Z,MUGM 200N 751W,0,2,4,4,10
Tropical Depression,Sixteen,4,1999-11-14T15:00:00Z,TGPY 120N 618W,0,0,0,4,4
Tropical Depression,Sixteen,4,1999-11-14T15:00:00Z,MUCM 214N 779W,0,0,1,1,2
Tropical Depression,Sixteen,4,1999-11-14T15:00:00Z,TBPB 131N 595W,0,0,0,2,2
Tropical Depression,Sixteen,4,1999-11-14T15:00:00Z,TJSJ 184N 661W,0,0,2,10,12
Tropical Depression,Sixteen,4,1999-11-14T15:00:00Z,TVSV 131N 612W,0,0,0,4,4
Tropical Depression,Sixteen,4,1999-11-14T15:00:00Z,MDPP 198N 707W,0,1,5,7,13
Tropical Depression,Sixteen,4,1999-11-14T15:00:00Z,TLPL 138N 610W,0,0,0,4,4
Tropical Depression,Sixteen,4,1999-11-14T15:00:00Z,MBJT 215N 712W,0,0,2,7,9
Tropical Depression,Sixteen,4,1999-11-14T15:00:00Z,TFFF 146N 610W,0,0,0,5,5
Tropical Depression,Sixteen,4,1999-11-14T15:00:00Z,MYMM 224N 730W,0,0,1,5,6
Tropical Depression,Sixteen,4,1999-11-14T15:00:00Z,TDPR 153N 614W,0,0,0,6,6
Tropical Depression,Sixteen,4,1999-11-14T15:00:00Z,MYSM 241N 745W,0,0,0,2,2
Tropical Depression,Sixteen,4,1999-11-14T15:00:00Z,TFFR 163N 615W,0,0,0,6,6
Tropical Depression,Sixteen,4,1999-11-14T15:00:00Z,MYEG 235N 758W,0,0,0,2,2
Tropical Depression,Sixteen,4,1999-11-14T15:00:00Z,TAPA 171N 618W,0,0,0,7,7
Tropical Depression,Sixteen,4,1999-11-14T15:00:00Z,ST CROIX VI,0,0,1,10,11
Tropical Depression,Sixteen,4,1999-11-14T15:00:00Z,TKPK 173N 627W,0,0,0,8,8
Tropical Depression,Sixteen,4,1999-11-14T15:00:00Z,ST THOMAS VI,0,0,1,10,11
Tropical Depression,Sixteen,4,1999-11-14T15:00:00Z,TNCM 181N 631W,0,0,0,8,8
Tropical Depression,Sixteen,4,1999-11-14T15:00:00Z,SAN JUAN PR,0,0,2,10,12
Tropical Depression,Sixteen,4,1999-11-14T15:00:00Z,TISX 177N 648W,0,0,1,10,11
Tropical Depression,Sixteen,4,1999-11-14T15:00:00Z,PONCE PR,0,0,3,10,13
Tropical Depression,Sixteen,4,1999-11-14T15:00:00Z,TIST 183N 650W,0,0,1,10,11
Tropical Storm,Lenny,6,1999-11-14T21:00:00Z,16.5N  76.4W,34,0,1,0,35
Tropical Storm,Lenny,6,1999-11-14T21:00:00Z,TJPS 180N 666W,0,0,3,11,14
Tropical Storm,Lenny,6,1999-11-14T21:00:00Z,16.6N  74.0W,5,19,1,1,26
Tropical Storm,Lenny,6,1999-11-14T21:00:00Z,MDSD 185N 697W,0,1,9,6,16
Tropical Storm,Lenny,6,1999-11-14T21:00:00Z,17.0N  71.2W,0,6,11,3,20
Tropical Storm,Lenny,6,1999-11-14T21:00:00Z,MDCB 176N 714W,0,6,10,3,19
Tropical Storm,Lenny,6,1999-11-14T21:00:00Z,SKPG 125N 717W,0,0,6,4,10
Tropical Storm,Lenny,6,1999-11-14T21:00:00Z,MTPP 186N 724W,0,6,8,3,17
Tropical Storm,Lenny,6,1999-11-14T21:00:00Z,TNCC 122N 690W,0,0,2,5,7
Tropical Storm,Lenny,6,1999-11-14T21:00:00Z,MTCA 183N 738W,1,12,4,2,19
Tropical Storm,Lenny,6,1999-11-14T21:00:00Z,SVMG 110N 640W,0,0,0,2,2
Tropical Storm,Lenny,6,1999-11-14T21:00:00Z,MKJP 179N 768W,19,3,0,0,22
Tropical Storm,Lenny,6,1999-11-14T21:00:00Z,TTPT 112N 608W,0,0,0,2,2
Tropical Storm,Lenny,6,1999-11-14T21:00:00Z,MKJS 185N 779W,6,4,0,2,12
Tropical Storm,Lenny,6,1999-11-14T21:00:00Z,TGPY 120N 618W,0,0,0,3,3
Tropical Storm,Lenny,6,1999-11-14T21:00:00Z,MUGM 200N 751W,0,2,3,5,10
Tropical Storm,Lenny,6,1999-11-14T21:00:00Z,TBPB 131N 595W,0,0,0,3,3
Tropical Storm,Lenny,6,1999-11-14T21:00:00Z,MUCM 214N 779W,0,0,0,3,3
Tropical Storm,Lenny,6,1999-11-14T21:00:00Z,TVSV 131N 612W,0,0,0,4,4
Tropical Storm,Lenny,6,1999-11-14T21:00:00Z,TJSJ 184N 661W,0,0,2,11,13
Tropical Storm,Lenny,6,1999-11-14T21:00:00Z,TLPL 138N 610W,0,0,0,4,4
Tropical Storm,Lenny,6,1999-11-14T21:00:00Z,MDPP 198N 707W,0,0,6,8,14
Tropical Storm,Lenny,6,1999-11-14T21:00:00Z,TFFF 146N 610W,0,0,0,5,5
Tropical Storm,Lenny,6,1999-11-14T21:00:00Z,MBJT 215N 712W,0,0,1,8,9
Tropical Storm,Lenny,6,1999-11-14T21:00:00Z,TDPR 153N 614W,0,0,0,6,6
Tropical Storm,Lenny,6,1999-11-14T21:00:00Z,MYMM 224N 730W,0,0,0,6,6
Tropical Storm,Lenny,6,1999-11-14T21:00:00Z,TFFR 163N 615W,0,0,0,7,7
Tropical Storm,Lenny,6,1999-11-14T21:00:00Z,MYSM 241N 745W,0,0,0,3,3
Tropical Storm,Lenny,6,1999-11-14T21:00:00Z,TAPA 171N 618W,0,0,0,8,8
Tropical Storm,Lenny,6,1999-11-14T21:00:00Z,MYEG 235N 758W,0,0,0,3,3
Tropical Storm,Lenny,6,1999-11-14T21:00:00Z,TKPK 173N 627W,0,0,0,9,9
Tropical Storm,Lenny,6,1999-11-14T21:00:00Z,ST CROIX VI,0,0,1,11,12
Tropical Storm,Lenny,6,1999-11-14T21:00:00Z,TNCM 181N 631W,0,0,0,10,10
Tropical Storm,Lenny,6,1999-11-14T21:00:00Z,ST THOMAS VI,0,0,1,11,12
Tropical Storm,Lenny,6,1999-11-14T21:00:00Z,TISX 177N 648W,0,0,1,11,12
Tropical Storm,Lenny,6,1999-11-14T21:00:00Z,SAN JUAN PR,0,0,2,11,13
Tropical Storm,Lenny,6,1999-11-14T21:00:00Z,TIST 183N 650W,0,0,1,11,12
Tropical Storm,Lenny,6,1999-11-14T21:00:00Z,PONCE PR,0,0,3,11,14
Hurricane,Lenny,7,1999-11-15T03:00:00Z,16.4N  74.9W,33,3,1,0,37
Hurricane,Lenny,7,1999-11-15T03:00:00Z,TJPS 180N 666W,0,0,6,10,16
Hurricane,Lenny,7,1999-11-15T03:00:00Z,16.8N  72.5W,3,23,2,1,29
Hurricane,Lenny,7,1999-11-15T03:00:00Z,MDSD 185N 697W,0,1,12,5,18
Hurricane,Lenny,7,1999-11-15T03:00:00Z,17.5N  70.0W,0,5,14,3,22
Hurricane,Lenny,7,1999-11-15T03:00:00Z,MDCB 176N 714W,0,13,8,2,23
Hurricane,Lenny,7,1999-11-15T03:00:00Z,SKPG 125N 717W,0,2,3,2,7
Hurricane,Lenny,7,1999-11-15T03:00:00Z,MTPP 186N 724W,0,7,8,2,17
Hurricane,Lenny,7,1999-11-15T03:00:00Z,TNCC 122N 690W,0,0,1,3,4
Hurricane,Lenny,7,1999-11-15T03:00:00Z,MTCA 183N 738W,4,10,3,1,18
Hurricane,Lenny,7,1999-11-15T03:00:00Z,TGPY 120N 618W,0,0,0,2,2
Hurricane,Lenny,7,1999-11-15T03:00:00Z,MKJP 179N 768W,14,2,0,1,17
Hurricane,Lenny,7,1999-11-15T03:00:00Z,TBPB 131N 595W,0,0,0,2,2
Hurricane,Lenny,7,1999-11-15T03:00:00Z,MKJS 185N 779W,1,1,0,3,5
Hurricane,Lenny,7,1999-11-15T03:00:00Z,TVSV 131N 612W,0,0,0,3,3
Hurricane,Lenny,7,1999-11-15T03:00:00Z,MUGM 200N 751W,0,1,1,5,7
Hurricane,Lenny,7,1999-11-15T03:00:00Z,TLPL 138N 610W,0,0,0,4,4
Hurricane,Lenny,7,1999-11-15T03:00:00Z,TJSJ 184N 661W,0,0,4,11,15
Hurricane,Lenny,7,1999-11-15T03:00:00Z,TFFF 146N 610W,0,0,0,5,5
Hurricane,Lenny,7,1999-11-15T03:00:00Z,MDPP 198N 707W,0,0,5,8,13
Hurricane,Lenny,7,1999-11-15T03:00:00Z,TDPR 153N 614W,0,0,0,6,6
Hurricane,Lenny,7,1999-11-15T03:00:00Z,MBJT 215N 712W,0,0,0,7,7
Hurricane,Lenny,7,1999-11-15T03:00:00Z,TFFR 163N 615W,0,0,0,8,8
Hurricane,Lenny,7,1999-11-15T03:00:00Z,MYMM 224N 730W,0,0,0,4,4
Hurricane,Lenny,7,1999-11-15T03:00:00Z,TAPA 171N 618W,0,0,0,9,9
Hurricane,Lenny,7,1999-11-15T03:00:00Z,ST CROIX VI,0,0,2,12,14
Hurricane,Lenny,7,1999-11-15T03:00:00Z,TKPK 173N 627W,0,0,0,10,10
Hurricane,Lenny,7,1999-11-15T03:00:00Z,ST THOMAS VI,0,0,2,12,14
Hurricane,Lenny,7,1999-11-15T03:00:00Z,TNCM 181N 631W,0,0,0,11,11
Hurricane,Lenny,7,1999-11-15T03:00:00Z,SAN JUAN PR,0,0,4,11,15
Hurricane,Lenny,7,1999-11-15T03:00:00Z,TISX 177N 648W,0,0,2,12,14
Hurricane,Lenny,7,1999-11-15T03:00:00Z,PONCE PR,0,0,6,10,16
Hurricane,Lenny,7,1999-11-15T03:00:00Z,TIST 183N 650W,0,0,2,12,14
Tropical Storm,Lenny,5,1999-11-14T19:15:00Z,16.5N  76.6W,32,4,0,0,36
Tropical Storm,Lenny,5,1999-11-14T19:15:00Z,MDSD 185N 697W,0,0,9,8,17
Tropical Storm,Lenny,5,1999-11-14T19:15:00Z,16.7N  74.0W,2,25,1,1,29
Tropical Storm,Lenny,5,1999-11-14T19:15:00Z,MDCB 176N 714W,0,5,13,3,21
Tropical Storm,Lenny,5,1999-11-14T19:15:00Z,17.0N  71.3W,0,6,14,2,22
Tropical Storm,Lenny,5,1999-11-14T19:15:00Z,MTPP 186N 724W,0,4,9,4,17
Tropical Storm,Lenny,5,1999-11-14T19:15:00Z,SKPG 125N 717W,0,0,4,5,9
Tropical Storm,Lenny,5,1999-11-14T19:15:00Z,MTCA 183N 738W,1,11,4,2,18
Tropical Storm,Lenny,5,1999-11-14T19:15:00Z,TNCC 122N 690W,0,0,0,6,6
Tropical Storm,Lenny,5,1999-11-14T19:15:00Z,MKJP 179N 768W,19,4,0,0,23
Tropical Storm,Lenny,5,1999-11-14T19:15:00Z,TVSV 131N 612W,0,0,0,2,2
Tropical Storm,Lenny,5,1999-11-14T19:15:00Z,MKJS 185N 779W,12,2,0,0,14
Tropical Storm,Lenny,5,1999-11-14T19:15:00Z,TLPL 138N 610W,0,0,0,3,3
Tropical Storm,Lenny,5,1999-11-14T19:15:00Z,MUGM 200N 751W,0,1,1,4,6
Tropical Storm,Lenny,5,1999-11-14T19:15:00Z,TFFF 146N 610W,0,0,0,4,4
Tropical Storm,Lenny,5,1999-11-14T19:15:00Z,TJSJ 184N 661W,0,0,1,13,14
Tropical Storm,Lenny,5,1999-11-14T19:15:00Z,TDPR 153N 614W,0,0,0,5,5
Tropical Storm,Lenny,5,1999-11-14T19:15:00Z,MDPP 198N 707W,0,0,4,8,12
Tropical Storm,Lenny,5,1999-11-14T19:15:00Z,TFFR 163N 615W,0,0,0,7,7
Tropical Storm,Lenny,5,1999-11-14T19:15:00Z,MBJT 215N 712W,0,0,0,6,6
Tropical Storm,Lenny,5,1999-11-14T19:15:00Z,TAPA 171N 618W,0,0,0,8,8
Tropical Storm,Lenny,5,1999-11-14T19:15:00Z,MYMM 224N 730W,0,0,0,3,3
Tropical Storm,Lenny,5,1999-11-14T19:15:00Z,TKPK 173N 627W,0,0,0,9,9
Tropical Storm,Lenny,5,1999-11-14T19:15:00Z,ST CROIX VI,0,0,0,12,12
Tropical Storm,Lenny,5,1999-11-14T19:15:00Z,TNCM 181N 631W,0,0,0,10,10
Tropical Storm,Lenny,5,1999-11-14T19:15:00Z,ST THOMAS VI,0,0,1,11,12
Tropical Storm,Lenny,5,1999-11-14T19:15:00Z,TISX 177N 648W,0,0,0,12,12
Tropical Storm,Lenny,5,1999-11-14T19:15:00Z,SAN JUAN PR,0,0,1,13,14
Tropical Storm,Lenny,5,1999-11-14T19:15:00Z,TIST 183N 650W,0,0,1,11,12
Tropical Storm,Lenny,5,1999-11-14T19:15:00Z,PONCE PR,0,0,2,13,15
Tropical Storm,Lenny,5,1999-11-14T19:15:00Z,TJPS 180N 666W,0,0,2,13,15
Hurricane,Lenny,8,1999-11-15T09:00:00Z,15.6N  74.0W,34,3,0,0,37
Hurricane,Lenny,8,1999-11-15T09:00:00Z,TJPS 180N 666W,0,0,6,12,18
Hurricane,Lenny,8,1999-11-15T09:00:00Z,16.2N  71.8W,5,21,6,1,33
Hurricane,Lenny,8,1999-11-15T09:00:00Z,MDSD 185N 697W,0,1,10,7,18
Hurricane,Lenny,8,1999-11-15T09:00:00Z,17.0N  69.0W,0,3,19,2,24
Hurricane,Lenny,8,1999-11-15T09:00:00Z,MDCB 176N 714W,1,10,11,1,23
Hurricane,Lenny,8,1999-11-15T09:00:00Z,SKPG 125N 717W,0,2,3,1,6
Hurricane,Lenny,8,1999-11-15T09:00:00Z,MTPP 186N 724W,0,3,8,4,15
Hurricane,Lenny,8,1999-11-15T09:00:00Z,TNCC 122N 690W,0,0,1,2,3
Hurricane,Lenny,8,1999-11-15T09:00:00Z,MTCA 183N 738W,1,5,6,2,14
Hurricane,Lenny,8,1999-11-15T09:00:00Z,TBPB 131N 595W,0,0,0,2,2
Hurricane,Lenny,8,1999-11-15T09:00:00Z,MKJP 179N 768W,0,1,1,3,5
Hurricane,Lenny,8,1999-11-15T09:00:00Z,TVSV 131N 612W,0,0,0,3,3
Hurricane,Lenny,8,1999-11-15T09:00:00Z,MKJS 185N 779W,0,0,0,2,2
Hurricane,Lenny,8,1999-11-15T09:00:00Z,TLPL 138N 610W,0,0,0,5,5
Hurricane,Lenny,8,1999-11-15T09:00:00Z,MUGM 200N 751W,0,0,0,5,5
Hurricane,Lenny,8,1999-11-15T09:00:00Z,TFFF 146N 610W,0,0,0,7,7
Hurricane,Lenny,8,1999-11-15T09:00:00Z,TJSJ 184N 661W,0,0,3,14,17
Hurricane,Lenny,8,1999-11-15T09:00:00Z,TDPR 153N 614W,0,0,0,9,9
Hurricane,Lenny,8,1999-11-15T09:00:00Z,MDPP 198N 707W,0,0,2,11,13
Hurricane,Lenny,8,1999-11-15T09:00:00Z,TFFR 163N 615W,0,0,0,11,11
Hurricane,Lenny,8,1999-11-15T09:00:00Z,MBJT 215N 712W,0,0,0,8,8
Hurricane,Lenny,8,1999-11-15T09:00:00Z,TAPA 171N 618W,0,0,0,12,12
Hurricane,Lenny,8,1999-11-15T09:00:00Z,MYMM 224N 730W,0,0,0,4,4
Hurricane,Lenny,8,1999-11-15T09:00:00Z,TKPK 173N 627W,0,0,0,13,13
Hurricane,Lenny,8,1999-11-15T09:00:00Z,ST CROIX VI,0,0,2,15,17
Hurricane,Lenny,8,1999-11-15T09:00:00Z,TNCM 181N 631W,0,0,0,14,14
Hurricane,Lenny,8,1999-11-15T09:00:00Z,ST THOMAS VI,0,0,2,14,16
Hurricane,Lenny,8,1999-11-15T09:00:00Z,TISX 177N 648W,0,0,2,15,17
Hurricane,Lenny,8,1999-11-15T09:00:00Z,SAN JUAN PR,0,0,3,14,17
Hurricane,Lenny,8,1999-11-15T09:00:00Z,TIST 183N 650W,0,0,2,14,16
Hurricane,Lenny,8,1999-11-15T09:00:00Z,PONCE PR,0,0,6,12,18
Hurricane,Lenny,9,1999-11-15T15:00:00Z,15.6N  72.0W,37,1,0,0,38
Hurricane,Lenny,9,1999-11-15T15:00:00Z,TISX 177N 648W,0,1,9,6,16
Hurricane,Lenny,9,1999-11-15T15:00:00Z,16.4N  69.3W,4,20,1,1,26
Hurricane,Lenny,9,1999-11-15T15:00:00Z,TIST 183N 650W,0,0,9,7,16
Hurricane,Lenny,9,1999-11-15T15:00:00Z,17.5N  67.0W,0,6,11,2,19
Hurricane,Lenny,9,1999-11-15T15:00:00Z,TJPS 180N 666W,0,3,11,4,18
Hurricane,Lenny,9,1999-11-15T15:00:00Z,SKPG 125N 717W,7,7,0,0,14
Hurricane,Lenny,9,1999-11-15T15:00:00Z,MDSD 185N 697W,0,8,6,3,17
Hurricane,Lenny,9,1999-11-15T15:00:00Z,TNCC 122N 690W,0,4,3,1,8
Hurricane,Lenny,9,1999-11-15T15:00:00Z,MDCB 176N 714W,7,11,1,1,20
Hurricane,Lenny,9,1999-11-15T15:00:00Z,SVMG 110N 640W,0,0,0,2,2
Hurricane,Lenny,9,1999-11-15T15:00:00Z,MTPP 186N 724W,1,5,3,3,12
Hurricane,Lenny,9,1999-11-15T15:00:00Z,TTPT 112N 608W,0,0,0,2,2
Hurricane,Lenny,9,1999-11-15T15:00:00Z,MTCA 183N 738W,1,3,2,2,8
Hurricane,Lenny,9,1999-11-15T15:00:00Z,TGPY 120N 618W,0,0,0,3,3
Hurricane,Lenny,9,1999-11-15T15:00:00Z,MUGM 200N 751W,0,0,0,3,3
Hurricane,Lenny,9,1999-11-15T15:00:00Z,TBPB 131N 595W,0,0,0,4,4
Hurricane,Lenny,9,1999-11-15T15:00:00Z,TJSJ 184N 661W,0,1,11,5,17
Hurricane,Lenny,9,1999-11-15T15:00:00Z,TVSV 131N 612W,0,0,0,5,5
Hurricane,Lenny,9,1999-11-15T15:00:00Z,MDPP 198N 707W,0,1,5,5,11
Hurricane,Lenny,9,1999-11-15T15:00:00Z,TLPL 138N 610W,0,0,0,6,6
Hurricane,Lenny,9,1999-11-15T15:00:00Z,MBJT 215N 712W,0,0,1,6,7
Hurricane,Lenny,9,1999-11-15T15:00:00Z,TFFF 146N 610W,0,0,1,7,8
Hurricane,Lenny,9,1999-11-15T15:00:00Z,MYMM 224N 730W,0,0,0,4,4
Hurricane,Lenny,9,1999-11-15T15:00:00Z,TDPR 153N 614W,0,0,1,8,9
Hurricane,Lenny,9,1999-11-15T15:00:00Z,MYSM 241N 745W,0,0,0,2,2
Hurricane,Lenny,9,1999-11-15T15:00:00Z,TFFR 163N 615W,0,0,2,9,11
Hurricane,Lenny,9,1999-11-15T15:00:00Z,ST CROIX VI,0,1,9,6,16
Hurricane,Lenny,9,1999-11-15T15:00:00Z,TAPA 171N 618W,0,0,2,10,12
Hurricane,Lenny,9,1999-11-15T15:00:00Z,ST THOMAS VI,0,0,9,7,16
Hurricane,Lenny,9,1999-11-15T15:00:00Z,TKPK 173N 627W,0,0,4,9,13
Hurricane,Lenny,9,1999-11-15T15:00:00Z,SAN JUAN PR,0,1,11,5,17
Hurricane,Lenny,9,1999-11-15T15:00:00Z,TNCM 181N 631W,0,0,4,10,14
Hurricane,Lenny,9,1999-11-15T15:00:00Z,PONCE PR,0,3,11,4,18
Hurricane,Lenny,10,1999-11-15T21:00:00Z,15.7N  69.9W,29,0,1,0,30
Hurricane,Lenny,10,1999-11-15T21:00:00Z,TIST 183N 650W,0,5,8,5,18
Hurricane,Lenny,10,1999-11-15T21:00:00Z,17.0N  68.0W,5,14,1,2,22
Hurricane,Lenny,10,1999-11-15T21:00:00Z,TJPS 180N 666W,0,11,6,2,19
Hurricane,Lenny,10,1999-11-15T21:00:00Z,18.5N  66.0W,0,7,8,3,18
Hurricane,Lenny,10,1999-11-15T21:00:00Z,MDSD 185N 697W,1,10,4,2,17
Hurricane,Lenny,10,1999-11-15T21:00:00Z,SKPG 125N 717W,22,0,0,0,22
Hurricane,Lenny,10,1999-11-15T21:00:00Z,MDCB 176N 714W,5,8,1,2,16
Hurricane,Lenny,10,1999-11-15T21:00:00Z,TNCC 122N 690W,4,5,1,0,10
Hurricane,Lenny,10,1999-11-15T21:00:00Z,MTPP 186N 724W,0,4,4,2,10
Hurricane,Lenny,10,1999-11-15T21:00:00Z,SVMG 110N 640W,0,0,0,2,2
Hurricane,Lenny,10,1999-11-15T21:00:00Z,MTCA 183N 738W,0,1,3,2,6
Hurricane,Lenny,10,1999-11-15T21:00:00Z,TGPY 120N 618W,0,0,0,3,3
Hurricane,Lenny,10,1999-11-15T21:00:00Z,MUGM 200N 751W,0,0,1,2,3
Hurricane,Lenny,10,1999-11-15T21:00:00Z,TBPB 131N 595W,0,0,0,3,3
Hurricane,Lenny,10,1999-11-15T21:00:00Z,TJSJ 184N 661W,0,8,7,4,19
Hurricane,Lenny,10,1999-11-15T21:00:00Z,TVSV 131N 612W,0,0,1,3,4
Hurricane,Lenny,10,1999-11-15T21:00:00Z,MDPP 198N 707W,0,3,5,4,12
Hurricane,Lenny,10,1999-11-15T21:00:00Z,TLPL 138N 610W,0,0,1,5,6
Hurricane,Lenny,10,1999-11-15T21:00:00Z,MBJT 215N 712W,0,0,3,5,8
Hurricane,Lenny,10,1999-11-15T21:00:00Z,TFFF 146N 610W,0,0,2,5,7
Hurricane,Lenny,10,1999-11-15T21:00:00Z,MYMM 224N 730W,0,0,1,3,4
Hurricane,Lenny,10,1999-11-15T21:00:00Z,TDPR 153N 614W,0,0,3,6,9
Hurricane,Lenny,10,1999-11-15T21:00:00Z,MYSM 241N 745W,0,0,0,2,2
Hurricane,Lenny,10,1999-11-15T21:00:00Z,TFFR 163N 615W,0,0,4,7,11
Hurricane,Lenny,10,1999-11-15T21:00:00Z,ST CROIX VI,0,5,9,4,18
Hurricane,Lenny,10,1999-11-15T21:00:00Z,TAPA 171N 618W,0,0,5,7,12
Hurricane,Lenny,10,1999-11-15T21:00:00Z,ST THOMAS VI,0,5,8,5,18
Hurricane,Lenny,10,1999-11-15T21:00:00Z,TKPK 173N 627W,0,1,7,6,14
Hurricane,Lenny,10,1999-11-15T21:00:00Z,SAN JUAN PR,0,8,7,4,19
Hurricane,Lenny,10,1999-11-15T21:00:00Z,TNCM 181N 631W,0,1,8,6,15
Hurricane,Lenny,10,1999-11-15T21:00:00Z,PONCE PR,0,11,6,2,19
Hurricane,Lenny,10,1999-11-15T21:00:00Z,TISX 177N 648W,0,5,9,4,18
Hurricane,Lenny,11,1999-11-16T03:00:00Z,16.6N  68.9W,31,1,0,0,32
Hurricane,Lenny,11,1999-11-16T03:00:00Z,TIST 183N 650W,1,11,5,2,19
Hurricane,Lenny,11,1999-11-16T03:00:00Z,18.0N  67.0W,6,13,2,1,22
Hurricane,Lenny,11,1999-11-16T03:00:00Z,TJPS 180N 666W,5,14,1,2,22
Hurricane,Lenny,11,1999-11-16T03:00:00Z,19.5N  65.0W,0,8,7,3,18
Hurricane,Lenny,11,1999-11-16T03:00:00Z,MDSD 185N 697W,5,11,1,1,18
Hurricane,Lenny,11,1999-11-16T03:00:00Z,SKPG 125N 717W,4,1,0,1,6
Hurricane,Lenny,11,1999-11-16T03:00:00Z,MDCB 176N 714W,9,6,1,0,16
Hurricane,Lenny,11,1999-11-16T03:00:00Z,TNCC 122N 690W,0,2,1,1,4
Hurricane,Lenny,11,1999-11-16T03:00:00Z,MTPP 186N 724W,0,4,3,2,9
Hurricane,Lenny,11,1999-11-16T03:00:00Z,TBPB 131N 595W,0,0,0,2,2
Hurricane,Lenny,11,1999-11-16T03:00:00Z,MTCA 183N 738W,0,1,2,1,4
Hurricane,Lenny,11,1999-11-16T03:00:00Z,TVSV 131N 612W,0,0,0,2,2
Hurricane,Lenny,11,1999-11-16T03:00:00Z,MUGM 200N 751W,0,0,0,2,2
Hurricane,Lenny,11,1999-11-16T03:00:00Z,TLPL 138N 610W,0,0,1,3,4
Hurricane,Lenny,11,1999-11-16T03:00:00Z,TJSJ 184N 661W,2,14,3,1,20
Hurricane,Lenny,11,1999-11-16T03:00:00Z,TFFF 146N 610W,0,0,1,4,5
Hurricane,Lenny,11,1999-11-16T03:00:00Z,MDPP 198N 707W,0,5,4,3,12
Hurricane,Lenny,11,1999-11-16T03:00:00Z,TDPR 153N 614W,0,0,3,4,7
Hurricane,Lenny,11,1999-11-16T03:00:00Z,MBJT 215N 712W,0,0,3,5,8
Hurricane,Lenny,11,1999-11-16T03:00:00Z,TFFR 163N 615W,0,1,4,5,10
Hurricane,Lenny,11,1999-11-16T03:00:00Z,MYMM 224N 730W,0,0,1,3,4
Hurricane,Lenny,11,1999-11-16T03:00:00Z,TAPA 171N 618W,0,1,6,5,12
Hurricane,Lenny,11,1999-11-16T03:00:00Z,ST CROIX VI,1,11,4,2,18
Hurricane,Lenny,11,1999-11-16T03:00:00Z,TKPK 173N 627W,0,3,7,4,14
Hurricane,Lenny,11,1999-11-16T03:00:00Z,ST THOMAS VI,1,11,5,2,19
Hurricane,Lenny,11,1999-11-16T03:00:00Z,TNCM 181N 631W,0,4,8,4,16
Hurricane,Lenny,11,1999-11-16T03:00:00Z,SAN JUAN PR,2,14,3,1,20
Hurricane,Lenny,11,1999-11-16T03:00:00Z,TISX 177N 648W,1,11,4,2,18
Hurricane,Lenny,11,1999-11-16T03:00:00Z,PONCE PR,5,14,1,2,22
Hurricane,Lenny,12,1999-11-16T09:00:00Z,17.0N  67.8W,31,0,1,0,32
Hurricane,Lenny,12,1999-11-16T09:00:00Z,TIST 183N 650W,3,15,2,1,21
Hurricane,Lenny,12,1999-11-16T09:00:00Z,18.7N  65.8W,4,15,2,1,22
Hurricane,Lenny,12,1999-11-16T09:00:00Z,TJPS 180N 666W,13,11,0,1,25
Hurricane,Lenny,12,1999-11-16T09:00:00Z,20.0N  64.0W,0,9,6,3,18
Hurricane,Lenny,12,1999-11-16T09:00:00Z,MDSD 185N 697W,5,8,2,1,16
Hurricane,Lenny,12,1999-11-16T09:00:00Z,SKPG 125N 717W,2,0,0,1,3
Hurricane,Lenny,12,1999-11-16T09:00:00Z,MDCB 176N 714W,2,5,2,1,10
Hurricane,Lenny,12,1999-11-16T09:00:00Z,TNCC 122N 690W,1,1,0,1,3
Hurricane,Lenny,12,1999-11-16T09:00:00Z,MTPP 186N 724W,0,1,2,2,5
Hurricane,Lenny,12,1999-11-16T09:00:00Z,TBPB 131N 595W,0,0,0,2,2
Hurricane,Lenny,12,1999-11-16T09:00:00Z,MTCA 183N 738W,0,0,1,1,2
Hurricane,Lenny,12,1999-11-16T09:00:00Z,TVSV 131N 612W,0,0,0,2,2
Hurricane,Lenny,12,1999-11-16T09:00:00Z,TJSJ 184N 661W,7,14,1,1,23
Hurricane,Lenny,12,1999-11-16T09:00:00Z,TLPL 138N 610W,0,0,1,2,3
Hurricane,Lenny,12,1999-11-16T09:00:00Z,MDPP 198N 707W,0,3,3,3,9
Hurricane,Lenny,12,1999-11-16T09:00:00Z,TFFF 146N 610W,0,0,2,3,5
Hurricane,Lenny,12,1999-11-16T09:00:00Z,MBJT 215N 712W,0,0,2,4,6
Hurricane,Lenny,12,1999-11-16T09:00:00Z,TDPR 153N 614W,0,0,3,4,7
Hurricane,Lenny,12,1999-11-16T09:00:00Z,MYMM 224N 730W,0,0,0,2,2
Hurricane,Lenny,12,1999-11-16T09:00:00Z,TFFR 163N 615W,0,1,5,4,10
Hurricane,Lenny,12,1999-11-16T09:00:00Z,ST CROIX VI,3,14,2,2,21
Hurricane,Lenny,12,1999-11-16T09:00:00Z,TAPA 171N 618W,0,2,7,4,13
Hurricane,Lenny,12,1999-11-16T09:00:00Z,ST THOMAS VI,3,15,2,1,21
Hurricane,Lenny,12,1999-11-16T09:00:00Z,TKPK 173N 627W,0,6,6,3,15
Hurricane,Lenny,12,1999-11-16T09:00:00Z,SAN JUAN PR,7,14,1,1,23
Hurricane,Lenny,12,1999-11-16T09:00:00Z,TNCM 181N 631W,0,9,5,3,17
Hurricane,Lenny,12,1999-11-16T09:00:00Z,PONCE PR,13,11,0,1,25
Hurricane,Lenny,12,1999-11-16T09:00:00Z,TISX 177N 648W,3,14,2,2,21
Hurricane,Lenny,13,1999-11-16T15:00:00Z,18.1N  65.3W,27,4,0,0,31
Hurricane,Lenny,13,1999-11-16T15:00:00Z,TISX 177N 648W,25,5,1,0,31
Hurricane,Lenny,13,1999-11-16T15:00:00Z,20.0N  62.5W,1,16,2,1,20
Hurricane,Lenny,13,1999-11-16T15:00:00Z,TIST 183N 650W,23,7,0,0,30
Hurricane,Lenny,13,1999-11-16T15:00:00Z,21.5N  61.0W,0,8,6,3,17
Hurricane,Lenny,13,1999-11-16T15:00:00Z,TJPS 180N 666W,32,1,0,0,33
Hurricane,Lenny,13,1999-11-16T15:00:00Z,TVSV 131N 612W,0,0,1,1,2
Hurricane,Lenny,13,1999-11-16T15:00:00Z,MDSD 185N 697W,2,1,0,1,4
Hurricane,Lenny,13,1999-11-16T15:00:00Z,TLPL 138N 610W,0,0,2,1,3
Hurricane,Lenny,13,1999-11-16T15:00:00Z,TJSJ 184N 661W,27,2,0,1,30
Hurricane,Lenny,13,1999-11-16T15:00:00Z,TFFF 146N 610W,0,1,2,2,5
Hurricane,Lenny,13,1999-11-16T15:00:00Z,MDPP 198N 707W,0,0,0,2,2
Hurricane,Lenny,13,1999-11-16T15:00:00Z,TDPR 153N 614W,0,3,3,2,8
Hurricane,Lenny,13,1999-11-16T15:00:00Z,ST CROIX VI,25,5,1,0,31
Hurricane,Lenny,13,1999-11-16T15:00:00Z,TFFR 163N 615W,0,7,3,1,11
Hurricane,Lenny,13,1999-11-16T15:00:00Z,ST THOMAS VI,23,7,0,0,30
Hurricane,Lenny,13,1999-11-16T15:00:00Z,TAPA 171N 618W,1,11,2,1,15
Hurricane,Lenny,13,1999-11-16T15:00:00Z,SAN JUAN PR,27,2,0,1,30
Hurricane,Lenny,13,1999-11-16T15:00:00Z,TKPK 173N 627W,4,14,1,0,19
Hurricane,Lenny,13,1999-11-16T15:00:00Z,PONCE PR,32,1,0,0,33
Hurricane,Lenny,13,1999-11-16T15:00:00Z,TNCM 181N 631W,6,16,1,0,23
Hurricane,Lenny,14,1999-11-16T21:00:00Z,18.8N  64.3W,28,3,0,0,31
Hurricane,Lenny,14,1999-11-16T21:00:00Z,TNCM 181N 631W,15,11,0,0,26
Hurricane,Lenny,14,1999-11-16T21:00:00Z,20.5N  62.0W,1,16,2,1,20
Hurricane,Lenny,14,1999-11-16T21:00:00Z,TISX 177N 648W,37,0,0,0,37
Hurricane,Lenny,14,1999-11-16T21:00:00Z,22.0N  60.0W,0,6,7,4,17
Hurricane,Lenny,14,1999-11-16T21:00:00Z,TIST 183N 650W,35,1,0,0,36
Hurricane,Lenny,14,1999-11-16T21:00:00Z,TVSV 131N 612W,0,0,1,1,2
Hurricane,Lenny,14,1999-11-16T21:00:00Z,TJPS 180N 666W,43,0,0,0,43
Hurricane,Lenny,14,1999-11-16T21:00:00Z,TLPL 138N 610W,0,1,1,1,3
Hurricane,Lenny,14,1999-11-16T21:00:00Z,TJSJ 184N 661W,35,0,0,0,35
Hurricane,Lenny,14,1999-11-16T21:00:00Z,TFFF 146N 610W,0,2,2,1,5
Hurricane,Lenny,14,1999-11-16T21:00:00Z,ST CROIX VI,37,0,0,0,37
Hurricane,Lenny,14,1999-11-16T21:00:00Z,TDPR 153N 614W,0,5,2,1,8
Hurricane,Lenny,14,1999-11-16T21:00:00Z,ST THOMAS VI,35,1,0,0,36
Hurricane,Lenny,14,1999-11-16T21:00:00Z,TFFR 163N 615W,1,8,3,1,13
Hurricane,Lenny,14,1999-11-16T21:00:00Z,SAN JUAN PR,35,0,0,0,35
Hurricane,Lenny,14,1999-11-16T21:00:00Z,TAPA 171N 618W,2,13,1,1,17
Hurricane,Lenny,14,1999-11-16T21:00:00Z,PONCE PR,43,0,0,0,43
Hurricane,Lenny,14,1999-11-16T21:00:00Z,TKPK 173N 627W,9,12,1,0,22
Hurricane,Lenny,15,1999-11-17T03:00:00Z,18.9N  63.2W,27,1,0,1,29
Hurricane,Lenny,15,1999-11-17T03:00:00Z,TKPK 173N 627W,27,1,0,0,28
Hurricane,Lenny,15,1999-11-17T03:00:00Z,20.4N  61.3W,2,14,2,1,19
Hurricane,Lenny,15,1999-11-17T03:00:00Z,TNCM 181N 631W,31,0,0,1,32
Hurricane,Lenny,15,1999-11-17T03:00:00Z,21.5N  60.0W,0,9,4,3,16
Hurricane,Lenny,15,1999-11-17T03:00:00Z,TISX 177N 648W,51,0,0,0,51
Hurricane,Lenny,15,1999-11-17T03:00:00Z,TGPY 120N 618W,0,0,1,1,2
Hurricane,Lenny,15,1999-11-17T03:00:00Z,TIST 183N 650W,41,0,0,0,41
Hurricane,Lenny,15,1999-11-17T03:00:00Z,TBPB 131N 595W,0,0,2,1,3
Hurricane,Lenny,15,1999-11-17T03:00:00Z,TJPS 180N 666W,41,0,0,0,41
Hurricane,Lenny,15,1999-11-17T03:00:00Z,TVSV 131N 612W,0,1,2,1,4
Hurricane,Lenny,15,1999-11-17T03:00:00Z,TJSJ 184N 661W,34,0,0,0,34
Hurricane,Lenny,15,1999-11-17T03:00:00Z,TLPL 138N 610W,0,2,2,2,6
Hurricane,Lenny,15,1999-11-17T03:00:00Z,ST CROIX VI,51,0,0,0,51
Hurricane,Lenny,15,1999-11-17T03:00:00Z,TFFF 146N 610W,1,4,2,2,9
Hurricane,Lenny,15,1999-11-17T03:00:00Z,ST THOMAS VI,41,0,0,0,41
Hurricane,Lenny,15,1999-11-17T03:00:00Z,TDPR 153N 614W,3,6,2,1,12
Hurricane,Lenny,15,1999-11-17T03:00:00Z,SAN JUAN PR,34,0,0,0,34
Hurricane,Lenny,15,1999-11-17T03:00:00Z,TFFR 163N 615W,8,7,1,1,17
Hurricane,Lenny,15,1999-11-17T03:00:00Z,PONCE PR,41,0,0,0,41
Hurricane,Lenny,15,1999-11-17T03:00:00Z,TAPA 171N 618W,15,5,1,0,21
Hurricane,Lenny,16,1999-11-17T09:00:00Z,19.2N  62.5W,27,1,1,0,29
Hurricane,Lenny,16,1999-11-17T09:00:00Z,TNCM 181N 631W,39,0,0,0,39
Hurricane,Lenny,16,1999-11-17T09:00:00Z,20.6N  60.8W,4,13,2,2,21
Hurricane,Lenny,16,1999-11-17T09:00:00Z,TISX 177N 648W,58,0,0,0,58
Hurricane,Lenny,16,1999-11-17T09:00:00Z,21.5N  59.5W,0,11,4,3,18
Hurricane,Lenny,16,1999-11-17T09:00:00Z,TIST 183N 650W,44,1,0,0,45
Hurricane,Lenny,16,1999-11-17T09:00:00Z,TBPB 131N 595W,0,0,1,1,2
Hurricane,Lenny,16,1999-11-17T09:00:00Z,TJPS 180N 666W,33,0,0,0,33
Hurricane,Lenny,16,1999-11-17T09:00:00Z,TVSV 131N 612W,0,0,1,2,3
Hurricane,Lenny,16,1999-11-17T09:00:00Z,MDSD 185N 697W,0,0,0,2,2
Hurricane,Lenny,16,1999-11-17T09:00:00Z,TLPL 138N 610W,0,1,1,2,4
Hurricane,Lenny,16,1999-11-17T09:00:00Z,TJSJ 184N 661W,30,0,0,1,31
Hurricane,Lenny,16,1999-11-17T09:00:00Z,TFFF 146N 610W,0,3,2,2,7
Hurricane,Lenny,16,1999-11-17T09:00:00Z,MDPP 198N 707W,0,0,0,2,2
Hurricane,Lenny,16,1999-11-17T09:00:00Z,TDPR 153N 614W,2,5,2,1,10
Hurricane,Lenny,16,1999-11-17T09:00:00Z,ST CROIX VI,58,0,0,0,58
Hurricane,Lenny,16,1999-11-17T09:00:00Z,TFFR 163N 615W,9,5,1,1,16
Hurricane,Lenny,16,1999-11-17T09:00:00Z,ST THOMAS VI,44,1,0,0,45
Hurricane,Lenny,16,1999-11-17T09:00:00Z,TAPA 171N 618W,20,2,0,1,23
Hurricane,Lenny,16,1999-11-17T09:00:00Z,SAN JUAN PR,30,0,0,1,31
Hurricane,Lenny,16,1999-11-17T09:00:00Z,TKPK 173N 627W,34,0,0,0,34
Hurricane,Lenny,16,1999-11-17T09:00:00Z,PONCE PR,33,0,0,0,33
Hurricane,Lenny,17,1999-11-17T15:00:00Z,19.0N  62.5W,33,1,0,0,34
Hurricane,Lenny,17,1999-11-17T15:00:00Z,TNCM 181N 631W,46,0,0,0,46
Hurricane,Lenny,17,1999-11-17T15:00:00Z,20.3N  61.0W,9,10,2,1,22
Hurricane,Lenny,17,1999-11-17T15:00:00Z,TISX 177N 648W,99,0,0,0,99
Hurricane,Lenny,17,1999-11-17T15:00:00Z,22.0N  59.5W,0,9,6,4,19
Hurricane,Lenny,17,1999-11-17T15:00:00Z,TIST 183N 650W,35,0,0,0,35
Hurricane,Lenny,17,1999-11-17T15:00:00Z,TLPL 138N 610W,0,1,1,1,3
Hurricane,Lenny,17,1999-11-17T15:00:00Z,TJPS 180N 666W,3,3,2,1,9
Hurricane,Lenny,17,1999-11-17T15:00:00Z,TFFF 146N 610W,0,3,1,1,5
Hurricane,Lenny,17,1999-11-17T15:00:00Z,TJSJ 184N 661W,8,2,2,0,12
Hurricane,Lenny,17,1999-11-17T15:00:00Z,TDPR 153N 614W,2,5,1,1,9
Hurricane,Lenny,17,1999-11-17T15:00:00Z,ST CROIX VI,99,0,0,0,99
Hurricane,Lenny,17,1999-11-17T15:00:00Z,TFFR 163N 615W,12,3,1,1,17
Hurricane,Lenny,17,1999-11-17T15:00:00Z,ST THOMAS VI,35,0,0,0,35
Hurricane,Lenny,17,1999-11-17T15:00:00Z,TAPA 171N 618W,24,1,0,1,26
Hurricane,Lenny,17,1999-11-17T15:00:00Z,SAN JUAN PR,8,2,2,0,12
Hurricane,Lenny,17,1999-11-17T15:00:00Z,TKPK 173N 627W,41,0,0,0,41
Hurricane,Lenny,17,1999-11-17T15:00:00Z,PONCE PR,3,3,2,1,9
Hurricane,Lenny,18,1999-11-17T21:00:00Z,19.7N  62.3W,33,0,0,1,34
Hurricane,Lenny,18,1999-11-17T21:00:00Z,TIST 183N 650W,99,0,0,0,99
Hurricane,Lenny,18,1999-11-17T21:00:00Z,21.0N  61.5W,15,6,2,1,24
Hurricane,Lenny,18,1999-11-17T21:00:00Z,TJPS 180N 666W,0,4,2,3,9
Hurricane,Lenny,18,1999-11-17T21:00:00Z,22.5N  60.5W,1,11,4,3,19
Hurricane,Lenny,18,1999-11-17T21:00:00Z,MDSD 185N 697W,0,0,1,2,3
Hurricane,Lenny,18,1999-11-17T21:00:00Z,TFFF 146N 610W,0,1,0,1,2
Hurricane,Lenny,18,1999-11-17T21:00:00Z,TJSJ 184N 661W,2,4,3,2,11
Hurricane,Lenny,18,1999-11-17T21:00:00Z,TDPR 153N 614W,1,1,2,1,5
Hurricane,Lenny,18,1999-11-17T21:00:00Z,MDPP 198N 707W,0,0,0,3,3
Hurricane,Lenny,18,1999-11-17T21:00:00Z,TFFR 163N 615W,6,3,1,1,11
Hurricane,Lenny,18,1999-11-17T21:00:00Z,MBJT 215N 712W,0,0,0,3,3
Hurricane,Lenny,18,1999-11-17T21:00:00Z,TAPA 171N 618W,19,1,1,0,21
Hurricane,Lenny,18,1999-11-17T21:00:00Z,ST CROIX VI,99,0,0,0,99
Hurricane,Lenny,18,1999-11-17T21:00:00Z,TKPK 173N 627W,41,0,0,0,41
Hurricane,Lenny,18,1999-11-17T21:00:00Z,ST THOMAS VI,99,0,0,0,99
Hurricane,Lenny,18,1999-11-17T21:00:00Z,TNCM 181N 631W,58,0,0,0,58
Hurricane,Lenny,18,1999-11-17T21:00:00Z,SAN JUAN PR,2,4,3,2,11
Hurricane,Lenny,18,1999-11-17T21:00:00Z,TISX 177N 648W,99,0,0,0,99
Hurricane,Lenny,18,1999-11-17T21:00:00Z,PONCE PR,0,4,2,3,9
Hurricane,Lenny,19,1999-11-18T03:00:00Z,19.4N  62.5W,35,1,0,0,36
Hurricane,Lenny,19,1999-11-18T03:00:00Z,TIST 183N 650W,99,0,0,0,99
Hurricane,Lenny,19,1999-11-18T03:00:00Z,20.6N  61.4W,12,14,1,1,28
Hurricane,Lenny,19,1999-11-18T03:00:00Z,TJPS 180N 666W,0,2,2,4,8
Hurricane,Lenny,19,1999-11-18T03:00:00Z,22.0N  60.5W,1,13,7,2,23
Hurricane,Lenny,19,1999-11-18T03:00:00Z,MDSD 185N 697W,0,0,0,2,2
Hurricane,Lenny,19,1999-11-18T03:00:00Z,TDPR 153N 614W,1,1,1,1,4
Hurricane,Lenny,19,1999-11-18T03:00:00Z,TJSJ 184N 661W,3,3,2,3,11
Hurricane,Lenny,19,1999-11-18T03:00:00Z,TFFR 163N 615W,9,1,1,1,12
Hurricane,Lenny,19,1999-11-18T03:00:00Z,ST CROIX VI,99,0,0,0,99
Hurricane,Lenny,19,1999-11-18T03:00:00Z,TAPA 171N 618W,20,1,1,0,22
Hurricane,Lenny,19,1999-11-18T03:00:00Z,ST THOMAS VI,99,0,0,0,99
Hurricane,Lenny,19,1999-11-18T03:00:00Z,TKPK 173N 627W,38,0,0,0,38
Hurricane,Lenny,19,1999-11-18T03:00:00Z,SAN JUAN PR,3,3,2,3,11
Hurricane,Lenny,19,1999-11-18T03:00:00Z,TNCM 181N 631W,99,0,0,0,99
Hurricane,Lenny,19,1999-11-18T03:00:00Z,PONCE PR,0,2,2,4,8
Hurricane,Lenny,19,1999-11-18T03:00:00Z,TISX 177N 648W,99,0,0,0,99
Hurricane,Lenny,20,1999-11-18T09:00:00Z,18.4N  62.6W,42,0,0,0,42
Hurricane,Lenny,20,1999-11-18T09:00:00Z,TIST 183N 650W,17,2,2,1,22
Hurricane,Lenny,20,1999-11-18T09:00:00Z,19.1N  61.9W,23,2,2,1,28
Hurricane,Lenny,20,1999-11-18T09:00:00Z,TJPS 180N 666W,1,5,3,3,12
Hurricane,Lenny,20,1999-11-18T09:00:00Z,20.0N  61.0W,5,10,5,3,23
Hurricane,Lenny,20,1999-11-18T09:00:00Z,MDSD 185N 697W,0,0,0,3,3
Hurricane,Lenny,20,1999-11-18T09:00:00Z,TFFF 146N 610W,1,1,1,1,4
Hurricane,Lenny,20,1999-11-18T09:00:00Z,TJSJ 184N 661W,3,6,3,3,15
Hurricane,Lenny,20,1999-11-18T09:00:00Z,TDPR 153N 614W,5,3,1,1,10
Hurricane,Lenny,20,1999-11-18T09:00:00Z,MDPP 198N 707W,0,0,0,2,2
Hurricane,Lenny,20,1999-11-18T09:00:00Z,TFFR 163N 615W,17,2,1,1,21
Hurricane,Lenny,20,1999-11-18T09:00:00Z,MBJT 215N 712W,0,0,0,2,2
Hurricane,Lenny,20,1999-11-18T09:00:00Z,TAPA 171N 618W,31,1,0,0,32
Hurricane,Lenny,20,1999-11-18T09:00:00Z,ST CROIX VI,99,0,0,0,99
Hurricane,Lenny,20,1999-11-18T09:00:00Z,TKPK 173N 627W,56,0,0,0,56
Hurricane,Lenny,20,1999-11-18T09:00:00Z,ST THOMAS VI,17,2,2,1,22
Hurricane,Lenny,20,1999-11-18T09:00:00Z,TNCM 181N 631W,99,0,0,0,99
Hurricane,Lenny,20,1999-11-18T09:00:00Z,SAN JUAN PR,3,6,3,3,15
Hurricane,Lenny,20,1999-11-18T09:00:00Z,TISX 177N 648W,99,0,0,0,99
Hurricane,Lenny,20,1999-11-18T09:00:00Z,PONCE PR,1,5,3,3,12
Hurricane,Lenny,21,1999-11-18T15:00:00Z,18.5N  62.5W,40,0,1,0,41
Hurricane,Lenny,21,1999-11-18T15:00:00Z,TKPK 173N 627W,99,0,0,0,99
Hurricane,Lenny,21,1999-11-18T15:00:00Z,19.3N  61.8W,22,3,2,1,28
Hurricane,Lenny,21,1999-11-18T15:00:00Z,TNCM 181N 631W,99,0,0,0,99
Hurricane,Lenny,21,1999-11-18T15:00:00Z,20.0N  61.0W,7,11,3,3,24
Hurricane,Lenny,21,1999-11-18T15:00:00Z,TISX 177N 648W,33,0,0,0,33
Hurricane,Lenny,21,1999-11-18T15:00:00Z,TGPY 120N 618W,0,0,0,2,2
Hurricane,Lenny,21,1999-11-18T15:00:00Z,TIST 183N 650W,28,0,0,1,29
Hurricane,Lenny,21,1999-11-18T15:00:00Z,TBPB 131N 595W,0,0,0,2,2
Hurricane,Lenny,21,1999-11-18T15:00:00Z,TJPS 180N 666W,2,2,1,4,9
Hurricane,Lenny,21,1999-11-18T15:00:00Z,TVSV 131N 612W,0,0,1,3,4
Hurricane,Lenny,21,1999-11-18T15:00:00Z,TJSJ 184N 661W,8,1,2,2,13
Hurricane,Lenny,21,1999-11-18T15:00:00Z,TLPL 138N 610W,0,1,1,4,6
Hurricane,Lenny,21,1999-11-18T15:00:00Z,ST CROIX VI,33,0,0,0,33
Hurricane,Lenny,21,1999-11-18T15:00:00Z,TFFF 146N 610W,1,2,2,4,9
Hurricane,Lenny,21,1999-11-18T15:00:00Z,ST THOMAS VI,28,0,0,1,29
Hurricane,Lenny,21,1999-11-18T15:00:00Z,TDPR 153N 614W,4,4,2,4,14
Hurricane,Lenny,21,1999-11-18T15:00:00Z,SAN JUAN PR,8,1,2,2,13
Hurricane,Lenny,21,1999-11-18T15:00:00Z,TFFR 163N 615W,16,2,2,1,21
Hurricane,Lenny,21,1999-11-18T15:00:00Z,PONCE PR,2,2,1,4,9
Hurricane,Lenny,21,1999-11-18T15:00:00Z,TAPA 171N 618W,30,0,1,0,31
Hurricane,Lenny,22,1999-11-18T21:00:00Z,19.0N  61.5W,31,1,0,1,33
Hurricane,Lenny,22,1999-11-18T21:00:00Z,TNCM 181N 631W,99,0,0,0,99
Hurricane,Lenny,22,1999-11-18T21:00:00Z,19.7N  60.3W,12,10,2,1,25
Hurricane,Lenny,22,1999-11-18T21:00:00Z,TISX 177N 648W,72,0,0,0,72
Hurricane,Lenny,22,1999-11-18T21:00:00Z,21.0N  59.0W,1,11,7,2,21
Hurricane,Lenny,22,1999-11-18T21:00:00Z,TIST 183N 650W,94,0,0,0,94
Hurricane,Lenny,22,1999-11-18T21:00:00Z,TLPL 138N 610W,0,0,1,1,2
Hurricane,Lenny,22,1999-11-18T21:00:00Z,TJPS 180N 666W,0,1,1,3,5
Hurricane,Lenny,22,1999-11-18T21:00:00Z,TFFF 146N 610W,1,1,2,1,5
Hurricane,Lenny,22,1999-11-18T21:00:00Z,TJSJ 184N 661W,23,0,0,0,23
Hurricane,Lenny,22,1999-11-18T21:00:00Z,TDPR 153N 614W,3,4,1,2,10
Hurricane,Lenny,22,1999-11-18T21:00:00Z,ST CROIX VI,72,0,0,0,72
Hurricane,Lenny,22,1999-11-18T21:00:00Z,TFFR 163N 615W,16,2,1,0,19
Hurricane,Lenny,22,1999-11-18T21:00:00Z,ST THOMAS VI,94,0,0,0,94
Hurricane,Lenny,22,1999-11-18T21:00:00Z,TAPA 171N 618W,95,0,0,0,95
Hurricane,Lenny,22,1999-11-18T21:00:00Z,SAN JUAN PR,23,0,0,0,23
Hurricane,Lenny,22,1999-11-18T21:00:00Z,TKPK 173N 627W,99,0,0,0,99
Hurricane,Lenny,22,1999-11-18T21:00:00Z,PONCE PR,0,1,1,3,5
Hurricane,Lenny,23,1999-11-19T03:00:00Z,18.7N  62.2W,41,0,0,0,41
Hurricane,Lenny,23,1999-11-19T03:00:00Z,TIST 183N 650W,10,5,3,1,19
Hurricane,Lenny,23,1999-11-19T03:00:00Z,19.4N  61.4W,23,2,3,0,28
Hurricane,Lenny,23,1999-11-19T03:00:00Z,TJPS 180N 666W,0,5,4,2,11
Hurricane,Lenny,23,1999-11-19T03:00:00Z,20.5N  60.0W,3,9,10,2,24
Hurricane,Lenny,23,1999-11-19T03:00:00Z,MDSD 185N 697W,0,0,0,2,2
Hurricane,Lenny,23,1999-11-19T03:00:00Z,TFFF 146N 610W,0,1,0,1,2
Hurricane,Lenny,23,1999-11-19T03:00:00Z,TJSJ 184N 661W,1,7,4,1,13
Hurricane,Lenny,23,1999-11-19T03:00:00Z,TDPR 153N 614W,2,3,1,1,7
Hurricane,Lenny,23,1999-11-19T03:00:00Z,MDPP 198N 707W,0,0,0,2,2
Hurricane,Lenny,23,1999-11-19T03:00:00Z,TFFR 163N 615W,10,3,2,0,15
Hurricane,Lenny,23,1999-11-19T03:00:00Z,MBJT 215N 712W,0,0,0,2,2
Hurricane,Lenny,23,1999-11-19T03:00:00Z,TAPA 171N 618W,23,2,0,0,25
Hurricane,Lenny,23,1999-11-19T03:00:00Z,ST CROIX VI,17,2,1,1,21
Hurricane,Lenny,23,1999-11-19T03:00:00Z,TKPK 173N 627W,99,0,0,0,99
Hurricane,Lenny,23,1999-11-19T03:00:00Z,ST THOMAS VI,10,5,3,1,19
Hurricane,Lenny,23,1999-11-19T03:00:00Z,TNCM 181N 631W,99,0,0,0,99
Hurricane,Lenny,23,1999-11-19T03:00:00Z,SAN JUAN PR,1,7,4,1,13
Hurricane,Lenny,23,1999-11-19T03:00:00Z,TISX 177N 648W,17,2,1,1,21
Hurricane,Lenny,23,1999-11-19T03:00:00Z,PONCE PR,0,5,4,2,11
Hurricane,Lenny,24,1999-11-19T09:00:00Z,18.4N  61.9W,99,0,0,0,99
Hurricane,Lenny,24,1999-11-19T09:00:00Z,TNCM 181N 631W,99,0,0,0,99
Hurricane,Lenny,24,1999-11-19T09:00:00Z,18.9N  61.0W,25,1,1,1,28
Hurricane,Lenny,24,1999-11-19T09:00:00Z,TISX 177N 648W,15,2,1,1,19
Hurricane,Lenny,24,1999-11-19T09:00:00Z,19.5N  60.0W,11,6,3,2,22
Hurricane,Lenny,24,1999-11-19T09:00:00Z,TIST 183N 650W,12,2,2,1,17
Hurricane,Lenny,24,1999-11-19T09:00:00Z,TBPB 131N 595W,0,0,1,1,2
Hurricane,Lenny,24,1999-11-19T09:00:00Z,TJPS 180N 666W,1,3,2,3,9
Hurricane,Lenny,24,1999-11-19T09:00:00Z,TVSV 131N 612W,0,1,1,1,3
Hurricane,Lenny,24,1999-11-19T09:00:00Z,MDSD 185N 697W,0,0,0,2,2
Hurricane,Lenny,24,1999-11-19T09:00:00Z,TLPL 138N 610W,0,3,1,1,5
Hurricane,Lenny,24,1999-11-19T09:00:00Z,TJSJ 184N 661W,3,3,2,3,11
Hurricane,Lenny,24,1999-11-19T09:00:00Z,TFFF 146N 610W,2,5,2,1,10
Hurricane,Lenny,24,1999-11-19T09:00:00Z,ST CROIX VI,15,2,1,1,19
Hurricane,Lenny,24,1999-11-19T09:00:00Z,TDPR 153N 614W,8,4,2,1,15
Hurricane,Lenny,24,1999-11-19T09:00:00Z,ST THOMAS VI,12,2,2,1,17
Hurricane,Lenny,24,1999-11-19T09:00:00Z,TFFR 163N 615W,19,2,1,1,23
Hurricane,Lenny,24,1999-11-19T09:00:00Z,SAN JUAN PR,3,3,2,3,11
Hurricane,Lenny,24,1999-11-19T09:00:00Z,TAPA 171N 618W,41,0,0,0,41
Hurricane,Lenny,24,1999-11-19T09:00:00Z,PONCE PR,1,3,2,3,9
Hurricane,Lenny,24,1999-11-19T09:00:00Z,TKPK 173N 627W,99,0,0,0,99
Hurricane,Lenny,25,1999-11-19T15:00:00Z,18.5N  61.5W,32,1,0,0,33
Hurricane,Lenny,25,1999-11-19T15:00:00Z,TISX 177N 648W,6,4,2,3,15
Hurricane,Lenny,25,1999-11-19T15:00:00Z,19.5N  60.5W,12,9,2,2,25
Hurricane,Lenny,25,1999-11-19T15:00:00Z,TIST 183N 650W,5,3,3,3,14
Hurricane,Lenny,25,1999-11-19T15:00:00Z,20.0N  59.5W,3,13,3,3,22
Hurricane,Lenny,25,1999-11-19T15:00:00Z,TJPS 180N 666W,0,1,3,5,9
Hurricane,Lenny,25,1999-11-19T15:00:00Z,TVSV 131N 612W,0,1,1,0,2
Hurricane,Lenny,25,1999-11-19T15:00:00Z,MDSD 185N 697W,0,0,0,3,3
Hurricane,Lenny,25,1999-11-19T15:00:00Z,TLPL 138N 610W,1,2,1,1,5
Hurricane,Lenny,25,1999-11-19T15:00:00Z,TJSJ 184N 661W,0,2,3,5,10
Hurricane,Lenny,25,1999-11-19T15:00:00Z,TFFF 146N 610W,5,3,1,1,10
Hurricane,Lenny,25,1999-11-19T15:00:00Z,MDPP 198N 707W,0,0,0,2,2
Hurricane,Lenny,25,1999-11-19T15:00:00Z,TDPR 153N 614W,12,2,1,1,16
Hurricane,Lenny,25,1999-11-19T15:00:00Z,ST CROIX VI,6,4,2,3,15
Hurricane,Lenny,25,1999-11-19T15:00:00Z,TFFR 163N 615W,23,1,1,0,25
Hurricane,Lenny,25,1999-11-19T15:00:00Z,ST THOMAS VI,5,3,3,3,14
Hurricane,Lenny,25,1999-11-19T15:00:00Z,TAPA 171N 618W,41,0,0,0,41
Hurricane,Lenny,25,1999-11-19T15:00:00Z,SAN JUAN PR,0,2,3,5,10
Hurricane,Lenny,25,1999-11-19T15:00:00Z,TKPK 173N 627W,99,0,0,0,99
Hurricane,Lenny,25,1999-11-19T15:00:00Z,PONCE PR,0,1,3,5,9
Hurricane,Lenny,25,1999-11-19T15:00:00Z,TNCM 181N 631W,99,0,0,0,99
Tropical Storm,Lenny,26,1999-11-19T21:00:00Z,18.0N  60.0W,32,1,0,0,33
Tropical Storm,Lenny,26,1999-11-19T21:00:00Z,TKPK 173N 627W,99,0,0,0,99
Tropical Storm,Lenny,26,1999-11-19T21:00:00Z,19.0N  59.0W,14,7,2,1,24
Tropical Storm,Lenny,26,1999-11-19T21:00:00Z,TNCM 181N 631W,99,0,0,0,99
Tropical Storm,Lenny,26,1999-11-19T21:00:00Z,20.0N  58.0W,2,12,4,3,21
Tropical Storm,Lenny,26,1999-11-19T21:00:00Z,TISX 177N 648W,0,3,2,2,7
Tropical Storm,Lenny,26,1999-11-19T21:00:00Z,TBPB 131N 595W,0,1,1,0,2
Tropical Storm,Lenny,26,1999-11-19T21:00:00Z,TIST 183N 650W,0,2,3,2,7
Tropical Storm,Lenny,26,1999-11-19T21:00:00Z,TVSV 131N 612W,1,1,0,0,2
Tropical Storm,Lenny,26,1999-11-19T21:00:00Z,TJPS 180N 666W,0,0,1,2,3
Tropical Storm,Lenny,26,1999-11-19T21:00:00Z,TLPL 138N 610W,4,1,1,0,6
Tropical Storm,Lenny,26,1999-11-19T21:00:00Z,TJSJ 184N 661W,0,0,2,2,4
Tropical Storm,Lenny,26,1999-11-19T21:00:00Z,TFFF 146N 610W,12,1,0,1,14
Tropical Storm,Lenny,26,1999-11-19T21:00:00Z,ST CROIX VI,0,3,2,2,7
Tropical Storm,Lenny,26,1999-11-19T21:00:00Z,TDPR 153N 614W,24,0,0,0,24
Tropical Storm,Lenny,26,1999-11-19T21:00:00Z,ST THOMAS VI,0,2,3,2,7
Tropical Storm,Lenny,26,1999-11-19T21:00:00Z,TFFR 163N 615W,45,0,0,0,45
Tropical Storm,Lenny,26,1999-11-19T21:00:00Z,SAN JUAN PR,0,0,2,2,4
Tropical Storm,Lenny,26,1999-11-19T21:00:00Z,TAPA 171N 618W,99,0,0,0,99
Tropical Storm,Lenny,26,1999-11-19T21:00:00Z,PONCE PR,0,0,1,2,3
Tropical Storm,Lenny,27,1999-11-20T03:00:00Z,17.1N  60.5W,44,0,0,0,44
Tropical Storm,Lenny,27,1999-11-20T03:00:00Z,TAPA 171N 618W,99,0,0,0,99
Tropical Storm,Lenny,27,1999-11-20T03:00:00Z,18.0N  59.5W,18,4,2,1,25
Tropical Storm,Lenny,27,1999-11-20T03:00:00Z,TKPK 173N 627W,99,0,0,0,99
Tropical Storm,Lenny,27,1999-11-20T03:00:00Z,19.0N  58.5W,3,12,3,3,21
Tropical Storm,Lenny,27,1999-11-20T03:00:00Z,TNCM 181N 631W,54,0,0,0,54
Tropical Storm,Lenny,27,1999-11-20T03:00:00Z,TBPB 131N 595W,4,3,1,0,8
Tropical Storm,Lenny,27,1999-11-20T03:00:00Z,TISX 177N 648W,2,3,1,1,7
Tropical Storm,Lenny,27,1999-11-20T03:00:00Z,TVSV 131N 612W,3,2,1,0,6
Tropical Storm,Lenny,27,1999-11-20T03:00:00Z,TIST 183N 650W,1,3,1,1,6
Tropical Storm,Lenny,27,1999-11-20T03:00:00Z,TLPL 138N 610W,9,2,1,0,12
Tropical Storm,Lenny,27,1999-11-20T03:00:00Z,TJSJ 184N 661W,0,1,1,1,3
Tropical Storm,Lenny,27,1999-11-20T03:00:00Z,TFFF 146N 610W,21,1,0,0,22
Tropical Storm,Lenny,27,1999-11-20T03:00:00Z,ST CROIX VI,2,3,1,1,7
Tropical Storm,Lenny,27,1999-11-20T03:00:00Z,TDPR 153N 614W,41,1,0,0,42
Tropical Storm,Lenny,27,1999-11-20T03:00:00Z,ST THOMAS VI,1,3,1,1,6
Tropical Storm,Lenny,27,1999-11-20T03:00:00Z,TFFR 163N 615W,99,0,0,0,99
Tropical Storm,Lenny,27,1999-11-20T03:00:00Z,SAN JUAN PR,0,1,1,1,3
Tropical Storm,Lenny,28,1999-11-20T09:00:00Z,17.0N  58.6W,31,1,0,0,32
Tropical Storm,Lenny,28,1999-11-20T09:00:00Z,TFFF 146N 610W,21,0,0,0,21
Tropical Storm,Lenny,28,1999-11-20T09:00:00Z,18.2N  57.6W,13,8,1,1,23
Tropical Storm,Lenny,28,1999-11-20T09:00:00Z,TDPR 153N 614W,36,0,0,0,36
Tropical Storm,Lenny,28,1999-11-20T09:00:00Z,20.0N  56.5W,0,8,9,3,20
Tropical Storm,Lenny,28,1999-11-20T09:00:00Z,TFFR 163N 615W,99,0,0,0,99
Tropical Storm,Lenny,28,1999-11-20T09:00:00Z,TBPB 131N 595W,3,2,0,0,5
Tropical Storm,Lenny,28,1999-11-20T09:00:00Z,TAPA 171N 618W,99,0,0,0,99
Tropical Storm,Lenny,28,1999-11-20T09:00:00Z,TVSV 131N 612W,2,1,0,0,3
Tropical Storm,Lenny,28,1999-11-20T09:00:00Z,TKPK 173N 627W,3,3,1,1,8
Tropical Storm,Lenny,28,1999-11-20T09:00:00Z,TLPL 138N 610W,9,0,1,0,10
Tropical Storm,Lenny,28,1999-11-20T09:00:00Z,TNCM 181N 631W,0,3,2,1,6
Tropical Storm,Lenny,29,1999-11-20T15:00:00Z,16.0N  57.5W,32,1,0,0,33
Tropical Storm,Lenny,29,1999-11-20T15:00:00Z,TLPL 138N 610W,10,0,0,0,10
Tropical Storm,Lenny,29,1999-11-20T15:00:00Z,17.5N  56.0W,8,14,2,0,24
Tropical Storm,Lenny,29,1999-11-20T15:00:00Z,TFFF 146N 610W,24,0,0,0,24
Tropical Storm,Lenny,29,1999-11-20T15:00:00Z,20.0N  55.0W,0,4,14,2,20
Tropical Storm,Lenny,29,1999-11-20T15:00:00Z,TDPR 153N 614W,27,0,0,0,27
Tropical Storm,Lenny,29,1999-11-20T15:00:00Z,TBPB 131N 595W,12,1,0,0,13
Tropical Storm,Lenny,29,1999-11-20T15:00:00Z,TFFR 163N 615W,2,4,1,0,7
Tropical Storm,Lenny,29,1999-11-20T15:00:00Z,TVSV 131N 612W,3,1,0,0,4
Tropical Storm,Lenny,29,1999-11-20T15:00:00Z,TAPA 171N 618W,0,3,1,0,4
Tropical Storm,Lenny,30,1999-11-20T21:00:00Z,16.0N  57.0W,32,0,1,0,33
Tropical Storm,Lenny,30,1999-11-20T21:00:00Z,TFFF 146N 610W,15,0,0,0,15
Tropical Storm,Lenny,30,1999-11-20T21:00:00Z,17.5N  56.0W,11,11,1,1,24
Tropical Storm,Lenny,30,1999-11-20T21:00:00Z,TDPR 153N 614W,2,2,1,0,5
Tropical Storm,Lenny,30,1999-11-20T21:00:00Z,19.5N  54.5W,0,7,11,2,20
Tropical Storm,Lenny,30,1999-11-20T21:00:00Z,TFFR 163N 615W,0,3,2,0,5
Tropical Storm,Lenny,30,1999-11-20T21:00:00Z,TBPB 131N 595W,15,1,0,0,16
Tropical Storm,Lenny,30,1999-11-20T21:00:00Z,TAPA 171N 618W,0,2,2,1,5
Tropical Storm,Lenny,30,1999-11-20T21:00:00Z,TVSV 131N 612W,2,0,0,0,2
Tropical Storm,Lenny,30,1999-11-20T21:00:00Z,TKPK 173N 627W,0,0,2,0,2
Tropical Storm,Lenny,30,1999-11-20T21:00:00Z,TLPL 138N 610W,9,0,1,0,10
Tropical Storm,Lenny,30,1999-11-20T21:00:00Z,TNCM 181N 631W,0,0,1,1,2
Tropical Storm,Lenny,31,1999-11-21T03:00:00Z,15.6N  56.1W,30,1,0,0,31
Tropical Storm,Lenny,31,1999-11-21T03:00:00Z,TLPL 138N 610W,3,1,0,0,4
Tropical Storm,Lenny,31,1999-11-21T03:00:00Z,16.8N  54.8W,12,9,2,0,23
Tropical Storm,Lenny,31,1999-11-21T03:00:00Z,TFFF 146N 610W,8,0,0,0,8
Tropical Storm,Lenny,31,1999-11-21T03:00:00Z,18.3N  53.2W,1,7,9,3,20
Tropical Storm,Lenny,31,1999-11-21T03:00:00Z,TDPR 153N 614W,0,1,1,0,2
Tropical Storm,Lenny,31,1999-11-21T03:00:00Z,TBPB 131N 595W,23,0,0,0,23
Tropical Storm,Lenny,31,1999-11-21T03:00:00Z,TFFR 163N 615W,0,1,0,1,2
Tropical Depression,Lenny,32,1999-11-21T09:00:00Z,18.7N  55.2W,36,0,0,0,36
Tropical Depression,Lenny,32,1999-11-21T09:00:00Z,21.5N  52.0W,1,13,3,3,20
Tropical Depression,Lenny,32,1999-11-21T09:00:00Z,20.2N  53.7W,14,9,1,1,25
Tropical Depression,One,1,2000-06-07T21:00:00Z,22.5N  93.7W,58,0,0,0,58
Tropical Depression,One,1,2000-06-07T21:00:00Z,PORT ARTHUR TX,0,0,0,6,6
Tropical Depression,One,1,2000-06-07T21:00:00Z,23.0N  94.0W,35,0,1,0,36
Tropical Depression,One,1,2000-06-07T21:00:00Z,GALVESTON TX,0,0,1,8,9
Tropical Depression,One,1,2000-06-07T21:00:00Z,23.5N  94.5W,20,3,1,1,25
Tropical Depression,One,1,2000-06-07T21:00:00Z,FREEPORT TX,0,0,1,9,10
Tropical Depression,One,1,2000-06-07T21:00:00Z,MMCZ 205N 869W,0,0,1,1,2
Tropical Depression,One,1,2000-06-07T21:00:00Z,PORT O CONNOR TX,0,0,3,9,12
Tropical Depression,One,1,2000-06-07T21:00:00Z,MMSO 238N 982W,0,1,3,6,10
Tropical Depression,One,1,2000-06-07T21:00:00Z,CORPUSCHRISTI TX,0,0,5,8,13
Tropical Depression,One,1,2000-06-07T21:00:00Z,MMTM 222N 979W,0,1,0,6,7
Tropical Depression,One,1,2000-06-07T21:00:00Z,BROWNSVILLE TX,0,2,7,6,15
Tropical Depression,One,1,2000-06-07T21:00:00Z,MMTX 210N 974W,0,1,0,4,5
Tropical Depression,One,1,2000-06-07T21:00:00Z,GULF 28N 89W,0,0,0,3,3
Tropical Depression,One,1,2000-06-07T21:00:00Z,MMVR 192N 961W,0,0,0,3,3
Tropical Depression,One,1,2000-06-07T21:00:00Z,GULF 28N 91W,0,0,0,6,6
Tropical Depression,One,1,2000-06-07T21:00:00Z,MMFR 185N 926W,0,0,0,3,3
Tropical Depression,One,1,2000-06-07T21:00:00Z,GULF 28N 93W,0,0,1,9,10
Tropical Depression,One,1,2000-06-07T21:00:00Z,MMMD 210N 897W,0,4,3,3,10
Tropical Depression,One,1,2000-06-07T21:00:00Z,GULF 28N 95W,0,0,4,8,12
Tropical Depression,One,1,2000-06-07T21:00:00Z,BURAS LA,0,0,0,2,2
Tropical Depression,One,1,2000-06-07T21:00:00Z,GULF 27N 96W,0,2,7,6,15
Tropical Depression,One,1,2000-06-07T21:00:00Z,NEW ORLEANS LA,0,0,0,2,2
Tropical Depression,One,1,2000-06-07T21:00:00Z,GULF 25N 96W,0,10,5,4,19
Tropical Depression,One,1,2000-06-07T21:00:00Z,NEW IBERIA LA,0,0,0,4,4
Tropical Depression,One,2,2000-06-08T03:00:00Z,21.7N  93.4W,99,0,0,0,99
Tropical Depression,One,2,2000-06-08T03:00:00Z,NEW IBERIA LA,0,0,0,5,5
Tropical Depression,One,2,2000-06-08T03:00:00Z,22.3N  93.9W,34,1,0,0,35
Tropical Depression,One,2,2000-06-08T03:00:00Z,PORT ARTHUR TX,0,0,0,7,7
Tropical Depression,One,2,2000-06-08T03:00:00Z,23.0N  94.5W,16,5,2,1,24
Tropical Depression,One,2,2000-06-08T03:00:00Z,GALVESTON TX,0,0,1,8,9
Tropical Depression,One,2,2000-06-08T03:00:00Z,MMCZ 205N 869W,0,0,0,2,2
Tropical Depression,One,2,2000-06-08T03:00:00Z,FREEPORT TX,0,0,1,9,10
Tropical Depression,One,2,2000-06-08T03:00:00Z,MZBZ 175N 883W,0,0,0,2,2
Tropical Depression,One,2,2000-06-08T03:00:00Z,PORT O CONNOR TX,0,0,3,9,12
Tropical Depression,One,2,2000-06-08T03:00:00Z,MMSO 238N 982W,0,1,2,7,10
Tropical Depression,One,2,2000-06-08T03:00:00Z,CORPUSCHRISTI TX,0,0,4,8,12
Tropical Depression,One,2,2000-06-08T03:00:00Z,MMTM 222N 979W,0,1,1,6,8
Tropical Depression,One,2,2000-06-08T03:00:00Z,BROWNSVILLE TX,0,1,6,7,14
Tropical Depression,One,2,2000-06-08T03:00:00Z,MMTX 210N 974W,0,1,0,6,7
Tropical Depression,One,2,2000-06-08T03:00:00Z,GULF 28N 89W,0,0,0,3,3
Tropical Depression,One,2,2000-06-08T03:00:00Z,MMVR 192N 961W,0,0,1,4,5
Tropical Depression,One,2,2000-06-08T03:00:00Z,GULF 28N 91W,0,0,0,6,6
Tropical Depression,One,2,2000-06-08T03:00:00Z,MMFR 185N 926W,0,1,2,3,6
Tropical Depression,One,2,2000-06-08T03:00:00Z,GULF 28N 93W,0,0,1,9,10
Tropical Depression,One,2,2000-06-08T03:00:00Z,MMMD 210N 897W,3,4,2,2,11
Tropical Depression,One,2,2000-06-08T03:00:00Z,GULF 28N 95W,0,0,4,8,12
Tropical Depression,One,2,2000-06-08T03:00:00Z,BURAS LA,0,0,0,2,2
Tropical Depression,One,2,2000-06-08T03:00:00Z,GULF 27N 96W,0,1,7,7,15
Tropical Depression,One,2,2000-06-08T03:00:00Z,NEW ORLEANS LA,0,0,0,3,3
Tropical Depression,One,2,2000-06-08T03:00:00Z,GULF 25N 96W,0,7,7,4,18
Tropical Depression,One,3,2000-06-08T09:00:00Z,21.5N  94.0W,50,0,0,0,50
Tropical Depression,One,3,2000-06-08T09:00:00Z,PORT ARTHUR TX,0,0,0,7,7
Tropical Depression,One,3,2000-06-08T09:00:00Z,22.5N  94.5W,22,4,1,1,28
Tropical Depression,One,3,2000-06-08T09:00:00Z,GALVESTON TX,0,0,0,9,9
Tropical Depression,One,3,2000-06-08T09:00:00Z,23.5N  95.0W,4,16,2,2,24
Tropical Depression,One,3,2000-06-08T09:00:00Z,FREEPORT TX,0,0,0,10,10
Tropical Depression,One,3,2000-06-08T09:00:00Z,MMCZ 205N 869W,0,0,0,2,2
Tropical Depression,One,3,2000-06-08T09:00:00Z,PORT O CONNOR TX,0,0,1,10,11
Tropical Depression,One,3,2000-06-08T09:00:00Z,MMSO 238N 982W,0,3,5,5,13
Tropical Depression,One,3,2000-06-08T09:00:00Z,CORPUSCHRISTI TX,0,0,3,9,12
Tropical Depression,One,3,2000-06-08T09:00:00Z,MMTM 222N 979W,0,3,3,4,10
Tropical Depression,One,3,2000-06-08T09:00:00Z,BROWNSVILLE TX,0,1,8,7,16
Tropical Depression,One,3,2000-06-08T09:00:00Z,MMTX 210N 974W,1,2,1,3,7
Tropical Depression,One,3,2000-06-08T09:00:00Z,GULF 28N 89W,0,0,0,3,3
Tropical Depression,One,3,2000-06-08T09:00:00Z,MMVR 192N 961W,2,1,0,2,5
Tropical Depression,One,3,2000-06-08T09:00:00Z,GULF 28N 91W,0,0,0,6,6
Tropical Depression,One,3,2000-06-08T09:00:00Z,MMFR 185N 926W,1,0,0,2,3
Tropical Depression,One,3,2000-06-08T09:00:00Z,GULF 28N 93W,0,0,1,8,9
Tropical Depression,One,3,2000-06-08T09:00:00Z,MMMD 210N 897W,0,4,3,2,9
Tropical Depression,One,3,2000-06-08T09:00:00Z,GULF 28N 95W,0,0,2,10,12
Tropical Depression,One,3,2000-06-08T09:00:00Z,BURAS LA,0,0,0,3,3
Tropical Depression,One,3,2000-06-08T09:00:00Z,GULF 27N 96W,0,0,6,8,14
Tropical Depression,One,3,2000-06-08T09:00:00Z,NEW ORLEANS LA,0,0,0,3,3
Tropical Depression,One,3,2000-06-08T09:00:00Z,GULF 25N 96W,0,7,8,4,19
Tropical Depression,One,3,2000-06-08T09:00:00Z,NEW IBERIA LA,0,0,0,4,4
Tropical Depression,One,4,2000-06-08T15:00:00Z,21.9N  94.4W,52,0,0,0,52
Tropical Depression,One,4,2000-06-08T15:00:00Z,PORT ARTHUR TX,0,0,0,7,7
Tropical Depression,One,4,2000-06-08T15:00:00Z,23.0N  95.0W,18,9,1,0,28
Tropical Depression,One,4,2000-06-08T15:00:00Z,GALVESTON TX,0,0,0,9,9
Tropical Depression,One,4,2000-06-08T15:00:00Z,24.0N  95.5W,2,17,2,2,23
Tropical Depression,One,4,2000-06-08T15:00:00Z,FREEPORT TX,0,0,0,10,10
Tropical Depression,One,4,2000-06-08T15:00:00Z,MMSO 238N 982W,0,5,7,3,15
Tropical Depression,One,4,2000-06-08T15:00:00Z,PORT O CONNOR TX,0,0,1,10,11
Tropical Depression,One,4,2000-06-08T15:00:00Z,MMTM 222N 979W,0,6,3,3,12
Tropical Depression,One,4,2000-06-08T15:00:00Z,CORPUSCHRISTI TX,0,0,2,10,12
Tropical Depression,One,4,2000-06-08T15:00:00Z,MMTX 210N 974W,1,4,1,3,9
Tropical Depression,One,4,2000-06-08T15:00:00Z,BROWNSVILLE TX,0,1,8,7,16
Tropical Depression,One,4,2000-06-08T15:00:00Z,MMVR 192N 961W,2,1,0,1,4
Tropical Depression,One,4,2000-06-08T15:00:00Z,GULF 29N 87W,0,0,0,2,2
Tropical Depression,One,4,2000-06-08T15:00:00Z,MMMD 210N 897W,0,0,1,3,4
Tropical Depression,One,4,2000-06-08T15:00:00Z,GULF 28N 89W,0,0,0,5,5
Tropical Depression,One,4,2000-06-08T15:00:00Z,MOBILE AL,0,0,0,2,2
Tropical Depression,One,4,2000-06-08T15:00:00Z,GULF 28N 91W,0,0,1,7,8
Tropical Depression,One,4,2000-06-08T15:00:00Z,GULFPORT MS,0,0,0,2,2
Tropical Depression,One,4,2000-06-08T15:00:00Z,GULF 28N 93W,0,0,1,10,11
Tropical Depression,One,4,2000-06-08T15:00:00Z,BURAS LA,0,0,0,4,4
Tropical Depression,One,4,2000-06-08T15:00:00Z,GULF 28N 95W,0,0,2,10,12
Tropical Depression,One,4,2000-06-08T15:00:00Z,NEW ORLEANS LA,0,0,0,4,4
Tropical Depression,One,4,2000-06-08T15:00:00Z,GULF 27N 96W,0,0,6,8,14
Tropical Depression,One,4,2000-06-08T15:00:00Z,NEW IBERIA LA,0,0,0,5,5
Tropical Depression,One,4,2000-06-08T15:00:00Z,GULF 25N 96W,0,8,8,3,19
Tropical Depression,Two,1,2000-06-24T15:00:00Z,9.7N  35.6W,42,2,0,0,44
Tropical Depression,Two,1,2000-06-24T15:00:00Z,10.5N  42.5W,0,1,25,1,27
Tropical Depression,Two,1,2000-06-24T15:00:00Z,10.1N  39.0W,0,31,2,0,33
Tropical Depression,Two,2,2000-06-24T21:00:00Z,10.2N  36.7W,42,2,0,0,44
Tropical Depression,Two,2,2000-06-24T21:00:00Z,11.0N  43.5W,0,1,25,1,27
Tropical Depression,Two,2,2000-06-24T21:00:00Z,10.5N  40.1W,0,32,1,0,33
Tropical Depression,Two,3,2000-06-25T03:00:00Z,10.9N  38.4W,41,3,0,0,44
Tropical Depression,Two,3,2000-06-25T03:00:00Z,12.0N  45.0W,0,2,24,1,27
Tropical Depression,Two,3,2000-06-25T03:00:00Z,11.4N  41.7W,0,31,2,0,33
Tropical Depression,Two,4,2000-06-25T09:00:00Z,10.8N  41.0W,43,4,0,0,47
Tropical Depression,Two,4,2000-06-25T09:00:00Z,TLPL 138N 610W,0,0,0,5,5
Tropical Depression,Two,4,2000-06-25T09:00:00Z,11.5N  45.0W,0,32,4,0,36
Tropical Depression,Two,4,2000-06-25T09:00:00Z,TFFF 146N 610W,0,0,0,6,6
Tropical Depression,Two,4,2000-06-25T09:00:00Z,12.3N  49.1W,0,0,27,1,28
Tropical Depression,Two,4,2000-06-25T09:00:00Z,TDPR 153N 614W,0,0,0,5,5
Tropical Depression,Two,4,2000-06-25T09:00:00Z,TTPP 106N 614W,0,0,0,2,2
Tropical Depression,Two,4,2000-06-25T09:00:00Z,TFFR 163N 615W,0,0,0,5,5
Tropical Depression,Two,4,2000-06-25T09:00:00Z,TTPT 112N 608W,0,0,0,3,3
Tropical Depression,Two,4,2000-06-25T09:00:00Z,TAPA 171N 618W,0,0,0,4,4
Tropical Depression,Two,4,2000-06-25T09:00:00Z,TGPY 120N 618W,0,0,0,2,2
Tropical Depression,Two,4,2000-06-25T09:00:00Z,TKPK 173N 627W,0,0,0,2,2
Tropical Depression,Two,4,2000-06-25T09:00:00Z,TBPB 131N 595W,0,0,0,9,9
Tropical Depression,Two,4,2000-06-25T09:00:00Z,TNCM 181N 631W,0,0,0,2,2
Tropical Depression,Two,4,2000-06-25T09:00:00Z,TVSV 131N 612W,0,0,0,4,4
Tropical Depression,Two,5,2000-06-25T15:00:00Z,10.0N  44.0W,41,5,0,0,46
Tropical Depression,Two,5,2000-06-25T15:00:00Z,TFFF 146N 610W,0,0,0,13,13
Tropical Depression,Two,5,2000-06-25T15:00:00Z,10.0N  48.0W,0,33,3,0,36
Tropical Depression,Two,5,2000-06-25T15:00:00Z,TDPR 153N 614W,0,0,0,11,11
Tropical Depression,Two,5,2000-06-25T15:00:00Z,11.0N  52.0W,0,0,27,2,29
Tropical Depression,Two,5,2000-06-25T15:00:00Z,TFFR 163N 615W,0,0,0,10,10
Tropical Depression,Two,5,2000-06-25T15:00:00Z,SVMG 110N 640W,0,0,0,2,2
Tropical Depression,Two,5,2000-06-25T15:00:00Z,TAPA 171N 618W,0,0,0,9,9
Tropical Depression,Two,5,2000-06-25T15:00:00Z,TTPP 106N 614W,0,0,0,8,8
Tropical Depression,Two,5,2000-06-25T15:00:00Z,TKPK 173N 627W,0,0,0,7,7
Tropical Depression,Two,5,2000-06-25T15:00:00Z,TTPT 112N 608W,0,0,0,11,11
Tropical Depression,Two,5,2000-06-25T15:00:00Z,TNCM 181N 631W,0,0,0,5,5
Tropical Depression,Two,5,2000-06-25T15:00:00Z,TGPY 120N 618W,0,0,0,9,9
Tropical Depression,Two,5,2000-06-25T15:00:00Z,TISX 177N 648W,0,0,0,3,3
Tropical Depression,Two,5,2000-06-25T15:00:00Z,TBPB 131N 595W,0,0,0,16,16
Tropical Depression,Two,5,2000-06-25T15:00:00Z,TIST 183N 650W,0,0,0,2,2
Tropical Depression,Two,5,2000-06-25T15:00:00Z,TVSV 131N 612W,0,0,0,12,12
Tropical Depression,Two,5,2000-06-25T15:00:00Z,ST CROIX VI,0,0,0,3,3
Tropical Depression,Two,5,2000-06-25T15:00:00Z,TLPL 138N 610W,0,0,0,13,13
Tropical Depression,Two,5,2000-06-25T15:00:00Z,ST THOMAS VI,0,0,0,2,2
Tropical Storm,Alberto,2,2000-08-04T15:00:00Z,13.0N  30.5W,43,1,0,0,44
Tropical Storm,Alberto,2,2000-08-04T15:00:00Z,14.0N  36.5W,0,2,18,2,22
Tropical Storm,Alberto,2,2000-08-04T15:00:00Z,13.5N  33.5W,0,27,2,0,29
Tropical Storm,Alberto,3,2000-08-04T21:00:00Z,13.5N  31.5W,42,2,0,0,44
Tropical Storm,Alberto,3,2000-08-04T21:00:00Z,14.5N  37.5W,0,1,21,1,23
Tropical Storm,Alberto,3,2000-08-04T21:00:00Z,14.0N  34.5W,0,29,1,0,30
Tropical Storm,Alberto,4,2000-08-05T03:00:00Z,14.4N  32.6W,46,1,0,0,47
Tropical Storm,Alberto,4,2000-08-05T03:00:00Z,15.5N  39.0W,0,1,21,1,23
Tropical Storm,Alberto,4,2000-08-05T03:00:00Z,15.1N  35.7W,0,30,1,0,31
Tropical Storm,Alberto,5,2000-08-05T09:00:00Z,14.7N  33.4W,46,1,0,0,47
Tropical Storm,Alberto,5,2000-08-05T09:00:00Z,15.5N  40.0W,0,1,21,1,23
Tropical Storm,Alberto,5,2000-08-05T09:00:00Z,15.1N  36.4W,0,30,1,0,31
Tropical Storm,Alberto,6,2000-08-05T15:00:00Z,15.3N  35.2W,46,0,0,0,46
Tropical Storm,Alberto,6,2000-08-05T15:00:00Z,16.5N  41.0W,0,2,19,1,22
Tropical Storm,Alberto,6,2000-08-05T15:00:00Z,16.0N  38.0W,0,29,1,0,30
Hurricane,Alberto,7,2000-08-05T21:00:00Z,15.5N  37.0W,44,1,0,0,45
Hurricane,Alberto,7,2000-08-05T21:00:00Z,17.0N  43.0W,0,1,21,1,23
Hurricane,Alberto,7,2000-08-05T21:00:00Z,16.0N  39.5W,1,28,1,0,30
Hurricane,Alberto,8,2000-08-06T03:00:00Z,15.5N  39.8W,41,2,0,0,43
Hurricane,Alberto,8,2000-08-06T03:00:00Z,16.9N  46.0W,0,2,19,2,23
Hurricane,Alberto,8,2000-08-06T03:00:00Z,16.2N  43.1W,0,28,1,0,29
Hurricane,Alberto,9,2000-08-06T09:00:00Z,14.8N  40.9W,41,1,0,0,42
Hurricane,Alberto,9,2000-08-06T09:00:00Z,16.0N  46.5W,0,3,19,1,23
Hurricane,Alberto,9,2000-08-06T09:00:00Z,15.2N  43.8W,1,28,0,0,29
Hurricane,Alberto,10,2000-08-06T15:00:00Z,15.4N  40.4W,44,0,0,1,45
Hurricane,Alberto,10,2000-08-06T15:00:00Z,16.5N  46.5W,0,1,20,1,22
Hurricane,Alberto,10,2000-08-06T15:00:00Z,15.9N  43.4W,0,29,1,0,30
Hurricane,Alberto,11,2000-08-06T21:00:00Z,16.2N  41.3W,43,0,0,0,43
Hurricane,Alberto,11,2000-08-06T21:00:00Z,17.5N  46.0W,0,5,16,1,22
Hurricane,Alberto,11,2000-08-06T21:00:00Z,16.7N  43.7W,1,28,0,0,29
Hurricane,Alberto,12,2000-08-07T03:00:00Z,17.5N  42.6W,45,0,0,0,45
Hurricane,Alberto,12,2000-08-07T03:00:00Z,19.5N  46.9W,0,6,14,2,22
Hurricane,Alberto,12,2000-08-07T03:00:00Z,18.5N  44.9W,1,28,0,1,30
Hurricane,Alberto,13,2000-08-07T09:00:00Z,17.4N  44.6W,45,0,0,0,45
Hurricane,Alberto,13,2000-08-07T09:00:00Z,19.5N  49.0W,0,5,15,2,22
Hurricane,Alberto,13,2000-08-07T09:00:00Z,18.4N  46.8W,2,26,1,0,29
Hurricane,Alberto,14,2000-08-07T15:00:00Z,17.6N  46.0W,44,0,0,0,44
Hurricane,Alberto,14,2000-08-07T15:00:00Z,20.0N  50.0W,0,6,15,2,23
Hurricane,Alberto,14,2000-08-07T15:00:00Z,18.8N  48.1W,2,28,0,0,30
Hurricane,Alberto,15,2000-08-07T21:00:00Z,17.9N  47.1W,44,0,0,1,45
Hurricane,Alberto,15,2000-08-07T21:00:00Z,20.0N  51.0W,0,6,15,2,23
Hurricane,Alberto,15,2000-08-07T21:00:00Z,18.8N  49.1W,3,26,1,0,30
Hurricane,Alberto,16,2000-08-08T03:00:00Z,17.7N  48.1W,42,1,0,0,43
Hurricane,Alberto,16,2000-08-08T03:00:00Z,20.0N  52.5W,0,4,17,2,23
Hurricane,Alberto,16,2000-08-08T03:00:00Z,18.7N  50.3W,1,27,1,0,29
Hurricane,Alberto,17,2000-08-08T09:00:00Z,18.5N  49.9W,43,0,0,0,43
Hurricane,Alberto,17,2000-08-08T09:00:00Z,TFFR 163N 615W,0,0,0,7,7
Hurricane,Alberto,17,2000-08-08T09:00:00Z,19.6N  52.4W,1,27,1,0,29
Hurricane,Alberto,17,2000-08-08T09:00:00Z,TAPA 171N 618W,0,0,0,8,8
Hurricane,Alberto,17,2000-08-08T09:00:00Z,21.0N  54.8W,0,4,17,2,23
Hurricane,Alberto,17,2000-08-08T09:00:00Z,TKPK 173N 627W,0,0,0,6,6
Hurricane,Alberto,17,2000-08-08T09:00:00Z,TBPB 131N 595W,0,0,0,4,4
Hurricane,Alberto,17,2000-08-08T09:00:00Z,TNCM 181N 631W,0,0,0,7,7
Hurricane,Alberto,17,2000-08-08T09:00:00Z,TVSV 131N 612W,0,0,0,2,2
Hurricane,Alberto,17,2000-08-08T09:00:00Z,TISX 177N 648W,0,0,0,3,3
Hurricane,Alberto,17,2000-08-08T09:00:00Z,TLPL 138N 610W,0,0,0,3,3
Hurricane,Alberto,17,2000-08-08T09:00:00Z,TIST 183N 650W,0,0,0,3,3
Hurricane,Alberto,17,2000-08-08T09:00:00Z,TFFF 146N 610W,0,0,0,5,5
Hurricane,Alberto,17,2000-08-08T09:00:00Z,ST CROIX VI,0,0,0,3,3
Hurricane,Alberto,17,2000-08-08T09:00:00Z,TDPR 153N 614W,0,0,0,5,5
Hurricane,Alberto,17,2000-08-08T09:00:00Z,ST THOMAS VI,0,0,0,3,3
Hurricane,Alberto,18,2000-08-08T15:00:00Z,18.7N  49.8W,53,0,0,0,53
Hurricane,Alberto,18,2000-08-08T15:00:00Z,TAPA 171N 618W,0,0,0,2,2
Hurricane,Alberto,18,2000-08-08T15:00:00Z,19.7N  51.8W,5,26,0,1,32
Hurricane,Alberto,18,2000-08-08T15:00:00Z,TNCM 181N 631W,0,0,0,2,2
Hurricane,Alberto,18,2000-08-08T15:00:00Z,21.0N  54.0W,0,11,12,1,24
Hurricane,Alberto,19,2000-08-08T21:00:00Z,20.0N  50.8W,43,1,0,0,44
Hurricane,Alberto,19,2000-08-08T21:00:00Z,22.0N  55.0W,0,15,6,2,23
Hurricane,Alberto,19,2000-08-08T21:00:00Z,21.0N  53.0W,10,18,1,0,29
Hurricane,Alberto,19,2000-08-08T21:00:00Z,TAPA 171N 618W,0,0,0,2,2
Tropical Storm,Alberto,20,2000-08-09T03:00:00Z,22.4N  51.1W,48,0,0,0,48
Tropical Storm,Alberto,20,2000-08-09T03:00:00Z,25.0N  55.5W,0,17,3,2,22
Tropical Storm,Alberto,20,2000-08-09T03:00:00Z,23.5N  53.4W,14,14,0,1,29
Tropical Storm,Alberto,20,2000-08-09T03:00:00Z,BERMUDA,0,0,0,4,4
Tropical Storm,Alberto,21,2000-08-09T09:00:00Z,23.5N  52.5W,45,0,0,0,45
Tropical Storm,Alberto,21,2000-08-09T09:00:00Z,27.0N  56.0W,1,17,3,1,22
Tropical Storm,Alberto,21,2000-08-09T09:00:00Z,25.0N  54.5W,17,11,0,0,28
Tropical Storm,Alberto,21,2000-08-09T09:00:00Z,BERMUDA,0,0,0,7,7
Tropical Storm,Alberto,22,2000-08-09T15:00:00Z,25.8N  54.4W,51,0,0,0,51
Tropical Storm,Alberto,22,2000-08-09T15:00:00Z,29.5N  58.0W,1,18,3,1,23
Tropical Storm,Alberto,22,2000-08-09T15:00:00Z,27.6N  56.2W,22,9,1,0,32
Tropical Storm,Alberto,22,2000-08-09T15:00:00Z,BERMUDA,0,0,2,8,10
Hurricane,Alberto,23,2000-08-09T21:00:00Z,28.2N  56.0W,44,0,0,0,44
Hurricane,Alberto,23,2000-08-09T21:00:00Z,BERMUDA,0,0,4,3,7
Hurricane,Alberto,23,2000-08-09T21:00:00Z,30.5N  57.7W,11,16,1,0,28
Hurricane,Alberto,23,2000-08-09T21:00:00Z,SABLE ISLAND NS,0,0,0,3,3
Hurricane,Alberto,23,2000-08-09T21:00:00Z,33.0N  58.5W,0,14,6,1,21
Hurricane,Alberto,24,2000-08-10T03:00:00Z,30.3N  57.4W,40,0,0,0,40
Hurricane,Alberto,24,2000-08-10T03:00:00Z,HALIFAX NS,0,0,0,4,4
Hurricane,Alberto,24,2000-08-10T03:00:00Z,32.9N  58.4W,6,18,1,0,25
Hurricane,Alberto,24,2000-08-10T03:00:00Z,SABLE ISLAND NS,0,0,0,6,6
Hurricane,Alberto,24,2000-08-10T03:00:00Z,35.0N  58.5W,0,10,7,2,19
Hurricane,Alberto,24,2000-08-10T03:00:00Z,SYDNEY NS,0,0,0,3,3
Hurricane,Alberto,24,2000-08-10T03:00:00Z,BERMUDA,0,2,2,2,6
Hurricane,Alberto,24,2000-08-10T03:00:00Z,EDDY POINT NS,0,0,0,4,4
Hurricane,Alberto,24,2000-08-10T03:00:00Z,EASTPORT ME,0,0,0,2,2
Hurricane,Alberto,24,2000-08-10T03:00:00Z,PTX BASQUES NFLD,0,0,0,2,2
Hurricane,Alberto,24,2000-08-10T03:00:00Z,ST JOHN NB,0,0,0,2,2
Hurricane,Alberto,24,2000-08-10T03:00:00Z,BURGEO NFLD,0,0,0,2,2
Hurricane,Alberto,24,2000-08-10T03:00:00Z,MONCTON NB,0,0,0,2,2
Hurricane,Alberto,24,2000-08-10T03:00:00Z,ILE ST PIERRE,0,0,0,2,2
Hurricane,Alberto,24,2000-08-10T03:00:00Z,YARMOUTH NS,0,0,0,3,3
Hurricane,Alberto,25,2000-08-10T09:00:00Z,31.5N  58.0W,40,0,1,0,41
Hurricane,Alberto,25,2000-08-10T09:00:00Z,EDDY POINT NS,0,0,0,3,3
Hurricane,Alberto,25,2000-08-10T09:00:00Z,34.0N  58.5W,9,16,0,1,26
Hurricane,Alberto,25,2000-08-10T09:00:00Z,PTX BASQUES NFLD,0,0,0,3,3
Hurricane,Alberto,25,2000-08-10T09:00:00Z,36.5N  56.5W,0,5,12,2,19
Hurricane,Alberto,25,2000-08-10T09:00:00Z,BURGEO NFLD,0,0,0,4,4
Hurricane,Alberto,25,2000-08-10T09:00:00Z,BERMUDA,0,1,2,0,3
Hurricane,Alberto,25,2000-08-10T09:00:00Z,ILE ST PIERRE,0,0,0,5,5
Hurricane,Alberto,25,2000-08-10T09:00:00Z,HALIFAX NS,0,0,0,2,2
Hurricane,Alberto,25,2000-08-10T09:00:00Z,CAPE RACE NFLD,0,0,0,6,6
Hurricane,Alberto,25,2000-08-10T09:00:00Z,SABLE ISLAND NS,0,0,0,7,7
Hurricane,Alberto,25,2000-08-10T09:00:00Z,HIBERNIA OILFLD,0,0,0,3,3
Hurricane,Alberto,25,2000-08-10T09:00:00Z,SYDNEY NS,0,0,0,4,4
Hurricane,Alberto,26,2000-08-10T15:00:00Z,33.0N  58.2W,45,0,0,0,45
Hurricane,Alberto,26,2000-08-10T15:00:00Z,PTX BASQUES NFLD,0,0,0,3,3
Hurricane,Alberto,26,2000-08-10T15:00:00Z,35.6N  57.5W,4,23,2,0,29
Hurricane,Alberto,26,2000-08-10T15:00:00Z,BURGEO NFLD,0,0,0,5,5
Hurricane,Alberto,26,2000-08-10T15:00:00Z,38.0N  55.0W,0,2,17,2,21
Hurricane,Alberto,26,2000-08-10T15:00:00Z,ILE ST PIERRE,0,0,0,7,7
Hurricane,Alberto,26,2000-08-10T15:00:00Z,SABLE ISLAND NS,0,0,1,5,6
Hurricane,Alberto,26,2000-08-10T15:00:00Z,CAPE RACE NFLD,0,0,0,9,9
Hurricane,Alberto,26,2000-08-10T15:00:00Z,SYDNEY NS,0,0,0,4,4
Hurricane,Alberto,26,2000-08-10T15:00:00Z,HIBERNIA OILFLD,0,0,0,7,7
Hurricane,Alberto,26,2000-08-10T15:00:00Z,EDDY POINT NS,0,0,0,3,3
Hurricane,Alberto,27,2000-08-10T21:00:00Z,34.3N  58.7W,41,1,0,0,42
Hurricane,Alberto,27,2000-08-10T21:00:00Z,PTX BASQUES NFLD,0,0,0,3,3
Hurricane,Alberto,27,2000-08-10T21:00:00Z,37.1N  57.0W,3,24,3,0,30
Hurricane,Alberto,27,2000-08-10T21:00:00Z,BURGEO NFLD,0,0,0,4,4
Hurricane,Alberto,27,2000-08-10T21:00:00Z,39.5N  53.0W,0,1,16,3,20
Hurricane,Alberto,27,2000-08-10T21:00:00Z,ILE ST PIERRE,0,0,1,6,7
Hurricane,Alberto,27,2000-08-10T21:00:00Z,SABLE ISLAND NS,0,0,3,2,5
Hurricane,Alberto,27,2000-08-10T21:00:00Z,CAPE RACE NFLD,0,0,1,8,9
Hurricane,Alberto,27,2000-08-10T21:00:00Z,SYDNEY NS,0,0,1,2,3
Hurricane,Alberto,27,2000-08-10T21:00:00Z,HIBERNIA OILFLD,0,0,0,9,9
Hurricane,Alberto,27,2000-08-10T21:00:00Z,EDDY POINT NS,0,0,0,2,2
Hurricane,Alberto,28,2000-08-11T03:00:00Z,34.8N  57.9W,29,3,0,0,32
Hurricane,Alberto,28,2000-08-11T03:00:00Z,PTX BASQUES NFLD,0,0,0,2,2
Hurricane,Alberto,28,2000-08-11T03:00:00Z,37.7N  55.8W,0,18,3,1,22
Hurricane,Alberto,28,2000-08-11T03:00:00Z,BURGEO NFLD,0,0,0,3,3
Hurricane,Alberto,28,2000-08-11T03:00:00Z,40.5N  51.5W,0,1,12,3,16
Hurricane,Alberto,28,2000-08-11T03:00:00Z,ILE ST PIERRE,0,0,1,4,5
Hurricane,Alberto,28,2000-08-11T03:00:00Z,SABLE ISLAND NS,0,0,2,2,4
Hurricane,Alberto,28,2000-08-11T03:00:00Z,CAPE RACE NFLD,0,0,1,6,7
Hurricane,Alberto,28,2000-08-11T03:00:00Z,SYDNEY NS,0,0,0,2,2
Hurricane,Alberto,28,2000-08-11T03:00:00Z,HIBERNIA OILFLD,0,0,0,9,9
Hurricane,Alberto,28,2000-08-11T03:00:00Z,EDDY POINT NS,0,0,1,1,2
Hurricane,Alberto,29,2000-08-11T09:00:00Z,37.5N  56.5W,42,4,0,0,46
Hurricane,Alberto,29,2000-08-11T09:00:00Z,ILE ST PIERRE,0,0,2,1,3
Hurricane,Alberto,29,2000-08-11T09:00:00Z,40.5N  52.0W,0,17,4,0,21
Hurricane,Alberto,29,2000-08-11T09:00:00Z,CAPE RACE NFLD,0,0,3,3,6
Hurricane,Alberto,29,2000-08-11T09:00:00Z,42.3N  46.8W,0,1,11,3,15
Hurricane,Alberto,29,2000-08-11T09:00:00Z,HIBERNIA OILFLD,0,0,3,6,9
Hurricane,Alberto,29,2000-08-11T09:00:00Z,SABLE ISLAND NS,0,1,1,0,2
Hurricane,Alberto,30,2000-08-11T15:00:00Z,37.8N  55.7W,26,9,0,0,35
Hurricane,Alberto,30,2000-08-11T15:00:00Z,CAPE RACE NFLD,0,0,3,0,3
Hurricane,Alberto,30,2000-08-11T15:00:00Z,40.3N  50.4W,0,12,8,0,20
Hurricane,Alberto,30,2000-08-11T15:00:00Z,HIBERNIA OILFLD,0,0,3,4,7
Hurricane,Alberto,30,2000-08-11T15:00:00Z,42.5N  43.5W,0,0,9,5,14
Hurricane,Alberto,31,2000-08-11T21:00:00Z,38.9N  53.0W,28,5,0,0,33
Hurricane,Alberto,31,2000-08-11T21:00:00Z,CAPE RACE NFLD,0,1,1,1,3
Hurricane,Alberto,31,2000-08-11T21:00:00Z,41.6N  46.8W,0,13,4,0,17
Hurricane,Alberto,31,2000-08-11T21:00:00Z,HIBERNIA OILFLD,0,1,4,1,6
Hurricane,Alberto,31,2000-08-11T21:00:00Z,43.5N  40.0W,0,1,8,3,12
Hurricane,Alberto,32,2000-08-12T03:00:00Z,39.9N  50.5W,16,3,0,0,19
Hurricane,Alberto,32,2000-08-12T03:00:00Z,ILE ST PIERRE,0,1,1,0,2
Hurricane,Alberto,32,2000-08-12T03:00:00Z,42.1N  44.2W,0,9,4,0,13
Hurricane,Alberto,32,2000-08-12T03:00:00Z,CAPE RACE NFLD,0,3,1,0,4
Hurricane,Alberto,32,2000-08-12T03:00:00Z,43.7N  36.3W,0,0,7,4,11
Hurricane,Alberto,32,2000-08-12T03:00:00Z,HIBERNIA OILFLD,0,3,3,1,7
Hurricane,Alberto,33,2000-08-12T09:00:00Z,39.7N  50.0W,23,2,1,0,26
Hurricane,Alberto,33,2000-08-12T09:00:00Z,CAPE RACE NFLD,0,1,1,0,2
Hurricane,Alberto,33,2000-08-12T09:00:00Z,41.5N  44.5W,0,11,3,1,15
Hurricane,Alberto,33,2000-08-12T09:00:00Z,HIBERNIA OILFLD,0,2,3,1,6
Hurricane,Alberto,33,2000-08-12T09:00:00Z,43.0N  38.0W,0,1,7,3,11
Hurricane,Alberto,34,2000-08-12T15:00:00Z,40.0N  48.0W,27,0,0,1,28
Hurricane,Alberto,34,2000-08-12T15:00:00Z,41.5N  36.5W,0,1,7,3,11
Hurricane,Alberto,34,2000-08-12T15:00:00Z,41.0N  43.5W,2,11,3,0,16
Hurricane,Alberto,34,2000-08-12T15:00:00Z,HIBERNIA OILFLD,0,2,2,0,4
Hurricane,Alberto,35,2000-08-12T21:00:00Z,40.0N  46.5W,26,1,0,0,27
Hurricane,Alberto,35,2000-08-12T21:00:00Z,39.5N  40.0W,0,7,3,4,14
Hurricane,Alberto,35,2000-08-12T21:00:00Z,40.0N  43.0W,6,8,2,1,17
Hurricane,Alberto,35,2000-08-12T21:00:00Z,HIBERNIA OILFLD,0,1,2,1,4
Hurricane,Alberto,36,2000-08-13T03:00:00Z,39.3N  44.2W,23,1,0,0,24
Hurricane,Alberto,36,2000-08-13T03:00:00Z,39.0N  38.0W,0,7,4,3,14
Hurricane,Alberto,36,2000-08-13T03:00:00Z,39.3N  41.0W,6,7,2,2,17
Hurricane,Alberto,36,2000-08-13T03:00:00Z,HIBERNIA OILFLD,0,0,1,1,2
Hurricane,Alberto,37,2000-08-13T09:00:00Z,39.5N  43.0W,24,0,1,0,25
Hurricane,Alberto,37,2000-08-13T09:00:00Z,38.5N  37.5W,1,7,3,3,14
Hurricane,Alberto,37,2000-08-13T09:00:00Z,39.5N  40.0W,7,7,1,2,17
Hurricane,Alberto,37,2000-08-13T09:00:00Z,HIBERNIA OILFLD,0,0,1,1,2
Hurricane,Alberto,38,2000-08-13T15:00:00Z,39.5N  41.0W,23,1,0,1,25
Hurricane,Alberto,38,2000-08-13T15:00:00Z,38.5N  37.0W,2,7,3,3,15
Hurricane,Alberto,38,2000-08-13T15:00:00Z,39.3N  38.7W,9,5,2,1,17
Hurricane,Alberto,38,2000-08-13T15:00:00Z,HIBERNIA OILFLD,0,0,0,2,2
Hurricane,Alberto,39,2000-08-13T21:00:00Z,39.4N  40.0W,24,1,0,0,25
Hurricane,Alberto,39,2000-08-13T21:00:00Z,38.0N  38.5W,15,3,1,1,20
Hurricane,Alberto,39,2000-08-13T21:00:00Z,38.6N  38.5W,16,2,1,1,20
Hurricane,Alberto,40,2000-08-14T03:00:00Z,39.0N  39.2W,33,0,1,0,34
Hurricane,Alberto,40,2000-08-14T03:00:00Z,37.0N  39.0W,18,2,1,1,22
Hurricane,Alberto,40,2000-08-14T03:00:00Z,38.0N  38.2W,21,1,1,1,24
Hurricane,Alberto,41,2000-08-14T09:00:00Z,37.0N  39.0W,31,0,0,0,31
Hurricane,Alberto,41,2000-08-14T09:00:00Z,36.3N  41.0W,23,1,0,1,25
Hurricane,Alberto,41,2000-08-14T09:00:00Z,36.5N  40.0W,28,1,0,0,29
Tropical Storm,Alberto,42,2000-08-14T15:00:00Z,37.9N  38.4W,41,0,0,0,41
Tropical Storm,Alberto,42,2000-08-14T15:00:00Z,37.0N  40.0W,25,1,0,1,27
Tropical Storm,Alberto,42,2000-08-14T15:00:00Z,37.4N  39.1W,36,0,0,0,36
Tropical Storm,Alberto,43,2000-08-14T21:00:00Z,38.1N  36.9W,48,0,0,0,48
Tropical Storm,Alberto,43,2000-08-14T21:00:00Z,37.0N  39.0W,22,1,1,0,24
Tropical Storm,Alberto,43,2000-08-14T21:00:00Z,37.5N  37.9W,43,0,0,0,43
Tropical Storm,Alberto,44,2000-08-15T03:00:00Z,37.0N  39.0W,46,0,0,0,46
Tropical Storm,Alberto,44,2000-08-15T03:00:00Z,36.0N  42.5W,9,5,2,2,18
Tropical Storm,Alberto,44,2000-08-15T03:00:00Z,36.5N  40.5W,24,1,0,0,25
Tropical Storm,Alberto,45,2000-08-15T09:00:00Z,36.5N  40.5W,39,0,1,0,40
Tropical Storm,Alberto,45,2000-08-15T09:00:00Z,35.7N  43.5W,12,5,1,1,19
Tropical Storm,Alberto,45,2000-08-15T09:00:00Z,36.0N  42.0W,22,2,0,1,25
Tropical Storm,Alberto,46,2000-08-15T15:00:00Z,35.6N  40.4W,40,0,0,1,41
Tropical Storm,Alberto,46,2000-08-15T15:00:00Z,35.0N  44.0W,9,6,2,1,18
Tropical Storm,Alberto,46,2000-08-15T15:00:00Z,35.2N  42.1W,23,1,1,0,25
Tropical Storm,Alberto,47,2000-08-15T21:00:00Z,35.2N  41.9W,35,0,0,1,36
Tropical Storm,Alberto,47,2000-08-15T21:00:00Z,34.5N  45.0W,12,4,2,1,19
Tropical Storm,Alberto,47,2000-08-15T21:00:00Z,34.8N  43.5W,21,1,1,0,23
Tropical Storm,Alberto,48,2000-08-16T03:00:00Z,34.5N  42.0W,36,0,0,0,36
Tropical Storm,Alberto,48,2000-08-16T03:00:00Z,33.5N  45.5W,8,7,2,1,18
Tropical Storm,Alberto,48,2000-08-16T03:00:00Z,34.0N  44.0W,18,2,1,1,22
Tropical Storm,Alberto,49,2000-08-16T09:00:00Z,34.0N  43.3W,39,1,0,0,40
Tropical Storm,Alberto,49,2000-08-16T09:00:00Z,34.0N  47.0W,8,7,2,1,18
Tropical Storm,Alberto,49,2000-08-16T09:00:00Z,33.7N  45.2W,19,2,1,1,23
Tropical Storm,Alberto,50,2000-08-16T15:00:00Z,33.2N  45.1W,36,0,0,0,36
Tropical Storm,Alberto,50,2000-08-16T15:00:00Z,33.5N  48.0W,12,4,2,1,19
Tropical Storm,Alberto,50,2000-08-16T15:00:00Z,33.2N  46.8W,20,2,0,1,23
Tropical Storm,Alberto,51,2000-08-16T21:00:00Z,33.0N  46.8W,37,0,0,0,37
Tropical Storm,Alberto,51,2000-08-16T21:00:00Z,33.5N  49.5W,14,3,2,1,20
Tropical Storm,Alberto,51,2000-08-16T21:00:00Z,33.2N  48.2W,23,1,0,1,25
Tropical Storm,Alberto,52,2000-08-17T03:00:00Z,33.0N  47.4W,42,0,0,0,42
Tropical Storm,Alberto,52,2000-08-17T03:00:00Z,34.5N  49.0W,16,3,1,1,21
Tropical Storm,Alberto,52,2000-08-17T03:00:00Z,33.5N  48.5W,26,0,1,0,27
Tropical Storm,Alberto,53,2000-08-17T09:00:00Z,33.0N  47.0W,38,0,0,0,38
Tropical Storm,Alberto,53,2000-08-17T09:00:00Z,35.0N  48.5W,12,4,1,2,19
Tropical Storm,Alberto,53,2000-08-17T09:00:00Z,33.9N  48.0W,22,1,1,0,24
Tropical Storm,Alberto,54,2000-08-17T15:00:00Z,33.5N  47.8W,41,1,0,0,42
Tropical Storm,Alberto,54,2000-08-17T15:00:00Z,35.5N  49.0W,14,3,2,1,20
Tropical Storm,Alberto,54,2000-08-17T15:00:00Z,34.5N  48.6W,24,1,0,1,26
Tropical Storm,Alberto,55,2000-08-17T21:00:00Z,34.3N  48.6W,41,0,0,0,41
Tropical Storm,Alberto,55,2000-08-17T21:00:00Z,36.5N  48.5W,14,4,1,2,21
Tropical Storm,Alberto,55,2000-08-17T21:00:00Z,35.4N  48.8W,24,1,1,0,26
Tropical Storm,Alberto,55,2000-08-17T21:00:00Z,HIBERNIA OILFLD,0,0,0,2,2
Tropical Storm,Alberto,56,2000-08-18T03:00:00Z,34.5N  48.5W,40,0,0,0,40
Tropical Storm,Alberto,56,2000-08-18T03:00:00Z,CAPE RACE NFLD,0,0,0,2,2
Tropical Storm,Alberto,56,2000-08-18T03:00:00Z,35.5N  48.5W,26,1,1,0,28
Tropical Storm,Alberto,56,2000-08-18T03:00:00Z,HIBERNIA OILFLD,0,0,0,3,3
Tropical Storm,Alberto,56,2000-08-18T03:00:00Z,37.0N  48.5W,12,5,2,1,20
Tropical Storm,Alberto,57,2000-08-18T09:00:00Z,35.4N  48.5W,36,0,0,0,36
Tropical Storm,Alberto,57,2000-08-18T09:00:00Z,CAPE RACE NFLD,0,0,0,2,2
Tropical Storm,Alberto,57,2000-08-18T09:00:00Z,36.4N  48.5W,24,1,1,0,26
Tropical Storm,Alberto,57,2000-08-18T09:00:00Z,HIBERNIA OILFLD,0,0,0,3,3
Tropical Storm,Alberto,57,2000-08-18T09:00:00Z,37.5N  48.5W,12,6,1,1,20
Hurricane,Alberto,58,2000-08-18T15:00:00Z,36.8N  48.4W,33,0,0,0,33
Hurricane,Alberto,58,2000-08-18T15:00:00Z,ILE ST PIERRE,0,0,0,2,2
Hurricane,Alberto,58,2000-08-18T15:00:00Z,38.3N  48.4W,16,4,2,0,22
Hurricane,Alberto,58,2000-08-18T15:00:00Z,CAPE RACE NFLD,0,0,0,4,4
Hurricane,Alberto,58,2000-08-18T15:00:00Z,39.7N  48.2W,4,10,3,2,19
Hurricane,Alberto,58,2000-08-18T15:00:00Z,HIBERNIA OILFLD,0,0,0,4,4
Hurricane,Alberto,59,2000-08-18T21:00:00Z,37.5N  48.8W,32,0,0,0,32
Hurricane,Alberto,59,2000-08-18T21:00:00Z,BURGEO NFLD,0,0,0,2,2
Hurricane,Alberto,59,2000-08-18T21:00:00Z,38.9N  48.6W,17,3,1,1,22
Hurricane,Alberto,59,2000-08-18T21:00:00Z,ILE ST PIERRE,0,0,0,3,3
Hurricane,Alberto,59,2000-08-18T21:00:00Z,40.5N  48.2W,3,8,4,2,17
Hurricane,Alberto,59,2000-08-18T21:00:00Z,CAPE RACE NFLD,0,0,0,5,5
Hurricane,Alberto,59,2000-08-18T21:00:00Z,SABLE ISLAND NS,0,0,0,2,2
Hurricane,Alberto,59,2000-08-18T21:00:00Z,HIBERNIA OILFLD,0,0,0,6,6
Hurricane,Alberto,60,2000-08-19T03:00:00Z,36.9N  48.7W,34,0,0,0,34
Hurricane,Alberto,60,2000-08-19T03:00:00Z,ILE ST PIERRE,0,0,0,2,2
Hurricane,Alberto,60,2000-08-19T03:00:00Z,38.2N  48.3W,20,3,1,0,24
Hurricane,Alberto,60,2000-08-19T03:00:00Z,CAPE RACE NFLD,0,0,0,4,4
Hurricane,Alberto,60,2000-08-19T03:00:00Z,39.5N  48.0W,7,10,2,1,20
Hurricane,Alberto,60,2000-08-19T03:00:00Z,HIBERNIA OILFLD,0,0,0,5,5
Hurricane,Alberto,61,2000-08-19T09:00:00Z,37.3N  48.5W,34,0,0,0,34
Hurricane,Alberto,61,2000-08-19T09:00:00Z,ILE ST PIERRE,0,0,0,3,3
Hurricane,Alberto,61,2000-08-19T09:00:00Z,38.8N  48.2W,18,4,1,1,24
Hurricane,Alberto,61,2000-08-19T09:00:00Z,CAPE RACE NFLD,0,0,0,5,5
Hurricane,Alberto,61,2000-08-19T09:00:00Z,40.5N  47.5W,2,12,4,1,19
Hurricane,Alberto,61,2000-08-19T09:00:00Z,HIBERNIA OILFLD,0,0,1,6,7
Hurricane,Alberto,61,2000-08-19T09:00:00Z,BURGEO NFLD,0,0,0,2,2
Hurricane,Alberto,62,2000-08-19T15:00:00Z,38.2N  48.3W,32,1,0,0,33
Hurricane,Alberto,62,2000-08-19T15:00:00Z,BURGEO NFLD,0,0,0,2,2
Hurricane,Alberto,62,2000-08-19T15:00:00Z,39.8N  47.7W,17,4,1,0,22
Hurricane,Alberto,62,2000-08-19T15:00:00Z,ILE ST PIERRE,0,0,0,4,4
Hurricane,Alberto,62,2000-08-19T15:00:00Z,41.5N  47.0W,2,9,4,2,17
Hurricane,Alberto,62,2000-08-19T15:00:00Z,CAPE RACE NFLD,0,0,1,5,6
Hurricane,Alberto,62,2000-08-19T15:00:00Z,SABLE ISLAND NS,0,0,0,2,2
Hurricane,Alberto,62,2000-08-19T15:00:00Z,HIBERNIA OILFLD,0,0,1,7,8
Hurricane,Alberto,62,2000-08-19T15:00:00Z,PTX BASQUES NFLD,0,0,0,2,2
Hurricane,Alberto,63,2000-08-19T21:00:00Z,39.2N  47.8W,35,0,0,0,35
Hurricane,Alberto,63,2000-08-19T21:00:00Z,ILE ST PIERRE,0,0,2,2,4
Hurricane,Alberto,63,2000-08-19T21:00:00Z,41.1N  47.0W,16,3,1,0,20
Hurricane,Alberto,63,2000-08-19T21:00:00Z,CAPE RACE NFLD,0,1,5,2,8
Hurricane,Alberto,63,2000-08-19T21:00:00Z,44.5N  45.5W,0,5,8,3,16
Hurricane,Alberto,63,2000-08-19T21:00:00Z,HIBERNIA OILFLD,0,1,7,5,13
Hurricane,Alberto,63,2000-08-19T21:00:00Z,BURGEO NFLD,0,0,1,1,2
Hurricane,Alberto,64,2000-08-20T03:00:00Z,38.5N  47.9W,47,0,0,0,47
Hurricane,Alberto,64,2000-08-20T03:00:00Z,ILE ST PIERRE,0,0,1,3,4
Hurricane,Alberto,64,2000-08-20T03:00:00Z,40.5N  47.2W,16,3,1,1,21
Hurricane,Alberto,64,2000-08-20T03:00:00Z,CAPE RACE NFLD,0,0,4,4,8
Hurricane,Alberto,64,2000-08-20T03:00:00Z,42.5N  46.5W,2,9,3,2,16
Hurricane,Alberto,64,2000-08-20T03:00:00Z,HIBERNIA OILFLD,0,0,5,6,11
Hurricane,Alberto,64,2000-08-20T03:00:00Z,BURGEO NFLD,0,0,1,1,2
Hurricane,Alberto,65,2000-08-20T09:00:00Z,39.2N  47.7W,39,0,0,0,39
Hurricane,Alberto,65,2000-08-20T09:00:00Z,ILE ST PIERRE,0,0,1,1,2
Hurricane,Alberto,65,2000-08-20T09:00:00Z,41.2N  47.0W,14,4,1,1,20
Hurricane,Alberto,65,2000-08-20T09:00:00Z,CAPE RACE NFLD,0,1,4,3,8
Hurricane,Alberto,65,2000-08-20T09:00:00Z,44.0N  45.5W,0,6,7,2,15
Hurricane,Alberto,65,2000-08-20T09:00:00Z,HIBERNIA OILFLD,0,1,8,4,13
Hurricane,Alberto,66,2000-08-20T15:00:00Z,40.1N  47.2W,36,1,0,0,37
Hurricane,Alberto,66,2000-08-20T15:00:00Z,ILE ST PIERRE,0,0,1,1,2
Hurricane,Alberto,66,2000-08-20T15:00:00Z,43.0N  45.9W,5,12,2,0,19
Hurricane,Alberto,66,2000-08-20T15:00:00Z,CAPE RACE NFLD,0,2,4,1,7
Hurricane,Alberto,66,2000-08-20T15:00:00Z,46.5N  43.5W,0,3,9,2,14
Hurricane,Alberto,66,2000-08-20T15:00:00Z,HIBERNIA OILFLD,0,4,8,1,13
Hurricane,Alberto,67,2000-08-20T21:00:00Z,40.6N  46.9W,36,0,0,0,36
Hurricane,Alberto,67,2000-08-20T21:00:00Z,CAPE RACE NFLD,0,1,3,0,4
Hurricane,Alberto,67,2000-08-20T21:00:00Z,43.7N  45.3W,3,15,3,0,21
Hurricane,Alberto,67,2000-08-20T21:00:00Z,HIBERNIA OILFLD,0,7,8,0,15
Hurricane,Alberto,67,2000-08-20T21:00:00Z,48.5N  41.5W,0,1,11,3,15
Hurricane,Alberto,68,2000-08-21T03:00:00Z,40.8N  46.0W,30,1,0,0,31
Hurricane,Alberto,68,2000-08-21T03:00:00Z,50.0N  39.0W,0,0,10,0,10
Hurricane,Alberto,68,2000-08-21T03:00:00Z,44.6N  43.9W,0,15,6,0,21
Hurricane,Alberto,68,2000-08-21T03:00:00Z,HIBERNIA OILFLD,0,6,5,0,11
Hurricane,Alberto,69,2000-08-21T09:00:00Z,41.7N  45.7W,30,2,0,0,32
Hurricane,Alberto,69,2000-08-21T09:00:00Z,51.0N  39.0W,0,0,10,0,10
Hurricane,Alberto,69,2000-08-21T09:00:00Z,45.7N  43.2W,0,14,6,0,20
Hurricane,Alberto,69,2000-08-21T09:00:00Z,HIBERNIA OILFLD,0,8,4,0,12
Hurricane,Alberto,70,2000-08-21T15:00:00Z,43.8N  44.7W,24,3,0,0,27
Hurricane,Alberto,70,2000-08-21T15:00:00Z,53.0N  38.0W,0,1,9,0,10
Hurricane,Alberto,70,2000-08-21T15:00:00Z,48.0N  42.0W,0,14,3,0,17
Hurricane,Alberto,70,2000-08-21T15:00:00Z,HIBERNIA OILFLD,2,9,1,0,12
Hurricane,Alberto,71,2000-08-21T21:00:00Z,45.6N  43.2W,22,3,0,0,25
Hurricane,Alberto,71,2000-08-21T21:00:00Z,55.0N  35.0W,0,0,8,0,8
Hurricane,Alberto,71,2000-08-21T21:00:00Z,50.0N  40.0W,0,11,4,0,15
Hurricane,Alberto,71,2000-08-21T21:00:00Z,HIBERNIA OILFLD,5,7,1,0,13
Hurricane,Alberto,72,2000-08-22T03:00:00Z,47.7N  41.7W,17,4,0,0,21
Hurricane,Alberto,72,2000-08-22T03:00:00Z,57.7N  31.8W,0,0,8,0,8
Hurricane,Alberto,72,2000-08-22T03:00:00Z,52.3N  37.6W,0,11,4,0,15
Hurricane,Alberto,72,2000-08-22T03:00:00Z,HIBERNIA OILFLD,8,2,0,0,10
Hurricane,Alberto,73,2000-08-22T09:00:00Z,52.0N  40.0W,13,9,0,0,22
Hurricane,Alberto,73,2000-08-22T09:00:00Z,HIBERNIA OILFLD,9,0,0,0,9
Hurricane,Alberto,73,2000-08-22T09:00:00Z,59.0N  35.0W,0,9,0,0,9
Hurricane,Alberto,74,2000-08-22T15:00:00Z,53.0N  38.0W,21,7,0,0,28
Hurricane,Alberto,74,2000-08-22T15:00:00Z,60.5N  36.5W,0,16,0,0,16
Hurricane,Alberto,75,2000-08-22T21:00:00Z,56.0N  34.0W,21,0,0,0,21
Tropical Storm,Alberto,76,2000-08-23T03:00:00Z,61.0N  26.0W,21,0,0,0,21
Tropical Depression,Four,1,2000-08-09T15:00:00Z,28.0N  78.6W,99,0,0,0,99
Tropical Depression,Four,1,2000-08-09T15:00:00Z,WILMINGTON NC,0,0,0,6,6
Tropical Depression,Four,1,2000-08-09T15:00:00Z,28.3N  79.1W,39,0,0,0,39
Tropical Depression,Four,1,2000-08-09T15:00:00Z,MOREHEAD CITY NC,0,0,0,4,4
Tropical Depression,Four,1,2000-08-09T15:00:00Z,28.5N  79.5W,30,1,1,0,32
Tropical Depression,Four,1,2000-08-09T15:00:00Z,CAPE HATTERAS NC,0,0,0,3,3
Tropical Depression,Four,1,2000-08-09T15:00:00Z,MUHA 230N 824W,0,0,0,2,2
Tropical Depression,Four,1,2000-08-09T15:00:00Z,KEY WEST FL,0,1,2,4,7
Tropical Depression,Four,1,2000-08-09T15:00:00Z,MYMM 224N 730W,0,0,0,2,2
Tropical Depression,Four,1,2000-08-09T15:00:00Z,MARCO ISLAND FL,1,5,4,4,14
Tropical Depression,Four,1,2000-08-09T15:00:00Z,MYSM 241N 745W,0,0,0,5,5
Tropical Depression,Four,1,2000-08-09T15:00:00Z,FT MYERS FL,2,6,5,3,16
Tropical Depression,Four,1,2000-08-09T15:00:00Z,MYEG 235N 758W,0,0,0,4,4
Tropical Depression,Four,1,2000-08-09T15:00:00Z,VENICE FL,1,6,5,4,16
Tropical Depression,Four,1,2000-08-09T15:00:00Z,MYAK 241N 776W,0,1,0,6,7
Tropical Depression,Four,1,2000-08-09T15:00:00Z,TAMPA FL,1,7,6,4,18
Tropical Depression,Four,1,2000-08-09T15:00:00Z,MYNN 251N 775W,3,2,1,5,11
Tropical Depression,Four,1,2000-08-09T15:00:00Z,CEDAR KEY FL,0,5,6,5,16
Tropical Depression,Four,1,2000-08-09T15:00:00Z,MYGF 266N 787W,21,2,0,1,24
Tropical Depression,Four,1,2000-08-09T15:00:00Z,ST MARKS FL,0,0,4,8,12
Tropical Depression,Four,1,2000-08-09T15:00:00Z,MARATHON FL,0,1,3,5,9
Tropical Depression,Four,1,2000-08-09T15:00:00Z,APALACHICOLA FL,0,0,3,8,11
Tropical Depression,Four,1,2000-08-09T15:00:00Z,MIAMI FL,5,5,3,3,16
Tropical Depression,Four,1,2000-08-09T15:00:00Z,PANAMA CITY FL,0,0,2,7,9
Tropical Depression,Four,1,2000-08-09T15:00:00Z,W PALM BEACH FL,14,4,2,2,22
Tropical Depression,Four,1,2000-08-09T15:00:00Z,PENSACOLA FL,0,0,0,6,6
Tropical Depression,Four,1,2000-08-09T15:00:00Z,FT PIERCE FL,18,3,2,1,24
Tropical Depression,Four,1,2000-08-09T15:00:00Z,MOBILE AL,0,0,0,4,4
Tropical Depression,Four,1,2000-08-09T15:00:00Z,COCOA BEACH FL,16,5,2,1,24
Tropical Depression,Four,1,2000-08-09T15:00:00Z,GULFPORT MS,0,0,0,3,3
Tropical Depression,Four,1,2000-08-09T15:00:00Z,DAYTONA BEACH FL,9,7,3,3,22
Tropical Depression,Four,1,2000-08-09T15:00:00Z,BURAS LA,0,0,0,2,2
Tropical Depression,Four,1,2000-08-09T15:00:00Z,JACKSONVILLE FL,1,5,5,6,17
Tropical Depression,Four,1,2000-08-09T15:00:00Z,NEW ORLEANS LA,0,0,0,2,2
Tropical Depression,Four,1,2000-08-09T15:00:00Z,SAVANNAH GA,0,1,3,8,12
Tropical Depression,Four,1,2000-08-09T15:00:00Z,GULF 29N 85W,0,0,4,7,11
Tropical Depression,Four,1,2000-08-09T15:00:00Z,CHARLESTON SC,0,0,2,8,10
Tropical Depression,Four,1,2000-08-09T15:00:00Z,GULF 29N 87W,0,0,1,5,6
Tropical Depression,Four,1,2000-08-09T15:00:00Z,MYRTLE BEACH SC,0,0,1,7,8
Tropical Depression,Four,1,2000-08-09T15:00:00Z,GULF 28N 89W,0,0,0,2,2
Tropical Depression,Four,2,2000-08-09T21:00:00Z,28.2N  79.1W,99,0,0,0,99
Tropical Depression,Four,2,2000-08-09T21:00:00Z,WILMINGTON NC,0,0,1,9,10
Tropical Depression,Four,2,2000-08-09T21:00:00Z,28.8N  79.5W,44,1,0,0,45
Tropical Depression,Four,2,2000-08-09T21:00:00Z,MOREHEAD CITY NC,0,0,0,8,8
Tropical Depression,Four,2,2000-08-09T21:00:00Z,29.5N  79.0W,36,0,1,0,37
Tropical Depression,Four,2,2000-08-09T21:00:00Z,CAPE HATTERAS NC,0,0,0,6,6
Tropical Depression,Four,2,2000-08-09T21:00:00Z,MYSM 241N 745W,0,0,0,3,3
Tropical Depression,Four,2,2000-08-09T21:00:00Z,NORFOLK VA,0,0,0,3,3
Tropical Depression,Four,2,2000-08-09T21:00:00Z,MYEG 235N 758W,0,0,0,2,2
Tropical Depression,Four,2,2000-08-09T21:00:00Z,KEY WEST FL,0,0,1,2,3
Tropical Depression,Four,2,2000-08-09T21:00:00Z,MYAK 241N 776W,0,1,0,2,3
Tropical Depression,Four,2,2000-08-09T21:00:00Z,MARCO ISLAND FL,1,4,3,3,11
Tropical Depression,Four,2,2000-08-09T21:00:00Z,MYNN 251N 775W,4,1,1,2,8
Tropical Depression,Four,2,2000-08-09T21:00:00Z,FT MYERS FL,1,7,3,2,13
Tropical Depression,Four,2,2000-08-09T21:00:00Z,MYGF 266N 787W,26,0,1,0,27
Tropical Depression,Four,2,2000-08-09T21:00:00Z,VENICE FL,1,6,4,2,13
Tropical Depression,Four,2,2000-08-09T21:00:00Z,MARATHON FL,0,1,2,2,5
Tropical Depression,Four,2,2000-08-09T21:00:00Z,TAMPA FL,2,8,4,2,16
Tropical Depression,Four,2,2000-08-09T21:00:00Z,MIAMI FL,5,4,2,2,13
Tropical Depression,Four,2,2000-08-09T21:00:00Z,CEDAR KEY FL,1,6,5,4,16
Tropical Depression,Four,2,2000-08-09T21:00:00Z,W PALM BEACH FL,16,3,1,1,21
Tropical Depression,Four,2,2000-08-09T21:00:00Z,ST MARKS FL,0,1,4,6,11
Tropical Depression,Four,2,2000-08-09T21:00:00Z,FT PIERCE FL,22,2,1,1,26
Tropical Depression,Four,2,2000-08-09T21:00:00Z,APALACHICOLA FL,0,0,3,6,9
Tropical Depression,Four,2,2000-08-09T21:00:00Z,COCOA BEACH FL,22,3,1,1,27
Tropical Depression,Four,2,2000-08-09T21:00:00Z,PANAMA CITY FL,0,0,2,5,7
Tropical Depression,Four,2,2000-08-09T21:00:00Z,DAYTONA BEACH FL,16,5,2,1,24
Tropical Depression,Four,2,2000-08-09T21:00:00Z,PENSACOLA FL,0,0,0,4,4
Tropical Depression,Four,2,2000-08-09T21:00:00Z,JACKSONVILLE FL,5,7,4,3,19
Tropical Depression,Four,2,2000-08-09T21:00:00Z,MOBILE AL,0,0,0,3,3
Tropical Depression,Four,2,2000-08-09T21:00:00Z,SAVANNAH GA,1,3,5,6,15
Tropical Depression,Four,2,2000-08-09T21:00:00Z,GULFPORT MS,0,0,0,2,2
Tropical Depression,Four,2,2000-08-09T21:00:00Z,CHARLESTON SC,0,2,4,8,14
Tropical Depression,Four,2,2000-08-09T21:00:00Z,GULF 29N 85W,0,0,3,5,8
Tropical Depression,Four,2,2000-08-09T21:00:00Z,MYRTLE BEACH SC,0,0,3,9,12
Tropical Depression,Four,2,2000-08-09T21:00:00Z,GULF 29N 87W,0,0,0,4,4
Tropical Depression,Four,3,2000-08-10T03:00:00Z,28.9N  80.1W,66,0,0,0,66
Tropical Depression,Four,3,2000-08-10T03:00:00Z,MOREHEAD CITY NC,0,0,1,10,11
Tropical Depression,Four,3,2000-08-10T03:00:00Z,29.7N  80.1W,49,1,0,0,50
Tropical Depression,Four,3,2000-08-10T03:00:00Z,CAPE HATTERAS NC,0,0,0,9,9
Tropical Depression,Four,3,2000-08-10T03:00:00Z,30.5N  79.5W,28,1,1,1,31
Tropical Depression,Four,3,2000-08-10T03:00:00Z,NORFOLK VA,0,0,0,6,6
Tropical Depression,Four,3,2000-08-10T03:00:00Z,MYNN 251N 775W,0,0,1,2,3
Tropical Depression,Four,3,2000-08-10T03:00:00Z,OCEAN CITY MD,0,0,0,2,2
Tropical Depression,Four,3,2000-08-10T03:00:00Z,MYGF 266N 787W,14,1,1,0,16
Tropical Depression,Four,3,2000-08-10T03:00:00Z,MARCO ISLAND FL,1,2,1,2,6
Tropical Depression,Four,3,2000-08-10T03:00:00Z,MIAMI FL,4,1,1,1,7
Tropical Depression,Four,3,2000-08-10T03:00:00Z,FT MYERS FL,3,3,2,1,9
Tropical Depression,Four,3,2000-08-10T03:00:00Z,W PALM BEACH FL,15,2,0,1,18
Tropical Depression,Four,3,2000-08-10T03:00:00Z,VENICE FL,2,5,1,2,10
Tropical Depression,Four,3,2000-08-10T03:00:00Z,FT PIERCE FL,29,1,0,0,30
Tropical Depression,Four,3,2000-08-10T03:00:00Z,TAMPA FL,7,5,2,1,15
Tropical Depression,Four,3,2000-08-10T03:00:00Z,COCOA BEACH FL,38,1,0,0,39
Tropical Depression,Four,3,2000-08-10T03:00:00Z,CEDAR KEY FL,5,8,2,2,17
Tropical Depression,Four,3,2000-08-10T03:00:00Z,DAYTONA BEACH FL,35,0,1,0,36
Tropical Depression,Four,3,2000-08-10T03:00:00Z,ST MARKS FL,0,4,5,3,12
Tropical Depression,Four,3,2000-08-10T03:00:00Z,JACKSONVILLE FL,17,4,2,1,24
Tropical Depression,Four,3,2000-08-10T03:00:00Z,APALACHICOLA FL,0,1,4,3,8
Tropical Depression,Four,3,2000-08-10T03:00:00Z,SAVANNAH GA,5,7,4,4,20
Tropical Depression,Four,3,2000-08-10T03:00:00Z,PANAMA CITY FL,0,0,3,4,7
Tropical Depression,Four,3,2000-08-10T03:00:00Z,CHARLESTON SC,1,5,6,6,18
Tropical Depression,Four,3,2000-08-10T03:00:00Z,PENSACOLA FL,0,0,0,3,3
Tropical Depression,Four,3,2000-08-10T03:00:00Z,MYRTLE BEACH SC,0,1,6,8,15
Tropical Depression,Four,3,2000-08-10T03:00:00Z,GULF 29N 85W,0,1,3,3,7
Tropical Depression,Four,3,2000-08-10T03:00:00Z,WILMINGTON NC,0,0,3,10,13
Tropical Depression,Four,3,2000-08-10T03:00:00Z,GULF 29N 87W,0,0,0,2,2
Tropical Depression,Four,4,2000-08-10T09:00:00Z,29.5N  80.3W,44,0,1,0,45
Tropical Depression,Four,4,2000-08-10T09:00:00Z,WILMINGTON NC,0,0,6,9,15
Tropical Depression,Four,4,2000-08-10T09:00:00Z,30.5N  79.8W,28,1,1,0,30
Tropical Depression,Four,4,2000-08-10T09:00:00Z,MOREHEAD CITY NC,0,0,3,11,14
Tropical Depression,Four,4,2000-08-10T09:00:00Z,31.5N  78.0W,4,9,8,2,23
Tropical Depression,Four,4,2000-08-10T09:00:00Z,CAPE HATTERAS NC,0,0,1,11,12
Tropical Depression,Four,4,2000-08-10T09:00:00Z,MYSM 241N 745W,0,0,0,2,2
Tropical Depression,Four,4,2000-08-10T09:00:00Z,NORFOLK VA,0,0,0,9,9
Tropical Depression,Four,4,2000-08-10T09:00:00Z,MYNN 251N 775W,0,0,0,2,2
Tropical Depression,Four,4,2000-08-10T09:00:00Z,OCEAN CITY MD,0,0,0,6,6
Tropical Depression,Four,4,2000-08-10T09:00:00Z,MYGF 266N 787W,4,2,2,1,9
Tropical Depression,Four,4,2000-08-10T09:00:00Z,ATLANTIC CITY NJ,0,0,0,3,3
Tropical Depression,Four,4,2000-08-10T09:00:00Z,MIAMI FL,1,1,0,1,3
Tropical Depression,Four,4,2000-08-10T09:00:00Z,MARCO ISLAND FL,0,1,1,1,3
Tropical Depression,Four,4,2000-08-10T09:00:00Z,W PALM BEACH FL,8,1,1,1,11
Tropical Depression,Four,4,2000-08-10T09:00:00Z,FT MYERS FL,2,2,1,1,6
Tropical Depression,Four,4,2000-08-10T09:00:00Z,FT PIERCE FL,22,1,0,0,23
Tropical Depression,Four,4,2000-08-10T09:00:00Z,VENICE FL,3,3,1,0,7
Tropical Depression,Four,4,2000-08-10T09:00:00Z,COCOA BEACH FL,99,0,0,0,99
Tropical Depression,Four,4,2000-08-10T09:00:00Z,TAMPA FL,11,2,1,0,14
Tropical Depression,Four,4,2000-08-10T09:00:00Z,DAYTONA BEACH FL,38,0,0,0,38
Tropical Depression,Four,4,2000-08-10T09:00:00Z,CEDAR KEY FL,12,3,1,0,16
Tropical Depression,Four,4,2000-08-10T09:00:00Z,JACKSONVILLE FL,23,2,0,1,26
Tropical Depression,Four,4,2000-08-10T09:00:00Z,ST MARKS FL,2,5,3,1,11
Tropical Depression,Four,4,2000-08-10T09:00:00Z,SAVANNAH GA,6,8,4,2,20
Tropical Depression,Four,4,2000-08-10T09:00:00Z,APALACHICOLA FL,0,3,2,1,6
Tropical Depression,Four,4,2000-08-10T09:00:00Z,CHARLESTON SC,1,7,8,3,19
Tropical Depression,Four,4,2000-08-10T09:00:00Z,PANAMA CITY FL,0,1,1,1,3
Tropical Depression,Four,4,2000-08-10T09:00:00Z,MYRTLE BEACH SC,0,2,8,7,17
Tropical Depression,Four,4,2000-08-10T09:00:00Z,GULF 29N 85W,0,2,1,1,4
Tropical Depression,Four,5,2000-08-10T15:00:00Z,30.6N  77.6W,42,0,0,0,42
Tropical Depression,Four,5,2000-08-10T15:00:00Z,OCEAN CITY MD,0,0,1,7,8
Tropical Depression,Four,5,2000-08-10T15:00:00Z,31.6N  76.2W,14,11,1,1,27
Tropical Depression,Four,5,2000-08-10T15:00:00Z,ATLANTIC CITY NJ,0,0,0,6,6
Tropical Depression,Four,5,2000-08-10T15:00:00Z,32.5N  74.5W,0,12,5,3,20
Tropical Depression,Four,5,2000-08-10T15:00:00Z,NEW YORK CITY NY,0,0,0,5,5
Tropical Depression,Four,5,2000-08-10T15:00:00Z,MYSM 241N 745W,0,0,0,2,2
Tropical Depression,Four,5,2000-08-10T15:00:00Z,MONTAUK POINT NY,0,0,0,5,5
Tropical Depression,Four,5,2000-08-10T15:00:00Z,MYAK 241N 776W,0,0,0,2,2
Tropical Depression,Four,5,2000-08-10T15:00:00Z,PROVIDENCE RI,0,0,0,4,4
Tropical Depression,Four,5,2000-08-10T15:00:00Z,MYNN 251N 775W,0,0,0,3,3
Tropical Depression,Four,5,2000-08-10T15:00:00Z,NANTUCKET MA,0,0,0,5,5
Tropical Depression,Four,5,2000-08-10T15:00:00Z,MYGF 266N 787W,0,1,1,4,6
Tropical Depression,Four,5,2000-08-10T15:00:00Z,HYANNIS MA,0,0,0,4,4
Tropical Depression,Four,5,2000-08-10T15:00:00Z,BERMUDA,0,0,0,5,5
Tropical Depression,Four,5,2000-08-10T15:00:00Z,BOSTON MA,0,0,0,3,3
Tropical Depression,Four,5,2000-08-10T15:00:00Z,MARATHON FL,0,0,0,2,2
Tropical Depression,Four,5,2000-08-10T15:00:00Z,PORTLAND ME,0,0,0,2,2
Tropical Depression,Four,5,2000-08-10T15:00:00Z,MIAMI FL,0,0,0,4,4
Tropical Depression,Four,5,2000-08-10T15:00:00Z,BAR HARBOR ME,0,0,0,2,2
Tropical Depression,Four,5,2000-08-10T15:00:00Z,W PALM BEACH FL,0,0,1,4,5
Tropical Depression,Four,5,2000-08-10T15:00:00Z,YARMOUTH NS,0,0,0,2,2
Tropical Depression,Four,5,2000-08-10T15:00:00Z,FT PIERCE FL,4,1,1,2,8
Tropical Depression,Four,5,2000-08-10T15:00:00Z,KEY WEST FL,0,0,0,2,2
Tropical Depression,Four,5,2000-08-10T15:00:00Z,COCOA BEACH FL,14,0,0,1,15
Tropical Depression,Four,5,2000-08-10T15:00:00Z,MARCO ISLAND FL,0,0,0,3,3
Tropical Depression,Four,5,2000-08-10T15:00:00Z,DAYTONA BEACH FL,17,1,0,1,19
Tropical Depression,Four,5,2000-08-10T15:00:00Z,FT MYERS FL,0,0,0,4,4
Tropical Depression,Four,5,2000-08-10T15:00:00Z,JACKSONVILLE FL,11,2,1,1,15
Tropical Depression,Four,5,2000-08-10T15:00:00Z,VENICE FL,0,0,0,4,4
Tropical Depression,Four,5,2000-08-10T15:00:00Z,SAVANNAH GA,5,8,1,2,16
Tropical Depression,Four,5,2000-08-10T15:00:00Z,TAMPA FL,0,0,1,4,5
Tropical Depression,Four,5,2000-08-10T15:00:00Z,CHARLESTON SC,3,11,2,1,17
Tropical Depression,Four,5,2000-08-10T15:00:00Z,CEDAR KEY FL,1,0,1,4,6
Tropical Depression,Four,5,2000-08-10T15:00:00Z,MYRTLE BEACH SC,0,10,4,3,17
Tropical Depression,Four,5,2000-08-10T15:00:00Z,ST MARKS FL,0,0,1,3,4
Tropical Depression,Four,5,2000-08-10T15:00:00Z,WILMINGTON NC,0,6,7,3,16
Tropical Depression,Four,5,2000-08-10T15:00:00Z,APALACHICOLA FL,0,0,0,3,3
Tropical Depression,Four,5,2000-08-10T15:00:00Z,MOREHEAD CITY NC,0,3,8,5,16
Tropical Depression,Four,5,2000-08-10T15:00:00Z,PANAMA CITY FL,0,0,0,2,2
Tropical Depression,Four,5,2000-08-10T15:00:00Z,CAPE HATTERAS NC,0,1,8,6,15
Tropical Depression,Four,5,2000-08-10T15:00:00Z,GULF 29N 85W,0,0,0,3,3
Tropical Depression,Four,5,2000-08-10T15:00:00Z,NORFOLK VA,0,0,3,8,11
Tropical Depression,Four,6,2000-08-10T21:00:00Z,29.0N  75.5W,35,1,0,0,36
Tropical Depression,Four,6,2000-08-10T21:00:00Z,MOREHEAD CITY NC,0,0,3,7,10
Tropical Depression,Four,6,2000-08-10T21:00:00Z,29.8N  73.7W,8,16,3,0,27
Tropical Depression,Four,6,2000-08-10T21:00:00Z,CAPE HATTERAS NC,0,0,2,9,11
Tropical Depression,Four,6,2000-08-10T21:00:00Z,31.0N  71.5W,0,5,14,2,21
Tropical Depression,Four,6,2000-08-10T21:00:00Z,NORFOLK VA,0,0,0,8,8
Tropical Depression,Four,6,2000-08-10T21:00:00Z,MYSM 241N 745W,0,2,1,0,3
Tropical Depression,Four,6,2000-08-10T21:00:00Z,OCEAN CITY MD,0,0,0,7,7
Tropical Depression,Four,6,2000-08-10T21:00:00Z,MYNN 251N 775W,3,2,1,0,6
Tropical Depression,Four,6,2000-08-10T21:00:00Z,ATLANTIC CITY NJ,0,0,0,6,6
Tropical Depression,Four,6,2000-08-10T21:00:00Z,MYGF 266N 787W,15,0,0,1,16
Tropical Depression,Four,6,2000-08-10T21:00:00Z,NEW YORK CITY NY,0,0,0,5,5
Tropical Depression,Four,6,2000-08-10T21:00:00Z,BERMUDA,0,0,0,11,11
Tropical Depression,Four,6,2000-08-10T21:00:00Z,MONTAUK POINT NY,0,0,0,4,4
Tropical Depression,Four,6,2000-08-10T21:00:00Z,SAVANNAH GA,0,0,0,2,2
Tropical Depression,Four,6,2000-08-10T21:00:00Z,PROVIDENCE RI,0,0,0,3,3
Tropical Depression,Four,6,2000-08-10T21:00:00Z,CHARLESTON SC,0,0,1,3,4
Tropical Depression,Four,6,2000-08-10T21:00:00Z,NANTUCKET MA,0,0,0,4,4
Tropical Depression,Four,6,2000-08-10T21:00:00Z,MYRTLE BEACH SC,0,0,2,4,6
Tropical Depression,Four,6,2000-08-10T21:00:00Z,HYANNIS MA,0,0,0,3,3
Tropical Depression,Four,6,2000-08-10T21:00:00Z,WILMINGTON NC,0,0,2,6,8
Tropical Depression,Four,6,2000-08-10T21:00:00Z,BOSTON MA,0,0,0,2,2
Tropical Depression,Five,1,2000-08-13T21:00:00Z,24.1N  93.7W,46,0,0,0,46
Tropical Depression,Five,1,2000-08-13T21:00:00Z,FREEPORT TX,0,7,7,2,16
Tropical Depression,Five,1,2000-08-13T21:00:00Z,25.4N  95.1W,17,9,1,0,27
Tropical Depression,Five,1,2000-08-13T21:00:00Z,PORT O CONNOR TX,0,9,7,2,18
Tropical Depression,Five,1,2000-08-13T21:00:00Z,26.5N  97.0W,0,13,5,2,20
Tropical Depression,Five,1,2000-08-13T21:00:00Z,CORPUSCHRISTI TX,0,7,9,3,19
Tropical Depression,Five,1,2000-08-13T21:00:00Z,MMSO 238N 982W,0,3,7,3,13
Tropical Depression,Five,1,2000-08-13T21:00:00Z,BROWNSVILLE TX,0,11,6,2,19
Tropical Depression,Five,1,2000-08-13T21:00:00Z,MMTM 222N 979W,0,1,4,5,10
Tropical Depression,Five,1,2000-08-13T21:00:00Z,GULF 28N 91W,0,1,1,1,3
Tropical Depression,Five,1,2000-08-13T21:00:00Z,MMTX 210N 974W,0,0,3,3,6
Tropical Depression,Five,1,2000-08-13T21:00:00Z,GULF 28N 93W,0,8,3,1,12
Tropical Depression,Five,1,2000-08-13T21:00:00Z,MMVR 192N 961W,0,0,1,1,2
Tropical Depression,Five,1,2000-08-13T21:00:00Z,GULF 28N 95W,0,13,4,1,18
Tropical Depression,Five,1,2000-08-13T21:00:00Z,NEW IBERIA LA,0,0,1,2,3
Tropical Depression,Five,1,2000-08-13T21:00:00Z,GULF 27N 96W,1,16,3,1,21
Tropical Depression,Five,1,2000-08-13T21:00:00Z,PORT ARTHUR TX,0,2,4,3,9
Tropical Depression,Five,1,2000-08-13T21:00:00Z,GULF 25N 96W,8,12,1,1,22
Tropical Depression,Five,1,2000-08-13T21:00:00Z,GALVESTON TX,0,5,6,3,14
Tropical Depression,Five,2,2000-08-14T03:00:00Z,24.0N  94.3W,51,0,0,0,51
Tropical Depression,Five,2,2000-08-14T03:00:00Z,GALVESTON TX,0,1,6,4,11
Tropical Depression,Five,2,2000-08-14T03:00:00Z,24.7N  95.3W,30,1,0,1,32
Tropical Depression,Five,2,2000-08-14T03:00:00Z,FREEPORT TX,0,3,6,4,13
Tropical Depression,Five,2,2000-08-14T03:00:00Z,25.5N  97.0W,3,13,3,2,21
Tropical Depression,Five,2,2000-08-14T03:00:00Z,PORT O CONNOR TX,0,5,8,3,16
Tropical Depression,Five,2,2000-08-14T03:00:00Z,MMSO 238N 982W,1,5,5,4,15
Tropical Depression,Five,2,2000-08-14T03:00:00Z,CORPUSCHRISTI TX,0,6,8,4,18
Tropical Depression,Five,2,2000-08-14T03:00:00Z,MMTM 222N 979W,0,2,4,5,11
Tropical Depression,Five,2,2000-08-14T03:00:00Z,BROWNSVILLE TX,1,12,5,2,20
Tropical Depression,Five,2,2000-08-14T03:00:00Z,MMTX 210N 974W,0,0,2,5,7
Tropical Depression,Five,2,2000-08-14T03:00:00Z,GULF 28N 91W,0,1,1,2,4
Tropical Depression,Five,2,2000-08-14T03:00:00Z,MMVR 192N 961W,0,0,0,3,3
Tropical Depression,Five,2,2000-08-14T03:00:00Z,GULF 28N 93W,0,4,4,3,11
Tropical Depression,Five,2,2000-08-14T03:00:00Z,MMMD 210N 897W,0,0,1,1,2
Tropical Depression,Five,2,2000-08-14T03:00:00Z,GULF 28N 95W,0,8,5,3,16
Tropical Depression,Five,2,2000-08-14T03:00:00Z,NEW IBERIA LA,0,0,1,2,3
Tropical Depression,Five,2,2000-08-14T03:00:00Z,GULF 27N 96W,1,14,3,2,20
Tropical Depression,Five,2,2000-08-14T03:00:00Z,PORT ARTHUR TX,0,0,3,4,7
Tropical Depression,Five,2,2000-08-14T03:00:00Z,GULF 25N 96W,18,5,1,1,25
Tropical Depression,Five,3,2000-08-14T09:00:00Z,24.4N  95.2W,54,0,0,0,54
Tropical Depression,Five,3,2000-08-14T09:00:00Z,FREEPORT TX,0,3,5,4,12
Tropical Depression,Five,3,2000-08-14T09:00:00Z,25.3N  96.5W,21,6,0,1,28
Tropical Depression,Five,3,2000-08-14T09:00:00Z,PORT O CONNOR TX,0,8,5,3,16
Tropical Depression,Five,3,2000-08-14T09:00:00Z,26.0N  97.8W,2,17,2,1,22
Tropical Depression,Five,3,2000-08-14T09:00:00Z,CORPUSCHRISTI TX,0,12,5,2,19
Tropical Depression,Five,3,2000-08-14T09:00:00Z,MMSO 238N 982W,3,8,2,3,16
Tropical Depression,Five,3,2000-08-14T09:00:00Z,BROWNSVILLE TX,4,17,1,2,24
Tropical Depression,Five,3,2000-08-14T09:00:00Z,MMTM 222N 979W,1,2,3,3,9
Tropical Depression,Five,3,2000-08-14T09:00:00Z,GULF 28N 91W,0,0,1,1,2
Tropical Depression,Five,3,2000-08-14T09:00:00Z,MMTX 210N 974W,0,1,1,3,5
Tropical Depression,Five,3,2000-08-14T09:00:00Z,GULF 28N 93W,0,3,3,2,8
Tropical Depression,Five,3,2000-08-14T09:00:00Z,MMVR 192N 961W,0,0,0,2,2
Tropical Depression,Five,3,2000-08-14T09:00:00Z,GULF 28N 95W,1,8,4,2,15
Tropical Depression,Five,3,2000-08-14T09:00:00Z,NEW IBERIA LA,0,0,0,2,2
Tropical Depression,Five,3,2000-08-14T09:00:00Z,GULF 27N 96W,3,16,2,1,22
Tropical Depression,Five,3,2000-08-14T09:00:00Z,PORT ARTHUR TX,0,0,2,3,5
Tropical Depression,Five,3,2000-08-14T09:00:00Z,GULF 25N 96W,30,2,0,0,32
Tropical Depression,Five,3,2000-08-14T09:00:00Z,GALVESTON TX,0,2,3,4,9
Tropical Storm,Beryl,4,2000-08-14T15:00:00Z,24.7N  97.3W,50,0,0,0,50
Tropical Storm,Beryl,4,2000-08-14T15:00:00Z,PORT O CONNOR TX,2,6,6,2,16
Tropical Storm,Beryl,4,2000-08-14T15:00:00Z,25.6N  98.3W,24,4,1,0,29
Tropical Storm,Beryl,4,2000-08-14T15:00:00Z,CORPUSCHRISTI TX,4,12,4,2,22
Tropical Storm,Beryl,4,2000-08-14T15:00:00Z,26.5N  99.5W,4,17,2,1,24
Tropical Storm,Beryl,4,2000-08-14T15:00:00Z,BROWNSVILLE TX,32,1,0,0,33
Tropical Storm,Beryl,4,2000-08-14T15:00:00Z,MMSO 238N 982W,22,1,0,0,23
Tropical Storm,Beryl,4,2000-08-14T15:00:00Z,GULF 28N 91W,0,0,1,1,2
Tropical Storm,Beryl,4,2000-08-14T15:00:00Z,MMTM 222N 979W,6,1,0,1,8
Tropical Storm,Beryl,4,2000-08-14T15:00:00Z,GULF 28N 93W,0,1,3,3,7
Tropical Storm,Beryl,4,2000-08-14T15:00:00Z,NEW IBERIA LA,0,0,0,2,2
Tropical Storm,Beryl,4,2000-08-14T15:00:00Z,GULF 28N 95W,2,5,5,2,14
Tropical Storm,Beryl,4,2000-08-14T15:00:00Z,PORT ARTHUR TX,0,0,1,4,5
Tropical Storm,Beryl,4,2000-08-14T15:00:00Z,GULF 27N 96W,15,5,2,1,23
Tropical Storm,Beryl,4,2000-08-14T15:00:00Z,GALVESTON TX,0,1,3,5,9
Tropical Storm,Beryl,4,2000-08-14T15:00:00Z,GULF 25N 96W,71,0,0,0,71
Tropical Storm,Beryl,4,2000-08-14T15:00:00Z,FREEPORT TX,0,2,5,4,11
Tropical Storm,Beryl,5,2000-08-14T21:00:00Z,25.2N  98.7W,50,0,0,0,50
Tropical Storm,Beryl,5,2000-08-14T21:00:00Z,PORT O CONNOR TX,1,1,1,0,3
Tropical Storm,Beryl,5,2000-08-14T21:00:00Z,25.9N 100.3W,20,12,0,0,32
Tropical Storm,Beryl,5,2000-08-14T21:00:00Z,CORPUSCHRISTI TX,7,5,1,0,13
Tropical Storm,Beryl,5,2000-08-14T21:00:00Z,26.5N 102.5W,1,20,5,0,26
Tropical Storm,Beryl,5,2000-08-14T21:00:00Z,BROWNSVILLE TX,49,0,0,0,49
Tropical Storm,Beryl,5,2000-08-14T21:00:00Z,MMSO 238N 982W,33,0,0,0,33
Tropical Storm,Beryl,5,2000-08-14T21:00:00Z,GULF 27N 96W,7,3,1,0,11
Tropical Storm,Beryl,5,2000-08-14T21:00:00Z,MMTM 222N 979W,3,2,1,0,6
Tropical Storm,Beryl,5,2000-08-14T21:00:00Z,GULF 25N 96W,99,0,0,0,99
Tropical Storm,Beryl,6,2000-08-15T03:00:00Z,25.3N  99.8W,48,0,0,0,48
Tropical Storm,Beryl,6,2000-08-15T03:00:00Z,CORPUSCHRISTI TX,3,3,0,0,6
Tropical Storm,Beryl,6,2000-08-15T03:00:00Z,25.8N 101.4W,20,10,0,0,30
Tropical Storm,Beryl,6,2000-08-15T03:00:00Z,BROWNSVILLE TX,46,0,0,0,46
Tropical Storm,Beryl,6,2000-08-15T03:00:00Z,0.0N   0.0W,99,0,0,0,99
Tropical Storm,Beryl,6,2000-08-15T03:00:00Z,GULF 27N 96W,1,2,0,0,3
Tropical Storm,Beryl,6,2000-08-15T03:00:00Z,MMSO 238N 982W,99,0,0,0,99
Tropical Storm,Beryl,6,2000-08-15T03:00:00Z,GULF 25N 96W,82,0,0,0,82
Tropical Storm,Beryl,6,2000-08-15T03:00:00Z,MMTM 222N 979W,1,2,0,0,3
Tropical Depression,Six,1,2000-08-17T21:00:00Z,16.0N  56.6W,45,0,0,0,45
Tropical Depression,Six,1,2000-08-17T21:00:00Z,TKPK 173N 627W,0,1,11,7,19
Tropical Depression,Six,1,2000-08-17T21:00:00Z,16.6N  58.2W,19,9,0,1,29
Tropical Depression,Six,1,2000-08-17T21:00:00Z,TNCM 181N 631W,0,1,9,9,19
Tropical Depression,Six,1,2000-08-17T21:00:00Z,17.5N  60.0W,1,16,4,2,23
Tropical Depression,Six,1,2000-08-17T21:00:00Z,TISX 177N 648W,0,0,3,13,16
Tropical Depression,Six,1,2000-08-17T21:00:00Z,SVMG 110N 640W,0,0,0,2,2
Tropical Depression,Six,1,2000-08-17T21:00:00Z,TIST 183N 650W,0,0,2,15,17
Tropical Depression,Six,1,2000-08-17T21:00:00Z,TTPP 106N 614W,0,0,1,1,2
Tropical Depression,Six,1,2000-08-17T21:00:00Z,TJPS 180N 666W,0,0,0,13,13
Tropical Depression,Six,1,2000-08-17T21:00:00Z,TTPT 112N 608W,0,0,2,2,4
Tropical Depression,Six,1,2000-08-17T21:00:00Z,MDSD 185N 697W,0,0,0,5,5
Tropical Depression,Six,1,2000-08-17T21:00:00Z,TGPY 120N 618W,0,0,3,3,6
Tropical Depression,Six,1,2000-08-17T21:00:00Z,TJSJ 184N 661W,0,0,1,14,15
Tropical Depression,Six,1,2000-08-17T21:00:00Z,TBPB 131N 595W,0,8,4,1,13
Tropical Depression,Six,1,2000-08-17T21:00:00Z,MDPP 198N 707W,0,0,0,3,3
Tropical Depression,Six,1,2000-08-17T21:00:00Z,TVSV 131N 612W,0,2,6,2,10
Tropical Depression,Six,1,2000-08-17T21:00:00Z,MBJT 215N 712W,0,0,0,2,2
Tropical Depression,Six,1,2000-08-17T21:00:00Z,TLPL 138N 610W,0,4,7,2,13
Tropical Depression,Six,1,2000-08-17T21:00:00Z,ST CROIX VI,0,0,3,13,16
Tropical Depression,Six,1,2000-08-17T21:00:00Z,TFFF 146N 610W,0,7,7,2,16
Tropical Depression,Six,1,2000-08-17T21:00:00Z,ST THOMAS VI,0,0,2,15,17
Tropical Depression,Six,1,2000-08-17T21:00:00Z,TDPR 153N 614W,0,6,8,3,17
Tropical Depression,Six,1,2000-08-17T21:00:00Z,SAN JUAN PR,0,0,1,14,15
Tropical Depression,Six,1,2000-08-17T21:00:00Z,TFFR 163N 615W,0,7,9,3,19
Tropical Depression,Six,1,2000-08-17T21:00:00Z,PONCE PR,0,0,0,13,13
Tropical Depression,Six,1,2000-08-17T21:00:00Z,TAPA 171N 618W,0,5,11,4,20
Tropical Depression,Six,2,2000-08-18T03:00:00Z,16.0N  56.5W,43,0,0,0,43
Tropical Depression,Six,2,2000-08-18T03:00:00Z,TNCM 181N 631W,0,1,11,8,20
Tropical Depression,Six,2,2000-08-18T03:00:00Z,17.0N  58.5W,11,16,1,0,28
Tropical Depression,Six,2,2000-08-18T03:00:00Z,TISX 177N 648W,0,0,4,13,17
Tropical Depression,Six,2,2000-08-18T03:00:00Z,18.0N  60.5W,0,14,7,2,23
Tropical Depression,Six,2,2000-08-18T03:00:00Z,TIST 183N 650W,0,0,3,14,17
Tropical Depression,Six,2,2000-08-18T03:00:00Z,TTPT 112N 608W,0,0,2,1,3
Tropical Depression,Six,2,2000-08-18T03:00:00Z,TJPS 180N 666W,0,0,1,13,14
Tropical Depression,Six,2,2000-08-18T03:00:00Z,TGPY 120N 618W,0,0,2,3,5
Tropical Depression,Six,2,2000-08-18T03:00:00Z,MDSD 185N 697W,0,0,0,7,7
Tropical Depression,Six,2,2000-08-18T03:00:00Z,TBPB 131N 595W,1,7,3,1,12
Tropical Depression,Six,2,2000-08-18T03:00:00Z,MDCB 176N 714W,0,0,0,2,2
Tropical Depression,Six,2,2000-08-18T03:00:00Z,TVSV 131N 612W,0,2,5,3,10
Tropical Depression,Six,2,2000-08-18T03:00:00Z,TJSJ 184N 661W,0,0,1,15,16
Tropical Depression,Six,2,2000-08-18T03:00:00Z,TLPL 138N 610W,0,5,6,2,13
Tropical Depression,Six,2,2000-08-18T03:00:00Z,MDPP 198N 707W,0,0,0,5,5
Tropical Depression,Six,2,2000-08-18T03:00:00Z,TFFF 146N 610W,0,8,6,2,16
Tropical Depression,Six,2,2000-08-18T03:00:00Z,MBJT 215N 712W,0,0,0,4,4
Tropical Depression,Six,2,2000-08-18T03:00:00Z,TDPR 153N 614W,0,7,9,2,18
Tropical Depression,Six,2,2000-08-18T03:00:00Z,ST CROIX VI,0,0,4,13,17
Tropical Depression,Six,2,2000-08-18T03:00:00Z,TFFR 163N 615W,0,8,10,2,20
Tropical Depression,Six,2,2000-08-18T03:00:00Z,ST THOMAS VI,0,0,3,14,17
Tropical Depression,Six,2,2000-08-18T03:00:00Z,TAPA 171N 618W,0,6,12,3,21
Tropical Depression,Six,2,2000-08-18T03:00:00Z,SAN JUAN PR,0,0,1,15,16
Tropical Depression,Six,2,2000-08-18T03:00:00Z,TKPK 173N 627W,0,2,12,6,20
Tropical Depression,Six,2,2000-08-18T03:00:00Z,PONCE PR,0,0,1,13,14
Tropical Depression,Six,3,2000-08-18T09:00:00Z,17.0N  57.4W,51,0,0,0,51
Tropical Depression,Six,3,2000-08-18T09:00:00Z,TIST 183N 650W,0,0,8,8,16
Tropical Depression,Six,3,2000-08-18T09:00:00Z,17.8N  59.2W,24,7,1,0,32
Tropical Depression,Six,3,2000-08-18T09:00:00Z,TJPS 180N 666W,0,0,2,11,13
Tropical Depression,Six,3,2000-08-18T09:00:00Z,19.0N  61.5W,1,15,8,1,25
Tropical Depression,Six,3,2000-08-18T09:00:00Z,MDSD 185N 697W,0,0,0,8,8
Tropical Depression,Six,3,2000-08-18T09:00:00Z,TBPB 131N 595W,0,2,1,0,3
Tropical Depression,Six,3,2000-08-18T09:00:00Z,MDCB 176N 714W,0,0,0,3,3
Tropical Depression,Six,3,2000-08-18T09:00:00Z,TVSV 131N 612W,0,1,1,0,2
Tropical Depression,Six,3,2000-08-18T09:00:00Z,MTPP 186N 724W,0,0,0,2,2
Tropical Depression,Six,3,2000-08-18T09:00:00Z,TLPL 138N 610W,0,2,3,0,5
Tropical Depression,Six,3,2000-08-18T09:00:00Z,TJSJ 184N 661W,0,0,4,11,15
Tropical Depression,Six,3,2000-08-18T09:00:00Z,TFFF 146N 610W,0,5,4,1,10
Tropical Depression,Six,3,2000-08-18T09:00:00Z,MDPP 198N 707W,0,0,0,7,7
Tropical Depression,Six,3,2000-08-18T09:00:00Z,TDPR 153N 614W,0,7,6,0,13
Tropical Depression,Six,3,2000-08-18T09:00:00Z,MBJT 215N 712W,0,0,0,6,6
Tropical Depression,Six,3,2000-08-18T09:00:00Z,TFFR 163N 615W,0,12,6,1,19
Tropical Depression,Six,3,2000-08-18T09:00:00Z,MYMM 224N 730W,0,0,0,2,2
Tropical Depression,Six,3,2000-08-18T09:00:00Z,TAPA 171N 618W,0,13,7,1,21
Tropical Depression,Six,3,2000-08-18T09:00:00Z,ST CROIX VI,0,0,8,7,15
Tropical Depression,Six,3,2000-08-18T09:00:00Z,TKPK 173N 627W,0,7,10,2,19
Tropical Depression,Six,3,2000-08-18T09:00:00Z,ST THOMAS VI,0,0,8,8,16
Tropical Depression,Six,3,2000-08-18T09:00:00Z,TNCM 181N 631W,0,5,12,3,20
Tropical Depression,Six,3,2000-08-18T09:00:00Z,SAN JUAN PR,0,0,4,11,15
Tropical Depression,Six,3,2000-08-18T09:00:00Z,TISX 177N 648W,0,0,8,7,15
Tropical Depression,Six,3,2000-08-18T09:00:00Z,PONCE PR,0,0,2,11,13
Tropical Storm,Chris,4,2000-08-18T15:00:00Z,18.4N  59.2W,50,0,0,0,50
Tropical Storm,Chris,4,2000-08-18T15:00:00Z,MDCB 176N 714W,0,0,0,4,4
Tropical Storm,Chris,4,2000-08-18T15:00:00Z,19.4N  61.4W,17,15,0,1,33
Tropical Storm,Chris,4,2000-08-18T15:00:00Z,MTPP 186N 724W,0,0,0,4,4
Tropical Storm,Chris,4,2000-08-18T15:00:00Z,20.3N  63.6W,0,18,5,1,24
Tropical Storm,Chris,4,2000-08-18T15:00:00Z,MTCA 183N 738W,0,0,0,2,2
Tropical Storm,Chris,4,2000-08-18T15:00:00Z,TFFF 146N 610W,0,2,1,0,3
Tropical Storm,Chris,4,2000-08-18T15:00:00Z,MUGM 200N 751W,0,0,0,2,2
Tropical Storm,Chris,4,2000-08-18T15:00:00Z,TDPR 153N 614W,0,5,2,0,7
Tropical Storm,Chris,4,2000-08-18T15:00:00Z,TJSJ 184N 661W,0,1,10,5,16
Tropical Storm,Chris,4,2000-08-18T15:00:00Z,TFFR 163N 615W,2,11,2,0,15
Tropical Storm,Chris,4,2000-08-18T15:00:00Z,MDPP 198N 707W,0,0,0,10,10
Tropical Storm,Chris,4,2000-08-18T15:00:00Z,TAPA 171N 618W,3,16,1,1,21
Tropical Storm,Chris,4,2000-08-18T15:00:00Z,MBJT 215N 712W,0,0,0,11,11
Tropical Storm,Chris,4,2000-08-18T15:00:00Z,TKPK 173N 627W,1,15,2,1,19
Tropical Storm,Chris,4,2000-08-18T15:00:00Z,MYMM 224N 730W,0,0,0,7,7
Tropical Storm,Chris,4,2000-08-18T15:00:00Z,TNCM 181N 631W,1,17,3,1,22
Tropical Storm,Chris,4,2000-08-18T15:00:00Z,MYSM 241N 745W,0,0,0,2,2
Tropical Storm,Chris,4,2000-08-18T15:00:00Z,TISX 177N 648W,0,4,10,2,16
Tropical Storm,Chris,4,2000-08-18T15:00:00Z,ST CROIX VI,0,4,10,2,16
Tropical Storm,Chris,4,2000-08-18T15:00:00Z,TIST 183N 650W,0,5,10,2,17
Tropical Storm,Chris,4,2000-08-18T15:00:00Z,ST THOMAS VI,0,5,10,2,17
Tropical Storm,Chris,4,2000-08-18T15:00:00Z,TJPS 180N 666W,0,0,8,5,13
Tropical Storm,Chris,4,2000-08-18T15:00:00Z,SAN JUAN PR,0,1,10,5,16
Tropical Storm,Chris,4,2000-08-18T15:00:00Z,MDSD 185N 697W,0,0,1,8,9
Tropical Storm,Chris,4,2000-08-18T15:00:00Z,PONCE PR,0,0,8,5,13
Tropical Storm,Chris,5,2000-08-18T21:00:00Z,18.7N  60.2W,52,0,0,0,52
Tropical Storm,Chris,5,2000-08-18T21:00:00Z,MTPP 186N 724W,0,0,0,5,5
Tropical Storm,Chris,5,2000-08-18T21:00:00Z,19.7N  62.2W,21,11,0,1,33
Tropical Storm,Chris,5,2000-08-18T21:00:00Z,MTCA 183N 738W,0,0,0,3,3
Tropical Storm,Chris,5,2000-08-18T21:00:00Z,20.7N  64.4W,1,17,6,1,25
Tropical Storm,Chris,5,2000-08-18T21:00:00Z,MUGM 200N 751W,0,0,0,2,2
Tropical Storm,Chris,5,2000-08-18T21:00:00Z,TFFF 146N 610W,0,1,1,0,2
Tropical Storm,Chris,5,2000-08-18T21:00:00Z,TJSJ 184N 661W,0,3,10,3,16
Tropical Storm,Chris,5,2000-08-18T21:00:00Z,TDPR 153N 614W,1,3,1,1,6
Tropical Storm,Chris,5,2000-08-18T21:00:00Z,MDPP 198N 707W,0,0,1,10,11
Tropical Storm,Chris,5,2000-08-18T21:00:00Z,TFFR 163N 615W,5,8,1,0,14
Tropical Storm,Chris,5,2000-08-18T21:00:00Z,MBJT 215N 712W,0,0,0,13,13
Tropical Storm,Chris,5,2000-08-18T21:00:00Z,TAPA 171N 618W,10,10,0,0,20
Tropical Storm,Chris,5,2000-08-18T21:00:00Z,MYMM 224N 730W,0,0,0,9,9
Tropical Storm,Chris,5,2000-08-18T21:00:00Z,TKPK 173N 627W,3,14,1,1,19
Tropical Storm,Chris,5,2000-08-18T21:00:00Z,MYSM 241N 745W,0,0,0,4,4
Tropical Storm,Chris,5,2000-08-18T21:00:00Z,TNCM 181N 631W,4,17,1,1,23
Tropical Storm,Chris,5,2000-08-18T21:00:00Z,MYEG 235N 758W,0,0,0,2,2
Tropical Storm,Chris,5,2000-08-18T21:00:00Z,TISX 177N 648W,0,7,7,2,16
Tropical Storm,Chris,5,2000-08-18T21:00:00Z,ST CROIX VI,0,7,7,2,16
Tropical Storm,Chris,5,2000-08-18T21:00:00Z,TIST 183N 650W,0,9,8,1,18
Tropical Storm,Chris,5,2000-08-18T21:00:00Z,ST THOMAS VI,0,9,8,1,18
Tropical Storm,Chris,5,2000-08-18T21:00:00Z,TJPS 180N 666W,0,1,9,3,13
Tropical Storm,Chris,5,2000-08-18T21:00:00Z,SAN JUAN PR,0,3,10,3,16
Tropical Storm,Chris,5,2000-08-18T21:00:00Z,MDSD 185N 697W,0,0,1,9,10
Tropical Storm,Chris,5,2000-08-18T21:00:00Z,PONCE PR,0,1,9,3,13
Tropical Storm,Chris,5,2000-08-18T21:00:00Z,MDCB 176N 714W,0,0,0,5,5
Tropical Depression,Chris,6,2000-08-19T03:00:00Z,18.5N  59.0W,58,0,0,0,58
Tropical Depression,Chris,6,2000-08-19T03:00:00Z,MTPP 186N 724W,0,0,0,4,4
Tropical Depression,Chris,6,2000-08-19T03:00:00Z,19.8N  61.3W,19,15,0,0,34
Tropical Depression,Chris,6,2000-08-19T03:00:00Z,MTCA 183N 738W,0,0,0,2,2
Tropical Depression,Chris,6,2000-08-19T03:00:00Z,21.0N  63.7W,0,14,9,1,24
Tropical Depression,Chris,6,2000-08-19T03:00:00Z,MUGM 200N 751W,0,0,0,3,3
Tropical Depression,Chris,6,2000-08-19T03:00:00Z,TDPR 153N 614W,0,2,1,0,3
Tropical Depression,Chris,6,2000-08-19T03:00:00Z,TJSJ 184N 661W,0,1,8,4,13
Tropical Depression,Chris,6,2000-08-19T03:00:00Z,TFFR 163N 615W,0,7,3,0,10
Tropical Depression,Chris,6,2000-08-19T03:00:00Z,MDPP 198N 707W,0,0,0,10,10
Tropical Depression,Chris,6,2000-08-19T03:00:00Z,TAPA 171N 618W,1,13,2,0,16
Tropical Depression,Chris,6,2000-08-19T03:00:00Z,MBJT 215N 712W,0,0,0,12,12
Tropical Depression,Chris,6,2000-08-19T03:00:00Z,TKPK 173N 627W,0,10,4,1,15
Tropical Depression,Chris,6,2000-08-19T03:00:00Z,MYMM 224N 730W,0,0,0,10,10
Tropical Depression,Chris,6,2000-08-19T03:00:00Z,TNCM 181N 631W,0,13,5,0,18
Tropical Depression,Chris,6,2000-08-19T03:00:00Z,MYSM 241N 745W,0,0,0,6,6
Tropical Depression,Chris,6,2000-08-19T03:00:00Z,TISX 177N 648W,0,2,9,1,12
Tropical Depression,Chris,6,2000-08-19T03:00:00Z,MYEG 235N 758W,0,0,0,3,3
Tropical Depression,Chris,6,2000-08-19T03:00:00Z,TIST 183N 650W,0,3,10,2,15
Tropical Depression,Chris,6,2000-08-19T03:00:00Z,ST CROIX VI,0,2,9,1,12
Tropical Depression,Chris,6,2000-08-19T03:00:00Z,TJPS 180N 666W,0,0,6,5,11
Tropical Depression,Chris,6,2000-08-19T03:00:00Z,ST THOMAS VI,0,3,10,2,15
Tropical Depression,Chris,6,2000-08-19T03:00:00Z,MDSD 185N 697W,0,0,1,7,8
Tropical Depression,Chris,6,2000-08-19T03:00:00Z,SAN JUAN PR,0,1,8,4,13
Tropical Depression,Chris,6,2000-08-19T03:00:00Z,MDCB 176N 714W,0,0,0,4,4
Tropical Depression,Chris,6,2000-08-19T03:00:00Z,PONCE PR,0,0,6,5,11
Tropical Depression,Chris,7,2000-08-19T09:00:00Z,19.7N  61.0W,55,0,0,0,55
Tropical Depression,Chris,7,2000-08-19T09:00:00Z,MUGM 200N 751W,0,0,0,3,3
Tropical Depression,Chris,7,2000-08-19T09:00:00Z,20.8N  62.9W,23,10,0,0,33
Tropical Depression,Chris,7,2000-08-19T09:00:00Z,TJSJ 184N 661W,0,2,7,1,10
Tropical Depression,Chris,7,2000-08-19T09:00:00Z,22.0N  65.0W,1,17,4,1,23
Tropical Depression,Chris,7,2000-08-19T09:00:00Z,MDPP 198N 707W,0,0,1,8,9
Tropical Depression,Chris,7,2000-08-19T09:00:00Z,TFFR 163N 615W,0,3,1,0,4
Tropical Depression,Chris,7,2000-08-19T09:00:00Z,MBJT 215N 712W,0,0,1,11,12
Tropical Depression,Chris,7,2000-08-19T09:00:00Z,TAPA 171N 618W,2,7,1,0,10
Tropical Depression,Chris,7,2000-08-19T09:00:00Z,MYMM 224N 730W,0,0,0,10,10
Tropical Depression,Chris,7,2000-08-19T09:00:00Z,TKPK 173N 627W,1,7,2,0,10
Tropical Depression,Chris,7,2000-08-19T09:00:00Z,MYSM 241N 745W,0,0,0,8,8
Tropical Depression,Chris,7,2000-08-19T09:00:00Z,TNCM 181N 631W,2,12,1,1,16
Tropical Depression,Chris,7,2000-08-19T09:00:00Z,MYEG 235N 758W,0,0,0,5,5
Tropical Depression,Chris,7,2000-08-19T09:00:00Z,TISX 177N 648W,0,4,4,1,9
Tropical Depression,Chris,7,2000-08-19T09:00:00Z,MYAK 241N 776W,0,0,0,2,2
Tropical Depression,Chris,7,2000-08-19T09:00:00Z,TIST 183N 650W,0,6,5,1,12
Tropical Depression,Chris,7,2000-08-19T09:00:00Z,MYNN 251N 775W,0,0,0,2,2
Tropical Depression,Chris,7,2000-08-19T09:00:00Z,TJPS 180N 666W,0,1,5,2,8
Tropical Depression,Chris,7,2000-08-19T09:00:00Z,ST CROIX VI,0,4,4,1,9
Tropical Depression,Chris,7,2000-08-19T09:00:00Z,MDSD 185N 697W,0,0,1,5,6
Tropical Depression,Chris,7,2000-08-19T09:00:00Z,ST THOMAS VI,0,6,5,1,12
Tropical Depression,Chris,7,2000-08-19T09:00:00Z,MDCB 176N 714W,0,0,0,2,2
Tropical Depression,Chris,7,2000-08-19T09:00:00Z,SAN JUAN PR,0,2,7,1,10
Tropical Depression,Chris,7,2000-08-19T09:00:00Z,MTPP 186N 724W,0,0,0,4,4
Tropical Depression,Chris,7,2000-08-19T09:00:00Z,PONCE PR,0,1,5,2,8
Tropical Depression,Chris,7,2000-08-19T09:00:00Z,MTCA 183N 738W,0,0,0,2,2
Tropical Depression,Seven,1,2000-08-19T21:00:00Z,13.5N  50.5W,45,1,0,0,46
Tropical Depression,Seven,1,2000-08-19T21:00:00Z,TAPA 171N 618W,0,0,1,16,17
Tropical Depression,Seven,1,2000-08-19T21:00:00Z,14.5N  53.5W,0,29,1,0,30
Tropical Depression,Seven,1,2000-08-19T21:00:00Z,TKPK 173N 627W,0,0,0,17,17
Tropical Depression,Seven,1,2000-08-19T21:00:00Z,15.5N  57.0W,0,0,21,1,22
Tropical Depression,Seven,1,2000-08-19T21:00:00Z,TNCM 181N 631W,0,0,0,16,16
Tropical Depression,Seven,1,2000-08-19T21:00:00Z,TNCC 122N 690W,0,0,0,2,2
Tropical Depression,Seven,1,2000-08-19T21:00:00Z,TISX 177N 648W,0,0,0,15,15
Tropical Depression,Seven,1,2000-08-19T21:00:00Z,SVMG 110N 640W,0,0,0,9,9
Tropical Depression,Seven,1,2000-08-19T21:00:00Z,TIST 183N 650W,0,0,0,14,14
Tropical Depression,Seven,1,2000-08-19T21:00:00Z,TTPP 106N 614W,0,0,1,10,11
Tropical Depression,Seven,1,2000-08-19T21:00:00Z,TJPS 180N 666W,0,0,0,11,11
Tropical Depression,Seven,1,2000-08-19T21:00:00Z,TTPT 112N 608W,0,0,2,11,13
Tropical Depression,Seven,1,2000-08-19T21:00:00Z,MDSD 185N 697W,0,0,0,4,4
Tropical Depression,Seven,1,2000-08-19T21:00:00Z,TGPY 120N 618W,0,0,1,12,13
Tropical Depression,Seven,1,2000-08-19T21:00:00Z,TJSJ 184N 661W,0,0,0,12,12
Tropical Depression,Seven,1,2000-08-19T21:00:00Z,TBPB 131N 595W,0,0,8,10,18
Tropical Depression,Seven,1,2000-08-19T21:00:00Z,MDPP 198N 707W,0,0,0,2,2
Tropical Depression,Seven,1,2000-08-19T21:00:00Z,TVSV 131N 612W,0,0,1,15,16
Tropical Depression,Seven,1,2000-08-19T21:00:00Z,ST CROIX VI,0,0,0,15,15
Tropical Depression,Seven,1,2000-08-19T21:00:00Z,TLPL 138N 610W,0,0,2,15,17
Tropical Depression,Seven,1,2000-08-19T21:00:00Z,ST THOMAS VI,0,0,0,14,14
Tropical Depression,Seven,1,2000-08-19T21:00:00Z,TFFF 146N 610W,0,0,2,16,18
Tropical Depression,Seven,1,2000-08-19T21:00:00Z,SAN JUAN PR,0,0,0,12,12
Tropical Depression,Seven,1,2000-08-19T21:00:00Z,TDPR 153N 614W,0,0,1,17,18
Tropical Depression,Seven,1,2000-08-19T21:00:00Z,PONCE PR,0,0,0,11,11
Tropical Depression,Seven,1,2000-08-19T21:00:00Z,TFFR 163N 615W,0,0,1,17,18
Tropical Depression,Seven,2,2000-08-20T03:00:00Z,14.0N  51.0W,53,1,0,0,54
Tropical Depression,Seven,2,2000-08-20T03:00:00Z,TKPK 173N 627W,0,0,1,19,20
Tropical Depression,Seven,2,2000-08-20T03:00:00Z,14.9N  54.3W,0,33,1,0,34
Tropical Depression,Seven,2,2000-08-20T03:00:00Z,TNCM 181N 631W,0,0,0,19,19
Tropical Depression,Seven,2,2000-08-20T03:00:00Z,15.7N  57.5W,0,4,20,1,25
Tropical Depression,Seven,2,2000-08-20T03:00:00Z,TISX 177N 648W,0,0,0,18,18
Tropical Depression,Seven,2,2000-08-20T03:00:00Z,SVMG 110N 640W,0,0,0,2,2
Tropical Depression,Seven,2,2000-08-20T03:00:00Z,TIST 183N 650W,0,0,0,17,17
Tropical Depression,Seven,2,2000-08-20T03:00:00Z,TTPP 106N 614W,0,0,0,3,3
Tropical Depression,Seven,2,2000-08-20T03:00:00Z,TJPS 180N 666W,0,0,0,15,15
Tropical Depression,Seven,2,2000-08-20T03:00:00Z,TTPT 112N 608W,0,0,1,4,5
Tropical Depression,Seven,2,2000-08-20T03:00:00Z,MDSD 185N 697W,0,0,0,5,5
Tropical Depression,Seven,2,2000-08-20T03:00:00Z,TGPY 120N 618W,0,0,1,7,8
Tropical Depression,Seven,2,2000-08-20T03:00:00Z,MDCB 176N 714W,0,0,0,2,2
Tropical Depression,Seven,2,2000-08-20T03:00:00Z,TBPB 131N 595W,0,0,10,5,15
Tropical Depression,Seven,2,2000-08-20T03:00:00Z,TJSJ 184N 661W,0,0,0,15,15
Tropical Depression,Seven,2,2000-08-20T03:00:00Z,TVSV 131N 612W,0,0,3,10,13
Tropical Depression,Seven,2,2000-08-20T03:00:00Z,MDPP 198N 707W,0,0,0,2,2
Tropical Depression,Seven,2,2000-08-20T03:00:00Z,TLPL 138N 610W,0,0,5,11,16
Tropical Depression,Seven,2,2000-08-20T03:00:00Z,ST CROIX VI,0,0,0,18,18
Tropical Depression,Seven,2,2000-08-20T03:00:00Z,TFFF 146N 610W,0,0,7,12,19
Tropical Depression,Seven,2,2000-08-20T03:00:00Z,ST THOMAS VI,0,0,0,17,17
Tropical Depression,Seven,2,2000-08-20T03:00:00Z,TDPR 153N 614W,0,0,5,15,20
Tropical Depression,Seven,2,2000-08-20T03:00:00Z,SAN JUAN PR,0,0,0,15,15
Tropical Depression,Seven,2,2000-08-20T03:00:00Z,TFFR 163N 615W,0,0,5,16,21
Tropical Depression,Seven,2,2000-08-20T03:00:00Z,PONCE PR,0,0,0,15,15
Tropical Depression,Seven,2,2000-08-20T03:00:00Z,TAPA 171N 618W,0,0,3,18,21
Tropical Depression,Seven,3,2000-08-20T09:00:00Z,14.8N  52.5W,56,1,0,0,57
Tropical Depression,Seven,3,2000-08-20T09:00:00Z,TKPK 173N 627W,0,0,6,14,20
Tropical Depression,Seven,3,2000-08-20T09:00:00Z,15.6N  55.7W,0,35,1,0,36
Tropical Depression,Seven,3,2000-08-20T09:00:00Z,TNCM 181N 631W,0,0,3,16,19
Tropical Depression,Seven,3,2000-08-20T09:00:00Z,16.5N  59.0W,0,3,22,1,26
Tropical Depression,Seven,3,2000-08-20T09:00:00Z,TISX 177N 648W,0,0,1,16,17
Tropical Depression,Seven,3,2000-08-20T09:00:00Z,TNCC 122N 690W,0,0,0,2,2
Tropical Depression,Seven,3,2000-08-20T09:00:00Z,TIST 183N 650W,0,0,0,17,17
Tropical Depression,Seven,3,2000-08-20T09:00:00Z,SVMG 110N 640W,0,0,0,3,3
Tropical Depression,Seven,3,2000-08-20T09:00:00Z,TJPS 180N 666W,0,0,0,15,15
Tropical Depression,Seven,3,2000-08-20T09:00:00Z,TTPP 106N 614W,0,0,1,2,3
Tropical Depression,Seven,3,2000-08-20T09:00:00Z,MDSD 185N 697W,0,0,0,6,6
Tropical Depression,Seven,3,2000-08-20T09:00:00Z,TTPT 112N 608W,0,0,1,4,5
Tropical Depression,Seven,3,2000-08-20T09:00:00Z,MDCB 176N 714W,0,0,0,2,2
Tropical Depression,Seven,3,2000-08-20T09:00:00Z,TGPY 120N 618W,0,0,2,5,7
Tropical Depression,Seven,3,2000-08-20T09:00:00Z,TJSJ 184N 661W,0,0,0,15,15
Tropical Depression,Seven,3,2000-08-20T09:00:00Z,TBPB 131N 595W,0,1,11,2,14
Tropical Depression,Seven,3,2000-08-20T09:00:00Z,MDPP 198N 707W,0,0,0,4,4
Tropical Depression,Seven,3,2000-08-20T09:00:00Z,TVSV 131N 612W,0,0,6,6,12
Tropical Depression,Seven,3,2000-08-20T09:00:00Z,MBJT 215N 712W,0,0,0,2,2
Tropical Depression,Seven,3,2000-08-20T09:00:00Z,TLPL 138N 610W,0,0,10,5,15
Tropical Depression,Seven,3,2000-08-20T09:00:00Z,ST CROIX VI,0,0,1,16,17
Tropical Depression,Seven,3,2000-08-20T09:00:00Z,TFFF 146N 610W,0,0,13,5,18
Tropical Depression,Seven,3,2000-08-20T09:00:00Z,ST THOMAS VI,0,0,0,17,17
Tropical Depression,Seven,3,2000-08-20T09:00:00Z,TDPR 153N 614W,0,0,12,7,19
Tropical Depression,Seven,3,2000-08-20T09:00:00Z,SAN JUAN PR,0,0,0,15,15
Tropical Depression,Seven,3,2000-08-20T09:00:00Z,TFFR 163N 615W,0,0,13,8,21
Tropical Depression,Seven,3,2000-08-20T09:00:00Z,PONCE PR,0,0,0,15,15
Tropical Depression,Seven,3,2000-08-20T09:00:00Z,TAPA 171N 618W,0,0,11,10,21
Tropical Storm,Debby,4,2000-08-20T15:00:00Z,16.0N  55.2W,57,1,0,0,58
Tropical Storm,Debby,4,2000-08-20T15:00:00Z,TIST 183N 650W,0,0,6,14,20
Tropical Storm,Debby,4,2000-08-20T15:00:00Z,16.8N  58.5W,0,34,0,0,34
Tropical Storm,Debby,4,2000-08-20T15:00:00Z,TJPS 180N 666W,0,0,1,18,19
Tropical Storm,Debby,4,2000-08-20T15:00:00Z,17.5N  61.5W,0,4,20,1,25
Tropical Storm,Debby,4,2000-08-20T15:00:00Z,MDSD 185N 697W,0,0,0,15,15
Tropical Storm,Debby,4,2000-08-20T15:00:00Z,TNCC 122N 690W,0,0,0,2,2
Tropical Storm,Debby,4,2000-08-20T15:00:00Z,MDCB 176N 714W,0,0,0,9,9
Tropical Storm,Debby,4,2000-08-20T15:00:00Z,TGPY 120N 618W,0,0,2,1,3
Tropical Storm,Debby,4,2000-08-20T15:00:00Z,MTPP 186N 724W,0,0,0,7,7
Tropical Storm,Debby,4,2000-08-20T15:00:00Z,TBPB 131N 595W,0,4,5,0,9
Tropical Storm,Debby,4,2000-08-20T15:00:00Z,MTCA 183N 738W,0,0,0,3,3
Tropical Storm,Debby,4,2000-08-20T15:00:00Z,TVSV 131N 612W,0,1,6,1,8
Tropical Storm,Debby,4,2000-08-20T15:00:00Z,TJSJ 184N 661W,0,0,2,17,19
Tropical Storm,Debby,4,2000-08-20T15:00:00Z,TLPL 138N 610W,0,3,9,0,12
Tropical Storm,Debby,4,2000-08-20T15:00:00Z,MDPP 198N 707W,0,0,0,12,12
Tropical Storm,Debby,4,2000-08-20T15:00:00Z,TFFF 146N 610W,0,5,12,0,17
Tropical Storm,Debby,4,2000-08-20T15:00:00Z,MBJT 215N 712W,0,0,0,9,9
Tropical Storm,Debby,4,2000-08-20T15:00:00Z,TDPR 153N 614W,0,5,15,0,20
Tropical Storm,Debby,4,2000-08-20T15:00:00Z,MYMM 224N 730W,0,0,0,3,3
Tropical Storm,Debby,4,2000-08-20T15:00:00Z,TFFR 163N 615W,0,5,18,1,24
Tropical Storm,Debby,4,2000-08-20T15:00:00Z,ST CROIX VI,0,0,8,12,20
Tropical Storm,Debby,4,2000-08-20T15:00:00Z,TAPA 171N 618W,0,3,20,1,24
Tropical Storm,Debby,4,2000-08-20T15:00:00Z,ST THOMAS VI,0,0,6,14,20
Tropical Storm,Debby,4,2000-08-20T15:00:00Z,TKPK 173N 627W,0,1,19,3,23
Tropical Storm,Debby,4,2000-08-20T15:00:00Z,SAN JUAN PR,0,0,2,17,19
Tropical Storm,Debby,4,2000-08-20T15:00:00Z,TNCM 181N 631W,0,0,17,5,22
Tropical Storm,Debby,4,2000-08-20T15:00:00Z,PONCE PR,0,0,1,18,19
Tropical Storm,Debby,4,2000-08-20T15:00:00Z,TISX 177N 648W,0,0,8,12,20
Tropical Storm,Debby,5,2000-08-20T21:00:00Z,16.9N  57.0W,56,2,0,0,58
Tropical Storm,Debby,5,2000-08-20T21:00:00Z,MTPP 186N 724W,0,0,0,13,13
Tropical Storm,Debby,5,2000-08-20T21:00:00Z,17.5N  60.5W,0,34,1,0,35
Tropical Storm,Debby,5,2000-08-20T21:00:00Z,MTCA 183N 738W,0,0,0,9,9
Tropical Storm,Debby,5,2000-08-20T21:00:00Z,18.0N  64.0W,0,3,22,1,26
Tropical Storm,Debby,5,2000-08-20T21:00:00Z,MKJP 179N 768W,0,0,0,2,2
Tropical Storm,Debby,5,2000-08-20T21:00:00Z,TLPL 138N 610W,0,2,2,0,4
Tropical Storm,Debby,5,2000-08-20T21:00:00Z,MUGM 200N 751W,0,0,0,7,7
Tropical Storm,Debby,5,2000-08-20T21:00:00Z,TFFF 146N 610W,0,7,4,0,11
Tropical Storm,Debby,5,2000-08-20T21:00:00Z,TJSJ 184N 661W,0,0,16,7,23
Tropical Storm,Debby,5,2000-08-20T21:00:00Z,TDPR 153N 614W,0,12,5,1,18
Tropical Storm,Debby,5,2000-08-20T21:00:00Z,MDPP 198N 707W,0,0,0,18,18
Tropical Storm,Debby,5,2000-08-20T21:00:00Z,TFFR 163N 615W,0,21,5,0,26
Tropical Storm,Debby,5,2000-08-20T21:00:00Z,MBJT 215N 712W,0,0,0,17,17
Tropical Storm,Debby,5,2000-08-20T21:00:00Z,TAPA 171N 618W,0,22,7,1,30
Tropical Storm,Debby,5,2000-08-20T21:00:00Z,MYMM 224N 730W,0,0,0,12,12
Tropical Storm,Debby,5,2000-08-20T21:00:00Z,TKPK 173N 627W,0,13,14,1,28
Tropical Storm,Debby,5,2000-08-20T21:00:00Z,MYSM 241N 745W,0,0,0,5,5
Tropical Storm,Debby,5,2000-08-20T21:00:00Z,TNCM 181N 631W,0,9,18,1,28
Tropical Storm,Debby,5,2000-08-20T21:00:00Z,MYEG 235N 758W,0,0,0,4,4
Tropical Storm,Debby,5,2000-08-20T21:00:00Z,TISX 177N 648W,0,1,21,2,24
Tropical Storm,Debby,5,2000-08-20T21:00:00Z,ST CROIX VI,0,1,21,2,24
Tropical Storm,Debby,5,2000-08-20T21:00:00Z,TIST 183N 650W,0,1,20,3,24
Tropical Storm,Debby,5,2000-08-20T21:00:00Z,ST THOMAS VI,0,1,20,3,24
Tropical Storm,Debby,5,2000-08-20T21:00:00Z,TJPS 180N 666W,0,0,13,8,21
Tropical Storm,Debby,5,2000-08-20T21:00:00Z,SAN JUAN PR,0,0,16,7,23
Tropical Storm,Debby,5,2000-08-20T21:00:00Z,MDSD 185N 697W,0,0,1,17,18
Tropical Storm,Debby,5,2000-08-20T21:00:00Z,PONCE PR,0,0,13,8,21
Tropical Storm,Debby,5,2000-08-20T21:00:00Z,MDCB 176N 714W,0,0,0,13,13
Tropical Storm,Debby,6,2000-08-21T03:00:00Z,17.0N  59.0W,57,1,0,0,58
Tropical Storm,Debby,6,2000-08-21T03:00:00Z,MTCA 183N 738W,0,0,0,11,11
Tropical Storm,Debby,6,2000-08-21T03:00:00Z,17.6N  62.5W,0,34,1,0,35
Tropical Storm,Debby,6,2000-08-21T03:00:00Z,MKJP 179N 768W,0,0,0,3,3
Tropical Storm,Debby,6,2000-08-21T03:00:00Z,18.6N  65.8W,0,3,22,0,25
Tropical Storm,Debby,6,2000-08-21T03:00:00Z,MKJS 185N 779W,0,0,0,2,2
Tropical Storm,Debby,6,2000-08-21T03:00:00Z,TLPL 138N 610W,0,3,0,0,3
Tropical Storm,Debby,6,2000-08-21T03:00:00Z,MUGM 200N 751W,0,0,0,11,11
Tropical Storm,Debby,6,2000-08-21T03:00:00Z,TFFF 146N 610W,1,10,1,0,12
Tropical Storm,Debby,6,2000-08-21T03:00:00Z,MUCM 214N 779W,0,0,0,3,3
Tropical Storm,Debby,6,2000-08-21T03:00:00Z,TDPR 153N 614W,1,21,0,1,23
Tropical Storm,Debby,6,2000-08-21T03:00:00Z,TJSJ 184N 661W,0,3,21,1,25
Tropical Storm,Debby,6,2000-08-21T03:00:00Z,TFFR 163N 615W,3,31,0,0,34
Tropical Storm,Debby,6,2000-08-21T03:00:00Z,MDPP 198N 707W,0,0,2,17,19
Tropical Storm,Debby,6,2000-08-21T03:00:00Z,TAPA 171N 618W,1,37,0,0,38
Tropical Storm,Debby,6,2000-08-21T03:00:00Z,MBJT 215N 712W,0,0,0,17,17
Tropical Storm,Debby,6,2000-08-21T03:00:00Z,TKPK 173N 627W,0,33,1,0,34
Tropical Storm,Debby,6,2000-08-21T03:00:00Z,MYMM 224N 730W,0,0,0,14,14
Tropical Storm,Debby,6,2000-08-21T03:00:00Z,TNCM 181N 631W,0,29,3,0,32
Tropical Storm,Debby,6,2000-08-21T03:00:00Z,MYSM 241N 745W,0,0,0,7,7
Tropical Storm,Debby,6,2000-08-21T03:00:00Z,TISX 177N 648W,0,13,15,0,28
Tropical Storm,Debby,6,2000-08-21T03:00:00Z,MYEG 235N 758W,0,0,0,6,6
Tropical Storm,Debby,6,2000-08-21T03:00:00Z,TIST 183N 650W,0,9,18,0,27
Tropical Storm,Debby,6,2000-08-21T03:00:00Z,MYAK 241N 776W,0,0,0,2,2
Tropical Storm,Debby,6,2000-08-21T03:00:00Z,TJPS 180N 666W,0,1,21,1,23
Tropical Storm,Debby,6,2000-08-21T03:00:00Z,ST CROIX VI,0,13,15,0,28
Tropical Storm,Debby,6,2000-08-21T03:00:00Z,MDSD 185N 697W,0,0,6,13,19
Tropical Storm,Debby,6,2000-08-21T03:00:00Z,ST THOMAS VI,0,9,18,0,27
Tropical Storm,Debby,6,2000-08-21T03:00:00Z,MDCB 176N 714W,0,0,1,13,14
Tropical Storm,Debby,6,2000-08-21T03:00:00Z,SAN JUAN PR,0,3,21,1,25
Tropical Storm,Debby,6,2000-08-21T03:00:00Z,MTPP 186N 724W,0,0,0,15,15
Tropical Storm,Debby,6,2000-08-21T03:00:00Z,PONCE PR,0,1,21,1,23
Tropical Storm,Debby,7,2000-08-21T09:00:00Z,16.9N  60.4W,56,0,0,1,57
Tropical Storm,Debby,7,2000-08-21T09:00:00Z,MKJP 179N 768W,0,0,0,5,5
Tropical Storm,Debby,7,2000-08-21T09:00:00Z,17.7N  63.6W,0,32,0,0,32
Tropical Storm,Debby,7,2000-08-21T09:00:00Z,MKJS 185N 779W,0,0,0,3,3
Tropical Storm,Debby,7,2000-08-21T09:00:00Z,18.5N  66.5W,0,6,17,0,23
Tropical Storm,Debby,7,2000-08-21T09:00:00Z,MUGM 200N 751W,0,0,0,12,12
Tropical Storm,Debby,7,2000-08-21T09:00:00Z,TLPL 138N 610W,2,2,0,0,4
Tropical Storm,Debby,7,2000-08-21T09:00:00Z,MUCM 214N 779W,0,0,0,4,4
Tropical Storm,Debby,7,2000-08-21T09:00:00Z,TFFF 146N 610W,11,5,0,0,16
Tropical Storm,Debby,7,2000-08-21T09:00:00Z,TJSJ 184N 661W,0,9,15,0,24
Tropical Storm,Debby,7,2000-08-21T09:00:00Z,TDPR 153N 614W,21,9,0,0,30
Tropical Storm,Debby,7,2000-08-21T09:00:00Z,MDPP 198N 707W,0,0,4,15,19
Tropical Storm,Debby,7,2000-08-21T09:00:00Z,TFFR 163N 615W,33,10,0,0,43
Tropical Storm,Debby,7,2000-08-21T09:00:00Z,MBJT 215N 712W,0,0,1,16,17
Tropical Storm,Debby,7,2000-08-21T09:00:00Z,TAPA 171N 618W,22,21,0,0,43
Tropical Storm,Debby,7,2000-08-21T09:00:00Z,MYMM 224N 730W,0,0,0,14,14
Tropical Storm,Debby,7,2000-08-21T09:00:00Z,TKPK 173N 627W,3,33,0,1,37
Tropical Storm,Debby,7,2000-08-21T09:00:00Z,MYSM 241N 745W,0,0,0,8,8
Tropical Storm,Debby,7,2000-08-21T09:00:00Z,TNCM 181N 631W,0,33,0,0,33
Tropical Storm,Debby,7,2000-08-21T09:00:00Z,MYEG 235N 758W,0,0,0,7,7
Tropical Storm,Debby,7,2000-08-21T09:00:00Z,TISX 177N 648W,0,23,4,0,27
Tropical Storm,Debby,7,2000-08-21T09:00:00Z,MYAK 241N 776W,0,0,0,3,3
Tropical Storm,Debby,7,2000-08-21T09:00:00Z,TIST 183N 650W,0,20,7,0,27
Tropical Storm,Debby,7,2000-08-21T09:00:00Z,MYNN 251N 775W,0,0,0,2,2
Tropical Storm,Debby,7,2000-08-21T09:00:00Z,TJPS 180N 666W,0,6,16,1,23
Tropical Storm,Debby,7,2000-08-21T09:00:00Z,ST CROIX VI,0,23,4,0,27
Tropical Storm,Debby,7,2000-08-21T09:00:00Z,MDSD 185N 697W,0,0,9,10,19
Tropical Storm,Debby,7,2000-08-21T09:00:00Z,ST THOMAS VI,0,20,7,0,27
Tropical Storm,Debby,7,2000-08-21T09:00:00Z,MDCB 176N 714W,0,0,2,13,15
Tropical Storm,Debby,7,2000-08-21T09:00:00Z,SAN JUAN PR,0,9,15,0,24
Tropical Storm,Debby,7,2000-08-21T09:00:00Z,MTPP 186N 724W,0,0,1,15,16
Tropical Storm,Debby,7,2000-08-21T09:00:00Z,PONCE PR,0,6,16,1,23
Tropical Storm,Debby,7,2000-08-21T09:00:00Z,MTCA 183N 738W,0,0,0,13,13
Tropical Storm,Debby,8,2000-08-21T15:00:00Z,17.0N  63.8W,49,2,0,0,51
Tropical Storm,Debby,8,2000-08-21T15:00:00Z,MKJS 185N 779W,0,0,0,10,10
Tropical Storm,Debby,8,2000-08-21T15:00:00Z,18.0N  67.2W,0,32,1,0,33
Tropical Storm,Debby,8,2000-08-21T15:00:00Z,MWCG 193N 814W,0,0,0,2,2
Tropical Storm,Debby,8,2000-08-21T15:00:00Z,19.0N  70.0W,0,6,18,1,25
Tropical Storm,Debby,8,2000-08-21T15:00:00Z,MUGM 200N 751W,0,0,1,16,17
Tropical Storm,Debby,8,2000-08-21T15:00:00Z,TBPB 131N 595W,2,0,0,0,2
Tropical Storm,Debby,8,2000-08-21T15:00:00Z,MUCM 214N 779W,0,0,0,12,12
Tropical Storm,Debby,8,2000-08-21T15:00:00Z,TVSV 131N 612W,3,0,0,0,3
Tropical Storm,Debby,8,2000-08-21T15:00:00Z,MUCF 221N 805W,0,0,0,5,5
Tropical Storm,Debby,8,2000-08-21T15:00:00Z,TLPL 138N 610W,15,0,0,0,15
Tropical Storm,Debby,8,2000-08-21T15:00:00Z,TJSJ 184N 661W,1,34,0,0,35
Tropical Storm,Debby,8,2000-08-21T15:00:00Z,TFFF 146N 610W,44,0,0,0,44
Tropical Storm,Debby,8,2000-08-21T15:00:00Z,MDPP 198N 707W,0,1,20,2,23
Tropical Storm,Debby,8,2000-08-21T15:00:00Z,TDPR 153N 614W,60,0,0,0,60
Tropical Storm,Debby,8,2000-08-21T15:00:00Z,MBJT 215N 712W,0,0,12,7,19
Tropical Storm,Debby,8,2000-08-21T15:00:00Z,TFFR 163N 615W,69,0,0,0,69
Tropical Storm,Debby,8,2000-08-21T15:00:00Z,MYMM 224N 730W,0,0,3,14,17
Tropical Storm,Debby,8,2000-08-21T15:00:00Z,TAPA 171N 618W,62,0,0,0,62
Tropical Storm,Debby,8,2000-08-21T15:00:00Z,MYSM 241N 745W,0,0,0,12,12
Tropical Storm,Debby,8,2000-08-21T15:00:00Z,TKPK 173N 627W,55,0,0,0,55
Tropical Storm,Debby,8,2000-08-21T15:00:00Z,MYEG 235N 758W,0,0,0,13,13
Tropical Storm,Debby,8,2000-08-21T15:00:00Z,TNCM 181N 631W,44,2,0,0,46
Tropical Storm,Debby,8,2000-08-21T15:00:00Z,MYAK 241N 776W,0,0,0,10,10
Tropical Storm,Debby,8,2000-08-21T15:00:00Z,TISX 177N 648W,22,21,0,0,43
Tropical Storm,Debby,8,2000-08-21T15:00:00Z,MYNN 251N 775W,0,0,0,8,8
Tropical Storm,Debby,8,2000-08-21T15:00:00Z,TIST 183N 650W,11,28,0,0,39
Tropical Storm,Debby,8,2000-08-21T15:00:00Z,MYGF 266N 787W,0,0,0,3,3
Tropical Storm,Debby,8,2000-08-21T15:00:00Z,TJPS 180N 666W,0,35,0,0,35
Tropical Storm,Debby,8,2000-08-21T15:00:00Z,ST CROIX VI,22,21,0,0,43
Tropical Storm,Debby,8,2000-08-21T15:00:00Z,MDSD 185N 697W,0,9,16,0,25
Tropical Storm,Debby,8,2000-08-21T15:00:00Z,ST THOMAS VI,11,28,0,0,39
Tropical Storm,Debby,8,2000-08-21T15:00:00Z,MDCB 176N 714W,0,1,16,3,20
Tropical Storm,Debby,8,2000-08-21T15:00:00Z,SAN JUAN PR,1,34,0,0,35
Tropical Storm,Debby,8,2000-08-21T15:00:00Z,MTPP 186N 724W,0,0,14,6,20
Tropical Storm,Debby,8,2000-08-21T15:00:00Z,PONCE PR,0,35,0,0,35
Tropical Storm,Debby,8,2000-08-21T15:00:00Z,MTCA 183N 738W,0,0,6,12,18
Tropical Storm,Debby,8,2000-08-21T15:00:00Z,MARATHON FL,0,0,0,2,2
Tropical Storm,Debby,8,2000-08-21T15:00:00Z,MKJP 179N 768W,0,0,0,11,11
Tropical Storm,Debby,8,2000-08-21T15:00:00Z,MIAMI FL,0,0,0,2,2
Tropical Storm,Debby,9,2000-08-21T21:00:00Z,17.8N  65.7W,54,1,0,0,55
Tropical Storm,Debby,9,2000-08-21T21:00:00Z,MUHA 230N 824W,0,0,0,4,4
Tropical Storm,Debby,9,2000-08-21T21:00:00Z,18.8N  68.8W,0,32,0,0,32
Tropical Storm,Debby,9,2000-08-21T21:00:00Z,TJSJ 184N 661W,43,6,0,0,49
Tropical Storm,Debby,9,2000-08-21T21:00:00Z,20.0N  71.5W,0,7,15,1,23
Tropical Storm,Debby,9,2000-08-21T21:00:00Z,MDPP 198N 707W,0,14,10,1,25
Tropical Storm,Debby,9,2000-08-21T21:00:00Z,TFFF 146N 610W,8,0,0,0,8
Tropical Storm,Debby,9,2000-08-21T21:00:00Z,MBJT 215N 712W,0,3,16,2,21
Tropical Storm,Debby,9,2000-08-21T21:00:00Z,TDPR 153N 614W,50,0,0,0,50
Tropical Storm,Debby,9,2000-08-21T21:00:00Z,MYMM 224N 730W,0,0,11,7,18
Tropical Storm,Debby,9,2000-08-21T21:00:00Z,TFFR 163N 615W,90,0,0,0,90
Tropical Storm,Debby,9,2000-08-21T21:00:00Z,MYSM 241N 745W,0,0,2,13,15
Tropical Storm,Debby,9,2000-08-21T21:00:00Z,TAPA 171N 618W,85,0,0,0,85
Tropical Storm,Debby,9,2000-08-21T21:00:00Z,MYEG 235N 758W,0,0,1,15,16
Tropical Storm,Debby,9,2000-08-21T21:00:00Z,TKPK 173N 627W,78,0,0,0,78
Tropical Storm,Debby,9,2000-08-21T21:00:00Z,MYAK 241N 776W,0,0,0,14,14
Tropical Storm,Debby,9,2000-08-21T21:00:00Z,TNCM 181N 631W,64,0,0,0,64
Tropical Storm,Debby,9,2000-08-21T21:00:00Z,MYNN 251N 775W,0,0,0,12,12
Tropical Storm,Debby,9,2000-08-21T21:00:00Z,TISX 177N 648W,63,0,0,0,63
Tropical Storm,Debby,9,2000-08-21T21:00:00Z,MYGF 266N 787W,0,0,0,8,8
Tropical Storm,Debby,9,2000-08-21T21:00:00Z,TIST 183N 650W,56,1,0,0,57
Tropical Storm,Debby,9,2000-08-21T21:00:00Z,ST CROIX VI,63,0,0,0,63
Tropical Storm,Debby,9,2000-08-21T21:00:00Z,TJPS 180N 666W,34,13,0,0,47
Tropical Storm,Debby,9,2000-08-21T21:00:00Z,ST THOMAS VI,56,1,0,0,57
Tropical Storm,Debby,9,2000-08-21T21:00:00Z,MDSD 185N 697W,0,26,2,0,28
Tropical Storm,Debby,9,2000-08-21T21:00:00Z,SAN JUAN PR,43,6,0,0,49
Tropical Storm,Debby,9,2000-08-21T21:00:00Z,MDCB 176N 714W,0,9,9,1,19
Tropical Storm,Debby,9,2000-08-21T21:00:00Z,PONCE PR,34,13,0,0,47
Tropical Storm,Debby,9,2000-08-21T21:00:00Z,MTPP 186N 724W,0,3,15,2,20
Tropical Storm,Debby,9,2000-08-21T21:00:00Z,MARATHON FL,0,0,0,7,7
Tropical Storm,Debby,9,2000-08-21T21:00:00Z,MTCA 183N 738W,0,0,12,5,17
Tropical Storm,Debby,9,2000-08-21T21:00:00Z,MIAMI FL,0,0,0,7,7
Tropical Storm,Debby,9,2000-08-21T21:00:00Z,MKJP 179N 768W,0,0,1,10,11
Tropical Storm,Debby,9,2000-08-21T21:00:00Z,W PALM BEACH FL,0,0,0,5,5
Tropical Storm,Debby,9,2000-08-21T21:00:00Z,MKJS 185N 779W,0,0,0,10,10
Tropical Storm,Debby,9,2000-08-21T21:00:00Z,FT PIERCE FL,0,0,0,4,4
Tropical Storm,Debby,9,2000-08-21T21:00:00Z,MWCG 193N 814W,0,0,0,5,5
Tropical Storm,Debby,9,2000-08-21T21:00:00Z,COCOA BEACH FL,0,0,0,2,2
Tropical Storm,Debby,9,2000-08-21T21:00:00Z,MUGM 200N 751W,0,0,7,11,18
Tropical Storm,Debby,9,2000-08-21T21:00:00Z,KEY WEST FL,0,0,0,5,5
Tropical Storm,Debby,9,2000-08-21T21:00:00Z,MUCM 214N 779W,0,0,0,15,15
Tropical Storm,Debby,9,2000-08-21T21:00:00Z,MARCO ISLAND FL,0,0,0,4,4
Tropical Storm,Debby,9,2000-08-21T21:00:00Z,MUCF 221N 805W,0,0,0,9,9
Tropical Storm,Debby,9,2000-08-21T21:00:00Z,FT MYERS FL,0,0,0,3,3
Tropical Storm,Debby,9,2000-08-21T21:00:00Z,MUSN 216N 826W,0,0,0,4,4
Tropical Storm,Debby,9,2000-08-21T21:00:00Z,VENICE FL,0,0,0,2,2
Tropical Storm,Debby,10,2000-08-22T03:00:00Z,18.7N  67.6W,58,1,0,0,59
Tropical Storm,Debby,10,2000-08-22T03:00:00Z,MDPP 198N 707W,0,34,1,0,35
Tropical Storm,Debby,10,2000-08-22T03:00:00Z,19.4N  70.8W,0,35,0,0,35
Tropical Storm,Debby,10,2000-08-22T03:00:00Z,MBJT 215N 712W,0,19,5,0,24
Tropical Storm,Debby,10,2000-08-22T03:00:00Z,20.6N  73.7W,0,6,19,0,25
Tropical Storm,Debby,10,2000-08-22T03:00:00Z,MYMM 224N 730W,0,3,16,2,21
Tropical Storm,Debby,10,2000-08-22T03:00:00Z,TDPR 153N 614W,11,0,0,0,11
Tropical Storm,Debby,10,2000-08-22T03:00:00Z,MYSM 241N 745W,0,0,8,8,16
Tropical Storm,Debby,10,2000-08-22T03:00:00Z,TFFR 163N 615W,99,0,0,0,99
Tropical Storm,Debby,10,2000-08-22T03:00:00Z,MYEG 235N 758W,0,0,7,11,18
Tropical Storm,Debby,10,2000-08-22T03:00:00Z,TAPA 171N 618W,99,0,0,0,99
Tropical Storm,Debby,10,2000-08-22T03:00:00Z,MYAK 241N 776W,0,0,2,14,16
Tropical Storm,Debby,10,2000-08-22T03:00:00Z,TKPK 173N 627W,98,0,0,0,98
Tropical Storm,Debby,10,2000-08-22T03:00:00Z,MYNN 251N 775W,0,0,1,13,14
Tropical Storm,Debby,10,2000-08-22T03:00:00Z,TNCM 181N 631W,94,0,0,0,94
Tropical Storm,Debby,10,2000-08-22T03:00:00Z,MYGF 266N 787W,0,0,0,11,11
Tropical Storm,Debby,10,2000-08-22T03:00:00Z,TISX 177N 648W,84,0,0,0,84
Tropical Storm,Debby,10,2000-08-22T03:00:00Z,ST CROIX VI,84,0,0,0,84
Tropical Storm,Debby,10,2000-08-22T03:00:00Z,TIST 183N 650W,83,0,0,0,83
Tropical Storm,Debby,10,2000-08-22T03:00:00Z,ST THOMAS VI,83,0,0,0,83
Tropical Storm,Debby,10,2000-08-22T03:00:00Z,TJPS 180N 666W,66,0,0,0,66
Tropical Storm,Debby,10,2000-08-22T03:00:00Z,SAN JUAN PR,74,0,0,0,74
Tropical Storm,Debby,10,2000-08-22T03:00:00Z,MDSD 185N 697W,5,35,0,0,40
Tropical Storm,Debby,10,2000-08-22T03:00:00Z,PONCE PR,66,0,0,0,66
Tropical Storm,Debby,10,2000-08-22T03:00:00Z,MDCB 176N 714W,0,24,2,0,26
Tropical Storm,Debby,10,2000-08-22T03:00:00Z,MARATHON FL,0,0,0,11,11
Tropical Storm,Debby,10,2000-08-22T03:00:00Z,MTPP 186N 724W,0,21,6,0,27
Tropical Storm,Debby,10,2000-08-22T03:00:00Z,MIAMI FL,0,0,0,11,11
Tropical Storm,Debby,10,2000-08-22T03:00:00Z,MTCA 183N 738W,0,6,15,1,22
Tropical Storm,Debby,10,2000-08-22T03:00:00Z,W PALM BEACH FL,0,0,0,9,9
Tropical Storm,Debby,10,2000-08-22T03:00:00Z,MKJP 179N 768W,0,0,6,7,13
Tropical Storm,Debby,10,2000-08-22T03:00:00Z,FT PIERCE FL,0,0,0,7,7
Tropical Storm,Debby,10,2000-08-22T03:00:00Z,MKJS 185N 779W,0,0,3,10,13
Tropical Storm,Debby,10,2000-08-22T03:00:00Z,COCOA BEACH FL,0,0,0,5,5
Tropical Storm,Debby,10,2000-08-22T03:00:00Z,MWCG 193N 814W,0,0,0,8,8
Tropical Storm,Debby,10,2000-08-22T03:00:00Z,DAYTONA BEACH FL,0,0,0,3,3
Tropical Storm,Debby,10,2000-08-22T03:00:00Z,MUGM 200N 751W,0,1,18,3,22
Tropical Storm,Debby,10,2000-08-22T03:00:00Z,KEY WEST FL,0,0,0,10,10
Tropical Storm,Debby,10,2000-08-22T03:00:00Z,MUCM 214N 779W,0,0,4,14,18
Tropical Storm,Debby,10,2000-08-22T03:00:00Z,MARCO ISLAND FL,0,0,0,8,8
Tropical Storm,Debby,10,2000-08-22T03:00:00Z,MUCF 221N 805W,0,0,0,13,13
Tropical Storm,Debby,10,2000-08-22T03:00:00Z,FT MYERS FL,0,0,0,7,7
Tropical Storm,Debby,10,2000-08-22T03:00:00Z,MUSN 216N 826W,0,0,0,7,7
Tropical Storm,Debby,10,2000-08-22T03:00:00Z,VENICE FL,0,0,0,5,5
Tropical Storm,Debby,10,2000-08-22T03:00:00Z,MUHA 230N 824W,0,0,0,8,8
Tropical Storm,Debby,10,2000-08-22T03:00:00Z,TAMPA FL,0,0,0,3,3
Tropical Storm,Debby,10,2000-08-22T03:00:00Z,MUAN 219N 850W,0,0,0,2,2
Tropical Storm,Debby,10,2000-08-22T03:00:00Z,CEDAR KEY FL,0,0,0,2,2
Tropical Storm,Debby,10,2000-08-22T03:00:00Z,TJSJ 184N 661W,74,0,0,0,74
Hurricane,Debby,11,2000-08-22T09:00:00Z,19.4N  68.7W,59,0,0,0,59
Hurricane,Debby,11,2000-08-22T09:00:00Z,MBJT 215N 712W,0,32,0,0,32
Hurricane,Debby,11,2000-08-22T09:00:00Z,20.4N  71.9W,0,35,0,0,35
Hurricane,Debby,11,2000-08-22T09:00:00Z,MYMM 224N 730W,0,15,8,1,24
Hurricane,Debby,11,2000-08-22T09:00:00Z,21.5N  74.5W,0,8,16,1,25
Hurricane,Debby,11,2000-08-22T09:00:00Z,MYSM 241N 745W,0,1,13,4,18
Hurricane,Debby,11,2000-08-22T09:00:00Z,TFFR 163N 615W,38,0,0,0,38
Hurricane,Debby,11,2000-08-22T09:00:00Z,MYEG 235N 758W,0,0,14,6,20
Hurricane,Debby,11,2000-08-22T09:00:00Z,TAPA 171N 618W,99,0,0,0,99
Hurricane,Debby,11,2000-08-22T09:00:00Z,MYAK 241N 776W,0,0,5,13,18
Hurricane,Debby,11,2000-08-22T09:00:00Z,TKPK 173N 627W,99,0,0,0,99
Hurricane,Debby,11,2000-08-22T09:00:00Z,MYNN 251N 775W,0,0,3,13,16
Hurricane,Debby,11,2000-08-22T09:00:00Z,TNCM 181N 631W,99,0,0,0,99
Hurricane,Debby,11,2000-08-22T09:00:00Z,MYGF 266N 787W,0,0,0,12,12
Hurricane,Debby,11,2000-08-22T09:00:00Z,TISX 177N 648W,91,0,0,0,91
Hurricane,Debby,11,2000-08-22T09:00:00Z,ST CROIX VI,91,0,0,0,91
Hurricane,Debby,11,2000-08-22T09:00:00Z,TIST 183N 650W,93,0,0,0,93
Hurricane,Debby,11,2000-08-22T09:00:00Z,ST THOMAS VI,93,0,0,0,93
Hurricane,Debby,11,2000-08-22T09:00:00Z,TJPS 180N 666W,73,0,0,0,73
Hurricane,Debby,11,2000-08-22T09:00:00Z,SAN JUAN PR,87,0,0,0,87
Hurricane,Debby,11,2000-08-22T09:00:00Z,MDSD 185N 697W,32,12,0,0,44
Hurricane,Debby,11,2000-08-22T09:00:00Z,PONCE PR,73,0,0,0,73
Hurricane,Debby,11,2000-08-22T09:00:00Z,MDCB 176N 714W,1,22,0,0,23
Hurricane,Debby,11,2000-08-22T09:00:00Z,MARATHON FL,0,0,0,12,12
Hurricane,Debby,11,2000-08-22T09:00:00Z,MTPP 186N 724W,0,26,1,0,27
Hurricane,Debby,11,2000-08-22T09:00:00Z,MIAMI FL,0,0,0,12,12
Hurricane,Debby,11,2000-08-22T09:00:00Z,MTCA 183N 738W,0,12,7,1,20
Hurricane,Debby,11,2000-08-22T09:00:00Z,W PALM BEACH FL,0,0,0,11,11
Hurricane,Debby,11,2000-08-22T09:00:00Z,MKJP 179N 768W,0,0,7,5,12
Hurricane,Debby,11,2000-08-22T09:00:00Z,FT PIERCE FL,0,0,0,9,9
Hurricane,Debby,11,2000-08-22T09:00:00Z,MKJS 185N 779W,0,0,5,7,12
Hurricane,Debby,11,2000-08-22T09:00:00Z,COCOA BEACH FL,0,0,0,7,7
Hurricane,Debby,11,2000-08-22T09:00:00Z,MWCG 193N 814W,0,0,0,8,8
Hurricane,Debby,11,2000-08-22T09:00:00Z,DAYTONA BEACH FL,0,0,0,5,5
Hurricane,Debby,11,2000-08-22T09:00:00Z,MUGM 200N 751W,0,5,16,1,22
Hurricane,Debby,11,2000-08-22T09:00:00Z,JACKSONVILLE FL,0,0,0,2,2
Hurricane,Debby,11,2000-08-22T09:00:00Z,MUCM 214N 779W,0,0,9,10,19
Hurricane,Debby,11,2000-08-22T09:00:00Z,KEY WEST FL,0,0,0,11,11
Hurricane,Debby,11,2000-08-22T09:00:00Z,MUCF 221N 805W,0,0,1,13,14
Hurricane,Debby,11,2000-08-22T09:00:00Z,MARCO ISLAND FL,0,0,0,10,10
Hurricane,Debby,11,2000-08-22T09:00:00Z,MUSN 216N 826W,0,0,0,8,8
Hurricane,Debby,11,2000-08-22T09:00:00Z,FT MYERS FL,0,0,0,8,8
Hurricane,Debby,11,2000-08-22T09:00:00Z,MUHA 230N 824W,0,0,0,10,10
Hurricane,Debby,11,2000-08-22T09:00:00Z,VENICE FL,0,0,0,6,6
Hurricane,Debby,11,2000-08-22T09:00:00Z,MUAN 219N 850W,0,0,0,3,3
Hurricane,Debby,11,2000-08-22T09:00:00Z,TAMPA FL,0,0,0,5,5
Hurricane,Debby,11,2000-08-22T09:00:00Z,TJSJ 184N 661W,87,0,0,0,87
Hurricane,Debby,11,2000-08-22T09:00:00Z,CEDAR KEY FL,0,0,0,3,3
Hurricane,Debby,11,2000-08-22T09:00:00Z,MDPP 198N 707W,6,37,0,0,43
Hurricane,Debby,12,2000-08-22T15:00:00Z,20.3N  70.3W,57,2,0,0,59
Hurricane,Debby,12,2000-08-22T15:00:00Z,MYEG 235N 758W,0,3,21,1,25
Hurricane,Debby,12,2000-08-22T15:00:00Z,21.5N  73.2W,1,39,0,0,40
Hurricane,Debby,12,2000-08-22T15:00:00Z,MYAK 241N 776W,0,0,13,8,21
Hurricane,Debby,12,2000-08-22T15:00:00Z,22.5N  75.5W,0,9,19,1,29
Hurricane,Debby,12,2000-08-22T15:00:00Z,MYNN 251N 775W,0,0,8,11,19
Hurricane,Debby,12,2000-08-22T15:00:00Z,TNCM 181N 631W,99,0,0,0,99
Hurricane,Debby,12,2000-08-22T15:00:00Z,MYGF 266N 787W,0,0,1,14,15
Hurricane,Debby,12,2000-08-22T15:00:00Z,TISX 177N 648W,99,0,0,0,99
Hurricane,Debby,12,2000-08-22T15:00:00Z,ST CROIX VI,99,0,0,0,99
Hurricane,Debby,12,2000-08-22T15:00:00Z,TIST 183N 650W,99,0,0,0,99
Hurricane,Debby,12,2000-08-22T15:00:00Z,ST THOMAS VI,99,0,0,0,99
Hurricane,Debby,12,2000-08-22T15:00:00Z,TJPS 180N 666W,58,0,0,0,58
Hurricane,Debby,12,2000-08-22T15:00:00Z,SAN JUAN PR,81,0,0,0,81
Hurricane,Debby,12,2000-08-22T15:00:00Z,MDSD 185N 697W,35,1,0,0,36
Hurricane,Debby,12,2000-08-22T15:00:00Z,PONCE PR,58,0,0,0,58
Hurricane,Debby,12,2000-08-22T15:00:00Z,MDCB 176N 714W,2,3,0,1,6
Hurricane,Debby,12,2000-08-22T15:00:00Z,MARATHON FL,0,0,0,14,14
Hurricane,Debby,12,2000-08-22T15:00:00Z,MTPP 186N 724W,3,16,0,0,19
Hurricane,Debby,12,2000-08-22T15:00:00Z,MIAMI FL,0,0,0,15,15
Hurricane,Debby,12,2000-08-22T15:00:00Z,MTCA 183N 738W,0,7,2,1,10
Hurricane,Debby,12,2000-08-22T15:00:00Z,W PALM BEACH FL,0,0,0,13,13
Hurricane,Debby,12,2000-08-22T15:00:00Z,MKJP 179N 768W,0,0,2,3,5
Hurricane,Debby,12,2000-08-22T15:00:00Z,FT PIERCE FL,0,0,0,11,11
Hurricane,Debby,12,2000-08-22T15:00:00Z,MKJS 185N 779W,0,0,2,4,6
Hurricane,Debby,12,2000-08-22T15:00:00Z,COCOA BEACH FL,0,0,0,9,9
Hurricane,Debby,12,2000-08-22T15:00:00Z,MWCG 193N 814W,0,0,0,4,4
Hurricane,Debby,12,2000-08-22T15:00:00Z,DAYTONA BEACH FL,0,0,0,7,7
Hurricane,Debby,12,2000-08-22T15:00:00Z,MUGM 200N 751W,0,13,8,1,22
Hurricane,Debby,12,2000-08-22T15:00:00Z,JACKSONVILLE FL,0,0,0,3,3
Hurricane,Debby,12,2000-08-22T15:00:00Z,MUCM 214N 779W,0,0,14,5,19
Hurricane,Debby,12,2000-08-22T15:00:00Z,KEY WEST FL,0,0,0,12,12
Hurricane,Debby,12,2000-08-22T15:00:00Z,MUCF 221N 805W,0,0,1,12,13
Hurricane,Debby,12,2000-08-22T15:00:00Z,MARCO ISLAND FL,0,0,0,12,12
Hurricane,Debby,12,2000-08-22T15:00:00Z,MUSN 216N 826W,0,0,0,6,6
Hurricane,Debby,12,2000-08-22T15:00:00Z,FT MYERS FL,0,0,0,11,11
Hurricane,Debby,12,2000-08-22T15:00:00Z,MUHA 230N 824W,0,0,0,9,9
Hurricane,Debby,12,2000-08-22T15:00:00Z,VENICE FL,0,0,0,9,9
Hurricane,Debby,12,2000-08-22T15:00:00Z,MUAN 219N 850W,0,0,0,2,2
Hurricane,Debby,12,2000-08-22T15:00:00Z,TAMPA FL,0,0,0,8,8
Hurricane,Debby,12,2000-08-22T15:00:00Z,TJSJ 184N 661W,81,0,0,0,81
Hurricane,Debby,12,2000-08-22T15:00:00Z,CEDAR KEY FL,0,0,0,5,5
Hurricane,Debby,12,2000-08-22T15:00:00Z,MDPP 198N 707W,48,4,0,0,52
Hurricane,Debby,12,2000-08-22T15:00:00Z,ST MARKS FL,0,0,0,2,2
Hurricane,Debby,12,2000-08-22T15:00:00Z,MBJT 215N 712W,33,15,0,0,48
Hurricane,Debby,12,2000-08-22T15:00:00Z,APALACHICOLA FL,0,0,0,2,2
Hurricane,Debby,12,2000-08-22T15:00:00Z,MYMM 224N 730W,1,35,0,0,36
Hurricane,Debby,12,2000-08-22T15:00:00Z,GULF 29N 85W,0,0,0,2,2
Hurricane,Debby,12,2000-08-22T15:00:00Z,MYSM 241N 745W,0,6,16,1,23
Hurricane,Debby,12,2000-08-22T15:00:00Z,20.3N  70.3W,57,2,0,0,59
Hurricane,Debby,12,2000-08-22T15:00:00Z,MYEG 235N 758W,0,3,21,1,25
Hurricane,Debby,12,2000-08-22T15:00:00Z,21.5N  73.2W,1,39,0,0,40
Hurricane,Debby,12,2000-08-22T15:00:00Z,MYAK 241N 776W,0,0,13,8,21
Hurricane,Debby,12,2000-08-22T15:00:00Z,22.5N  75.5W,0,9,19,1,29
Hurricane,Debby,12,2000-08-22T15:00:00Z,MYNN 251N 775W,0,0,8,11,19
Hurricane,Debby,12,2000-08-22T15:00:00Z,TNCM 181N 631W,99,0,0,0,99
Hurricane,Debby,12,2000-08-22T15:00:00Z,MYGF 266N 787W,0,0,1,14,15
Hurricane,Debby,12,2000-08-22T15:00:00Z,TISX 177N 648W,99,0,0,0,99
Hurricane,Debby,12,2000-08-22T15:00:00Z,ST CROIX VI,99,0,0,0,99
Hurricane,Debby,12,2000-08-22T15:00:00Z,TIST 183N 650W,99,0,0,0,99
Hurricane,Debby,12,2000-08-22T15:00:00Z,ST THOMAS VI,99,0,0,0,99
Hurricane,Debby,12,2000-08-22T15:00:00Z,TJPS 180N 666W,58,0,0,0,58
Hurricane,Debby,12,2000-08-22T15:00:00Z,SAN JUAN PR,81,0,0,0,81
Hurricane,Debby,12,2000-08-22T15:00:00Z,MDSD 185N 697W,35,1,0,0,36
Hurricane,Debby,12,2000-08-22T15:00:00Z,PONCE PR,58,0,0,0,58
Hurricane,Debby,12,2000-08-22T15:00:00Z,MDCB 176N 714W,2,3,0,1,6
Hurricane,Debby,12,2000-08-22T15:00:00Z,MARATHON FL,0,0,0,14,14
Hurricane,Debby,12,2000-08-22T15:00:00Z,MTPP 186N 724W,3,16,0,0,19
Hurricane,Debby,12,2000-08-22T15:00:00Z,MIAMI FL,0,0,0,15,15
Hurricane,Debby,12,2000-08-22T15:00:00Z,MTCA 183N 738W,0,7,2,1,10
Hurricane,Debby,12,2000-08-22T15:00:00Z,W PALM BEACH FL,0,0,0,13,13
Hurricane,Debby,12,2000-08-22T15:00:00Z,MKJP 179N 768W,0,0,2,3,5
Hurricane,Debby,12,2000-08-22T15:00:00Z,FT PIERCE FL,0,0,0,11,11
Hurricane,Debby,12,2000-08-22T15:00:00Z,MKJS 185N 779W,0,0,2,4,6
Hurricane,Debby,12,2000-08-22T15:00:00Z,COCOA BEACH FL,0,0,0,9,9
Hurricane,Debby,12,2000-08-22T15:00:00Z,MWCG 193N 814W,0,0,0,4,4
Hurricane,Debby,12,2000-08-22T15:00:00Z,DAYTONA BEACH FL,0,0,0,7,7
Hurricane,Debby,12,2000-08-22T15:00:00Z,MUGM 200N 751W,0,13,8,1,22
Hurricane,Debby,12,2000-08-22T15:00:00Z,JACKSONVILLE FL,0,0,0,3,3
Hurricane,Debby,12,2000-08-22T15:00:00Z,MUCM 214N 779W,0,0,14,5,19
Hurricane,Debby,12,2000-08-22T15:00:00Z,KEY WEST FL,0,0,0,12,12
Hurricane,Debby,12,2000-08-22T15:00:00Z,MUCF 221N 805W,0,0,1,12,13
Hurricane,Debby,12,2000-08-22T15:00:00Z,MARCO ISLAND FL,0,0,0,12,12
Hurricane,Debby,12,2000-08-22T15:00:00Z,MUSN 216N 826W,0,0,0,6,6
Hurricane,Debby,12,2000-08-22T15:00:00Z,FT MYERS FL,0,0,0,11,11
Hurricane,Debby,12,2000-08-22T15:00:00Z,MUHA 230N 824W,0,0,0,9,9
Hurricane,Debby,12,2000-08-22T15:00:00Z,VENICE FL,0,0,0,9,9
Hurricane,Debby,12,2000-08-22T15:00:00Z,MUAN 219N 850W,0,0,0,2,2
Hurricane,Debby,12,2000-08-22T15:00:00Z,TAMPA FL,0,0,0,8,8
Hurricane,Debby,12,2000-08-22T15:00:00Z,TJSJ 184N 661W,81,0,0,0,81
Hurricane,Debby,12,2000-08-22T15:00:00Z,CEDAR KEY FL,0,0,0,5,5
Hurricane,Debby,12,2000-08-22T15:00:00Z,MDPP 198N 707W,48,4,0,0,52
Hurricane,Debby,12,2000-08-22T15:00:00Z,ST MARKS FL,0,0,0,2,2
Hurricane,Debby,12,2000-08-22T15:00:00Z,MBJT 215N 712W,33,15,0,0,48
Hurricane,Debby,12,2000-08-22T15:00:00Z,APALACHICOLA FL,0,0,0,2,2
Hurricane,Debby,12,2000-08-22T15:00:00Z,MYMM 224N 730W,1,35,0,0,36
Hurricane,Debby,12,2000-08-22T15:00:00Z,GULF 29N 85W,0,0,0,2,2
Hurricane,Debby,12,2000-08-22T15:00:00Z,MYSM 241N 745W,0,6,16,1,23
Hurricane,Debby,13,2000-08-22T21:00:00Z,21.0N  72.0W,53,0,0,0,53
Hurricane,Debby,13,2000-08-22T21:00:00Z,MYNN 251N 775W,0,1,12,7,20
Hurricane,Debby,13,2000-08-22T21:00:00Z,22.0N  74.5W,3,32,1,0,36
Hurricane,Debby,13,2000-08-22T21:00:00Z,MYGF 266N 787W,0,0,3,13,16
Hurricane,Debby,13,2000-08-22T21:00:00Z,23.0N  76.0W,0,19,7,1,27
Hurricane,Debby,13,2000-08-22T21:00:00Z,ST THOMAS VI,99,0,0,0,99
Hurricane,Debby,13,2000-08-22T21:00:00Z,TIST 183N 650W,99,0,0,0,99
Hurricane,Debby,13,2000-08-22T21:00:00Z,SAN JUAN PR,99,0,0,0,99
Hurricane,Debby,13,2000-08-22T21:00:00Z,TJPS 180N 666W,99,0,0,0,99
Hurricane,Debby,13,2000-08-22T21:00:00Z,PONCE PR,99,0,0,0,99
Hurricane,Debby,13,2000-08-22T21:00:00Z,MDSD 185N 697W,37,0,0,0,37
Hurricane,Debby,13,2000-08-22T21:00:00Z,MARATHON FL,0,0,1,13,14
Hurricane,Debby,13,2000-08-22T21:00:00Z,MDCB 176N 714W,2,1,0,0,3
Hurricane,Debby,13,2000-08-22T21:00:00Z,MIAMI FL,0,0,1,14,15
Hurricane,Debby,13,2000-08-22T21:00:00Z,MTPP 186N 724W,10,5,0,0,15
Hurricane,Debby,13,2000-08-22T21:00:00Z,W PALM BEACH FL,0,0,1,13,14
Hurricane,Debby,13,2000-08-22T21:00:00Z,MTCA 183N 738W,1,6,1,1,9
Hurricane,Debby,13,2000-08-22T21:00:00Z,FT PIERCE FL,0,0,0,13,13
Hurricane,Debby,13,2000-08-22T21:00:00Z,MKJP 179N 768W,0,0,2,2,4
Hurricane,Debby,13,2000-08-22T21:00:00Z,COCOA BEACH FL,0,0,0,11,11
Hurricane,Debby,13,2000-08-22T21:00:00Z,MKJS 185N 779W,0,0,2,3,5
Hurricane,Debby,13,2000-08-22T21:00:00Z,DAYTONA BEACH FL,0,0,0,8,8
Hurricane,Debby,13,2000-08-22T21:00:00Z,MWCG 193N 814W,0,0,0,3,3
Hurricane,Debby,13,2000-08-22T21:00:00Z,JACKSONVILLE FL,0,0,0,5,5
Hurricane,Debby,13,2000-08-22T21:00:00Z,MUGM 200N 751W,0,20,1,1,22
Hurricane,Debby,13,2000-08-22T21:00:00Z,SAVANNAH GA,0,0,0,2,2
Hurricane,Debby,13,2000-08-22T21:00:00Z,MUCM 214N 779W,0,2,12,4,18
Hurricane,Debby,13,2000-08-22T21:00:00Z,KEY WEST FL,0,0,0,12,12
Hurricane,Debby,13,2000-08-22T21:00:00Z,MUCF 221N 805W,0,0,2,10,12
Hurricane,Debby,13,2000-08-22T21:00:00Z,MARCO ISLAND FL,0,0,0,12,12
Hurricane,Debby,13,2000-08-22T21:00:00Z,MUSN 216N 826W,0,0,0,5,5
Hurricane,Debby,13,2000-08-22T21:00:00Z,FT MYERS FL,0,0,0,11,11
Hurricane,Debby,13,2000-08-22T21:00:00Z,MUHA 230N 824W,0,0,0,8,8
Hurricane,Debby,13,2000-08-22T21:00:00Z,VENICE FL,0,0,0,10,10
Hurricane,Debby,13,2000-08-22T21:00:00Z,TJSJ 184N 661W,99,0,0,0,99
Hurricane,Debby,13,2000-08-22T21:00:00Z,TAMPA FL,0,0,0,8,8
Hurricane,Debby,13,2000-08-22T21:00:00Z,MDPP 198N 707W,62,0,0,0,62
Hurricane,Debby,13,2000-08-22T21:00:00Z,CEDAR KEY FL,0,0,0,6,6
Hurricane,Debby,13,2000-08-22T21:00:00Z,MBJT 215N 712W,58,0,0,0,58
Hurricane,Debby,13,2000-08-22T21:00:00Z,ST MARKS FL,0,0,0,3,3
Hurricane,Debby,13,2000-08-22T21:00:00Z,MYMM 224N 730W,24,17,0,0,41
Hurricane,Debby,13,2000-08-22T21:00:00Z,APALACHICOLA FL,0,0,0,2,2
Hurricane,Debby,13,2000-08-22T21:00:00Z,MYSM 241N 745W,0,21,3,1,25
Hurricane,Debby,13,2000-08-22T21:00:00Z,PANAMA CITY FL,0,0,0,2,2
Hurricane,Debby,13,2000-08-22T21:00:00Z,MYEG 235N 758W,0,18,7,1,26
Hurricane,Debby,13,2000-08-22T21:00:00Z,GULF 29N 85W,0,0,0,3,3
Hurricane,Debby,13,2000-08-22T21:00:00Z,MYAK 241N 776W,0,2,15,5,22
Hurricane,Debby,14,2000-08-23T03:00:00Z,21.0N  72.2W,53,0,0,0,53
Hurricane,Debby,14,2000-08-23T03:00:00Z,MYNN 251N 775W,0,1,16,5,22
Hurricane,Debby,14,2000-08-23T03:00:00Z,22.0N  74.5W,5,34,0,0,39
Hurricane,Debby,14,2000-08-23T03:00:00Z,MYGF 266N 787W,0,0,4,14,18
Hurricane,Debby,14,2000-08-23T03:00:00Z,23.0N  76.5W,0,14,14,1,29
Hurricane,Debby,14,2000-08-23T03:00:00Z,SAN JUAN PR,99,0,0,0,99
Hurricane,Debby,14,2000-08-23T03:00:00Z,MDSD 185N 697W,25,0,0,0,25
Hurricane,Debby,14,2000-08-23T03:00:00Z,MARATHON FL,0,0,1,15,16
Hurricane,Debby,14,2000-08-23T03:00:00Z,MDCB 176N 714W,2,0,0,0,2
Hurricane,Debby,14,2000-08-23T03:00:00Z,MIAMI FL,0,0,2,16,18
Hurricane,Debby,14,2000-08-23T03:00:00Z,MTPP 186N 724W,10,4,0,1,15
Hurricane,Debby,14,2000-08-23T03:00:00Z,W PALM BEACH FL,0,0,1,16,17
Hurricane,Debby,14,2000-08-23T03:00:00Z,MTCA 183N 738W,1,4,1,1,7
Hurricane,Debby,14,2000-08-23T03:00:00Z,FT PIERCE FL,0,0,0,15,15
Hurricane,Debby,14,2000-08-23T03:00:00Z,MKJP 179N 768W,0,0,1,1,2
Hurricane,Debby,14,2000-08-23T03:00:00Z,COCOA BEACH FL,0,0,0,13,13
Hurricane,Debby,14,2000-08-23T03:00:00Z,MKJS 185N 779W,0,0,2,2,4
Hurricane,Debby,14,2000-08-23T03:00:00Z,DAYTONA BEACH FL,0,0,0,10,10
Hurricane,Debby,14,2000-08-23T03:00:00Z,MWCG 193N 814W,0,0,0,2,2
Hurricane,Debby,14,2000-08-23T03:00:00Z,JACKSONVILLE FL,0,0,0,6,6
Hurricane,Debby,14,2000-08-23T03:00:00Z,MUGM 200N 751W,1,19,1,1,22
Hurricane,Debby,14,2000-08-23T03:00:00Z,SAVANNAH GA,0,0,0,2,2
Hurricane,Debby,14,2000-08-23T03:00:00Z,MUCM 214N 779W,0,2,15,3,20
Hurricane,Debby,14,2000-08-23T03:00:00Z,KEY WEST FL,0,0,1,13,14
Hurricane,Debby,14,2000-08-23T03:00:00Z,MUCF 221N 805W,0,0,3,10,13
Hurricane,Debby,14,2000-08-23T03:00:00Z,MARCO ISLAND FL,0,0,0,15,15
Hurricane,Debby,14,2000-08-23T03:00:00Z,MUSN 216N 826W,0,0,0,6,6
Hurricane,Debby,14,2000-08-23T03:00:00Z,FT MYERS FL,0,0,0,14,14
Hurricane,Debby,14,2000-08-23T03:00:00Z,MUHA 230N 824W,0,0,0,10,10
Hurricane,Debby,14,2000-08-23T03:00:00Z,VENICE FL,0,0,0,13,13
Hurricane,Debby,14,2000-08-23T03:00:00Z,MUAN 219N 850W,0,0,0,2,2
Hurricane,Debby,14,2000-08-23T03:00:00Z,TAMPA FL,0,0,0,12,12
Hurricane,Debby,14,2000-08-23T03:00:00Z,TJSJ 184N 661W,99,0,0,0,99
Hurricane,Debby,14,2000-08-23T03:00:00Z,CEDAR KEY FL,0,0,0,9,9
Hurricane,Debby,14,2000-08-23T03:00:00Z,MDPP 198N 707W,62,0,0,0,62
Hurricane,Debby,14,2000-08-23T03:00:00Z,ST MARKS FL,0,0,0,5,5
Hurricane,Debby,14,2000-08-23T03:00:00Z,MBJT 215N 712W,62,0,0,0,62
Hurricane,Debby,14,2000-08-23T03:00:00Z,APALACHICOLA FL,0,0,0,4,4
Hurricane,Debby,14,2000-08-23T03:00:00Z,MYMM 224N 730W,32,12,0,0,44
Hurricane,Debby,14,2000-08-23T03:00:00Z,PANAMA CITY FL,0,0,0,3,3
Hurricane,Debby,14,2000-08-23T03:00:00Z,MYSM 241N 745W,0,24,3,0,27
Hurricane,Debby,14,2000-08-23T03:00:00Z,GULF 29N 85W,0,0,0,5,5
Hurricane,Debby,14,2000-08-23T03:00:00Z,MYEG 235N 758W,0,20,9,1,30
Hurricane,Debby,14,2000-08-23T03:00:00Z,GULF 29N 87W,0,0,0,2,2
Hurricane,Debby,14,2000-08-23T03:00:00Z,MYAK 241N 776W,0,2,19,4,25
Hurricane,Debby,15,2000-08-23T09:00:00Z,21.0N  72.9W,54,0,0,0,54
Hurricane,Debby,15,2000-08-23T09:00:00Z,MYGF 266N 787W,0,0,5,12,17
Hurricane,Debby,15,2000-08-23T09:00:00Z,22.0N  75.1W,10,27,0,0,37
Hurricane,Debby,15,2000-08-23T09:00:00Z,MARATHON FL,0,0,3,14,17
Hurricane,Debby,15,2000-08-23T09:00:00Z,23.0N  77.0W,0,15,11,1,27
Hurricane,Debby,15,2000-08-23T09:00:00Z,MIAMI FL,0,0,4,14,18
Hurricane,Debby,15,2000-08-23T09:00:00Z,MDSD 185N 697W,35,0,0,0,35
Hurricane,Debby,15,2000-08-23T09:00:00Z,W PALM BEACH FL,0,0,2,15,17
Hurricane,Debby,15,2000-08-23T09:00:00Z,MTPP 186N 724W,11,2,0,0,13
Hurricane,Debby,15,2000-08-23T09:00:00Z,FT PIERCE FL,0,0,1,14,15
Hurricane,Debby,15,2000-08-23T09:00:00Z,MTCA 183N 738W,1,4,1,0,6
Hurricane,Debby,15,2000-08-23T09:00:00Z,COCOA BEACH FL,0,0,0,13,13
Hurricane,Debby,15,2000-08-23T09:00:00Z,MKJP 179N 768W,0,0,2,2,4
Hurricane,Debby,15,2000-08-23T09:00:00Z,DAYTONA BEACH FL,0,0,0,10,10
Hurricane,Debby,15,2000-08-23T09:00:00Z,MKJS 185N 779W,0,0,3,3,6
Hurricane,Debby,15,2000-08-23T09:00:00Z,JACKSONVILLE FL,0,0,0,7,7
Hurricane,Debby,15,2000-08-23T09:00:00Z,MWCG 193N 814W,0,0,0,4,4
Hurricane,Debby,15,2000-08-23T09:00:00Z,SAVANNAH GA,0,0,0,3,3
Hurricane,Debby,15,2000-08-23T09:00:00Z,MUGM 200N 751W,5,18,1,0,24
Hurricane,Debby,15,2000-08-23T09:00:00Z,KEY WEST FL,0,0,1,15,16
Hurricane,Debby,15,2000-08-23T09:00:00Z,MUCM 214N 779W,0,7,12,2,21
Hurricane,Debby,15,2000-08-23T09:00:00Z,MARCO ISLAND FL,0,0,1,15,16
Hurricane,Debby,15,2000-08-23T09:00:00Z,MUCF 221N 805W,0,0,7,8,15
Hurricane,Debby,15,2000-08-23T09:00:00Z,FT MYERS FL,0,0,0,15,15
Hurricane,Debby,15,2000-08-23T09:00:00Z,MUSN 216N 826W,0,0,0,8,8
Hurricane,Debby,15,2000-08-23T09:00:00Z,VENICE FL,0,0,0,13,13
Hurricane,Debby,15,2000-08-23T09:00:00Z,MUHA 230N 824W,0,0,1,11,12
Hurricane,Debby,15,2000-08-23T09:00:00Z,TAMPA FL,0,0,0,12,12
Hurricane,Debby,15,2000-08-23T09:00:00Z,MUAN 219N 850W,0,0,0,3,3
Hurricane,Debby,15,2000-08-23T09:00:00Z,CEDAR KEY FL,0,0,0,9,9
Hurricane,Debby,15,2000-08-23T09:00:00Z,MDPP 198N 707W,69,0,0,0,69
Hurricane,Debby,15,2000-08-23T09:00:00Z,ST MARKS FL,0,0,0,6,6
Hurricane,Debby,15,2000-08-23T09:00:00Z,MBJT 215N 712W,62,0,0,0,62
Hurricane,Debby,15,2000-08-23T09:00:00Z,APALACHICOLA FL,0,0,0,5,5
Hurricane,Debby,15,2000-08-23T09:00:00Z,MYMM 224N 730W,42,2,0,0,44
Hurricane,Debby,15,2000-08-23T09:00:00Z,PANAMA CITY FL,0,0,0,4,4
Hurricane,Debby,15,2000-08-23T09:00:00Z,MYSM 241N 745W,1,19,3,0,23
Hurricane,Debby,15,2000-08-23T09:00:00Z,PENSACOLA FL,0,0,0,2,2
Hurricane,Debby,15,2000-08-23T09:00:00Z,MYEG 235N 758W,0,23,5,0,28
Hurricane,Debby,15,2000-08-23T09:00:00Z,GULF 29N 85W,0,0,0,6,6
Hurricane,Debby,15,2000-08-23T09:00:00Z,MYAK 241N 776W,0,4,17,3,24
Hurricane,Debby,15,2000-08-23T09:00:00Z,GULF 29N 87W,0,0,0,3,3
Hurricane,Debby,15,2000-08-23T09:00:00Z,MYNN 251N 775W,0,2,15,4,21
Tropical Storm,Debby,16,2000-08-23T15:00:00Z,21.2N  75.1W,55,0,0,0,55
Tropical Storm,Debby,16,2000-08-23T15:00:00Z,MARATHON FL,0,0,12,8,20
Tropical Storm,Debby,16,2000-08-23T15:00:00Z,22.3N  76.9W,14,23,0,0,37
Tropical Storm,Debby,16,2000-08-23T15:00:00Z,MIAMI FL,0,0,11,9,20
Tropical Storm,Debby,16,2000-08-23T15:00:00Z,23.5N  78.5W,0,19,9,1,29
Tropical Storm,Debby,16,2000-08-23T15:00:00Z,W PALM BEACH FL,0,0,7,11,18
Tropical Storm,Debby,16,2000-08-23T15:00:00Z,MDSD 185N 697W,5,0,0,0,5
Tropical Storm,Debby,16,2000-08-23T15:00:00Z,FT PIERCE FL,0,0,3,12,15
Tropical Storm,Debby,16,2000-08-23T15:00:00Z,MTPP 186N 724W,27,0,0,0,27
Tropical Storm,Debby,16,2000-08-23T15:00:00Z,COCOA BEACH FL,0,0,1,12,13
Tropical Storm,Debby,16,2000-08-23T15:00:00Z,MTCA 183N 738W,5,0,0,0,5
Tropical Storm,Debby,16,2000-08-23T15:00:00Z,DAYTONA BEACH FL,0,0,0,10,10
Tropical Storm,Debby,16,2000-08-23T15:00:00Z,MKJP 179N 768W,0,1,0,1,2
Tropical Storm,Debby,16,2000-08-23T15:00:00Z,JACKSONVILLE FL,0,0,0,6,6
Tropical Storm,Debby,16,2000-08-23T15:00:00Z,MKJS 185N 779W,0,2,1,1,4
Tropical Storm,Debby,16,2000-08-23T15:00:00Z,SAVANNAH GA,0,0,0,2,2
Tropical Storm,Debby,16,2000-08-23T15:00:00Z,MWCG 193N 814W,0,0,1,3,4
Tropical Storm,Debby,16,2000-08-23T15:00:00Z,KEY WEST FL,0,0,8,10,18
Tropical Storm,Debby,16,2000-08-23T15:00:00Z,MUGM 200N 751W,37,1,0,0,38
Tropical Storm,Debby,16,2000-08-23T15:00:00Z,MARCO ISLAND FL,0,0,4,14,18
Tropical Storm,Debby,16,2000-08-23T15:00:00Z,MUCM 214N 779W,2,25,1,0,28
Tropical Storm,Debby,16,2000-08-23T15:00:00Z,FT MYERS FL,0,0,2,15,17
Tropical Storm,Debby,16,2000-08-23T15:00:00Z,MUCF 221N 805W,0,2,13,3,18
Tropical Storm,Debby,16,2000-08-23T15:00:00Z,VENICE FL,0,0,1,14,15
Tropical Storm,Debby,16,2000-08-23T15:00:00Z,MUSN 216N 826W,0,0,2,8,10
Tropical Storm,Debby,16,2000-08-23T15:00:00Z,TAMPA FL,0,0,0,13,13
Tropical Storm,Debby,16,2000-08-23T15:00:00Z,MUHA 230N 824W,0,0,5,10,15
Tropical Storm,Debby,16,2000-08-23T15:00:00Z,CEDAR KEY FL,0,0,0,10,10
Tropical Storm,Debby,16,2000-08-23T15:00:00Z,MUAN 219N 850W,0,0,0,5,5
Tropical Storm,Debby,16,2000-08-23T15:00:00Z,ST MARKS FL,0,0,0,6,6
Tropical Storm,Debby,16,2000-08-23T15:00:00Z,MDPP 198N 707W,99,0,0,0,99
Tropical Storm,Debby,16,2000-08-23T15:00:00Z,APALACHICOLA FL,0,0,0,7,7
Tropical Storm,Debby,16,2000-08-23T15:00:00Z,MBJT 215N 712W,43,0,0,0,43
Tropical Storm,Debby,16,2000-08-23T15:00:00Z,PANAMA CITY FL,0,0,0,5,5
Tropical Storm,Debby,16,2000-08-23T15:00:00Z,MYMM 224N 730W,38,0,0,0,38
Tropical Storm,Debby,16,2000-08-23T15:00:00Z,PENSACOLA FL,0,0,0,3,3
Tropical Storm,Debby,16,2000-08-23T15:00:00Z,MYSM 241N 745W,7,9,1,1,18
Tropical Storm,Debby,16,2000-08-23T15:00:00Z,MOBILE AL,0,0,0,2,2
Tropical Storm,Debby,16,2000-08-23T15:00:00Z,MYEG 235N 758W,15,15,1,0,31
Tropical Storm,Debby,16,2000-08-23T15:00:00Z,GULF 29N 85W,0,0,0,8,8
Tropical Storm,Debby,16,2000-08-23T15:00:00Z,MYAK 241N 776W,0,21,6,1,28
Tropical Storm,Debby,16,2000-08-23T15:00:00Z,GULF 29N 87W,0,0,0,5,5
Tropical Storm,Debby,16,2000-08-23T15:00:00Z,MYNN 251N 775W,0,9,11,2,22
Tropical Storm,Debby,16,2000-08-23T15:00:00Z,GULF 28N 89W,0,0,0,2,2
Tropical Storm,Debby,16,2000-08-23T15:00:00Z,MYGF 266N 787W,0,0,10,7,17
Tropical Storm,Debby,17,2000-08-23T21:00:00Z,21.4N  77.6W,52,0,0,0,52
Tropical Storm,Debby,17,2000-08-23T21:00:00Z,W PALM BEACH FL,0,2,11,5,18
Tropical Storm,Debby,17,2000-08-23T21:00:00Z,22.6N  79.5W,10,24,0,1,35
Tropical Storm,Debby,17,2000-08-23T21:00:00Z,FT PIERCE FL,0,0,8,8,16
Tropical Storm,Debby,17,2000-08-23T21:00:00Z,24.0N  81.0W,0,16,10,1,27
Tropical Storm,Debby,17,2000-08-23T21:00:00Z,COCOA BEACH FL,0,0,4,10,14
Tropical Storm,Debby,17,2000-08-23T21:00:00Z,MTPP 186N 724W,5,0,0,0,5
Tropical Storm,Debby,17,2000-08-23T21:00:00Z,DAYTONA BEACH FL,0,0,1,11,12
Tropical Storm,Debby,17,2000-08-23T21:00:00Z,MTCA 183N 738W,2,0,0,0,2
Tropical Storm,Debby,17,2000-08-23T21:00:00Z,JACKSONVILLE FL,0,0,0,8,8
Tropical Storm,Debby,17,2000-08-23T21:00:00Z,MKJP 179N 768W,1,1,0,0,2
Tropical Storm,Debby,17,2000-08-23T21:00:00Z,SAVANNAH GA,0,0,0,3,3
Tropical Storm,Debby,17,2000-08-23T21:00:00Z,MKJS 185N 779W,4,4,0,0,8
Tropical Storm,Debby,17,2000-08-23T21:00:00Z,KEY WEST FL,0,6,15,3,24
Tropical Storm,Debby,17,2000-08-23T21:00:00Z,MWCG 193N 814W,0,3,3,1,7
Tropical Storm,Debby,17,2000-08-23T21:00:00Z,MARCO ISLAND FL,0,1,15,5,21
Tropical Storm,Debby,17,2000-08-23T21:00:00Z,MUGM 200N 751W,70,0,0,0,70
Tropical Storm,Debby,17,2000-08-23T21:00:00Z,FT MYERS FL,0,0,12,7,19
Tropical Storm,Debby,17,2000-08-23T21:00:00Z,MUCM 214N 779W,47,0,0,0,47
Tropical Storm,Debby,17,2000-08-23T21:00:00Z,VENICE FL,0,0,8,10,18
Tropical Storm,Debby,17,2000-08-23T21:00:00Z,MUCF 221N 805W,2,24,2,0,28
Tropical Storm,Debby,17,2000-08-23T21:00:00Z,TAMPA FL,0,0,3,13,16
Tropical Storm,Debby,17,2000-08-23T21:00:00Z,MUSN 216N 826W,0,4,9,3,16
Tropical Storm,Debby,17,2000-08-23T21:00:00Z,CEDAR KEY FL,0,0,1,12,13
Tropical Storm,Debby,17,2000-08-23T21:00:00Z,MUHA 230N 824W,0,6,13,2,21
Tropical Storm,Debby,17,2000-08-23T21:00:00Z,ST MARKS FL,0,0,0,10,10
Tropical Storm,Debby,17,2000-08-23T21:00:00Z,MUAN 219N 850W,0,0,2,6,8
Tropical Storm,Debby,17,2000-08-23T21:00:00Z,APALACHICOLA FL,0,0,0,10,10
Tropical Storm,Debby,17,2000-08-23T21:00:00Z,MDPP 198N 707W,99,0,0,0,99
Tropical Storm,Debby,17,2000-08-23T21:00:00Z,PANAMA CITY FL,0,0,0,9,9
Tropical Storm,Debby,17,2000-08-23T21:00:00Z,MBJT 215N 712W,9,0,0,0,9
Tropical Storm,Debby,17,2000-08-23T21:00:00Z,PENSACOLA FL,0,0,0,6,6
Tropical Storm,Debby,17,2000-08-23T21:00:00Z,MYMM 224N 730W,2,0,0,0,2
Tropical Storm,Debby,17,2000-08-23T21:00:00Z,MOBILE AL,0,0,0,4,4
Tropical Storm,Debby,17,2000-08-23T21:00:00Z,MYSM 241N 745W,0,1,0,1,2
Tropical Storm,Debby,17,2000-08-23T21:00:00Z,GULFPORT MS,0,0,0,3,3
Tropical Storm,Debby,17,2000-08-23T21:00:00Z,MYEG 235N 758W,13,3,0,1,17
Tropical Storm,Debby,17,2000-08-23T21:00:00Z,BURAS LA,0,0,0,3,3
Tropical Storm,Debby,17,2000-08-23T21:00:00Z,MYAK 241N 776W,10,13,1,0,24
Tropical Storm,Debby,17,2000-08-23T21:00:00Z,NEW ORLEANS LA,0,0,0,2,2
Tropical Storm,Debby,17,2000-08-23T21:00:00Z,MYNN 251N 775W,1,10,4,1,16
Tropical Storm,Debby,17,2000-08-23T21:00:00Z,GULF 29N 85W,0,0,0,12,12
Tropical Storm,Debby,17,2000-08-23T21:00:00Z,MYGF 266N 787W,0,2,8,5,15
Tropical Storm,Debby,17,2000-08-23T21:00:00Z,GULF 29N 87W,0,0,0,9,9
Tropical Storm,Debby,17,2000-08-23T21:00:00Z,MARATHON FL,0,10,13,2,25
Tropical Storm,Debby,17,2000-08-23T21:00:00Z,GULF 28N 89W,0,0,0,5,5
Tropical Storm,Debby,17,2000-08-23T21:00:00Z,MIAMI FL,0,5,13,4,22
Tropical Storm,Debby,18,2000-08-24T03:00:00Z,20.5N  78.0W,53,0,0,0,53
Tropical Storm,Debby,18,2000-08-24T03:00:00Z,COCOA BEACH FL,0,0,1,9,10
Tropical Storm,Debby,18,2000-08-24T03:00:00Z,21.5N  80.0W,11,26,0,0,37
Tropical Storm,Debby,18,2000-08-24T03:00:00Z,DAYTONA BEACH FL,0,0,0,8,8
Tropical Storm,Debby,18,2000-08-24T03:00:00Z,23.0N  81.5W,0,17,10,1,28
Tropical Storm,Debby,18,2000-08-24T03:00:00Z,JACKSONVILLE FL,0,0,0,5,5
Tropical Storm,Debby,18,2000-08-24T03:00:00Z,MTCA 183N 738W,3,0,0,0,3
Tropical Storm,Debby,18,2000-08-24T03:00:00Z,SAVANNAH GA,0,0,0,2,2
Tropical Storm,Debby,18,2000-08-24T03:00:00Z,MKJP 179N 768W,12,1,0,1,14
Tropical Storm,Debby,18,2000-08-24T03:00:00Z,KEY WEST FL,0,5,15,3,23
Tropical Storm,Debby,18,2000-08-24T03:00:00Z,MKJS 185N 779W,21,2,0,1,24
Tropical Storm,Debby,18,2000-08-24T03:00:00Z,MARCO ISLAND FL,0,1,10,8,19
Tropical Storm,Debby,18,2000-08-24T03:00:00Z,MWCG 193N 814W,0,11,4,1,16
Tropical Storm,Debby,18,2000-08-24T03:00:00Z,FT MYERS FL,0,0,7,10,17
Tropical Storm,Debby,18,2000-08-24T03:00:00Z,MUGM 200N 751W,99,0,0,0,99
Tropical Storm,Debby,18,2000-08-24T03:00:00Z,VENICE FL,0,0,4,12,16
Tropical Storm,Debby,18,2000-08-24T03:00:00Z,MUCM 214N 779W,50,0,0,0,50
Tropical Storm,Debby,18,2000-08-24T03:00:00Z,TAMPA FL,0,0,1,12,13
Tropical Storm,Debby,18,2000-08-24T03:00:00Z,MUCF 221N 805W,3,29,1,0,33
Tropical Storm,Debby,18,2000-08-24T03:00:00Z,CEDAR KEY FL,0,0,0,11,11
Tropical Storm,Debby,18,2000-08-24T03:00:00Z,MUSN 216N 826W,0,8,13,2,23
Tropical Storm,Debby,18,2000-08-24T03:00:00Z,ST MARKS FL,0,0,0,8,8
Tropical Storm,Debby,18,2000-08-24T03:00:00Z,MUHA 230N 824W,0,8,15,2,25
Tropical Storm,Debby,18,2000-08-24T03:00:00Z,APALACHICOLA FL,0,0,0,9,9
Tropical Storm,Debby,18,2000-08-24T03:00:00Z,MUAN 219N 850W,0,0,6,7,13
Tropical Storm,Debby,18,2000-08-24T03:00:00Z,PANAMA CITY FL,0,0,0,8,8
Tropical Storm,Debby,18,2000-08-24T03:00:00Z,MMCZ 205N 869W,0,0,0,3,3
Tropical Storm,Debby,18,2000-08-24T03:00:00Z,PENSACOLA FL,0,0,0,6,6
Tropical Storm,Debby,18,2000-08-24T03:00:00Z,MYEG 235N 758W,1,1,0,2,4
Tropical Storm,Debby,18,2000-08-24T03:00:00Z,MOBILE AL,0,0,0,4,4
Tropical Storm,Debby,18,2000-08-24T03:00:00Z,MYAK 241N 776W,3,7,2,2,14
Tropical Storm,Debby,18,2000-08-24T03:00:00Z,GULFPORT MS,0,0,0,4,4
Tropical Storm,Debby,18,2000-08-24T03:00:00Z,MYNN 251N 775W,0,2,3,4,9
Tropical Storm,Debby,18,2000-08-24T03:00:00Z,BURAS LA,0,0,0,4,4
Tropical Storm,Debby,18,2000-08-24T03:00:00Z,MYGF 266N 787W,0,0,3,6,9
Tropical Storm,Debby,18,2000-08-24T03:00:00Z,NEW ORLEANS LA,0,0,0,3,3
Tropical Storm,Debby,18,2000-08-24T03:00:00Z,MARATHON FL,0,6,14,2,22
Tropical Storm,Debby,18,2000-08-24T03:00:00Z,GULF 29N 85W,0,0,0,11,11
Tropical Storm,Debby,18,2000-08-24T03:00:00Z,MIAMI FL,0,2,9,6,17
Tropical Storm,Debby,18,2000-08-24T03:00:00Z,GULF 29N 87W,0,0,0,9,9
Tropical Storm,Debby,18,2000-08-24T03:00:00Z,W PALM BEACH FL,0,0,5,8,13
Tropical Storm,Debby,18,2000-08-24T03:00:00Z,GULF 28N 89W,0,0,0,7,7
Tropical Storm,Debby,18,2000-08-24T03:00:00Z,FT PIERCE FL,0,0,2,10,12
Tropical Storm,Debby,18,2000-08-24T03:00:00Z,GULF 28N 91W,0,0,0,3,3
Tropical Storm,Debby,19,2000-08-24T09:00:00Z,20.8N  80.7W,55,0,0,0,55
Tropical Storm,Debby,19,2000-08-24T09:00:00Z,DAYTONA BEACH FL,0,0,0,4,4
Tropical Storm,Debby,19,2000-08-24T09:00:00Z,22.1N  82.5W,9,27,0,1,37
Tropical Storm,Debby,19,2000-08-24T09:00:00Z,JACKSONVILLE FL,0,0,0,2,2
Tropical Storm,Debby,19,2000-08-24T09:00:00Z,23.5N  84.0W,0,16,11,1,28
Tropical Storm,Debby,19,2000-08-24T09:00:00Z,KEY WEST FL,0,18,4,1,23
Tropical Storm,Debby,19,2000-08-24T09:00:00Z,MKJP 179N 768W,3,0,0,0,3
Tropical Storm,Debby,19,2000-08-24T09:00:00Z,MARCO ISLAND FL,0,3,8,4,15
Tropical Storm,Debby,19,2000-08-24T09:00:00Z,MKJS 185N 779W,39,0,0,0,39
Tropical Storm,Debby,19,2000-08-24T09:00:00Z,FT MYERS FL,0,1,7,6,14
Tropical Storm,Debby,19,2000-08-24T09:00:00Z,MWCG 193N 814W,22,4,1,0,27
Tropical Storm,Debby,19,2000-08-24T09:00:00Z,VENICE FL,0,0,6,7,13
Tropical Storm,Debby,19,2000-08-24T09:00:00Z,MUGM 200N 751W,99,0,0,0,99
Tropical Storm,Debby,19,2000-08-24T09:00:00Z,TAMPA FL,0,0,2,8,10
Tropical Storm,Debby,19,2000-08-24T09:00:00Z,MUCM 214N 779W,35,0,0,0,35
Tropical Storm,Debby,19,2000-08-24T09:00:00Z,CEDAR KEY FL,0,0,0,7,7
Tropical Storm,Debby,19,2000-08-24T09:00:00Z,MUCF 221N 805W,41,2,0,0,43
Tropical Storm,Debby,19,2000-08-24T09:00:00Z,ST MARKS FL,0,0,0,5,5
Tropical Storm,Debby,19,2000-08-24T09:00:00Z,MUSN 216N 826W,10,25,1,0,36
Tropical Storm,Debby,19,2000-08-24T09:00:00Z,APALACHICOLA FL,0,0,0,7,7
Tropical Storm,Debby,19,2000-08-24T09:00:00Z,MUHA 230N 824W,4,29,0,1,34
Tropical Storm,Debby,19,2000-08-24T09:00:00Z,PANAMA CITY FL,0,0,0,6,6
Tropical Storm,Debby,19,2000-08-24T09:00:00Z,MUAN 219N 850W,0,8,12,1,21
Tropical Storm,Debby,19,2000-08-24T09:00:00Z,PENSACOLA FL,0,0,0,5,5
Tropical Storm,Debby,19,2000-08-24T09:00:00Z,MMCZ 205N 869W,0,0,4,4,8
Tropical Storm,Debby,19,2000-08-24T09:00:00Z,MOBILE AL,0,0,0,4,4
Tropical Storm,Debby,19,2000-08-24T09:00:00Z,MYAK 241N 776W,0,0,0,2,2
Tropical Storm,Debby,19,2000-08-24T09:00:00Z,GULFPORT MS,0,0,0,4,4
Tropical Storm,Debby,19,2000-08-24T09:00:00Z,MYNN 251N 775W,0,0,0,2,2
Tropical Storm,Debby,19,2000-08-24T09:00:00Z,BURAS LA,0,0,0,6,6
Tropical Storm,Debby,19,2000-08-24T09:00:00Z,MYGF 266N 787W,0,0,0,3,3
Tropical Storm,Debby,19,2000-08-24T09:00:00Z,NEW ORLEANS LA,0,0,0,4,4
Tropical Storm,Debby,19,2000-08-24T09:00:00Z,MMMD 210N 897W,0,0,0,4,4
Tropical Storm,Debby,19,2000-08-24T09:00:00Z,NEW IBERIA LA,0,0,0,2,2
Tropical Storm,Debby,19,2000-08-24T09:00:00Z,MARATHON FL,0,13,4,2,19
Tropical Storm,Debby,19,2000-08-24T09:00:00Z,GULF 29N 85W,0,0,0,10,10
Tropical Storm,Debby,19,2000-08-24T09:00:00Z,MIAMI FL,0,2,4,4,10
Tropical Storm,Debby,19,2000-08-24T09:00:00Z,GULF 29N 87W,0,0,0,10,10
Tropical Storm,Debby,19,2000-08-24T09:00:00Z,W PALM BEACH FL,0,0,2,5,7
Tropical Storm,Debby,19,2000-08-24T09:00:00Z,GULF 28N 89W,0,0,0,10,10
Tropical Storm,Debby,19,2000-08-24T09:00:00Z,FT PIERCE FL,0,0,1,5,6
Tropical Storm,Debby,19,2000-08-24T09:00:00Z,GULF 28N 91W,0,0,0,6,6
Tropical Storm,Debby,19,2000-08-24T09:00:00Z,COCOA BEACH FL,0,0,1,4,5
Tropical Storm,Debby,19,2000-08-24T09:00:00Z,GULF 28N 93W,0,0,0,3,3
Tropical Depression,Eight,1,2000-09-02T03:00:00Z,16.5N  53.0W,54,0,0,0,54
Tropical Depression,Eight,1,2000-09-02T03:00:00Z,TKPK 173N 627W,0,0,1,11,12
Tropical Depression,Eight,1,2000-09-02T03:00:00Z,17.0N  55.0W,7,26,0,0,33
Tropical Depression,Eight,1,2000-09-02T03:00:00Z,TNCM 181N 631W,0,0,1,12,13
Tropical Depression,Eight,1,2000-09-02T03:00:00Z,18.0N  57.0W,0,16,9,1,26
Tropical Depression,Eight,1,2000-09-02T03:00:00Z,TISX 177N 648W,0,0,0,8,8
Tropical Depression,Eight,1,2000-09-02T03:00:00Z,TBPB 131N 595W,0,0,1,3,4
Tropical Depression,Eight,1,2000-09-02T03:00:00Z,TIST 183N 650W,0,0,0,8,8
Tropical Depression,Eight,1,2000-09-02T03:00:00Z,TVSV 131N 612W,0,0,0,3,3
Tropical Depression,Eight,1,2000-09-02T03:00:00Z,TJPS 180N 666W,0,0,0,4,4
Tropical Depression,Eight,1,2000-09-02T03:00:00Z,TLPL 138N 610W,0,0,1,4,5
Tropical Depression,Eight,1,2000-09-02T03:00:00Z,TJSJ 184N 661W,0,0,0,5,5
Tropical Depression,Eight,1,2000-09-02T03:00:00Z,TFFF 146N 610W,0,0,1,6,7
Tropical Depression,Eight,1,2000-09-02T03:00:00Z,ST CROIX VI,0,0,0,8,8
Tropical Depression,Eight,1,2000-09-02T03:00:00Z,TDPR 153N 614W,0,0,2,7,9
Tropical Depression,Eight,1,2000-09-02T03:00:00Z,ST THOMAS VI,0,0,0,8,8
Tropical Depression,Eight,1,2000-09-02T03:00:00Z,TFFR 163N 615W,0,0,3,9,12
Tropical Depression,Eight,1,2000-09-02T03:00:00Z,SAN JUAN PR,0,0,0,5,5
Tropical Depression,Eight,1,2000-09-02T03:00:00Z,TAPA 171N 618W,0,0,3,11,14
Tropical Depression,Eight,1,2000-09-02T03:00:00Z,PONCE PR,0,0,0,4,4
Tropical Storm,Ernesto,2,2000-09-02T09:00:00Z,17.6N  53.9W,50,0,0,0,50
Tropical Storm,Ernesto,2,2000-09-02T09:00:00Z,TNCM 181N 631W,0,0,3,13,16
Tropical Storm,Ernesto,2,2000-09-02T09:00:00Z,18.4N  56.3W,17,15,0,0,32
Tropical Storm,Ernesto,2,2000-09-02T09:00:00Z,TISX 177N 648W,0,0,0,13,13
Tropical Storm,Ernesto,2,2000-09-02T09:00:00Z,19.0N  58.5W,0,17,6,1,24
Tropical Storm,Ernesto,2,2000-09-02T09:00:00Z,TIST 183N 650W,0,0,0,14,14
Tropical Storm,Ernesto,2,2000-09-02T09:00:00Z,TBPB 131N 595W,0,0,1,1,2
Tropical Storm,Ernesto,2,2000-09-02T09:00:00Z,TJPS 180N 666W,0,0,0,10,10
Tropical Storm,Ernesto,2,2000-09-02T09:00:00Z,TVSV 131N 612W,0,0,0,2,2
Tropical Storm,Ernesto,2,2000-09-02T09:00:00Z,MDSD 185N 697W,0,0,0,3,3
Tropical Storm,Ernesto,2,2000-09-02T09:00:00Z,TLPL 138N 610W,0,0,1,3,4
Tropical Storm,Ernesto,2,2000-09-02T09:00:00Z,TJSJ 184N 661W,0,0,0,12,12
Tropical Storm,Ernesto,2,2000-09-02T09:00:00Z,TFFF 146N 610W,0,0,3,4,7
Tropical Storm,Ernesto,2,2000-09-02T09:00:00Z,MDPP 198N 707W,0,0,0,2,2
Tropical Storm,Ernesto,2,2000-09-02T09:00:00Z,TDPR 153N 614W,0,0,4,5,9
Tropical Storm,Ernesto,2,2000-09-02T09:00:00Z,ST CROIX VI,0,0,0,13,13
Tropical Storm,Ernesto,2,2000-09-02T09:00:00Z,TFFR 163N 615W,0,0,7,6,13
Tropical Storm,Ernesto,2,2000-09-02T09:00:00Z,ST THOMAS VI,0,0,0,14,14
Tropical Storm,Ernesto,2,2000-09-02T09:00:00Z,TAPA 171N 618W,0,0,8,7,15
Tropical Storm,Ernesto,2,2000-09-02T09:00:00Z,SAN JUAN PR,0,0,0,12,12
Tropical Storm,Ernesto,2,2000-09-02T09:00:00Z,TKPK 173N 627W,0,0,4,11,15
Tropical Storm,Ernesto,2,2000-09-02T09:00:00Z,PONCE PR,0,0,0,10,10
Tropical Storm,Ernesto,3,2000-09-02T15:00:00Z,19.0N  56.2W,50,0,0,0,50
Tropical Storm,Ernesto,3,2000-09-02T15:00:00Z,TJPS 180N 666W,0,0,1,6,7
Tropical Storm,Ernesto,3,2000-09-02T15:00:00Z,20.0N  58.7W,12,19,1,0,32
Tropical Storm,Ernesto,3,2000-09-02T15:00:00Z,MDSD 185N 697W,0,0,0,3,3
Tropical Storm,Ernesto,3,2000-09-02T15:00:00Z,21.0N  61.2W,0,15,9,1,25
Tropical Storm,Ernesto,3,2000-09-02T15:00:00Z,TJSJ 184N 661W,0,0,2,7,9
Tropical Storm,Ernesto,3,2000-09-02T15:00:00Z,TDPR 153N 614W,0,0,2,1,3
Tropical Storm,Ernesto,3,2000-09-02T15:00:00Z,MDPP 198N 707W,0,0,0,4,4
Tropical Storm,Ernesto,3,2000-09-02T15:00:00Z,TFFR 163N 615W,0,1,5,1,7
Tropical Storm,Ernesto,3,2000-09-02T15:00:00Z,MBJT 215N 712W,0,0,0,4,4
Tropical Storm,Ernesto,3,2000-09-02T15:00:00Z,TAPA 171N 618W,0,2,7,1,10
Tropical Storm,Ernesto,3,2000-09-02T15:00:00Z,ST CROIX VI,0,0,3,6,9
Tropical Storm,Ernesto,3,2000-09-02T15:00:00Z,TKPK 173N 627W,0,1,6,3,10
Tropical Storm,Ernesto,3,2000-09-02T15:00:00Z,ST THOMAS VI,0,0,4,7,11
Tropical Storm,Ernesto,3,2000-09-02T15:00:00Z,TNCM 181N 631W,0,1,9,3,13
Tropical Storm,Ernesto,3,2000-09-02T15:00:00Z,SAN JUAN PR,0,0,2,7,9
Tropical Storm,Ernesto,3,2000-09-02T15:00:00Z,TISX 177N 648W,0,0,3,6,9
Tropical Storm,Ernesto,3,2000-09-02T15:00:00Z,PONCE PR,0,0,1,6,7
Tropical Storm,Ernesto,3,2000-09-02T15:00:00Z,TIST 183N 650W,0,0,4,7,11
Tropical Storm,Ernesto,4,2000-09-02T21:00:00Z,19.9N  57.0W,51,0,0,0,51
Tropical Storm,Ernesto,4,2000-09-02T21:00:00Z,TJPS 180N 666W,0,0,0,5,5
Tropical Storm,Ernesto,4,2000-09-02T21:00:00Z,21.1N  59.3W,16,16,1,0,33
Tropical Storm,Ernesto,4,2000-09-02T21:00:00Z,MDSD 185N 697W,0,0,0,2,2
Tropical Storm,Ernesto,4,2000-09-02T21:00:00Z,22.2N  61.7W,0,15,9,1,25
Tropical Storm,Ernesto,4,2000-09-02T21:00:00Z,TJSJ 184N 661W,0,0,1,5,6
Tropical Storm,Ernesto,4,2000-09-02T21:00:00Z,TDPR 153N 614W,0,0,1,1,2
Tropical Storm,Ernesto,4,2000-09-02T21:00:00Z,MDPP 198N 707W,0,0,0,2,2
Tropical Storm,Ernesto,4,2000-09-02T21:00:00Z,TFFR 163N 615W,0,0,3,1,4
Tropical Storm,Ernesto,4,2000-09-02T21:00:00Z,MBJT 215N 712W,0,0,0,3,3
Tropical Storm,Ernesto,4,2000-09-02T21:00:00Z,TAPA 171N 618W,0,1,5,1,7
Tropical Storm,Ernesto,4,2000-09-02T21:00:00Z,BERMUDA,0,0,0,3,3
Tropical Storm,Ernesto,4,2000-09-02T21:00:00Z,TKPK 173N 627W,0,0,5,2,7
Tropical Storm,Ernesto,4,2000-09-02T21:00:00Z,ST CROIX VI,0,0,2,4,6
Tropical Storm,Ernesto,4,2000-09-02T21:00:00Z,TNCM 181N 631W,0,1,6,3,10
Tropical Storm,Ernesto,4,2000-09-02T21:00:00Z,ST THOMAS VI,0,0,3,5,8
Tropical Storm,Ernesto,4,2000-09-02T21:00:00Z,TISX 177N 648W,0,0,2,4,6
Tropical Storm,Ernesto,4,2000-09-02T21:00:00Z,SAN JUAN PR,0,0,1,5,6
Tropical Storm,Ernesto,4,2000-09-02T21:00:00Z,TIST 183N 650W,0,0,3,5,8
Tropical Storm,Ernesto,4,2000-09-02T21:00:00Z,PONCE PR,0,0,0,5,5
Tropical Storm,Ernesto,5,2000-09-03T03:00:00Z,20.5N  58.0W,52,0,0,0,52
Tropical Storm,Ernesto,5,2000-09-03T03:00:00Z,TIST 183N 650W,0,0,1,2,3
Tropical Storm,Ernesto,5,2000-09-03T03:00:00Z,21.5N  60.0W,20,10,1,0,31
Tropical Storm,Ernesto,5,2000-09-03T03:00:00Z,TJSJ 184N 661W,0,0,0,2,2
Tropical Storm,Ernesto,5,2000-09-03T03:00:00Z,23.0N  62.0W,1,15,7,1,24
Tropical Storm,Ernesto,5,2000-09-03T03:00:00Z,BERMUDA,0,0,0,4,4
Tropical Storm,Ernesto,5,2000-09-03T03:00:00Z,TAPA 171N 618W,0,0,2,0,2
Tropical Storm,Ernesto,5,2000-09-03T03:00:00Z,ST CROIX VI,0,0,1,1,2
Tropical Storm,Ernesto,5,2000-09-03T03:00:00Z,TKPK 173N 627W,0,0,2,0,2
Tropical Storm,Ernesto,5,2000-09-03T03:00:00Z,ST THOMAS VI,0,0,1,2,3
Tropical Storm,Ernesto,5,2000-09-03T03:00:00Z,TNCM 181N 631W,0,0,3,1,4
Tropical Storm,Ernesto,5,2000-09-03T03:00:00Z,SAN JUAN PR,0,0,0,2,2
Tropical Storm,Ernesto,5,2000-09-03T03:00:00Z,TISX 177N 648W,0,0,1,1,2
Tropical Storm,Ernesto,6,2000-09-03T09:00:00Z,21.0N  60.0W,51,0,0,0,51
Tropical Storm,Ernesto,6,2000-09-03T09:00:00Z,TJSJ 184N 661W,0,0,1,1,2
Tropical Storm,Ernesto,6,2000-09-03T09:00:00Z,22.5N  62.5W,9,23,1,0,33
Tropical Storm,Ernesto,6,2000-09-03T09:00:00Z,MBJT 215N 712W,0,0,0,2,2
Tropical Storm,Ernesto,6,2000-09-03T09:00:00Z,24.0N  64.0W,0,19,4,1,24
Tropical Storm,Ernesto,6,2000-09-03T09:00:00Z,BERMUDA,0,0,0,4,4
Tropical Storm,Ernesto,6,2000-09-03T09:00:00Z,TNCM 181N 631W,0,1,2,0,3
Tropical Storm,Ernesto,6,2000-09-03T09:00:00Z,ST THOMAS VI,0,0,1,1,2
Tropical Storm,Ernesto,6,2000-09-03T09:00:00Z,TIST 183N 650W,0,0,1,1,2
Tropical Storm,Ernesto,6,2000-09-03T09:00:00Z,SAN JUAN PR,0,0,1,1,2
Tropical Storm,Ernesto,7,2000-09-03T15:00:00Z,21.8N  61.4W,52,0,0,0,52
Tropical Storm,Ernesto,7,2000-09-03T15:00:00Z,TJSJ 184N 661W,0,0,1,1,2
Tropical Storm,Ernesto,7,2000-09-03T15:00:00Z,23.0N  63.0W,27,5,1,0,33
Tropical Storm,Ernesto,7,2000-09-03T15:00:00Z,MBJT 215N 712W,0,0,0,2,2
Tropical Storm,Ernesto,7,2000-09-03T15:00:00Z,24.5N  64.5W,2,18,3,1,24
Tropical Storm,Ernesto,7,2000-09-03T15:00:00Z,BERMUDA,0,0,0,8,8
Tropical Storm,Ernesto,7,2000-09-03T15:00:00Z,TNCM 181N 631W,0,1,1,0,2
Tropical Storm,Ernesto,7,2000-09-03T15:00:00Z,ST THOMAS VI,0,0,1,1,2
Tropical Storm,Ernesto,7,2000-09-03T15:00:00Z,TIST 183N 650W,0,0,1,1,2
Tropical Storm,Ernesto,7,2000-09-03T15:00:00Z,SAN JUAN PR,0,0,1,1,2
Tropical Depression,Nine,1,2000-09-09T00:00:00Z,32.6N  93.3W,33,0,0,0,33
Tropical Depression,Nine,1,2000-09-09T00:00:00Z,PORT ARTHUR TX,70,0,0,0,70
Tropical Depression,Nine,1,2000-09-09T00:00:00Z,0.0N   0.0W,99,0,0,0,99
Tropical Depression,Nine,1,2000-09-09T00:00:00Z,GALVESTON TX,65,0,0,0,65
Tropical Depression,Nine,1,2000-09-09T00:00:00Z,0.0N   0.0W,99,0,0,0,99
Tropical Depression,Nine,1,2000-09-09T00:00:00Z,FREEPORT TX,43,0,0,0,43
Tropical Depression,Nine,1,2000-09-09T00:00:00Z,GULFPORT MS,3,0,0,0,3
Tropical Depression,Nine,1,2000-09-09T00:00:00Z,PORT O CONNOR TX,2,0,0,0,2
Tropical Depression,Nine,1,2000-09-09T00:00:00Z,BURAS LA,2,0,0,0,2
Tropical Depression,Nine,1,2000-09-09T00:00:00Z,GULF 28N 91W,8,0,0,0,8
Tropical Depression,Nine,1,2000-09-09T00:00:00Z,NEW ORLEANS LA,13,0,0,0,13
Tropical Depression,Nine,1,2000-09-09T00:00:00Z,GULF 28N 93W,99,0,0,0,99
Tropical Depression,Nine,1,2000-09-09T00:00:00Z,NEW IBERIA LA,56,0,0,0,56
Tropical Depression,Nine,1,2000-09-09T00:00:00Z,GULF 28N 95W,79,0,0,0,79
Tropical Depression,Nine,2,2000-09-09T03:00:00Z,32.5N  93.3W,33,0,0,0,33
Tropical Depression,Nine,2,2000-09-09T03:00:00Z,PORT ARTHUR TX,70,0,0,0,70
Tropical Depression,Nine,2,2000-09-09T03:00:00Z,0.0N   0.0W,99,0,0,0,99
Tropical Depression,Nine,2,2000-09-09T03:00:00Z,GALVESTON TX,65,0,0,0,65
Tropical Depression,Nine,2,2000-09-09T03:00:00Z,0.0N   0.0W,99,0,0,0,99
Tropical Depression,Nine,2,2000-09-09T03:00:00Z,FREEPORT TX,43,0,0,0,43
Tropical Depression,Nine,2,2000-09-09T03:00:00Z,GULFPORT MS,3,0,0,0,3
Tropical Depression,Nine,2,2000-09-09T03:00:00Z,PORT O CONNOR TX,2,0,0,0,2
Tropical Depression,Nine,2,2000-09-09T03:00:00Z,BURAS LA,2,0,0,0,2
Tropical Depression,Nine,2,2000-09-09T03:00:00Z,GULF 28N 91W,8,0,0,0,8
Tropical Depression,Nine,2,2000-09-09T03:00:00Z,NEW ORLEANS LA,13,0,0,0,13
Tropical Depression,Nine,2,2000-09-09T03:00:00Z,GULF 28N 93W,99,0,0,0,99
Tropical Depression,Nine,2,2000-09-09T03:00:00Z,NEW IBERIA LA,56,0,0,0,56
Tropical Depression,Nine,2,2000-09-09T03:00:00Z,GULF 28N 95W,79,0,0,0,79
Tropical Depression,Ten,1,2000-09-11T15:00:00Z,30.1N  73.6W,99,0,0,0,99
Tropical Depression,Ten,1,2000-09-11T15:00:00Z,SAVANNAH GA,0,0,0,7,7
Tropical Depression,Ten,1,2000-09-11T15:00:00Z,30.0N  74.0W,42,0,0,0,42
Tropical Depression,Ten,1,2000-09-11T15:00:00Z,CHARLESTON SC,0,0,0,7,7
Tropical Depression,Ten,1,2000-09-11T15:00:00Z,30.0N  74.0W,42,0,0,0,42
Tropical Depression,Ten,1,2000-09-11T15:00:00Z,MYRTLE BEACH SC,0,0,0,6,6
Tropical Depression,Ten,1,2000-09-11T15:00:00Z,MYSM 241N 745W,0,0,0,3,3
Tropical Depression,Ten,1,2000-09-11T15:00:00Z,WILMINGTON NC,0,0,0,6,6
Tropical Depression,Ten,1,2000-09-11T15:00:00Z,MYEG 235N 758W,0,0,0,2,2
Tropical Depression,Ten,1,2000-09-11T15:00:00Z,MOREHEAD CITY NC,0,0,1,4,5
Tropical Depression,Ten,1,2000-09-11T15:00:00Z,MYAK 241N 776W,0,0,0,3,3
Tropical Depression,Ten,1,2000-09-11T15:00:00Z,CAPE HATTERAS NC,0,0,0,4,4
Tropical Depression,Ten,1,2000-09-11T15:00:00Z,MYNN 251N 775W,0,0,2,4,6
Tropical Depression,Ten,1,2000-09-11T15:00:00Z,KEY WEST FL,0,0,0,2,2
Tropical Depression,Ten,1,2000-09-11T15:00:00Z,MYGF 266N 787W,0,0,3,7,10
Tropical Depression,Ten,1,2000-09-11T15:00:00Z,MARCO ISLAND FL,0,0,0,4,4
Tropical Depression,Ten,1,2000-09-11T15:00:00Z,BERMUDA,0,0,0,3,3
Tropical Depression,Ten,1,2000-09-11T15:00:00Z,FT MYERS FL,0,0,0,5,5
Tropical Depression,Ten,1,2000-09-11T15:00:00Z,MARATHON FL,0,0,0,2,2
Tropical Depression,Ten,1,2000-09-11T15:00:00Z,VENICE FL,0,0,0,4,4
Tropical Depression,Ten,1,2000-09-11T15:00:00Z,MIAMI FL,0,0,1,4,5
Tropical Depression,Ten,1,2000-09-11T15:00:00Z,TAMPA FL,0,0,0,6,6
Tropical Depression,Ten,1,2000-09-11T15:00:00Z,W PALM BEACH FL,0,0,1,7,8
Tropical Depression,Ten,1,2000-09-11T15:00:00Z,CEDAR KEY FL,0,0,0,6,6
Tropical Depression,Ten,1,2000-09-11T15:00:00Z,FT PIERCE FL,0,0,2,7,9
Tropical Depression,Ten,1,2000-09-11T15:00:00Z,ST MARKS FL,0,0,0,4,4
Tropical Depression,Ten,1,2000-09-11T15:00:00Z,COCOA BEACH FL,0,0,1,8,9
Tropical Depression,Ten,1,2000-09-11T15:00:00Z,APALACHICOLA FL,0,0,0,3,3
Tropical Depression,Ten,1,2000-09-11T15:00:00Z,DAYTONA BEACH FL,0,0,1,8,9
Tropical Depression,Ten,1,2000-09-11T15:00:00Z,PANAMA CITY FL,0,0,0,2,2
Tropical Depression,Ten,1,2000-09-11T15:00:00Z,JACKSONVILLE FL,0,0,0,8,8
Tropical Depression,Ten,1,2000-09-11T15:00:00Z,GULF 29N 85W,0,0,0,3,3
Tropical Storm,Florence,2,2000-09-11T18:00:00Z,30.1N  73.6W,99,0,0,0,99
Tropical Storm,Florence,2,2000-09-11T18:00:00Z,SAVANNAH GA,0,0,0,7,7
Tropical Storm,Florence,2,2000-09-11T18:00:00Z,30.0N  74.0W,42,0,0,0,42
Tropical Storm,Florence,2,2000-09-11T18:00:00Z,CHARLESTON SC,0,0,0,7,7
Tropical Storm,Florence,2,2000-09-11T18:00:00Z,30.0N  74.0W,42,0,0,0,42
Tropical Storm,Florence,2,2000-09-11T18:00:00Z,MYRTLE BEACH SC,0,0,0,6,6
Tropical Storm,Florence,2,2000-09-11T18:00:00Z,MYSM 241N 745W,0,0,0,3,3
Tropical Storm,Florence,2,2000-09-11T18:00:00Z,WILMINGTON NC,0,0,0,6,6
Tropical Storm,Florence,2,2000-09-11T18:00:00Z,MYEG 235N 758W,0,0,0,2,2
Tropical Storm,Florence,2,2000-09-11T18:00:00Z,MOREHEAD CITY NC,0,0,1,4,5
Tropical Storm,Florence,2,2000-09-11T18:00:00Z,MYAK 241N 776W,0,0,0,3,3
Tropical Storm,Florence,2,2000-09-11T18:00:00Z,CAPE HATTERAS NC,0,0,0,4,4
Tropical Storm,Florence,2,2000-09-11T18:00:00Z,MYNN 251N 775W,0,0,2,4,6
Tropical Storm,Florence,2,2000-09-11T18:00:00Z,KEY WEST FL,0,0,0,2,2
Tropical Storm,Florence,2,2000-09-11T18:00:00Z,MYGF 266N 787W,0,0,3,7,10
Tropical Storm,Florence,2,2000-09-11T18:00:00Z,MARCO ISLAND FL,0,0,0,4,4
Tropical Storm,Florence,2,2000-09-11T18:00:00Z,BERMUDA,0,0,0,3,3
Tropical Storm,Florence,2,2000-09-11T18:00:00Z,FT MYERS FL,0,0,0,5,5
Tropical Storm,Florence,2,2000-09-11T18:00:00Z,MARATHON FL,0,0,0,2,2
Tropical Storm,Florence,2,2000-09-11T18:00:00Z,VENICE FL,0,0,0,4,4
Tropical Storm,Florence,2,2000-09-11T18:00:00Z,MIAMI FL,0,0,1,4,5
Tropical Storm,Florence,2,2000-09-11T18:00:00Z,TAMPA FL,0,0,0,6,6
Tropical Storm,Florence,2,2000-09-11T18:00:00Z,W PALM BEACH FL,0,0,1,7,8
Tropical Storm,Florence,2,2000-09-11T18:00:00Z,CEDAR KEY FL,0,0,0,6,6
Tropical Storm,Florence,2,2000-09-11T18:00:00Z,FT PIERCE FL,0,0,2,7,9
Tropical Storm,Florence,2,2000-09-11T18:00:00Z,ST MARKS FL,0,0,0,4,4
Tropical Storm,Florence,2,2000-09-11T18:00:00Z,COCOA BEACH FL,0,0,1,8,9
Tropical Storm,Florence,2,2000-09-11T18:00:00Z,APALACHICOLA FL,0,0,0,3,3
Tropical Storm,Florence,2,2000-09-11T18:00:00Z,DAYTONA BEACH FL,0,0,1,8,9
Tropical Storm,Florence,2,2000-09-11T18:00:00Z,PANAMA CITY FL,0,0,0,2,2
Tropical Storm,Florence,2,2000-09-11T18:00:00Z,JACKSONVILLE FL,0,0,0,8,8
Tropical Storm,Florence,2,2000-09-11T18:00:00Z,GULF 29N 85W,0,0,0,3,3
Tropical Storm,Florence,3,2000-09-11T21:00:00Z,29.6N  74.0W,57,0,0,0,57
Tropical Storm,Florence,3,2000-09-11T21:00:00Z,CHARLESTON SC,0,0,1,8,9
Tropical Storm,Florence,3,2000-09-11T21:00:00Z,29.6N  74.6W,46,0,1,0,47
Tropical Storm,Florence,3,2000-09-11T21:00:00Z,MYRTLE BEACH SC,0,0,1,8,9
Tropical Storm,Florence,3,2000-09-11T21:00:00Z,30.0N  75.0W,39,1,0,0,40
Tropical Storm,Florence,3,2000-09-11T21:00:00Z,WILMINGTON NC,0,0,1,8,9
Tropical Storm,Florence,3,2000-09-11T21:00:00Z,MYSM 241N 745W,0,0,0,2,2
Tropical Storm,Florence,3,2000-09-11T21:00:00Z,MOREHEAD CITY NC,0,0,2,7,9
Tropical Storm,Florence,3,2000-09-11T21:00:00Z,MYEG 235N 758W,0,0,0,2,2
Tropical Storm,Florence,3,2000-09-11T21:00:00Z,CAPE HATTERAS NC,0,0,1,6,7
Tropical Storm,Florence,3,2000-09-11T21:00:00Z,MYAK 241N 776W,0,0,0,3,3
Tropical Storm,Florence,3,2000-09-11T21:00:00Z,NORFOLK VA,0,0,0,3,3
Tropical Storm,Florence,3,2000-09-11T21:00:00Z,MYNN 251N 775W,0,0,1,5,6
Tropical Storm,Florence,3,2000-09-11T21:00:00Z,KEY WEST FL,0,0,0,2,2
Tropical Storm,Florence,3,2000-09-11T21:00:00Z,MYGF 266N 787W,0,0,4,6,10
Tropical Storm,Florence,3,2000-09-11T21:00:00Z,MARCO ISLAND FL,0,0,0,4,4
Tropical Storm,Florence,3,2000-09-11T21:00:00Z,BERMUDA,0,0,0,2,2
Tropical Storm,Florence,3,2000-09-11T21:00:00Z,FT MYERS FL,0,0,0,5,5
Tropical Storm,Florence,3,2000-09-11T21:00:00Z,MARATHON FL,0,0,0,2,2
Tropical Storm,Florence,3,2000-09-11T21:00:00Z,VENICE FL,0,0,0,5,5
Tropical Storm,Florence,3,2000-09-11T21:00:00Z,MIAMI FL,0,0,1,4,5
Tropical Storm,Florence,3,2000-09-11T21:00:00Z,TAMPA FL,0,0,0,6,6
Tropical Storm,Florence,3,2000-09-11T21:00:00Z,W PALM BEACH FL,0,0,1,7,8
Tropical Storm,Florence,3,2000-09-11T21:00:00Z,CEDAR KEY FL,0,0,0,6,6
Tropical Storm,Florence,3,2000-09-11T21:00:00Z,FT PIERCE FL,0,0,2,7,9
Tropical Storm,Florence,3,2000-09-11T21:00:00Z,ST MARKS FL,0,0,0,4,4
Tropical Storm,Florence,3,2000-09-11T21:00:00Z,COCOA BEACH FL,0,0,2,8,10
Tropical Storm,Florence,3,2000-09-11T21:00:00Z,APALACHICOLA FL,0,0,0,3,3
Tropical Storm,Florence,3,2000-09-11T21:00:00Z,DAYTONA BEACH FL,0,0,1,8,9
Tropical Storm,Florence,3,2000-09-11T21:00:00Z,PANAMA CITY FL,0,0,0,2,2
Tropical Storm,Florence,3,2000-09-11T21:00:00Z,JACKSONVILLE FL,0,0,1,7,8
Tropical Storm,Florence,3,2000-09-11T21:00:00Z,GULF 29N 85W,0,0,0,3,3
Tropical Storm,Florence,3,2000-09-11T21:00:00Z,SAVANNAH GA,0,0,0,8,8
Tropical Storm,Florence,4,2000-09-12T03:00:00Z,30.1N  73.9W,99,0,0,0,99
Tropical Storm,Florence,4,2000-09-12T03:00:00Z,SAVANNAH GA,0,0,1,6,7
Tropical Storm,Florence,4,2000-09-12T03:00:00Z,30.6N  74.2W,50,0,0,0,50
Tropical Storm,Florence,4,2000-09-12T03:00:00Z,CHARLESTON SC,0,0,2,7,9
Tropical Storm,Florence,4,2000-09-12T03:00:00Z,31.0N  73.5W,99,0,0,0,99
Tropical Storm,Florence,4,2000-09-12T03:00:00Z,MYRTLE BEACH SC,0,1,1,7,9
Tropical Storm,Florence,4,2000-09-12T03:00:00Z,MYNN 251N 775W,0,0,0,2,2
Tropical Storm,Florence,4,2000-09-12T03:00:00Z,WILMINGTON NC,0,1,1,7,9
Tropical Storm,Florence,4,2000-09-12T03:00:00Z,MYGF 266N 787W,0,0,2,3,5
Tropical Storm,Florence,4,2000-09-12T03:00:00Z,MOREHEAD CITY NC,0,1,1,7,9
Tropical Storm,Florence,4,2000-09-12T03:00:00Z,BERMUDA,0,0,0,5,5
Tropical Storm,Florence,4,2000-09-12T03:00:00Z,CAPE HATTERAS NC,0,0,1,7,8
Tropical Storm,Florence,4,2000-09-12T03:00:00Z,MIAMI FL,0,0,0,2,2
Tropical Storm,Florence,4,2000-09-12T03:00:00Z,NORFOLK VA,0,0,0,3,3
Tropical Storm,Florence,4,2000-09-12T03:00:00Z,W PALM BEACH FL,0,0,1,3,4
Tropical Storm,Florence,4,2000-09-12T03:00:00Z,FT MYERS FL,0,0,0,2,2
Tropical Storm,Florence,4,2000-09-12T03:00:00Z,FT PIERCE FL,0,0,2,3,5
Tropical Storm,Florence,4,2000-09-12T03:00:00Z,VENICE FL,0,0,0,2,2
Tropical Storm,Florence,4,2000-09-12T03:00:00Z,COCOA BEACH FL,0,0,2,4,6
Tropical Storm,Florence,4,2000-09-12T03:00:00Z,TAMPA FL,0,0,0,2,2
Tropical Storm,Florence,4,2000-09-12T03:00:00Z,DAYTONA BEACH FL,0,0,2,5,7
Tropical Storm,Florence,4,2000-09-12T03:00:00Z,CEDAR KEY FL,0,0,0,3,3
Tropical Storm,Florence,4,2000-09-12T03:00:00Z,JACKSONVILLE FL,0,0,1,5,6
Tropical Storm,Florence,4,2000-09-12T03:00:00Z,ST MARKS FL,0,0,0,2,2
Tropical Storm,Florence,5,2000-09-12T09:00:00Z,30.4N  74.0W,99,0,0,0,99
Tropical Storm,Florence,5,2000-09-12T09:00:00Z,JACKSONVILLE FL,0,0,1,5,6
Tropical Storm,Florence,5,2000-09-12T09:00:00Z,30.5N  73.5W,99,0,0,0,99
Tropical Storm,Florence,5,2000-09-12T09:00:00Z,SAVANNAH GA,0,0,1,6,7
Tropical Storm,Florence,5,2000-09-12T09:00:00Z,30.5N  73.0W,99,0,0,0,99
Tropical Storm,Florence,5,2000-09-12T09:00:00Z,CHARLESTON SC,0,0,2,7,9
Tropical Storm,Florence,5,2000-09-12T09:00:00Z,MYSM 241N 745W,0,0,0,2,2
Tropical Storm,Florence,5,2000-09-12T09:00:00Z,MYRTLE BEACH SC,0,0,2,8,10
Tropical Storm,Florence,5,2000-09-12T09:00:00Z,MYNN 251N 775W,0,0,1,1,2
Tropical Storm,Florence,5,2000-09-12T09:00:00Z,WILMINGTON NC,0,1,1,8,10
Tropical Storm,Florence,5,2000-09-12T09:00:00Z,MYGF 266N 787W,0,0,2,2,4
Tropical Storm,Florence,5,2000-09-12T09:00:00Z,MOREHEAD CITY NC,0,1,1,8,10
Tropical Storm,Florence,5,2000-09-12T09:00:00Z,BERMUDA,0,0,0,6,6
Tropical Storm,Florence,5,2000-09-12T09:00:00Z,CAPE HATTERAS NC,0,0,2,6,8
Tropical Storm,Florence,5,2000-09-12T09:00:00Z,W PALM BEACH FL,0,0,1,2,3
Tropical Storm,Florence,5,2000-09-12T09:00:00Z,NORFOLK VA,0,0,0,4,4
Tropical Storm,Florence,5,2000-09-12T09:00:00Z,FT PIERCE FL,0,0,1,3,4
Tropical Storm,Florence,5,2000-09-12T09:00:00Z,TAMPA FL,0,0,0,2,2
Tropical Storm,Florence,5,2000-09-12T09:00:00Z,COCOA BEACH FL,0,0,2,3,5
Tropical Storm,Florence,5,2000-09-12T09:00:00Z,CEDAR KEY FL,0,0,0,2,2
Tropical Storm,Florence,5,2000-09-12T09:00:00Z,DAYTONA BEACH FL,0,0,2,4,6
Tropical Storm,Florence,5,2000-09-12T09:00:00Z,ST MARKS FL,0,0,0,2,2
Tropical Storm,Florence,6,2000-09-12T15:00:00Z,30.5N  73.0W,99,0,0,0,99
Tropical Storm,Florence,6,2000-09-12T15:00:00Z,COCOA BEACH FL,0,0,1,3,4
Tropical Storm,Florence,6,2000-09-12T15:00:00Z,30.7N  72.6W,99,0,0,0,99
Tropical Storm,Florence,6,2000-09-12T15:00:00Z,DAYTONA BEACH FL,0,0,0,3,3
Tropical Storm,Florence,6,2000-09-12T15:00:00Z,31.0N  72.0W,34,0,0,1,35
Tropical Storm,Florence,6,2000-09-12T15:00:00Z,JACKSONVILLE FL,0,0,0,2,2
Tropical Storm,Florence,6,2000-09-12T15:00:00Z,MYMM 224N 730W,0,0,0,3,3
Tropical Storm,Florence,6,2000-09-12T15:00:00Z,SAVANNAH GA,0,0,0,2,2
Tropical Storm,Florence,6,2000-09-12T15:00:00Z,MYSM 241N 745W,0,0,1,5,6
Tropical Storm,Florence,6,2000-09-12T15:00:00Z,CHARLESTON SC,0,0,1,2,3
Tropical Storm,Florence,6,2000-09-12T15:00:00Z,MYEG 235N 758W,0,0,0,4,4
Tropical Storm,Florence,6,2000-09-12T15:00:00Z,MYRTLE BEACH SC,0,0,1,3,4
Tropical Storm,Florence,6,2000-09-12T15:00:00Z,MYAK 241N 776W,0,0,0,4,4
Tropical Storm,Florence,6,2000-09-12T15:00:00Z,WILMINGTON NC,0,0,1,4,5
Tropical Storm,Florence,6,2000-09-12T15:00:00Z,MYNN 251N 775W,0,0,1,5,6
Tropical Storm,Florence,6,2000-09-12T15:00:00Z,MOREHEAD CITY NC,0,0,2,5,7
Tropical Storm,Florence,6,2000-09-12T15:00:00Z,MYGF 266N 787W,0,0,1,6,7
Tropical Storm,Florence,6,2000-09-12T15:00:00Z,CAPE HATTERAS NC,0,0,1,6,7
Tropical Storm,Florence,6,2000-09-12T15:00:00Z,BERMUDA,0,0,0,6,6
Tropical Storm,Florence,6,2000-09-12T15:00:00Z,NORFOLK VA,0,0,0,3,3
Tropical Storm,Florence,6,2000-09-12T15:00:00Z,MARATHON FL,0,0,0,2,2
Tropical Storm,Florence,6,2000-09-12T15:00:00Z,OCEAN CITY MD,0,0,0,2,2
Tropical Storm,Florence,6,2000-09-12T15:00:00Z,MIAMI FL,0,0,0,3,3
Tropical Storm,Florence,6,2000-09-12T15:00:00Z,MARCO ISLAND FL,0,0,0,2,2
Tropical Storm,Florence,6,2000-09-12T15:00:00Z,W PALM BEACH FL,0,0,0,4,4
Tropical Storm,Florence,6,2000-09-12T15:00:00Z,FT MYERS FL,0,0,0,2,2
Tropical Storm,Florence,6,2000-09-12T15:00:00Z,FT PIERCE FL,0,0,1,3,4
Tropical Storm,Florence,6,2000-09-12T15:00:00Z,TAMPA FL,0,0,0,2,2
Hurricane,Florence,7,2000-09-12T21:00:00Z,31.4N  73.5W,99,0,0,0,99
Hurricane,Florence,7,2000-09-12T21:00:00Z,MOREHEAD CITY NC,0,2,5,5,12
Hurricane,Florence,7,2000-09-12T21:00:00Z,31.5N  73.0W,99,0,0,0,99
Hurricane,Florence,7,2000-09-12T21:00:00Z,CAPE HATTERAS NC,0,1,5,7,13
Hurricane,Florence,7,2000-09-12T21:00:00Z,31.7N  72.0W,27,0,1,1,29
Hurricane,Florence,7,2000-09-12T21:00:00Z,NORFOLK VA,0,0,2,7,9
Hurricane,Florence,7,2000-09-12T21:00:00Z,MBJT 215N 712W,0,0,0,2,2
Hurricane,Florence,7,2000-09-12T21:00:00Z,OCEAN CITY MD,0,0,1,7,8
Hurricane,Florence,7,2000-09-12T21:00:00Z,MYMM 224N 730W,0,0,0,2,2
Hurricane,Florence,7,2000-09-12T21:00:00Z,ATLANTIC CITY NJ,0,0,0,6,6
Hurricane,Florence,7,2000-09-12T21:00:00Z,MYSM 241N 745W,0,0,0,3,3
Hurricane,Florence,7,2000-09-12T21:00:00Z,NEW YORK CITY NY,0,0,0,4,4
Hurricane,Florence,7,2000-09-12T21:00:00Z,MYGF 266N 787W,0,0,0,2,2
Hurricane,Florence,7,2000-09-12T21:00:00Z,MONTAUK POINT NY,0,0,0,3,3
Hurricane,Florence,7,2000-09-12T21:00:00Z,BERMUDA,0,0,0,5,5
Hurricane,Florence,7,2000-09-12T21:00:00Z,PROVIDENCE RI,0,0,0,2,2
Hurricane,Florence,7,2000-09-12T21:00:00Z,SAVANNAH GA,0,0,1,1,2
Hurricane,Florence,7,2000-09-12T21:00:00Z,NANTUCKET MA,0,0,0,2,2
Hurricane,Florence,7,2000-09-12T21:00:00Z,CHARLESTON SC,0,1,1,3,5
Hurricane,Florence,7,2000-09-12T21:00:00Z,HYANNIS MA,0,0,0,2,2
Hurricane,Florence,7,2000-09-12T21:00:00Z,MYRTLE BEACH SC,0,1,3,4,8
Hurricane,Florence,7,2000-09-12T21:00:00Z,BOSTON MA,0,0,0,2,2
Hurricane,Florence,7,2000-09-12T21:00:00Z,WILMINGTON NC,0,1,4,5,10
Hurricane,Florence,8,2000-09-13T03:00:00Z,31.6N  73.0W,42,0,0,0,42
Hurricane,Florence,8,2000-09-13T03:00:00Z,NORFOLK VA,0,0,2,4,6
Hurricane,Florence,8,2000-09-13T03:00:00Z,31.8N  71.7W,20,3,1,1,25
Hurricane,Florence,8,2000-09-13T03:00:00Z,OCEAN CITY MD,0,0,1,4,5
Hurricane,Florence,8,2000-09-13T03:00:00Z,32.0N  70.0W,5,7,4,3,19
Hurricane,Florence,8,2000-09-13T03:00:00Z,ATLANTIC CITY NJ,0,0,0,4,4
Hurricane,Florence,8,2000-09-13T03:00:00Z,MBJT 215N 712W,0,0,0,2,2
Hurricane,Florence,8,2000-09-13T03:00:00Z,NEW YORK CITY NY,0,0,0,4,4
Hurricane,Florence,8,2000-09-13T03:00:00Z,MYSM 241N 745W,0,0,0,2,2
Hurricane,Florence,8,2000-09-13T03:00:00Z,MONTAUK POINT NY,0,0,0,4,4
Hurricane,Florence,8,2000-09-13T03:00:00Z,BERMUDA,0,0,1,7,8
Hurricane,Florence,8,2000-09-13T03:00:00Z,PROVIDENCE RI,0,0,0,3,3
Hurricane,Florence,8,2000-09-13T03:00:00Z,MYRTLE BEACH SC,0,1,0,2,3
Hurricane,Florence,8,2000-09-13T03:00:00Z,NANTUCKET MA,0,0,0,4,4
Hurricane,Florence,8,2000-09-13T03:00:00Z,WILMINGTON NC,0,1,2,2,5
Hurricane,Florence,8,2000-09-13T03:00:00Z,HYANNIS MA,0,0,0,3,3
Hurricane,Florence,8,2000-09-13T03:00:00Z,MOREHEAD CITY NC,0,3,2,3,8
Hurricane,Florence,8,2000-09-13T03:00:00Z,BOSTON MA,0,0,0,3,3
Hurricane,Florence,8,2000-09-13T03:00:00Z,CAPE HATTERAS NC,0,2,4,4,10
Hurricane,Florence,8,2000-09-13T03:00:00Z,PORTLAND ME,0,0,0,2,2
Hurricane,Florence,9,2000-09-13T09:00:00Z,31.0N  73.4W,99,0,0,0,99
Hurricane,Florence,9,2000-09-13T09:00:00Z,OCEAN CITY MD,0,0,1,5,6
Hurricane,Florence,9,2000-09-13T09:00:00Z,31.2N  72.0W,21,2,2,1,26
Hurricane,Florence,9,2000-09-13T09:00:00Z,ATLANTIC CITY NJ,0,0,0,5,5
Hurricane,Florence,9,2000-09-13T09:00:00Z,31.5N  70.5W,2,10,5,3,20
Hurricane,Florence,9,2000-09-13T09:00:00Z,NEW YORK CITY NY,0,0,0,5,5
Hurricane,Florence,9,2000-09-13T09:00:00Z,MYSM 241N 745W,0,0,0,2,2
Hurricane,Florence,9,2000-09-13T09:00:00Z,MONTAUK POINT NY,0,0,0,5,5
Hurricane,Florence,9,2000-09-13T09:00:00Z,BERMUDA,0,0,0,9,9
Hurricane,Florence,9,2000-09-13T09:00:00Z,PROVIDENCE RI,0,0,0,4,4
Hurricane,Florence,9,2000-09-13T09:00:00Z,MYRTLE BEACH SC,0,1,1,1,3
Hurricane,Florence,9,2000-09-13T09:00:00Z,NANTUCKET MA,0,0,0,5,5
Hurricane,Florence,9,2000-09-13T09:00:00Z,WILMINGTON NC,0,1,2,2,5
Hurricane,Florence,9,2000-09-13T09:00:00Z,HYANNIS MA,0,0,0,4,4
Hurricane,Florence,9,2000-09-13T09:00:00Z,MOREHEAD CITY NC,0,2,3,3,8
Hurricane,Florence,9,2000-09-13T09:00:00Z,BOSTON MA,0,0,0,4,4
Hurricane,Florence,9,2000-09-13T09:00:00Z,CAPE HATTERAS NC,0,1,4,5,10
Hurricane,Florence,9,2000-09-13T09:00:00Z,PORTLAND ME,0,0,0,2,2
Hurricane,Florence,9,2000-09-13T09:00:00Z,NORFOLK VA,0,0,1,5,6
Hurricane,Florence,10,2000-09-13T15:00:00Z,31.0N  73.0W,99,0,0,0,99
Hurricane,Florence,10,2000-09-13T15:00:00Z,OCEAN CITY MD,0,0,0,7,7
Hurricane,Florence,10,2000-09-13T15:00:00Z,31.3N  71.0W,9,14,1,1,25
Hurricane,Florence,10,2000-09-13T15:00:00Z,ATLANTIC CITY NJ,0,0,0,6,6
Hurricane,Florence,10,2000-09-13T15:00:00Z,32.5N  69.0W,0,4,12,3,19
Hurricane,Florence,10,2000-09-13T15:00:00Z,NEW YORK CITY NY,0,0,0,4,4
Hurricane,Florence,10,2000-09-13T15:00:00Z,BERMUDA,0,0,4,8,12
Hurricane,Florence,10,2000-09-13T15:00:00Z,MONTAUK POINT NY,0,0,0,5,5
Hurricane,Florence,10,2000-09-13T15:00:00Z,JACKSONVILLE FL,0,0,0,2,2
Hurricane,Florence,10,2000-09-13T15:00:00Z,PROVIDENCE RI,0,0,0,4,4
Hurricane,Florence,10,2000-09-13T15:00:00Z,SAVANNAH GA,0,0,0,3,3
Hurricane,Florence,10,2000-09-13T15:00:00Z,NANTUCKET MA,0,0,0,5,5
Hurricane,Florence,10,2000-09-13T15:00:00Z,CHARLESTON SC,0,0,0,4,4
Hurricane,Florence,10,2000-09-13T15:00:00Z,HYANNIS MA,0,0,0,4,4
Hurricane,Florence,10,2000-09-13T15:00:00Z,MYRTLE BEACH SC,0,0,1,5,6
Hurricane,Florence,10,2000-09-13T15:00:00Z,BOSTON MA,0,0,0,3,3
Hurricane,Florence,10,2000-09-13T15:00:00Z,WILMINGTON NC,0,1,1,5,7
Hurricane,Florence,10,2000-09-13T15:00:00Z,PORTLAND ME,0,0,0,2,2
Hurricane,Florence,10,2000-09-13T15:00:00Z,MOREHEAD CITY NC,1,1,2,5,9
Hurricane,Florence,10,2000-09-13T15:00:00Z,YARMOUTH NS,0,0,0,2,2
Hurricane,Florence,10,2000-09-13T15:00:00Z,CAPE HATTERAS NC,0,2,3,5,10
Hurricane,Florence,10,2000-09-13T15:00:00Z,SABLE ISLAND NS,0,0,0,2,2
Hurricane,Florence,10,2000-09-13T15:00:00Z,NORFOLK VA,0,0,1,7,8
Tropical Storm,Florence,11,2000-09-13T21:00:00Z,30.5N  71.7W,32,1,1,0,34
Tropical Storm,Florence,11,2000-09-13T21:00:00Z,PROVIDENCE RI,0,0,0,6,6
Tropical Storm,Florence,11,2000-09-13T21:00:00Z,31.2N  69.1W,3,20,2,0,25
Tropical Storm,Florence,11,2000-09-13T21:00:00Z,NANTUCKET MA,0,0,0,7,7
Tropical Storm,Florence,11,2000-09-13T21:00:00Z,33.0N  66.5W,0,5,13,2,20
Tropical Storm,Florence,11,2000-09-13T21:00:00Z,HYANNIS MA,0,0,0,7,7
Tropical Storm,Florence,11,2000-09-13T21:00:00Z,BERMUDA,0,2,13,3,18
Tropical Storm,Florence,11,2000-09-13T21:00:00Z,BOSTON MA,0,0,0,5,5
Tropical Storm,Florence,11,2000-09-13T21:00:00Z,WILMINGTON NC,0,0,0,2,2
Tropical Storm,Florence,11,2000-09-13T21:00:00Z,PORTLAND ME,0,0,0,4,4
Tropical Storm,Florence,11,2000-09-13T21:00:00Z,MOREHEAD CITY NC,0,0,1,3,4
Tropical Storm,Florence,11,2000-09-13T21:00:00Z,BAR HARBOR ME,0,0,0,3,3
Tropical Storm,Florence,11,2000-09-13T21:00:00Z,CAPE HATTERAS NC,0,0,1,5,6
Tropical Storm,Florence,11,2000-09-13T21:00:00Z,EASTPORT ME,0,0,0,2,2
Tropical Storm,Florence,11,2000-09-13T21:00:00Z,NORFOLK VA,0,0,0,5,5
Tropical Storm,Florence,11,2000-09-13T21:00:00Z,ST JOHN NB,0,0,0,2,2
Tropical Storm,Florence,11,2000-09-13T21:00:00Z,OCEAN CITY MD,0,0,0,6,6
Tropical Storm,Florence,11,2000-09-13T21:00:00Z,YARMOUTH NS,0,0,0,4,4
Tropical Storm,Florence,11,2000-09-13T21:00:00Z,ATLANTIC CITY NJ,0,0,0,6,6
Tropical Storm,Florence,11,2000-09-13T21:00:00Z,HALIFAX NS,0,0,0,2,2
Tropical Storm,Florence,11,2000-09-13T21:00:00Z,NEW YORK CITY NY,0,0,0,6,6
Tropical Storm,Florence,11,2000-09-13T21:00:00Z,SABLE ISLAND NS,0,0,0,2,2
Tropical Storm,Florence,11,2000-09-13T21:00:00Z,MONTAUK POINT NY,0,0,0,7,7
Tropical Storm,Florence,12,2000-09-14T03:00:00Z,30.2N  70.2W,35,1,0,0,36
Tropical Storm,Florence,12,2000-09-14T03:00:00Z,HYANNIS MA,0,0,0,8,8
Tropical Storm,Florence,12,2000-09-14T03:00:00Z,31.5N  67.5W,4,19,2,0,25
Tropical Storm,Florence,12,2000-09-14T03:00:00Z,BOSTON MA,0,0,0,7,7
Tropical Storm,Florence,12,2000-09-14T03:00:00Z,34.0N  65.0W,0,1,15,3,19
Tropical Storm,Florence,12,2000-09-14T03:00:00Z,PORTLAND ME,0,0,0,6,6
Tropical Storm,Florence,12,2000-09-14T03:00:00Z,BERMUDA,0,6,13,1,20
Tropical Storm,Florence,12,2000-09-14T03:00:00Z,BAR HARBOR ME,0,0,0,7,7
Tropical Storm,Florence,12,2000-09-14T03:00:00Z,CAPE HATTERAS NC,0,0,1,1,2
Tropical Storm,Florence,12,2000-09-14T03:00:00Z,EASTPORT ME,0,0,0,6,6
Tropical Storm,Florence,12,2000-09-14T03:00:00Z,NORFOLK VA,0,0,0,2,2
Tropical Storm,Florence,12,2000-09-14T03:00:00Z,ST JOHN NB,0,0,0,6,6
Tropical Storm,Florence,12,2000-09-14T03:00:00Z,OCEAN CITY MD,0,0,0,3,3
Tropical Storm,Florence,12,2000-09-14T03:00:00Z,MONCTON NB,0,0,0,5,5
Tropical Storm,Florence,12,2000-09-14T03:00:00Z,ATLANTIC CITY NJ,0,0,0,4,4
Tropical Storm,Florence,12,2000-09-14T03:00:00Z,YARMOUTH NS,0,0,0,8,8
Tropical Storm,Florence,12,2000-09-14T03:00:00Z,NEW YORK CITY NY,0,0,0,4,4
Tropical Storm,Florence,12,2000-09-14T03:00:00Z,HALIFAX NS,0,0,0,7,7
Tropical Storm,Florence,12,2000-09-14T03:00:00Z,MONTAUK POINT NY,0,0,0,7,7
Tropical Storm,Florence,12,2000-09-14T03:00:00Z,SABLE ISLAND NS,0,0,0,6,6
Tropical Storm,Florence,12,2000-09-14T03:00:00Z,PROVIDENCE RI,0,0,0,7,7
Tropical Storm,Florence,12,2000-09-14T03:00:00Z,SYDNEY NS,0,0,0,3,3
Tropical Storm,Florence,12,2000-09-14T03:00:00Z,NANTUCKET MA,0,0,0,8,8
Tropical Storm,Florence,12,2000-09-14T03:00:00Z,EDDY POINT NS,0,0,0,4,4
Tropical Storm,Florence,13,2000-09-14T09:00:00Z,30.0N  70.5W,37,1,0,0,38
Tropical Storm,Florence,13,2000-09-14T09:00:00Z,PORTLAND ME,0,0,0,7,7
Tropical Storm,Florence,13,2000-09-14T09:00:00Z,31.5N  67.5W,2,21,2,0,25
Tropical Storm,Florence,13,2000-09-14T09:00:00Z,BAR HARBOR ME,0,0,0,8,8
Tropical Storm,Florence,13,2000-09-14T09:00:00Z,34.0N  65.0W,0,1,15,3,19
Tropical Storm,Florence,13,2000-09-14T09:00:00Z,EASTPORT ME,0,0,0,8,8
Tropical Storm,Florence,13,2000-09-14T09:00:00Z,BERMUDA,0,5,13,1,19
Tropical Storm,Florence,13,2000-09-14T09:00:00Z,ST JOHN NB,0,0,0,7,7
Tropical Storm,Florence,13,2000-09-14T09:00:00Z,CAPE HATTERAS NC,0,0,1,1,2
Tropical Storm,Florence,13,2000-09-14T09:00:00Z,MONCTON NB,0,0,0,6,6
Tropical Storm,Florence,13,2000-09-14T09:00:00Z,OCEAN CITY MD,0,0,0,3,3
Tropical Storm,Florence,13,2000-09-14T09:00:00Z,YARMOUTH NS,0,0,0,9,9
Tropical Storm,Florence,13,2000-09-14T09:00:00Z,ATLANTIC CITY NJ,0,0,0,4,4
Tropical Storm,Florence,13,2000-09-14T09:00:00Z,HALIFAX NS,0,0,0,8,8
Tropical Storm,Florence,13,2000-09-14T09:00:00Z,NEW YORK CITY NY,0,0,0,5,5
Tropical Storm,Florence,13,2000-09-14T09:00:00Z,SABLE ISLAND NS,0,0,0,7,7
Tropical Storm,Florence,13,2000-09-14T09:00:00Z,MONTAUK POINT NY,0,0,0,7,7
Tropical Storm,Florence,13,2000-09-14T09:00:00Z,SYDNEY NS,0,0,0,4,4
Tropical Storm,Florence,13,2000-09-14T09:00:00Z,PROVIDENCE RI,0,0,0,7,7
Tropical Storm,Florence,13,2000-09-14T09:00:00Z,EDDY POINT NS,0,0,0,6,6
Tropical Storm,Florence,13,2000-09-14T09:00:00Z,NANTUCKET MA,0,0,0,9,9
Tropical Storm,Florence,13,2000-09-14T09:00:00Z,PTX BASQUES NFLD,0,0,0,2,2
Tropical Storm,Florence,13,2000-09-14T09:00:00Z,HYANNIS MA,0,0,0,9,9
Tropical Storm,Florence,13,2000-09-14T09:00:00Z,BURGEO NFLD,0,0,0,2,2
Tropical Storm,Florence,13,2000-09-14T09:00:00Z,BOSTON MA,0,0,0,7,7
Tropical Storm,Florence,13,2000-09-14T09:00:00Z,ILE ST PIERRE,0,0,0,2,2
Tropical Storm,Florence,14,2000-09-14T15:00:00Z,30.3N  70.1W,38,10,0,0,48
Tropical Storm,Florence,14,2000-09-14T15:00:00Z,EASTPORT ME,0,0,0,10,10
Tropical Storm,Florence,14,2000-09-14T15:00:00Z,32.4N  66.6W,0,25,6,0,31
Tropical Storm,Florence,14,2000-09-14T15:00:00Z,ST JOHN NB,0,0,0,10,10
Tropical Storm,Florence,14,2000-09-14T15:00:00Z,36.0N  64.0W,0,0,18,2,20
Tropical Storm,Florence,14,2000-09-14T15:00:00Z,MONCTON NB,0,0,0,10,10
Tropical Storm,Florence,14,2000-09-14T15:00:00Z,BERMUDA,0,8,14,1,23
Tropical Storm,Florence,14,2000-09-14T15:00:00Z,YARMOUTH NS,0,0,0,11,11
Tropical Storm,Florence,14,2000-09-14T15:00:00Z,ATLANTIC CITY NJ,0,0,0,2,2
Tropical Storm,Florence,14,2000-09-14T15:00:00Z,HALIFAX NS,0,0,0,11,11
Tropical Storm,Florence,14,2000-09-14T15:00:00Z,NEW YORK CITY NY,0,0,0,4,4
Tropical Storm,Florence,14,2000-09-14T15:00:00Z,SABLE ISLAND NS,0,0,0,11,11
Tropical Storm,Florence,14,2000-09-14T15:00:00Z,MONTAUK POINT NY,0,0,0,6,6
Tropical Storm,Florence,14,2000-09-14T15:00:00Z,SYDNEY NS,0,0,0,9,9
Tropical Storm,Florence,14,2000-09-14T15:00:00Z,PROVIDENCE RI,0,0,0,7,7
Tropical Storm,Florence,14,2000-09-14T15:00:00Z,EDDY POINT NS,0,0,0,10,10
Tropical Storm,Florence,14,2000-09-14T15:00:00Z,NANTUCKET MA,0,0,1,8,9
Tropical Storm,Florence,14,2000-09-14T15:00:00Z,PTX BASQUES NFLD,0,0,0,7,7
Tropical Storm,Florence,14,2000-09-14T15:00:00Z,HYANNIS MA,0,0,0,9,9
Tropical Storm,Florence,14,2000-09-14T15:00:00Z,BURGEO NFLD,0,0,0,6,6
Tropical Storm,Florence,14,2000-09-14T15:00:00Z,BOSTON MA,0,0,0,8,8
Tropical Storm,Florence,14,2000-09-14T15:00:00Z,ILE ST PIERRE,0,0,0,6,6
Tropical Storm,Florence,14,2000-09-14T15:00:00Z,PORTLAND ME,0,0,0,8,8
Tropical Storm,Florence,14,2000-09-14T15:00:00Z,CAPE RACE NFLD,0,0,0,4,4
Tropical Storm,Florence,14,2000-09-14T15:00:00Z,BAR HARBOR ME,0,0,0,10,10
Tropical Storm,Florence,15,2000-09-14T21:00:00Z,30.0N  68.5W,41,8,0,0,49
Tropical Storm,Florence,15,2000-09-14T21:00:00Z,ST JOHN NB,0,0,0,10,10
Tropical Storm,Florence,15,2000-09-14T21:00:00Z,33.0N  65.0W,0,25,6,0,31
Tropical Storm,Florence,15,2000-09-14T21:00:00Z,MONCTON NB,0,0,0,11,11
Tropical Storm,Florence,15,2000-09-14T21:00:00Z,37.0N  62.0W,0,0,17,3,20
Tropical Storm,Florence,15,2000-09-14T21:00:00Z,YARMOUTH NS,0,0,0,11,11
Tropical Storm,Florence,15,2000-09-14T21:00:00Z,BERMUDA,0,25,5,0,30
Tropical Storm,Florence,15,2000-09-14T21:00:00Z,HALIFAX NS,0,0,0,13,13
Tropical Storm,Florence,15,2000-09-14T21:00:00Z,MONTAUK POINT NY,0,0,0,2,2
Tropical Storm,Florence,15,2000-09-14T21:00:00Z,SABLE ISLAND NS,0,0,0,14,14
Tropical Storm,Florence,15,2000-09-14T21:00:00Z,PROVIDENCE RI,0,0,0,2,2
Tropical Storm,Florence,15,2000-09-14T21:00:00Z,SYDNEY NS,0,0,0,13,13
Tropical Storm,Florence,15,2000-09-14T21:00:00Z,NANTUCKET MA,0,0,0,4,4
Tropical Storm,Florence,15,2000-09-14T21:00:00Z,EDDY POINT NS,0,0,0,13,13
Tropical Storm,Florence,15,2000-09-14T21:00:00Z,HYANNIS MA,0,0,0,4,4
Tropical Storm,Florence,15,2000-09-14T21:00:00Z,PTX BASQUES NFLD,0,0,0,12,12
Tropical Storm,Florence,15,2000-09-14T21:00:00Z,BOSTON MA,0,0,0,3,3
Tropical Storm,Florence,15,2000-09-14T21:00:00Z,BURGEO NFLD,0,0,0,11,11
Tropical Storm,Florence,15,2000-09-14T21:00:00Z,PORTLAND ME,0,0,0,4,4
Tropical Storm,Florence,15,2000-09-14T21:00:00Z,ILE ST PIERRE,0,0,0,11,11
Tropical Storm,Florence,15,2000-09-14T21:00:00Z,BAR HARBOR ME,0,0,0,7,7
Tropical Storm,Florence,15,2000-09-14T21:00:00Z,CAPE RACE NFLD,0,0,0,8,8
Tropical Storm,Florence,15,2000-09-14T21:00:00Z,EASTPORT ME,0,0,0,9,9
Tropical Storm,Florence,15,2000-09-14T21:00:00Z,HIBERNIA OILFLD,0,0,0,2,2
Tropical Storm,Florence,16,2000-09-15T03:00:00Z,30.0N  69.5W,41,8,0,0,49
Tropical Storm,Florence,16,2000-09-15T03:00:00Z,ST JOHN NB,0,0,0,10,10
Tropical Storm,Florence,16,2000-09-15T03:00:00Z,32.0N  66.0W,0,27,6,0,33
Tropical Storm,Florence,16,2000-09-15T03:00:00Z,MONCTON NB,0,0,0,10,10
Tropical Storm,Florence,16,2000-09-15T03:00:00Z,36.0N  63.0W,0,0,18,4,22
Tropical Storm,Florence,16,2000-09-15T03:00:00Z,YARMOUTH NS,0,0,0,10,10
Tropical Storm,Florence,16,2000-09-15T03:00:00Z,BERMUDA,0,13,15,0,28
Tropical Storm,Florence,16,2000-09-15T03:00:00Z,HALIFAX NS,0,0,0,12,12
Tropical Storm,Florence,16,2000-09-15T03:00:00Z,MONTAUK POINT NY,0,0,0,2,2
Tropical Storm,Florence,16,2000-09-15T03:00:00Z,SABLE ISLAND NS,0,0,0,14,14
Tropical Storm,Florence,16,2000-09-15T03:00:00Z,PROVIDENCE RI,0,0,0,3,3
Tropical Storm,Florence,16,2000-09-15T03:00:00Z,SYDNEY NS,0,0,0,12,12
Tropical Storm,Florence,16,2000-09-15T03:00:00Z,NANTUCKET MA,0,0,0,5,5
Tropical Storm,Florence,16,2000-09-15T03:00:00Z,EDDY POINT NS,0,0,0,12,12
Tropical Storm,Florence,16,2000-09-15T03:00:00Z,HYANNIS MA,0,0,0,5,5
Tropical Storm,Florence,16,2000-09-15T03:00:00Z,PTX BASQUES NFLD,0,0,0,11,11
Tropical Storm,Florence,16,2000-09-15T03:00:00Z,BOSTON MA,0,0,0,3,3
Tropical Storm,Florence,16,2000-09-15T03:00:00Z,BURGEO NFLD,0,0,0,10,10
Tropical Storm,Florence,16,2000-09-15T03:00:00Z,PORTLAND ME,0,0,0,4,4
Tropical Storm,Florence,16,2000-09-15T03:00:00Z,ILE ST PIERRE,0,0,0,11,11
Tropical Storm,Florence,16,2000-09-15T03:00:00Z,BAR HARBOR ME,0,0,0,7,7
Tropical Storm,Florence,16,2000-09-15T03:00:00Z,CAPE RACE NFLD,0,0,0,8,8
Tropical Storm,Florence,16,2000-09-15T03:00:00Z,EASTPORT ME,0,0,0,9,9
Tropical Storm,Florence,16,2000-09-15T03:00:00Z,HIBERNIA OILFLD,0,0,0,4,4
Tropical Storm,Florence,17,2000-09-15T09:00:00Z,32.3N  66.3W,26,7,0,0,33
Tropical Storm,Florence,17,2000-09-15T09:00:00Z,HALIFAX NS,0,0,1,5,6
Tropical Storm,Florence,17,2000-09-15T09:00:00Z,36.0N  62.0W,0,13,4,1,18
Tropical Storm,Florence,17,2000-09-15T09:00:00Z,SABLE ISLAND NS,0,0,4,6,10
Tropical Storm,Florence,17,2000-09-15T09:00:00Z,41.0N  58.0W,0,1,8,4,13
Tropical Storm,Florence,17,2000-09-15T09:00:00Z,SYDNEY NS,0,0,1,8,9
Tropical Storm,Florence,17,2000-09-15T09:00:00Z,BERMUDA,9,16,0,0,25
Tropical Storm,Florence,17,2000-09-15T09:00:00Z,EDDY POINT NS,0,0,2,6,8
Tropical Storm,Florence,17,2000-09-15T09:00:00Z,BAR HARBOR ME,0,0,0,2,2
Tropical Storm,Florence,17,2000-09-15T09:00:00Z,PTX BASQUES NFLD,0,0,1,8,9
Tropical Storm,Florence,17,2000-09-15T09:00:00Z,EASTPORT ME,0,0,0,3,3
Tropical Storm,Florence,17,2000-09-15T09:00:00Z,BURGEO NFLD,0,0,1,9,10
Tropical Storm,Florence,17,2000-09-15T09:00:00Z,ST JOHN NB,0,0,0,3,3
Tropical Storm,Florence,17,2000-09-15T09:00:00Z,ILE ST PIERRE,0,0,1,10,11
Tropical Storm,Florence,17,2000-09-15T09:00:00Z,MONCTON NB,0,0,0,5,5
Tropical Storm,Florence,17,2000-09-15T09:00:00Z,CAPE RACE NFLD,0,0,1,10,11
Tropical Storm,Florence,17,2000-09-15T09:00:00Z,YARMOUTH NS,0,0,1,3,4
Tropical Storm,Florence,17,2000-09-15T09:00:00Z,HIBERNIA OILFLD,0,0,0,9,9
Tropical Storm,Florence,18,2000-09-15T15:00:00Z,33.3N  65.5W,24,4,0,0,28
Tropical Storm,Florence,18,2000-09-15T15:00:00Z,YARMOUTH NS,0,0,3,4,7
Tropical Storm,Florence,18,2000-09-15T15:00:00Z,36.0N  62.0W,0,14,3,0,17
Tropical Storm,Florence,18,2000-09-15T15:00:00Z,HALIFAX NS,0,0,3,5,8
Tropical Storm,Florence,18,2000-09-15T15:00:00Z,39.5N  59.0W,0,1,10,3,14
Tropical Storm,Florence,18,2000-09-15T15:00:00Z,SABLE ISLAND NS,0,0,4,7,11
Tropical Storm,Florence,18,2000-09-15T15:00:00Z,BERMUDA,18,7,0,0,25
Tropical Storm,Florence,18,2000-09-15T15:00:00Z,SYDNEY NS,0,0,1,9,10
Tropical Storm,Florence,18,2000-09-15T15:00:00Z,NANTUCKET MA,0,0,2,1,3
Tropical Storm,Florence,18,2000-09-15T15:00:00Z,EDDY POINT NS,0,0,2,8,10
Tropical Storm,Florence,18,2000-09-15T15:00:00Z,HYANNIS MA,0,0,1,1,2
Tropical Storm,Florence,18,2000-09-15T15:00:00Z,PTX BASQUES NFLD,0,0,0,9,9
Tropical Storm,Florence,18,2000-09-15T15:00:00Z,PORTLAND ME,0,0,1,1,2
Tropical Storm,Florence,18,2000-09-15T15:00:00Z,BURGEO NFLD,0,0,0,10,10
Tropical Storm,Florence,18,2000-09-15T15:00:00Z,BAR HARBOR ME,0,0,1,2,3
Tropical Storm,Florence,18,2000-09-15T15:00:00Z,ILE ST PIERRE,0,0,0,11,11
Tropical Storm,Florence,18,2000-09-15T15:00:00Z,EASTPORT ME,0,0,1,4,5
Tropical Storm,Florence,18,2000-09-15T15:00:00Z,CAPE RACE NFLD,0,0,0,10,10
Tropical Storm,Florence,18,2000-09-15T15:00:00Z,ST JOHN NB,0,0,1,5,6
Tropical Storm,Florence,18,2000-09-15T15:00:00Z,HIBERNIA OILFLD,0,0,0,7,7
Tropical Storm,Florence,18,2000-09-15T15:00:00Z,MONCTON NB,0,0,1,5,6
Tropical Storm,Florence,19,2000-09-15T21:00:00Z,33.5N  64.5W,34,9,0,0,43
Tropical Storm,Florence,19,2000-09-15T21:00:00Z,EDDY POINT NS,0,0,1,5,6
Tropical Storm,Florence,19,2000-09-15T21:00:00Z,36.5N  60.0W,0,17,9,0,26
Tropical Storm,Florence,19,2000-09-15T21:00:00Z,PTX BASQUES NFLD,0,0,1,7,8
Tropical Storm,Florence,19,2000-09-15T21:00:00Z,42.0N  55.0W,0,0,11,5,16
Tropical Storm,Florence,19,2000-09-15T21:00:00Z,BURGEO NFLD,0,0,1,9,10
Tropical Storm,Florence,19,2000-09-15T21:00:00Z,BERMUDA,44,3,0,0,47
Tropical Storm,Florence,19,2000-09-15T21:00:00Z,ILE ST PIERRE,0,0,2,11,13
Tropical Storm,Florence,19,2000-09-15T21:00:00Z,HALIFAX NS,0,0,1,2,3
Tropical Storm,Florence,19,2000-09-15T21:00:00Z,CAPE RACE NFLD,0,0,2,12,14
Tropical Storm,Florence,19,2000-09-15T21:00:00Z,SABLE ISLAND NS,0,0,5,5,10
Tropical Storm,Florence,19,2000-09-15T21:00:00Z,HIBERNIA OILFLD,0,0,0,11,11
Tropical Storm,Florence,19,2000-09-15T21:00:00Z,SYDNEY NS,0,0,1,7,8
Hurricane,Florence,20,2000-09-16T03:00:00Z,36.4N  58.9W,15,4,1,0,20
Hurricane,Florence,20,2000-09-16T03:00:00Z,EDDY POINT NS,0,2,2,1,5
Hurricane,Florence,20,2000-09-16T03:00:00Z,40.2N  55.2W,0,13,2,1,16
Hurricane,Florence,20,2000-09-16T03:00:00Z,PTX BASQUES NFLD,0,1,5,1,7
Hurricane,Florence,20,2000-09-16T03:00:00Z,44.4N  51.7W,0,2,9,2,13
Hurricane,Florence,20,2000-09-16T03:00:00Z,BURGEO NFLD,0,1,6,2,9
Hurricane,Florence,20,2000-09-16T03:00:00Z,BERMUDA,64,0,0,0,64
Hurricane,Florence,20,2000-09-16T03:00:00Z,ILE ST PIERRE,0,2,7,2,11
Hurricane,Florence,20,2000-09-16T03:00:00Z,HALIFAX NS,0,1,1,0,2
Hurricane,Florence,20,2000-09-16T03:00:00Z,CAPE RACE NFLD,0,1,9,2,12
Hurricane,Florence,20,2000-09-16T03:00:00Z,SABLE ISLAND NS,0,6,2,0,8
Hurricane,Florence,20,2000-09-16T03:00:00Z,HIBERNIA OILFLD,0,0,4,7,11
Hurricane,Florence,20,2000-09-16T03:00:00Z,SYDNEY NS,0,2,4,0,6
Hurricane,Florence,21,2000-09-16T09:00:00Z,39.0N  57.5W,13,6,0,0,19
Hurricane,Florence,21,2000-09-16T09:00:00Z,EDDY POINT NS,0,3,1,0,4
Hurricane,Florence,21,2000-09-16T09:00:00Z,43.5N  53.0W,0,11,5,0,16
Hurricane,Florence,21,2000-09-16T09:00:00Z,PTX BASQUES NFLD,0,3,3,0,6
Hurricane,Florence,21,2000-09-16T09:00:00Z,50.0N  49.0W,0,0,9,3,12
Hurricane,Florence,21,2000-09-16T09:00:00Z,BURGEO NFLD,0,4,4,0,8
Hurricane,Florence,21,2000-09-16T09:00:00Z,BERMUDA,99,0,0,0,99
Hurricane,Florence,21,2000-09-16T09:00:00Z,ILE ST PIERRE,0,6,5,0,11
Hurricane,Florence,21,2000-09-16T09:00:00Z,SABLE ISLAND NS,1,6,1,0,8
Hurricane,Florence,21,2000-09-16T09:00:00Z,CAPE RACE NFLD,0,5,9,0,14
Hurricane,Florence,21,2000-09-16T09:00:00Z,SYDNEY NS,0,4,1,0,5
Hurricane,Florence,21,2000-09-16T09:00:00Z,HIBERNIA OILFLD,0,1,9,1,11
Hurricane,Florence,23,2000-09-16T21:00:00Z,46.0N  52.0W,17,7,0,0,24
Hurricane,Florence,23,2000-09-16T21:00:00Z,ILE ST PIERRE,7,2,0,0,9
Hurricane,Florence,23,2000-09-16T21:00:00Z,52.0N  50.0W,0,14,0,0,14
Hurricane,Florence,23,2000-09-16T21:00:00Z,CAPE RACE NFLD,15,7,0,0,22
Hurricane,Florence,23,2000-09-16T21:00:00Z,BURGEO NFLD,2,1,0,0,3
Hurricane,Florence,23,2000-09-16T21:00:00Z,HIBERNIA OILFLD,1,13,0,0,14
Tropical Storm,Florence,24,2000-09-17T03:00:00Z,48.5N  51.3W,16,6,0,0,22
Tropical Storm,Florence,24,2000-09-17T03:00:00Z,ILE ST PIERRE,8,1,0,0,9
Tropical Storm,Florence,24,2000-09-17T03:00:00Z,54.8N  50.5W,0,15,0,0,15
Tropical Storm,Florence,24,2000-09-17T03:00:00Z,CAPE RACE NFLD,22,1,0,0,23
Tropical Storm,Florence,24,2000-09-17T03:00:00Z,PTX BASQUES NFLD,1,1,0,0,2
Tropical Storm,Florence,24,2000-09-17T03:00:00Z,HIBERNIA OILFLD,11,6,0,0,17
Tropical Storm,Florence,24,2000-09-17T03:00:00Z,BURGEO NFLD,4,1,0,0,5
Tropical Storm,Florence,25,2000-09-17T09:00:00Z,52.1N  51.3W,15,0,0,0,15
Tropical Storm,Florence,25,2000-09-17T09:00:00Z,CAPE RACE NFLD,32,0,0,0,32
Tropical Storm,Florence,25,2000-09-17T09:00:00Z,BURGEO NFLD,2,0,0,0,2
Tropical Storm,Florence,25,2000-09-17T09:00:00Z,HIBERNIA OILFLD,14,0,0,0,14
Tropical Storm,Florence,25,2000-09-17T09:00:00Z,ILE ST PIERRE,4,0,0,0,4
Tropical Storm,Florence,26,2000-09-17T15:00:00Z,57.0N  52.4W,19,0,0,0,19
Tropical Storm,Florence,26,2000-09-17T15:00:00Z,CAPE RACE NFLD,44,0,0,0,44
Tropical Storm,Florence,26,2000-09-17T15:00:00Z,ILE ST PIERRE,2,0,0,0,2
Tropical Storm,Florence,26,2000-09-17T15:00:00Z,HIBERNIA OILFLD,16,0,0,0,16
Tropical Depression,Eleven,1,2000-09-14T15:00:00Z,21.5N  90.0W,46,0,0,0,46
Tropical Depression,Eleven,1,2000-09-14T15:00:00Z,MOBILE AL,0,0,0,3,3
Tropical Depression,Eleven,1,2000-09-14T15:00:00Z,22.0N  90.3W,36,1,0,0,37
Tropical Depression,Eleven,1,2000-09-14T15:00:00Z,GULFPORT MS,0,0,0,4,4
Tropical Depression,Eleven,1,2000-09-14T15:00:00Z,22.7N  90.6W,25,2,1,0,28
Tropical Depression,Eleven,1,2000-09-14T15:00:00Z,BURAS LA,0,0,1,6,7
Tropical Depression,Eleven,1,2000-09-14T15:00:00Z,MUSN 216N 826W,0,0,1,2,3
Tropical Depression,Eleven,1,2000-09-14T15:00:00Z,NEW ORLEANS LA,0,0,0,6,6
Tropical Depression,Eleven,1,2000-09-14T15:00:00Z,MUHA 230N 824W,0,0,0,3,3
Tropical Depression,Eleven,1,2000-09-14T15:00:00Z,NEW IBERIA LA,0,0,0,7,7
Tropical Depression,Eleven,1,2000-09-14T15:00:00Z,MUAN 219N 850W,0,2,4,4,10
Tropical Depression,Eleven,1,2000-09-14T15:00:00Z,PORT ARTHUR TX,0,0,0,6,6
Tropical Depression,Eleven,1,2000-09-14T15:00:00Z,MMCZ 205N 869W,99,0,0,0,99
Tropical Depression,Eleven,1,2000-09-14T15:00:00Z,GALVESTON TX,0,0,0,7,7
Tropical Depression,Eleven,1,2000-09-14T15:00:00Z,MZBZ 175N 883W,0,0,2,4,6
Tropical Depression,Eleven,1,2000-09-14T15:00:00Z,FREEPORT TX,0,0,0,7,7
Tropical Depression,Eleven,1,2000-09-14T15:00:00Z,MGPB 157N 886W,0,0,0,2,2
Tropical Depression,Eleven,1,2000-09-14T15:00:00Z,PORT O CONNOR TX,0,0,0,6,6
Tropical Depression,Eleven,1,2000-09-14T15:00:00Z,MHNJ 165N 859W,0,0,0,3,3
Tropical Depression,Eleven,1,2000-09-14T15:00:00Z,CORPUSCHRISTI TX,0,0,0,5,5
Tropical Depression,Eleven,1,2000-09-14T15:00:00Z,MMSO 238N 982W,0,0,0,5,5
Tropical Depression,Eleven,1,2000-09-14T15:00:00Z,BROWNSVILLE TX,0,0,1,6,7
Tropical Depression,Eleven,1,2000-09-14T15:00:00Z,MMTM 222N 979W,0,0,0,4,4
Tropical Depression,Eleven,1,2000-09-14T15:00:00Z,GULF 29N 85W,0,0,0,2,2
Tropical Depression,Eleven,1,2000-09-14T15:00:00Z,MMTX 210N 974W,0,0,0,4,4
Tropical Depression,Eleven,1,2000-09-14T15:00:00Z,GULF 29N 87W,0,0,0,5,5
Tropical Depression,Eleven,1,2000-09-14T15:00:00Z,MMVR 192N 961W,0,0,0,3,3
Tropical Depression,Eleven,1,2000-09-14T15:00:00Z,GULF 28N 89W,0,0,2,7,9
Tropical Depression,Eleven,1,2000-09-14T15:00:00Z,MMFR 185N 926W,0,1,1,5,7
Tropical Depression,Eleven,1,2000-09-14T15:00:00Z,GULF 28N 91W,0,0,3,8,11
Tropical Depression,Eleven,1,2000-09-14T15:00:00Z,MMMD 210N 897W,54,0,0,0,54
Tropical Depression,Eleven,1,2000-09-14T15:00:00Z,GULF 28N 93W,0,0,3,8,11
Tropical Depression,Eleven,1,2000-09-14T15:00:00Z,KEY WEST FL,0,0,0,2,2
Tropical Depression,Eleven,1,2000-09-14T15:00:00Z,GULF 28N 95W,0,0,1,8,9
Tropical Depression,Eleven,1,2000-09-14T15:00:00Z,APALACHICOLA FL,0,0,0,2,2
Tropical Depression,Eleven,1,2000-09-14T15:00:00Z,GULF 27N 96W,0,0,1,8,9
Tropical Depression,Eleven,1,2000-09-14T15:00:00Z,PANAMA CITY FL,0,0,0,2,2
Tropical Depression,Eleven,1,2000-09-14T15:00:00Z,GULF 25N 96W,0,0,3,7,10
Tropical Depression,Eleven,1,2000-09-14T15:00:00Z,PENSACOLA FL,0,0,0,3,3
Tropical Depression,Eleven,2,2000-09-14T21:00:00Z,21.2N  89.5W,45,0,0,0,45
Tropical Depression,Eleven,2,2000-09-14T21:00:00Z,GULFPORT MS,0,0,0,2,2
Tropical Depression,Eleven,2,2000-09-14T21:00:00Z,21.9N  90.4W,26,2,1,0,29
Tropical Depression,Eleven,2,2000-09-14T21:00:00Z,BURAS LA,0,0,0,4,4
Tropical Depression,Eleven,2,2000-09-14T21:00:00Z,22.5N  91.0W,10,12,1,1,24
Tropical Depression,Eleven,2,2000-09-14T21:00:00Z,NEW ORLEANS LA,0,0,0,3,3
Tropical Depression,Eleven,2,2000-09-14T21:00:00Z,MUSN 216N 826W,0,0,1,2,3
Tropical Depression,Eleven,2,2000-09-14T21:00:00Z,NEW IBERIA LA,0,0,0,4,4
Tropical Depression,Eleven,2,2000-09-14T21:00:00Z,MUHA 230N 824W,0,0,1,2,3
Tropical Depression,Eleven,2,2000-09-14T21:00:00Z,PORT ARTHUR TX,0,0,0,4,4
Tropical Depression,Eleven,2,2000-09-14T21:00:00Z,MUAN 219N 850W,0,3,3,3,9
Tropical Depression,Eleven,2,2000-09-14T21:00:00Z,GALVESTON TX,0,0,0,5,5
Tropical Depression,Eleven,2,2000-09-14T21:00:00Z,MMCZ 205N 869W,99,0,0,0,99
Tropical Depression,Eleven,2,2000-09-14T21:00:00Z,FREEPORT TX,0,0,0,6,6
Tropical Depression,Eleven,2,2000-09-14T21:00:00Z,MZBZ 175N 883W,0,1,0,4,5
Tropical Depression,Eleven,2,2000-09-14T21:00:00Z,PORT O CONNOR TX,0,0,0,6,6
Tropical Depression,Eleven,2,2000-09-14T21:00:00Z,MHNJ 165N 859W,0,0,0,2,2
Tropical Depression,Eleven,2,2000-09-14T21:00:00Z,CORPUSCHRISTI TX,0,0,0,6,6
Tropical Depression,Eleven,2,2000-09-14T21:00:00Z,MMSO 238N 982W,0,0,1,6,7
Tropical Depression,Eleven,2,2000-09-14T21:00:00Z,BROWNSVILLE TX,0,0,1,7,8
Tropical Depression,Eleven,2,2000-09-14T21:00:00Z,MMTM 222N 979W,0,0,1,6,7
Tropical Depression,Eleven,2,2000-09-14T21:00:00Z,GULF 29N 87W,0,0,0,3,3
Tropical Depression,Eleven,2,2000-09-14T21:00:00Z,MMTX 210N 974W,0,0,1,5,6
Tropical Depression,Eleven,2,2000-09-14T21:00:00Z,GULF 28N 89W,0,0,1,5,6
Tropical Depression,Eleven,2,2000-09-14T21:00:00Z,MMVR 192N 961W,0,0,1,3,4
Tropical Depression,Eleven,2,2000-09-14T21:00:00Z,GULF 28N 91W,0,0,1,7,8
Tropical Depression,Eleven,2,2000-09-14T21:00:00Z,MMFR 185N 926W,0,1,2,4,7
Tropical Depression,Eleven,2,2000-09-14T21:00:00Z,GULF 28N 93W,0,0,1,7,8
Tropical Depression,Eleven,2,2000-09-14T21:00:00Z,MMMD 210N 897W,41,0,0,0,41
Tropical Depression,Eleven,2,2000-09-14T21:00:00Z,GULF 28N 95W,0,0,1,7,8
Tropical Depression,Eleven,2,2000-09-14T21:00:00Z,KEY WEST FL,0,0,0,2,2
Tropical Depression,Eleven,2,2000-09-14T21:00:00Z,GULF 27N 96W,0,0,1,8,9
Tropical Depression,Eleven,2,2000-09-14T21:00:00Z,MOBILE AL,0,0,0,2,2
Tropical Depression,Eleven,2,2000-09-14T21:00:00Z,GULF 25N 96W,0,0,4,7,11
Tropical Depression,Eleven,3,2000-09-15T03:00:00Z,21.5N  89.5W,61,0,0,0,61
Tropical Depression,Eleven,3,2000-09-15T03:00:00Z,GULFPORT MS,0,0,0,3,3
Tropical Depression,Eleven,3,2000-09-15T03:00:00Z,22.3N  90.4W,29,2,0,1,32
Tropical Depression,Eleven,3,2000-09-15T03:00:00Z,BURAS LA,0,0,0,5,5
Tropical Depression,Eleven,3,2000-09-15T03:00:00Z,23.0N  91.0W,12,13,1,0,26
Tropical Depression,Eleven,3,2000-09-15T03:00:00Z,NEW ORLEANS LA,0,0,0,4,4
Tropical Depression,Eleven,3,2000-09-15T03:00:00Z,MUSN 216N 826W,0,0,1,2,3
Tropical Depression,Eleven,3,2000-09-15T03:00:00Z,NEW IBERIA LA,0,0,0,5,5
Tropical Depression,Eleven,3,2000-09-15T03:00:00Z,MUHA 230N 824W,0,0,1,2,3
Tropical Depression,Eleven,3,2000-09-15T03:00:00Z,PORT ARTHUR TX,0,0,0,5,5
Tropical Depression,Eleven,3,2000-09-15T03:00:00Z,MUAN 219N 850W,0,3,3,3,9
Tropical Depression,Eleven,3,2000-09-15T03:00:00Z,GALVESTON TX,0,0,0,6,6
Tropical Depression,Eleven,3,2000-09-15T03:00:00Z,MMCZ 205N 869W,37,0,0,0,37
Tropical Depression,Eleven,3,2000-09-15T03:00:00Z,FREEPORT TX,0,0,0,6,6
Tropical Depression,Eleven,3,2000-09-15T03:00:00Z,MZBZ 175N 883W,0,0,0,3,3
Tropical Depression,Eleven,3,2000-09-15T03:00:00Z,PORT O CONNOR TX,0,0,0,6,6
Tropical Depression,Eleven,3,2000-09-15T03:00:00Z,MMSO 238N 982W,0,0,2,5,7
Tropical Depression,Eleven,3,2000-09-15T03:00:00Z,CORPUSCHRISTI TX,0,0,0,6,6
Tropical Depression,Eleven,3,2000-09-15T03:00:00Z,MMTM 222N 979W,0,0,1,5,6
Tropical Depression,Eleven,3,2000-09-15T03:00:00Z,BROWNSVILLE TX,0,0,2,7,9
Tropical Depression,Eleven,3,2000-09-15T03:00:00Z,MMTX 210N 974W,0,0,1,4,5
Tropical Depression,Eleven,3,2000-09-15T03:00:00Z,GULF 29N 85W,0,0,0,2,2
Tropical Depression,Eleven,3,2000-09-15T03:00:00Z,MMVR 192N 961W,0,0,0,3,3
Tropical Depression,Eleven,3,2000-09-15T03:00:00Z,GULF 29N 87W,0,0,0,4,4
Tropical Depression,Eleven,3,2000-09-15T03:00:00Z,MMFR 185N 926W,0,0,1,4,5
Tropical Depression,Eleven,3,2000-09-15T03:00:00Z,GULF 28N 89W,0,0,0,7,7
Tropical Depression,Eleven,3,2000-09-15T03:00:00Z,MMMD 210N 897W,48,0,0,0,48
Tropical Depression,Eleven,3,2000-09-15T03:00:00Z,GULF 28N 91W,0,0,1,8,9
Tropical Depression,Eleven,3,2000-09-15T03:00:00Z,KEY WEST FL,0,0,0,2,2
Tropical Depression,Eleven,3,2000-09-15T03:00:00Z,GULF 28N 93W,0,0,1,8,9
Tropical Depression,Eleven,3,2000-09-15T03:00:00Z,VENICE FL,0,0,0,2,2
Tropical Depression,Eleven,3,2000-09-15T03:00:00Z,GULF 28N 95W,0,0,1,7,8
Tropical Depression,Eleven,3,2000-09-15T03:00:00Z,PANAMA CITY FL,0,0,0,2,2
Tropical Depression,Eleven,3,2000-09-15T03:00:00Z,GULF 27N 96W,0,0,2,7,9
Tropical Depression,Eleven,3,2000-09-15T03:00:00Z,PENSACOLA FL,0,0,0,2,2
Tropical Depression,Eleven,3,2000-09-15T03:00:00Z,GULF 25N 96W,0,1,5,6,12
Tropical Depression,Eleven,3,2000-09-15T03:00:00Z,MOBILE AL,0,0,0,2,2
Tropical Depression,Eleven,4,2000-09-15T09:00:00Z,22.4N  89.2W,55,0,0,0,55
Tropical Depression,Eleven,4,2000-09-15T09:00:00Z,GULFPORT MS,0,0,0,4,4
Tropical Depression,Eleven,4,2000-09-15T09:00:00Z,22.9N  89.9W,31,1,0,0,32
Tropical Depression,Eleven,4,2000-09-15T09:00:00Z,BURAS LA,0,0,1,6,7
Tropical Depression,Eleven,4,2000-09-15T09:00:00Z,23.5N  90.5W,17,6,1,1,25
Tropical Depression,Eleven,4,2000-09-15T09:00:00Z,NEW ORLEANS LA,0,0,0,6,6
Tropical Depression,Eleven,4,2000-09-15T09:00:00Z,MUSN 216N 826W,0,0,1,2,3
Tropical Depression,Eleven,4,2000-09-15T09:00:00Z,NEW IBERIA LA,0,0,0,7,7
Tropical Depression,Eleven,4,2000-09-15T09:00:00Z,MUHA 230N 824W,0,0,1,2,3
Tropical Depression,Eleven,4,2000-09-15T09:00:00Z,PORT ARTHUR TX,0,0,0,7,7
Tropical Depression,Eleven,4,2000-09-15T09:00:00Z,MUAN 219N 850W,1,2,3,3,9
Tropical Depression,Eleven,4,2000-09-15T09:00:00Z,GALVESTON TX,0,0,1,7,8
Tropical Depression,Eleven,4,2000-09-15T09:00:00Z,MMCZ 205N 869W,99,0,0,0,99
Tropical Depression,Eleven,4,2000-09-15T09:00:00Z,FREEPORT TX,0,0,1,7,8
Tropical Depression,Eleven,4,2000-09-15T09:00:00Z,MZBZ 175N 883W,0,0,0,3,3
Tropical Depression,Eleven,4,2000-09-15T09:00:00Z,PORT O CONNOR TX,0,0,1,7,8
Tropical Depression,Eleven,4,2000-09-15T09:00:00Z,MMSO 238N 982W,0,0,0,6,6
Tropical Depression,Eleven,4,2000-09-15T09:00:00Z,CORPUSCHRISTI TX,0,0,0,7,7
Tropical Depression,Eleven,4,2000-09-15T09:00:00Z,MMTM 222N 979W,0,0,0,5,5
Tropical Depression,Eleven,4,2000-09-15T09:00:00Z,BROWNSVILLE TX,0,0,1,7,8
Tropical Depression,Eleven,4,2000-09-15T09:00:00Z,MMTX 210N 974W,0,0,0,4,4
Tropical Depression,Eleven,4,2000-09-15T09:00:00Z,GULF 29N 85W,0,0,0,2,2
Tropical Depression,Eleven,4,2000-09-15T09:00:00Z,MMVR 192N 961W,0,0,0,3,3
Tropical Depression,Eleven,4,2000-09-15T09:00:00Z,GULF 29N 87W,0,0,0,5,5
Tropical Depression,Eleven,4,2000-09-15T09:00:00Z,MMFR 185N 926W,0,0,0,4,4
Tropical Depression,Eleven,4,2000-09-15T09:00:00Z,GULF 28N 89W,0,0,3,6,9
Tropical Depression,Eleven,4,2000-09-15T09:00:00Z,MMMD 210N 897W,26,1,0,0,27
Tropical Depression,Eleven,4,2000-09-15T09:00:00Z,GULF 28N 91W,0,0,4,7,11
Tropical Depression,Eleven,4,2000-09-15T09:00:00Z,KEY WEST FL,0,0,0,2,2
Tropical Depression,Eleven,4,2000-09-15T09:00:00Z,GULF 28N 93W,0,0,3,8,11
Tropical Depression,Eleven,4,2000-09-15T09:00:00Z,APALACHICOLA FL,0,0,0,2,2
Tropical Depression,Eleven,4,2000-09-15T09:00:00Z,GULF 28N 95W,0,0,2,8,10
Tropical Depression,Eleven,4,2000-09-15T09:00:00Z,PANAMA CITY FL,0,0,0,2,2
Tropical Depression,Eleven,4,2000-09-15T09:00:00Z,GULF 27N 96W,0,0,2,8,10
Tropical Depression,Eleven,4,2000-09-15T09:00:00Z,PENSACOLA FL,0,0,0,3,3
Tropical Depression,Eleven,4,2000-09-15T09:00:00Z,GULF 25N 96W,0,0,3,7,10
Tropical Depression,Eleven,4,2000-09-15T09:00:00Z,MOBILE AL,0,0,0,3,3
Tropical Depression,Eleven,5,2000-09-15T15:00:00Z,22.5N  90.5W,51,0,0,0,51
Tropical Depression,Eleven,5,2000-09-15T15:00:00Z,PANAMA CITY FL,0,0,0,4,4
Tropical Depression,Eleven,5,2000-09-15T15:00:00Z,23.5N  90.5W,37,0,0,0,37
Tropical Depression,Eleven,5,2000-09-15T15:00:00Z,PENSACOLA FL,0,0,0,5,5
Tropical Depression,Eleven,5,2000-09-15T15:00:00Z,24.5N  91.0W,13,8,2,1,24
Tropical Depression,Eleven,5,2000-09-15T15:00:00Z,MOBILE AL,0,0,0,6,6
Tropical Depression,Eleven,5,2000-09-15T15:00:00Z,MUSN 216N 826W,0,0,0,2,2
Tropical Depression,Eleven,5,2000-09-15T15:00:00Z,GULFPORT MS,0,0,1,6,7
Tropical Depression,Eleven,5,2000-09-15T15:00:00Z,MUHA 230N 824W,0,0,0,3,3
Tropical Depression,Eleven,5,2000-09-15T15:00:00Z,BURAS LA,0,0,3,7,10
Tropical Depression,Eleven,5,2000-09-15T15:00:00Z,MUAN 219N 850W,0,1,2,4,7
Tropical Depression,Eleven,5,2000-09-15T15:00:00Z,NEW ORLEANS LA,0,0,2,7,9
Tropical Depression,Eleven,5,2000-09-15T15:00:00Z,MMCZ 205N 869W,0,2,2,3,7
Tropical Depression,Eleven,5,2000-09-15T15:00:00Z,NEW IBERIA LA,0,0,2,8,10
Tropical Depression,Eleven,5,2000-09-15T15:00:00Z,MZBZ 175N 883W,0,0,0,2,2
Tropical Depression,Eleven,5,2000-09-15T15:00:00Z,PORT ARTHUR TX,0,0,1,8,9
Tropical Depression,Eleven,5,2000-09-15T15:00:00Z,MMSO 238N 982W,0,0,0,4,4
Tropical Depression,Eleven,5,2000-09-15T15:00:00Z,GALVESTON TX,0,0,2,8,10
Tropical Depression,Eleven,5,2000-09-15T15:00:00Z,MMTM 222N 979W,0,0,0,3,3
Tropical Depression,Eleven,5,2000-09-15T15:00:00Z,FREEPORT TX,0,0,2,8,10
Tropical Depression,Eleven,5,2000-09-15T15:00:00Z,MMTX 210N 974W,0,0,0,2,2
Tropical Depression,Eleven,5,2000-09-15T15:00:00Z,PORT O CONNOR TX,0,0,1,8,9
Tropical Depression,Eleven,5,2000-09-15T15:00:00Z,MMFR 185N 926W,0,0,0,2,2
Tropical Depression,Eleven,5,2000-09-15T15:00:00Z,CORPUSCHRISTI TX,0,0,1,6,7
Tropical Depression,Eleven,5,2000-09-15T15:00:00Z,MMMD 210N 897W,99,0,0,0,99
Tropical Depression,Eleven,5,2000-09-15T15:00:00Z,BROWNSVILLE TX,0,0,1,6,7
Tropical Depression,Eleven,5,2000-09-15T15:00:00Z,MARATHON FL,0,0,0,2,2
Tropical Depression,Eleven,5,2000-09-15T15:00:00Z,GULF 29N 85W,0,0,0,4,4
Tropical Depression,Eleven,5,2000-09-15T15:00:00Z,KEY WEST FL,0,0,0,2,2
Tropical Depression,Eleven,5,2000-09-15T15:00:00Z,GULF 29N 87W,0,0,1,6,7
Tropical Depression,Eleven,5,2000-09-15T15:00:00Z,MARCO ISLAND FL,0,0,0,2,2
Tropical Depression,Eleven,5,2000-09-15T15:00:00Z,GULF 28N 89W,0,1,6,6,13
Tropical Depression,Eleven,5,2000-09-15T15:00:00Z,FT MYERS FL,0,0,0,2,2
Tropical Depression,Eleven,5,2000-09-15T15:00:00Z,GULF 28N 91W,0,1,7,6,14
Tropical Depression,Eleven,5,2000-09-15T15:00:00Z,VENICE FL,0,0,0,2,2
Tropical Depression,Eleven,5,2000-09-15T15:00:00Z,GULF 28N 93W,0,0,7,7,14
Tropical Depression,Eleven,5,2000-09-15T15:00:00Z,TAMPA FL,0,0,0,2,2
Tropical Depression,Eleven,5,2000-09-15T15:00:00Z,GULF 28N 95W,0,0,4,7,11
Tropical Depression,Eleven,5,2000-09-15T15:00:00Z,CEDAR KEY FL,0,0,0,2,2
Tropical Depression,Eleven,5,2000-09-15T15:00:00Z,GULF 27N 96W,0,0,3,7,10
Tropical Depression,Eleven,5,2000-09-15T15:00:00Z,ST MARKS FL,0,0,0,2,2
Tropical Depression,Eleven,5,2000-09-15T15:00:00Z,GULF 25N 96W,0,0,4,6,10
Tropical Depression,Eleven,5,2000-09-15T15:00:00Z,APALACHICOLA FL,0,0,0,3,3
Tropical Depression,Eleven,6,2000-09-15T21:00:00Z,23.0N  88.5W,53,0,0,0,53
Tropical Depression,Eleven,6,2000-09-15T21:00:00Z,PENSACOLA FL,0,0,2,9,11
Tropical Depression,Eleven,6,2000-09-15T21:00:00Z,23.8N  88.6W,40,0,0,0,40
Tropical Depression,Eleven,6,2000-09-15T21:00:00Z,MOBILE AL,0,0,2,10,12
Tropical Depression,Eleven,6,2000-09-15T21:00:00Z,25.0N  88.8W,20,4,2,1,27
Tropical Depression,Eleven,6,2000-09-15T21:00:00Z,GULFPORT MS,0,0,4,9,13
Tropical Depression,Eleven,6,2000-09-15T21:00:00Z,MUSN 216N 826W,0,0,0,2,2
Tropical Depression,Eleven,6,2000-09-15T21:00:00Z,BURAS LA,0,1,7,7,15
Tropical Depression,Eleven,6,2000-09-15T21:00:00Z,MUHA 230N 824W,0,0,0,2,2
Tropical Depression,Eleven,6,2000-09-15T21:00:00Z,NEW ORLEANS LA,0,0,5,9,14
Tropical Depression,Eleven,6,2000-09-15T21:00:00Z,MUAN 219N 850W,2,2,2,3,9
Tropical Depression,Eleven,6,2000-09-15T21:00:00Z,NEW IBERIA LA,0,0,4,8,12
Tropical Depression,Eleven,6,2000-09-15T21:00:00Z,MMCZ 205N 869W,12,2,1,1,16
Tropical Depression,Eleven,6,2000-09-15T21:00:00Z,PORT ARTHUR TX,0,0,1,7,8
Tropical Depression,Eleven,6,2000-09-15T21:00:00Z,MZBZ 175N 883W,0,0,0,2,2
Tropical Depression,Eleven,6,2000-09-15T21:00:00Z,GALVESTON TX,0,0,0,7,7
Tropical Depression,Eleven,6,2000-09-15T21:00:00Z,MMFR 185N 926W,0,0,0,2,2
Tropical Depression,Eleven,6,2000-09-15T21:00:00Z,FREEPORT TX,0,0,0,5,5
Tropical Depression,Eleven,6,2000-09-15T21:00:00Z,MMMD 210N 897W,4,5,3,2,14
Tropical Depression,Eleven,6,2000-09-15T21:00:00Z,PORT O CONNOR TX,0,0,0,4,4
Tropical Depression,Eleven,6,2000-09-15T21:00:00Z,JACKSONVILLE FL,0,0,0,2,2
Tropical Depression,Eleven,6,2000-09-15T21:00:00Z,CORPUSCHRISTI TX,0,0,0,2,2
Tropical Depression,Eleven,6,2000-09-15T21:00:00Z,KEY WEST FL,0,0,0,2,2
Tropical Depression,Eleven,6,2000-09-15T21:00:00Z,BROWNSVILLE TX,0,0,0,2,2
Tropical Depression,Eleven,6,2000-09-15T21:00:00Z,MARCO ISLAND FL,0,0,0,2,2
Tropical Depression,Eleven,6,2000-09-15T21:00:00Z,GULF 29N 85W,0,0,1,7,8
Tropical Depression,Eleven,6,2000-09-15T21:00:00Z,FT MYERS FL,0,0,0,2,2
Tropical Depression,Eleven,6,2000-09-15T21:00:00Z,GULF 29N 87W,0,0,5,8,13
Tropical Depression,Eleven,6,2000-09-15T21:00:00Z,VENICE FL,0,0,0,3,3
Tropical Depression,Eleven,6,2000-09-15T21:00:00Z,GULF 28N 89W,0,4,10,4,18
Tropical Depression,Eleven,6,2000-09-15T21:00:00Z,TAMPA FL,0,0,0,3,3
Tropical Depression,Eleven,6,2000-09-15T21:00:00Z,GULF 28N 91W,0,3,9,5,17
Tropical Depression,Eleven,6,2000-09-15T21:00:00Z,CEDAR KEY FL,0,0,0,4,4
Tropical Depression,Eleven,6,2000-09-15T21:00:00Z,GULF 28N 93W,0,0,5,7,12
Tropical Depression,Eleven,6,2000-09-15T21:00:00Z,ST MARKS FL,0,0,0,6,6
Tropical Depression,Eleven,6,2000-09-15T21:00:00Z,GULF 28N 95W,0,0,1,6,7
Tropical Depression,Eleven,6,2000-09-15T21:00:00Z,APALACHICOLA FL,0,0,1,7,8
Tropical Depression,Eleven,6,2000-09-15T21:00:00Z,GULF 27N 96W,0,0,0,4,4
Tropical Depression,Eleven,6,2000-09-15T21:00:00Z,PANAMA CITY FL,0,0,1,8,9
Tropical Depression,Eleven,6,2000-09-15T21:00:00Z,GULF 25N 96W,0,0,0,4,4
Tropical Storm,Gordon,7,2000-09-16T03:00:00Z,25.8N  85.0W,34,0,0,0,34
Tropical Storm,Gordon,7,2000-09-16T03:00:00Z,ATLANTIC CITY NJ,0,0,0,6,6
Tropical Storm,Gordon,7,2000-09-16T03:00:00Z,27.8N  83.8W,11,12,1,1,25
Tropical Storm,Gordon,7,2000-09-16T03:00:00Z,NEW YORK CITY NY,0,0,0,5,5
Tropical Storm,Gordon,7,2000-09-16T03:00:00Z,30.0N  82.0W,0,12,8,1,21
Tropical Storm,Gordon,7,2000-09-16T03:00:00Z,MONTAUK POINT NY,0,0,0,3,3
Tropical Storm,Gordon,7,2000-09-16T03:00:00Z,MUSN 216N 826W,1,0,1,0,2
Tropical Storm,Gordon,7,2000-09-16T03:00:00Z,PROVIDENCE RI,0,0,0,2,2
Tropical Storm,Gordon,7,2000-09-16T03:00:00Z,MUHA 230N 824W,5,2,1,0,8
Tropical Storm,Gordon,7,2000-09-16T03:00:00Z,NANTUCKET MA,0,0,0,2,2
Tropical Storm,Gordon,7,2000-09-16T03:00:00Z,MUAN 219N 850W,40,0,0,0,40
Tropical Storm,Gordon,7,2000-09-16T03:00:00Z,HYANNIS MA,0,0,0,2,2
Tropical Storm,Gordon,7,2000-09-16T03:00:00Z,MMCZ 205N 869W,11,0,0,0,11
Tropical Storm,Gordon,7,2000-09-16T03:00:00Z,BOSTON MA,0,0,0,2,2
Tropical Storm,Gordon,7,2000-09-16T03:00:00Z,MYNN 251N 775W,0,0,1,1,2
Tropical Storm,Gordon,7,2000-09-16T03:00:00Z,KEY WEST FL,5,5,2,0,12
Tropical Storm,Gordon,7,2000-09-16T03:00:00Z,MYGF 266N 787W,0,1,4,3,8
Tropical Storm,Gordon,7,2000-09-16T03:00:00Z,MARCO ISLAND FL,6,9,2,0,17
Tropical Storm,Gordon,7,2000-09-16T03:00:00Z,MARATHON FL,2,5,2,1,10
Tropical Storm,Gordon,7,2000-09-16T03:00:00Z,FT MYERS FL,6,12,1,1,20
Tropical Storm,Gordon,7,2000-09-16T03:00:00Z,MIAMI FL,1,5,4,1,11
Tropical Storm,Gordon,7,2000-09-16T03:00:00Z,VENICE FL,9,12,1,1,23
Tropical Storm,Gordon,7,2000-09-16T03:00:00Z,W PALM BEACH FL,0,7,5,1,13
Tropical Storm,Gordon,7,2000-09-16T03:00:00Z,TAMPA FL,5,15,2,1,23
Tropical Storm,Gordon,7,2000-09-16T03:00:00Z,FT PIERCE FL,0,9,6,1,16
Tropical Storm,Gordon,7,2000-09-16T03:00:00Z,CEDAR KEY FL,2,16,3,1,22
Tropical Storm,Gordon,7,2000-09-16T03:00:00Z,COCOA BEACH FL,0,11,6,2,19
Tropical Storm,Gordon,7,2000-09-16T03:00:00Z,ST MARKS FL,0,10,7,1,18
Tropical Storm,Gordon,7,2000-09-16T03:00:00Z,DAYTONA BEACH FL,0,12,7,2,21
Tropical Storm,Gordon,7,2000-09-16T03:00:00Z,APALACHICOLA FL,1,10,5,1,17
Tropical Storm,Gordon,7,2000-09-16T03:00:00Z,JACKSONVILLE FL,0,9,9,2,20
Tropical Storm,Gordon,7,2000-09-16T03:00:00Z,PANAMA CITY FL,0,7,5,2,14
Tropical Storm,Gordon,7,2000-09-16T03:00:00Z,SAVANNAH GA,0,3,11,4,18
Tropical Storm,Gordon,7,2000-09-16T03:00:00Z,PENSACOLA FL,0,1,4,3,8
Tropical Storm,Gordon,7,2000-09-16T03:00:00Z,CHARLESTON SC,0,1,10,6,17
Tropical Storm,Gordon,7,2000-09-16T03:00:00Z,MOBILE AL,0,0,1,3,4
Tropical Storm,Gordon,7,2000-09-16T03:00:00Z,MYRTLE BEACH SC,0,0,7,8,15
Tropical Storm,Gordon,7,2000-09-16T03:00:00Z,GULFPORT MS,0,0,1,2,3
Tropical Storm,Gordon,7,2000-09-16T03:00:00Z,WILMINGTON NC,0,0,4,10,14
Tropical Storm,Gordon,7,2000-09-16T03:00:00Z,BURAS LA,0,0,1,1,2
Tropical Storm,Gordon,7,2000-09-16T03:00:00Z,MOREHEAD CITY NC,0,0,2,11,13
Tropical Storm,Gordon,7,2000-09-16T03:00:00Z,GULF 29N 85W,2,13,3,1,19
Tropical Storm,Gordon,7,2000-09-16T03:00:00Z,CAPE HATTERAS NC,0,0,1,11,12
Tropical Storm,Gordon,7,2000-09-16T03:00:00Z,GULF 29N 87W,0,6,4,1,11
Tropical Storm,Gordon,7,2000-09-16T03:00:00Z,NORFOLK VA,0,0,1,10,11
Tropical Storm,Gordon,7,2000-09-16T03:00:00Z,GULF 28N 89W,0,1,2,1,4
Tropical Storm,Gordon,7,2000-09-16T03:00:00Z,OCEAN CITY MD,0,0,0,8,8
Tropical Storm,Gordon,8,2000-09-16T09:00:00Z,26.0N  85.7W,33,0,0,0,33
Tropical Storm,Gordon,8,2000-09-16T09:00:00Z,OCEAN CITY MD,0,0,0,2,2
Tropical Storm,Gordon,8,2000-09-16T09:00:00Z,27.5N  85.1W,16,6,1,1,24
Tropical Storm,Gordon,8,2000-09-16T09:00:00Z,ATLANTIC CITY NJ,0,0,0,2,2
Tropical Storm,Gordon,8,2000-09-16T09:00:00Z,30.0N  84.0W,0,9,9,2,20
Tropical Storm,Gordon,8,2000-09-16T09:00:00Z,KEY WEST FL,1,3,3,2,9
Tropical Storm,Gordon,8,2000-09-16T09:00:00Z,MUSN 216N 826W,0,1,1,1,3
Tropical Storm,Gordon,8,2000-09-16T09:00:00Z,MARCO ISLAND FL,1,4,4,2,11
Tropical Storm,Gordon,8,2000-09-16T09:00:00Z,MUHA 230N 824W,2,1,2,1,6
Tropical Storm,Gordon,8,2000-09-16T09:00:00Z,FT MYERS FL,1,5,5,2,13
Tropical Storm,Gordon,8,2000-09-16T09:00:00Z,MUAN 219N 850W,5,2,1,0,8
Tropical Storm,Gordon,8,2000-09-16T09:00:00Z,VENICE FL,2,7,5,2,16
Tropical Storm,Gordon,8,2000-09-16T09:00:00Z,MYNN 251N 775W,0,0,0,2,2
Tropical Storm,Gordon,8,2000-09-16T09:00:00Z,TAMPA FL,1,7,7,2,17
Tropical Storm,Gordon,8,2000-09-16T09:00:00Z,MYGF 266N 787W,0,0,1,4,5
Tropical Storm,Gordon,8,2000-09-16T09:00:00Z,CEDAR KEY FL,0,8,8,2,18
Tropical Storm,Gordon,8,2000-09-16T09:00:00Z,MARATHON FL,0,1,3,2,6
Tropical Storm,Gordon,8,2000-09-16T09:00:00Z,ST MARKS FL,0,9,9,2,20
Tropical Storm,Gordon,8,2000-09-16T09:00:00Z,MIAMI FL,0,0,2,4,6
Tropical Storm,Gordon,8,2000-09-16T09:00:00Z,APALACHICOLA FL,1,12,7,1,21
Tropical Storm,Gordon,8,2000-09-16T09:00:00Z,W PALM BEACH FL,0,0,3,4,7
Tropical Storm,Gordon,8,2000-09-16T09:00:00Z,PANAMA CITY FL,1,11,7,1,20
Tropical Storm,Gordon,8,2000-09-16T09:00:00Z,FT PIERCE FL,0,0,4,5,9
Tropical Storm,Gordon,8,2000-09-16T09:00:00Z,PENSACOLA FL,0,7,6,3,16
Tropical Storm,Gordon,8,2000-09-16T09:00:00Z,COCOA BEACH FL,0,1,4,5,10
Tropical Storm,Gordon,8,2000-09-16T09:00:00Z,MOBILE AL,0,3,5,3,11
Tropical Storm,Gordon,8,2000-09-16T09:00:00Z,DAYTONA BEACH FL,0,1,7,5,13
Tropical Storm,Gordon,8,2000-09-16T09:00:00Z,GULFPORT MS,0,2,4,3,9
Tropical Storm,Gordon,8,2000-09-16T09:00:00Z,JACKSONVILLE FL,0,1,8,5,14
Tropical Storm,Gordon,8,2000-09-16T09:00:00Z,BURAS LA,0,2,3,2,7
Tropical Storm,Gordon,8,2000-09-16T09:00:00Z,SAVANNAH GA,0,0,5,8,13
Tropical Storm,Gordon,8,2000-09-16T09:00:00Z,NEW ORLEANS LA,0,0,2,3,5
Tropical Storm,Gordon,8,2000-09-16T09:00:00Z,CHARLESTON SC,0,0,2,8,10
Tropical Storm,Gordon,8,2000-09-16T09:00:00Z,NEW IBERIA LA,0,0,0,2,2
Tropical Storm,Gordon,8,2000-09-16T09:00:00Z,MYRTLE BEACH SC,0,0,1,7,8
Tropical Storm,Gordon,8,2000-09-16T09:00:00Z,GULF 29N 85W,3,13,5,1,22
Tropical Storm,Gordon,8,2000-09-16T09:00:00Z,WILMINGTON NC,0,0,0,7,7
Tropical Storm,Gordon,8,2000-09-16T09:00:00Z,GULF 29N 87W,5,9,4,1,19
Tropical Storm,Gordon,8,2000-09-16T09:00:00Z,MOREHEAD CITY NC,0,0,0,5,5
Tropical Storm,Gordon,8,2000-09-16T09:00:00Z,GULF 28N 89W,2,5,3,1,11
Tropical Storm,Gordon,8,2000-09-16T09:00:00Z,CAPE HATTERAS NC,0,0,0,4,4
Tropical Storm,Gordon,8,2000-09-16T09:00:00Z,GULF 28N 91W,0,0,1,2,3
Tropical Storm,Gordon,8,2000-09-16T09:00:00Z,NORFOLK VA,0,0,0,4,4
Tropical Storm,Gordon,9,2000-09-16T15:00:00Z,27.0N  84.6W,31,1,0,0,32
Tropical Storm,Gordon,9,2000-09-16T15:00:00Z,MONTAUK POINT NY,0,0,0,4,4
Tropical Storm,Gordon,9,2000-09-16T15:00:00Z,28.8N  83.7W,13,10,1,1,25
Tropical Storm,Gordon,9,2000-09-16T15:00:00Z,PROVIDENCE RI,0,0,0,3,3
Tropical Storm,Gordon,9,2000-09-16T15:00:00Z,31.0N  82.5W,0,14,6,2,22
Tropical Storm,Gordon,9,2000-09-16T15:00:00Z,NANTUCKET MA,0,0,0,2,2
Tropical Storm,Gordon,9,2000-09-16T15:00:00Z,MUHA 230N 824W,2,1,0,1,4
Tropical Storm,Gordon,9,2000-09-16T15:00:00Z,HYANNIS MA,0,0,0,2,2
Tropical Storm,Gordon,9,2000-09-16T15:00:00Z,MUAN 219N 850W,4,0,1,0,5
Tropical Storm,Gordon,9,2000-09-16T15:00:00Z,BOSTON MA,0,0,0,2,2
Tropical Storm,Gordon,9,2000-09-16T15:00:00Z,MYGF 266N 787W,0,0,1,2,3
Tropical Storm,Gordon,9,2000-09-16T15:00:00Z,KEY WEST FL,4,2,1,0,7
Tropical Storm,Gordon,9,2000-09-16T15:00:00Z,MARATHON FL,1,2,1,1,5
Tropical Storm,Gordon,9,2000-09-16T15:00:00Z,MARCO ISLAND FL,5,5,2,0,12
Tropical Storm,Gordon,9,2000-09-16T15:00:00Z,MIAMI FL,0,2,2,1,5
Tropical Storm,Gordon,9,2000-09-16T15:00:00Z,FT MYERS FL,7,7,1,1,16
Tropical Storm,Gordon,9,2000-09-16T15:00:00Z,W PALM BEACH FL,0,3,3,2,8
Tropical Storm,Gordon,9,2000-09-16T15:00:00Z,VENICE FL,12,7,1,0,20
Tropical Storm,Gordon,9,2000-09-16T15:00:00Z,FT PIERCE FL,0,6,3,2,11
Tropical Storm,Gordon,9,2000-09-16T15:00:00Z,TAMPA FL,9,10,2,0,21
Tropical Storm,Gordon,9,2000-09-16T15:00:00Z,COCOA BEACH FL,1,8,4,1,14
Tropical Storm,Gordon,9,2000-09-16T15:00:00Z,CEDAR KEY FL,6,15,2,1,24
Tropical Storm,Gordon,9,2000-09-16T15:00:00Z,DAYTONA BEACH FL,1,12,4,1,18
Tropical Storm,Gordon,9,2000-09-16T15:00:00Z,ST MARKS FL,4,14,3,1,22
Tropical Storm,Gordon,9,2000-09-16T15:00:00Z,JACKSONVILLE FL,0,14,6,1,21
Tropical Storm,Gordon,9,2000-09-16T15:00:00Z,APALACHICOLA FL,8,10,2,1,21
Tropical Storm,Gordon,9,2000-09-16T15:00:00Z,SAVANNAH GA,0,7,10,3,20
Tropical Storm,Gordon,9,2000-09-16T15:00:00Z,PANAMA CITY FL,5,9,4,1,19
Tropical Storm,Gordon,9,2000-09-16T15:00:00Z,CHARLESTON SC,0,3,11,3,17
Tropical Storm,Gordon,9,2000-09-16T15:00:00Z,PENSACOLA FL,1,4,5,2,12
Tropical Storm,Gordon,9,2000-09-16T15:00:00Z,MYRTLE BEACH SC,0,1,9,6,16
Tropical Storm,Gordon,9,2000-09-16T15:00:00Z,MOBILE AL,0,1,4,3,8
Tropical Storm,Gordon,9,2000-09-16T15:00:00Z,WILMINGTON NC,0,0,6,8,14
Tropical Storm,Gordon,9,2000-09-16T15:00:00Z,GULFPORT MS,0,1,1,4,6
Tropical Storm,Gordon,9,2000-09-16T15:00:00Z,MOREHEAD CITY NC,0,0,3,9,12
Tropical Storm,Gordon,9,2000-09-16T15:00:00Z,BURAS LA,0,1,1,3,5
Tropical Storm,Gordon,9,2000-09-16T15:00:00Z,CAPE HATTERAS NC,0,0,2,8,10
Tropical Storm,Gordon,9,2000-09-16T15:00:00Z,NEW ORLEANS LA,0,0,1,3,4
Tropical Storm,Gordon,9,2000-09-16T15:00:00Z,NORFOLK VA,0,0,1,10,11
Tropical Storm,Gordon,9,2000-09-16T15:00:00Z,GULF 29N 85W,14,7,2,0,23
Tropical Storm,Gordon,9,2000-09-16T15:00:00Z,OCEAN CITY MD,0,0,0,8,8
Tropical Storm,Gordon,9,2000-09-16T15:00:00Z,GULF 29N 87W,7,5,3,1,16
Tropical Storm,Gordon,9,2000-09-16T15:00:00Z,ATLANTIC CITY NJ,0,0,0,7,7
Tropical Storm,Gordon,9,2000-09-16T15:00:00Z,GULF 28N 89W,1,2,3,2,8
Tropical Storm,Gordon,9,2000-09-16T15:00:00Z,NEW YORK CITY NY,0,0,0,5,5
Tropical Storm,Gordon,9,2000-09-16T15:00:00Z,GULF 28N 91W,0,0,1,1,2
Tropical Storm,Gordon,10,2000-09-16T21:00:00Z,27.8N  84.3W,34,1,0,0,35
Tropical Storm,Gordon,10,2000-09-16T21:00:00Z,PROVIDENCE RI,0,0,0,4,4
Tropical Storm,Gordon,10,2000-09-16T21:00:00Z,30.0N  83.3W,10,14,1,0,25
Tropical Storm,Gordon,10,2000-09-16T21:00:00Z,NANTUCKET MA,0,0,0,3,3
Tropical Storm,Gordon,10,2000-09-16T21:00:00Z,32.0N  82.0W,0,15,4,1,20
Tropical Storm,Gordon,10,2000-09-16T21:00:00Z,HYANNIS MA,0,0,0,3,3
Tropical Storm,Gordon,10,2000-09-16T21:00:00Z,MUHA 230N 824W,0,1,1,0,2
Tropical Storm,Gordon,10,2000-09-16T21:00:00Z,BOSTON MA,0,0,0,3,3
Tropical Storm,Gordon,10,2000-09-16T21:00:00Z,MYGF 266N 787W,0,0,2,3,5
Tropical Storm,Gordon,10,2000-09-16T21:00:00Z,PORTLAND ME,0,0,0,2,2
Tropical Storm,Gordon,10,2000-09-16T21:00:00Z,MARATHON FL,1,1,2,1,5
Tropical Storm,Gordon,10,2000-09-16T21:00:00Z,KEY WEST FL,2,3,1,1,7
Tropical Storm,Gordon,10,2000-09-16T21:00:00Z,MIAMI FL,1,1,2,2,6
Tropical Storm,Gordon,10,2000-09-16T21:00:00Z,MARCO ISLAND FL,8,4,1,1,14
Tropical Storm,Gordon,10,2000-09-16T21:00:00Z,W PALM BEACH FL,1,3,2,2,8
Tropical Storm,Gordon,10,2000-09-16T21:00:00Z,FT MYERS FL,12,4,1,0,17
Tropical Storm,Gordon,10,2000-09-16T21:00:00Z,FT PIERCE FL,1,6,3,1,11
Tropical Storm,Gordon,10,2000-09-16T21:00:00Z,VENICE FL,21,1,1,0,23
Tropical Storm,Gordon,10,2000-09-16T21:00:00Z,COCOA BEACH FL,2,9,2,2,15
Tropical Storm,Gordon,10,2000-09-16T21:00:00Z,TAMPA FL,19,4,1,0,24
Tropical Storm,Gordon,10,2000-09-16T21:00:00Z,DAYTONA BEACH FL,3,12,3,1,19
Tropical Storm,Gordon,10,2000-09-16T21:00:00Z,CEDAR KEY FL,17,8,1,0,26
Tropical Storm,Gordon,10,2000-09-16T21:00:00Z,JACKSONVILLE FL,2,16,2,1,21
Tropical Storm,Gordon,10,2000-09-16T21:00:00Z,ST MARKS FL,9,13,2,0,24
Tropical Storm,Gordon,10,2000-09-16T21:00:00Z,SAVANNAH GA,0,12,5,2,19
Tropical Storm,Gordon,10,2000-09-16T21:00:00Z,APALACHICOLA FL,13,10,0,1,24
Tropical Storm,Gordon,10,2000-09-16T21:00:00Z,CHARLESTON SC,0,6,8,4,18
Tropical Storm,Gordon,10,2000-09-16T21:00:00Z,PANAMA CITY FL,8,11,1,1,21
Tropical Storm,Gordon,10,2000-09-16T21:00:00Z,MYRTLE BEACH SC,0,2,9,5,16
Tropical Storm,Gordon,10,2000-09-16T21:00:00Z,PENSACOLA FL,1,7,2,2,12
Tropical Storm,Gordon,10,2000-09-16T21:00:00Z,WILMINGTON NC,0,1,7,7,15
Tropical Storm,Gordon,10,2000-09-16T21:00:00Z,MOBILE AL,0,2,3,2,7
Tropical Storm,Gordon,10,2000-09-16T21:00:00Z,MOREHEAD CITY NC,0,0,5,8,13
Tropical Storm,Gordon,10,2000-09-16T21:00:00Z,GULFPORT MS,0,1,2,2,5
Tropical Storm,Gordon,10,2000-09-16T21:00:00Z,CAPE HATTERAS NC,0,0,2,9,11
Tropical Storm,Gordon,10,2000-09-16T21:00:00Z,BURAS LA,0,1,1,2,4
Tropical Storm,Gordon,10,2000-09-16T21:00:00Z,NORFOLK VA,0,0,2,10,12
Tropical Storm,Gordon,10,2000-09-16T21:00:00Z,NEW ORLEANS LA,0,0,1,1,2
Tropical Storm,Gordon,10,2000-09-16T21:00:00Z,OCEAN CITY MD,0,0,1,9,10
Tropical Storm,Gordon,10,2000-09-16T21:00:00Z,GULF 29N 85W,21,5,0,0,26
Tropical Storm,Gordon,10,2000-09-16T21:00:00Z,ATLANTIC CITY NJ,0,0,0,8,8
Tropical Storm,Gordon,10,2000-09-16T21:00:00Z,GULF 29N 87W,7,7,1,1,16
Tropical Storm,Gordon,10,2000-09-16T21:00:00Z,NEW YORK CITY NY,0,0,0,7,7
Tropical Storm,Gordon,10,2000-09-16T21:00:00Z,GULF 28N 89W,1,2,2,1,6
Tropical Storm,Gordon,10,2000-09-16T21:00:00Z,MONTAUK POINT NY,0,0,0,5,5
Hurricane,Gordon,11,2000-09-17T03:00:00Z,29.0N  83.6W,33,0,0,0,33
Hurricane,Gordon,11,2000-09-17T03:00:00Z,NEW YORK CITY NY,0,0,0,9,9
Hurricane,Gordon,11,2000-09-17T03:00:00Z,31.2N  81.8W,4,16,1,0,21
Hurricane,Gordon,11,2000-09-17T03:00:00Z,MONTAUK POINT NY,0,0,0,7,7
Hurricane,Gordon,11,2000-09-17T03:00:00Z,33.5N  80.0W,0,8,7,2,17
Hurricane,Gordon,11,2000-09-17T03:00:00Z,PROVIDENCE RI,0,0,0,6,6
Hurricane,Gordon,11,2000-09-17T03:00:00Z,MYAK 241N 776W,0,0,1,1,2
Hurricane,Gordon,11,2000-09-17T03:00:00Z,NANTUCKET MA,0,0,0,6,6
Hurricane,Gordon,11,2000-09-17T03:00:00Z,MYNN 251N 775W,0,0,1,2,3
Hurricane,Gordon,11,2000-09-17T03:00:00Z,HYANNIS MA,0,0,0,6,6
Hurricane,Gordon,11,2000-09-17T03:00:00Z,MYGF 266N 787W,0,3,3,1,7
Hurricane,Gordon,11,2000-09-17T03:00:00Z,BOSTON MA,0,0,0,6,6
Hurricane,Gordon,11,2000-09-17T03:00:00Z,MARATHON FL,1,3,1,1,6
Hurricane,Gordon,11,2000-09-17T03:00:00Z,PORTLAND ME,0,0,0,4,4
Hurricane,Gordon,11,2000-09-17T03:00:00Z,MIAMI FL,2,4,2,1,9
Hurricane,Gordon,11,2000-09-17T03:00:00Z,BAR HARBOR ME,0,0,0,3,3
Hurricane,Gordon,11,2000-09-17T03:00:00Z,W PALM BEACH FL,4,6,1,1,12
Hurricane,Gordon,11,2000-09-17T03:00:00Z,EASTPORT ME,0,0,0,2,2
Hurricane,Gordon,11,2000-09-17T03:00:00Z,FT PIERCE FL,7,6,2,0,15
Hurricane,Gordon,11,2000-09-17T03:00:00Z,KEY WEST FL,2,2,1,1,6
Hurricane,Gordon,11,2000-09-17T03:00:00Z,COCOA BEACH FL,11,6,1,1,19
Hurricane,Gordon,11,2000-09-17T03:00:00Z,MARCO ISLAND FL,15,1,0,1,17
Hurricane,Gordon,11,2000-09-17T03:00:00Z,DAYTONA BEACH FL,13,8,1,0,22
Hurricane,Gordon,11,2000-09-17T03:00:00Z,FT MYERS FL,22,1,0,0,23
Hurricane,Gordon,11,2000-09-17T03:00:00Z,JACKSONVILLE FL,8,13,1,1,23
Hurricane,Gordon,11,2000-09-17T03:00:00Z,VENICE FL,33,0,0,0,33
Hurricane,Gordon,11,2000-09-17T03:00:00Z,SAVANNAH GA,0,16,3,0,19
Hurricane,Gordon,11,2000-09-17T03:00:00Z,TAMPA FL,33,0,0,0,33
Hurricane,Gordon,11,2000-09-17T03:00:00Z,CHARLESTON SC,0,10,6,2,18
Hurricane,Gordon,11,2000-09-17T03:00:00Z,CEDAR KEY FL,30,1,0,0,31
Hurricane,Gordon,11,2000-09-17T03:00:00Z,MYRTLE BEACH SC,0,5,8,3,16
Hurricane,Gordon,11,2000-09-17T03:00:00Z,ST MARKS FL,18,5,0,0,23
Hurricane,Gordon,11,2000-09-17T03:00:00Z,WILMINGTON NC,0,2,9,4,15
Hurricane,Gordon,11,2000-09-17T03:00:00Z,APALACHICOLA FL,20,2,0,1,23
Hurricane,Gordon,11,2000-09-17T03:00:00Z,MOREHEAD CITY NC,0,0,7,7,14
Hurricane,Gordon,11,2000-09-17T03:00:00Z,PANAMA CITY FL,13,3,1,0,17
Hurricane,Gordon,11,2000-09-17T03:00:00Z,CAPE HATTERAS NC,0,0,4,8,12
Hurricane,Gordon,11,2000-09-17T03:00:00Z,PENSACOLA FL,2,2,1,0,5
Hurricane,Gordon,11,2000-09-17T03:00:00Z,NORFOLK VA,0,0,4,9,13
Hurricane,Gordon,11,2000-09-17T03:00:00Z,GULF 29N 85W,28,0,0,0,28
Hurricane,Gordon,11,2000-09-17T03:00:00Z,OCEAN CITY MD,0,0,2,9,11
Hurricane,Gordon,11,2000-09-17T03:00:00Z,GULF 29N 87W,6,2,1,0,9
Hurricane,Gordon,11,2000-09-17T03:00:00Z,ATLANTIC CITY NJ,0,0,1,9,10
Hurricane,Gordon,12,2000-09-17T09:00:00Z,31.0N  82.4W,31,1,0,0,32
Hurricane,Gordon,12,2000-09-17T09:00:00Z,PROVIDENCE RI,0,0,1,8,9
Hurricane,Gordon,12,2000-09-17T09:00:00Z,33.5N  80.5W,3,17,1,0,21
Hurricane,Gordon,12,2000-09-17T09:00:00Z,NANTUCKET MA,0,0,0,8,8
Hurricane,Gordon,12,2000-09-17T09:00:00Z,36.5N  78.5W,0,5,10,2,17
Hurricane,Gordon,12,2000-09-17T09:00:00Z,HYANNIS MA,0,0,0,8,8
Hurricane,Gordon,12,2000-09-17T09:00:00Z,MYGF 266N 787W,0,2,1,1,4
Hurricane,Gordon,12,2000-09-17T09:00:00Z,BOSTON MA,0,0,0,8,8
Hurricane,Gordon,12,2000-09-17T09:00:00Z,MIAMI FL,0,2,0,1,3
Hurricane,Gordon,12,2000-09-17T09:00:00Z,PORTLAND ME,0,0,0,7,7
Hurricane,Gordon,12,2000-09-17T09:00:00Z,W PALM BEACH FL,2,3,1,1,7
Hurricane,Gordon,12,2000-09-17T09:00:00Z,BAR HARBOR ME,0,0,0,5,5
Hurricane,Gordon,12,2000-09-17T09:00:00Z,FT PIERCE FL,7,4,1,0,12
Hurricane,Gordon,12,2000-09-17T09:00:00Z,EASTPORT ME,0,0,0,4,4
Hurricane,Gordon,12,2000-09-17T09:00:00Z,COCOA BEACH FL,16,3,0,0,19
Hurricane,Gordon,12,2000-09-17T09:00:00Z,ST JOHN NB,0,0,0,3,3
Hurricane,Gordon,12,2000-09-17T09:00:00Z,DAYTONA BEACH FL,29,0,0,0,29
Hurricane,Gordon,12,2000-09-17T09:00:00Z,MONCTON NB,0,0,0,2,2
Hurricane,Gordon,12,2000-09-17T09:00:00Z,JACKSONVILLE FL,32,1,0,0,33
Hurricane,Gordon,12,2000-09-17T09:00:00Z,YARMOUTH NS,0,0,0,4,4
Hurricane,Gordon,12,2000-09-17T09:00:00Z,SAVANNAH GA,15,10,0,0,25
Hurricane,Gordon,12,2000-09-17T09:00:00Z,HALIFAX NS,0,0,0,2,2
Hurricane,Gordon,12,2000-09-17T09:00:00Z,CHARLESTON SC,3,18,1,0,22
Hurricane,Gordon,12,2000-09-17T09:00:00Z,MARCO ISLAND FL,1,2,1,0,4
Hurricane,Gordon,12,2000-09-17T09:00:00Z,MYRTLE BEACH SC,0,16,4,0,20
Hurricane,Gordon,12,2000-09-17T09:00:00Z,FT MYERS FL,9,2,0,0,11
Hurricane,Gordon,12,2000-09-17T09:00:00Z,WILMINGTON NC,0,10,8,1,19
Hurricane,Gordon,12,2000-09-17T09:00:00Z,VENICE FL,40,0,0,0,40
Hurricane,Gordon,12,2000-09-17T09:00:00Z,MOREHEAD CITY NC,0,5,10,2,17
Hurricane,Gordon,12,2000-09-17T09:00:00Z,TAMPA FL,52,0,0,0,52
Hurricane,Gordon,12,2000-09-17T09:00:00Z,CAPE HATTERAS NC,0,2,10,3,15
Hurricane,Gordon,12,2000-09-17T09:00:00Z,CEDAR KEY FL,57,0,0,0,57
Hurricane,Gordon,12,2000-09-17T09:00:00Z,NORFOLK VA,0,1,11,4,16
Hurricane,Gordon,12,2000-09-17T09:00:00Z,ST MARKS FL,36,0,0,0,36
Hurricane,Gordon,12,2000-09-17T09:00:00Z,OCEAN CITY MD,0,0,8,6,14
Hurricane,Gordon,12,2000-09-17T09:00:00Z,APALACHICOLA FL,32,0,0,0,32
Hurricane,Gordon,12,2000-09-17T09:00:00Z,ATLANTIC CITY NJ,0,0,5,8,13
Hurricane,Gordon,12,2000-09-17T09:00:00Z,PANAMA CITY FL,14,1,0,0,15
Hurricane,Gordon,12,2000-09-17T09:00:00Z,NEW YORK CITY NY,0,0,3,8,11
Hurricane,Gordon,12,2000-09-17T09:00:00Z,GULF 29N 85W,51,0,0,0,51
Hurricane,Gordon,12,2000-09-17T09:00:00Z,MONTAUK POINT NY,0,0,1,9,10
Hurricane,Gordon,13,2000-09-17T15:00:00Z,32.3N  80.3W,34,1,1,0,36
Hurricane,Gordon,13,2000-09-17T15:00:00Z,BOSTON MA,0,0,3,8,11
Hurricane,Gordon,13,2000-09-17T15:00:00Z,35.0N  77.5W,0,21,2,0,23
Hurricane,Gordon,13,2000-09-17T15:00:00Z,PORTLAND ME,0,0,1,9,10
Hurricane,Gordon,13,2000-09-17T15:00:00Z,37.5N  74.0W,0,3,12,2,17
Hurricane,Gordon,13,2000-09-17T15:00:00Z,BAR HARBOR ME,0,0,0,9,9
Hurricane,Gordon,13,2000-09-17T15:00:00Z,BERMUDA,0,0,0,2,2
Hurricane,Gordon,13,2000-09-17T15:00:00Z,EASTPORT ME,0,0,0,8,8
Hurricane,Gordon,13,2000-09-17T15:00:00Z,FT PIERCE FL,7,0,0,1,8
Hurricane,Gordon,13,2000-09-17T15:00:00Z,ST JOHN NB,0,0,0,8,8
Hurricane,Gordon,13,2000-09-17T15:00:00Z,COCOA BEACH FL,25,0,0,1,26
Hurricane,Gordon,13,2000-09-17T15:00:00Z,MONCTON NB,0,0,0,7,7
Hurricane,Gordon,13,2000-09-17T15:00:00Z,DAYTONA BEACH FL,51,0,0,0,51
Hurricane,Gordon,13,2000-09-17T15:00:00Z,YARMOUTH NS,0,0,0,9,9
Hurricane,Gordon,13,2000-09-17T15:00:00Z,JACKSONVILLE FL,52,0,0,0,52
Hurricane,Gordon,13,2000-09-17T15:00:00Z,HALIFAX NS,0,0,0,8,8
Hurricane,Gordon,13,2000-09-17T15:00:00Z,SAVANNAH GA,35,1,0,0,36
Hurricane,Gordon,13,2000-09-17T15:00:00Z,SABLE ISLAND NS,0,0,0,6,6
Hurricane,Gordon,13,2000-09-17T15:00:00Z,CHARLESTON SC,25,7,0,0,32
Hurricane,Gordon,13,2000-09-17T15:00:00Z,SYDNEY NS,0,0,0,5,5
Hurricane,Gordon,13,2000-09-17T15:00:00Z,MYRTLE BEACH SC,10,17,1,0,28
Hurricane,Gordon,13,2000-09-17T15:00:00Z,EDDY POINT NS,0,0,0,6,6
Hurricane,Gordon,13,2000-09-17T15:00:00Z,WILMINGTON NC,2,22,1,0,25
Hurricane,Gordon,13,2000-09-17T15:00:00Z,PTX BASQUES NFLD,0,0,0,3,3
Hurricane,Gordon,13,2000-09-17T15:00:00Z,MOREHEAD CITY NC,0,19,3,0,22
Hurricane,Gordon,13,2000-09-17T15:00:00Z,BURGEO NFLD,0,0,0,3,3
Hurricane,Gordon,13,2000-09-17T15:00:00Z,CAPE HATTERAS NC,0,13,6,1,20
Hurricane,Gordon,13,2000-09-17T15:00:00Z,ILE ST PIERRE,0,0,0,2,2
Hurricane,Gordon,13,2000-09-17T15:00:00Z,NORFOLK VA,0,10,8,1,19
Hurricane,Gordon,13,2000-09-17T15:00:00Z,FT MYERS FL,6,1,0,0,7
Hurricane,Gordon,13,2000-09-17T15:00:00Z,OCEAN CITY MD,0,3,12,2,17
Hurricane,Gordon,13,2000-09-17T15:00:00Z,VENICE FL,64,0,0,0,64
Hurricane,Gordon,13,2000-09-17T15:00:00Z,ATLANTIC CITY NJ,0,1,11,3,15
Hurricane,Gordon,13,2000-09-17T15:00:00Z,TAMPA FL,81,0,0,0,81
Hurricane,Gordon,13,2000-09-17T15:00:00Z,NEW YORK CITY NY,0,0,9,4,13
Hurricane,Gordon,13,2000-09-17T15:00:00Z,CEDAR KEY FL,76,0,0,0,76
Hurricane,Gordon,13,2000-09-17T15:00:00Z,MONTAUK POINT NY,0,0,6,7,13
Hurricane,Gordon,13,2000-09-17T15:00:00Z,ST MARKS FL,19,1,0,0,20
Hurricane,Gordon,13,2000-09-17T15:00:00Z,PROVIDENCE RI,0,0,4,8,12
Hurricane,Gordon,13,2000-09-17T15:00:00Z,APALACHICOLA FL,4,0,0,0,4
Hurricane,Gordon,13,2000-09-17T15:00:00Z,NANTUCKET MA,0,0,3,10,13
Hurricane,Gordon,13,2000-09-17T15:00:00Z,GULF 29N 85W,11,0,0,0,11
Hurricane,Gordon,13,2000-09-17T15:00:00Z,HYANNIS MA,0,0,3,9,12
Hurricane,Gordon,14,2000-09-17T18:00:00Z,32.3N  80.3W,34,1,1,0,36
Hurricane,Gordon,14,2000-09-17T18:00:00Z,BOSTON MA,0,0,3,8,11
Hurricane,Gordon,14,2000-09-17T18:00:00Z,35.0N  77.5W,0,21,2,0,23
Hurricane,Gordon,14,2000-09-17T18:00:00Z,PORTLAND ME,0,0,1,9,10
Hurricane,Gordon,14,2000-09-17T18:00:00Z,37.5N  74.0W,0,3,12,2,17
Hurricane,Gordon,14,2000-09-17T18:00:00Z,BAR HARBOR ME,0,0,0,9,9
Hurricane,Gordon,14,2000-09-17T18:00:00Z,BERMUDA,0,0,0,2,2
Hurricane,Gordon,14,2000-09-17T18:00:00Z,EASTPORT ME,0,0,0,8,8
Hurricane,Gordon,14,2000-09-17T18:00:00Z,FT PIERCE FL,7,0,0,1,8
Hurricane,Gordon,14,2000-09-17T18:00:00Z,ST JOHN NB,0,0,0,8,8
Hurricane,Gordon,14,2000-09-17T18:00:00Z,COCOA BEACH FL,25,0,0,1,26
Hurricane,Gordon,14,2000-09-17T18:00:00Z,MONCTON NB,0,0,0,7,7
Hurricane,Gordon,14,2000-09-17T18:00:00Z,DAYTONA BEACH FL,51,0,0,0,51
Hurricane,Gordon,14,2000-09-17T18:00:00Z,YARMOUTH NS,0,0,0,9,9
Hurricane,Gordon,14,2000-09-17T18:00:00Z,JACKSONVILLE FL,52,0,0,0,52
Hurricane,Gordon,14,2000-09-17T18:00:00Z,HALIFAX NS,0,0,0,8,8
Hurricane,Gordon,14,2000-09-17T18:00:00Z,SAVANNAH GA,35,1,0,0,36
Hurricane,Gordon,14,2000-09-17T18:00:00Z,SABLE ISLAND NS,0,0,0,6,6
Hurricane,Gordon,14,2000-09-17T18:00:00Z,CHARLESTON SC,25,7,0,0,32
Hurricane,Gordon,14,2000-09-17T18:00:00Z,SYDNEY NS,0,0,0,5,5
Hurricane,Gordon,14,2000-09-17T18:00:00Z,MYRTLE BEACH SC,10,17,1,0,28
Hurricane,Gordon,14,2000-09-17T18:00:00Z,EDDY POINT NS,0,0,0,6,6
Hurricane,Gordon,14,2000-09-17T18:00:00Z,WILMINGTON NC,2,22,1,0,25
Hurricane,Gordon,14,2000-09-17T18:00:00Z,PTX BASQUES NFLD,0,0,0,3,3
Hurricane,Gordon,14,2000-09-17T18:00:00Z,MOREHEAD CITY NC,0,19,3,0,22
Hurricane,Gordon,14,2000-09-17T18:00:00Z,BURGEO NFLD,0,0,0,3,3
Hurricane,Gordon,14,2000-09-17T18:00:00Z,CAPE HATTERAS NC,0,13,6,1,20
Hurricane,Gordon,14,2000-09-17T18:00:00Z,ILE ST PIERRE,0,0,0,2,2
Hurricane,Gordon,14,2000-09-17T18:00:00Z,NORFOLK VA,0,10,8,1,19
Hurricane,Gordon,14,2000-09-17T18:00:00Z,FT MYERS FL,6,1,0,0,7
Hurricane,Gordon,14,2000-09-17T18:00:00Z,OCEAN CITY MD,0,3,12,2,17
Hurricane,Gordon,14,2000-09-17T18:00:00Z,VENICE FL,64,0,0,0,64
Hurricane,Gordon,14,2000-09-17T18:00:00Z,ATLANTIC CITY NJ,0,1,11,3,15
Hurricane,Gordon,14,2000-09-17T18:00:00Z,TAMPA FL,81,0,0,0,81
Hurricane,Gordon,14,2000-09-17T18:00:00Z,NEW YORK CITY NY,0,0,9,4,13
Hurricane,Gordon,14,2000-09-17T18:00:00Z,CEDAR KEY FL,76,0,0,0,76
Hurricane,Gordon,14,2000-09-17T18:00:00Z,MONTAUK POINT NY,0,0,6,7,13
Hurricane,Gordon,14,2000-09-17T18:00:00Z,ST MARKS FL,19,1,0,0,20
Hurricane,Gordon,14,2000-09-17T18:00:00Z,PROVIDENCE RI,0,0,4,8,12
Hurricane,Gordon,14,2000-09-17T18:00:00Z,APALACHICOLA FL,4,0,0,0,4
Hurricane,Gordon,14,2000-09-17T18:00:00Z,NANTUCKET MA,0,0,3,10,13
Hurricane,Gordon,14,2000-09-17T18:00:00Z,GULF 29N 85W,11,0,0,0,11
Hurricane,Gordon,14,2000-09-17T18:00:00Z,HYANNIS MA,0,0,3,9,12
Hurricane,Gordon,15,2000-09-17T21:00:00Z,32.8N  80.0W,38,2,0,0,40
Hurricane,Gordon,15,2000-09-17T21:00:00Z,BOSTON MA,0,0,4,7,11
Hurricane,Gordon,15,2000-09-17T21:00:00Z,35.5N  76.5W,0,21,2,0,23
Hurricane,Gordon,15,2000-09-17T21:00:00Z,PORTLAND ME,0,0,2,7,9
Hurricane,Gordon,15,2000-09-17T21:00:00Z,38.5N  72.5W,0,1,13,2,16
Hurricane,Gordon,15,2000-09-17T21:00:00Z,BAR HARBOR ME,0,0,1,8,9
Hurricane,Gordon,15,2000-09-17T21:00:00Z,BERMUDA,0,0,0,3,3
Hurricane,Gordon,15,2000-09-17T21:00:00Z,EASTPORT ME,0,0,0,9,9
Hurricane,Gordon,15,2000-09-17T21:00:00Z,COCOA BEACH FL,12,1,0,0,13
Hurricane,Gordon,15,2000-09-17T21:00:00Z,ST JOHN NB,0,0,0,9,9
Hurricane,Gordon,15,2000-09-17T21:00:00Z,DAYTONA BEACH FL,57,0,0,0,57
Hurricane,Gordon,15,2000-09-17T21:00:00Z,MONCTON NB,0,0,0,8,8
Hurricane,Gordon,15,2000-09-17T21:00:00Z,JACKSONVILLE FL,66,0,0,0,66
Hurricane,Gordon,15,2000-09-17T21:00:00Z,YARMOUTH NS,0,0,0,10,10
Hurricane,Gordon,15,2000-09-17T21:00:00Z,SAVANNAH GA,45,0,0,0,45
Hurricane,Gordon,15,2000-09-17T21:00:00Z,HALIFAX NS,0,0,0,9,9
Hurricane,Gordon,15,2000-09-17T21:00:00Z,CHARLESTON SC,36,2,0,0,38
Hurricane,Gordon,15,2000-09-17T21:00:00Z,SABLE ISLAND NS,0,0,0,7,7
Hurricane,Gordon,15,2000-09-17T21:00:00Z,MYRTLE BEACH SC,19,13,0,1,33
Hurricane,Gordon,15,2000-09-17T21:00:00Z,SYDNEY NS,0,0,0,7,7
Hurricane,Gordon,15,2000-09-17T21:00:00Z,WILMINGTON NC,6,22,0,0,28
Hurricane,Gordon,15,2000-09-17T21:00:00Z,EDDY POINT NS,0,0,0,8,8
Hurricane,Gordon,15,2000-09-17T21:00:00Z,MOREHEAD CITY NC,1,23,1,0,25
Hurricane,Gordon,15,2000-09-17T21:00:00Z,PTX BASQUES NFLD,0,0,0,5,5
Hurricane,Gordon,15,2000-09-17T21:00:00Z,CAPE HATTERAS NC,0,18,4,0,22
Hurricane,Gordon,15,2000-09-17T21:00:00Z,BURGEO NFLD,0,0,0,4,4
Hurricane,Gordon,15,2000-09-17T21:00:00Z,NORFOLK VA,0,13,6,0,19
Hurricane,Gordon,15,2000-09-17T21:00:00Z,ILE ST PIERRE,0,0,0,4,4
Hurricane,Gordon,15,2000-09-17T21:00:00Z,OCEAN CITY MD,0,5,11,0,16
Hurricane,Gordon,15,2000-09-17T21:00:00Z,CAPE RACE NFLD,0,0,0,2,2
Hurricane,Gordon,15,2000-09-17T21:00:00Z,ATLANTIC CITY NJ,0,2,11,1,14
Hurricane,Gordon,15,2000-09-17T21:00:00Z,VENICE FL,40,0,0,0,40
Hurricane,Gordon,15,2000-09-17T21:00:00Z,NEW YORK CITY NY,0,0,10,2,12
Hurricane,Gordon,15,2000-09-17T21:00:00Z,TAMPA FL,99,0,0,0,99
Hurricane,Gordon,15,2000-09-17T21:00:00Z,MONTAUK POINT NY,0,0,7,6,13
Hurricane,Gordon,15,2000-09-17T21:00:00Z,CEDAR KEY FL,99,0,0,0,99
Hurricane,Gordon,15,2000-09-17T21:00:00Z,PROVIDENCE RI,0,0,6,6,12
Hurricane,Gordon,15,2000-09-17T21:00:00Z,ST MARKS FL,23,0,0,0,23
Hurricane,Gordon,15,2000-09-17T21:00:00Z,NANTUCKET MA,0,0,5,8,13
Hurricane,Gordon,15,2000-09-17T21:00:00Z,APALACHICOLA FL,2,0,0,0,2
Hurricane,Gordon,15,2000-09-17T21:00:00Z,HYANNIS MA,0,0,5,7,12
Hurricane,Gordon,15,2000-09-17T21:00:00Z,GULF 29N 85W,6,0,0,0,6
Tropical Storm,Gordon,16,2000-09-18T03:00:00Z,33.0N  79.6W,36,2,0,0,38
Tropical Storm,Gordon,16,2000-09-18T03:00:00Z,BOSTON MA,0,0,6,6,12
Tropical Storm,Gordon,16,2000-09-18T03:00:00Z,36.0N  76.0W,0,21,2,0,23
Tropical Storm,Gordon,16,2000-09-18T03:00:00Z,PORTLAND ME,0,0,3,7,10
Tropical Storm,Gordon,16,2000-09-18T03:00:00Z,39.0N  71.5W,0,1,13,2,16
Tropical Storm,Gordon,16,2000-09-18T03:00:00Z,BAR HARBOR ME,0,0,2,8,10
Tropical Storm,Gordon,16,2000-09-18T03:00:00Z,BERMUDA,0,0,0,2,2
Tropical Storm,Gordon,16,2000-09-18T03:00:00Z,EASTPORT ME,0,0,1,9,10
Tropical Storm,Gordon,16,2000-09-18T03:00:00Z,COCOA BEACH FL,6,0,0,0,6
Tropical Storm,Gordon,16,2000-09-18T03:00:00Z,ST JOHN NB,0,0,0,9,9
Tropical Storm,Gordon,16,2000-09-18T03:00:00Z,DAYTONA BEACH FL,58,0,0,0,58
Tropical Storm,Gordon,16,2000-09-18T03:00:00Z,MONCTON NB,0,0,0,9,9
Tropical Storm,Gordon,16,2000-09-18T03:00:00Z,JACKSONVILLE FL,74,0,0,0,74
Tropical Storm,Gordon,16,2000-09-18T03:00:00Z,YARMOUTH NS,0,0,1,10,11
Tropical Storm,Gordon,16,2000-09-18T03:00:00Z,SAVANNAH GA,48,0,0,0,48
Tropical Storm,Gordon,16,2000-09-18T03:00:00Z,HALIFAX NS,0,0,0,10,10
Tropical Storm,Gordon,16,2000-09-18T03:00:00Z,CHARLESTON SC,39,1,0,0,40
Tropical Storm,Gordon,16,2000-09-18T03:00:00Z,SABLE ISLAND NS,0,0,0,8,8
Tropical Storm,Gordon,16,2000-09-18T03:00:00Z,MYRTLE BEACH SC,26,8,0,0,34
Tropical Storm,Gordon,16,2000-09-18T03:00:00Z,SYDNEY NS,0,0,0,8,8
Tropical Storm,Gordon,16,2000-09-18T03:00:00Z,WILMINGTON NC,12,18,0,0,30
Tropical Storm,Gordon,16,2000-09-18T03:00:00Z,EDDY POINT NS,0,0,0,9,9
Tropical Storm,Gordon,16,2000-09-18T03:00:00Z,MOREHEAD CITY NC,3,24,0,0,27
Tropical Storm,Gordon,16,2000-09-18T03:00:00Z,PTX BASQUES NFLD,0,0,0,6,6
Tropical Storm,Gordon,16,2000-09-18T03:00:00Z,CAPE HATTERAS NC,0,22,2,0,24
Tropical Storm,Gordon,16,2000-09-18T03:00:00Z,BURGEO NFLD,0,0,0,5,5
Tropical Storm,Gordon,16,2000-09-18T03:00:00Z,NORFOLK VA,0,17,4,0,21
Tropical Storm,Gordon,16,2000-09-18T03:00:00Z,ILE ST PIERRE,0,0,0,5,5
Tropical Storm,Gordon,16,2000-09-18T03:00:00Z,OCEAN CITY MD,0,8,9,1,18
Tropical Storm,Gordon,16,2000-09-18T03:00:00Z,CAPE RACE NFLD,0,0,0,3,3
Tropical Storm,Gordon,16,2000-09-18T03:00:00Z,ATLANTIC CITY NJ,0,3,11,1,15
Tropical Storm,Gordon,16,2000-09-18T03:00:00Z,TAMPA FL,85,0,0,0,85
Tropical Storm,Gordon,16,2000-09-18T03:00:00Z,NEW YORK CITY NY,0,1,11,1,13
Tropical Storm,Gordon,16,2000-09-18T03:00:00Z,CEDAR KEY FL,99,0,0,0,99
Tropical Storm,Gordon,16,2000-09-18T03:00:00Z,MONTAUK POINT NY,0,0,10,3,13
Tropical Storm,Gordon,16,2000-09-18T03:00:00Z,ST MARKS FL,68,0,0,0,68
Tropical Storm,Gordon,16,2000-09-18T03:00:00Z,PROVIDENCE RI,0,0,8,5,13
Tropical Storm,Gordon,16,2000-09-18T03:00:00Z,APALACHICOLA FL,18,0,0,0,18
Tropical Storm,Gordon,16,2000-09-18T03:00:00Z,NANTUCKET MA,0,0,8,5,13
Tropical Storm,Gordon,16,2000-09-18T03:00:00Z,GULF 29N 85W,3,0,0,0,3
Tropical Storm,Gordon,16,2000-09-18T03:00:00Z,HYANNIS MA,0,0,7,6,13
Tropical Depression,Twelve,1,2000-09-15T21:00:00Z,16.3N  58.6W,55,0,0,0,55
Tropical Depression,Twelve,1,2000-09-15T21:00:00Z,TIST 183N 650W,0,2,16,3,21
Tropical Depression,Twelve,1,2000-09-15T21:00:00Z,16.5N  61.5W,1,32,0,0,33
Tropical Depression,Twelve,1,2000-09-15T21:00:00Z,TJPS 180N 666W,0,0,13,7,20
Tropical Depression,Twelve,1,2000-09-15T21:00:00Z,16.5N  64.5W,0,7,17,1,25
Tropical Depression,Twelve,1,2000-09-15T21:00:00Z,MDSD 185N 697W,0,0,1,16,17
Tropical Depression,Twelve,1,2000-09-15T21:00:00Z,SKPG 125N 717W,0,0,0,6,6
Tropical Depression,Twelve,1,2000-09-15T21:00:00Z,MDCB 176N 714W,0,0,0,16,16
Tropical Depression,Twelve,1,2000-09-15T21:00:00Z,TNCC 122N 690W,0,0,0,7,7
Tropical Depression,Twelve,1,2000-09-15T21:00:00Z,MTPP 186N 724W,0,0,0,14,14
Tropical Depression,Twelve,1,2000-09-15T21:00:00Z,TGPY 120N 618W,0,1,0,1,2
Tropical Depression,Twelve,1,2000-09-15T21:00:00Z,MTCA 183N 738W,0,0,0,11,11
Tropical Depression,Twelve,1,2000-09-15T21:00:00Z,TBPB 131N 595W,1,3,0,0,4
Tropical Depression,Twelve,1,2000-09-15T21:00:00Z,MKJP 179N 768W,0,0,0,3,3
Tropical Depression,Twelve,1,2000-09-15T21:00:00Z,TVSV 131N 612W,0,4,3,0,7
Tropical Depression,Twelve,1,2000-09-15T21:00:00Z,MUGM 200N 751W,0,0,0,5,5
Tropical Depression,Twelve,1,2000-09-15T21:00:00Z,TLPL 138N 610W,0,12,2,0,14
Tropical Depression,Twelve,1,2000-09-15T21:00:00Z,TJSJ 184N 661W,0,0,14,5,19
Tropical Depression,Twelve,1,2000-09-15T21:00:00Z,TFFF 146N 610W,2,20,1,0,23
Tropical Depression,Twelve,1,2000-09-15T21:00:00Z,MDPP 198N 707W,0,0,0,13,13
Tropical Depression,Twelve,1,2000-09-15T21:00:00Z,TDPR 153N 614W,1,27,1,0,29
Tropical Depression,Twelve,1,2000-09-15T21:00:00Z,MBJT 215N 712W,0,0,0,7,7
Tropical Depression,Twelve,1,2000-09-15T21:00:00Z,TFFR 163N 615W,1,32,0,0,33
Tropical Depression,Twelve,1,2000-09-15T21:00:00Z,MYMM 224N 730W,0,0,0,3,3
Tropical Depression,Twelve,1,2000-09-15T21:00:00Z,TAPA 171N 618W,0,30,1,0,31
Tropical Depression,Twelve,1,2000-09-15T21:00:00Z,ST CROIX VI,0,3,18,2,23
Tropical Depression,Twelve,1,2000-09-15T21:00:00Z,TKPK 173N 627W,0,22,6,0,28
Tropical Depression,Twelve,1,2000-09-15T21:00:00Z,ST THOMAS VI,0,2,16,3,21
Tropical Depression,Twelve,1,2000-09-15T21:00:00Z,TNCM 181N 631W,0,14,9,1,24
Tropical Depression,Twelve,1,2000-09-15T21:00:00Z,SAN JUAN PR,0,0,14,5,19
Tropical Depression,Twelve,1,2000-09-15T21:00:00Z,TISX 177N 648W,0,3,18,2,23
Tropical Depression,Twelve,1,2000-09-15T21:00:00Z,PONCE PR,0,0,13,7,20
Tropical Depression,Twelve,2,2000-09-16T03:00:00Z,16.4N  58.7W,53,0,0,0,53
Tropical Depression,Twelve,2,2000-09-16T03:00:00Z,TIST 183N 650W,0,3,16,2,21
Tropical Depression,Twelve,2,2000-09-16T03:00:00Z,16.5N  61.7W,1,31,0,1,33
Tropical Depression,Twelve,2,2000-09-16T03:00:00Z,TJPS 180N 666W,0,0,15,5,20
Tropical Depression,Twelve,2,2000-09-16T03:00:00Z,16.5N  65.0W,0,5,18,1,24
Tropical Depression,Twelve,2,2000-09-16T03:00:00Z,MDSD 185N 697W,0,0,2,15,17
Tropical Depression,Twelve,2,2000-09-16T03:00:00Z,SKPG 125N 717W,0,0,0,8,8
Tropical Depression,Twelve,2,2000-09-16T03:00:00Z,MDCB 176N 714W,0,0,0,16,16
Tropical Depression,Twelve,2,2000-09-16T03:00:00Z,TNCC 122N 690W,0,0,1,8,9
Tropical Depression,Twelve,2,2000-09-16T03:00:00Z,MTPP 186N 724W,0,0,0,14,14
Tropical Depression,Twelve,2,2000-09-16T03:00:00Z,SVMG 110N 640W,0,0,1,1,2
Tropical Depression,Twelve,2,2000-09-16T03:00:00Z,MTCA 183N 738W,0,0,0,12,12
Tropical Depression,Twelve,2,2000-09-16T03:00:00Z,TGPY 120N 618W,0,2,2,0,4
Tropical Depression,Twelve,2,2000-09-16T03:00:00Z,MKJP 179N 768W,0,0,0,4,4
Tropical Depression,Twelve,2,2000-09-16T03:00:00Z,TBPB 131N 595W,5,7,1,0,13
Tropical Depression,Twelve,2,2000-09-16T03:00:00Z,MKJS 185N 779W,0,0,0,2,2
Tropical Depression,Twelve,2,2000-09-16T03:00:00Z,TVSV 131N 612W,0,10,2,0,12
Tropical Depression,Twelve,2,2000-09-16T03:00:00Z,MUGM 200N 751W,0,0,0,6,6
Tropical Depression,Twelve,2,2000-09-16T03:00:00Z,TLPL 138N 610W,1,17,1,0,19
Tropical Depression,Twelve,2,2000-09-16T03:00:00Z,TJSJ 184N 661W,0,1,14,4,19
Tropical Depression,Twelve,2,2000-09-16T03:00:00Z,TFFF 146N 610W,3,23,0,0,26
Tropical Depression,Twelve,2,2000-09-16T03:00:00Z,MDPP 198N 707W,0,0,0,13,13
Tropical Depression,Twelve,2,2000-09-16T03:00:00Z,TDPR 153N 614W,1,29,0,0,30
Tropical Depression,Twelve,2,2000-09-16T03:00:00Z,MBJT 215N 712W,0,0,0,7,7
Tropical Depression,Twelve,2,2000-09-16T03:00:00Z,TFFR 163N 615W,1,32,0,0,33
Tropical Depression,Twelve,2,2000-09-16T03:00:00Z,MYMM 224N 730W,0,0,0,3,3
Tropical Depression,Twelve,2,2000-09-16T03:00:00Z,TAPA 171N 618W,0,31,0,0,31
Tropical Depression,Twelve,2,2000-09-16T03:00:00Z,ST CROIX VI,0,5,17,1,23
Tropical Depression,Twelve,2,2000-09-16T03:00:00Z,TKPK 173N 627W,0,24,4,0,28
Tropical Depression,Twelve,2,2000-09-16T03:00:00Z,ST THOMAS VI,0,3,16,2,21
Tropical Depression,Twelve,2,2000-09-16T03:00:00Z,TNCM 181N 631W,0,17,7,0,24
Tropical Depression,Twelve,2,2000-09-16T03:00:00Z,SAN JUAN PR,0,1,14,4,19
Tropical Depression,Twelve,2,2000-09-16T03:00:00Z,TISX 177N 648W,0,5,17,1,23
Tropical Depression,Twelve,2,2000-09-16T03:00:00Z,PONCE PR,0,0,15,5,20
Tropical Depression,Twelve,3,2000-09-16T09:00:00Z,16.5N  59.6W,53,0,0,0,53
Tropical Depression,Twelve,3,2000-09-16T09:00:00Z,TJPS 180N 666W,0,2,17,2,21
Tropical Depression,Twelve,3,2000-09-16T09:00:00Z,16.5N  62.8W,0,33,0,0,33
Tropical Depression,Twelve,3,2000-09-16T09:00:00Z,MDSD 185N 697W,0,0,4,13,17
Tropical Depression,Twelve,3,2000-09-16T09:00:00Z,16.5N  66.0W,0,5,18,1,24
Tropical Depression,Twelve,3,2000-09-16T09:00:00Z,MDCB 176N 714W,0,0,1,16,17
Tropical Depression,Twelve,3,2000-09-16T09:00:00Z,SKPG 125N 717W,0,0,0,9,9
Tropical Depression,Twelve,3,2000-09-16T09:00:00Z,MTPP 186N 724W,0,0,0,15,15
Tropical Depression,Twelve,3,2000-09-16T09:00:00Z,TNCC 122N 690W,0,0,1,8,9
Tropical Depression,Twelve,3,2000-09-16T09:00:00Z,MTCA 183N 738W,0,0,0,13,13
Tropical Depression,Twelve,3,2000-09-16T09:00:00Z,TGPY 120N 618W,0,2,1,0,3
Tropical Depression,Twelve,3,2000-09-16T09:00:00Z,MKJP 179N 768W,0,0,0,7,7
Tropical Depression,Twelve,3,2000-09-16T09:00:00Z,TBPB 131N 595W,6,4,0,0,10
Tropical Depression,Twelve,3,2000-09-16T09:00:00Z,MKJS 185N 779W,0,0,0,3,3
Tropical Depression,Twelve,3,2000-09-16T09:00:00Z,TVSV 131N 612W,1,8,1,1,11
Tropical Depression,Twelve,3,2000-09-16T09:00:00Z,MUGM 200N 751W,0,0,0,8,8
Tropical Depression,Twelve,3,2000-09-16T09:00:00Z,TLPL 138N 610W,4,14,1,0,19
Tropical Depression,Twelve,3,2000-09-16T09:00:00Z,TJSJ 184N 661W,0,3,16,1,20
Tropical Depression,Twelve,3,2000-09-16T09:00:00Z,TFFF 146N 610W,9,19,0,1,29
Tropical Depression,Twelve,3,2000-09-16T09:00:00Z,MDPP 198N 707W,0,0,1,12,13
Tropical Depression,Twelve,3,2000-09-16T09:00:00Z,TDPR 153N 614W,8,26,0,0,34
Tropical Depression,Twelve,3,2000-09-16T09:00:00Z,MBJT 215N 712W,0,0,0,7,7
Tropical Depression,Twelve,3,2000-09-16T09:00:00Z,TFFR 163N 615W,10,29,0,0,39
Tropical Depression,Twelve,3,2000-09-16T09:00:00Z,MYMM 224N 730W,0,0,0,4,4
Tropical Depression,Twelve,3,2000-09-16T09:00:00Z,TAPA 171N 618W,5,32,0,0,37
Tropical Depression,Twelve,3,2000-09-16T09:00:00Z,ST CROIX VI,0,13,11,1,25
Tropical Depression,Twelve,3,2000-09-16T09:00:00Z,TKPK 173N 627W,0,32,0,0,32
Tropical Depression,Twelve,3,2000-09-16T09:00:00Z,ST THOMAS VI,0,9,13,0,22
Tropical Depression,Twelve,3,2000-09-16T09:00:00Z,TNCM 181N 631W,0,25,2,0,27
Tropical Depression,Twelve,3,2000-09-16T09:00:00Z,SAN JUAN PR,0,3,16,1,20
Tropical Depression,Twelve,3,2000-09-16T09:00:00Z,TISX 177N 648W,0,13,11,1,25
Tropical Depression,Twelve,3,2000-09-16T09:00:00Z,PONCE PR,0,2,17,2,21
Tropical Depression,Twelve,3,2000-09-16T09:00:00Z,TIST 183N 650W,0,9,13,0,22
Tropical Depression,Twelve,4,2000-09-16T15:00:00Z,16.5N  63.0W,53,0,0,0,53
Tropical Depression,Twelve,4,2000-09-16T15:00:00Z,MTCA 183N 738W,0,0,2,15,17
Tropical Depression,Twelve,4,2000-09-16T15:00:00Z,16.8N  66.0W,0,31,0,0,31
Tropical Depression,Twelve,4,2000-09-16T15:00:00Z,MKJP 179N 768W,0,0,0,12,12
Tropical Depression,Twelve,4,2000-09-16T15:00:00Z,17.0N  69.0W,0,6,16,1,23
Tropical Depression,Twelve,4,2000-09-16T15:00:00Z,MKJS 185N 779W,0,0,0,9,9
Tropical Depression,Twelve,4,2000-09-16T15:00:00Z,SKPG 125N 717W,0,0,2,7,9
Tropical Depression,Twelve,4,2000-09-16T15:00:00Z,MWCG 193N 814W,0,0,0,2,2
Tropical Depression,Twelve,4,2000-09-16T15:00:00Z,TNCC 122N 690W,0,0,4,3,7
Tropical Depression,Twelve,4,2000-09-16T15:00:00Z,MUGM 200N 751W,0,0,0,13,13
Tropical Depression,Twelve,4,2000-09-16T15:00:00Z,TVSV 131N 612W,2,0,0,0,2
Tropical Depression,Twelve,4,2000-09-16T15:00:00Z,MUCM 214N 779W,0,0,0,6,6
Tropical Depression,Twelve,4,2000-09-16T15:00:00Z,TLPL 138N 610W,9,1,0,0,10
Tropical Depression,Twelve,4,2000-09-16T15:00:00Z,MUCF 221N 805W,0,0,0,2,2
Tropical Depression,Twelve,4,2000-09-16T15:00:00Z,TFFF 146N 610W,37,0,0,0,37
Tropical Depression,Twelve,4,2000-09-16T15:00:00Z,TJSJ 184N 661W,0,24,2,0,26
Tropical Depression,Twelve,4,2000-09-16T15:00:00Z,TDPR 153N 614W,57,0,0,0,57
Tropical Depression,Twelve,4,2000-09-16T15:00:00Z,MDPP 198N 707W,0,0,10,6,16
Tropical Depression,Twelve,4,2000-09-16T15:00:00Z,TFFR 163N 615W,68,0,1,0,69
Tropical Depression,Twelve,4,2000-09-16T15:00:00Z,MBJT 215N 712W,0,0,3,8,11
Tropical Depression,Twelve,4,2000-09-16T15:00:00Z,TAPA 171N 618W,63,0,0,0,63
Tropical Depression,Twelve,4,2000-09-16T15:00:00Z,MYMM 224N 730W,0,0,0,9,9
Tropical Depression,Twelve,4,2000-09-16T15:00:00Z,TKPK 173N 627W,53,0,0,0,53
Tropical Depression,Twelve,4,2000-09-16T15:00:00Z,MYSM 241N 745W,0,0,0,4,4
Tropical Depression,Twelve,4,2000-09-16T15:00:00Z,TNCM 181N 631W,36,4,0,0,40
Tropical Depression,Twelve,4,2000-09-16T15:00:00Z,MYEG 235N 758W,0,0,0,5,5
Tropical Depression,Twelve,4,2000-09-16T15:00:00Z,TISX 177N 648W,8,26,0,0,34
Tropical Depression,Twelve,4,2000-09-16T15:00:00Z,MYAK 241N 776W,0,0,0,2,2
Tropical Depression,Twelve,4,2000-09-16T15:00:00Z,TIST 183N 650W,3,26,0,0,29
Tropical Depression,Twelve,4,2000-09-16T15:00:00Z,ST CROIX VI,8,26,0,0,34
Tropical Depression,Twelve,4,2000-09-16T15:00:00Z,TJPS 180N 666W,0,24,2,0,26
Tropical Depression,Twelve,4,2000-09-16T15:00:00Z,ST THOMAS VI,3,26,0,0,29
Tropical Depression,Twelve,4,2000-09-16T15:00:00Z,MDSD 185N 697W,0,1,17,2,20
Tropical Depression,Twelve,4,2000-09-16T15:00:00Z,SAN JUAN PR,0,24,2,0,26
Tropical Depression,Twelve,4,2000-09-16T15:00:00Z,MDCB 176N 714W,0,0,12,7,19
Tropical Depression,Twelve,4,2000-09-16T15:00:00Z,PONCE PR,0,24,2,0,26
Tropical Depression,Twelve,4,2000-09-16T15:00:00Z,MTPP 186N 724W,0,0,6,12,18
Tropical Depression,Twelve,6,2000-09-19T23:00:00Z,22.0N  84.5W,50,1,0,0,51
Tropical Depression,Twelve,6,2000-09-19T23:00:00Z,MARCO ISLAND FL,0,2,4,6,12
Tropical Depression,Twelve,6,2000-09-19T23:00:00Z,24.0N  86.0W,4,32,0,0,36
Tropical Depression,Twelve,6,2000-09-19T23:00:00Z,FT MYERS FL,0,1,5,7,13
Tropical Depression,Twelve,6,2000-09-19T23:00:00Z,26.0N  86.5W,0,13,13,1,27
Tropical Depression,Twelve,6,2000-09-19T23:00:00Z,VENICE FL,0,1,7,7,15
Tropical Depression,Twelve,6,2000-09-19T23:00:00Z,MWCG 193N 814W,79,0,0,0,79
Tropical Depression,Twelve,6,2000-09-19T23:00:00Z,TAMPA FL,0,0,5,9,14
Tropical Depression,Twelve,6,2000-09-19T23:00:00Z,MUCF 221N 805W,23,0,0,1,24
Tropical Depression,Twelve,6,2000-09-19T23:00:00Z,CEDAR KEY FL,0,0,3,11,14
Tropical Depression,Twelve,6,2000-09-19T23:00:00Z,MUSN 216N 826W,73,0,0,0,73
Tropical Depression,Twelve,6,2000-09-19T23:00:00Z,ST MARKS FL,0,0,1,14,15
Tropical Depression,Twelve,6,2000-09-19T23:00:00Z,MUHA 230N 824W,42,0,0,0,42
Tropical Depression,Twelve,6,2000-09-19T23:00:00Z,APALACHICOLA FL,0,0,3,14,17
Tropical Depression,Twelve,6,2000-09-19T23:00:00Z,MUAN 219N 850W,43,2,0,0,45
Tropical Depression,Twelve,6,2000-09-19T23:00:00Z,PANAMA CITY FL,0,0,3,14,17
Tropical Depression,Twelve,6,2000-09-19T23:00:00Z,MMCZ 205N 869W,3,8,0,0,11
Tropical Depression,Twelve,6,2000-09-19T23:00:00Z,PENSACOLA FL,0,0,1,15,16
Tropical Depression,Twelve,6,2000-09-19T23:00:00Z,MYNN 251N 775W,0,0,0,2,2
Tropical Depression,Twelve,6,2000-09-19T23:00:00Z,MOBILE AL,0,0,1,14,15
Tropical Depression,Twelve,6,2000-09-19T23:00:00Z,MYGF 266N 787W,0,0,0,5,5
Tropical Depression,Twelve,6,2000-09-19T23:00:00Z,GULFPORT MS,0,0,1,13,14
Tropical Depression,Twelve,6,2000-09-19T23:00:00Z,MARATHON FL,1,1,1,5,8
Tropical Depression,Twelve,6,2000-09-19T23:00:00Z,BURAS LA,0,0,1,13,14
Tropical Depression,Twelve,6,2000-09-19T23:00:00Z,MIAMI FL,0,0,1,6,7
Tropical Depression,Twelve,6,2000-09-19T23:00:00Z,NEW ORLEANS LA,0,0,0,12,12
Tropical Depression,Twelve,6,2000-09-19T23:00:00Z,W PALM BEACH FL,0,0,0,8,8
Tropical Depression,Twelve,6,2000-09-19T23:00:00Z,NEW IBERIA LA,0,0,0,8,8
Tropical Depression,Twelve,6,2000-09-19T23:00:00Z,FT PIERCE FL,0,0,0,9,9
Tropical Depression,Twelve,6,2000-09-19T23:00:00Z,PORT ARTHUR TX,0,0,0,3,3
Tropical Depression,Twelve,6,2000-09-19T23:00:00Z,COCOA BEACH FL,0,0,0,9,9
Tropical Depression,Twelve,6,2000-09-19T23:00:00Z,GALVESTON TX,0,0,0,2,2
Tropical Depression,Twelve,6,2000-09-19T23:00:00Z,DAYTONA BEACH FL,0,0,0,10,10
Tropical Depression,Twelve,6,2000-09-19T23:00:00Z,GULF 29N 85W,0,0,7,11,18
Tropical Depression,Twelve,6,2000-09-19T23:00:00Z,JACKSONVILLE FL,0,0,0,10,10
Tropical Depression,Twelve,6,2000-09-19T23:00:00Z,GULF 29N 87W,0,0,7,12,19
Tropical Depression,Twelve,6,2000-09-19T23:00:00Z,SAVANNAH GA,0,0,0,6,6
Tropical Depression,Twelve,6,2000-09-19T23:00:00Z,GULF 28N 89W,0,0,7,9,16
Tropical Depression,Twelve,6,2000-09-19T23:00:00Z,CHARLESTON SC,0,0,0,2,2
Tropical Depression,Twelve,6,2000-09-19T23:00:00Z,GULF 28N 91W,0,0,1,9,10
Tropical Depression,Twelve,6,2000-09-19T23:00:00Z,KEY WEST FL,4,5,1,2,12
Tropical Depression,Twelve,6,2000-09-19T23:00:00Z,GULF 28N 93W,0,0,0,4,4
Tropical Depression,Twelve,7,2000-09-20T03:00:00Z,22.7N  85.3W,52,0,0,0,52
Tropical Depression,Twelve,7,2000-09-20T03:00:00Z,MARCO ISLAND FL,0,1,3,7,11
Tropical Depression,Twelve,7,2000-09-20T03:00:00Z,24.5N  86.5W,7,29,0,0,36
Tropical Depression,Twelve,7,2000-09-20T03:00:00Z,FT MYERS FL,0,1,3,8,12
Tropical Depression,Twelve,7,2000-09-20T03:00:00Z,26.5N  86.5W,0,14,13,1,28
Tropical Depression,Twelve,7,2000-09-20T03:00:00Z,VENICE FL,0,1,6,7,14
Tropical Depression,Twelve,7,2000-09-20T03:00:00Z,MWCG 193N 814W,99,0,0,0,99
Tropical Depression,Twelve,7,2000-09-20T03:00:00Z,TAMPA FL,0,0,4,10,14
Tropical Depression,Twelve,7,2000-09-20T03:00:00Z,MUCF 221N 805W,3,0,0,1,4
Tropical Depression,Twelve,7,2000-09-20T03:00:00Z,CEDAR KEY FL,0,0,2,12,14
Tropical Depression,Twelve,7,2000-09-20T03:00:00Z,MUSN 216N 826W,74,0,0,0,74
Tropical Depression,Twelve,7,2000-09-20T03:00:00Z,ST MARKS FL,0,0,1,14,15
Tropical Depression,Twelve,7,2000-09-20T03:00:00Z,MUHA 230N 824W,30,0,0,1,31
Tropical Depression,Twelve,7,2000-09-20T03:00:00Z,APALACHICOLA FL,0,0,4,13,17
Tropical Depression,Twelve,7,2000-09-20T03:00:00Z,MUAN 219N 850W,56,0,0,0,56
Tropical Depression,Twelve,7,2000-09-20T03:00:00Z,PANAMA CITY FL,0,0,3,15,18
Tropical Depression,Twelve,7,2000-09-20T03:00:00Z,MMCZ 205N 869W,9,2,0,0,11
Tropical Depression,Twelve,7,2000-09-20T03:00:00Z,PENSACOLA FL,0,0,2,15,17
Tropical Depression,Twelve,7,2000-09-20T03:00:00Z,MYGF 266N 787W,0,0,0,4,4
Tropical Depression,Twelve,7,2000-09-20T03:00:00Z,MOBILE AL,0,0,1,15,16
Tropical Depression,Twelve,7,2000-09-20T03:00:00Z,MARATHON FL,0,0,1,6,7
Tropical Depression,Twelve,7,2000-09-20T03:00:00Z,GULFPORT MS,0,0,1,14,15
Tropical Depression,Twelve,7,2000-09-20T03:00:00Z,MIAMI FL,0,0,1,6,7
Tropical Depression,Twelve,7,2000-09-20T03:00:00Z,BURAS LA,0,0,3,12,15
Tropical Depression,Twelve,7,2000-09-20T03:00:00Z,W PALM BEACH FL,0,0,0,7,7
Tropical Depression,Twelve,7,2000-09-20T03:00:00Z,NEW ORLEANS LA,0,0,1,11,12
Tropical Depression,Twelve,7,2000-09-20T03:00:00Z,FT PIERCE FL,0,0,0,8,8
Tropical Depression,Twelve,7,2000-09-20T03:00:00Z,NEW IBERIA LA,0,0,0,8,8
Tropical Depression,Twelve,7,2000-09-20T03:00:00Z,COCOA BEACH FL,0,0,0,9,9
Tropical Depression,Twelve,7,2000-09-20T03:00:00Z,PORT ARTHUR TX,0,0,0,2,2
Tropical Depression,Twelve,7,2000-09-20T03:00:00Z,DAYTONA BEACH FL,0,0,0,9,9
Tropical Depression,Twelve,7,2000-09-20T03:00:00Z,GULF 29N 85W,0,0,8,11,19
Tropical Depression,Twelve,7,2000-09-20T03:00:00Z,JACKSONVILLE FL,0,0,0,9,9
Tropical Depression,Twelve,7,2000-09-20T03:00:00Z,GULF 29N 87W,0,0,10,10,20
Tropical Depression,Twelve,7,2000-09-20T03:00:00Z,SAVANNAH GA,0,0,0,5,5
Tropical Depression,Twelve,7,2000-09-20T03:00:00Z,GULF 28N 89W,0,0,11,7,18
Tropical Depression,Twelve,7,2000-09-20T03:00:00Z,CHARLESTON SC,0,0,0,2,2
Tropical Depression,Twelve,7,2000-09-20T03:00:00Z,GULF 28N 91W,0,0,3,7,10
Tropical Depression,Twelve,7,2000-09-20T03:00:00Z,KEY WEST FL,1,1,3,4,9
Tropical Depression,Twelve,7,2000-09-20T03:00:00Z,GULF 28N 93W,0,0,0,3,3
Tropical Depression,Twelve,8,2000-09-20T09:00:00Z,24.5N  87.0W,48,0,0,0,48
Tropical Depression,Twelve,8,2000-09-20T09:00:00Z,FT MYERS FL,0,2,5,2,9
Tropical Depression,Twelve,8,2000-09-20T09:00:00Z,27.0N  87.5W,3,27,0,0,30
Tropical Depression,Twelve,8,2000-09-20T09:00:00Z,VENICE FL,0,3,7,2,12
Tropical Depression,Twelve,8,2000-09-20T09:00:00Z,29.5N  87.5W,0,4,15,2,21
Tropical Depression,Twelve,8,2000-09-20T09:00:00Z,TAMPA FL,0,1,8,3,12
Tropical Depression,Twelve,8,2000-09-20T09:00:00Z,MUSN 216N 826W,99,0,0,0,99
Tropical Depression,Twelve,8,2000-09-20T09:00:00Z,CEDAR KEY FL,0,0,9,4,13
Tropical Depression,Twelve,8,2000-09-20T09:00:00Z,MUHA 230N 824W,4,1,0,0,5
Tropical Depression,Twelve,8,2000-09-20T09:00:00Z,ST MARKS FL,0,0,9,6,15
Tropical Depression,Twelve,8,2000-09-20T09:00:00Z,MUAN 219N 850W,90,0,0,0,90
Tropical Depression,Twelve,8,2000-09-20T09:00:00Z,APALACHICOLA FL,0,1,13,3,17
Tropical Depression,Twelve,8,2000-09-20T09:00:00Z,MYGF 266N 787W,0,0,1,2,3
Tropical Depression,Twelve,8,2000-09-20T09:00:00Z,PANAMA CITY FL,0,1,13,4,18
Tropical Depression,Twelve,8,2000-09-20T09:00:00Z,MARATHON FL,0,1,1,1,3
Tropical Depression,Twelve,8,2000-09-20T09:00:00Z,PENSACOLA FL,0,0,15,3,18
Tropical Depression,Twelve,8,2000-09-20T09:00:00Z,MIAMI FL,0,0,2,2,4
Tropical Depression,Twelve,8,2000-09-20T09:00:00Z,MOBILE AL,0,0,14,4,18
Tropical Depression,Twelve,8,2000-09-20T09:00:00Z,W PALM BEACH FL,0,0,2,3,5
Tropical Depression,Twelve,8,2000-09-20T09:00:00Z,GULFPORT MS,0,1,14,3,18
Tropical Depression,Twelve,8,2000-09-20T09:00:00Z,FT PIERCE FL,0,0,3,3,6
Tropical Depression,Twelve,8,2000-09-20T09:00:00Z,BURAS LA,0,5,13,1,19
Tropical Depression,Twelve,8,2000-09-20T09:00:00Z,COCOA BEACH FL,0,0,3,5,8
Tropical Depression,Twelve,8,2000-09-20T09:00:00Z,NEW ORLEANS LA,0,2,13,2,17
Tropical Depression,Twelve,8,2000-09-20T09:00:00Z,DAYTONA BEACH FL,0,0,3,6,9
Tropical Depression,Twelve,8,2000-09-20T09:00:00Z,NEW IBERIA LA,0,1,10,2,13
Tropical Depression,Twelve,8,2000-09-20T09:00:00Z,JACKSONVILLE FL,0,0,2,9,11
Tropical Depression,Twelve,8,2000-09-20T09:00:00Z,PORT ARTHUR TX,0,0,4,3,7
Tropical Depression,Twelve,8,2000-09-20T09:00:00Z,SAVANNAH GA,0,0,0,9,9
Tropical Depression,Twelve,8,2000-09-20T09:00:00Z,GALVESTON TX,0,0,2,2,4
Tropical Depression,Twelve,8,2000-09-20T09:00:00Z,CHARLESTON SC,0,0,0,7,7
Tropical Depression,Twelve,8,2000-09-20T09:00:00Z,FREEPORT TX,0,0,1,1,2
Tropical Depression,Twelve,8,2000-09-20T09:00:00Z,MYRTLE BEACH SC,0,0,0,5,5
Tropical Depression,Twelve,8,2000-09-20T09:00:00Z,GULF 29N 85W,0,3,13,2,18
Tropical Depression,Twelve,8,2000-09-20T09:00:00Z,WILMINGTON NC,0,0,0,3,3
Tropical Depression,Twelve,8,2000-09-20T09:00:00Z,GULF 29N 87W,0,8,13,1,22
Tropical Depression,Twelve,8,2000-09-20T09:00:00Z,MOREHEAD CITY NC,0,0,0,2,2
Tropical Depression,Twelve,8,2000-09-20T09:00:00Z,GULF 28N 89W,0,20,3,0,23
Tropical Depression,Twelve,8,2000-09-20T09:00:00Z,KEY WEST FL,0,2,1,1,4
Tropical Depression,Twelve,8,2000-09-20T09:00:00Z,GULF 28N 91W,0,10,5,0,15
Tropical Depression,Twelve,8,2000-09-20T09:00:00Z,MARCO ISLAND FL,0,2,4,1,7
Tropical Depression,Twelve,8,2000-09-20T09:00:00Z,GULF 28N 93W,0,2,3,1,6
Tropical Depression,Twelve,9,2000-09-20T15:00:00Z,27.0N  88.7W,45,1,0,0,46
Tropical Depression,Twelve,9,2000-09-20T15:00:00Z,PENSACOLA FL,0,21,5,0,26
Tropical Depression,Twelve,9,2000-09-20T15:00:00Z,30.0N  88.7W,1,28,1,0,30
Tropical Depression,Twelve,9,2000-09-20T15:00:00Z,MOBILE AL,0,24,3,0,27
Tropical Depression,Twelve,9,2000-09-20T15:00:00Z,32.5N  86.5W,0,2,18,0,20
Tropical Depression,Twelve,9,2000-09-20T15:00:00Z,GULFPORT MS,0,26,2,0,28
Tropical Depression,Twelve,9,2000-09-20T15:00:00Z,MUAN 219N 850W,99,0,0,0,99
Tropical Depression,Twelve,9,2000-09-20T15:00:00Z,BURAS LA,3,27,1,0,31
Tropical Depression,Twelve,9,2000-09-20T15:00:00Z,DAYTONA BEACH FL,0,0,2,0,2
Tropical Depression,Twelve,9,2000-09-20T15:00:00Z,NEW ORLEANS LA,0,24,1,0,25
Tropical Depression,Twelve,9,2000-09-20T15:00:00Z,JACKSONVILLE FL,0,0,6,0,6
Tropical Depression,Twelve,9,2000-09-20T15:00:00Z,NEW IBERIA LA,0,12,1,0,13
Tropical Depression,Twelve,9,2000-09-20T15:00:00Z,SAVANNAH GA,0,0,4,0,4
Tropical Depression,Twelve,9,2000-09-20T15:00:00Z,GULF 29N 85W,0,12,4,0,16
Tropical Depression,Twelve,9,2000-09-20T15:00:00Z,TAMPA FL,0,1,2,0,3
Tropical Depression,Twelve,9,2000-09-20T15:00:00Z,GULF 29N 87W,3,26,0,0,29
Tropical Depression,Twelve,9,2000-09-20T15:00:00Z,CEDAR KEY FL,0,1,6,0,7
Tropical Depression,Twelve,9,2000-09-20T15:00:00Z,GULF 28N 89W,27,12,0,0,39
Tropical Depression,Twelve,9,2000-09-20T15:00:00Z,ST MARKS FL,0,4,11,0,15
Tropical Depression,Twelve,9,2000-09-20T15:00:00Z,GULF 28N 91W,7,13,0,0,20
Tropical Depression,Twelve,9,2000-09-20T15:00:00Z,APALACHICOLA FL,0,10,7,0,17
Tropical Depression,Twelve,9,2000-09-20T15:00:00Z,GULF 28N 93W,0,2,0,0,2
Tropical Depression,Twelve,9,2000-09-20T15:00:00Z,PANAMA CITY FL,0,14,6,0,20
Tropical Depression,Twelve,10,2000-09-20T21:00:00Z,28.5N  88.5W,39,2,0,0,41
Tropical Depression,Twelve,10,2000-09-20T21:00:00Z,PANAMA CITY FL,2,20,4,0,26
Tropical Depression,Twelve,10,2000-09-20T21:00:00Z,31.4N  87.4W,1,28,4,0,33
Tropical Depression,Twelve,10,2000-09-20T21:00:00Z,PENSACOLA FL,5,28,1,0,34
Tropical Depression,Twelve,10,2000-09-20T21:00:00Z,34.0N  84.0W,0,0,19,0,19
Tropical Depression,Twelve,10,2000-09-20T21:00:00Z,MOBILE AL,6,28,1,0,35
Tropical Depression,Twelve,10,2000-09-20T21:00:00Z,MUAN 219N 850W,97,0,0,0,97
Tropical Depression,Twelve,10,2000-09-20T21:00:00Z,GULFPORT MS,11,23,0,0,34
Tropical Depression,Twelve,10,2000-09-20T21:00:00Z,DAYTONA BEACH FL,0,0,3,0,3
Tropical Depression,Twelve,10,2000-09-20T21:00:00Z,BURAS LA,24,9,0,0,33
Tropical Depression,Twelve,10,2000-09-20T21:00:00Z,JACKSONVILLE FL,0,0,8,0,8
Tropical Depression,Twelve,10,2000-09-20T21:00:00Z,NEW ORLEANS LA,11,15,0,0,26
Tropical Depression,Twelve,10,2000-09-20T21:00:00Z,SAVANNAH GA,0,0,9,0,9
Tropical Depression,Twelve,10,2000-09-20T21:00:00Z,NEW IBERIA LA,2,6,0,0,8
Tropical Depression,Twelve,10,2000-09-20T21:00:00Z,CHARLESTON SC,0,0,4,0,4
Tropical Depression,Twelve,10,2000-09-20T21:00:00Z,GULF 29N 85W,2,15,3,0,20
Tropical Depression,Twelve,10,2000-09-20T21:00:00Z,TAMPA FL,0,1,2,0,3
Tropical Depression,Twelve,10,2000-09-20T21:00:00Z,GULF 29N 87W,23,12,0,0,35
Tropical Depression,Twelve,10,2000-09-20T21:00:00Z,CEDAR KEY FL,0,2,6,0,8
Tropical Depression,Twelve,10,2000-09-20T21:00:00Z,GULF 28N 89W,41,1,0,0,42
Tropical Depression,Twelve,10,2000-09-20T21:00:00Z,ST MARKS FL,0,8,11,0,19
Tropical Depression,Twelve,10,2000-09-20T21:00:00Z,GULF 28N 91W,10,3,0,0,13
Tropical Depression,Twelve,10,2000-09-20T21:00:00Z,APALACHICOLA FL,1,16,5,0,22
Tropical Depression,Twelve,11,2000-09-21T03:00:00Z,29.7N  87.4W,37,2,0,0,39
Tropical Depression,Twelve,11,2000-09-21T03:00:00Z,APALACHICOLA FL,15,10,1,0,26
Tropical Depression,Twelve,11,2000-09-21T03:00:00Z,32.5N  85.5W,1,25,1,0,27
Tropical Depression,Twelve,11,2000-09-21T03:00:00Z,PANAMA CITY FL,21,10,0,0,31
Tropical Depression,Twelve,11,2000-09-21T03:00:00Z,34.5N  82.0W,0,1,16,0,17
Tropical Depression,Twelve,11,2000-09-21T03:00:00Z,PENSACOLA FL,28,8,0,0,36
Tropical Depression,Twelve,11,2000-09-21T03:00:00Z,COCOA BEACH FL,0,0,2,0,2
Tropical Depression,Twelve,11,2000-09-21T03:00:00Z,MOBILE AL,24,9,0,0,33
Tropical Depression,Twelve,11,2000-09-21T03:00:00Z,DAYTONA BEACH FL,0,1,5,0,6
Tropical Depression,Twelve,11,2000-09-21T03:00:00Z,GULFPORT MS,22,6,0,0,28
Tropical Depression,Twelve,11,2000-09-21T03:00:00Z,JACKSONVILLE FL,0,3,9,0,12
Tropical Depression,Twelve,11,2000-09-21T03:00:00Z,BURAS LA,24,1,0,0,25
Tropical Depression,Twelve,11,2000-09-21T03:00:00Z,SAVANNAH GA,0,2,12,0,14
Tropical Depression,Twelve,11,2000-09-21T03:00:00Z,NEW ORLEANS LA,12,4,0,0,16
Tropical Depression,Twelve,11,2000-09-21T03:00:00Z,CHARLESTON SC,0,0,11,0,11
Tropical Depression,Twelve,11,2000-09-21T03:00:00Z,NEW IBERIA LA,1,1,0,0,2
Tropical Depression,Twelve,11,2000-09-21T03:00:00Z,MYRTLE BEACH SC,0,0,7,0,7
Tropical Depression,Twelve,11,2000-09-21T03:00:00Z,GULF 29N 85W,18,6,0,0,24
Tropical Depression,Twelve,11,2000-09-21T03:00:00Z,WILMINGTON NC,0,0,4,0,4
Tropical Depression,Twelve,11,2000-09-21T03:00:00Z,GULF 29N 87W,42,0,0,0,42
Tropical Depression,Twelve,11,2000-09-21T03:00:00Z,TAMPA FL,0,2,2,0,4
Tropical Depression,Twelve,11,2000-09-21T03:00:00Z,GULF 28N 89W,38,0,0,0,38
Tropical Depression,Twelve,11,2000-09-21T03:00:00Z,CEDAR KEY FL,1,6,4,0,11
Tropical Depression,Twelve,11,2000-09-21T03:00:00Z,GULF 28N 91W,5,0,0,0,5
Tropical Depression,Twelve,11,2000-09-21T03:00:00Z,ST MARKS FL,5,15,1,0,21
Tropical Depression,Twelve,12,2000-09-21T09:00:00Z,29.0N  88.0W,36,0,0,0,36
Tropical Depression,Twelve,12,2000-09-21T09:00:00Z,ST MARKS FL,2,9,5,0,16
Tropical Depression,Twelve,12,2000-09-21T09:00:00Z,31.0N  87.5W,12,11,1,0,24
Tropical Depression,Twelve,12,2000-09-21T09:00:00Z,APALACHICOLA FL,9,7,2,0,18
Tropical Depression,Twelve,12,2000-09-21T09:00:00Z,32.5N  85.0W,0,9,8,0,17
Tropical Depression,Twelve,12,2000-09-21T09:00:00Z,PANAMA CITY FL,12,7,2,0,21
Tropical Depression,Twelve,12,2000-09-21T09:00:00Z,FT PIERCE FL,0,0,2,0,2
Tropical Depression,Twelve,12,2000-09-21T09:00:00Z,PENSACOLA FL,18,7,1,0,26
Tropical Depression,Twelve,12,2000-09-21T09:00:00Z,COCOA BEACH FL,0,0,3,0,3
Tropical Depression,Twelve,12,2000-09-21T09:00:00Z,MOBILE AL,17,8,0,0,25
Tropical Depression,Twelve,12,2000-09-21T09:00:00Z,DAYTONA BEACH FL,0,0,5,0,5
Tropical Depression,Twelve,12,2000-09-21T09:00:00Z,GULFPORT MS,19,5,0,0,24
Tropical Depression,Twelve,12,2000-09-21T09:00:00Z,JACKSONVILLE FL,0,1,7,0,8
Tropical Depression,Twelve,12,2000-09-21T09:00:00Z,BURAS LA,24,1,0,0,25
Tropical Depression,Twelve,12,2000-09-21T09:00:00Z,SAVANNAH GA,0,0,6,0,6
Tropical Depression,Twelve,12,2000-09-21T09:00:00Z,NEW ORLEANS LA,14,4,0,0,18
Tropical Depression,Twelve,12,2000-09-21T09:00:00Z,CHARLESTON SC,0,0,2,0,2
Tropical Depression,Twelve,12,2000-09-21T09:00:00Z,NEW IBERIA LA,2,5,1,0,8
Tropical Depression,Twelve,12,2000-09-21T09:00:00Z,MARCO ISLAND FL,0,0,3,0,3
Tropical Depression,Twelve,12,2000-09-21T09:00:00Z,GULF 29N 85W,12,5,1,0,18
Tropical Depression,Twelve,12,2000-09-21T09:00:00Z,FT MYERS FL,0,0,4,0,4
Tropical Depression,Twelve,12,2000-09-21T09:00:00Z,GULF 29N 87W,32,0,0,0,32
Tropical Depression,Twelve,12,2000-09-21T09:00:00Z,VENICE FL,0,1,6,0,7
Tropical Depression,Twelve,12,2000-09-21T09:00:00Z,GULF 28N 89W,42,0,0,0,42
Tropical Depression,Twelve,12,2000-09-21T09:00:00Z,TAMPA FL,0,2,6,0,8
Tropical Depression,Twelve,12,2000-09-21T09:00:00Z,GULF 28N 91W,10,1,1,0,12
Tropical Depression,Twelve,12,2000-09-21T09:00:00Z,CEDAR KEY FL,1,3,8,0,12
Tropical Storm,Helene,13,2000-09-21T15:00:00Z,30.4N  87.0W,33,0,0,0,33
Tropical Storm,Helene,13,2000-09-21T15:00:00Z,TAMPA FL,1,4,5,0,10
Tropical Storm,Helene,13,2000-09-21T15:00:00Z,32.0N  85.5W,9,13,1,0,23
Tropical Storm,Helene,13,2000-09-21T15:00:00Z,CEDAR KEY FL,4,7,3,0,14
Tropical Storm,Helene,13,2000-09-21T15:00:00Z,33.5N  82.5W,0,6,11,0,17
Tropical Storm,Helene,13,2000-09-21T15:00:00Z,ST MARKS FL,13,5,2,0,20
Tropical Storm,Helene,13,2000-09-21T15:00:00Z,MIAMI FL,0,0,2,0,2
Tropical Storm,Helene,13,2000-09-21T15:00:00Z,APALACHICOLA FL,22,1,1,0,24
Tropical Storm,Helene,13,2000-09-21T15:00:00Z,W PALM BEACH FL,0,0,3,0,3
Tropical Storm,Helene,13,2000-09-21T15:00:00Z,PANAMA CITY FL,27,0,1,0,28
Tropical Storm,Helene,13,2000-09-21T15:00:00Z,FT PIERCE FL,0,0,4,0,4
Tropical Storm,Helene,13,2000-09-21T15:00:00Z,PENSACOLA FL,31,1,0,0,32
Tropical Storm,Helene,13,2000-09-21T15:00:00Z,COCOA BEACH FL,0,1,5,0,6
Tropical Storm,Helene,13,2000-09-21T15:00:00Z,MOBILE AL,27,0,0,0,27
Tropical Storm,Helene,13,2000-09-21T15:00:00Z,DAYTONA BEACH FL,0,2,8,0,10
Tropical Storm,Helene,13,2000-09-21T15:00:00Z,GULFPORT MS,23,1,0,0,24
Tropical Storm,Helene,13,2000-09-21T15:00:00Z,JACKSONVILLE FL,1,4,9,0,14
Tropical Storm,Helene,13,2000-09-21T15:00:00Z,BURAS LA,23,0,0,0,23
Tropical Storm,Helene,13,2000-09-21T15:00:00Z,SAVANNAH GA,0,3,11,0,14
Tropical Storm,Helene,13,2000-09-21T15:00:00Z,NEW ORLEANS LA,12,1,1,0,14
Tropical Storm,Helene,13,2000-09-21T15:00:00Z,CHARLESTON SC,0,1,9,0,10
Tropical Storm,Helene,13,2000-09-21T15:00:00Z,NEW IBERIA LA,1,1,0,0,2
Tropical Storm,Helene,13,2000-09-21T15:00:00Z,MYRTLE BEACH SC,0,0,5,0,5
Tropical Storm,Helene,13,2000-09-21T15:00:00Z,GULF 29N 85W,22,1,1,0,24
Tropical Storm,Helene,13,2000-09-21T15:00:00Z,WILMINGTON NC,0,0,3,0,3
Tropical Storm,Helene,13,2000-09-21T15:00:00Z,GULF 29N 87W,49,0,0,0,49
Tropical Storm,Helene,13,2000-09-21T15:00:00Z,MARCO ISLAND FL,0,0,3,0,3
Tropical Storm,Helene,13,2000-09-21T15:00:00Z,GULF 28N 89W,39,0,0,0,39
Tropical Storm,Helene,13,2000-09-21T15:00:00Z,FT MYERS FL,0,1,4,0,5
Tropical Storm,Helene,13,2000-09-21T15:00:00Z,GULF 28N 91W,1,1,0,0,2
Tropical Storm,Helene,13,2000-09-21T15:00:00Z,VENICE FL,0,2,5,0,7
Tropical Storm,Helene,14,2000-09-21T21:00:00Z,31.1N  86.0W,32,1,0,0,33
Tropical Storm,Helene,14,2000-09-21T21:00:00Z,NANTUCKET MA,0,0,0,7,7
Tropical Storm,Helene,14,2000-09-21T21:00:00Z,32.8N  84.1W,7,12,1,0,20
Tropical Storm,Helene,14,2000-09-21T21:00:00Z,HYANNIS MA,0,0,0,7,7
Tropical Storm,Helene,14,2000-09-21T21:00:00Z,34.5N  80.5W,0,3,11,2,16
Tropical Storm,Helene,14,2000-09-21T21:00:00Z,BOSTON MA,0,0,0,7,7
Tropical Storm,Helene,14,2000-09-21T21:00:00Z,MYNN 251N 775W,0,0,1,1,2
Tropical Storm,Helene,14,2000-09-21T21:00:00Z,PORTLAND ME,0,0,0,5,5
Tropical Storm,Helene,14,2000-09-21T21:00:00Z,MYGF 266N 787W,0,0,2,2,4
Tropical Storm,Helene,14,2000-09-21T21:00:00Z,BAR HARBOR ME,0,0,0,3,3
Tropical Storm,Helene,14,2000-09-21T21:00:00Z,BERMUDA,0,0,0,2,2
Tropical Storm,Helene,14,2000-09-21T21:00:00Z,EASTPORT ME,0,0,0,2,2
Tropical Storm,Helene,14,2000-09-21T21:00:00Z,MIAMI FL,0,0,2,1,3
Tropical Storm,Helene,14,2000-09-21T21:00:00Z,ST JOHN NB,0,0,0,2,2
Tropical Storm,Helene,14,2000-09-21T21:00:00Z,W PALM BEACH FL,0,1,3,1,5
Tropical Storm,Helene,14,2000-09-21T21:00:00Z,YARMOUTH NS,0,0,0,3,3
Tropical Storm,Helene,14,2000-09-21T21:00:00Z,FT PIERCE FL,0,2,4,1,7
Tropical Storm,Helene,14,2000-09-21T21:00:00Z,MARCO ISLAND FL,0,1,2,1,4
Tropical Storm,Helene,14,2000-09-21T21:00:00Z,COCOA BEACH FL,0,3,6,0,9
Tropical Storm,Helene,14,2000-09-21T21:00:00Z,FT MYERS FL,0,2,3,1,6
Tropical Storm,Helene,14,2000-09-21T21:00:00Z,DAYTONA BEACH FL,1,6,5,1,13
Tropical Storm,Helene,14,2000-09-21T21:00:00Z,VENICE FL,0,4,3,0,7
Tropical Storm,Helene,14,2000-09-21T21:00:00Z,JACKSONVILLE FL,2,10,4,0,16
Tropical Storm,Helene,14,2000-09-21T21:00:00Z,TAMPA FL,2,6,3,0,11
Tropical Storm,Helene,14,2000-09-21T21:00:00Z,SAVANNAH GA,0,9,7,1,17
Tropical Storm,Helene,14,2000-09-21T21:00:00Z,CEDAR KEY FL,10,5,1,0,16
Tropical Storm,Helene,14,2000-09-21T21:00:00Z,CHARLESTON SC,0,3,11,2,16
Tropical Storm,Helene,14,2000-09-21T21:00:00Z,ST MARKS FL,26,0,1,0,27
Tropical Storm,Helene,14,2000-09-21T21:00:00Z,MYRTLE BEACH SC,0,1,10,4,15
Tropical Storm,Helene,14,2000-09-21T21:00:00Z,APALACHICOLA FL,36,0,0,0,36
Tropical Storm,Helene,14,2000-09-21T21:00:00Z,WILMINGTON NC,0,0,8,6,14
Tropical Storm,Helene,14,2000-09-21T21:00:00Z,PANAMA CITY FL,41,0,0,0,41
Tropical Storm,Helene,14,2000-09-21T21:00:00Z,MOREHEAD CITY NC,0,0,5,8,13
Tropical Storm,Helene,14,2000-09-21T21:00:00Z,PENSACOLA FL,38,0,0,0,38
Tropical Storm,Helene,14,2000-09-21T21:00:00Z,CAPE HATTERAS NC,0,0,2,11,13
Tropical Storm,Helene,14,2000-09-21T21:00:00Z,MOBILE AL,24,0,0,0,24
Tropical Storm,Helene,14,2000-09-21T21:00:00Z,NORFOLK VA,0,0,2,11,13
Tropical Storm,Helene,14,2000-09-21T21:00:00Z,GULFPORT MS,16,0,0,0,16
Tropical Storm,Helene,14,2000-09-21T21:00:00Z,OCEAN CITY MD,0,0,1,11,12
Tropical Storm,Helene,14,2000-09-21T21:00:00Z,BURAS LA,12,0,0,0,12
Tropical Storm,Helene,14,2000-09-21T21:00:00Z,ATLANTIC CITY NJ,0,0,0,11,11
Tropical Storm,Helene,14,2000-09-21T21:00:00Z,NEW ORLEANS LA,3,0,0,0,3
Tropical Storm,Helene,14,2000-09-21T21:00:00Z,NEW YORK CITY NY,0,0,0,9,9
Tropical Storm,Helene,14,2000-09-21T21:00:00Z,GULF 29N 85W,36,0,0,0,36
Tropical Storm,Helene,14,2000-09-21T21:00:00Z,MONTAUK POINT NY,0,0,0,8,8
Tropical Storm,Helene,14,2000-09-21T21:00:00Z,GULF 29N 87W,69,0,0,0,69
Tropical Storm,Helene,14,2000-09-21T21:00:00Z,PROVIDENCE RI,0,0,0,8,8
Tropical Storm,Helene,14,2000-09-21T21:00:00Z,GULF 28N 89W,34,0,0,0,34
Tropical Storm,Helene,15,2000-09-22T03:00:00Z,33.0N  84.0W,36,0,0,0,36
Tropical Storm,Helene,15,2000-09-22T03:00:00Z,HYANNIS MA,0,0,0,9,9
Tropical Storm,Helene,15,2000-09-22T03:00:00Z,35.0N  81.0W,2,19,1,0,22
Tropical Storm,Helene,15,2000-09-22T03:00:00Z,BOSTON MA,0,0,0,8,8
Tropical Storm,Helene,15,2000-09-22T03:00:00Z,36.5N  76.5W,0,1,13,2,16
Tropical Storm,Helene,15,2000-09-22T03:00:00Z,PORTLAND ME,0,0,0,6,6
Tropical Storm,Helene,15,2000-09-22T03:00:00Z,BERMUDA,0,0,0,4,4
Tropical Storm,Helene,15,2000-09-22T03:00:00Z,BAR HARBOR ME,0,0,0,5,5
Tropical Storm,Helene,15,2000-09-22T03:00:00Z,COCOA BEACH FL,0,1,1,0,2
Tropical Storm,Helene,15,2000-09-22T03:00:00Z,EASTPORT ME,0,0,0,4,4
Tropical Storm,Helene,15,2000-09-22T03:00:00Z,DAYTONA BEACH FL,1,4,1,0,6
Tropical Storm,Helene,15,2000-09-22T03:00:00Z,ST JOHN NB,0,0,0,4,4
Tropical Storm,Helene,15,2000-09-22T03:00:00Z,JACKSONVILLE FL,11,6,0,0,17
Tropical Storm,Helene,15,2000-09-22T03:00:00Z,MONCTON NB,0,0,0,3,3
Tropical Storm,Helene,15,2000-09-22T03:00:00Z,SAVANNAH GA,12,11,0,0,23
Tropical Storm,Helene,15,2000-09-22T03:00:00Z,YARMOUTH NS,0,0,0,5,5
Tropical Storm,Helene,15,2000-09-22T03:00:00Z,CHARLESTON SC,2,17,1,0,20
Tropical Storm,Helene,15,2000-09-22T03:00:00Z,HALIFAX NS,0,0,0,3,3
Tropical Storm,Helene,15,2000-09-22T03:00:00Z,MYRTLE BEACH SC,0,13,6,1,20
Tropical Storm,Helene,15,2000-09-22T03:00:00Z,SABLE ISLAND NS,0,0,0,2,2
Tropical Storm,Helene,15,2000-09-22T03:00:00Z,WILMINGTON NC,0,8,10,0,18
Tropical Storm,Helene,15,2000-09-22T03:00:00Z,EDDY POINT NS,0,0,0,2,2
Tropical Storm,Helene,15,2000-09-22T03:00:00Z,MOREHEAD CITY NC,0,3,13,1,17
Tropical Storm,Helene,15,2000-09-22T03:00:00Z,CEDAR KEY FL,8,2,0,0,10
Tropical Storm,Helene,15,2000-09-22T03:00:00Z,CAPE HATTERAS NC,0,1,12,2,15
Tropical Storm,Helene,15,2000-09-22T03:00:00Z,ST MARKS FL,47,0,0,0,47
Tropical Storm,Helene,15,2000-09-22T03:00:00Z,NORFOLK VA,0,1,12,2,15
Tropical Storm,Helene,15,2000-09-22T03:00:00Z,APALACHICOLA FL,64,0,0,0,64
Tropical Storm,Helene,15,2000-09-22T03:00:00Z,OCEAN CITY MD,0,0,8,5,13
Tropical Storm,Helene,15,2000-09-22T03:00:00Z,PANAMA CITY FL,76,0,0,0,76
Tropical Storm,Helene,15,2000-09-22T03:00:00Z,ATLANTIC CITY NJ,0,0,5,7,12
Tropical Storm,Helene,15,2000-09-22T03:00:00Z,PENSACOLA FL,67,0,0,0,67
Tropical Storm,Helene,15,2000-09-22T03:00:00Z,NEW YORK CITY NY,0,0,2,8,10
Tropical Storm,Helene,15,2000-09-22T03:00:00Z,MOBILE AL,21,0,0,0,21
Tropical Storm,Helene,15,2000-09-22T03:00:00Z,MONTAUK POINT NY,0,0,1,9,10
Tropical Storm,Helene,15,2000-09-22T03:00:00Z,GULFPORT MS,2,0,0,0,2
Tropical Storm,Helene,15,2000-09-22T03:00:00Z,PROVIDENCE RI,0,0,0,9,9
Tropical Storm,Helene,15,2000-09-22T03:00:00Z,GULF 29N 85W,58,0,0,0,58
Tropical Storm,Helene,15,2000-09-22T03:00:00Z,NANTUCKET MA,0,0,0,9,9
Tropical Storm,Helene,15,2000-09-22T03:00:00Z,GULF 29N 87W,99,0,0,0,99
Tropical Storm,Helene,16,2000-09-22T09:00:00Z,34.0N  83.5W,27,5,0,0,32
Tropical Storm,Helene,16,2000-09-22T09:00:00Z,PORTLAND ME,0,0,0,8,8
Tropical Storm,Helene,16,2000-09-22T09:00:00Z,36.0N  80.0W,0,18,3,0,21
Tropical Storm,Helene,16,2000-09-22T09:00:00Z,BAR HARBOR ME,0,0,0,8,8
Tropical Storm,Helene,16,2000-09-22T09:00:00Z,37.5N  75.0W,0,1,13,2,16
Tropical Storm,Helene,16,2000-09-22T09:00:00Z,EASTPORT ME,0,0,0,7,7
Tropical Storm,Helene,16,2000-09-22T09:00:00Z,BERMUDA,0,0,0,5,5
Tropical Storm,Helene,16,2000-09-22T09:00:00Z,ST JOHN NB,0,0,0,7,7
Tropical Storm,Helene,16,2000-09-22T09:00:00Z,JACKSONVILLE FL,5,5,0,0,10
Tropical Storm,Helene,16,2000-09-22T09:00:00Z,MONCTON NB,0,0,0,5,5
Tropical Storm,Helene,16,2000-09-22T09:00:00Z,SAVANNAH GA,14,9,0,0,23
Tropical Storm,Helene,16,2000-09-22T09:00:00Z,YARMOUTH NS,0,0,0,8,8
Tropical Storm,Helene,16,2000-09-22T09:00:00Z,CHARLESTON SC,5,16,1,0,22
Tropical Storm,Helene,16,2000-09-22T09:00:00Z,HALIFAX NS,0,0,0,7,7
Tropical Storm,Helene,16,2000-09-22T09:00:00Z,MYRTLE BEACH SC,1,18,2,0,21
Tropical Storm,Helene,16,2000-09-22T09:00:00Z,SABLE ISLAND NS,0,0,0,4,4
Tropical Storm,Helene,16,2000-09-22T09:00:00Z,WILMINGTON NC,0,15,5,0,20
Tropical Storm,Helene,16,2000-09-22T09:00:00Z,SYDNEY NS,0,0,0,3,3
Tropical Storm,Helene,16,2000-09-22T09:00:00Z,MOREHEAD CITY NC,0,9,9,1,19
Tropical Storm,Helene,16,2000-09-22T09:00:00Z,EDDY POINT NS,0,0,0,4,4
Tropical Storm,Helene,16,2000-09-22T09:00:00Z,CAPE HATTERAS NC,0,4,13,1,18
Tropical Storm,Helene,16,2000-09-22T09:00:00Z,PTX BASQUES NFLD,0,0,0,2,2
Tropical Storm,Helene,16,2000-09-22T09:00:00Z,NORFOLK VA,0,3,14,0,17
Tropical Storm,Helene,16,2000-09-22T09:00:00Z,ST MARKS FL,14,1,0,0,15
Tropical Storm,Helene,16,2000-09-22T09:00:00Z,OCEAN CITY MD,0,1,11,3,15
Tropical Storm,Helene,16,2000-09-22T09:00:00Z,APALACHICOLA FL,17,1,0,0,18
Tropical Storm,Helene,16,2000-09-22T09:00:00Z,ATLANTIC CITY NJ,0,0,8,5,13
Tropical Storm,Helene,16,2000-09-22T09:00:00Z,PANAMA CITY FL,48,0,0,0,48
Tropical Storm,Helene,16,2000-09-22T09:00:00Z,NEW YORK CITY NY,0,0,5,6,11
Tropical Storm,Helene,16,2000-09-22T09:00:00Z,PENSACOLA FL,99,0,0,0,99
Tropical Storm,Helene,16,2000-09-22T09:00:00Z,MONTAUK POINT NY,0,0,2,9,11
Tropical Storm,Helene,16,2000-09-22T09:00:00Z,MOBILE AL,99,0,0,0,99
Tropical Storm,Helene,16,2000-09-22T09:00:00Z,PROVIDENCE RI,0,0,1,10,11
Tropical Storm,Helene,16,2000-09-22T09:00:00Z,GULFPORT MS,5,0,0,0,5
Tropical Storm,Helene,16,2000-09-22T09:00:00Z,NANTUCKET MA,0,0,1,10,11
Tropical Storm,Helene,16,2000-09-22T09:00:00Z,GULF 29N 85W,21,0,0,0,21
Tropical Storm,Helene,16,2000-09-22T09:00:00Z,HYANNIS MA,0,0,1,10,11
Tropical Storm,Helene,16,2000-09-22T09:00:00Z,GULF 29N 87W,99,0,0,0,99
Tropical Storm,Helene,16,2000-09-22T09:00:00Z,BOSTON MA,0,0,1,9,10
Tropical Storm,Helene,17,2000-09-22T15:00:00Z,34.6N  81.3W,28,4,0,0,32
Tropical Storm,Helene,17,2000-09-22T15:00:00Z,PORTLAND ME,0,0,4,7,11
Tropical Storm,Helene,17,2000-09-22T15:00:00Z,36.4N  77.1W,0,22,3,0,25
Tropical Storm,Helene,17,2000-09-22T15:00:00Z,BAR HARBOR ME,0,0,2,9,11
Tropical Storm,Helene,17,2000-09-22T15:00:00Z,38.5N  72.0W,0,2,17,2,21
Tropical Storm,Helene,17,2000-09-22T15:00:00Z,EASTPORT ME,0,0,1,10,11
Tropical Storm,Helene,17,2000-09-22T15:00:00Z,BERMUDA,0,0,0,2,2
Tropical Storm,Helene,17,2000-09-22T15:00:00Z,ST JOHN NB,0,0,1,9,10
Tropical Storm,Helene,17,2000-09-22T15:00:00Z,DAYTONA BEACH FL,1,1,0,0,2
Tropical Storm,Helene,17,2000-09-22T15:00:00Z,MONCTON NB,0,0,0,9,9
Tropical Storm,Helene,17,2000-09-22T15:00:00Z,JACKSONVILLE FL,11,2,0,0,13
Tropical Storm,Helene,17,2000-09-22T15:00:00Z,YARMOUTH NS,0,0,2,11,13
Tropical Storm,Helene,17,2000-09-22T15:00:00Z,SAVANNAH GA,25,2,0,0,27
Tropical Storm,Helene,17,2000-09-22T15:00:00Z,HALIFAX NS,0,0,0,12,12
Tropical Storm,Helene,17,2000-09-22T15:00:00Z,CHARLESTON SC,16,9,0,0,25
Tropical Storm,Helene,17,2000-09-22T15:00:00Z,SABLE ISLAND NS,0,0,0,12,12
Tropical Storm,Helene,17,2000-09-22T15:00:00Z,MYRTLE BEACH SC,7,17,0,0,24
Tropical Storm,Helene,17,2000-09-22T15:00:00Z,SYDNEY NS,0,0,0,10,10
Tropical Storm,Helene,17,2000-09-22T15:00:00Z,WILMINGTON NC,2,20,2,0,24
Tropical Storm,Helene,17,2000-09-22T15:00:00Z,EDDY POINT NS,0,0,0,11,11
Tropical Storm,Helene,17,2000-09-22T15:00:00Z,MOREHEAD CITY NC,0,18,4,0,22
Tropical Storm,Helene,17,2000-09-22T15:00:00Z,PTX BASQUES NFLD,0,0,0,7,7
Tropical Storm,Helene,17,2000-09-22T15:00:00Z,CAPE HATTERAS NC,0,14,8,0,22
Tropical Storm,Helene,17,2000-09-22T15:00:00Z,BURGEO NFLD,0,0,0,7,7
Tropical Storm,Helene,17,2000-09-22T15:00:00Z,NORFOLK VA,0,19,5,0,24
Tropical Storm,Helene,17,2000-09-22T15:00:00Z,ILE ST PIERRE,0,0,0,7,7
Tropical Storm,Helene,17,2000-09-22T15:00:00Z,OCEAN CITY MD,0,12,10,0,22
Tropical Storm,Helene,17,2000-09-22T15:00:00Z,CAPE RACE NFLD,0,0,0,5,5
Tropical Storm,Helene,17,2000-09-22T15:00:00Z,ATLANTIC CITY NJ,0,6,12,1,19
Tropical Storm,Helene,17,2000-09-22T15:00:00Z,CEDAR KEY FL,1,1,0,0,2
Tropical Storm,Helene,17,2000-09-22T15:00:00Z,NEW YORK CITY NY,0,3,12,1,16
Tropical Storm,Helene,17,2000-09-22T15:00:00Z,ST MARKS FL,49,1,0,0,50
Tropical Storm,Helene,17,2000-09-22T15:00:00Z,MONTAUK POINT NY,0,1,12,3,16
Tropical Storm,Helene,17,2000-09-22T15:00:00Z,APALACHICOLA FL,75,0,0,0,75
Tropical Storm,Helene,17,2000-09-22T15:00:00Z,PROVIDENCE RI,0,0,11,4,15
Tropical Storm,Helene,17,2000-09-22T15:00:00Z,PANAMA CITY FL,99,0,0,0,99
Tropical Storm,Helene,17,2000-09-22T15:00:00Z,NANTUCKET MA,0,0,11,6,17
Tropical Storm,Helene,17,2000-09-22T15:00:00Z,PENSACOLA FL,99,0,0,0,99
Tropical Storm,Helene,17,2000-09-22T15:00:00Z,HYANNIS MA,0,0,10,6,16
Tropical Storm,Helene,17,2000-09-22T15:00:00Z,GULF 29N 85W,14,0,0,0,14
Tropical Storm,Helene,17,2000-09-22T15:00:00Z,BOSTON MA,0,0,8,5,13
Tropical Depression,Thirteen,1,2000-09-21T15:00:00Z,13.0N  28.2W,44,0,0,0,44
Tropical Depression,Thirteen,1,2000-09-21T15:00:00Z,14.0N  33.5W,0,2,19,1,22
Tropical Depression,Thirteen,1,2000-09-21T15:00:00Z,13.6N  30.6W,1,27,1,0,29
Tropical Depression,Thirteen,2,2000-09-21T21:00:00Z,13.2N  29.8W,46,0,0,0,46
Tropical Depression,Thirteen,2,2000-09-21T21:00:00Z,14.0N  34.5W,0,4,17,2,23
Tropical Depression,Thirteen,2,2000-09-21T21:00:00Z,13.6N  32.1W,2,27,1,0,30
Tropical Storm,Isaac,3,2000-09-22T03:00:00Z,13.6N  30.7W,47,0,0,0,47
Tropical Storm,Isaac,3,2000-09-22T03:00:00Z,14.5N  36.0W,0,2,20,2,24
Tropical Storm,Isaac,3,2000-09-22T03:00:00Z,14.1N  33.3W,1,30,0,0,31
Tropical Storm,Isaac,4,2000-09-22T09:00:00Z,13.6N  33.2W,44,0,0,0,44
Tropical Storm,Isaac,4,2000-09-22T09:00:00Z,14.4N  38.5W,0,7,14,1,22
Tropical Storm,Isaac,4,2000-09-22T09:00:00Z,14.1N  36.2W,0,29,0,0,29
Tropical Storm,Isaac,5,2000-09-22T15:00:00Z,14.5N  34.3W,44,0,0,0,44
Tropical Storm,Isaac,5,2000-09-22T15:00:00Z,15.2N  39.0W,0,5,16,1,22
Tropical Storm,Isaac,5,2000-09-22T15:00:00Z,14.8N  36.8W,1,28,0,0,29
Tropical Storm,Isaac,6,2000-09-22T21:00:00Z,15.0N  36.1W,45,0,0,0,45
Tropical Storm,Isaac,6,2000-09-22T21:00:00Z,16.0N  40.5W,0,8,13,1,22
Tropical Storm,Isaac,6,2000-09-22T21:00:00Z,15.5N  38.4W,1,28,1,0,30
Tropical Storm,Isaac,7,2000-09-23T03:00:00Z,14.6N  36.0W,44,0,0,0,44
Tropical Storm,Isaac,7,2000-09-23T03:00:00Z,15.5N  41.0W,0,3,18,2,23
Tropical Storm,Isaac,7,2000-09-23T03:00:00Z,15.0N  38.5W,1,28,0,0,29
Tropical Storm,Isaac,8,2000-09-23T09:00:00Z,14.2N  36.3W,44,0,0,1,45
Tropical Storm,Isaac,8,2000-09-23T09:00:00Z,15.0N  40.0W,0,8,14,1,23
Tropical Storm,Isaac,8,2000-09-23T09:00:00Z,14.5N  38.0W,8,19,1,0,28
Tropical Storm,Isaac,9,2000-09-23T15:00:00Z,15.1N  37.3W,45,0,0,0,45
Tropical Storm,Isaac,9,2000-09-23T15:00:00Z,15.8N  40.7W,0,12,10,2,24
Tropical Storm,Isaac,9,2000-09-23T15:00:00Z,15.5N  39.0W,7,21,1,0,29
Hurricane,Isaac,10,2000-09-23T21:00:00Z,15.8N  38.0W,47,0,0,0,47
Hurricane,Isaac,10,2000-09-23T21:00:00Z,16.6N  40.7W,3,16,2,2,23
Hurricane,Isaac,10,2000-09-23T21:00:00Z,16.2N  39.5W,22,8,0,1,31
Hurricane,Isaac,11,2000-09-24T03:00:00Z,15.6N  38.2W,44,0,0,0,44
Hurricane,Isaac,11,2000-09-24T03:00:00Z,16.5N  41.5W,0,11,10,2,23
Hurricane,Isaac,11,2000-09-24T03:00:00Z,16.0N  39.8W,14,14,1,0,29
Hurricane,Isaac,12,2000-09-24T09:00:00Z,16.2N  38.9W,52,0,0,0,52
Hurricane,Isaac,12,2000-09-24T09:00:00Z,17.5N  42.0W,1,19,4,1,25
Hurricane,Isaac,12,2000-09-24T09:00:00Z,16.8N  40.4W,25,9,0,0,34
Hurricane,Isaac,13,2000-09-24T15:00:00Z,16.8N  40.7W,51,0,0,0,51
Hurricane,Isaac,13,2000-09-24T15:00:00Z,18.5N  44.5W,0,16,10,1,27
Hurricane,Isaac,13,2000-09-24T15:00:00Z,17.5N  42.5W,17,16,0,0,33
Hurricane,Isaac,14,2000-09-24T21:00:00Z,17.1N  41.7W,49,0,0,0,49
Hurricane,Isaac,14,2000-09-24T21:00:00Z,18.5N  45.5W,0,14,11,1,26
Hurricane,Isaac,14,2000-09-24T21:00:00Z,17.8N  43.6W,10,23,0,0,33
Hurricane,Isaac,15,2000-09-25T03:00:00Z,17.8N  41.9W,48,0,0,0,48
Hurricane,Isaac,15,2000-09-25T03:00:00Z,19.5N  46.5W,0,12,13,1,26
Hurricane,Isaac,15,2000-09-25T03:00:00Z,18.6N  44.1W,8,24,0,0,32
Hurricane,Isaac,16,2000-09-25T09:00:00Z,18.3N  43.0W,51,0,0,1,52
Hurricane,Isaac,16,2000-09-25T09:00:00Z,20.0N  47.0W,0,20,6,0,26
Hurricane,Isaac,16,2000-09-25T09:00:00Z,19.2N  45.0W,14,21,0,0,35
Hurricane,Isaac,17,2000-09-25T15:00:00Z,19.0N  44.0W,46,1,0,0,47
Hurricane,Isaac,17,2000-09-25T15:00:00Z,21.0N  48.0W,0,12,8,2,22
Hurricane,Isaac,17,2000-09-25T15:00:00Z,20.0N  46.0W,6,23,0,0,29
Hurricane,Isaac,18,2000-09-25T21:00:00Z,19.5N  44.6W,50,0,0,0,50
Hurricane,Isaac,18,2000-09-25T21:00:00Z,21.8N  49.0W,0,10,13,1,24
Hurricane,Isaac,18,2000-09-25T21:00:00Z,20.6N  46.8W,4,28,1,0,33
Hurricane,Isaac,19,2000-09-26T03:00:00Z,20.0N  45.1W,59,0,0,1,60
Hurricane,Isaac,19,2000-09-26T03:00:00Z,22.5N  49.5W,0,7,18,1,26
Hurricane,Isaac,19,2000-09-26T03:00:00Z,21.0N  47.0W,7,27,0,0,34
Hurricane,Isaac,20,2000-09-26T09:00:00Z,20.3N  46.0W,43,0,0,0,43
Hurricane,Isaac,20,2000-09-26T09:00:00Z,23.0N  50.5W,0,10,14,1,25
Hurricane,Isaac,20,2000-09-26T09:00:00Z,21.4N  47.9W,11,19,1,0,31
Hurricane,Isaac,21,2000-09-26T15:00:00Z,20.5N  48.0W,43,0,0,0,43
Hurricane,Isaac,21,2000-09-26T15:00:00Z,23.5N  52.0W,0,12,7,1,20
Hurricane,Isaac,21,2000-09-26T15:00:00Z,22.0N  50.0W,7,19,1,0,27
Hurricane,Isaac,22,2000-09-26T21:00:00Z,21.2N  49.5W,45,0,0,0,45
Hurricane,Isaac,22,2000-09-26T21:00:00Z,25.0N  53.5W,0,11,9,2,22
Hurricane,Isaac,22,2000-09-26T21:00:00Z,23.0N  51.5W,6,21,1,0,28
Hurricane,Isaac,23,2000-09-27T03:00:00Z,22.3N  49.6W,47,0,0,1,48
Hurricane,Isaac,23,2000-09-27T03:00:00Z,25.5N  53.5W,1,15,4,1,21
Hurricane,Isaac,23,2000-09-27T03:00:00Z,23.7N  51.5W,20,8,0,1,29
Hurricane,Isaac,23,2000-09-27T03:00:00Z,BERMUDA,0,0,0,3,3
Hurricane,Isaac,24,2000-09-27T09:00:00Z,23.1N  51.2W,51,0,0,0,51
Hurricane,Isaac,24,2000-09-27T09:00:00Z,27.0N  55.0W,1,17,4,1,23
Hurricane,Isaac,24,2000-09-27T09:00:00Z,25.0N  53.3W,22,9,1,0,32
Hurricane,Isaac,24,2000-09-27T09:00:00Z,BERMUDA,0,0,0,4,4
Hurricane,Isaac,25,2000-09-27T15:00:00Z,24.2N  52.3W,52,0,0,0,52
Hurricane,Isaac,25,2000-09-27T15:00:00Z,29.0N  55.5W,1,16,5,1,23
Hurricane,Isaac,25,2000-09-27T15:00:00Z,26.3N  54.3W,21,10,0,0,31
Hurricane,Isaac,25,2000-09-27T15:00:00Z,BERMUDA,0,0,0,3,3
Hurricane,Isaac,26,2000-09-27T21:00:00Z,25.5N  54.0W,51,0,0,0,51
Hurricane,Isaac,26,2000-09-27T21:00:00Z,30.5N  56.5W,1,14,7,1,23
Hurricane,Isaac,26,2000-09-27T21:00:00Z,27.5N  55.5W,24,7,1,0,32
Hurricane,Isaac,26,2000-09-27T21:00:00Z,BERMUDA,0,0,1,2,3
Hurricane,Isaac,27,2000-09-28T03:00:00Z,26.8N  54.7W,42,0,0,0,42
Hurricane,Isaac,27,2000-09-28T03:00:00Z,31.5N  56.0W,0,12,7,1,20
Hurricane,Isaac,27,2000-09-28T03:00:00Z,28.9N  55.8W,16,9,1,0,26
Hurricane,Isaac,27,2000-09-28T03:00:00Z,SABLE ISLAND NS,0,0,0,2,2
Hurricane,Isaac,28,2000-09-28T09:00:00Z,28.0N  55.7W,38,0,0,0,38
Hurricane,Isaac,28,2000-09-28T09:00:00Z,33.5N  56.0W,0,7,12,1,20
Hurricane,Isaac,28,2000-09-28T09:00:00Z,30.6N  56.5W,7,17,1,0,25
Hurricane,Isaac,28,2000-09-28T09:00:00Z,SABLE ISLAND NS,0,0,0,2,2
Hurricane,Isaac,29,2000-09-28T15:00:00Z,30.1N  56.2W,40,0,0,0,40
Hurricane,Isaac,29,2000-09-28T15:00:00Z,ILE ST PIERRE,0,0,0,3,3
Hurricane,Isaac,29,2000-09-28T15:00:00Z,33.0N  55.5W,3,22,1,0,26
Hurricane,Isaac,29,2000-09-28T15:00:00Z,CAPE RACE NFLD,0,0,0,5,5
Hurricane,Isaac,29,2000-09-28T15:00:00Z,36.0N  53.5W,0,3,15,2,20
Hurricane,Isaac,29,2000-09-28T15:00:00Z,HIBERNIA OILFLD,0,0,0,4,4
Hurricane,Isaac,29,2000-09-28T15:00:00Z,SABLE ISLAND NS,0,0,0,2,2
Hurricane,Isaac,30,2000-09-28T21:00:00Z,32.7N  56.0W,35,2,0,0,37
Hurricane,Isaac,30,2000-09-28T21:00:00Z,BURGEO NFLD,0,0,0,2,2
Hurricane,Isaac,30,2000-09-28T21:00:00Z,35.5N  54.5W,1,21,1,0,23
Hurricane,Isaac,30,2000-09-28T21:00:00Z,ILE ST PIERRE,0,0,0,4,4
Hurricane,Isaac,30,2000-09-28T21:00:00Z,38.0N  52.0W,0,5,11,2,18
Hurricane,Isaac,30,2000-09-28T21:00:00Z,CAPE RACE NFLD,0,0,0,6,6
Hurricane,Isaac,30,2000-09-28T21:00:00Z,SABLE ISLAND NS,0,0,0,3,3
Hurricane,Isaac,30,2000-09-28T21:00:00Z,HIBERNIA OILFLD,0,0,0,6,6
Hurricane,Isaac,30,2000-09-28T21:00:00Z,SYDNEY NS,0,0,0,2,2
Hurricane,Isaac,31,2000-09-29T03:00:00Z,33.3N  55.8W,31,1,0,0,32
Hurricane,Isaac,31,2000-09-29T03:00:00Z,PTX BASQUES NFLD,0,0,0,2,2
Hurricane,Isaac,31,2000-09-29T03:00:00Z,35.8N  54.1W,3,15,1,1,20
Hurricane,Isaac,31,2000-09-29T03:00:00Z,BURGEO NFLD,0,0,0,3,3
Hurricane,Isaac,31,2000-09-29T03:00:00Z,38.0N  51.5W,0,4,8,3,15
Hurricane,Isaac,31,2000-09-29T03:00:00Z,ILE ST PIERRE,0,0,0,4,4
Hurricane,Isaac,31,2000-09-29T03:00:00Z,SABLE ISLAND NS,0,0,1,2,3
Hurricane,Isaac,31,2000-09-29T03:00:00Z,CAPE RACE NFLD,0,0,0,6,6
Hurricane,Isaac,31,2000-09-29T03:00:00Z,SYDNEY NS,0,0,0,2,2
Hurricane,Isaac,31,2000-09-29T03:00:00Z,HIBERNIA OILFLD,0,0,0,6,6
Hurricane,Isaac,31,2000-09-29T03:00:00Z,EDDY POINT NS,0,0,0,2,2
Hurricane,Isaac,32,2000-09-29T09:00:00Z,35.6N  54.6W,28,3,0,1,32
Hurricane,Isaac,32,2000-09-29T09:00:00Z,ILE ST PIERRE,0,0,1,2,3
Hurricane,Isaac,32,2000-09-29T09:00:00Z,38.0N  52.0W,0,17,2,1,20
Hurricane,Isaac,32,2000-09-29T09:00:00Z,CAPE RACE NFLD,0,0,1,5,6
Hurricane,Isaac,32,2000-09-29T09:00:00Z,40.0N  48.5W,0,2,10,3,15
Hurricane,Isaac,32,2000-09-29T09:00:00Z,HIBERNIA OILFLD,0,0,1,7,8
Hurricane,Isaac,33,2000-09-29T15:00:00Z,37.0N  53.0W,22,5,0,0,27
Hurricane,Isaac,33,2000-09-29T15:00:00Z,ILE ST PIERRE,0,0,1,1,2
Hurricane,Isaac,33,2000-09-29T15:00:00Z,40.0N  49.0W,0,15,3,1,19
Hurricane,Isaac,33,2000-09-29T15:00:00Z,CAPE RACE NFLD,0,1,2,2,5
Hurricane,Isaac,33,2000-09-29T15:00:00Z,42.5N  44.0W,0,1,10,3,14
Hurricane,Isaac,33,2000-09-29T15:00:00Z,HIBERNIA OILFLD,0,0,6,3,9
Hurricane,Isaac,34,2000-09-29T21:00:00Z,39.0N  50.0W,16,3,0,0,19
Hurricane,Isaac,34,2000-09-29T21:00:00Z,ILE ST PIERRE,0,1,1,1,3
Hurricane,Isaac,34,2000-09-29T21:00:00Z,42.0N  46.0W,0,10,3,0,13
Hurricane,Isaac,34,2000-09-29T21:00:00Z,CAPE RACE NFLD,0,3,2,1,6
Hurricane,Isaac,34,2000-09-29T21:00:00Z,45.0N  40.0W,0,1,7,3,11
Hurricane,Isaac,34,2000-09-29T21:00:00Z,HIBERNIA OILFLD,0,2,5,2,9
Hurricane,Isaac,35,2000-09-30T03:00:00Z,41.0N  47.5W,16,5,1,0,22
Hurricane,Isaac,35,2000-09-30T03:00:00Z,CAPE RACE NFLD,0,2,1,0,3
Hurricane,Isaac,35,2000-09-30T03:00:00Z,44.0N  41.5W,0,13,4,0,17
Hurricane,Isaac,35,2000-09-30T03:00:00Z,HIBERNIA OILFLD,0,5,3,0,8
Hurricane,Isaac,35,2000-09-30T03:00:00Z,47.0N  33.0W,0,0,10,3,13
Hurricane,Isaac,36,2000-09-30T09:00:00Z,40.6N  47.6W,19,2,1,0,22
Hurricane,Isaac,36,2000-09-30T09:00:00Z,CAPE RACE NFLD,0,2,2,0,4
Hurricane,Isaac,36,2000-09-30T09:00:00Z,42.9N  43.1W,1,12,3,0,16
Hurricane,Isaac,36,2000-09-30T09:00:00Z,HIBERNIA OILFLD,0,4,5,0,9
Hurricane,Isaac,36,2000-09-30T09:00:00Z,45.4N  36.4W,0,1,8,0,9
Hurricane,Isaac,37,2000-09-30T15:00:00Z,42.5N  41.5W,17,7,0,0,24
Hurricane,Isaac,37,2000-09-30T15:00:00Z,51.0N  26.0W,0,0,10,0,10
Hurricane,Isaac,37,2000-09-30T15:00:00Z,45.0N  35.0W,0,15,4,0,19
Hurricane,Isaac,37,2000-09-30T15:00:00Z,HIBERNIA OILFLD,1,2,0,0,3
Hurricane,Isaac,38,2000-09-30T21:00:00Z,43.5N  40.0W,18,7,0,0,25
Hurricane,Isaac,38,2000-09-30T21:00:00Z,50.0N  24.0W,0,0,12,0,12
Hurricane,Isaac,38,2000-09-30T21:00:00Z,46.5N  33.0W,0,15,4,0,19
Hurricane,Isaac,38,2000-09-30T21:00:00Z,HIBERNIA OILFLD,1,0,1,0,2
Hurricane,Isaac,39,2000-10-01T03:00:00Z,45.4N  35.5W,19,4,0,0,23
Hurricane,Isaac,39,2000-10-01T03:00:00Z,48.6N  28.3W,0,13,0,0,13
Tropical Storm,Isaac,40,2000-10-01T09:00:00Z,46.2N  32.5W,20,5,0,0,25
Tropical Storm,Isaac,40,2000-10-01T09:00:00Z,49.5N  23.5W,0,15,0,0,15
Tropical Depression,Fourteen,1,2000-09-25T21:00:00Z,12.2N  35.9W,43,0,0,0,43
Tropical Depression,Fourteen,1,2000-09-25T21:00:00Z,13.0N  41.0W,0,3,18,1,22
Tropical Depression,Fourteen,1,2000-09-25T21:00:00Z,12.6N  38.5W,1,27,0,0,28
Tropical Storm,Joyce,2,2000-09-26T03:00:00Z,12.5N  37.2W,43,0,0,0,43
Tropical Storm,Joyce,2,2000-09-26T03:00:00Z,13.0N  42.5W,0,3,19,1,23
Tropical Storm,Joyce,2,2000-09-26T03:00:00Z,12.8N  39.8W,1,28,1,0,30
Tropical Storm,Joyce,3,2000-09-26T09:00:00Z,11.9N  38.0W,45,0,0,0,45
Tropical Storm,Joyce,3,2000-09-26T09:00:00Z,12.2N  42.5W,0,7,14,1,22
Tropical Storm,Joyce,3,2000-09-26T09:00:00Z,12.0N  40.3W,2,28,0,0,30
Tropical Storm,Joyce,4,2000-09-26T15:00:00Z,11.9N  38.9W,43,0,0,1,44
Tropical Storm,Joyce,4,2000-09-26T15:00:00Z,12.0N  43.0W,0,9,12,1,22
Tropical Storm,Joyce,4,2000-09-26T15:00:00Z,12.0N  41.0W,4,24,0,0,28
Tropical Storm,Joyce,5,2000-09-26T21:00:00Z,11.5N  40.5W,43,0,0,0,43
Tropical Storm,Joyce,5,2000-09-26T21:00:00Z,11.5N  44.5W,0,10,11,2,23
Tropical Storm,Joyce,5,2000-09-26T21:00:00Z,11.5N  42.4W,4,24,1,0,29
Tropical Storm,Joyce,6,2000-09-27T03:00:00Z,12.0N  40.0W,44,0,0,0,44
Tropical Storm,Joyce,6,2000-09-27T03:00:00Z,12.3N  44.3W,0,8,14,1,23
Tropical Storm,Joyce,6,2000-09-27T03:00:00Z,12.1N  42.0W,4,25,0,0,29
Tropical Storm,Joyce,7,2000-09-27T09:00:00Z,12.7N  42.6W,46,0,0,0,46
Tropical Storm,Joyce,7,2000-09-27T09:00:00Z,12.8N  47.0W,0,9,12,2,23
Tropical Storm,Joyce,7,2000-09-27T09:00:00Z,12.7N  44.9W,2,28,0,0,30
Hurricane,Joyce,8,2000-09-27T15:00:00Z,12.5N  44.0W,43,0,0,0,43
Hurricane,Joyce,8,2000-09-27T15:00:00Z,12.5N  48.0W,0,9,11,2,22
Hurricane,Joyce,8,2000-09-27T15:00:00Z,12.5N  46.0W,3,24,1,0,28
Hurricane,Joyce,9,2000-09-27T21:00:00Z,12.7N  44.8W,43,0,0,0,43
Hurricane,Joyce,9,2000-09-27T21:00:00Z,12.7N  47.0W,3,25,0,1,29
Hurricane,Joyce,10,2000-09-28T03:00:00Z,12.5N  45.4W,43,0,0,0,43
Hurricane,Joyce,10,2000-09-28T03:00:00Z,TLPL 138N 610W,0,0,0,2,2
Hurricane,Joyce,10,2000-09-28T03:00:00Z,12.5N  47.6W,4,25,0,0,29
Hurricane,Joyce,10,2000-09-28T03:00:00Z,TFFF 146N 610W,0,0,0,2,2
Hurricane,Joyce,10,2000-09-28T03:00:00Z,12.5N  50.0W,0,6,16,1,23
Hurricane,Joyce,10,2000-09-28T03:00:00Z,TDPR 153N 614W,0,0,0,2,2
Hurricane,Joyce,10,2000-09-28T03:00:00Z,TBPB 131N 595W,0,0,0,4,4
Hurricane,Joyce,10,2000-09-28T03:00:00Z,TFFR 163N 615W,0,0,0,2,2
Hurricane,Joyce,11,2000-09-28T09:00:00Z,12.5N  46.6W,47,0,0,0,47
Hurricane,Joyce,11,2000-09-28T09:00:00Z,TLPL 138N 610W,0,0,0,3,3
Hurricane,Joyce,11,2000-09-28T09:00:00Z,12.5N  48.9W,3,27,1,0,31
Hurricane,Joyce,11,2000-09-28T09:00:00Z,TFFF 146N 610W,0,0,0,3,3
Hurricane,Joyce,11,2000-09-28T09:00:00Z,12.7N  51.0W,0,11,10,2,23
Hurricane,Joyce,11,2000-09-28T09:00:00Z,TDPR 153N 614W,0,0,0,3,3
Hurricane,Joyce,11,2000-09-28T09:00:00Z,TTPT 112N 608W,0,0,0,2,2
Hurricane,Joyce,11,2000-09-28T09:00:00Z,TFFR 163N 615W,0,0,0,2,2
Hurricane,Joyce,11,2000-09-28T09:00:00Z,TBPB 131N 595W,0,0,0,6,6
Hurricane,Joyce,11,2000-09-28T09:00:00Z,TAPA 171N 618W,0,0,0,2,2
Hurricane,Joyce,11,2000-09-28T09:00:00Z,TVSV 131N 612W,0,0,0,3,3
Hurricane,Joyce,12,2000-09-28T15:00:00Z,11.0N  48.0W,45,0,0,0,45
Hurricane,Joyce,12,2000-09-28T15:00:00Z,TFFF 146N 610W,0,0,0,9,9
Hurricane,Joyce,12,2000-09-28T15:00:00Z,11.0N  50.5W,1,29,1,0,31
Hurricane,Joyce,12,2000-09-28T15:00:00Z,TDPR 153N 614W,0,0,0,8,8
Hurricane,Joyce,12,2000-09-28T15:00:00Z,11.5N  53.0W,0,7,15,2,24
Hurricane,Joyce,12,2000-09-28T15:00:00Z,TFFR 163N 615W,0,0,0,7,7
Hurricane,Joyce,12,2000-09-28T15:00:00Z,TTPP 106N 614W,0,0,0,4,4
Hurricane,Joyce,12,2000-09-28T15:00:00Z,TAPA 171N 618W,0,0,0,6,6
Hurricane,Joyce,12,2000-09-28T15:00:00Z,TTPT 112N 608W,0,0,0,6,6
Hurricane,Joyce,12,2000-09-28T15:00:00Z,TKPK 173N 627W,0,0,0,4,4
Hurricane,Joyce,12,2000-09-28T15:00:00Z,TGPY 120N 618W,0,0,0,5,5
Hurricane,Joyce,12,2000-09-28T15:00:00Z,TNCM 181N 631W,0,0,0,3,3
Hurricane,Joyce,12,2000-09-28T15:00:00Z,TBPB 131N 595W,0,0,0,12,12
Hurricane,Joyce,12,2000-09-28T15:00:00Z,TISX 177N 648W,0,0,0,2,2
Hurricane,Joyce,12,2000-09-28T15:00:00Z,TVSV 131N 612W,0,0,0,7,7
Hurricane,Joyce,12,2000-09-28T15:00:00Z,ST CROIX VI,0,0,0,2,2
Hurricane,Joyce,12,2000-09-28T15:00:00Z,TLPL 138N 610W,0,0,0,8,8
Hurricane,Joyce,13,2000-09-28T21:00:00Z,10.5N  50.0W,51,0,0,0,51
Hurricane,Joyce,13,2000-09-28T21:00:00Z,TVSV 131N 612W,0,0,0,13,13
Hurricane,Joyce,13,2000-09-28T21:00:00Z,10.5N  52.0W,4,26,0,0,30
Hurricane,Joyce,13,2000-09-28T21:00:00Z,TLPL 138N 610W,0,0,0,13,13
Hurricane,Joyce,13,2000-09-28T21:00:00Z,11.0N  54.0W,0,14,8,1,23
Hurricane,Joyce,13,2000-09-28T21:00:00Z,TFFF 146N 610W,0,0,0,11,11
Hurricane,Joyce,13,2000-09-28T21:00:00Z,SVMG 110N 640W,0,0,0,4,4
Hurricane,Joyce,13,2000-09-28T21:00:00Z,TDPR 153N 614W,0,0,0,9,9
Hurricane,Joyce,13,2000-09-28T21:00:00Z,TTPP 106N 614W,0,0,0,10,10
Hurricane,Joyce,13,2000-09-28T21:00:00Z,TFFR 163N 615W,0,0,0,6,6
Hurricane,Joyce,13,2000-09-28T21:00:00Z,TTPT 112N 608W,0,0,0,12,12
Hurricane,Joyce,13,2000-09-28T21:00:00Z,TAPA 171N 618W,0,0,0,4,4
Hurricane,Joyce,13,2000-09-28T21:00:00Z,TGPY 120N 618W,0,0,0,11,11
Hurricane,Joyce,13,2000-09-28T21:00:00Z,TKPK 173N 627W,0,0,0,2,2
Hurricane,Joyce,13,2000-09-28T21:00:00Z,TBPB 131N 595W,0,0,0,16,16
Hurricane,Joyce,14,2000-09-29T03:00:00Z,10.7N  51.1W,52,0,0,0,52
Hurricane,Joyce,14,2000-09-29T03:00:00Z,TVSV 131N 612W,0,0,0,14,14
Hurricane,Joyce,14,2000-09-29T03:00:00Z,10.9N  53.3W,4,27,0,1,32
Hurricane,Joyce,14,2000-09-29T03:00:00Z,TLPL 138N 610W,0,0,0,14,14
Hurricane,Joyce,14,2000-09-29T03:00:00Z,11.5N  55.5W,0,10,12,2,24
Hurricane,Joyce,14,2000-09-29T03:00:00Z,TFFF 146N 610W,0,0,0,13,13
Hurricane,Joyce,14,2000-09-29T03:00:00Z,SVMG 110N 640W,0,0,0,6,6
Hurricane,Joyce,14,2000-09-29T03:00:00Z,TDPR 153N 614W,0,0,0,11,11
Hurricane,Joyce,14,2000-09-29T03:00:00Z,TTPP 106N 614W,0,0,0,11,11
Hurricane,Joyce,14,2000-09-29T03:00:00Z,TFFR 163N 615W,0,0,0,9,9
Hurricane,Joyce,14,2000-09-29T03:00:00Z,TTPT 112N 608W,0,0,1,13,14
Hurricane,Joyce,14,2000-09-29T03:00:00Z,TAPA 171N 618W,0,0,0,6,6
Hurricane,Joyce,14,2000-09-29T03:00:00Z,TGPY 120N 618W,0,0,0,12,12
Hurricane,Joyce,14,2000-09-29T03:00:00Z,TKPK 173N 627W,0,0,0,4,4
Hurricane,Joyce,14,2000-09-29T03:00:00Z,TBPB 131N 595W,0,0,2,15,17
Hurricane,Joyce,14,2000-09-29T03:00:00Z,TNCM 181N 631W,0,0,0,2,2
Hurricane,Joyce,15,2000-09-29T09:00:00Z,10.3N  51.6W,54,0,0,0,54
Hurricane,Joyce,15,2000-09-29T09:00:00Z,TFFF 146N 610W,0,0,1,14,15
Hurricane,Joyce,15,2000-09-29T09:00:00Z,10.8N  53.9W,3,28,1,0,32
Hurricane,Joyce,15,2000-09-29T09:00:00Z,TDPR 153N 614W,0,0,0,14,14
Hurricane,Joyce,15,2000-09-29T09:00:00Z,11.4N  56.2W,0,12,10,1,23
Hurricane,Joyce,15,2000-09-29T09:00:00Z,TFFR 163N 615W,0,0,0,12,12
Hurricane,Joyce,15,2000-09-29T09:00:00Z,SVMG 110N 640W,0,0,0,7,7
Hurricane,Joyce,15,2000-09-29T09:00:00Z,TAPA 171N 618W,0,0,0,10,10
Hurricane,Joyce,15,2000-09-29T09:00:00Z,TTPP 106N 614W,0,0,1,11,12
Hurricane,Joyce,15,2000-09-29T09:00:00Z,TKPK 173N 627W,0,0,0,8,8
Hurricane,Joyce,15,2000-09-29T09:00:00Z,TTPT 112N 608W,0,0,3,12,15
Hurricane,Joyce,15,2000-09-29T09:00:00Z,TNCM 181N 631W,0,0,0,6,6
Hurricane,Joyce,15,2000-09-29T09:00:00Z,TGPY 120N 618W,0,0,1,13,14
Hurricane,Joyce,15,2000-09-29T09:00:00Z,TISX 177N 648W,0,0,0,4,4
Hurricane,Joyce,15,2000-09-29T09:00:00Z,TBPB 131N 595W,0,0,6,12,18
Hurricane,Joyce,15,2000-09-29T09:00:00Z,TIST 183N 650W,0,0,0,3,3
Hurricane,Joyce,15,2000-09-29T09:00:00Z,TVSV 131N 612W,0,0,1,15,16
Hurricane,Joyce,15,2000-09-29T09:00:00Z,ST CROIX VI,0,0,0,4,4
Hurricane,Joyce,15,2000-09-29T09:00:00Z,TLPL 138N 610W,0,0,1,15,16
Hurricane,Joyce,15,2000-09-29T09:00:00Z,ST THOMAS VI,0,0,0,3,3
Tropical Storm,Joyce,16,2000-09-29T15:00:00Z,11.0N  53.0W,53,0,0,0,53
Tropical Storm,Joyce,16,2000-09-29T15:00:00Z,TFFR 163N 615W,0,0,0,15,15
Tropical Storm,Joyce,16,2000-09-29T15:00:00Z,11.5N  55.0W,6,25,0,0,31
Tropical Storm,Joyce,16,2000-09-29T15:00:00Z,TAPA 171N 618W,0,0,0,13,13
Tropical Storm,Joyce,16,2000-09-29T15:00:00Z,12.5N  57.0W,0,13,10,1,24
Tropical Storm,Joyce,16,2000-09-29T15:00:00Z,TKPK 173N 627W,0,0,0,11,11
Tropical Storm,Joyce,16,2000-09-29T15:00:00Z,SVMG 110N 640W,0,0,0,6,6
Tropical Storm,Joyce,16,2000-09-29T15:00:00Z,TNCM 181N 631W,0,0,0,8,8
Tropical Storm,Joyce,16,2000-09-29T15:00:00Z,TTPP 106N 614W,0,0,2,9,11
Tropical Storm,Joyce,16,2000-09-29T15:00:00Z,TISX 177N 648W,0,0,0,6,6
Tropical Storm,Joyce,16,2000-09-29T15:00:00Z,TTPT 112N 608W,0,0,5,9,14
Tropical Storm,Joyce,16,2000-09-29T15:00:00Z,TIST 183N 650W,0,0,0,4,4
Tropical Storm,Joyce,16,2000-09-29T15:00:00Z,TGPY 120N 618W,0,0,2,11,13
Tropical Storm,Joyce,16,2000-09-29T15:00:00Z,TJPS 180N 666W,0,0,0,2,2
Tropical Storm,Joyce,16,2000-09-29T15:00:00Z,TBPB 131N 595W,0,0,12,7,19
Tropical Storm,Joyce,16,2000-09-29T15:00:00Z,TJSJ 184N 661W,0,0,0,2,2
Tropical Storm,Joyce,16,2000-09-29T15:00:00Z,TVSV 131N 612W,0,0,3,13,16
Tropical Storm,Joyce,16,2000-09-29T15:00:00Z,ST CROIX VI,0,0,0,6,6
Tropical Storm,Joyce,16,2000-09-29T15:00:00Z,TLPL 138N 610W,0,0,3,14,17
Tropical Storm,Joyce,16,2000-09-29T15:00:00Z,ST THOMAS VI,0,0,0,4,4
Tropical Storm,Joyce,16,2000-09-29T15:00:00Z,TFFF 146N 610W,0,0,2,15,17
Tropical Storm,Joyce,16,2000-09-29T15:00:00Z,SAN JUAN PR,0,0,0,2,2
Tropical Storm,Joyce,16,2000-09-29T15:00:00Z,TDPR 153N 614W,0,0,1,15,16
Tropical Storm,Joyce,16,2000-09-29T15:00:00Z,PONCE PR,0,0,0,2,2
Tropical Storm,Joyce,17,2000-09-29T21:00:00Z,11.5N  55.0W,54,0,0,0,54
Tropical Storm,Joyce,17,2000-09-29T21:00:00Z,TFFR 163N 615W,0,0,6,11,17
Tropical Storm,Joyce,17,2000-09-29T21:00:00Z,12.5N  57.0W,5,26,0,1,32
Tropical Storm,Joyce,17,2000-09-29T21:00:00Z,TAPA 171N 618W,0,0,3,12,15
Tropical Storm,Joyce,17,2000-09-29T21:00:00Z,13.5N  59.0W,0,13,9,2,24
Tropical Storm,Joyce,17,2000-09-29T21:00:00Z,TKPK 173N 627W,0,0,1,13,14
Tropical Storm,Joyce,17,2000-09-29T21:00:00Z,SVMG 110N 640W,0,0,1,8,9
Tropical Storm,Joyce,17,2000-09-29T21:00:00Z,TNCM 181N 631W,0,0,0,11,11
Tropical Storm,Joyce,17,2000-09-29T21:00:00Z,TTPP 106N 614W,0,0,7,5,12
Tropical Storm,Joyce,17,2000-09-29T21:00:00Z,TISX 177N 648W,0,0,0,10,10
Tropical Storm,Joyce,17,2000-09-29T21:00:00Z,TTPT 112N 608W,0,1,11,3,15
Tropical Storm,Joyce,17,2000-09-29T21:00:00Z,TIST 183N 650W,0,0,0,8,8
Tropical Storm,Joyce,17,2000-09-29T21:00:00Z,TGPY 120N 618W,0,0,9,7,16
Tropical Storm,Joyce,17,2000-09-29T21:00:00Z,TJPS 180N 666W,0,0,0,6,6
Tropical Storm,Joyce,17,2000-09-29T21:00:00Z,TBPB 131N 595W,0,10,11,2,23
Tropical Storm,Joyce,17,2000-09-29T21:00:00Z,TJSJ 184N 661W,0,0,0,6,6
Tropical Storm,Joyce,17,2000-09-29T21:00:00Z,TVSV 131N 612W,0,1,13,5,19
Tropical Storm,Joyce,17,2000-09-29T21:00:00Z,ST CROIX VI,0,0,0,10,10
Tropical Storm,Joyce,17,2000-09-29T21:00:00Z,TLPL 138N 610W,0,1,14,5,20
Tropical Storm,Joyce,17,2000-09-29T21:00:00Z,ST THOMAS VI,0,0,0,8,8
Tropical Storm,Joyce,17,2000-09-29T21:00:00Z,TFFF 146N 610W,0,1,12,6,19
Tropical Storm,Joyce,17,2000-09-29T21:00:00Z,SAN JUAN PR,0,0,0,6,6
Tropical Storm,Joyce,17,2000-09-29T21:00:00Z,TDPR 153N 614W,0,0,10,8,18
Tropical Storm,Joyce,17,2000-09-29T21:00:00Z,PONCE PR,0,0,0,6,6
Tropical Storm,Joyce,18,2000-09-30T03:00:00Z,11.7N  57.0W,54,0,0,0,54
Tropical Storm,Joyce,18,2000-09-30T03:00:00Z,TAPA 171N 618W,0,0,8,8,16
Tropical Storm,Joyce,18,2000-09-30T03:00:00Z,12.8N  59.2W,2,31,0,0,33
Tropical Storm,Joyce,18,2000-09-30T03:00:00Z,TKPK 173N 627W,0,0,6,10,16
Tropical Storm,Joyce,18,2000-09-30T03:00:00Z,13.8N  61.2W,0,14,9,1,24
Tropical Storm,Joyce,18,2000-09-30T03:00:00Z,TNCM 181N 631W,0,0,2,12,14
Tropical Storm,Joyce,18,2000-09-30T03:00:00Z,TNCC 122N 690W,0,0,0,5,5
Tropical Storm,Joyce,18,2000-09-30T03:00:00Z,TISX 177N 648W,0,0,1,14,15
Tropical Storm,Joyce,18,2000-09-30T03:00:00Z,SVMG 110N 640W,0,0,6,4,10
Tropical Storm,Joyce,18,2000-09-30T03:00:00Z,TIST 183N 650W,0,0,1,12,13
Tropical Storm,Joyce,18,2000-09-30T03:00:00Z,TTPP 106N 614W,0,6,6,1,13
Tropical Storm,Joyce,18,2000-09-30T03:00:00Z,TJPS 180N 666W,0,0,0,12,12
Tropical Storm,Joyce,18,2000-09-30T03:00:00Z,TTPT 112N 608W,0,15,3,1,19
Tropical Storm,Joyce,18,2000-09-30T03:00:00Z,MDSD 185N 697W,0,0,0,6,6
Tropical Storm,Joyce,18,2000-09-30T03:00:00Z,TGPY 120N 618W,0,9,9,1,19
Tropical Storm,Joyce,18,2000-09-30T03:00:00Z,MDCB 176N 714W,0,0,0,3,3
Tropical Storm,Joyce,18,2000-09-30T03:00:00Z,TBPB 131N 595W,0,31,0,0,31
Tropical Storm,Joyce,18,2000-09-30T03:00:00Z,TJSJ 184N 661W,0,0,0,12,12
Tropical Storm,Joyce,18,2000-09-30T03:00:00Z,TVSV 131N 612W,0,16,7,1,24
Tropical Storm,Joyce,18,2000-09-30T03:00:00Z,MDPP 198N 707W,0,0,0,2,2
Tropical Storm,Joyce,18,2000-09-30T03:00:00Z,TLPL 138N 610W,0,16,8,1,25
Tropical Storm,Joyce,18,2000-09-30T03:00:00Z,ST CROIX VI,0,0,1,14,15
Tropical Storm,Joyce,18,2000-09-30T03:00:00Z,TFFF 146N 610W,0,11,10,2,23
Tropical Storm,Joyce,18,2000-09-30T03:00:00Z,ST THOMAS VI,0,0,1,12,13
Tropical Storm,Joyce,18,2000-09-30T03:00:00Z,TDPR 153N 614W,0,4,14,3,21
Tropical Storm,Joyce,18,2000-09-30T03:00:00Z,SAN JUAN PR,0,0,0,12,12
Tropical Storm,Joyce,18,2000-09-30T03:00:00Z,TFFR 163N 615W,0,1,12,5,18
Tropical Storm,Joyce,18,2000-09-30T03:00:00Z,PONCE PR,0,0,0,12,12
Tropical Storm,Joyce,19,2000-09-30T09:00:00Z,11.2N  57.6W,54,0,0,0,54
Tropical Storm,Joyce,19,2000-09-30T09:00:00Z,TKPK 173N 627W,0,0,5,8,13
Tropical Storm,Joyce,19,2000-09-30T09:00:00Z,12.2N  59.9W,2,30,0,1,33
Tropical Storm,Joyce,19,2000-09-30T09:00:00Z,TNCM 181N 631W,0,0,2,9,11
Tropical Storm,Joyce,19,2000-09-30T09:00:00Z,13.5N  62.5W,0,6,17,1,24
Tropical Storm,Joyce,19,2000-09-30T09:00:00Z,TISX 177N 648W,0,0,2,12,14
Tropical Storm,Joyce,19,2000-09-30T09:00:00Z,SKPG 125N 717W,0,0,0,5,5
Tropical Storm,Joyce,19,2000-09-30T09:00:00Z,TIST 183N 650W,0,0,1,11,12
Tropical Storm,Joyce,19,2000-09-30T09:00:00Z,TNCC 122N 690W,0,0,0,11,11
Tropical Storm,Joyce,19,2000-09-30T09:00:00Z,TJPS 180N 666W,0,0,0,13,13
Tropical Storm,Joyce,19,2000-09-30T09:00:00Z,SVMG 110N 640W,0,1,11,3,15
Tropical Storm,Joyce,19,2000-09-30T09:00:00Z,MDSD 185N 697W,0,0,0,10,10
Tropical Storm,Joyce,19,2000-09-30T09:00:00Z,TTPP 106N 614W,0,16,4,1,21
Tropical Storm,Joyce,19,2000-09-30T09:00:00Z,MDCB 176N 714W,0,0,0,8,8
Tropical Storm,Joyce,19,2000-09-30T09:00:00Z,TTPT 112N 608W,0,24,2,0,26
Tropical Storm,Joyce,19,2000-09-30T09:00:00Z,MTPP 186N 724W,0,0,0,4,4
Tropical Storm,Joyce,19,2000-09-30T09:00:00Z,TGPY 120N 618W,0,17,8,0,25
Tropical Storm,Joyce,19,2000-09-30T09:00:00Z,MTCA 183N 738W,0,0,0,2,2
Tropical Storm,Joyce,19,2000-09-30T09:00:00Z,TBPB 131N 595W,2,27,1,0,30
Tropical Storm,Joyce,19,2000-09-30T09:00:00Z,TJSJ 184N 661W,0,0,0,12,12
Tropical Storm,Joyce,19,2000-09-30T09:00:00Z,TVSV 131N 612W,0,20,7,0,27
Tropical Storm,Joyce,19,2000-09-30T09:00:00Z,MDPP 198N 707W,0,0,0,5,5
Tropical Storm,Joyce,19,2000-09-30T09:00:00Z,TLPL 138N 610W,0,16,9,0,25
Tropical Storm,Joyce,19,2000-09-30T09:00:00Z,ST CROIX VI,0,0,2,12,14
Tropical Storm,Joyce,19,2000-09-30T09:00:00Z,TFFF 146N 610W,0,10,11,1,22
Tropical Storm,Joyce,19,2000-09-30T09:00:00Z,ST THOMAS VI,0,0,1,11,12
Tropical Storm,Joyce,19,2000-09-30T09:00:00Z,TDPR 153N 614W,0,4,14,1,19
Tropical Storm,Joyce,19,2000-09-30T09:00:00Z,SAN JUAN PR,0,0,0,12,12
Tropical Storm,Joyce,19,2000-09-30T09:00:00Z,TFFR 163N 615W,0,1,11,3,15
Tropical Storm,Joyce,19,2000-09-30T09:00:00Z,PONCE PR,0,0,0,13,13
Tropical Storm,Joyce,19,2000-09-30T09:00:00Z,TAPA 171N 618W,0,0,7,5,12
Tropical Storm,Joyce,20,2000-09-30T15:00:00Z,11.3N  61.4W,56,0,0,0,56
Tropical Storm,Joyce,20,2000-09-30T15:00:00Z,TISX 177N 648W,0,0,2,4,6
Tropical Storm,Joyce,20,2000-09-30T15:00:00Z,12.0N  64.0W,1,32,0,0,33
Tropical Storm,Joyce,20,2000-09-30T15:00:00Z,TIST 183N 650W,0,0,1,4,5
Tropical Storm,Joyce,20,2000-09-30T15:00:00Z,13.0N  66.5W,0,8,17,1,26
Tropical Storm,Joyce,20,2000-09-30T15:00:00Z,TJPS 180N 666W,0,0,2,7,9
Tropical Storm,Joyce,20,2000-09-30T15:00:00Z,SKPG 125N 717W,0,0,1,13,14
Tropical Storm,Joyce,20,2000-09-30T15:00:00Z,MDSD 185N 697W,0,0,0,10,10
Tropical Storm,Joyce,20,2000-09-30T15:00:00Z,TNCC 122N 690W,0,0,12,7,19
Tropical Storm,Joyce,20,2000-09-30T15:00:00Z,MDCB 176N 714W,0,0,0,11,11
Tropical Storm,Joyce,20,2000-09-30T15:00:00Z,SVMG 110N 640W,1,29,0,1,31
Tropical Storm,Joyce,20,2000-09-30T15:00:00Z,MTPP 186N 724W,0,0,0,8,8
Tropical Storm,Joyce,20,2000-09-30T15:00:00Z,TTPP 106N 614W,51,0,0,0,51
Tropical Storm,Joyce,20,2000-09-30T15:00:00Z,MTCA 183N 738W,0,0,0,6,6
Tropical Storm,Joyce,20,2000-09-30T15:00:00Z,TTPT 112N 608W,63,0,0,0,63
Tropical Storm,Joyce,20,2000-09-30T15:00:00Z,MKJP 179N 768W,0,0,0,2,2
Tropical Storm,Joyce,20,2000-09-30T15:00:00Z,TGPY 120N 618W,47,3,0,0,50
Tropical Storm,Joyce,20,2000-09-30T15:00:00Z,MUGM 200N 751W,0,0,0,2,2
Tropical Storm,Joyce,20,2000-09-30T15:00:00Z,TBPB 131N 595W,27,0,0,0,27
Tropical Storm,Joyce,20,2000-09-30T15:00:00Z,TJSJ 184N 661W,0,0,1,6,7
Tropical Storm,Joyce,20,2000-09-30T15:00:00Z,TVSV 131N 612W,34,3,0,1,38
Tropical Storm,Joyce,20,2000-09-30T15:00:00Z,MDPP 198N 707W,0,0,0,6,6
Tropical Storm,Joyce,20,2000-09-30T15:00:00Z,TLPL 138N 610W,17,6,0,0,23
Tropical Storm,Joyce,20,2000-09-30T15:00:00Z,MBJT 215N 712W,0,0,0,2,2
Tropical Storm,Joyce,20,2000-09-30T15:00:00Z,TFFF 146N 610W,4,6,0,1,11
Tropical Storm,Joyce,20,2000-09-30T15:00:00Z,ST CROIX VI,0,0,2,4,6
Tropical Storm,Joyce,20,2000-09-30T15:00:00Z,TDPR 153N 614W,1,4,1,0,6
Tropical Storm,Joyce,20,2000-09-30T15:00:00Z,ST THOMAS VI,0,0,1,4,5
Tropical Storm,Joyce,20,2000-09-30T15:00:00Z,TFFR 163N 615W,0,1,1,0,2
Tropical Storm,Joyce,20,2000-09-30T15:00:00Z,SAN JUAN PR,0,0,1,6,7
Tropical Storm,Joyce,20,2000-09-30T15:00:00Z,TKPK 173N 627W,0,0,1,1,2
Tropical Storm,Joyce,20,2000-09-30T15:00:00Z,PONCE PR,0,0,2,7,9
Tropical Storm,Joyce,20,2000-09-30T15:00:00Z,TNCM 181N 631W,0,0,1,1,2
Tropical Storm,Joyce,21,2000-09-30T21:00:00Z,11.8N  62.2W,56,0,0,0,56
Tropical Storm,Joyce,21,2000-09-30T21:00:00Z,TIST 183N 650W,0,0,2,2,4
Tropical Storm,Joyce,21,2000-09-30T21:00:00Z,12.5N  65.0W,0,33,0,0,33
Tropical Storm,Joyce,21,2000-09-30T21:00:00Z,TJPS 180N 666W,0,0,5,4,9
Tropical Storm,Joyce,21,2000-09-30T21:00:00Z,13.5N  67.5W,0,8,16,1,25
Tropical Storm,Joyce,21,2000-09-30T21:00:00Z,MDSD 185N 697W,0,0,1,10,11
Tropical Storm,Joyce,21,2000-09-30T21:00:00Z,SKPG 125N 717W,0,0,3,13,16
Tropical Storm,Joyce,21,2000-09-30T21:00:00Z,MDCB 176N 714W,0,0,1,13,14
Tropical Storm,Joyce,21,2000-09-30T21:00:00Z,TNCC 122N 690W,0,1,16,3,20
Tropical Storm,Joyce,21,2000-09-30T21:00:00Z,MTPP 186N 724W,0,0,0,11,11
Tropical Storm,Joyce,21,2000-09-30T21:00:00Z,SVMG 110N 640W,10,25,0,0,35
Tropical Storm,Joyce,21,2000-09-30T21:00:00Z,MTCA 183N 738W,0,0,0,11,11
Tropical Storm,Joyce,21,2000-09-30T21:00:00Z,TTPP 106N 614W,58,0,0,0,58
Tropical Storm,Joyce,21,2000-09-30T21:00:00Z,MKJP 179N 768W,0,0,0,5,5
Tropical Storm,Joyce,21,2000-09-30T21:00:00Z,TTPT 112N 608W,73,0,0,0,73
Tropical Storm,Joyce,21,2000-09-30T21:00:00Z,MKJS 185N 779W,0,0,0,2,2
Tropical Storm,Joyce,21,2000-09-30T21:00:00Z,TGPY 120N 618W,59,0,1,0,60
Tropical Storm,Joyce,21,2000-09-30T21:00:00Z,MUGM 200N 751W,0,0,0,5,5
Tropical Storm,Joyce,21,2000-09-30T21:00:00Z,TBPB 131N 595W,43,0,0,0,43
Tropical Storm,Joyce,21,2000-09-30T21:00:00Z,TJSJ 184N 661W,0,0,3,3,6
Tropical Storm,Joyce,21,2000-09-30T21:00:00Z,TVSV 131N 612W,50,0,0,0,50
Tropical Storm,Joyce,21,2000-09-30T21:00:00Z,MDPP 198N 707W,0,0,0,8,8
Tropical Storm,Joyce,21,2000-09-30T21:00:00Z,TLPL 138N 610W,33,0,0,0,33
Tropical Storm,Joyce,21,2000-09-30T21:00:00Z,MBJT 215N 712W,0,0,0,4,4
Tropical Storm,Joyce,21,2000-09-30T21:00:00Z,TFFF 146N 610W,12,3,0,0,15
Tropical Storm,Joyce,21,2000-09-30T21:00:00Z,MYMM 224N 730W,0,0,0,2,2
Tropical Storm,Joyce,21,2000-09-30T21:00:00Z,TDPR 153N 614W,4,3,1,0,8
Tropical Storm,Joyce,21,2000-09-30T21:00:00Z,ST CROIX VI,0,1,3,2,6
Tropical Storm,Joyce,21,2000-09-30T21:00:00Z,TFFR 163N 615W,0,2,0,0,2
Tropical Storm,Joyce,21,2000-09-30T21:00:00Z,ST THOMAS VI,0,0,2,2,4
Tropical Storm,Joyce,21,2000-09-30T21:00:00Z,TKPK 173N 627W,0,1,1,0,2
Tropical Storm,Joyce,21,2000-09-30T21:00:00Z,SAN JUAN PR,0,0,3,3,6
Tropical Storm,Joyce,21,2000-09-30T21:00:00Z,TISX 177N 648W,0,1,3,2,6
Tropical Storm,Joyce,21,2000-09-30T21:00:00Z,PONCE PR,0,0,5,4,9
Tropical Storm,Joyce,22,2000-10-01T03:00:00Z,11.9N  62.5W,54,0,0,0,54
Tropical Storm,Joyce,22,2000-10-01T03:00:00Z,TIST 183N 650W,0,0,2,2,4
Tropical Storm,Joyce,22,2000-10-01T03:00:00Z,12.7N  65.2W,1,32,0,0,33
Tropical Storm,Joyce,22,2000-10-01T03:00:00Z,TJPS 180N 666W,0,0,5,3,8
Tropical Storm,Joyce,22,2000-10-01T03:00:00Z,13.5N  68.0W,0,7,16,1,24
Tropical Storm,Joyce,22,2000-10-01T03:00:00Z,MDSD 185N 697W,0,0,2,9,11
Tropical Storm,Joyce,22,2000-10-01T03:00:00Z,SKPG 125N 717W,0,0,6,10,16
Tropical Storm,Joyce,22,2000-10-01T03:00:00Z,MDCB 176N 714W,0,0,2,12,14
Tropical Storm,Joyce,22,2000-10-01T03:00:00Z,TNCC 122N 690W,0,2,16,2,20
Tropical Storm,Joyce,22,2000-10-01T03:00:00Z,MTPP 186N 724W,0,0,0,11,11
Tropical Storm,Joyce,22,2000-10-01T03:00:00Z,SVMG 110N 640W,18,15,0,0,33
Tropical Storm,Joyce,22,2000-10-01T03:00:00Z,MTCA 183N 738W,0,0,0,11,11
Tropical Storm,Joyce,22,2000-10-01T03:00:00Z,TTPP 106N 614W,53,0,1,0,54
Tropical Storm,Joyce,22,2000-10-01T03:00:00Z,MKJP 179N 768W,0,0,0,7,7
Tropical Storm,Joyce,22,2000-10-01T03:00:00Z,TTPT 112N 608W,75,0,0,0,75
Tropical Storm,Joyce,22,2000-10-01T03:00:00Z,MKJS 185N 779W,0,0,0,4,4
Tropical Storm,Joyce,22,2000-10-01T03:00:00Z,TGPY 120N 618W,60,0,0,0,60
Tropical Storm,Joyce,22,2000-10-01T03:00:00Z,MUGM 200N 751W,0,0,0,5,5
Tropical Storm,Joyce,22,2000-10-01T03:00:00Z,TBPB 131N 595W,33,0,0,0,33
Tropical Storm,Joyce,22,2000-10-01T03:00:00Z,TJSJ 184N 661W,0,0,3,3,6
Tropical Storm,Joyce,22,2000-10-01T03:00:00Z,TVSV 131N 612W,46,0,0,0,46
Tropical Storm,Joyce,22,2000-10-01T03:00:00Z,MDPP 198N 707W,0,0,0,7,7
Tropical Storm,Joyce,22,2000-10-01T03:00:00Z,TLPL 138N 610W,26,1,0,0,27
Tropical Storm,Joyce,22,2000-10-01T03:00:00Z,MBJT 215N 712W,0,0,0,3,3
Tropical Storm,Joyce,22,2000-10-01T03:00:00Z,TFFF 146N 610W,7,4,0,0,11
Tropical Storm,Joyce,22,2000-10-01T03:00:00Z,ST CROIX VI,0,1,3,2,6
Tropical Storm,Joyce,22,2000-10-01T03:00:00Z,TDPR 153N 614W,2,3,1,0,6
Tropical Storm,Joyce,22,2000-10-01T03:00:00Z,ST THOMAS VI,0,0,2,2,4
Tropical Storm,Joyce,22,2000-10-01T03:00:00Z,TFFR 163N 615W,0,1,1,0,2
Tropical Storm,Joyce,22,2000-10-01T03:00:00Z,SAN JUAN PR,0,0,3,3,6
Tropical Storm,Joyce,22,2000-10-01T03:00:00Z,TKPK 173N 627W,0,1,1,0,2
Tropical Storm,Joyce,22,2000-10-01T03:00:00Z,PONCE PR,0,0,5,3,8
Tropical Storm,Joyce,22,2000-10-01T03:00:00Z,TISX 177N 648W,0,1,3,2,6
Tropical Storm,Joyce,23,2000-10-01T09:00:00Z,12.4N  65.0W,54,0,0,0,54
Tropical Storm,Joyce,23,2000-10-01T09:00:00Z,MTPP 186N 724W,0,0,1,11,12
Tropical Storm,Joyce,23,2000-10-01T09:00:00Z,13.3N  67.2W,4,28,0,0,32
Tropical Storm,Joyce,23,2000-10-01T09:00:00Z,MTCA 183N 738W,0,0,0,13,13
Tropical Storm,Joyce,23,2000-10-01T09:00:00Z,14.0N  69.5W,0,11,11,1,23
Tropical Storm,Joyce,23,2000-10-01T09:00:00Z,MKJP 179N 768W,0,0,0,11,11
Tropical Storm,Joyce,23,2000-10-01T09:00:00Z,SKPG 125N 717W,0,1,12,4,17
Tropical Storm,Joyce,23,2000-10-01T09:00:00Z,MKJS 185N 779W,0,0,0,8,8
Tropical Storm,Joyce,23,2000-10-01T09:00:00Z,TNCC 122N 690W,0,16,5,0,21
Tropical Storm,Joyce,23,2000-10-01T09:00:00Z,MUGM 200N 751W,0,0,0,8,8
Tropical Storm,Joyce,23,2000-10-01T09:00:00Z,SVMG 110N 640W,56,0,0,0,56
Tropical Storm,Joyce,23,2000-10-01T09:00:00Z,MUCM 214N 779W,0,0,0,2,2
Tropical Storm,Joyce,23,2000-10-01T09:00:00Z,TTPP 106N 614W,99,0,0,0,99
Tropical Storm,Joyce,23,2000-10-01T09:00:00Z,TJSJ 184N 661W,0,1,2,1,4
Tropical Storm,Joyce,23,2000-10-01T09:00:00Z,TTPT 112N 608W,99,0,0,0,99
Tropical Storm,Joyce,23,2000-10-01T09:00:00Z,MDPP 198N 707W,0,0,1,6,7
Tropical Storm,Joyce,23,2000-10-01T09:00:00Z,TGPY 120N 618W,92,0,0,0,92
Tropical Storm,Joyce,23,2000-10-01T09:00:00Z,MBJT 215N 712W,0,0,0,3,3
Tropical Storm,Joyce,23,2000-10-01T09:00:00Z,TVSV 131N 612W,25,0,0,0,25
Tropical Storm,Joyce,23,2000-10-01T09:00:00Z,MYMM 224N 730W,0,0,0,2,2
Tropical Storm,Joyce,23,2000-10-01T09:00:00Z,TISX 177N 648W,0,1,2,0,3
Tropical Storm,Joyce,23,2000-10-01T09:00:00Z,ST CROIX VI,0,1,2,0,3
Tropical Storm,Joyce,23,2000-10-01T09:00:00Z,TIST 183N 650W,0,0,2,0,2
Tropical Storm,Joyce,23,2000-10-01T09:00:00Z,ST THOMAS VI,0,0,2,0,2
Tropical Storm,Joyce,23,2000-10-01T09:00:00Z,TJPS 180N 666W,0,1,4,2,7
Tropical Storm,Joyce,23,2000-10-01T09:00:00Z,SAN JUAN PR,0,1,2,1,4
Tropical Storm,Joyce,23,2000-10-01T09:00:00Z,MDSD 185N 697W,0,0,4,6,10
Tropical Storm,Joyce,23,2000-10-01T09:00:00Z,PONCE PR,0,1,4,2,7
Tropical Storm,Joyce,23,2000-10-01T09:00:00Z,MDCB 176N 714W,0,0,5,10,15
Tropical Storm,Joyce,24,2000-10-01T15:00:00Z,13.0N  66.0W,54,0,0,0,54
Tropical Storm,Joyce,24,2000-10-01T15:00:00Z,MTPP 186N 724W,0,0,4,8,12
Tropical Storm,Joyce,24,2000-10-01T15:00:00Z,13.7N  68.5W,1,32,0,0,33
Tropical Storm,Joyce,24,2000-10-01T15:00:00Z,MTCA 183N 738W,0,0,3,11,14
Tropical Storm,Joyce,24,2000-10-01T15:00:00Z,14.5N  71.5W,0,4,20,1,25
Tropical Storm,Joyce,24,2000-10-01T15:00:00Z,MKJP 179N 768W,0,0,0,15,15
Tropical Storm,Joyce,24,2000-10-01T15:00:00Z,SKPG 125N 717W,0,4,16,1,21
Tropical Storm,Joyce,24,2000-10-01T15:00:00Z,MKJS 185N 779W,0,0,0,13,13
Tropical Storm,Joyce,24,2000-10-01T15:00:00Z,TNCC 122N 690W,0,26,1,0,27
Tropical Storm,Joyce,24,2000-10-01T15:00:00Z,MWCG 193N 814W,0,0,0,5,5
Tropical Storm,Joyce,24,2000-10-01T15:00:00Z,SVMG 110N 640W,54,0,0,0,54
Tropical Storm,Joyce,24,2000-10-01T15:00:00Z,MUGM 200N 751W,0,0,0,10,10
Tropical Storm,Joyce,24,2000-10-01T15:00:00Z,TTPP 106N 614W,86,0,0,0,86
Tropical Storm,Joyce,24,2000-10-01T15:00:00Z,MUCM 214N 779W,0,0,0,5,5
Tropical Storm,Joyce,24,2000-10-01T15:00:00Z,TTPT 112N 608W,99,0,0,0,99
Tropical Storm,Joyce,24,2000-10-01T15:00:00Z,MUCF 221N 805W,0,0,0,2,2
Tropical Storm,Joyce,24,2000-10-01T15:00:00Z,TGPY 120N 618W,99,0,0,0,99
Tropical Storm,Joyce,24,2000-10-01T15:00:00Z,MNPC 141N 834W,0,0,0,2,2
Tropical Storm,Joyce,24,2000-10-01T15:00:00Z,TVSV 131N 612W,84,0,0,0,84
Tropical Storm,Joyce,24,2000-10-01T15:00:00Z,SKSP 126N 817W,0,0,0,3,3
Tropical Storm,Joyce,24,2000-10-01T15:00:00Z,TLPL 138N 610W,6,0,0,0,6
Tropical Storm,Joyce,24,2000-10-01T15:00:00Z,MDPP 198N 707W,0,0,1,4,5
Tropical Storm,Joyce,24,2000-10-01T15:00:00Z,TJPS 180N 666W,0,1,2,0,3
Tropical Storm,Joyce,24,2000-10-01T15:00:00Z,MBJT 215N 712W,0,0,0,2,2
Tropical Storm,Joyce,24,2000-10-01T15:00:00Z,MDSD 185N 697W,0,0,6,2,8
Tropical Storm,Joyce,24,2000-10-01T15:00:00Z,MYMM 224N 730W,0,0,0,2,2
Tropical Storm,Joyce,24,2000-10-01T15:00:00Z,MDCB 176N 714W,0,0,11,4,15
Tropical Storm,Joyce,24,2000-10-01T15:00:00Z,PONCE PR,0,1,2,0,3
Tropical Depression,Joyce,25,2000-10-01T21:00:00Z,13.0N  67.0W,54,1,0,0,55
Tropical Depression,Joyce,25,2000-10-01T21:00:00Z,MKJP 179N 768W,0,0,2,14,16
Tropical Depression,Joyce,25,2000-10-01T21:00:00Z,15.0N  70.0W,0,33,0,0,33
Tropical Depression,Joyce,25,2000-10-01T21:00:00Z,MKJS 185N 779W,0,0,0,14,14
Tropical Depression,Joyce,25,2000-10-01T21:00:00Z,14.5N  73.0W,0,6,19,1,26
Tropical Depression,Joyce,25,2000-10-01T21:00:00Z,MWCG 193N 814W,0,0,0,9,9
Tropical Depression,Joyce,25,2000-10-01T21:00:00Z,SKPG 125N 717W,0,7,10,0,17
Tropical Depression,Joyce,25,2000-10-01T21:00:00Z,MUGM 200N 751W,0,0,1,6,7
Tropical Depression,Joyce,25,2000-10-01T21:00:00Z,TNCC 122N 690W,6,22,1,0,29
Tropical Depression,Joyce,25,2000-10-01T21:00:00Z,MUCM 214N 779W,0,0,0,4,4
Tropical Depression,Joyce,25,2000-10-01T21:00:00Z,SVMG 110N 640W,68,0,0,0,68
Tropical Depression,Joyce,25,2000-10-01T21:00:00Z,MUCF 221N 805W,0,0,0,2,2
Tropical Depression,Joyce,25,2000-10-01T21:00:00Z,TGPY 120N 618W,99,0,0,0,99
Tropical Depression,Joyce,25,2000-10-01T21:00:00Z,MUSN 216N 826W,0,0,0,2,2
Tropical Depression,Joyce,25,2000-10-01T21:00:00Z,TVSV 131N 612W,2,0,0,0,2
Tropical Depression,Joyce,25,2000-10-01T21:00:00Z,MHNJ 165N 859W,0,0,0,2,2
Tropical Depression,Joyce,25,2000-10-01T21:00:00Z,TJPS 180N 666W,0,2,1,0,3
Tropical Depression,Joyce,25,2000-10-01T21:00:00Z,MNPC 141N 834W,0,0,0,6,6
Tropical Depression,Joyce,25,2000-10-01T21:00:00Z,MDSD 185N 697W,0,4,5,1,10
Tropical Depression,Joyce,25,2000-10-01T21:00:00Z,MNBL 120N 839W,0,0,0,2,2
Tropical Depression,Joyce,25,2000-10-01T21:00:00Z,MDCB 176N 714W,0,6,12,0,18
Tropical Depression,Joyce,25,2000-10-01T21:00:00Z,SKSP 126N 817W,0,0,0,7,7
Tropical Depression,Joyce,25,2000-10-01T21:00:00Z,MTPP 186N 724W,0,1,7,3,11
Tropical Depression,Joyce,25,2000-10-01T21:00:00Z,MDPP 198N 707W,0,0,2,2,4
Tropical Depression,Joyce,25,2000-10-01T21:00:00Z,MTCA 183N 738W,0,0,7,7,14
Tropical Depression,Joyce,25,2000-10-01T21:00:00Z,PONCE PR,0,2,1,0,3
Tropical Depression,Joyce,26,2000-10-02T03:00:00Z,13.4N  68.6W,53,0,0,0,53
Tropical Depression,Joyce,26,2000-10-02T03:00:00Z,MWCG 193N 814W,0,0,0,10,10
Tropical Depression,Joyce,26,2000-10-02T03:00:00Z,14.2N  71.1W,2,29,1,0,32
Tropical Depression,Joyce,26,2000-10-02T03:00:00Z,MUGM 200N 751W,0,0,2,7,9
Tropical Depression,Joyce,26,2000-10-02T03:00:00Z,14.9N  73.6W,0,11,11,1,23
Tropical Depression,Joyce,26,2000-10-02T03:00:00Z,MUCM 214N 779W,0,0,0,6,6
Tropical Depression,Joyce,26,2000-10-02T03:00:00Z,SKPG 125N 717W,0,21,1,0,22
Tropical Depression,Joyce,26,2000-10-02T03:00:00Z,MUCF 221N 805W,0,0,0,3,3
Tropical Depression,Joyce,26,2000-10-02T03:00:00Z,TNCC 122N 690W,37,2,0,0,39
Tropical Depression,Joyce,26,2000-10-02T03:00:00Z,MUSN 216N 826W,0,0,0,3,3
Tropical Depression,Joyce,26,2000-10-02T03:00:00Z,SVMG 110N 640W,99,0,0,0,99
Tropical Depression,Joyce,26,2000-10-02T03:00:00Z,MHNJ 165N 859W,0,0,0,2,2
Tropical Depression,Joyce,26,2000-10-02T03:00:00Z,MDSD 185N 697W,0,2,3,1,6
Tropical Depression,Joyce,26,2000-10-02T03:00:00Z,MNPC 141N 834W,0,0,0,6,6
Tropical Depression,Joyce,26,2000-10-02T03:00:00Z,MDCB 176N 714W,0,6,8,1,15
Tropical Depression,Joyce,26,2000-10-02T03:00:00Z,MNBL 120N 839W,0,0,0,2,2
Tropical Depression,Joyce,26,2000-10-02T03:00:00Z,MTPP 186N 724W,0,1,8,3,12
Tropical Depression,Joyce,26,2000-10-02T03:00:00Z,SKSP 126N 817W,0,0,0,7,7
Tropical Depression,Joyce,26,2000-10-02T03:00:00Z,MTCA 183N 738W,0,0,10,4,14
Tropical Depression,Joyce,26,2000-10-02T03:00:00Z,MPCO 093N 799W,0,0,0,2,2
Tropical Depression,Joyce,26,2000-10-02T03:00:00Z,MKJP 179N 768W,0,0,4,13,17
Tropical Depression,Joyce,26,2000-10-02T03:00:00Z,MDPP 198N 707W,0,0,2,2,4
Tropical Depression,Joyce,26,2000-10-02T03:00:00Z,MKJS 185N 779W,0,0,1,14,15
Tropical Depression,Joyce,27,2000-10-02T09:00:00Z,13.7N  69.9W,54,0,0,0,54
Tropical Depression,Joyce,27,2000-10-02T09:00:00Z,MUGM 200N 751W,0,0,1,7,8
Tropical Depression,Joyce,27,2000-10-02T09:00:00Z,14.5N  72.5W,2,36,0,0,38
Tropical Depression,Joyce,27,2000-10-02T09:00:00Z,MUCM 214N 779W,0,0,0,7,7
Tropical Depression,Joyce,27,2000-10-02T09:00:00Z,15.2N  75.0W,0,8,20,0,28
Tropical Depression,Joyce,27,2000-10-02T09:00:00Z,MUCF 221N 805W,0,0,0,6,6
Tropical Depression,Joyce,27,2000-10-02T09:00:00Z,SKPG 125N 717W,9,17,0,0,26
Tropical Depression,Joyce,27,2000-10-02T09:00:00Z,MUSN 216N 826W,0,0,0,7,7
Tropical Depression,Joyce,27,2000-10-02T09:00:00Z,TNCC 122N 690W,37,0,0,0,37
Tropical Depression,Joyce,27,2000-10-02T09:00:00Z,MUHA 230N 824W,0,0,0,4,4
Tropical Depression,Joyce,27,2000-10-02T09:00:00Z,MDCB 176N 714W,0,7,5,1,13
Tropical Depression,Joyce,27,2000-10-02T09:00:00Z,MUAN 219N 850W,0,0,0,3,3
Tropical Depression,Joyce,27,2000-10-02T09:00:00Z,MTPP 186N 724W,0,1,6,1,8
Tropical Depression,Joyce,27,2000-10-02T09:00:00Z,MMCZ 205N 869W,0,0,0,2,2
Tropical Depression,Joyce,27,2000-10-02T09:00:00Z,MTCA 183N 738W,0,1,10,3,14
Tropical Depression,Joyce,27,2000-10-02T09:00:00Z,MHNJ 165N 859W,0,0,0,3,3
Tropical Depression,Joyce,27,2000-10-02T09:00:00Z,MKJP 179N 768W,0,0,8,11,19
Tropical Depression,Joyce,27,2000-10-02T09:00:00Z,MNPC 141N 834W,0,0,0,6,6
Tropical Depression,Joyce,27,2000-10-02T09:00:00Z,MKJS 185N 779W,0,0,2,15,17
Tropical Depression,Joyce,27,2000-10-02T09:00:00Z,SKSP 126N 817W,0,0,0,6,6
Tropical Depression,Joyce,27,2000-10-02T09:00:00Z,MWCG 193N 814W,0,0,0,14,14
Tropical Depression,Fifteen,1,2000-09-28T21:00:00Z,16.7N  83.3W,99,0,0,0,99
Tropical Depression,Fifteen,1,2000-09-28T21:00:00Z,MGPB 157N 886W,0,0,1,6,7
Tropical Depression,Fifteen,1,2000-09-28T21:00:00Z,17.0N  83.5W,99,0,0,0,99
Tropical Depression,Fifteen,1,2000-09-28T21:00:00Z,MHNJ 165N 859W,7,4,3,3,17
Tropical Depression,Fifteen,1,2000-09-28T21:00:00Z,17.5N  84.0W,33,0,1,0,34
Tropical Depression,Fifteen,1,2000-09-28T21:00:00Z,MNPC 141N 834W,3,5,3,4,15
Tropical Depression,Fifteen,1,2000-09-28T21:00:00Z,MKJP 179N 768W,0,0,1,2,3
Tropical Depression,Fifteen,1,2000-09-28T21:00:00Z,MNBL 120N 839W,0,0,2,5,7
Tropical Depression,Fifteen,1,2000-09-28T21:00:00Z,MKJS 185N 779W,0,0,2,4,6
Tropical Depression,Fifteen,1,2000-09-28T21:00:00Z,SKSP 126N 817W,0,1,3,4,8
Tropical Depression,Fifteen,1,2000-09-28T21:00:00Z,MWCG 193N 814W,5,6,3,3,17
Tropical Depression,Fifteen,1,2000-09-28T21:00:00Z,MRLM 100N 831W,0,0,0,3,3
Tropical Depression,Fifteen,1,2000-09-28T21:00:00Z,MUCM 214N 779W,0,0,0,3,3
Tropical Depression,Fifteen,1,2000-09-28T21:00:00Z,MMFR 185N 926W,0,0,0,2,2
Tropical Depression,Fifteen,1,2000-09-28T21:00:00Z,MUCF 221N 805W,0,0,2,5,7
Tropical Depression,Fifteen,1,2000-09-28T21:00:00Z,MMMD 210N 897W,0,0,1,6,7
Tropical Depression,Fifteen,1,2000-09-28T21:00:00Z,MUSN 216N 826W,0,2,5,5,12
Tropical Depression,Fifteen,1,2000-09-28T21:00:00Z,MARATHON FL,0,0,0,3,3
Tropical Depression,Fifteen,1,2000-09-28T21:00:00Z,MUHA 230N 824W,0,0,2,6,8
Tropical Depression,Fifteen,1,2000-09-28T21:00:00Z,KEY WEST FL,0,0,0,4,4
Tropical Depression,Fifteen,1,2000-09-28T21:00:00Z,MUAN 219N 850W,0,1,6,6,13
Tropical Depression,Fifteen,1,2000-09-28T21:00:00Z,MARCO ISLAND FL,0,0,0,2,2
Tropical Depression,Fifteen,1,2000-09-28T21:00:00Z,MMCZ 205N 869W,0,1,6,6,13
Tropical Depression,Fifteen,1,2000-09-28T21:00:00Z,FT MYERS FL,0,0,0,2,2
Tropical Depression,Fifteen,1,2000-09-28T21:00:00Z,MZBZ 175N 883W,0,0,3,7,10
Tropical Depression,Fifteen,2,2000-09-29T03:00:00Z,16.9N  83.7W,99,0,0,0,99
Tropical Depression,Fifteen,2,2000-09-29T03:00:00Z,MZBZ 175N 883W,0,2,5,5,12
Tropical Depression,Fifteen,2,2000-09-29T03:00:00Z,17.2N  83.8W,48,0,0,0,48
Tropical Depression,Fifteen,2,2000-09-29T03:00:00Z,MGPB 157N 886W,0,0,2,5,7
Tropical Depression,Fifteen,2,2000-09-29T03:00:00Z,17.5N  84.0W,34,0,0,1,35
Tropical Depression,Fifteen,2,2000-09-29T03:00:00Z,MHNJ 165N 859W,8,5,3,2,18
Tropical Depression,Fifteen,2,2000-09-29T03:00:00Z,MKJP 179N 768W,0,0,1,3,4
Tropical Depression,Fifteen,2,2000-09-29T03:00:00Z,MNPC 141N 834W,4,3,2,3,12
Tropical Depression,Fifteen,2,2000-09-29T03:00:00Z,MKJS 185N 779W,0,0,2,4,6
Tropical Depression,Fifteen,2,2000-09-29T03:00:00Z,MNBL 120N 839W,0,0,0,4,4
Tropical Depression,Fifteen,2,2000-09-29T03:00:00Z,MWCG 193N 814W,4,4,3,4,15
Tropical Depression,Fifteen,2,2000-09-29T03:00:00Z,SKSP 126N 817W,0,0,1,4,5
Tropical Depression,Fifteen,2,2000-09-29T03:00:00Z,MUCM 214N 779W,0,0,0,3,3
Tropical Depression,Fifteen,2,2000-09-29T03:00:00Z,MMFR 185N 926W,0,0,0,3,3
Tropical Depression,Fifteen,2,2000-09-29T03:00:00Z,MUCF 221N 805W,0,0,0,6,6
Tropical Depression,Fifteen,2,2000-09-29T03:00:00Z,MMMD 210N 897W,0,0,2,7,9
Tropical Depression,Fifteen,2,2000-09-29T03:00:00Z,MUSN 216N 826W,0,1,2,7,10
Tropical Depression,Fifteen,2,2000-09-29T03:00:00Z,MARATHON FL,0,0,0,3,3
Tropical Depression,Fifteen,2,2000-09-29T03:00:00Z,MUHA 230N 824W,0,0,0,6,6
Tropical Depression,Fifteen,2,2000-09-29T03:00:00Z,KEY WEST FL,0,0,0,3,3
Tropical Depression,Fifteen,2,2000-09-29T03:00:00Z,MUAN 219N 850W,0,1,3,7,11
Tropical Depression,Fifteen,2,2000-09-29T03:00:00Z,MARCO ISLAND FL,0,0,0,2,2
Tropical Depression,Fifteen,2,2000-09-29T03:00:00Z,MMCZ 205N 869W,0,3,5,6,14
Tropical Depression,Fifteen,3,2000-09-29T09:00:00Z,17.2N  83.5W,99,0,0,0,99
Tropical Depression,Fifteen,3,2000-09-29T09:00:00Z,MNPC 141N 834W,0,2,2,4,8
Tropical Depression,Fifteen,3,2000-09-29T09:00:00Z,17.8N  83.9W,36,0,0,1,37
Tropical Depression,Fifteen,3,2000-09-29T09:00:00Z,MNBL 120N 839W,0,0,0,2,2
Tropical Depression,Fifteen,3,2000-09-29T09:00:00Z,18.5N  84.2W,17,7,1,1,26
Tropical Depression,Fifteen,3,2000-09-29T09:00:00Z,SKSP 126N 817W,0,0,1,2,3
Tropical Depression,Fifteen,3,2000-09-29T09:00:00Z,MKJP 179N 768W,0,0,0,3,3
Tropical Depression,Fifteen,3,2000-09-29T09:00:00Z,MMFR 185N 926W,0,0,0,2,2
Tropical Depression,Fifteen,3,2000-09-29T09:00:00Z,MKJS 185N 779W,0,0,1,4,5
Tropical Depression,Fifteen,3,2000-09-29T09:00:00Z,MMMD 210N 897W,0,0,3,6,9
Tropical Depression,Fifteen,3,2000-09-29T09:00:00Z,MWCG 193N 814W,5,5,3,3,16
Tropical Depression,Fifteen,3,2000-09-29T09:00:00Z,MARATHON FL,0,0,0,4,4
Tropical Depression,Fifteen,3,2000-09-29T09:00:00Z,MUCM 214N 779W,0,0,0,3,3
Tropical Depression,Fifteen,3,2000-09-29T09:00:00Z,MIAMI FL,0,0,0,2,2
Tropical Depression,Fifteen,3,2000-09-29T09:00:00Z,MUCF 221N 805W,0,0,1,6,7
Tropical Depression,Fifteen,3,2000-09-29T09:00:00Z,KEY WEST FL,0,0,0,5,5
Tropical Depression,Fifteen,3,2000-09-29T09:00:00Z,MUSN 216N 826W,0,1,5,6,12
Tropical Depression,Fifteen,3,2000-09-29T09:00:00Z,MARCO ISLAND FL,0,0,0,3,3
Tropical Depression,Fifteen,3,2000-09-29T09:00:00Z,MUHA 230N 824W,0,0,1,8,9
Tropical Depression,Fifteen,3,2000-09-29T09:00:00Z,FT MYERS FL,0,0,0,3,3
Tropical Depression,Fifteen,3,2000-09-29T09:00:00Z,MUAN 219N 850W,0,1,6,7,14
Tropical Depression,Fifteen,3,2000-09-29T09:00:00Z,VENICE FL,0,0,0,2,2
Tropical Depression,Fifteen,3,2000-09-29T09:00:00Z,MMCZ 205N 869W,0,4,7,5,16
Tropical Depression,Fifteen,3,2000-09-29T09:00:00Z,TAMPA FL,0,0,0,2,2
Tropical Depression,Fifteen,3,2000-09-29T09:00:00Z,MZBZ 175N 883W,0,2,3,5,10
Tropical Depression,Fifteen,3,2000-09-29T09:00:00Z,GULF 29N 87W,0,0,0,2,2
Tropical Depression,Fifteen,3,2000-09-29T09:00:00Z,MGPB 157N 886W,0,0,1,4,5
Tropical Depression,Fifteen,3,2000-09-29T09:00:00Z,GULF 28N 89W,0,0,0,2,2
Tropical Depression,Fifteen,3,2000-09-29T09:00:00Z,MHNJ 165N 859W,10,3,2,2,17
Tropical Depression,Fifteen,3,2000-09-29T09:00:00Z,GULF 28N 91W,0,0,0,2,2
Tropical Depression,Fifteen,4,2000-09-29T15:00:00Z,18.0N  84.7W,99,0,0,0,99
Tropical Depression,Fifteen,4,2000-09-29T15:00:00Z,MNPC 141N 834W,0,0,1,4,5
Tropical Depression,Fifteen,4,2000-09-29T15:00:00Z,18.5N  85.0W,37,0,1,0,38
Tropical Depression,Fifteen,4,2000-09-29T15:00:00Z,SKSP 126N 817W,0,0,0,2,2
Tropical Depression,Fifteen,4,2000-09-29T15:00:00Z,19.5N  85.0W,17,6,1,1,25
Tropical Depression,Fifteen,4,2000-09-29T15:00:00Z,MYAK 241N 776W,0,0,0,2,2
Tropical Depression,Fifteen,4,2000-09-29T15:00:00Z,MKJP 179N 768W,0,0,0,3,3
Tropical Depression,Fifteen,4,2000-09-29T15:00:00Z,MMFR 185N 926W,0,0,0,3,3
Tropical Depression,Fifteen,4,2000-09-29T15:00:00Z,MKJS 185N 779W,0,0,1,4,5
Tropical Depression,Fifteen,4,2000-09-29T15:00:00Z,MMMD 210N 897W,0,1,5,6,12
Tropical Depression,Fifteen,4,2000-09-29T15:00:00Z,MWCG 193N 814W,4,4,4,3,15
Tropical Depression,Fifteen,4,2000-09-29T15:00:00Z,MARATHON FL,0,0,0,5,5
Tropical Depression,Fifteen,4,2000-09-29T15:00:00Z,MUCM 214N 779W,0,0,0,4,4
Tropical Depression,Fifteen,4,2000-09-29T15:00:00Z,MIAMI FL,0,0,0,2,2
Tropical Depression,Fifteen,4,2000-09-29T15:00:00Z,MUCF 221N 805W,0,0,2,6,8
Tropical Depression,Fifteen,4,2000-09-29T15:00:00Z,KEY WEST FL,0,0,0,6,6
Tropical Depression,Fifteen,4,2000-09-29T15:00:00Z,MUSN 216N 826W,0,2,6,5,13
Tropical Depression,Fifteen,4,2000-09-29T15:00:00Z,MARCO ISLAND FL,0,0,0,3,3
Tropical Depression,Fifteen,4,2000-09-29T15:00:00Z,MUHA 230N 824W,0,0,2,8,10
Tropical Depression,Fifteen,4,2000-09-29T15:00:00Z,FT MYERS FL,0,0,0,3,3
Tropical Depression,Fifteen,4,2000-09-29T15:00:00Z,MUAN 219N 850W,0,4,7,5,16
Tropical Depression,Fifteen,4,2000-09-29T15:00:00Z,VENICE FL,0,0,0,2,2
Tropical Depression,Fifteen,4,2000-09-29T15:00:00Z,MMCZ 205N 869W,0,10,5,3,18
Tropical Depression,Fifteen,4,2000-09-29T15:00:00Z,TAMPA FL,0,0,0,2,2
Tropical Depression,Fifteen,4,2000-09-29T15:00:00Z,MZBZ 175N 883W,1,4,3,3,11
Tropical Depression,Fifteen,4,2000-09-29T15:00:00Z,GULF 29N 87W,0,0,0,2,2
Tropical Depression,Fifteen,4,2000-09-29T15:00:00Z,MGPB 157N 886W,0,0,1,4,5
Tropical Depression,Fifteen,4,2000-09-29T15:00:00Z,GULF 28N 89W,0,0,0,2,2
Tropical Depression,Fifteen,4,2000-09-29T15:00:00Z,MHNJ 165N 859W,20,0,1,1,22
Tropical Depression,Fifteen,4,2000-09-29T15:00:00Z,GULF 28N 91W,0,0,0,2,2
Tropical Storm,Keith,5,2000-09-29T21:00:00Z,18.4N  85.2W,99,0,0,0,99
Tropical Storm,Keith,5,2000-09-29T21:00:00Z,W PALM BEACH FL,0,0,0,2,2
Tropical Storm,Keith,5,2000-09-29T21:00:00Z,19.0N  85.5W,35,0,0,1,36
Tropical Storm,Keith,5,2000-09-29T21:00:00Z,FT PIERCE FL,0,0,0,2,2
Tropical Storm,Keith,5,2000-09-29T21:00:00Z,20.0N  85.7W,19,5,1,1,26
Tropical Storm,Keith,5,2000-09-29T21:00:00Z,COCOA BEACH FL,0,0,0,2,2
Tropical Storm,Keith,5,2000-09-29T21:00:00Z,MKJS 185N 779W,0,0,0,2,2
Tropical Storm,Keith,5,2000-09-29T21:00:00Z,KEY WEST FL,0,0,1,6,7
Tropical Storm,Keith,5,2000-09-29T21:00:00Z,MWCG 193N 814W,1,2,4,4,11
Tropical Storm,Keith,5,2000-09-29T21:00:00Z,MARCO ISLAND FL,0,0,0,5,5
Tropical Storm,Keith,5,2000-09-29T21:00:00Z,MUCM 214N 779W,0,0,0,2,2
Tropical Storm,Keith,5,2000-09-29T21:00:00Z,FT MYERS FL,0,0,0,4,4
Tropical Storm,Keith,5,2000-09-29T21:00:00Z,MUCF 221N 805W,0,0,1,6,7
Tropical Storm,Keith,5,2000-09-29T21:00:00Z,VENICE FL,0,0,0,4,4
Tropical Storm,Keith,5,2000-09-29T21:00:00Z,MUSN 216N 826W,0,4,5,4,13
Tropical Storm,Keith,5,2000-09-29T21:00:00Z,TAMPA FL,0,0,0,3,3
Tropical Storm,Keith,5,2000-09-29T21:00:00Z,MUHA 230N 824W,0,0,4,6,10
Tropical Storm,Keith,5,2000-09-29T21:00:00Z,CEDAR KEY FL,0,0,0,2,2
Tropical Storm,Keith,5,2000-09-29T21:00:00Z,MUAN 219N 850W,1,10,4,4,19
Tropical Storm,Keith,5,2000-09-29T21:00:00Z,ST MARKS FL,0,0,0,2,2
Tropical Storm,Keith,5,2000-09-29T21:00:00Z,MMCZ 205N 869W,4,11,3,2,20
Tropical Storm,Keith,5,2000-09-29T21:00:00Z,APALACHICOLA FL,0,0,0,3,3
Tropical Storm,Keith,5,2000-09-29T21:00:00Z,MZBZ 175N 883W,1,3,2,5,11
Tropical Storm,Keith,5,2000-09-29T21:00:00Z,PANAMA CITY FL,0,0,0,2,2
Tropical Storm,Keith,5,2000-09-29T21:00:00Z,MGPB 157N 886W,0,0,1,5,6
Tropical Storm,Keith,5,2000-09-29T21:00:00Z,PENSACOLA FL,0,0,0,2,2
Tropical Storm,Keith,5,2000-09-29T21:00:00Z,MHNJ 165N 859W,43,0,0,0,43
Tropical Storm,Keith,5,2000-09-29T21:00:00Z,MOBILE AL,0,0,0,2,2
Tropical Storm,Keith,5,2000-09-29T21:00:00Z,MNPC 141N 834W,0,1,1,4,6
Tropical Storm,Keith,5,2000-09-29T21:00:00Z,GULFPORT MS,0,0,0,2,2
Tropical Storm,Keith,5,2000-09-29T21:00:00Z,MNBL 120N 839W,0,0,0,2,2
Tropical Storm,Keith,5,2000-09-29T21:00:00Z,BURAS LA,0,0,0,2,2
Tropical Storm,Keith,5,2000-09-29T21:00:00Z,SKSP 126N 817W,0,0,0,2,2
Tropical Storm,Keith,5,2000-09-29T21:00:00Z,GULF 29N 85W,0,0,0,3,3
Tropical Storm,Keith,5,2000-09-29T21:00:00Z,MMFR 185N 926W,0,0,0,3,3
Tropical Storm,Keith,5,2000-09-29T21:00:00Z,GULF 29N 87W,0,0,0,4,4
Tropical Storm,Keith,5,2000-09-29T21:00:00Z,MMMD 210N 897W,0,1,4,6,11
Tropical Storm,Keith,5,2000-09-29T21:00:00Z,GULF 28N 89W,0,0,0,4,4
Tropical Storm,Keith,5,2000-09-29T21:00:00Z,MARATHON FL,0,0,0,5,5
Tropical Storm,Keith,5,2000-09-29T21:00:00Z,GULF 28N 91W,0,0,0,3,3
Tropical Storm,Keith,5,2000-09-29T21:00:00Z,MIAMI FL,0,0,0,3,3
Tropical Storm,Keith,6,2000-09-30T03:00:00Z,18.9N  85.7W,99,0,0,0,99
Tropical Storm,Keith,6,2000-09-30T03:00:00Z,KEY WEST FL,0,0,1,5,6
Tropical Storm,Keith,6,2000-09-30T03:00:00Z,19.6N  86.1W,34,0,0,0,34
Tropical Storm,Keith,6,2000-09-30T03:00:00Z,MARCO ISLAND FL,0,0,0,4,4
Tropical Storm,Keith,6,2000-09-30T03:00:00Z,20.5N  86.5W,15,7,1,2,25
Tropical Storm,Keith,6,2000-09-30T03:00:00Z,FT MYERS FL,0,0,0,3,3
Tropical Storm,Keith,6,2000-09-30T03:00:00Z,MKJS 185N 779W,0,0,0,2,2
Tropical Storm,Keith,6,2000-09-30T03:00:00Z,VENICE FL,0,0,0,3,3
Tropical Storm,Keith,6,2000-09-30T03:00:00Z,MWCG 193N 814W,1,3,3,4,11
Tropical Storm,Keith,6,2000-09-30T03:00:00Z,TAMPA FL,0,0,0,2,2
Tropical Storm,Keith,6,2000-09-30T03:00:00Z,MUCM 214N 779W,0,0,0,2,2
Tropical Storm,Keith,6,2000-09-30T03:00:00Z,CEDAR KEY FL,0,0,0,2,2
Tropical Storm,Keith,6,2000-09-30T03:00:00Z,MUCF 221N 805W,0,0,1,5,6
Tropical Storm,Keith,6,2000-09-30T03:00:00Z,APALACHICOLA FL,0,0,0,2,2
Tropical Storm,Keith,6,2000-09-30T03:00:00Z,MUSN 216N 826W,1,4,4,4,13
Tropical Storm,Keith,6,2000-09-30T03:00:00Z,PANAMA CITY FL,0,0,0,2,2
Tropical Storm,Keith,6,2000-09-30T03:00:00Z,MUHA 230N 824W,0,1,3,6,10
Tropical Storm,Keith,6,2000-09-30T03:00:00Z,PENSACOLA FL,0,0,0,2,2
Tropical Storm,Keith,6,2000-09-30T03:00:00Z,MUAN 219N 850W,2,11,4,2,19
Tropical Storm,Keith,6,2000-09-30T03:00:00Z,MOBILE AL,0,0,0,2,2
Tropical Storm,Keith,6,2000-09-30T03:00:00Z,MMCZ 205N 869W,12,8,2,1,23
Tropical Storm,Keith,6,2000-09-30T03:00:00Z,GULFPORT MS,0,0,0,2,2
Tropical Storm,Keith,6,2000-09-30T03:00:00Z,MZBZ 175N 883W,4,3,2,3,12
Tropical Storm,Keith,6,2000-09-30T03:00:00Z,BURAS LA,0,0,0,3,3
Tropical Storm,Keith,6,2000-09-30T03:00:00Z,MGPB 157N 886W,0,0,1,4,5
Tropical Storm,Keith,6,2000-09-30T03:00:00Z,NEW ORLEANS LA,0,0,0,2,2
Tropical Storm,Keith,6,2000-09-30T03:00:00Z,MHNJ 165N 859W,25,0,1,0,26
Tropical Storm,Keith,6,2000-09-30T03:00:00Z,NEW IBERIA LA,0,0,0,2,2
Tropical Storm,Keith,6,2000-09-30T03:00:00Z,MNPC 141N 834W,0,0,1,2,3
Tropical Storm,Keith,6,2000-09-30T03:00:00Z,GULF 29N 85W,0,0,0,3,3
Tropical Storm,Keith,6,2000-09-30T03:00:00Z,MMFR 185N 926W,0,0,0,3,3
Tropical Storm,Keith,6,2000-09-30T03:00:00Z,GULF 29N 87W,0,0,0,4,4
Tropical Storm,Keith,6,2000-09-30T03:00:00Z,MMMD 210N 897W,0,3,5,5,13
Tropical Storm,Keith,6,2000-09-30T03:00:00Z,GULF 28N 89W,0,0,0,6,6
Tropical Storm,Keith,6,2000-09-30T03:00:00Z,MARATHON FL,0,0,0,5,5
Tropical Storm,Keith,6,2000-09-30T03:00:00Z,GULF 28N 91W,0,0,0,5,5
Tropical Storm,Keith,6,2000-09-30T03:00:00Z,MIAMI FL,0,0,0,2,2
Tropical Storm,Keith,6,2000-09-30T03:00:00Z,GULF 28N 93W,0,0,0,3,3
Tropical Storm,Keith,6,2000-09-30T03:00:00Z,W PALM BEACH FL,0,0,0,2,2
Tropical Storm,Keith,7,2000-09-30T09:00:00Z,19.5N  87.0W,52,0,0,0,52
Tropical Storm,Keith,7,2000-09-30T09:00:00Z,CEDAR KEY FL,0,0,0,2,2
Tropical Storm,Keith,7,2000-09-30T09:00:00Z,20.4N  87.2W,34,0,1,0,35
Tropical Storm,Keith,7,2000-09-30T09:00:00Z,ST MARKS FL,0,0,0,2,2
Tropical Storm,Keith,7,2000-09-30T09:00:00Z,21.5N  87.5W,11,9,2,1,23
Tropical Storm,Keith,7,2000-09-30T09:00:00Z,APALACHICOLA FL,0,0,0,3,3
Tropical Storm,Keith,7,2000-09-30T09:00:00Z,MWCG 193N 814W,0,1,2,4,7
Tropical Storm,Keith,7,2000-09-30T09:00:00Z,PANAMA CITY FL,0,0,0,3,3
Tropical Storm,Keith,7,2000-09-30T09:00:00Z,MUCF 221N 805W,0,0,1,4,5
Tropical Storm,Keith,7,2000-09-30T09:00:00Z,PENSACOLA FL,0,0,0,3,3
Tropical Storm,Keith,7,2000-09-30T09:00:00Z,MUSN 216N 826W,0,2,3,5,10
Tropical Storm,Keith,7,2000-09-30T09:00:00Z,MOBILE AL,0,0,0,3,3
Tropical Storm,Keith,7,2000-09-30T09:00:00Z,MUHA 230N 824W,0,0,2,6,8
Tropical Storm,Keith,7,2000-09-30T09:00:00Z,GULFPORT MS,0,0,0,3,3
Tropical Storm,Keith,7,2000-09-30T09:00:00Z,MUAN 219N 850W,5,6,3,3,17
Tropical Storm,Keith,7,2000-09-30T09:00:00Z,BURAS LA,0,0,0,5,5
Tropical Storm,Keith,7,2000-09-30T09:00:00Z,MMCZ 205N 869W,32,1,0,0,33
Tropical Storm,Keith,7,2000-09-30T09:00:00Z,NEW ORLEANS LA,0,0,0,4,4
Tropical Storm,Keith,7,2000-09-30T09:00:00Z,MZBZ 175N 883W,10,2,0,1,13
Tropical Storm,Keith,7,2000-09-30T09:00:00Z,NEW IBERIA LA,0,0,0,3,3
Tropical Storm,Keith,7,2000-09-30T09:00:00Z,MGPB 157N 886W,0,0,0,3,3
Tropical Storm,Keith,7,2000-09-30T09:00:00Z,PORT ARTHUR TX,0,0,0,2,2
Tropical Storm,Keith,7,2000-09-30T09:00:00Z,MHNJ 165N 859W,5,1,1,2,9
Tropical Storm,Keith,7,2000-09-30T09:00:00Z,GALVESTON TX,0,0,0,2,2
Tropical Storm,Keith,7,2000-09-30T09:00:00Z,MMFR 185N 926W,0,0,0,3,3
Tropical Storm,Keith,7,2000-09-30T09:00:00Z,FREEPORT TX,0,0,0,2,2
Tropical Storm,Keith,7,2000-09-30T09:00:00Z,MMMD 210N 897W,1,10,4,2,17
Tropical Storm,Keith,7,2000-09-30T09:00:00Z,PORT O CONNOR TX,0,0,0,2,2
Tropical Storm,Keith,7,2000-09-30T09:00:00Z,MARATHON FL,0,0,0,4,4
Tropical Storm,Keith,7,2000-09-30T09:00:00Z,GULF 29N 85W,0,0,0,4,4
Tropical Storm,Keith,7,2000-09-30T09:00:00Z,MIAMI FL,0,0,0,2,2
Tropical Storm,Keith,7,2000-09-30T09:00:00Z,GULF 29N 87W,0,0,0,5,5
Tropical Storm,Keith,7,2000-09-30T09:00:00Z,W PALM BEACH FL,0,0,0,2,2
Tropical Storm,Keith,7,2000-09-30T09:00:00Z,GULF 28N 89W,0,0,0,7,7
Tropical Storm,Keith,7,2000-09-30T09:00:00Z,KEY WEST FL,0,0,0,5,5
Tropical Storm,Keith,7,2000-09-30T09:00:00Z,GULF 28N 91W,0,0,0,7,7
Tropical Storm,Keith,7,2000-09-30T09:00:00Z,MARCO ISLAND FL,0,0,0,4,4
Tropical Storm,Keith,7,2000-09-30T09:00:00Z,GULF 28N 93W,0,0,0,5,5
Tropical Storm,Keith,7,2000-09-30T09:00:00Z,FT MYERS FL,0,0,0,3,3
Tropical Storm,Keith,7,2000-09-30T09:00:00Z,GULF 28N 95W,0,0,0,3,3
Tropical Storm,Keith,7,2000-09-30T09:00:00Z,VENICE FL,0,0,0,4,4
Tropical Storm,Keith,7,2000-09-30T09:00:00Z,GULF 27N 96W,0,0,0,3,3
Tropical Storm,Keith,7,2000-09-30T09:00:00Z,TAMPA FL,0,0,0,3,3
Tropical Storm,Keith,7,2000-09-30T09:00:00Z,GULF 25N 96W,0,0,0,3,3
Hurricane,Keith,8,2000-09-30T15:00:00Z,20.0N  87.5W,49,0,0,0,49
Hurricane,Keith,8,2000-09-30T15:00:00Z,ST MARKS FL,0,0,0,2,2
Hurricane,Keith,8,2000-09-30T15:00:00Z,20.8N  87.8W,36,0,0,1,37
Hurricane,Keith,8,2000-09-30T15:00:00Z,APALACHICOLA FL,0,0,0,2,2
Hurricane,Keith,8,2000-09-30T15:00:00Z,21.5N  88.0W,22,4,1,1,28
Hurricane,Keith,8,2000-09-30T15:00:00Z,PANAMA CITY FL,0,0,0,2,2
Hurricane,Keith,8,2000-09-30T15:00:00Z,MWCG 193N 814W,0,0,1,4,5
Hurricane,Keith,8,2000-09-30T15:00:00Z,PENSACOLA FL,0,0,0,2,2
Hurricane,Keith,8,2000-09-30T15:00:00Z,MUCF 221N 805W,0,0,0,4,4
Hurricane,Keith,8,2000-09-30T15:00:00Z,MOBILE AL,0,0,0,3,3
Hurricane,Keith,8,2000-09-30T15:00:00Z,MUSN 216N 826W,0,1,3,5,9
Hurricane,Keith,8,2000-09-30T15:00:00Z,GULFPORT MS,0,0,0,3,3
Hurricane,Keith,8,2000-09-30T15:00:00Z,MUHA 230N 824W,0,0,2,5,7
Hurricane,Keith,8,2000-09-30T15:00:00Z,BURAS LA,0,0,0,5,5
Hurricane,Keith,8,2000-09-30T15:00:00Z,MUAN 219N 850W,4,6,4,3,17
Hurricane,Keith,8,2000-09-30T15:00:00Z,NEW ORLEANS LA,0,0,0,4,4
Hurricane,Keith,8,2000-09-30T15:00:00Z,MMCZ 205N 869W,43,0,0,0,43
Hurricane,Keith,8,2000-09-30T15:00:00Z,NEW IBERIA LA,0,0,0,3,3
Hurricane,Keith,8,2000-09-30T15:00:00Z,MZBZ 175N 883W,13,1,1,1,16
Hurricane,Keith,8,2000-09-30T15:00:00Z,PORT ARTHUR TX,0,0,0,2,2
Hurricane,Keith,8,2000-09-30T15:00:00Z,MGPB 157N 886W,0,0,1,4,5
Hurricane,Keith,8,2000-09-30T15:00:00Z,GALVESTON TX,0,0,0,2,2
Hurricane,Keith,8,2000-09-30T15:00:00Z,MHNJ 165N 859W,2,1,2,3,8
Hurricane,Keith,8,2000-09-30T15:00:00Z,FREEPORT TX,0,0,0,2,2
Hurricane,Keith,8,2000-09-30T15:00:00Z,MNPC 141N 834W,0,0,0,2,2
Hurricane,Keith,8,2000-09-30T15:00:00Z,PORT O CONNOR TX,0,0,0,2,2
Hurricane,Keith,8,2000-09-30T15:00:00Z,MMFR 185N 926W,0,0,1,4,5
Hurricane,Keith,8,2000-09-30T15:00:00Z,BROWNSVILLE TX,0,0,0,2,2
Hurricane,Keith,8,2000-09-30T15:00:00Z,MMMD 210N 897W,7,9,3,1,20
Hurricane,Keith,8,2000-09-30T15:00:00Z,GULF 29N 85W,0,0,0,3,3
Hurricane,Keith,8,2000-09-30T15:00:00Z,MARATHON FL,0,0,0,3,3
Hurricane,Keith,8,2000-09-30T15:00:00Z,GULF 29N 87W,0,0,0,5,5
Hurricane,Keith,8,2000-09-30T15:00:00Z,MIAMI FL,0,0,0,2,2
Hurricane,Keith,8,2000-09-30T15:00:00Z,GULF 28N 89W,0,0,1,6,7
Hurricane,Keith,8,2000-09-30T15:00:00Z,KEY WEST FL,0,0,0,5,5
Hurricane,Keith,8,2000-09-30T15:00:00Z,GULF 28N 91W,0,0,1,6,7
Hurricane,Keith,8,2000-09-30T15:00:00Z,MARCO ISLAND FL,0,0,0,3,3
Hurricane,Keith,8,2000-09-30T15:00:00Z,GULF 28N 93W,0,0,0,5,5
Hurricane,Keith,8,2000-09-30T15:00:00Z,FT MYERS FL,0,0,0,3,3
Hurricane,Keith,8,2000-09-30T15:00:00Z,GULF 28N 95W,0,0,0,3,3
Hurricane,Keith,8,2000-09-30T15:00:00Z,VENICE FL,0,0,0,3,3
Hurricane,Keith,8,2000-09-30T15:00:00Z,GULF 27N 96W,0,0,0,3,3
Hurricane,Keith,8,2000-09-30T15:00:00Z,TAMPA FL,0,0,0,2,2
Hurricane,Keith,8,2000-09-30T15:00:00Z,GULF 25N 96W,0,0,0,3,3
Hurricane,Keith,8,2000-09-30T15:00:00Z,CEDAR KEY FL,0,0,0,2,2
Hurricane,Keith,9,2000-09-30T21:00:00Z,19.5N  87.2W,55,0,0,0,55
Hurricane,Keith,9,2000-09-30T21:00:00Z,PANAMA CITY FL,0,0,0,2,2
Hurricane,Keith,9,2000-09-30T21:00:00Z,20.3N  87.4W,41,0,1,0,42
Hurricane,Keith,9,2000-09-30T21:00:00Z,PENSACOLA FL,0,0,0,2,2
Hurricane,Keith,9,2000-09-30T21:00:00Z,21.0N  87.5W,26,3,1,0,30
Hurricane,Keith,9,2000-09-30T21:00:00Z,MOBILE AL,0,0,0,3,3
Hurricane,Keith,9,2000-09-30T21:00:00Z,MWCG 193N 814W,0,0,4,4,8
Hurricane,Keith,9,2000-09-30T21:00:00Z,GULFPORT MS,0,0,0,3,3
Hurricane,Keith,9,2000-09-30T21:00:00Z,MUCF 221N 805W,0,0,0,4,4
Hurricane,Keith,9,2000-09-30T21:00:00Z,BURAS LA,0,0,0,5,5
Hurricane,Keith,9,2000-09-30T21:00:00Z,MUSN 216N 826W,0,0,4,6,10
Hurricane,Keith,9,2000-09-30T21:00:00Z,NEW ORLEANS LA,0,0,0,4,4
Hurricane,Keith,9,2000-09-30T21:00:00Z,MUHA 230N 824W,0,0,1,6,7
Hurricane,Keith,9,2000-09-30T21:00:00Z,NEW IBERIA LA,0,0,0,4,4
Hurricane,Keith,9,2000-09-30T21:00:00Z,MUAN 219N 850W,1,6,6,4,17
Hurricane,Keith,9,2000-09-30T21:00:00Z,PORT ARTHUR TX,0,0,0,3,3
Hurricane,Keith,9,2000-09-30T21:00:00Z,MMCZ 205N 869W,37,0,1,0,38
Hurricane,Keith,9,2000-09-30T21:00:00Z,GALVESTON TX,0,0,0,3,3
Hurricane,Keith,9,2000-09-30T21:00:00Z,MZBZ 175N 883W,14,1,0,1,16
Hurricane,Keith,9,2000-09-30T21:00:00Z,FREEPORT TX,0,0,0,3,3
Hurricane,Keith,9,2000-09-30T21:00:00Z,MGPB 157N 886W,0,0,0,3,3
Hurricane,Keith,9,2000-09-30T21:00:00Z,PORT O CONNOR TX,0,0,0,2,2
Hurricane,Keith,9,2000-09-30T21:00:00Z,MHNJ 165N 859W,7,0,1,2,10
Hurricane,Keith,9,2000-09-30T21:00:00Z,CORPUSCHRISTI TX,0,0,0,2,2
Hurricane,Keith,9,2000-09-30T21:00:00Z,MNPC 141N 834W,0,0,0,2,2
Hurricane,Keith,9,2000-09-30T21:00:00Z,BROWNSVILLE TX,0,0,0,2,2
Hurricane,Keith,9,2000-09-30T21:00:00Z,MMFR 185N 926W,0,0,0,3,3
Hurricane,Keith,9,2000-09-30T21:00:00Z,GULF 29N 85W,0,0,0,3,3
Hurricane,Keith,9,2000-09-30T21:00:00Z,MMMD 210N 897W,4,9,3,3,19
Hurricane,Keith,9,2000-09-30T21:00:00Z,GULF 29N 87W,0,0,0,4,4
Hurricane,Keith,9,2000-09-30T21:00:00Z,MARATHON FL,0,0,0,3,3
Hurricane,Keith,9,2000-09-30T21:00:00Z,GULF 28N 89W,0,0,0,7,7
Hurricane,Keith,9,2000-09-30T21:00:00Z,KEY WEST FL,0,0,0,4,4
Hurricane,Keith,9,2000-09-30T21:00:00Z,GULF 28N 91W,0,0,0,7,7
Hurricane,Keith,9,2000-09-30T21:00:00Z,MARCO ISLAND FL,0,0,0,3,3
Hurricane,Keith,9,2000-09-30T21:00:00Z,GULF 28N 93W,0,0,0,6,6
Hurricane,Keith,9,2000-09-30T21:00:00Z,FT MYERS FL,0,0,0,2,2
Hurricane,Keith,9,2000-09-30T21:00:00Z,GULF 28N 95W,0,0,0,4,4
Hurricane,Keith,9,2000-09-30T21:00:00Z,VENICE FL,0,0,0,3,3
Hurricane,Keith,9,2000-09-30T21:00:00Z,GULF 27N 96W,0,0,0,3,3
Hurricane,Keith,9,2000-09-30T21:00:00Z,TAMPA FL,0,0,0,2,2
Hurricane,Keith,9,2000-09-30T21:00:00Z,GULF 25N 96W,0,0,0,4,4
Hurricane,Keith,9,2000-09-30T21:00:00Z,APALACHICOLA FL,0,0,0,2,2
Hurricane,Keith,10,2000-10-01T03:00:00Z,19.0N  87.5W,83,0,0,0,83
Hurricane,Keith,10,2000-10-01T03:00:00Z,CEDAR KEY FL,0,0,0,2,2
Hurricane,Keith,10,2000-10-01T03:00:00Z,20.0N  87.6W,29,1,1,0,31
Hurricane,Keith,10,2000-10-01T03:00:00Z,ST MARKS FL,0,0,0,2,2
Hurricane,Keith,10,2000-10-01T03:00:00Z,21.0N  87.7W,14,8,2,1,25
Hurricane,Keith,10,2000-10-01T03:00:00Z,APALACHICOLA FL,0,0,0,3,3
Hurricane,Keith,10,2000-10-01T03:00:00Z,MWCG 193N 814W,0,1,3,3,7
Hurricane,Keith,10,2000-10-01T03:00:00Z,PANAMA CITY FL,0,0,0,3,3
Hurricane,Keith,10,2000-10-01T03:00:00Z,MUCM 214N 779W,0,0,0,2,2
Hurricane,Keith,10,2000-10-01T03:00:00Z,PENSACOLA FL,0,0,0,3,3
Hurricane,Keith,10,2000-10-01T03:00:00Z,MUCF 221N 805W,0,0,2,5,7
Hurricane,Keith,10,2000-10-01T03:00:00Z,MOBILE AL,0,0,0,3,3
Hurricane,Keith,10,2000-10-01T03:00:00Z,MUSN 216N 826W,0,3,6,4,13
Hurricane,Keith,10,2000-10-01T03:00:00Z,GULFPORT MS,0,0,0,3,3
Hurricane,Keith,10,2000-10-01T03:00:00Z,MUHA 230N 824W,0,0,4,7,11
Hurricane,Keith,10,2000-10-01T03:00:00Z,BURAS LA,0,0,0,5,5
Hurricane,Keith,10,2000-10-01T03:00:00Z,MUAN 219N 850W,2,10,5,2,19
Hurricane,Keith,10,2000-10-01T03:00:00Z,NEW ORLEANS LA,0,0,0,4,4
Hurricane,Keith,10,2000-10-01T03:00:00Z,MMCZ 205N 869W,25,2,1,0,28
Hurricane,Keith,10,2000-10-01T03:00:00Z,NEW IBERIA LA,0,0,0,3,3
Hurricane,Keith,10,2000-10-01T03:00:00Z,MZBZ 175N 883W,32,0,0,0,32
Hurricane,Keith,10,2000-10-01T03:00:00Z,PORT ARTHUR TX,0,0,0,2,2
Hurricane,Keith,10,2000-10-01T03:00:00Z,MGPB 157N 886W,1,0,0,1,2
Hurricane,Keith,10,2000-10-01T03:00:00Z,GALVESTON TX,0,0,0,3,3
Hurricane,Keith,10,2000-10-01T03:00:00Z,MHNJ 165N 859W,5,1,0,1,7
Hurricane,Keith,10,2000-10-01T03:00:00Z,FREEPORT TX,0,0,0,3,3
Hurricane,Keith,10,2000-10-01T03:00:00Z,MMFR 185N 926W,0,0,1,2,3
Hurricane,Keith,10,2000-10-01T03:00:00Z,PORT O CONNOR TX,0,0,0,2,2
Hurricane,Keith,10,2000-10-01T03:00:00Z,MMMD 210N 897W,1,11,4,2,18
Hurricane,Keith,10,2000-10-01T03:00:00Z,CORPUSCHRISTI TX,0,0,0,2,2
Hurricane,Keith,10,2000-10-01T03:00:00Z,MARATHON FL,0,0,0,6,6
Hurricane,Keith,10,2000-10-01T03:00:00Z,BROWNSVILLE TX,0,0,0,2,2
Hurricane,Keith,10,2000-10-01T03:00:00Z,MIAMI FL,0,0,0,3,3
Hurricane,Keith,10,2000-10-01T03:00:00Z,GULF 29N 85W,0,0,0,4,4
Hurricane,Keith,10,2000-10-01T03:00:00Z,W PALM BEACH FL,0,0,0,2,2
Hurricane,Keith,10,2000-10-01T03:00:00Z,GULF 29N 87W,0,0,0,5,5
Hurricane,Keith,10,2000-10-01T03:00:00Z,FT PIERCE FL,0,0,0,2,2
Hurricane,Keith,10,2000-10-01T03:00:00Z,GULF 28N 89W,0,0,0,7,7
Hurricane,Keith,10,2000-10-01T03:00:00Z,COCOA BEACH FL,0,0,0,2,2
Hurricane,Keith,10,2000-10-01T03:00:00Z,GULF 28N 91W,0,0,0,7,7
Hurricane,Keith,10,2000-10-01T03:00:00Z,KEY WEST FL,0,0,1,6,7
Hurricane,Keith,10,2000-10-01T03:00:00Z,GULF 28N 93W,0,0,0,5,5
Hurricane,Keith,10,2000-10-01T03:00:00Z,MARCO ISLAND FL,0,0,0,5,5
Hurricane,Keith,10,2000-10-01T03:00:00Z,GULF 28N 95W,0,0,0,4,4
Hurricane,Keith,10,2000-10-01T03:00:00Z,FT MYERS FL,0,0,0,4,4
Hurricane,Keith,10,2000-10-01T03:00:00Z,GULF 27N 96W,0,0,0,3,3
Hurricane,Keith,10,2000-10-01T03:00:00Z,VENICE FL,0,0,0,4,4
Hurricane,Keith,10,2000-10-01T03:00:00Z,GULF 25N 96W,0,0,0,4,4
Hurricane,Keith,10,2000-10-01T03:00:00Z,TAMPA FL,0,0,0,3,3
Hurricane,Keith,11,2000-10-01T09:00:00Z,18.7N  87.3W,99,0,0,0,99
Hurricane,Keith,11,2000-10-01T09:00:00Z,PANAMA CITY FL,0,0,0,4,4
Hurricane,Keith,11,2000-10-01T09:00:00Z,19.5N  87.5W,32,1,0,0,33
Hurricane,Keith,11,2000-10-01T09:00:00Z,PENSACOLA FL,0,0,0,5,5
Hurricane,Keith,11,2000-10-01T09:00:00Z,21.0N  88.0W,8,11,2,2,23
Hurricane,Keith,11,2000-10-01T09:00:00Z,MOBILE AL,0,0,0,5,5
Hurricane,Keith,11,2000-10-01T09:00:00Z,MUSN 216N 826W,0,0,1,3,4
Hurricane,Keith,11,2000-10-01T09:00:00Z,GULFPORT MS,0,0,0,6,6
Hurricane,Keith,11,2000-10-01T09:00:00Z,MUHA 230N 824W,0,0,0,4,4
Hurricane,Keith,11,2000-10-01T09:00:00Z,BURAS LA,0,0,0,8,8
Hurricane,Keith,11,2000-10-01T09:00:00Z,MUAN 219N 850W,1,7,4,3,15
Hurricane,Keith,11,2000-10-01T09:00:00Z,NEW ORLEANS LA,0,0,0,6,6
Hurricane,Keith,11,2000-10-01T09:00:00Z,MMCZ 205N 869W,19,6,1,0,26
Hurricane,Keith,11,2000-10-01T09:00:00Z,NEW IBERIA LA,0,0,0,5,5
Hurricane,Keith,11,2000-10-01T09:00:00Z,MZBZ 175N 883W,99,0,0,0,99
Hurricane,Keith,11,2000-10-01T09:00:00Z,PORT ARTHUR TX,0,0,0,3,3
Hurricane,Keith,11,2000-10-01T09:00:00Z,MGPB 157N 886W,1,2,1,2,6
Hurricane,Keith,11,2000-10-01T09:00:00Z,GALVESTON TX,0,0,0,3,3
Hurricane,Keith,11,2000-10-01T09:00:00Z,MHNJ 165N 859W,13,2,1,0,16
Hurricane,Keith,11,2000-10-01T09:00:00Z,FREEPORT TX,0,0,0,2,2
Hurricane,Keith,11,2000-10-01T09:00:00Z,MMFR 185N 926W,0,0,0,5,5
Hurricane,Keith,11,2000-10-01T09:00:00Z,PORT O CONNOR TX,0,0,0,2,2
Hurricane,Keith,11,2000-10-01T09:00:00Z,MMMD 210N 897W,1,6,6,3,16
Hurricane,Keith,11,2000-10-01T09:00:00Z,GULF 29N 85W,0,0,0,5,5
Hurricane,Keith,11,2000-10-01T09:00:00Z,KEY WEST FL,0,0,0,2,2
Hurricane,Keith,11,2000-10-01T09:00:00Z,GULF 29N 87W,0,0,0,7,7
Hurricane,Keith,11,2000-10-01T09:00:00Z,MARCO ISLAND FL,0,0,0,2,2
Hurricane,Keith,11,2000-10-01T09:00:00Z,GULF 28N 89W,0,0,1,9,10
Hurricane,Keith,11,2000-10-01T09:00:00Z,FT MYERS FL,0,0,0,2,2
Hurricane,Keith,11,2000-10-01T09:00:00Z,GULF 28N 91W,0,0,1,8,9
Hurricane,Keith,11,2000-10-01T09:00:00Z,VENICE FL,0,0,0,3,3
Hurricane,Keith,11,2000-10-01T09:00:00Z,GULF 28N 93W,0,0,0,6,6
Hurricane,Keith,11,2000-10-01T09:00:00Z,TAMPA FL,0,0,0,2,2
Hurricane,Keith,11,2000-10-01T09:00:00Z,GULF 28N 95W,0,0,0,3,3
Hurricane,Keith,11,2000-10-01T09:00:00Z,CEDAR KEY FL,0,0,0,2,2
Hurricane,Keith,11,2000-10-01T09:00:00Z,GULF 27N 96W,0,0,0,2,2
Hurricane,Keith,11,2000-10-01T09:00:00Z,ST MARKS FL,0,0,0,3,3
Hurricane,Keith,11,2000-10-01T09:00:00Z,GULF 25N 96W,0,0,0,3,3
Hurricane,Keith,11,2000-10-01T09:00:00Z,APALACHICOLA FL,0,0,0,4,4
Hurricane,Keith,12,2000-10-01T15:00:00Z,18.6N  88.0W,99,0,0,0,99
Hurricane,Keith,12,2000-10-01T15:00:00Z,TAMPA FL,0,0,0,3,3
Hurricane,Keith,12,2000-10-01T15:00:00Z,20.0N  88.4W,16,12,0,0,28
Hurricane,Keith,12,2000-10-01T15:00:00Z,CEDAR KEY FL,0,0,0,2,2
Hurricane,Keith,12,2000-10-01T15:00:00Z,21.5N  89.0W,0,15,6,1,22
Hurricane,Keith,12,2000-10-01T15:00:00Z,ST MARKS FL,0,0,0,2,2
Hurricane,Keith,12,2000-10-01T15:00:00Z,MUCF 221N 805W,0,0,1,2,3
Hurricane,Keith,12,2000-10-01T15:00:00Z,APALACHICOLA FL,0,0,0,3,3
Hurricane,Keith,12,2000-10-01T15:00:00Z,MUSN 216N 826W,0,1,4,3,8
Hurricane,Keith,12,2000-10-01T15:00:00Z,PANAMA CITY FL,0,0,0,3,3
Hurricane,Keith,12,2000-10-01T15:00:00Z,MUHA 230N 824W,0,0,4,4,8
Hurricane,Keith,12,2000-10-01T15:00:00Z,PENSACOLA FL,0,0,0,3,3
Hurricane,Keith,12,2000-10-01T15:00:00Z,MUAN 219N 850W,1,8,6,2,17
Hurricane,Keith,12,2000-10-01T15:00:00Z,MOBILE AL,0,0,0,3,3
Hurricane,Keith,12,2000-10-01T15:00:00Z,MMCZ 205N 869W,18,9,1,0,28
Hurricane,Keith,12,2000-10-01T15:00:00Z,GULFPORT MS,0,0,0,4,4
Hurricane,Keith,12,2000-10-01T15:00:00Z,MZBZ 175N 883W,99,0,0,0,99
Hurricane,Keith,12,2000-10-01T15:00:00Z,BURAS LA,0,0,0,5,5
Hurricane,Keith,12,2000-10-01T15:00:00Z,MGPB 157N 886W,5,0,0,0,5
Hurricane,Keith,12,2000-10-01T15:00:00Z,NEW ORLEANS LA,0,0,0,5,5
Hurricane,Keith,12,2000-10-01T15:00:00Z,MHNJ 165N 859W,3,0,0,0,3
Hurricane,Keith,12,2000-10-01T15:00:00Z,NEW IBERIA LA,0,0,0,4,4
Hurricane,Keith,12,2000-10-01T15:00:00Z,MMSO 238N 982W,0,0,0,4,4
Hurricane,Keith,12,2000-10-01T15:00:00Z,PORT ARTHUR TX,0,0,0,4,4
Hurricane,Keith,12,2000-10-01T15:00:00Z,MMTM 222N 979W,0,0,0,3,3
Hurricane,Keith,12,2000-10-01T15:00:00Z,GALVESTON TX,0,0,0,4,4
Hurricane,Keith,12,2000-10-01T15:00:00Z,MMTX 210N 974W,0,0,0,3,3
Hurricane,Keith,12,2000-10-01T15:00:00Z,FREEPORT TX,0,0,0,4,4
Hurricane,Keith,12,2000-10-01T15:00:00Z,MMVR 192N 961W,0,0,0,2,2
Hurricane,Keith,12,2000-10-01T15:00:00Z,PORT O CONNOR TX,0,0,0,4,4
Hurricane,Keith,12,2000-10-01T15:00:00Z,MMFR 185N 926W,0,1,1,2,4
Hurricane,Keith,12,2000-10-01T15:00:00Z,CORPUSCHRISTI TX,0,0,0,4,4
Hurricane,Keith,12,2000-10-01T15:00:00Z,MMMD 210N 897W,0,16,4,1,21
Hurricane,Keith,12,2000-10-01T15:00:00Z,BROWNSVILLE TX,0,0,0,5,5
Hurricane,Keith,12,2000-10-01T15:00:00Z,MARATHON FL,0,0,0,4,4
Hurricane,Keith,12,2000-10-01T15:00:00Z,GULF 29N 85W,0,0,0,4,4
Hurricane,Keith,12,2000-10-01T15:00:00Z,MIAMI FL,0,0,0,2,2
Hurricane,Keith,12,2000-10-01T15:00:00Z,GULF 29N 87W,0,0,0,5,5
Hurricane,Keith,12,2000-10-01T15:00:00Z,W PALM BEACH FL,0,0,0,2,2
Hurricane,Keith,12,2000-10-01T15:00:00Z,GULF 28N 89W,0,0,0,8,8
Hurricane,Keith,12,2000-10-01T15:00:00Z,FT PIERCE FL,0,0,0,2,2
Hurricane,Keith,12,2000-10-01T15:00:00Z,GULF 28N 91W,0,0,0,8,8
Hurricane,Keith,12,2000-10-01T15:00:00Z,KEY WEST FL,0,0,1,4,5
Hurricane,Keith,12,2000-10-01T15:00:00Z,GULF 28N 93W,0,0,0,7,7
Hurricane,Keith,12,2000-10-01T15:00:00Z,MARCO ISLAND FL,0,0,0,4,4
Hurricane,Keith,12,2000-10-01T15:00:00Z,GULF 28N 95W,0,0,0,6,6
Hurricane,Keith,12,2000-10-01T15:00:00Z,FT MYERS FL,0,0,0,4,4
Hurricane,Keith,12,2000-10-01T15:00:00Z,GULF 27N 96W,0,0,0,6,6
Hurricane,Keith,12,2000-10-01T15:00:00Z,VENICE FL,0,0,0,4,4
Hurricane,Keith,12,2000-10-01T15:00:00Z,GULF 25N 96W,0,0,0,7,7
Hurricane,Keith,13,2000-10-01T21:00:00Z,18.6N  88.3W,99,0,0,0,99
Hurricane,Keith,13,2000-10-01T21:00:00Z,ST MARKS FL,0,0,0,2,2
Hurricane,Keith,13,2000-10-01T21:00:00Z,20.3N  88.6W,18,10,1,0,29
Hurricane,Keith,13,2000-10-01T21:00:00Z,APALACHICOLA FL,0,0,0,3,3
Hurricane,Keith,13,2000-10-01T21:00:00Z,22.0N  89.5W,0,14,7,1,22
Hurricane,Keith,13,2000-10-01T21:00:00Z,PANAMA CITY FL,0,0,0,3,3
Hurricane,Keith,13,2000-10-01T21:00:00Z,MWCG 193N 814W,0,0,1,1,2
Hurricane,Keith,13,2000-10-01T21:00:00Z,PENSACOLA FL,0,0,0,4,4
Hurricane,Keith,13,2000-10-01T21:00:00Z,MUCF 221N 805W,0,0,0,2,2
Hurricane,Keith,13,2000-10-01T21:00:00Z,MOBILE AL,0,0,0,4,4
Hurricane,Keith,13,2000-10-01T21:00:00Z,MUSN 216N 826W,0,0,3,3,6
Hurricane,Keith,13,2000-10-01T21:00:00Z,GULFPORT MS,0,0,0,5,5
Hurricane,Keith,13,2000-10-01T21:00:00Z,MUHA 230N 824W,0,0,1,4,5
Hurricane,Keith,13,2000-10-01T21:00:00Z,BURAS LA,0,0,0,7,7
Hurricane,Keith,13,2000-10-01T21:00:00Z,MUAN 219N 850W,0,6,7,2,15
Hurricane,Keith,13,2000-10-01T21:00:00Z,NEW ORLEANS LA,0,0,0,7,7
Hurricane,Keith,13,2000-10-01T21:00:00Z,MMCZ 205N 869W,17,9,0,1,27
Hurricane,Keith,13,2000-10-01T21:00:00Z,NEW IBERIA LA,0,0,0,7,7
Hurricane,Keith,13,2000-10-01T21:00:00Z,MZBZ 175N 883W,99,0,0,0,99
Hurricane,Keith,13,2000-10-01T21:00:00Z,PORT ARTHUR TX,0,0,0,7,7
Hurricane,Keith,13,2000-10-01T21:00:00Z,MGPB 157N 886W,5,0,0,1,6
Hurricane,Keith,13,2000-10-01T21:00:00Z,GALVESTON TX,0,0,0,7,7
Hurricane,Keith,13,2000-10-01T21:00:00Z,MHNJ 165N 859W,2,1,0,1,4
Hurricane,Keith,13,2000-10-01T21:00:00Z,FREEPORT TX,0,0,0,7,7
Hurricane,Keith,13,2000-10-01T21:00:00Z,MMSO 238N 982W,0,0,0,4,4
Hurricane,Keith,13,2000-10-01T21:00:00Z,PORT O CONNOR TX,0,0,0,7,7
Hurricane,Keith,13,2000-10-01T21:00:00Z,MMTM 222N 979W,0,0,0,2,2
Hurricane,Keith,13,2000-10-01T21:00:00Z,CORPUSCHRISTI TX,0,0,0,6,6
Hurricane,Keith,13,2000-10-01T21:00:00Z,MMTX 210N 974W,0,0,0,2,2
Hurricane,Keith,13,2000-10-01T21:00:00Z,BROWNSVILLE TX,0,0,0,6,6
Hurricane,Keith,13,2000-10-01T21:00:00Z,MMFR 185N 926W,0,1,0,1,2
Hurricane,Keith,13,2000-10-01T21:00:00Z,GULF 29N 85W,0,0,0,3,3
Hurricane,Keith,13,2000-10-01T21:00:00Z,MMMD 210N 897W,1,18,2,1,22
Hurricane,Keith,13,2000-10-01T21:00:00Z,GULF 29N 87W,0,0,0,6,6
Hurricane,Keith,13,2000-10-01T21:00:00Z,MARATHON FL,0,0,0,2,2
Hurricane,Keith,13,2000-10-01T21:00:00Z,GULF 28N 89W,0,0,0,9,9
Hurricane,Keith,13,2000-10-01T21:00:00Z,KEY WEST FL,0,0,0,3,3
Hurricane,Keith,13,2000-10-01T21:00:00Z,GULF 28N 91W,0,0,0,10,10
Hurricane,Keith,13,2000-10-01T21:00:00Z,MARCO ISLAND FL,0,0,0,2,2
Hurricane,Keith,13,2000-10-01T21:00:00Z,GULF 28N 93W,0,0,0,10,10
Hurricane,Keith,13,2000-10-01T21:00:00Z,FT MYERS FL,0,0,0,2,2
Hurricane,Keith,13,2000-10-01T21:00:00Z,GULF 28N 95W,0,0,0,9,9
Hurricane,Keith,13,2000-10-01T21:00:00Z,VENICE FL,0,0,0,2,2
Hurricane,Keith,13,2000-10-01T21:00:00Z,GULF 27N 96W,0,0,0,8,8
Hurricane,Keith,13,2000-10-01T21:00:00Z,TAMPA FL,0,0,0,2,2
Hurricane,Keith,13,2000-10-01T21:00:00Z,GULF 25N 96W,0,0,1,8,9
Hurricane,Keith,14,2000-10-02T03:00:00Z,19.0N  88.0W,49,0,0,0,49
Hurricane,Keith,14,2000-10-02T03:00:00Z,GULFPORT MS,0,0,0,8,8
Hurricane,Keith,14,2000-10-02T03:00:00Z,20.3N  88.6W,27,3,0,1,31
Hurricane,Keith,14,2000-10-02T03:00:00Z,BURAS LA,0,0,1,9,10
Hurricane,Keith,14,2000-10-02T03:00:00Z,22.0N  89.5W,1,16,5,1,23
Hurricane,Keith,14,2000-10-02T03:00:00Z,NEW ORLEANS LA,0,0,0,9,9
Hurricane,Keith,14,2000-10-02T03:00:00Z,MUAN 219N 850W,0,3,3,2,8
Hurricane,Keith,14,2000-10-02T03:00:00Z,NEW IBERIA LA,0,0,0,10,10
Hurricane,Keith,14,2000-10-02T03:00:00Z,MMCZ 205N 869W,23,4,1,0,28
Hurricane,Keith,14,2000-10-02T03:00:00Z,PORT ARTHUR TX,0,0,0,8,8
Hurricane,Keith,14,2000-10-02T03:00:00Z,MZBZ 175N 883W,99,0,0,0,99
Hurricane,Keith,14,2000-10-02T03:00:00Z,GALVESTON TX,0,0,0,8,8
Hurricane,Keith,14,2000-10-02T03:00:00Z,MGPB 157N 886W,2,2,2,1,7
Hurricane,Keith,14,2000-10-02T03:00:00Z,FREEPORT TX,0,0,0,7,7
Hurricane,Keith,14,2000-10-02T03:00:00Z,MHNJ 165N 859W,6,2,1,0,9
Hurricane,Keith,14,2000-10-02T03:00:00Z,PORT O CONNOR TX,0,0,0,6,6
Hurricane,Keith,14,2000-10-02T03:00:00Z,MMSO 238N 982W,0,0,0,3,3
Hurricane,Keith,14,2000-10-02T03:00:00Z,CORPUSCHRISTI TX,0,0,0,5,5
Hurricane,Keith,14,2000-10-02T03:00:00Z,MMTM 222N 979W,0,0,0,3,3
Hurricane,Keith,14,2000-10-02T03:00:00Z,BROWNSVILLE TX,0,0,0,5,5
Hurricane,Keith,14,2000-10-02T03:00:00Z,MMTX 210N 974W,0,0,0,3,3
Hurricane,Keith,14,2000-10-02T03:00:00Z,GULF 29N 85W,0,0,0,3,3
Hurricane,Keith,14,2000-10-02T03:00:00Z,MMVR 192N 961W,0,0,0,3,3
Hurricane,Keith,14,2000-10-02T03:00:00Z,GULF 29N 87W,0,0,0,7,7
Hurricane,Keith,14,2000-10-02T03:00:00Z,MMFR 185N 926W,0,0,1,6,7
Hurricane,Keith,14,2000-10-02T03:00:00Z,GULF 28N 89W,0,0,3,9,12
Hurricane,Keith,14,2000-10-02T03:00:00Z,MMMD 210N 897W,4,14,3,1,22
Hurricane,Keith,14,2000-10-02T03:00:00Z,GULF 28N 91W,0,0,2,11,13
Hurricane,Keith,14,2000-10-02T03:00:00Z,ST MARKS FL,0,0,0,2,2
Hurricane,Keith,14,2000-10-02T03:00:00Z,GULF 28N 93W,0,0,1,10,11
Hurricane,Keith,14,2000-10-02T03:00:00Z,APALACHICOLA FL,0,0,0,3,3
Hurricane,Keith,14,2000-10-02T03:00:00Z,GULF 28N 95W,0,0,0,9,9
Hurricane,Keith,14,2000-10-02T03:00:00Z,PANAMA CITY FL,0,0,0,3,3
Hurricane,Keith,14,2000-10-02T03:00:00Z,GULF 27N 96W,0,0,0,7,7
Hurricane,Keith,14,2000-10-02T03:00:00Z,PENSACOLA FL,0,0,0,5,5
Hurricane,Keith,14,2000-10-02T03:00:00Z,GULF 25N 96W,0,0,0,7,7
Hurricane,Keith,14,2000-10-02T03:00:00Z,MOBILE AL,0,0,0,7,7
Hurricane,Keith,15,2000-10-02T09:00:00Z,19.0N  88.0W,49,0,0,0,49
Hurricane,Keith,15,2000-10-02T09:00:00Z,PANAMA CITY FL,0,0,0,4,4
Hurricane,Keith,15,2000-10-02T09:00:00Z,20.0N  88.4W,28,1,1,0,30
Hurricane,Keith,15,2000-10-02T09:00:00Z,PENSACOLA FL,0,0,0,5,5
Hurricane,Keith,15,2000-10-02T09:00:00Z,21.5N  89.0W,5,13,3,1,22
Hurricane,Keith,15,2000-10-02T09:00:00Z,MOBILE AL,0,0,0,6,6
Hurricane,Keith,15,2000-10-02T09:00:00Z,MUSN 216N 826W,0,0,1,1,2
Hurricane,Keith,15,2000-10-02T09:00:00Z,GULFPORT MS,0,0,0,7,7
Hurricane,Keith,15,2000-10-02T09:00:00Z,MUHA 230N 824W,0,0,0,2,2
Hurricane,Keith,15,2000-10-02T09:00:00Z,BURAS LA,0,0,0,9,9
Hurricane,Keith,15,2000-10-02T09:00:00Z,MUAN 219N 850W,0,5,4,2,11
Hurricane,Keith,15,2000-10-02T09:00:00Z,NEW ORLEANS LA,0,0,0,8,8
Hurricane,Keith,15,2000-10-02T09:00:00Z,MMCZ 205N 869W,20,3,1,1,25
Hurricane,Keith,15,2000-10-02T09:00:00Z,NEW IBERIA LA,0,0,0,8,8
Hurricane,Keith,15,2000-10-02T09:00:00Z,MZBZ 175N 883W,99,0,0,0,99
Hurricane,Keith,15,2000-10-02T09:00:00Z,PORT ARTHUR TX,0,0,0,6,6
Hurricane,Keith,15,2000-10-02T09:00:00Z,MGPB 157N 886W,2,3,2,1,8
Hurricane,Keith,15,2000-10-02T09:00:00Z,GALVESTON TX,0,0,0,6,6
Hurricane,Keith,15,2000-10-02T09:00:00Z,MHNJ 165N 859W,7,2,1,0,10
Hurricane,Keith,15,2000-10-02T09:00:00Z,FREEPORT TX,0,0,0,6,6
Hurricane,Keith,15,2000-10-02T09:00:00Z,MMSO 238N 982W,0,0,0,4,4
Hurricane,Keith,15,2000-10-02T09:00:00Z,PORT O CONNOR TX,0,0,0,5,5
Hurricane,Keith,15,2000-10-02T09:00:00Z,MMTM 222N 979W,0,0,0,4,4
Hurricane,Keith,15,2000-10-02T09:00:00Z,CORPUSCHRISTI TX,0,0,0,4,4
Hurricane,Keith,15,2000-10-02T09:00:00Z,MMTX 210N 974W,0,0,0,4,4
Hurricane,Keith,15,2000-10-02T09:00:00Z,BROWNSVILLE TX,0,0,0,5,5
Hurricane,Keith,15,2000-10-02T09:00:00Z,MMVR 192N 961W,0,0,0,4,4
Hurricane,Keith,15,2000-10-02T09:00:00Z,GULF 29N 85W,0,0,0,4,4
Hurricane,Keith,15,2000-10-02T09:00:00Z,MMFR 185N 926W,0,1,3,5,9
Hurricane,Keith,15,2000-10-02T09:00:00Z,GULF 29N 87W,0,0,1,6,7
Hurricane,Keith,15,2000-10-02T09:00:00Z,MMMD 210N 897W,6,11,2,2,21
Hurricane,Keith,15,2000-10-02T09:00:00Z,GULF 28N 89W,0,0,2,9,11
Hurricane,Keith,15,2000-10-02T09:00:00Z,VENICE FL,0,0,0,2,2
Hurricane,Keith,15,2000-10-02T09:00:00Z,GULF 28N 91W,0,0,1,10,11
Hurricane,Keith,15,2000-10-02T09:00:00Z,TAMPA FL,0,0,0,2,2
Hurricane,Keith,15,2000-10-02T09:00:00Z,GULF 28N 93W,0,0,0,10,10
Hurricane,Keith,15,2000-10-02T09:00:00Z,CEDAR KEY FL,0,0,0,2,2
Hurricane,Keith,15,2000-10-02T09:00:00Z,GULF 28N 95W,0,0,0,7,7
Hurricane,Keith,15,2000-10-02T09:00:00Z,ST MARKS FL,0,0,0,2,2
Hurricane,Keith,15,2000-10-02T09:00:00Z,GULF 27N 96W,0,0,0,7,7
Hurricane,Keith,15,2000-10-02T09:00:00Z,APALACHICOLA FL,0,0,0,4,4
Hurricane,Keith,15,2000-10-02T09:00:00Z,GULF 25N 96W,0,0,0,7,7
Hurricane,Keith,16,2000-10-02T15:00:00Z,18.3N  88.1W,99,0,0,0,99
Hurricane,Keith,16,2000-10-02T15:00:00Z,GULFPORT MS,0,0,0,7,7
Hurricane,Keith,16,2000-10-02T15:00:00Z,19.5N  88.5W,26,3,0,0,29
Hurricane,Keith,16,2000-10-02T15:00:00Z,BURAS LA,0,0,1,8,9
Hurricane,Keith,16,2000-10-02T15:00:00Z,21.5N  89.0W,2,17,3,1,23
Hurricane,Keith,16,2000-10-02T15:00:00Z,NEW ORLEANS LA,0,0,0,8,8
Hurricane,Keith,16,2000-10-02T15:00:00Z,MUAN 219N 850W,0,0,3,4,7
Hurricane,Keith,16,2000-10-02T15:00:00Z,NEW IBERIA LA,0,0,0,8,8
Hurricane,Keith,16,2000-10-02T15:00:00Z,MMCZ 205N 869W,9,8,2,1,20
Hurricane,Keith,16,2000-10-02T15:00:00Z,PORT ARTHUR TX,0,0,0,6,6
Hurricane,Keith,16,2000-10-02T15:00:00Z,MZBZ 175N 883W,99,0,0,0,99
Hurricane,Keith,16,2000-10-02T15:00:00Z,GALVESTON TX,0,0,0,6,6
Hurricane,Keith,16,2000-10-02T15:00:00Z,MGPB 157N 886W,7,4,1,1,13
Hurricane,Keith,16,2000-10-02T15:00:00Z,FREEPORT TX,0,0,0,5,5
Hurricane,Keith,16,2000-10-02T15:00:00Z,MHNJ 165N 859W,10,2,1,1,14
Hurricane,Keith,16,2000-10-02T15:00:00Z,PORT O CONNOR TX,0,0,0,4,4
Hurricane,Keith,16,2000-10-02T15:00:00Z,MMSO 238N 982W,0,0,0,2,2
Hurricane,Keith,16,2000-10-02T15:00:00Z,CORPUSCHRISTI TX,0,0,0,3,3
Hurricane,Keith,16,2000-10-02T15:00:00Z,MMTM 222N 979W,0,0,0,2,2
Hurricane,Keith,16,2000-10-02T15:00:00Z,BROWNSVILLE TX,0,0,0,3,3
Hurricane,Keith,16,2000-10-02T15:00:00Z,MMTX 210N 974W,0,0,0,2,2
Hurricane,Keith,16,2000-10-02T15:00:00Z,GULF 29N 85W,0,0,0,3,3
Hurricane,Keith,16,2000-10-02T15:00:00Z,MMVR 192N 961W,0,0,0,2,2
Hurricane,Keith,16,2000-10-02T15:00:00Z,GULF 29N 87W,0,0,0,6,6
Hurricane,Keith,16,2000-10-02T15:00:00Z,MMFR 185N 926W,0,0,1,5,6
Hurricane,Keith,16,2000-10-02T15:00:00Z,GULF 28N 89W,0,0,2,9,11
Hurricane,Keith,16,2000-10-02T15:00:00Z,MMMD 210N 897W,2,14,4,2,22
Hurricane,Keith,16,2000-10-02T15:00:00Z,GULF 28N 91W,0,0,2,9,11
Hurricane,Keith,16,2000-10-02T15:00:00Z,ST MARKS FL,0,0,0,2,2
Hurricane,Keith,16,2000-10-02T15:00:00Z,GULF 28N 93W,0,0,1,8,9
Hurricane,Keith,16,2000-10-02T15:00:00Z,APALACHICOLA FL,0,0,0,3,3
Hurricane,Keith,16,2000-10-02T15:00:00Z,GULF 28N 95W,0,0,0,6,6
Hurricane,Keith,16,2000-10-02T15:00:00Z,PANAMA CITY FL,0,0,0,3,3
Hurricane,Keith,16,2000-10-02T15:00:00Z,GULF 27N 96W,0,0,0,5,5
Hurricane,Keith,16,2000-10-02T15:00:00Z,PENSACOLA FL,0,0,0,5,5
Hurricane,Keith,16,2000-10-02T15:00:00Z,GULF 25N 96W,0,0,0,5,5
Hurricane,Keith,16,2000-10-02T15:00:00Z,MOBILE AL,0,0,0,6,6
Hurricane,Keith,17,2000-10-02T21:00:00Z,18.9N  88.8W,49,0,0,0,49
Hurricane,Keith,17,2000-10-02T21:00:00Z,ST MARKS FL,0,0,0,2,2
Hurricane,Keith,17,2000-10-02T21:00:00Z,20.4N  89.3W,18,11,1,0,30
Hurricane,Keith,17,2000-10-02T21:00:00Z,APALACHICOLA FL,0,0,0,3,3
Hurricane,Keith,17,2000-10-02T21:00:00Z,22.0N  90.0W,0,12,8,2,22
Hurricane,Keith,17,2000-10-02T21:00:00Z,PANAMA CITY FL,0,0,0,3,3
Hurricane,Keith,17,2000-10-02T21:00:00Z,MUSN 216N 826W,0,1,2,2,5
Hurricane,Keith,17,2000-10-02T21:00:00Z,PENSACOLA FL,0,0,0,3,3
Hurricane,Keith,17,2000-10-02T21:00:00Z,MUHA 230N 824W,0,0,3,2,5
Hurricane,Keith,17,2000-10-02T21:00:00Z,MOBILE AL,0,0,0,3,3
Hurricane,Keith,17,2000-10-02T21:00:00Z,MUAN 219N 850W,0,7,5,2,14
Hurricane,Keith,17,2000-10-02T21:00:00Z,GULFPORT MS,0,0,0,4,4
Hurricane,Keith,17,2000-10-02T21:00:00Z,MMCZ 205N 869W,12,11,1,0,24
Hurricane,Keith,17,2000-10-02T21:00:00Z,BURAS LA,0,0,0,6,6
Hurricane,Keith,17,2000-10-02T21:00:00Z,MZBZ 175N 883W,99,0,0,0,99
Hurricane,Keith,17,2000-10-02T21:00:00Z,NEW ORLEANS LA,0,0,0,5,5
Hurricane,Keith,17,2000-10-02T21:00:00Z,MGPB 157N 886W,3,0,0,0,3
Hurricane,Keith,17,2000-10-02T21:00:00Z,NEW IBERIA LA,0,0,0,6,6
Hurricane,Keith,17,2000-10-02T21:00:00Z,MMSO 238N 982W,0,0,0,7,7
Hurricane,Keith,17,2000-10-02T21:00:00Z,PORT ARTHUR TX,0,0,0,6,6
Hurricane,Keith,17,2000-10-02T21:00:00Z,MMTM 222N 979W,0,0,1,6,7
Hurricane,Keith,17,2000-10-02T21:00:00Z,GALVESTON TX,0,0,0,7,7
Hurricane,Keith,17,2000-10-02T21:00:00Z,MMTX 210N 974W,0,0,1,5,6
Hurricane,Keith,17,2000-10-02T21:00:00Z,FREEPORT TX,0,0,0,7,7
Hurricane,Keith,17,2000-10-02T21:00:00Z,MMVR 192N 961W,0,0,2,2,4
Hurricane,Keith,17,2000-10-02T21:00:00Z,PORT O CONNOR TX,0,0,0,7,7
Hurricane,Keith,17,2000-10-02T21:00:00Z,MMFR 185N 926W,0,7,2,1,10
Hurricane,Keith,17,2000-10-02T21:00:00Z,CORPUSCHRISTI TX,0,0,0,7,7
Hurricane,Keith,17,2000-10-02T21:00:00Z,MMMD 210N 897W,4,20,1,0,25
Hurricane,Keith,17,2000-10-02T21:00:00Z,BROWNSVILLE TX,0,0,0,8,8
Hurricane,Keith,17,2000-10-02T21:00:00Z,MARATHON FL,0,0,0,3,3
Hurricane,Keith,17,2000-10-02T21:00:00Z,GULF 29N 85W,0,0,0,4,4
Hurricane,Keith,17,2000-10-02T21:00:00Z,MIAMI FL,0,0,0,2,2
Hurricane,Keith,17,2000-10-02T21:00:00Z,GULF 29N 87W,0,0,0,5,5
Hurricane,Keith,17,2000-10-02T21:00:00Z,KEY WEST FL,0,0,1,3,4
Hurricane,Keith,17,2000-10-02T21:00:00Z,GULF 28N 89W,0,0,0,9,9
Hurricane,Keith,17,2000-10-02T21:00:00Z,MARCO ISLAND FL,0,0,0,3,3
Hurricane,Keith,17,2000-10-02T21:00:00Z,GULF 28N 91W,0,0,0,9,9
Hurricane,Keith,17,2000-10-02T21:00:00Z,FT MYERS FL,0,0,0,3,3
Hurricane,Keith,17,2000-10-02T21:00:00Z,GULF 28N 93W,0,0,0,9,9
Hurricane,Keith,17,2000-10-02T21:00:00Z,VENICE FL,0,0,0,3,3
Hurricane,Keith,17,2000-10-02T21:00:00Z,GULF 28N 95W,0,0,0,8,8
Hurricane,Keith,17,2000-10-02T21:00:00Z,TAMPA FL,0,0,0,3,3
Hurricane,Keith,17,2000-10-02T21:00:00Z,GULF 27N 96W,0,0,0,9,9
Hurricane,Keith,17,2000-10-02T21:00:00Z,CEDAR KEY FL,0,0,0,2,2
Hurricane,Keith,17,2000-10-02T21:00:00Z,GULF 25N 96W,0,0,0,10,10
Tropical Storm,Keith,18,2000-10-03T03:00:00Z,19.0N  88.6W,52,0,0,0,52
Tropical Storm,Keith,18,2000-10-03T03:00:00Z,GULFPORT MS,0,0,0,5,5
Tropical Storm,Keith,18,2000-10-03T03:00:00Z,20.4N  89.4W,22,8,0,0,30
Tropical Storm,Keith,18,2000-10-03T03:00:00Z,BURAS LA,0,0,0,7,7
Tropical Storm,Keith,18,2000-10-03T03:00:00Z,22.5N  90.5W,0,16,6,1,23
Tropical Storm,Keith,18,2000-10-03T03:00:00Z,NEW ORLEANS LA,0,0,0,6,6
Tropical Storm,Keith,18,2000-10-03T03:00:00Z,MUAN 219N 850W,0,0,3,3,6
Tropical Storm,Keith,18,2000-10-03T03:00:00Z,NEW IBERIA LA,0,0,0,7,7
Tropical Storm,Keith,18,2000-10-03T03:00:00Z,MMCZ 205N 869W,17,3,0,1,21
Tropical Storm,Keith,18,2000-10-03T03:00:00Z,PORT ARTHUR TX,0,0,0,8,8
Tropical Storm,Keith,18,2000-10-03T03:00:00Z,MZBZ 175N 883W,99,0,0,0,99
Tropical Storm,Keith,18,2000-10-03T03:00:00Z,GALVESTON TX,0,0,0,8,8
Tropical Storm,Keith,18,2000-10-03T03:00:00Z,MGPB 157N 886W,1,2,0,1,4
Tropical Storm,Keith,18,2000-10-03T03:00:00Z,FREEPORT TX,0,0,1,7,8
Tropical Storm,Keith,18,2000-10-03T03:00:00Z,MHNJ 165N 859W,2,2,2,0,6
Tropical Storm,Keith,18,2000-10-03T03:00:00Z,PORT O CONNOR TX,0,0,1,7,8
Tropical Storm,Keith,18,2000-10-03T03:00:00Z,MMSO 238N 982W,0,0,0,5,5
Tropical Storm,Keith,18,2000-10-03T03:00:00Z,CORPUSCHRISTI TX,0,0,0,7,7
Tropical Storm,Keith,18,2000-10-03T03:00:00Z,MMTM 222N 979W,0,0,0,4,4
Tropical Storm,Keith,18,2000-10-03T03:00:00Z,BROWNSVILLE TX,0,0,1,7,8
Tropical Storm,Keith,18,2000-10-03T03:00:00Z,MMTX 210N 974W,0,0,0,4,4
Tropical Storm,Keith,18,2000-10-03T03:00:00Z,GULF 29N 85W,0,0,0,2,2
Tropical Storm,Keith,18,2000-10-03T03:00:00Z,MMVR 192N 961W,0,0,0,3,3
Tropical Storm,Keith,18,2000-10-03T03:00:00Z,GULF 29N 87W,0,0,0,4,4
Tropical Storm,Keith,18,2000-10-03T03:00:00Z,MMFR 185N 926W,0,1,1,4,6
Tropical Storm,Keith,18,2000-10-03T03:00:00Z,GULF 28N 89W,0,0,0,8,8
Tropical Storm,Keith,18,2000-10-03T03:00:00Z,MMMD 210N 897W,9,17,1,0,27
Tropical Storm,Keith,18,2000-10-03T03:00:00Z,GULF 28N 91W,0,0,1,9,10
Tropical Storm,Keith,18,2000-10-03T03:00:00Z,APALACHICOLA FL,0,0,0,2,2
Tropical Storm,Keith,18,2000-10-03T03:00:00Z,GULF 28N 93W,0,0,2,9,11
Tropical Storm,Keith,18,2000-10-03T03:00:00Z,PANAMA CITY FL,0,0,0,2,2
Tropical Storm,Keith,18,2000-10-03T03:00:00Z,GULF 28N 95W,0,0,1,9,10
Tropical Storm,Keith,18,2000-10-03T03:00:00Z,PENSACOLA FL,0,0,0,3,3
Tropical Storm,Keith,18,2000-10-03T03:00:00Z,GULF 27N 96W,0,0,1,9,10
Tropical Storm,Keith,18,2000-10-03T03:00:00Z,MOBILE AL,0,0,0,4,4
Tropical Storm,Keith,18,2000-10-03T03:00:00Z,GULF 25N 96W,0,0,2,8,10
Tropical Storm,Keith,19,2000-10-03T09:00:00Z,20.1N  90.2W,54,0,0,0,54
Tropical Storm,Keith,19,2000-10-03T09:00:00Z,GULFPORT MS,0,0,0,5,5
Tropical Storm,Keith,19,2000-10-03T09:00:00Z,21.3N  90.9W,28,4,0,0,32
Tropical Storm,Keith,19,2000-10-03T09:00:00Z,BURAS LA,0,0,0,7,7
Tropical Storm,Keith,19,2000-10-03T09:00:00Z,23.0N  91.5W,2,16,2,2,22
Tropical Storm,Keith,19,2000-10-03T09:00:00Z,NEW ORLEANS LA,0,0,0,7,7
Tropical Storm,Keith,19,2000-10-03T09:00:00Z,MUSN 216N 826W,0,0,0,2,2
Tropical Storm,Keith,19,2000-10-03T09:00:00Z,NEW IBERIA LA,0,0,0,8,8
Tropical Storm,Keith,19,2000-10-03T09:00:00Z,MUHA 230N 824W,0,0,0,2,2
Tropical Storm,Keith,19,2000-10-03T09:00:00Z,PORT ARTHUR TX,0,0,0,8,8
Tropical Storm,Keith,19,2000-10-03T09:00:00Z,MUAN 219N 850W,0,0,2,4,6
Tropical Storm,Keith,19,2000-10-03T09:00:00Z,GALVESTON TX,0,0,0,9,9
Tropical Storm,Keith,19,2000-10-03T09:00:00Z,MMCZ 205N 869W,5,4,2,2,13
Tropical Storm,Keith,19,2000-10-03T09:00:00Z,FREEPORT TX,0,0,0,9,9
Tropical Storm,Keith,19,2000-10-03T09:00:00Z,MZBZ 175N 883W,99,0,0,0,99
Tropical Storm,Keith,19,2000-10-03T09:00:00Z,PORT O CONNOR TX,0,0,1,8,9
Tropical Storm,Keith,19,2000-10-03T09:00:00Z,MMSO 238N 982W,0,0,2,4,6
Tropical Storm,Keith,19,2000-10-03T09:00:00Z,CORPUSCHRISTI TX,0,0,1,7,8
Tropical Storm,Keith,19,2000-10-03T09:00:00Z,MMTM 222N 979W,0,0,1,4,5
Tropical Storm,Keith,19,2000-10-03T09:00:00Z,BROWNSVILLE TX,0,0,3,6,9
Tropical Storm,Keith,19,2000-10-03T09:00:00Z,MMTX 210N 974W,0,0,0,3,3
Tropical Storm,Keith,19,2000-10-03T09:00:00Z,GULF 29N 85W,0,0,0,3,3
Tropical Storm,Keith,19,2000-10-03T09:00:00Z,MMVR 192N 961W,0,0,0,2,2
Tropical Storm,Keith,19,2000-10-03T09:00:00Z,GULF 29N 87W,0,0,0,5,5
Tropical Storm,Keith,19,2000-10-03T09:00:00Z,MMFR 185N 926W,1,2,1,2,6
Tropical Storm,Keith,19,2000-10-03T09:00:00Z,GULF 28N 89W,0,0,0,8,8
Tropical Storm,Keith,19,2000-10-03T09:00:00Z,MMMD 210N 897W,40,1,0,0,41
Tropical Storm,Keith,19,2000-10-03T09:00:00Z,GULF 28N 91W,0,0,1,9,10
Tropical Storm,Keith,19,2000-10-03T09:00:00Z,APALACHICOLA FL,0,0,0,2,2
Tropical Storm,Keith,19,2000-10-03T09:00:00Z,GULF 28N 93W,0,0,1,10,11
Tropical Storm,Keith,19,2000-10-03T09:00:00Z,PANAMA CITY FL,0,0,0,3,3
Tropical Storm,Keith,19,2000-10-03T09:00:00Z,GULF 28N 95W,0,0,1,10,11
Tropical Storm,Keith,19,2000-10-03T09:00:00Z,PENSACOLA FL,0,0,0,4,4
Tropical Storm,Keith,19,2000-10-03T09:00:00Z,GULF 27N 96W,0,0,3,8,11
Tropical Storm,Keith,19,2000-10-03T09:00:00Z,MOBILE AL,0,0,0,4,4
Tropical Storm,Keith,19,2000-10-03T09:00:00Z,GULF 25N 96W,0,1,6,5,12
Tropical Depression,Keith,20,2000-10-03T15:00:00Z,19.1N  91.3W,53,0,0,0,53
Tropical Depression,Keith,20,2000-10-03T15:00:00Z,NEW IBERIA LA,0,0,0,3,3
Tropical Depression,Keith,20,2000-10-03T15:00:00Z,20.2N  92.4W,27,6,0,0,33
Tropical Depression,Keith,20,2000-10-03T15:00:00Z,PORT ARTHUR TX,0,0,0,5,5
Tropical Depression,Keith,20,2000-10-03T15:00:00Z,21.5N  93.5W,1,19,3,1,24
Tropical Depression,Keith,20,2000-10-03T15:00:00Z,GALVESTON TX,0,0,0,6,6
Tropical Depression,Keith,20,2000-10-03T15:00:00Z,MUAN 219N 850W,0,0,1,3,4
Tropical Depression,Keith,20,2000-10-03T15:00:00Z,FREEPORT TX,0,0,0,7,7
Tropical Depression,Keith,20,2000-10-03T15:00:00Z,MMCZ 205N 869W,0,4,3,2,9
Tropical Depression,Keith,20,2000-10-03T15:00:00Z,PORT O CONNOR TX,0,0,0,8,8
Tropical Depression,Keith,20,2000-10-03T15:00:00Z,MZBZ 175N 883W,21,0,0,0,21
Tropical Depression,Keith,20,2000-10-03T15:00:00Z,CORPUSCHRISTI TX,0,0,0,9,9
Tropical Depression,Keith,20,2000-10-03T15:00:00Z,MMSO 238N 982W,0,0,4,9,13
Tropical Depression,Keith,20,2000-10-03T15:00:00Z,BROWNSVILLE TX,0,0,1,11,12
Tropical Depression,Keith,20,2000-10-03T15:00:00Z,MMTM 222N 979W,0,1,7,5,13
Tropical Depression,Keith,20,2000-10-03T15:00:00Z,GULF 28N 89W,0,0,0,4,4
Tropical Depression,Keith,20,2000-10-03T15:00:00Z,MMTX 210N 974W,0,2,7,4,13
Tropical Depression,Keith,20,2000-10-03T15:00:00Z,GULF 28N 91W,0,0,0,6,6
Tropical Depression,Keith,20,2000-10-03T15:00:00Z,MMVR 192N 961W,0,3,4,3,10
Tropical Depression,Keith,20,2000-10-03T15:00:00Z,GULF 28N 93W,0,0,0,8,8
Tropical Depression,Keith,20,2000-10-03T15:00:00Z,MMFR 185N 926W,21,1,0,1,23
Tropical Depression,Keith,20,2000-10-03T15:00:00Z,GULF 28N 95W,0,0,0,9,9
Tropical Depression,Keith,20,2000-10-03T15:00:00Z,MMMD 210N 897W,12,8,1,1,22
Tropical Depression,Keith,20,2000-10-03T15:00:00Z,GULF 27N 96W,0,0,0,10,10
Tropical Depression,Keith,20,2000-10-03T15:00:00Z,BURAS LA,0,0,0,3,3
Tropical Depression,Keith,20,2000-10-03T15:00:00Z,GULF 25N 96W,0,0,3,11,14
Tropical Depression,Keith,20,2000-10-03T15:00:00Z,NEW ORLEANS LA,0,0,0,2,2
Tropical Depression,Keith,21,2000-10-03T21:00:00Z,19.3N  91.8W,49,0,0,0,49
Tropical Depression,Keith,21,2000-10-03T21:00:00Z,PORT ARTHUR TX,0,0,0,3,3
Tropical Depression,Keith,21,2000-10-03T21:00:00Z,20.0N  93.0W,27,3,1,0,31
Tropical Depression,Keith,21,2000-10-03T21:00:00Z,GALVESTON TX,0,0,0,4,4
Tropical Depression,Keith,21,2000-10-03T21:00:00Z,21.5N  95.0W,0,13,10,1,24
Tropical Depression,Keith,21,2000-10-03T21:00:00Z,FREEPORT TX,0,0,0,5,5
Tropical Depression,Keith,21,2000-10-03T21:00:00Z,MMCZ 205N 869W,0,2,2,1,5
Tropical Depression,Keith,21,2000-10-03T21:00:00Z,PORT O CONNOR TX,0,0,0,7,7
Tropical Depression,Keith,21,2000-10-03T21:00:00Z,MZBZ 175N 883W,1,0,1,1,3
Tropical Depression,Keith,21,2000-10-03T21:00:00Z,CORPUSCHRISTI TX,0,0,0,8,8
Tropical Depression,Keith,21,2000-10-03T21:00:00Z,MMSO 238N 982W,0,0,6,9,15
Tropical Depression,Keith,21,2000-10-03T21:00:00Z,BROWNSVILLE TX,0,0,1,11,12
Tropical Depression,Keith,21,2000-10-03T21:00:00Z,MMTM 222N 979W,0,1,11,5,17
Tropical Depression,Keith,21,2000-10-03T21:00:00Z,GULF 28N 89W,0,0,0,2,2
Tropical Depression,Keith,21,2000-10-03T21:00:00Z,MMTX 210N 974W,0,3,11,3,17
Tropical Depression,Keith,21,2000-10-03T21:00:00Z,GULF 28N 91W,0,0,0,3,3
Tropical Depression,Keith,21,2000-10-03T21:00:00Z,MMVR 192N 961W,0,7,5,2,14
Tropical Depression,Keith,21,2000-10-03T21:00:00Z,GULF 28N 93W,0,0,0,5,5
Tropical Depression,Keith,21,2000-10-03T21:00:00Z,MMFR 185N 926W,26,1,0,0,27
Tropical Depression,Keith,21,2000-10-03T21:00:00Z,GULF 28N 95W,0,0,0,7,7
Tropical Depression,Keith,21,2000-10-03T21:00:00Z,MMMD 210N 897W,11,5,2,1,19
Tropical Depression,Keith,21,2000-10-03T21:00:00Z,GULF 27N 96W,0,0,0,9,9
Tropical Depression,Keith,21,2000-10-03T21:00:00Z,NEW IBERIA LA,0,0,0,2,2
Tropical Depression,Keith,21,2000-10-03T21:00:00Z,GULF 25N 96W,0,0,4,10,14
Tropical Depression,Keith,22,2000-10-04T03:00:00Z,20.3N  92.8W,47,1,0,0,48
Tropical Depression,Keith,22,2000-10-04T03:00:00Z,GALVESTON TX,0,0,0,6,6
Tropical Depression,Keith,22,2000-10-04T03:00:00Z,21.3N  94.2W,22,6,0,1,29
Tropical Depression,Keith,22,2000-10-04T03:00:00Z,FREEPORT TX,0,0,0,7,7
Tropical Depression,Keith,22,2000-10-04T03:00:00Z,22.5N  96.0W,0,15,5,1,21
Tropical Depression,Keith,22,2000-10-04T03:00:00Z,PORT O CONNOR TX,0,0,1,8,9
Tropical Depression,Keith,22,2000-10-04T03:00:00Z,MMSO 238N 982W,0,2,11,4,17
Tropical Depression,Keith,22,2000-10-04T03:00:00Z,CORPUSCHRISTI TX,0,0,1,10,11
Tropical Depression,Keith,22,2000-10-04T03:00:00Z,MMTM 222N 979W,0,6,9,3,18
Tropical Depression,Keith,22,2000-10-04T03:00:00Z,BROWNSVILLE TX,0,0,7,8,15
Tropical Depression,Keith,22,2000-10-04T03:00:00Z,MMTX 210N 974W,0,8,6,2,16
Tropical Depression,Keith,22,2000-10-04T03:00:00Z,GULF 28N 91W,0,0,0,3,3
Tropical Depression,Keith,22,2000-10-04T03:00:00Z,MMVR 192N 961W,1,6,3,2,12
Tropical Depression,Keith,22,2000-10-04T03:00:00Z,GULF 28N 93W,0,0,0,6,6
Tropical Depression,Keith,22,2000-10-04T03:00:00Z,MMFR 185N 926W,20,1,0,0,21
Tropical Depression,Keith,22,2000-10-04T03:00:00Z,GULF 28N 95W,0,0,1,7,8
Tropical Depression,Keith,22,2000-10-04T03:00:00Z,MMMD 210N 897W,40,1,0,0,41
Tropical Depression,Keith,22,2000-10-04T03:00:00Z,GULF 27N 96W,0,0,3,9,12
Tropical Depression,Keith,22,2000-10-04T03:00:00Z,NEW IBERIA LA,0,0,0,2,2
Tropical Depression,Keith,22,2000-10-04T03:00:00Z,GULF 25N 96W,0,2,10,4,16
Tropical Depression,Keith,22,2000-10-04T03:00:00Z,PORT ARTHUR TX,0,0,0,4,4
Tropical Depression,Keith,23,2000-10-04T09:00:00Z,21.3N  94.5W,49,0,0,0,49
Tropical Depression,Keith,23,2000-10-04T09:00:00Z,GALVESTON TX,0,0,0,6,6
Tropical Depression,Keith,23,2000-10-04T09:00:00Z,22.4N  95.8W,20,10,0,1,31
Tropical Depression,Keith,23,2000-10-04T09:00:00Z,FREEPORT TX,0,0,0,7,7
Tropical Depression,Keith,23,2000-10-04T09:00:00Z,23.5N  97.0W,1,18,3,1,23
Tropical Depression,Keith,23,2000-10-04T09:00:00Z,PORT O CONNOR TX,0,0,0,9,9
Tropical Depression,Keith,23,2000-10-04T09:00:00Z,MMSO 238N 982W,0,12,6,2,20
Tropical Depression,Keith,23,2000-10-04T09:00:00Z,CORPUSCHRISTI TX,0,0,1,10,11
Tropical Depression,Keith,23,2000-10-04T09:00:00Z,MMTM 222N 979W,1,17,2,1,21
Tropical Depression,Keith,23,2000-10-04T09:00:00Z,BROWNSVILLE TX,0,0,9,6,15
Tropical Depression,Keith,23,2000-10-04T09:00:00Z,MMTX 210N 974W,4,10,2,1,17
Tropical Depression,Keith,23,2000-10-04T09:00:00Z,GULF 28N 89W,0,0,0,2,2
Tropical Depression,Keith,23,2000-10-04T09:00:00Z,MMVR 192N 961W,1,2,1,2,6
Tropical Depression,Keith,23,2000-10-04T09:00:00Z,GULF 28N 91W,0,0,0,3,3
Tropical Depression,Keith,23,2000-10-04T09:00:00Z,MMFR 185N 926W,46,0,1,0,47
Tropical Depression,Keith,23,2000-10-04T09:00:00Z,GULF 28N 93W,0,0,0,6,6
Tropical Depression,Keith,23,2000-10-04T09:00:00Z,MMMD 210N 897W,0,2,2,1,5
Tropical Depression,Keith,23,2000-10-04T09:00:00Z,GULF 28N 95W,0,0,0,9,9
Tropical Depression,Keith,23,2000-10-04T09:00:00Z,NEW IBERIA LA,0,0,0,2,2
Tropical Depression,Keith,23,2000-10-04T09:00:00Z,GULF 27N 96W,0,0,2,10,12
Tropical Depression,Keith,23,2000-10-04T09:00:00Z,PORT ARTHUR TX,0,0,0,4,4
Tropical Depression,Keith,23,2000-10-04T09:00:00Z,GULF 25N 96W,0,4,9,4,17
Tropical Depression,Keith,24,2000-10-04T15:00:00Z,21.9N  96.4W,45,0,0,0,45
Tropical Depression,Keith,24,2000-10-04T15:00:00Z,GALVESTON TX,0,0,1,7,8
Tropical Depression,Keith,24,2000-10-04T15:00:00Z,23.3N  97.8W,15,16,0,0,31
Tropical Depression,Keith,24,2000-10-04T15:00:00Z,FREEPORT TX,0,0,1,8,9
Tropical Depression,Keith,24,2000-10-04T15:00:00Z,25.0N  99.0W,0,18,6,1,25
Tropical Depression,Keith,24,2000-10-04T15:00:00Z,PORT O CONNOR TX,0,0,4,9,13
Tropical Depression,Keith,24,2000-10-04T15:00:00Z,MMSO 238N 982W,4,24,1,0,29
Tropical Depression,Keith,24,2000-10-04T15:00:00Z,CORPUSCHRISTI TX,0,0,9,7,16
Tropical Depression,Keith,24,2000-10-04T15:00:00Z,MMTM 222N 979W,20,8,0,0,28
Tropical Depression,Keith,24,2000-10-04T15:00:00Z,BROWNSVILLE TX,0,11,10,2,23
Tropical Depression,Keith,24,2000-10-04T15:00:00Z,MMTX 210N 974W,24,1,0,0,25
Tropical Depression,Keith,24,2000-10-04T15:00:00Z,GULF 28N 91W,0,0,0,3,3
Tropical Depression,Keith,24,2000-10-04T15:00:00Z,MMVR 192N 961W,12,0,0,1,13
Tropical Depression,Keith,24,2000-10-04T15:00:00Z,GULF 28N 93W,0,0,1,5,6
Tropical Depression,Keith,24,2000-10-04T15:00:00Z,MMFR 185N 926W,55,0,0,0,55
Tropical Depression,Keith,24,2000-10-04T15:00:00Z,GULF 28N 95W,0,0,3,8,11
Tropical Depression,Keith,24,2000-10-04T15:00:00Z,NEW IBERIA LA,0,0,0,2,2
Tropical Depression,Keith,24,2000-10-04T15:00:00Z,GULF 27N 96W,0,1,10,5,16
Tropical Depression,Keith,24,2000-10-04T15:00:00Z,PORT ARTHUR TX,0,0,0,5,5
Tropical Depression,Keith,24,2000-10-04T15:00:00Z,GULF 25N 96W,2,16,4,1,23
Tropical Storm,Keith,25,2000-10-04T21:00:00Z,22.2N  96.7W,43,0,0,0,43
Tropical Storm,Keith,25,2000-10-04T21:00:00Z,FREEPORT TX,0,0,2,7,9
Tropical Storm,Keith,25,2000-10-04T21:00:00Z,23.8N  98.0W,13,16,0,0,29
Tropical Storm,Keith,25,2000-10-04T21:00:00Z,PORT O CONNOR TX,0,0,6,7,13
Tropical Storm,Keith,25,2000-10-04T21:00:00Z,25.5N  99.5W,0,15,8,1,24
Tropical Storm,Keith,25,2000-10-04T21:00:00Z,CORPUSCHRISTI TX,0,1,10,5,16
Tropical Storm,Keith,25,2000-10-04T21:00:00Z,MMSO 238N 982W,10,17,1,0,28
Tropical Storm,Keith,25,2000-10-04T21:00:00Z,BROWNSVILLE TX,1,15,7,1,24
Tropical Storm,Keith,25,2000-10-04T21:00:00Z,MMTM 222N 979W,23,3,1,0,27
Tropical Storm,Keith,25,2000-10-04T21:00:00Z,GULF 28N 91W,0,0,0,3,3
Tropical Storm,Keith,25,2000-10-04T21:00:00Z,MMTX 210N 974W,24,1,0,0,25
Tropical Storm,Keith,25,2000-10-04T21:00:00Z,GULF 28N 93W,0,0,1,5,6
Tropical Storm,Keith,25,2000-10-04T21:00:00Z,MMVR 192N 961W,10,0,0,0,10
Tropical Storm,Keith,25,2000-10-04T21:00:00Z,GULF 28N 95W,0,0,5,6,11
Tropical Storm,Keith,25,2000-10-04T21:00:00Z,NEW IBERIA LA,0,0,0,2,2
Tropical Storm,Keith,25,2000-10-04T21:00:00Z,GULF 27N 96W,0,3,10,3,16
Tropical Storm,Keith,25,2000-10-04T21:00:00Z,PORT ARTHUR TX,0,0,0,5,5
Tropical Storm,Keith,25,2000-10-04T21:00:00Z,GULF 25N 96W,7,15,2,0,24
Tropical Storm,Keith,25,2000-10-04T21:00:00Z,GALVESTON TX,0,0,1,6,7
Tropical Storm,Keith,26,2000-10-05T03:00:00Z,23.0N  98.5W,41,1,0,0,42
Tropical Storm,Keith,26,2000-10-05T03:00:00Z,PORT O CONNOR TX,0,0,5,0,5
Tropical Storm,Keith,26,2000-10-05T03:00:00Z,24.3N  99.8W,15,14,0,0,29
Tropical Storm,Keith,26,2000-10-05T03:00:00Z,CORPUSCHRISTI TX,0,1,10,0,11
Tropical Storm,Keith,26,2000-10-05T03:00:00Z,26.0N 100.5W,1,19,4,0,24
Tropical Storm,Keith,26,2000-10-05T03:00:00Z,BROWNSVILLE TX,7,10,3,0,20
Tropical Storm,Keith,26,2000-10-05T03:00:00Z,MMSO 238N 982W,40,0,0,0,40
Tropical Storm,Keith,26,2000-10-05T03:00:00Z,GULF 28N 95W,0,0,3,0,3
Tropical Storm,Keith,26,2000-10-05T03:00:00Z,MMTM 222N 979W,53,0,0,0,53
Tropical Storm,Keith,26,2000-10-05T03:00:00Z,GULF 27N 96W,0,2,8,0,10
Tropical Storm,Keith,26,2000-10-05T03:00:00Z,MMTX 210N 974W,51,0,0,0,51
Tropical Storm,Keith,26,2000-10-05T03:00:00Z,GULF 25N 96W,11,5,2,0,18
Tropical Storm,Keith,26,2000-10-05T03:00:00Z,MMVR 192N 961W,17,0,0,0,17
Hurricane,Keith,27,2000-10-05T09:00:00Z,23.5N 100.5W,43,0,0,0,43
Hurricane,Keith,27,2000-10-05T09:00:00Z,MMTM 222N 979W,90,0,0,0,90
Hurricane,Keith,27,2000-10-05T09:00:00Z,25.0N 102.5W,1,27,0,0,28
Hurricane,Keith,27,2000-10-05T09:00:00Z,MMTX 210N 974W,99,0,0,0,99
Hurricane,Keith,27,2000-10-05T09:00:00Z,0.0N   0.0W,99,0,0,0,99
Hurricane,Keith,27,2000-10-05T09:00:00Z,BROWNSVILLE TX,3,6,0,0,9
Hurricane,Keith,27,2000-10-05T09:00:00Z,MMSO 238N 982W,46,0,0,0,46
Hurricane,Keith,28,2000-10-05T15:00:00Z,24.8N  99.8W,45,0,0,0,45
Hurricane,Keith,28,2000-10-05T15:00:00Z,MMTX 210N 974W,99,0,0,0,99
Hurricane,Keith,28,2000-10-05T15:00:00Z,26.5N 101.5W,6,21,0,0,27
Hurricane,Keith,28,2000-10-05T15:00:00Z,CORPUSCHRISTI TX,1,6,0,0,7
Hurricane,Keith,28,2000-10-05T15:00:00Z,0.0N   0.0W,99,0,0,0,99
Hurricane,Keith,28,2000-10-05T15:00:00Z,BROWNSVILLE TX,18,3,0,0,21
Hurricane,Keith,28,2000-10-05T15:00:00Z,MMSO 238N 982W,73,0,0,0,73
Hurricane,Keith,28,2000-10-05T15:00:00Z,GULF 27N 96W,0,2,0,0,2
Hurricane,Keith,28,2000-10-05T15:00:00Z,MMTM 222N 979W,99,0,0,0,99
Hurricane,Keith,28,2000-10-05T15:00:00Z,GULF 25N 96W,6,2,0,0,8
Subtropical Depression,One,1,2000-10-04T21:00:00Z,31.7N  78.2W,30,0,0,1,31
Subtropical Depression,One,1,2000-10-04T21:00:00Z,WILMINGTON NC,2,9,2,0,13
Subtropical Depression,One,1,2000-10-04T21:00:00Z,32.5N  75.9W,5,9,2,0,16
Subtropical Depression,One,1,2000-10-04T21:00:00Z,MOREHEAD CITY NC,1,8,3,1,13
Subtropical Depression,One,1,2000-10-04T21:00:00Z,33.0N  72.5W,0,3,6,3,12
Subtropical Depression,One,1,2000-10-04T21:00:00Z,CAPE HATTERAS NC,0,6,4,2,12
Subtropical Depression,One,1,2000-10-04T21:00:00Z,MBJT 215N 712W,0,0,0,2,2
Subtropical Depression,One,1,2000-10-04T21:00:00Z,NORFOLK VA,0,3,4,2,9
Subtropical Depression,One,1,2000-10-04T21:00:00Z,MYMM 224N 730W,0,0,1,1,2
Subtropical Depression,One,1,2000-10-04T21:00:00Z,OCEAN CITY MD,0,1,3,3,7
Subtropical Depression,One,1,2000-10-04T21:00:00Z,MYSM 241N 745W,0,0,2,2,4
Subtropical Depression,One,1,2000-10-04T21:00:00Z,ATLANTIC CITY NJ,0,0,2,3,5
Subtropical Depression,One,1,2000-10-04T21:00:00Z,MYEG 235N 758W,0,0,1,1,2
Subtropical Depression,One,1,2000-10-04T21:00:00Z,NEW YORK CITY NY,0,0,1,3,4
Subtropical Depression,One,1,2000-10-04T21:00:00Z,MYAK 241N 776W,0,0,1,1,2
Subtropical Depression,One,1,2000-10-04T21:00:00Z,MONTAUK POINT NY,0,0,1,3,4
Subtropical Depression,One,1,2000-10-04T21:00:00Z,MYNN 251N 775W,0,1,2,1,4
Subtropical Depression,One,1,2000-10-04T21:00:00Z,PROVIDENCE RI,0,0,0,4,4
Subtropical Depression,One,1,2000-10-04T21:00:00Z,MYGF 266N 787W,0,4,1,1,6
Subtropical Depression,One,1,2000-10-04T21:00:00Z,NANTUCKET MA,0,0,0,4,4
Subtropical Depression,One,1,2000-10-04T21:00:00Z,BERMUDA,0,0,0,7,7
Subtropical Depression,One,1,2000-10-04T21:00:00Z,HYANNIS MA,0,0,0,4,4
Subtropical Depression,One,1,2000-10-04T21:00:00Z,MIAMI FL,0,1,1,0,2
Subtropical Depression,One,1,2000-10-04T21:00:00Z,BOSTON MA,0,0,0,3,3
Subtropical Depression,One,1,2000-10-04T21:00:00Z,W PALM BEACH FL,0,3,1,0,4
Subtropical Depression,One,1,2000-10-04T21:00:00Z,PORTLAND ME,0,0,0,2,2
Subtropical Depression,One,1,2000-10-04T21:00:00Z,FT PIERCE FL,2,4,0,0,6
Subtropical Depression,One,1,2000-10-04T21:00:00Z,BAR HARBOR ME,0,0,0,2,2
Subtropical Depression,One,1,2000-10-04T21:00:00Z,COCOA BEACH FL,11,1,0,1,13
Subtropical Depression,One,1,2000-10-04T21:00:00Z,EASTPORT ME,0,0,0,2,2
Subtropical Depression,One,1,2000-10-04T21:00:00Z,DAYTONA BEACH FL,99,0,0,0,99
Subtropical Depression,One,1,2000-10-04T21:00:00Z,YARMOUTH NS,0,0,0,2,2
Subtropical Depression,One,1,2000-10-04T21:00:00Z,JACKSONVILLE FL,99,0,0,0,99
Subtropical Depression,One,1,2000-10-04T21:00:00Z,TAMPA FL,1,1,0,0,2
Subtropical Depression,One,1,2000-10-04T21:00:00Z,SAVANNAH GA,23,1,0,0,24
Subtropical Depression,One,1,2000-10-04T21:00:00Z,CEDAR KEY FL,2,1,1,0,4
Subtropical Depression,One,1,2000-10-04T21:00:00Z,CHARLESTON SC,15,3,0,0,18
Subtropical Depression,One,1,2000-10-04T21:00:00Z,ST MARKS FL,1,1,0,0,2
Subtropical Depression,One,1,2000-10-04T21:00:00Z,MYRTLE BEACH SC,6,8,1,0,15
Subtropical Depression,One,2,2000-10-05T03:00:00Z,30.6N  76.3W,29,0,0,0,29
Subtropical Depression,One,2,2000-10-05T03:00:00Z,FT PIERCE FL,2,4,0,1,7
Subtropical Depression,One,2,2000-10-05T03:00:00Z,31.1N  73.5W,3,12,1,1,17
Subtropical Depression,One,2,2000-10-05T03:00:00Z,COCOA BEACH FL,4,3,0,1,8
Subtropical Depression,One,2,2000-10-05T03:00:00Z,31.5N  70.0W,0,4,6,3,13
Subtropical Depression,One,2,2000-10-05T03:00:00Z,DAYTONA BEACH FL,13,0,0,1,14
Subtropical Depression,One,2,2000-10-05T03:00:00Z,MBJT 215N 712W,0,0,0,2,2
Subtropical Depression,One,2,2000-10-05T03:00:00Z,JACKSONVILLE FL,2,2,0,0,4
Subtropical Depression,One,2,2000-10-05T03:00:00Z,MYMM 224N 730W,0,0,1,2,3
Subtropical Depression,One,2,2000-10-05T03:00:00Z,SAVANNAH GA,6,1,0,0,7
Subtropical Depression,One,2,2000-10-05T03:00:00Z,MYSM 241N 745W,0,1,3,2,6
Subtropical Depression,One,2,2000-10-05T03:00:00Z,CHARLESTON SC,4,2,0,1,7
Subtropical Depression,One,2,2000-10-05T03:00:00Z,MYEG 235N 758W,0,1,2,1,4
Subtropical Depression,One,2,2000-10-05T03:00:00Z,MYRTLE BEACH SC,1,3,1,0,5
Subtropical Depression,One,2,2000-10-05T03:00:00Z,MYAK 241N 776W,0,1,2,1,4
Subtropical Depression,One,2,2000-10-05T03:00:00Z,WILMINGTON NC,0,3,2,0,5
Subtropical Depression,One,2,2000-10-05T03:00:00Z,MYNN 251N 775W,0,3,2,1,6
Subtropical Depression,One,2,2000-10-05T03:00:00Z,MOREHEAD CITY NC,0,4,1,1,6
Subtropical Depression,One,2,2000-10-05T03:00:00Z,MYGF 266N 787W,3,5,1,0,9
Subtropical Depression,One,2,2000-10-05T03:00:00Z,CAPE HATTERAS NC,0,3,2,1,6
Subtropical Depression,One,2,2000-10-05T03:00:00Z,BERMUDA,0,0,2,7,9
Subtropical Depression,One,2,2000-10-05T03:00:00Z,NORFOLK VA,0,0,1,1,2
Subtropical Depression,One,2,2000-10-05T03:00:00Z,MIAMI FL,0,2,1,0,3
Subtropical Depression,One,2,2000-10-05T03:00:00Z,OCEAN CITY MD,0,0,1,1,2
Subtropical Depression,One,2,2000-10-05T03:00:00Z,W PALM BEACH FL,1,3,1,0,5
Subtropical Depression,One,2,2000-10-05T03:00:00Z,NANTUCKET MA,0,0,0,2,2
Subtropical Depression,One,3,2000-10-05T09:00:00Z,30.5N  73.5W,29,1,0,0,30
Subtropical Depression,One,3,2000-10-05T09:00:00Z,MYNN 251N 775W,0,1,1,1,3
Subtropical Depression,One,3,2000-10-05T09:00:00Z,31.0N  71.0W,4,12,1,1,18
Subtropical Depression,One,3,2000-10-05T09:00:00Z,MYGF 266N 787W,0,1,2,0,3
Subtropical Depression,One,3,2000-10-05T09:00:00Z,32.0N  68.5W,0,7,5,3,15
Subtropical Depression,One,3,2000-10-05T09:00:00Z,BERMUDA,0,1,4,6,11
Subtropical Depression,One,3,2000-10-05T09:00:00Z,MYSM 241N 745W,0,1,1,2,4
Subtropical Depression,One,3,2000-10-05T09:00:00Z,MOREHEAD CITY NC,0,0,1,1,2
Subtropical Depression,One,3,2000-10-05T09:00:00Z,MYEG 235N 758W,0,0,1,1,2
Subtropical Depression,One,3,2000-10-05T09:00:00Z,CAPE HATTERAS NC,0,0,1,1,2
Subtropical Depression,One,3,2000-10-05T09:00:00Z,MYAK 241N 776W,0,0,1,1,2
Tropical Storm,Leslie,4,2000-10-05T15:00:00Z,31.6N  70.8W,26,0,1,0,27
Tropical Storm,Leslie,4,2000-10-05T15:00:00Z,BAR HARBOR ME,0,0,0,3,3
Tropical Storm,Leslie,4,2000-10-05T15:00:00Z,32.8N  68.1W,1,12,2,1,16
Tropical Storm,Leslie,4,2000-10-05T15:00:00Z,EASTPORT ME,0,0,0,3,3
Tropical Storm,Leslie,4,2000-10-05T15:00:00Z,34.5N  65.0W,0,5,5,3,13
Tropical Storm,Leslie,4,2000-10-05T15:00:00Z,ST JOHN NB,0,0,0,3,3
Tropical Storm,Leslie,4,2000-10-05T15:00:00Z,BERMUDA,0,6,5,2,13
Tropical Storm,Leslie,4,2000-10-05T15:00:00Z,MONCTON NB,0,0,0,3,3
Tropical Storm,Leslie,4,2000-10-05T15:00:00Z,MOREHEAD CITY NC,0,0,1,1,2
Tropical Storm,Leslie,4,2000-10-05T15:00:00Z,YARMOUTH NS,0,0,0,5,5
Tropical Storm,Leslie,4,2000-10-05T15:00:00Z,CAPE HATTERAS NC,0,1,1,1,3
Tropical Storm,Leslie,4,2000-10-05T15:00:00Z,HALIFAX NS,0,0,0,5,5
Tropical Storm,Leslie,4,2000-10-05T15:00:00Z,MONTAUK POINT NY,0,0,0,2,2
Tropical Storm,Leslie,4,2000-10-05T15:00:00Z,SABLE ISLAND NS,0,0,0,6,6
Tropical Storm,Leslie,4,2000-10-05T15:00:00Z,PROVIDENCE RI,0,0,0,2,2
Tropical Storm,Leslie,4,2000-10-05T15:00:00Z,SYDNEY NS,0,0,0,3,3
Tropical Storm,Leslie,4,2000-10-05T15:00:00Z,NANTUCKET MA,0,0,0,4,4
Tropical Storm,Leslie,4,2000-10-05T15:00:00Z,EDDY POINT NS,0,0,0,4,4
Tropical Storm,Leslie,4,2000-10-05T15:00:00Z,HYANNIS MA,0,0,0,3,3
Tropical Storm,Leslie,4,2000-10-05T15:00:00Z,PTX BASQUES NFLD,0,0,0,2,2
Tropical Storm,Leslie,4,2000-10-05T15:00:00Z,BOSTON MA,0,0,0,2,2
Tropical Storm,Leslie,4,2000-10-05T15:00:00Z,BURGEO NFLD,0,0,0,2,2
Tropical Storm,Leslie,4,2000-10-05T15:00:00Z,PORTLAND ME,0,0,0,2,2
Tropical Storm,Leslie,4,2000-10-05T15:00:00Z,ILE ST PIERRE,0,0,0,2,2
Tropical Storm,Leslie,5,2000-10-05T21:00:00Z,30.6N  71.1W,28,1,0,0,29
Tropical Storm,Leslie,5,2000-10-05T21:00:00Z,HALIFAX NS,0,0,0,4,4
Tropical Storm,Leslie,5,2000-10-05T21:00:00Z,31.8N  68.2W,2,13,2,1,18
Tropical Storm,Leslie,5,2000-10-05T21:00:00Z,SABLE ISLAND NS,0,0,0,6,6
Tropical Storm,Leslie,5,2000-10-05T21:00:00Z,34.5N  64.0W,0,2,8,3,13
Tropical Storm,Leslie,5,2000-10-05T21:00:00Z,SYDNEY NS,0,0,0,3,3
Tropical Storm,Leslie,5,2000-10-05T21:00:00Z,BERMUDA,0,5,8,1,14
Tropical Storm,Leslie,5,2000-10-05T21:00:00Z,EDDY POINT NS,0,0,0,4,4
Tropical Storm,Leslie,5,2000-10-05T21:00:00Z,NANTUCKET MA,0,0,0,2,2
Tropical Storm,Leslie,5,2000-10-05T21:00:00Z,PTX BASQUES NFLD,0,0,0,2,2
Tropical Storm,Leslie,5,2000-10-05T21:00:00Z,HYANNIS MA,0,0,0,2,2
Tropical Storm,Leslie,5,2000-10-05T21:00:00Z,BURGEO NFLD,0,0,0,3,3
Tropical Storm,Leslie,5,2000-10-05T21:00:00Z,EASTPORT ME,0,0,0,2,2
Tropical Storm,Leslie,5,2000-10-05T21:00:00Z,ILE ST PIERRE,0,0,0,4,4
Tropical Storm,Leslie,5,2000-10-05T21:00:00Z,ST JOHN NB,0,0,0,2,2
Tropical Storm,Leslie,5,2000-10-05T21:00:00Z,CAPE RACE NFLD,0,0,0,4,4
Tropical Storm,Leslie,5,2000-10-05T21:00:00Z,MONCTON NB,0,0,0,2,2
Tropical Storm,Leslie,5,2000-10-05T21:00:00Z,HIBERNIA OILFLD,0,0,0,2,2
Tropical Storm,Leslie,5,2000-10-05T21:00:00Z,YARMOUTH NS,0,0,0,3,3
Tropical Storm,Leslie,6,2000-10-06T03:00:00Z,31.7N  69.1W,27,1,0,0,28
Tropical Storm,Leslie,6,2000-10-06T03:00:00Z,ST JOHN NB,0,0,0,4,4
Tropical Storm,Leslie,6,2000-10-06T03:00:00Z,33.5N  66.2W,1,12,2,1,16
Tropical Storm,Leslie,6,2000-10-06T03:00:00Z,MONCTON NB,0,0,0,5,5
Tropical Storm,Leslie,6,2000-10-06T03:00:00Z,36.5N  62.5W,0,3,7,3,13
Tropical Storm,Leslie,6,2000-10-06T03:00:00Z,YARMOUTH NS,0,0,0,5,5
Tropical Storm,Leslie,6,2000-10-06T03:00:00Z,BERMUDA,0,11,3,0,14
Tropical Storm,Leslie,6,2000-10-06T03:00:00Z,HALIFAX NS,0,0,0,7,7
Tropical Storm,Leslie,6,2000-10-06T03:00:00Z,MONTAUK POINT NY,0,0,0,2,2
Tropical Storm,Leslie,6,2000-10-06T03:00:00Z,SABLE ISLAND NS,0,0,0,10,10
Tropical Storm,Leslie,6,2000-10-06T03:00:00Z,PROVIDENCE RI,0,0,0,2,2
Tropical Storm,Leslie,6,2000-10-06T03:00:00Z,SYDNEY NS,0,0,0,8,8
Tropical Storm,Leslie,6,2000-10-06T03:00:00Z,NANTUCKET MA,0,0,1,2,3
Tropical Storm,Leslie,6,2000-10-06T03:00:00Z,EDDY POINT NS,0,0,0,8,8
Tropical Storm,Leslie,6,2000-10-06T03:00:00Z,HYANNIS MA,0,0,0,3,3
Tropical Storm,Leslie,6,2000-10-06T03:00:00Z,PTX BASQUES NFLD,0,0,0,7,7
Tropical Storm,Leslie,6,2000-10-06T03:00:00Z,BOSTON MA,0,0,0,2,2
Tropical Storm,Leslie,6,2000-10-06T03:00:00Z,BURGEO NFLD,0,0,0,7,7
Tropical Storm,Leslie,6,2000-10-06T03:00:00Z,PORTLAND ME,0,0,0,2,2
Tropical Storm,Leslie,6,2000-10-06T03:00:00Z,ILE ST PIERRE,0,0,0,8,8
Tropical Storm,Leslie,6,2000-10-06T03:00:00Z,BAR HARBOR ME,0,0,0,3,3
Tropical Storm,Leslie,6,2000-10-06T03:00:00Z,CAPE RACE NFLD,0,0,0,8,8
Tropical Storm,Leslie,6,2000-10-06T03:00:00Z,EASTPORT ME,0,0,0,4,4
Tropical Storm,Leslie,6,2000-10-06T03:00:00Z,HIBERNIA OILFLD,0,0,0,5,5
Tropical Storm,Leslie,7,2000-10-06T09:00:00Z,33.0N  65.5W,24,7,0,0,31
Tropical Storm,Leslie,7,2000-10-06T09:00:00Z,SYDNEY NS,0,0,2,5,7
Tropical Storm,Leslie,7,2000-10-06T09:00:00Z,36.5N  61.5W,0,14,6,1,21
Tropical Storm,Leslie,7,2000-10-06T09:00:00Z,EDDY POINT NS,0,0,2,4,6
Tropical Storm,Leslie,7,2000-10-06T09:00:00Z,42.0N  56.5W,0,0,9,5,14
Tropical Storm,Leslie,7,2000-10-06T09:00:00Z,PTX BASQUES NFLD,0,0,1,6,7
Tropical Storm,Leslie,7,2000-10-06T09:00:00Z,BERMUDA,21,8,0,0,29
Tropical Storm,Leslie,7,2000-10-06T09:00:00Z,BURGEO NFLD,0,0,1,8,9
Tropical Storm,Leslie,7,2000-10-06T09:00:00Z,MONCTON NB,0,0,0,2,2
Tropical Storm,Leslie,7,2000-10-06T09:00:00Z,ILE ST PIERRE,0,0,2,9,11
Tropical Storm,Leslie,7,2000-10-06T09:00:00Z,HALIFAX NS,0,0,1,2,3
Tropical Storm,Leslie,7,2000-10-06T09:00:00Z,CAPE RACE NFLD,0,0,2,10,12
Tropical Storm,Leslie,7,2000-10-06T09:00:00Z,SABLE ISLAND NS,0,0,6,4,10
Tropical Storm,Leslie,7,2000-10-06T09:00:00Z,HIBERNIA OILFLD,0,0,0,11,11
Tropical Storm,Leslie,8,2000-10-06T15:00:00Z,33.5N  67.0W,26,7,0,0,33
Tropical Storm,Leslie,8,2000-10-06T15:00:00Z,HALIFAX NS,0,0,4,4,8
Tropical Storm,Leslie,8,2000-10-06T15:00:00Z,37.5N  62.5W,0,12,5,1,18
Tropical Storm,Leslie,8,2000-10-06T15:00:00Z,SABLE ISLAND NS,0,0,7,5,12
Tropical Storm,Leslie,8,2000-10-06T15:00:00Z,43.0N  58.0W,0,0,9,4,13
Tropical Storm,Leslie,8,2000-10-06T15:00:00Z,SYDNEY NS,0,0,3,7,10
Tropical Storm,Leslie,8,2000-10-06T15:00:00Z,BERMUDA,5,16,0,0,21
Tropical Storm,Leslie,8,2000-10-06T15:00:00Z,EDDY POINT NS,0,0,4,6,10
Tropical Storm,Leslie,8,2000-10-06T15:00:00Z,BAR HARBOR ME,0,0,1,1,2
Tropical Storm,Leslie,8,2000-10-06T15:00:00Z,PTX BASQUES NFLD,0,0,2,8,10
Tropical Storm,Leslie,8,2000-10-06T15:00:00Z,EASTPORT ME,0,0,1,2,3
Tropical Storm,Leslie,8,2000-10-06T15:00:00Z,BURGEO NFLD,0,0,2,9,11
Tropical Storm,Leslie,8,2000-10-06T15:00:00Z,ST JOHN NB,0,0,1,3,4
Tropical Storm,Leslie,8,2000-10-06T15:00:00Z,ILE ST PIERRE,0,0,3,9,12
Tropical Storm,Leslie,8,2000-10-06T15:00:00Z,MONCTON NB,0,0,1,4,5
Tropical Storm,Leslie,8,2000-10-06T15:00:00Z,CAPE RACE NFLD,0,0,2,10,12
Tropical Storm,Leslie,8,2000-10-06T15:00:00Z,YARMOUTH NS,0,0,2,2,4
Tropical Storm,Leslie,8,2000-10-06T15:00:00Z,HIBERNIA OILFLD,0,0,0,9,9
Tropical Depression,Seventeen,1,2000-10-17T03:00:00Z,30.8N  70.4W,99,0,0,0,99
Tropical Depression,Seventeen,1,2000-10-17T03:00:00Z,BOSTON MA,0,0,0,7,7
Tropical Depression,Seventeen,1,2000-10-17T03:00:00Z,32.0N  70.3W,20,2,1,0,23
Tropical Depression,Seventeen,1,2000-10-17T03:00:00Z,PORTLAND ME,0,0,0,6,6
Tropical Depression,Seventeen,1,2000-10-17T03:00:00Z,34.5N  69.0W,0,9,5,2,16
Tropical Depression,Seventeen,1,2000-10-17T03:00:00Z,BAR HARBOR ME,0,0,0,7,7
Tropical Depression,Seventeen,1,2000-10-17T03:00:00Z,BERMUDA,0,2,2,5,9
Tropical Depression,Seventeen,1,2000-10-17T03:00:00Z,EASTPORT ME,0,0,0,7,7
Tropical Depression,Seventeen,1,2000-10-17T03:00:00Z,MYRTLE BEACH SC,0,0,1,1,2
Tropical Depression,Seventeen,1,2000-10-17T03:00:00Z,ST JOHN NB,0,0,0,7,7
Tropical Depression,Seventeen,1,2000-10-17T03:00:00Z,WILMINGTON NC,0,0,1,2,3
Tropical Depression,Seventeen,1,2000-10-17T03:00:00Z,MONCTON NB,0,0,0,6,6
Tropical Depression,Seventeen,1,2000-10-17T03:00:00Z,MOREHEAD CITY NC,0,0,3,2,5
Tropical Depression,Seventeen,1,2000-10-17T03:00:00Z,YARMOUTH NS,0,0,0,9,9
Tropical Depression,Seventeen,1,2000-10-17T03:00:00Z,CAPE HATTERAS NC,0,1,3,4,8
Tropical Depression,Seventeen,1,2000-10-17T03:00:00Z,HALIFAX NS,0,0,0,9,9
Tropical Depression,Seventeen,1,2000-10-17T03:00:00Z,NORFOLK VA,0,0,1,3,4
Tropical Depression,Seventeen,1,2000-10-17T03:00:00Z,SABLE ISLAND NS,0,0,0,9,9
Tropical Depression,Seventeen,1,2000-10-17T03:00:00Z,OCEAN CITY MD,0,0,1,4,5
Tropical Depression,Seventeen,1,2000-10-17T03:00:00Z,SYDNEY NS,0,0,0,7,7
Tropical Depression,Seventeen,1,2000-10-17T03:00:00Z,ATLANTIC CITY NJ,0,0,1,4,5
Tropical Depression,Seventeen,1,2000-10-17T03:00:00Z,EDDY POINT NS,0,0,0,8,8
Tropical Depression,Seventeen,1,2000-10-17T03:00:00Z,NEW YORK CITY NY,0,0,0,5,5
Tropical Depression,Seventeen,1,2000-10-17T03:00:00Z,PTX BASQUES NFLD,0,0,0,5,5
Tropical Depression,Seventeen,1,2000-10-17T03:00:00Z,MONTAUK POINT NY,0,0,1,6,7
Tropical Depression,Seventeen,1,2000-10-17T03:00:00Z,BURGEO NFLD,0,0,0,5,5
Tropical Depression,Seventeen,1,2000-10-17T03:00:00Z,PROVIDENCE RI,0,0,0,7,7
Tropical Depression,Seventeen,1,2000-10-17T03:00:00Z,ILE ST PIERRE,0,0,0,6,6
Tropical Depression,Seventeen,1,2000-10-17T03:00:00Z,NANTUCKET MA,0,0,1,8,9
Tropical Depression,Seventeen,1,2000-10-17T03:00:00Z,CAPE RACE NFLD,0,0,0,4,4
Tropical Depression,Seventeen,1,2000-10-17T03:00:00Z,HYANNIS MA,0,0,1,7,8
Tropical Depression,Seventeen,1,2000-10-17T03:00:00Z,HIBERNIA OILFLD,0,0,0,2,2
Tropical Storm,Michael,2,2000-10-17T09:00:00Z,31.1N  70.2W,49,0,0,0,49
Tropical Storm,Michael,2,2000-10-17T09:00:00Z,BOSTON MA,0,0,1,6,7
Tropical Storm,Michael,2,2000-10-17T09:00:00Z,33.2N  69.5W,9,11,1,0,21
Tropical Storm,Michael,2,2000-10-17T09:00:00Z,PORTLAND ME,0,0,0,6,6
Tropical Storm,Michael,2,2000-10-17T09:00:00Z,35.5N  67.5W,0,9,5,2,16
Tropical Storm,Michael,2,2000-10-17T09:00:00Z,BAR HARBOR ME,0,0,0,7,7
Tropical Storm,Michael,2,2000-10-17T09:00:00Z,BERMUDA,0,4,4,2,10
Tropical Storm,Michael,2,2000-10-17T09:00:00Z,EASTPORT ME,0,0,0,8,8
Tropical Storm,Michael,2,2000-10-17T09:00:00Z,MYRTLE BEACH SC,0,0,1,1,2
Tropical Storm,Michael,2,2000-10-17T09:00:00Z,ST JOHN NB,0,0,0,8,8
Tropical Storm,Michael,2,2000-10-17T09:00:00Z,WILMINGTON NC,0,0,2,2,4
Tropical Storm,Michael,2,2000-10-17T09:00:00Z,MONCTON NB,0,0,0,7,7
Tropical Storm,Michael,2,2000-10-17T09:00:00Z,MOREHEAD CITY NC,0,1,3,2,6
Tropical Storm,Michael,2,2000-10-17T09:00:00Z,YARMOUTH NS,0,0,1,9,10
Tropical Storm,Michael,2,2000-10-17T09:00:00Z,CAPE HATTERAS NC,0,1,5,2,8
Tropical Storm,Michael,2,2000-10-17T09:00:00Z,HALIFAX NS,0,0,0,10,10
Tropical Storm,Michael,2,2000-10-17T09:00:00Z,NORFOLK VA,0,0,3,2,5
Tropical Storm,Michael,2,2000-10-17T09:00:00Z,SABLE ISLAND NS,0,0,0,11,11
Tropical Storm,Michael,2,2000-10-17T09:00:00Z,OCEAN CITY MD,0,0,2,4,6
Tropical Storm,Michael,2,2000-10-17T09:00:00Z,SYDNEY NS,0,0,0,9,9
Tropical Storm,Michael,2,2000-10-17T09:00:00Z,ATLANTIC CITY NJ,0,0,2,4,6
Tropical Storm,Michael,2,2000-10-17T09:00:00Z,EDDY POINT NS,0,0,0,10,10
Tropical Storm,Michael,2,2000-10-17T09:00:00Z,NEW YORK CITY NY,0,0,1,5,6
Tropical Storm,Michael,2,2000-10-17T09:00:00Z,PTX BASQUES NFLD,0,0,0,7,7
Tropical Storm,Michael,2,2000-10-17T09:00:00Z,MONTAUK POINT NY,0,0,2,6,8
Tropical Storm,Michael,2,2000-10-17T09:00:00Z,BURGEO NFLD,0,0,0,7,7
Tropical Storm,Michael,2,2000-10-17T09:00:00Z,PROVIDENCE RI,0,0,1,6,7
Tropical Storm,Michael,2,2000-10-17T09:00:00Z,ILE ST PIERRE,0,0,0,8,8
Tropical Storm,Michael,2,2000-10-17T09:00:00Z,NANTUCKET MA,0,0,2,8,10
Tropical Storm,Michael,2,2000-10-17T09:00:00Z,CAPE RACE NFLD,0,0,0,6,6
Tropical Storm,Michael,2,2000-10-17T09:00:00Z,HYANNIS MA,0,0,2,7,9
Tropical Storm,Michael,2,2000-10-17T09:00:00Z,HIBERNIA OILFLD,0,0,0,3,3
Tropical Storm,Michael,3,2000-10-17T15:00:00Z,32.0N  70.0W,41,0,0,1,42
Tropical Storm,Michael,3,2000-10-17T15:00:00Z,BOSTON MA,0,0,3,6,9
Tropical Storm,Michael,3,2000-10-17T15:00:00Z,34.0N  69.0W,14,7,2,0,23
Tropical Storm,Michael,3,2000-10-17T15:00:00Z,PORTLAND ME,0,0,2,7,9
Tropical Storm,Michael,3,2000-10-17T15:00:00Z,38.0N  66.0W,0,4,11,2,17
Tropical Storm,Michael,3,2000-10-17T15:00:00Z,BAR HARBOR ME,0,0,2,8,10
Tropical Storm,Michael,3,2000-10-17T15:00:00Z,BERMUDA,0,3,5,2,10
Tropical Storm,Michael,3,2000-10-17T15:00:00Z,EASTPORT ME,0,0,2,8,10
Tropical Storm,Michael,3,2000-10-17T15:00:00Z,WILMINGTON NC,0,0,1,1,2
Tropical Storm,Michael,3,2000-10-17T15:00:00Z,ST JOHN NB,0,0,2,9,11
Tropical Storm,Michael,3,2000-10-17T15:00:00Z,MOREHEAD CITY NC,0,1,1,1,3
Tropical Storm,Michael,3,2000-10-17T15:00:00Z,MONCTON NB,0,0,1,9,10
Tropical Storm,Michael,3,2000-10-17T15:00:00Z,CAPE HATTERAS NC,0,1,4,1,6
Tropical Storm,Michael,3,2000-10-17T15:00:00Z,YARMOUTH NS,0,0,3,9,12
Tropical Storm,Michael,3,2000-10-17T15:00:00Z,NORFOLK VA,0,0,2,2,4
Tropical Storm,Michael,3,2000-10-17T15:00:00Z,HALIFAX NS,0,0,2,10,12
Tropical Storm,Michael,3,2000-10-17T15:00:00Z,OCEAN CITY MD,0,0,3,2,5
Tropical Storm,Michael,3,2000-10-17T15:00:00Z,SABLE ISLAND NS,0,0,1,9,10
Tropical Storm,Michael,3,2000-10-17T15:00:00Z,ATLANTIC CITY NJ,0,0,2,4,6
Tropical Storm,Michael,3,2000-10-17T15:00:00Z,SYDNEY NS,0,0,0,10,10
Tropical Storm,Michael,3,2000-10-17T15:00:00Z,NEW YORK CITY NY,0,0,2,4,6
Tropical Storm,Michael,3,2000-10-17T15:00:00Z,EDDY POINT NS,0,0,1,10,11
Tropical Storm,Michael,3,2000-10-17T15:00:00Z,MONTAUK POINT NY,0,0,4,5,9
Tropical Storm,Michael,3,2000-10-17T15:00:00Z,PTX BASQUES NFLD,0,0,0,9,9
Tropical Storm,Michael,3,2000-10-17T15:00:00Z,PROVIDENCE RI,0,0,4,5,9
Tropical Storm,Michael,3,2000-10-17T15:00:00Z,BURGEO NFLD,0,0,0,8,8
Tropical Storm,Michael,3,2000-10-17T15:00:00Z,NANTUCKET MA,0,0,6,5,11
Tropical Storm,Michael,3,2000-10-17T15:00:00Z,ILE ST PIERRE,0,0,0,7,7
Tropical Storm,Michael,3,2000-10-17T15:00:00Z,HYANNIS MA,0,0,5,5,10
Tropical Storm,Michael,3,2000-10-17T15:00:00Z,CAPE RACE NFLD,0,0,0,4,4
Hurricane,Michael,4,2000-10-17T21:00:00Z,32.2N  69.8W,41,0,0,0,41
Hurricane,Michael,4,2000-10-17T21:00:00Z,ST JOHN NB,0,0,1,9,10
Hurricane,Michael,4,2000-10-17T21:00:00Z,34.5N  68.0W,4,18,6,0,28
Hurricane,Michael,4,2000-10-17T21:00:00Z,MONCTON NB,0,0,0,10,10
Hurricane,Michael,4,2000-10-17T21:00:00Z,39.0N  64.0W,0,0,11,5,16
Hurricane,Michael,4,2000-10-17T21:00:00Z,YARMOUTH NS,0,0,2,9,11
Hurricane,Michael,4,2000-10-17T21:00:00Z,BERMUDA,0,3,8,1,12
Hurricane,Michael,4,2000-10-17T21:00:00Z,HALIFAX NS,0,0,1,11,12
Hurricane,Michael,4,2000-10-17T21:00:00Z,MONTAUK POINT NY,0,0,2,1,3
Hurricane,Michael,4,2000-10-17T21:00:00Z,SABLE ISLAND NS,0,0,0,12,12
Hurricane,Michael,4,2000-10-17T21:00:00Z,PROVIDENCE RI,0,0,2,2,4
Hurricane,Michael,4,2000-10-17T21:00:00Z,SYDNEY NS,0,0,0,11,11
Hurricane,Michael,4,2000-10-17T21:00:00Z,NANTUCKET MA,0,0,4,3,7
Hurricane,Michael,4,2000-10-17T21:00:00Z,EDDY POINT NS,0,0,0,11,11
Hurricane,Michael,4,2000-10-17T21:00:00Z,HYANNIS MA,0,0,3,3,6
Hurricane,Michael,4,2000-10-17T21:00:00Z,PTX BASQUES NFLD,0,0,0,10,10
Hurricane,Michael,4,2000-10-17T21:00:00Z,BOSTON MA,0,0,2,2,4
Hurricane,Michael,4,2000-10-17T21:00:00Z,BURGEO NFLD,0,0,0,9,9
Hurricane,Michael,4,2000-10-17T21:00:00Z,PORTLAND ME,0,0,1,4,5
Hurricane,Michael,4,2000-10-17T21:00:00Z,ILE ST PIERRE,0,0,0,9,9
Hurricane,Michael,4,2000-10-17T21:00:00Z,BAR HARBOR ME,0,0,1,7,8
Hurricane,Michael,4,2000-10-17T21:00:00Z,CAPE RACE NFLD,0,0,0,6,6
Hurricane,Michael,4,2000-10-17T21:00:00Z,EASTPORT ME,0,0,1,8,9
Hurricane,Michael,4,2000-10-17T21:00:00Z,HIBERNIA OILFLD,0,0,0,2,2
Hurricane,Michael,5,2000-10-18T03:00:00Z,33.0N  69.2W,43,0,0,0,43
Hurricane,Michael,5,2000-10-18T03:00:00Z,EASTPORT ME,0,0,4,0,4
Hurricane,Michael,5,2000-10-18T03:00:00Z,36.5N  65.7W,0,19,5,0,24
Hurricane,Michael,5,2000-10-18T03:00:00Z,ST JOHN NB,0,0,4,0,4
Hurricane,Michael,5,2000-10-18T03:00:00Z,41.5N  60.5W,0,0,11,0,11
Hurricane,Michael,5,2000-10-18T03:00:00Z,MONCTON NB,0,0,4,0,4
Hurricane,Michael,5,2000-10-18T03:00:00Z,BERMUDA,0,7,3,0,10
Hurricane,Michael,5,2000-10-18T03:00:00Z,YARMOUTH NS,0,0,7,0,7
Hurricane,Michael,5,2000-10-18T03:00:00Z,PROVIDENCE RI,0,0,2,0,2
Hurricane,Michael,5,2000-10-18T03:00:00Z,HALIFAX NS,0,0,7,0,7
Hurricane,Michael,5,2000-10-18T03:00:00Z,NANTUCKET MA,0,1,3,0,4
Hurricane,Michael,5,2000-10-18T03:00:00Z,SABLE ISLAND NS,0,0,7,0,7
Hurricane,Michael,5,2000-10-18T03:00:00Z,HYANNIS MA,0,1,2,0,3
Hurricane,Michael,5,2000-10-18T03:00:00Z,SYDNEY NS,0,0,3,0,3
Hurricane,Michael,5,2000-10-18T03:00:00Z,BOSTON MA,0,0,2,0,2
Hurricane,Michael,5,2000-10-18T03:00:00Z,EDDY POINT NS,0,0,5,0,5
Hurricane,Michael,5,2000-10-18T03:00:00Z,PORTLAND ME,0,0,2,0,2
Hurricane,Michael,5,2000-10-18T03:00:00Z,PTX BASQUES NFLD,0,0,2,0,2
Hurricane,Michael,5,2000-10-18T03:00:00Z,BAR HARBOR ME,0,0,3,0,3
Hurricane,Michael,6,2000-10-18T09:00:00Z,34.7N  68.5W,41,4,0,0,45
Hurricane,Michael,6,2000-10-18T09:00:00Z,EASTPORT ME,0,0,6,0,6
Hurricane,Michael,6,2000-10-18T09:00:00Z,38.7N  64.5W,0,17,6,0,23
Hurricane,Michael,6,2000-10-18T09:00:00Z,ST JOHN NB,0,0,7,0,7
Hurricane,Michael,6,2000-10-18T09:00:00Z,44.0N  58.5W,0,0,10,0,10
Hurricane,Michael,6,2000-10-18T09:00:00Z,MONCTON NB,0,0,7,0,7
Hurricane,Michael,6,2000-10-18T09:00:00Z,BERMUDA,0,2,0,0,2
Hurricane,Michael,6,2000-10-18T09:00:00Z,YARMOUTH NS,0,1,10,0,11
Hurricane,Michael,6,2000-10-18T09:00:00Z,MONTAUK POINT NY,0,2,1,0,3
Hurricane,Michael,6,2000-10-18T09:00:00Z,HALIFAX NS,0,0,11,0,11
Hurricane,Michael,6,2000-10-18T09:00:00Z,PROVIDENCE RI,0,2,1,0,3
Hurricane,Michael,6,2000-10-18T09:00:00Z,SABLE ISLAND NS,0,0,12,0,12
Hurricane,Michael,6,2000-10-18T09:00:00Z,NANTUCKET MA,0,4,3,0,7
Hurricane,Michael,6,2000-10-18T09:00:00Z,SYDNEY NS,0,0,7,0,7
Hurricane,Michael,6,2000-10-18T09:00:00Z,HYANNIS MA,0,3,3,0,6
Hurricane,Michael,6,2000-10-18T09:00:00Z,EDDY POINT NS,0,0,9,0,9
Hurricane,Michael,6,2000-10-18T09:00:00Z,BOSTON MA,0,1,2,0,3
Hurricane,Michael,6,2000-10-18T09:00:00Z,PTX BASQUES NFLD,0,0,4,0,4
Hurricane,Michael,6,2000-10-18T09:00:00Z,PORTLAND ME,0,1,2,0,3
Hurricane,Michael,6,2000-10-18T09:00:00Z,BURGEO NFLD,0,0,3,0,3
Hurricane,Michael,6,2000-10-18T09:00:00Z,BAR HARBOR ME,0,0,5,0,5
Hurricane,Michael,6,2000-10-18T09:00:00Z,ILE ST PIERRE,0,0,3,0,3
Hurricane,Michael,7,2000-10-18T15:00:00Z,37.0N  65.0W,21,6,0,0,27
Hurricane,Michael,7,2000-10-18T15:00:00Z,MONCTON NB,0,3,0,0,3
Hurricane,Michael,7,2000-10-18T15:00:00Z,42.0N  60.0W,0,10,0,0,10
Hurricane,Michael,7,2000-10-18T15:00:00Z,YARMOUTH NS,0,5,0,0,5
Hurricane,Michael,7,2000-10-18T15:00:00Z,BERMUDA,13,1,0,0,14
Hurricane,Michael,7,2000-10-18T15:00:00Z,HALIFAX NS,0,5,0,0,5
Hurricane,Michael,7,2000-10-18T15:00:00Z,BAR HARBOR ME,0,2,0,0,2
Hurricane,Michael,7,2000-10-18T15:00:00Z,SABLE ISLAND NS,0,6,0,0,6
Hurricane,Michael,7,2000-10-18T15:00:00Z,EASTPORT ME,0,2,0,0,2
Hurricane,Michael,7,2000-10-18T15:00:00Z,SYDNEY NS,0,2,0,0,2
Hurricane,Michael,7,2000-10-18T15:00:00Z,ST JOHN NB,0,3,0,0,3
Hurricane,Michael,7,2000-10-18T15:00:00Z,EDDY POINT NS,0,4,0,0,4
Hurricane,Michael,8,2000-10-18T21:00:00Z,41.0N  62.0W,12,7,0,0,19
Hurricane,Michael,8,2000-10-18T21:00:00Z,HALIFAX NS,1,10,0,0,11
Hurricane,Michael,8,2000-10-18T21:00:00Z,46.0N  57.5W,0,10,2,0,12
Hurricane,Michael,8,2000-10-18T21:00:00Z,SABLE ISLAND NS,0,15,0,0,15
Hurricane,Michael,8,2000-10-18T21:00:00Z,51.0N  54.0W,0,0,8,0,8
Hurricane,Michael,8,2000-10-18T21:00:00Z,SYDNEY NS,0,11,2,0,13
Hurricane,Michael,8,2000-10-18T21:00:00Z,BERMUDA,6,0,0,0,6
Hurricane,Michael,8,2000-10-18T21:00:00Z,EDDY POINT NS,0,12,1,0,13
Hurricane,Michael,8,2000-10-18T21:00:00Z,BAR HARBOR ME,1,1,0,0,2
Hurricane,Michael,8,2000-10-18T21:00:00Z,PTX BASQUES NFLD,0,8,4,0,12
Hurricane,Michael,8,2000-10-18T21:00:00Z,EASTPORT ME,1,3,0,0,4
Hurricane,Michael,8,2000-10-18T21:00:00Z,BURGEO NFLD,0,7,5,0,12
Hurricane,Michael,8,2000-10-18T21:00:00Z,ST JOHN NB,1,5,0,0,6
Hurricane,Michael,8,2000-10-18T21:00:00Z,ILE ST PIERRE,0,6,5,0,11
Hurricane,Michael,8,2000-10-18T21:00:00Z,MONCTON NB,0,7,0,0,7
Hurricane,Michael,8,2000-10-18T21:00:00Z,CAPE RACE NFLD,0,2,7,0,9
Hurricane,Michael,8,2000-10-18T21:00:00Z,YARMOUTH NS,3,4,0,0,7
Hurricane,Michael,8,2000-10-18T21:00:00Z,HIBERNIA OILFLD,0,0,3,0,3
Hurricane,Michael,9,2000-10-19T03:00:00Z,42.8N  58.3W,13,0,0,0,13
Hurricane,Michael,9,2000-10-19T03:00:00Z,SYDNEY NS,2,0,0,0,2
Hurricane,Michael,9,2000-10-19T03:00:00Z,HALIFAX NS,4,0,0,0,4
Hurricane,Michael,9,2000-10-19T03:00:00Z,EDDY POINT NS,5,0,0,0,5
Hurricane,Michael,9,2000-10-19T03:00:00Z,SABLE ISLAND NS,11,0,0,0,11
Hurricane,Michael,10,2000-10-19T09:00:00Z,47.1N  53.2W,18,0,0,0,18
Hurricane,Michael,10,2000-10-19T09:00:00Z,PTX BASQUES NFLD,4,0,0,0,4
Hurricane,Michael,10,2000-10-19T09:00:00Z,SABLE ISLAND NS,16,0,0,0,16
Hurricane,Michael,10,2000-10-19T09:00:00Z,BURGEO NFLD,8,0,0,0,8
Hurricane,Michael,10,2000-10-19T09:00:00Z,SYDNEY NS,4,0,0,0,4
Hurricane,Michael,10,2000-10-19T09:00:00Z,ILE ST PIERRE,17,0,0,0,17
Hurricane,Michael,10,2000-10-19T09:00:00Z,EDDY POINT NS,3,0,0,0,3
Hurricane,Michael,10,2000-10-19T09:00:00Z,CAPE RACE NFLD,19,0,0,0,19
Hurricane,Michael,11,2000-10-19T15:00:00Z,49.5N  51.5W,23,0,0,0,23
Hurricane,Michael,11,2000-10-19T15:00:00Z,BURGEO NFLD,14,0,0,0,14
Hurricane,Michael,11,2000-10-19T15:00:00Z,SABLE ISLAND NS,12,0,0,0,12
Hurricane,Michael,11,2000-10-19T15:00:00Z,ILE ST PIERRE,28,0,0,0,28
Hurricane,Michael,11,2000-10-19T15:00:00Z,SYDNEY NS,4,0,0,0,4
Hurricane,Michael,11,2000-10-19T15:00:00Z,CAPE RACE NFLD,34,0,0,0,34
Hurricane,Michael,11,2000-10-19T15:00:00Z,PTX BASQUES NFLD,5,0,0,0,5
Hurricane,Michael,11,2000-10-19T15:00:00Z,HIBERNIA OILFLD,13,0,0,0,13
Hurricane,Michael,12,2000-10-19T18:00:00Z,50.0N  53.5W,22,0,0,0,22
Hurricane,Michael,12,2000-10-19T18:00:00Z,BURGEO NFLD,25,0,0,0,25
Hurricane,Michael,12,2000-10-19T18:00:00Z,SABLE ISLAND NS,24,0,0,0,24
Hurricane,Michael,12,2000-10-19T18:00:00Z,ILE ST PIERRE,38,0,0,0,38
Hurricane,Michael,12,2000-10-19T18:00:00Z,SYDNEY NS,10,0,0,0,10
Hurricane,Michael,12,2000-10-19T18:00:00Z,CAPE RACE NFLD,29,0,0,0,29
Hurricane,Michael,12,2000-10-19T18:00:00Z,EDDY POINT NS,3,0,0,0,3
Hurricane,Michael,12,2000-10-19T18:00:00Z,HIBERNIA OILFLD,6,0,0,0,6
Hurricane,Michael,12,2000-10-19T18:00:00Z,PTX BASQUES NFLD,14,0,0,0,14
Hurricane,Michael,13,2000-10-19T21:00:00Z,56.0N  40.5W,24,0,0,0,24
Hurricane,Michael,13,2000-10-19T21:00:00Z,BURGEO NFLD,16,0,0,0,16
Hurricane,Michael,13,2000-10-19T21:00:00Z,SABLE ISLAND NS,25,0,0,0,25
Hurricane,Michael,13,2000-10-19T21:00:00Z,ILE ST PIERRE,99,0,0,0,99
Hurricane,Michael,13,2000-10-19T21:00:00Z,PTX BASQUES NFLD,2,0,0,0,2
Hurricane,Michael,13,2000-10-19T21:00:00Z,CAPE RACE NFLD,27,0,0,0,27
Tropical Depression,Eighteen,1,2000-10-19T21:00:00Z,32.0N  55.5W,25,5,0,0,30
Tropical Depression,Eighteen,1,2000-10-19T21:00:00Z,ILE ST PIERRE,0,0,0,2,2
Tropical Depression,Eighteen,1,2000-10-19T21:00:00Z,34.5N  52.5W,0,18,2,1,21
Tropical Depression,Eighteen,1,2000-10-19T21:00:00Z,CAPE RACE NFLD,0,0,0,3,3
Tropical Depression,Eighteen,1,2000-10-19T21:00:00Z,36.5N  50.0W,0,5,9,3,17
Tropical Depression,Eighteen,1,2000-10-19T21:00:00Z,HIBERNIA OILFLD,0,0,0,3,3
Tropical Depression,Eighteen,1,2000-10-19T21:00:00Z,SABLE ISLAND NS,0,0,0,2,2
Tropical Depression,Eighteen,2,2000-10-20T03:00:00Z,32.1N  54.9W,22,5,0,0,27
Tropical Depression,Eighteen,2,2000-10-20T03:00:00Z,BURGEO NFLD,0,0,0,2,2
Tropical Depression,Eighteen,2,2000-10-20T03:00:00Z,34.1N  52.1W,1,15,3,1,20
Tropical Depression,Eighteen,2,2000-10-20T03:00:00Z,ILE ST PIERRE,0,0,0,3,3
Tropical Depression,Eighteen,2,2000-10-20T03:00:00Z,36.5N  49.5W,0,2,11,3,16
Tropical Depression,Eighteen,2,2000-10-20T03:00:00Z,CAPE RACE NFLD,0,0,0,4,4
Tropical Depression,Eighteen,2,2000-10-20T03:00:00Z,SABLE ISLAND NS,0,0,0,2,2
Tropical Depression,Eighteen,2,2000-10-20T03:00:00Z,HIBERNIA OILFLD,0,0,0,4,4
Tropical Depression,Eighteen,3,2000-10-20T09:00:00Z,32.9N  54.3W,24,4,0,0,28
Tropical Depression,Eighteen,3,2000-10-20T09:00:00Z,PTX BASQUES NFLD,0,0,0,2,2
Tropical Depression,Eighteen,3,2000-10-20T09:00:00Z,34.9N  51.7W,1,16,3,0,20
Tropical Depression,Eighteen,3,2000-10-20T09:00:00Z,BURGEO NFLD,0,0,0,3,3
Tropical Depression,Eighteen,3,2000-10-20T09:00:00Z,37.5N  49.5W,0,3,11,2,16
Tropical Depression,Eighteen,3,2000-10-20T09:00:00Z,ILE ST PIERRE,0,0,0,4,4
Tropical Depression,Eighteen,3,2000-10-20T09:00:00Z,SABLE ISLAND NS,0,0,0,3,3
Tropical Depression,Eighteen,3,2000-10-20T09:00:00Z,CAPE RACE NFLD,0,0,0,6,6
Tropical Depression,Eighteen,3,2000-10-20T09:00:00Z,SYDNEY NS,0,0,0,2,2
Tropical Depression,Eighteen,3,2000-10-20T09:00:00Z,HIBERNIA OILFLD,0,0,0,7,7
Tropical Depression,Eighteen,3,2000-10-20T09:00:00Z,EDDY POINT NS,0,0,0,2,2
Tropical Storm,Nadine,4,2000-10-20T15:00:00Z,34.0N  53.5W,23,3,0,0,26
Tropical Storm,Nadine,4,2000-10-20T15:00:00Z,PTX BASQUES NFLD,0,0,0,2,2
Tropical Storm,Nadine,4,2000-10-20T15:00:00Z,36.5N  51.0W,1,15,2,1,19
Tropical Storm,Nadine,4,2000-10-20T15:00:00Z,BURGEO NFLD,0,0,0,4,4
Tropical Storm,Nadine,4,2000-10-20T15:00:00Z,40.0N  48.0W,0,2,10,2,14
Tropical Storm,Nadine,4,2000-10-20T15:00:00Z,ILE ST PIERRE,0,0,0,5,5
Tropical Storm,Nadine,4,2000-10-20T15:00:00Z,SABLE ISLAND NS,0,0,0,2,2
Tropical Storm,Nadine,4,2000-10-20T15:00:00Z,CAPE RACE NFLD,0,0,1,6,7
Tropical Storm,Nadine,4,2000-10-20T15:00:00Z,SYDNEY NS,0,0,0,2,2
Tropical Storm,Nadine,4,2000-10-20T15:00:00Z,HIBERNIA OILFLD,0,0,1,8,9
Tropical Storm,Nadine,5,2000-10-20T21:00:00Z,35.8N  53.0W,27,1,0,0,28
Tropical Storm,Nadine,5,2000-10-20T21:00:00Z,BURGEO NFLD,0,0,1,2,3
Tropical Storm,Nadine,5,2000-10-20T21:00:00Z,38.5N  50.0W,2,12,1,0,15
Tropical Storm,Nadine,5,2000-10-20T21:00:00Z,ILE ST PIERRE,0,0,2,2,4
Tropical Storm,Nadine,5,2000-10-20T21:00:00Z,42.0N  46.0W,0,2,7,2,11
Tropical Storm,Nadine,5,2000-10-20T21:00:00Z,CAPE RACE NFLD,0,0,4,3,7
Tropical Storm,Nadine,5,2000-10-20T21:00:00Z,SABLE ISLAND NS,0,0,1,1,2
Tropical Storm,Nadine,5,2000-10-20T21:00:00Z,HIBERNIA OILFLD,0,0,3,6,9
Tropical Storm,Nadine,5,2000-10-20T21:00:00Z,PTX BASQUES NFLD,0,0,1,1,2
Tropical Storm,Nadine,6,2000-10-21T03:00:00Z,37.7N  49.3W,17,4,0,0,21
Tropical Storm,Nadine,6,2000-10-21T03:00:00Z,ILE ST PIERRE,0,0,2,0,2
Tropical Storm,Nadine,6,2000-10-21T03:00:00Z,40.6N  45.9W,1,13,3,1,18
Tropical Storm,Nadine,6,2000-10-21T03:00:00Z,CAPE RACE NFLD,0,0,5,1,6
Tropical Storm,Nadine,6,2000-10-21T03:00:00Z,45.0N  41.5W,0,1,10,2,13
Tropical Storm,Nadine,6,2000-10-21T03:00:00Z,HIBERNIA OILFLD,0,0,7,3,10
Tropical Storm,Nadine,7,2000-10-21T09:00:00Z,38.0N  49.0W,20,2,0,0,22
Tropical Storm,Nadine,7,2000-10-21T09:00:00Z,CAPE RACE NFLD,0,2,1,0,3
Tropical Storm,Nadine,7,2000-10-21T09:00:00Z,41.5N  45.5W,0,12,5,0,17
Tropical Storm,Nadine,7,2000-10-21T09:00:00Z,HIBERNIA OILFLD,0,2,6,1,9
Tropical Storm,Nadine,7,2000-10-21T09:00:00Z,46.5N  39.5W,0,0,8,4,12
Tropical Storm,Nadine,8,2000-10-21T15:00:00Z,40.0N  46.5W,17,4,0,0,21
Tropical Storm,Nadine,8,2000-10-21T15:00:00Z,CAPE RACE NFLD,0,2,1,0,3
Tropical Storm,Nadine,8,2000-10-21T15:00:00Z,44.0N  42.0W,0,11,3,0,14
Tropical Storm,Nadine,8,2000-10-21T15:00:00Z,HIBERNIA OILFLD,0,5,3,0,8
Tropical Storm,Nadine,8,2000-10-21T15:00:00Z,49.0N  35.0W,0,0,8,3,11
Tropical Storm,Nadine,9,2000-10-21T21:00:00Z,41.0N  45.0W,16,6,0,0,22
Tropical Storm,Nadine,9,2000-10-21T21:00:00Z,51.0N  32.0W,0,0,8,0,8
Tropical Storm,Nadine,9,2000-10-21T21:00:00Z,45.0N  40.0W,0,13,5,0,18
Tropical Storm,Nadine,9,2000-10-21T21:00:00Z,HIBERNIA OILFLD,0,4,2,0,6
Tropical Storm,Nadine,10,2000-10-22T03:00:00Z,41.7N  44.0W,16,9,0,0,25
Tropical Storm,Nadine,10,2000-10-22T03:00:00Z,55.0N  29.0W,0,0,7,0,7
Tropical Storm,Nadine,10,2000-10-22T03:00:00Z,47.5N  37.1W,0,10,5,0,15
Tropical Storm,Nadine,10,2000-10-22T03:00:00Z,HIBERNIA OILFLD,0,4,1,0,5
Tropical Storm,Allison,1,2001-06-05T19:00:00Z,31.6N  93.9W,36,0,0,0,36
Tropical Storm,Allison,1,2001-06-05T19:00:00Z,PORT ARTHUR TX,61,0,0,0,61
Tropical Storm,Allison,1,2001-06-05T19:00:00Z,33.1N  93.2W,20,3,1,0,24
Tropical Storm,Allison,1,2001-06-05T19:00:00Z,GALVESTON TX,99,0,0,0,99
Tropical Storm,Allison,1,2001-06-05T19:00:00Z,34.4N  92.0W,4,9,3,0,16
Tropical Storm,Allison,1,2001-06-05T19:00:00Z,FREEPORT TX,99,0,0,0,99
Tropical Storm,Allison,1,2001-06-05T19:00:00Z,MOBILE AL,0,0,2,0,2
Tropical Storm,Allison,1,2001-06-05T19:00:00Z,PORT O CONNOR TX,1,1,0,0,2
Tropical Storm,Allison,1,2001-06-05T19:00:00Z,GULFPORT MS,0,1,3,0,4
Tropical Storm,Allison,1,2001-06-05T19:00:00Z,GULF 28N 91W,1,1,1,0,3
Tropical Storm,Allison,1,2001-06-05T19:00:00Z,BURAS LA,0,1,3,0,4
Tropical Storm,Allison,1,2001-06-05T19:00:00Z,GULF 28N 93W,24,0,0,0,24
Tropical Storm,Allison,1,2001-06-05T19:00:00Z,NEW ORLEANS LA,1,3,3,0,7
Tropical Storm,Allison,1,2001-06-05T19:00:00Z,GULF 28N 95W,99,0,0,0,99
Tropical Storm,Allison,1,2001-06-05T19:00:00Z,NEW IBERIA LA,12,2,1,0,15
Tropical Storm,Allison,2,2001-06-05T21:00:00Z,32.2N  94.8W,54,0,0,0,54
Tropical Storm,Allison,2,2001-06-05T21:00:00Z,GALVESTON TX,99,0,0,0,99
Tropical Storm,Allison,2,2001-06-05T21:00:00Z,33.6N  93.9W,31,2,1,0,34
Tropical Storm,Allison,2,2001-06-05T21:00:00Z,FREEPORT TX,99,0,0,0,99
Tropical Storm,Allison,2,2001-06-05T21:00:00Z,34.5N  92.6W,8,13,2,0,23
Tropical Storm,Allison,2,2001-06-05T21:00:00Z,PORT O CONNOR TX,3,2,0,0,5
Tropical Storm,Allison,2,2001-06-05T21:00:00Z,NEW ORLEANS LA,0,0,2,0,2
Tropical Storm,Allison,2,2001-06-05T21:00:00Z,GULF 28N 93W,0,1,1,0,2
Tropical Storm,Allison,2,2001-06-05T21:00:00Z,NEW IBERIA LA,1,3,3,0,7
Tropical Storm,Allison,2,2001-06-05T21:00:00Z,GULF 28N 95W,99,0,0,0,99
Tropical Storm,Allison,2,2001-06-05T21:00:00Z,PORT ARTHUR TX,62,0,0,0,62
Tropical Depression,Two,1,2001-07-12T03:00:00Z,13.7N  48.2W,48,0,0,0,48
Tropical Depression,Two,1,2001-07-12T03:00:00Z,TLPL 138N 610W,0,0,0,5,5
Tropical Depression,Two,1,2001-07-12T03:00:00Z,14.7N  50.6W,11,23,0,0,34
Tropical Depression,Two,1,2001-07-12T03:00:00Z,TFFF 146N 610W,0,0,0,6,6
Tropical Depression,Two,1,2001-07-12T03:00:00Z,15.7N  52.9W,0,18,7,1,26
Tropical Depression,Two,1,2001-07-12T03:00:00Z,TDPR 153N 614W,0,0,0,6,6
Tropical Depression,Two,1,2001-07-12T03:00:00Z,TTPT 112N 608W,0,0,0,3,3
Tropical Depression,Two,1,2001-07-12T03:00:00Z,TFFR 163N 615W,0,0,0,6,6
Tropical Depression,Two,1,2001-07-12T03:00:00Z,TGPY 120N 618W,0,0,0,2,2
Tropical Depression,Two,1,2001-07-12T03:00:00Z,TAPA 171N 618W,0,0,0,6,6
Tropical Depression,Two,1,2001-07-12T03:00:00Z,TBPB 131N 595W,0,0,0,8,8
Tropical Depression,Two,1,2001-07-12T03:00:00Z,TKPK 173N 627W,0,0,0,4,4
Tropical Depression,Two,1,2001-07-12T03:00:00Z,TVSV 131N 612W,0,0,0,4,4
Tropical Depression,Two,1,2001-07-12T03:00:00Z,TNCM 181N 631W,0,0,0,3,3
Tropical Depression,Two,2,2001-07-12T09:00:00Z,14.3N  51.1W,51,0,0,0,51
Tropical Depression,Two,2,2001-07-12T09:00:00Z,TAPA 171N 618W,0,0,0,15,15
Tropical Depression,Two,2,2001-07-12T09:00:00Z,15.2N  53.6W,6,29,1,0,36
Tropical Depression,Two,2,2001-07-12T09:00:00Z,TKPK 173N 627W,0,0,0,13,13
Tropical Depression,Two,2,2001-07-12T09:00:00Z,16.0N  56.0W,0,13,14,1,28
Tropical Depression,Two,2,2001-07-12T09:00:00Z,TNCM 181N 631W,0,0,0,13,13
Tropical Depression,Two,2,2001-07-12T09:00:00Z,TBPB 131N 595W,0,0,1,7,8
Tropical Depression,Two,2,2001-07-12T09:00:00Z,TISX 177N 648W,0,0,0,6,6
Tropical Depression,Two,2,2001-07-12T09:00:00Z,TVSV 131N 612W,0,0,0,5,5
Tropical Depression,Two,2,2001-07-12T09:00:00Z,TIST 183N 650W,0,0,0,5,5
Tropical Depression,Two,2,2001-07-12T09:00:00Z,TLPL 138N 610W,0,0,0,7,7
Tropical Depression,Two,2,2001-07-12T09:00:00Z,TJSJ 184N 661W,0,0,0,2,2
Tropical Depression,Two,2,2001-07-12T09:00:00Z,TFFF 146N 610W,0,0,1,10,11
Tropical Depression,Two,2,2001-07-12T09:00:00Z,ST CROIX VI,0,0,0,6,6
Tropical Depression,Two,2,2001-07-12T09:00:00Z,TDPR 153N 614W,0,0,0,12,12
Tropical Depression,Two,2,2001-07-12T09:00:00Z,ST THOMAS VI,0,0,0,5,5
Tropical Depression,Two,2,2001-07-12T09:00:00Z,TFFR 163N 615W,0,0,1,14,15
Tropical Depression,Two,2,2001-07-12T09:00:00Z,SAN JUAN PR,0,0,0,2,2
Tropical Depression,Two,3,2001-07-12T15:00:00Z,14.5N  52.5W,52,0,0,0,52
Tropical Depression,Two,3,2001-07-12T15:00:00Z,TAPA 171N 618W,0,0,3,16,19
Tropical Depression,Two,3,2001-07-12T15:00:00Z,15.5N  55.0W,2,32,1,0,35
Tropical Depression,Two,3,2001-07-12T15:00:00Z,TKPK 173N 627W,0,0,1,16,17
Tropical Depression,Two,3,2001-07-12T15:00:00Z,16.0N  57.5W,0,10,15,1,26
Tropical Depression,Two,3,2001-07-12T15:00:00Z,TNCM 181N 631W,0,0,0,16,16
Tropical Depression,Two,3,2001-07-12T15:00:00Z,TTPT 112N 608W,0,0,0,3,3
Tropical Depression,Two,3,2001-07-12T15:00:00Z,TISX 177N 648W,0,0,0,12,12
Tropical Depression,Two,3,2001-07-12T15:00:00Z,TGPY 120N 618W,0,0,0,4,4
Tropical Depression,Two,3,2001-07-12T15:00:00Z,TIST 183N 650W,0,0,0,11,11
Tropical Depression,Two,3,2001-07-12T15:00:00Z,TBPB 131N 595W,0,0,6,5,11
Tropical Depression,Two,3,2001-07-12T15:00:00Z,TJPS 180N 666W,0,0,0,5,5
Tropical Depression,Two,3,2001-07-12T15:00:00Z,TVSV 131N 612W,0,0,1,8,9
Tropical Depression,Two,3,2001-07-12T15:00:00Z,TJSJ 184N 661W,0,0,0,7,7
Tropical Depression,Two,3,2001-07-12T15:00:00Z,TLPL 138N 610W,0,0,3,9,12
Tropical Depression,Two,3,2001-07-12T15:00:00Z,ST CROIX VI,0,0,0,12,12
Tropical Depression,Two,3,2001-07-12T15:00:00Z,TFFF 146N 610W,0,0,4,11,15
Tropical Depression,Two,3,2001-07-12T15:00:00Z,ST THOMAS VI,0,0,0,11,11
Tropical Depression,Two,3,2001-07-12T15:00:00Z,TDPR 153N 614W,0,0,4,12,16
Tropical Depression,Two,3,2001-07-12T15:00:00Z,SAN JUAN PR,0,0,0,7,7
Tropical Depression,Two,3,2001-07-12T15:00:00Z,TFFR 163N 615W,0,0,4,14,18
Tropical Depression,Two,3,2001-07-12T15:00:00Z,PONCE PR,0,0,0,5,5
Tropical Storm,Barry,1,2001-08-02T19:00:00Z,27.3N  86.2W,58,0,0,0,58
Tropical Storm,Barry,1,2001-08-02T19:00:00Z,NEW ORLEANS LA,1,11,5,3,20
Tropical Storm,Barry,1,2001-08-02T19:00:00Z,27.6N  87.5W,31,1,0,0,32
Tropical Storm,Barry,1,2001-08-02T19:00:00Z,NEW IBERIA LA,0,4,8,5,17
Tropical Storm,Barry,1,2001-08-02T19:00:00Z,27.8N  88.8W,15,8,2,1,26
Tropical Storm,Barry,1,2001-08-02T19:00:00Z,PORT ARTHUR TX,0,0,4,8,12
Tropical Storm,Barry,1,2001-08-02T19:00:00Z,MUAN 219N 850W,0,0,0,2,2
Tropical Storm,Barry,1,2001-08-02T19:00:00Z,GALVESTON TX,0,0,2,9,11
Tropical Storm,Barry,1,2001-08-02T19:00:00Z,MMMD 210N 897W,0,0,0,2,2
Tropical Storm,Barry,1,2001-08-02T19:00:00Z,FREEPORT TX,0,0,1,8,9
Tropical Storm,Barry,1,2001-08-02T19:00:00Z,MARCO ISLAND FL,0,0,0,2,2
Tropical Storm,Barry,1,2001-08-02T19:00:00Z,PORT O CONNOR TX,0,0,0,7,7
Tropical Storm,Barry,1,2001-08-02T19:00:00Z,FT MYERS FL,0,1,0,1,2
Tropical Storm,Barry,1,2001-08-02T19:00:00Z,CORPUSCHRISTI TX,0,0,0,5,5
Tropical Storm,Barry,1,2001-08-02T19:00:00Z,VENICE FL,7,0,0,1,8
Tropical Storm,Barry,1,2001-08-02T19:00:00Z,BROWNSVILLE TX,0,0,0,4,4
Tropical Storm,Barry,1,2001-08-02T19:00:00Z,TAMPA FL,6,0,0,1,7
Tropical Storm,Barry,1,2001-08-02T19:00:00Z,GULF 29N 85W,24,1,0,0,25
Tropical Storm,Barry,1,2001-08-02T19:00:00Z,CEDAR KEY FL,5,1,0,2,8
Tropical Storm,Barry,1,2001-08-02T19:00:00Z,GULF 29N 87W,25,2,0,1,28
Tropical Storm,Barry,1,2001-08-02T19:00:00Z,ST MARKS FL,5,2,1,2,10
Tropical Storm,Barry,1,2001-08-02T19:00:00Z,GULF 28N 89W,12,10,2,1,25
Tropical Storm,Barry,1,2001-08-02T19:00:00Z,APALACHICOLA FL,14,1,1,1,17
Tropical Storm,Barry,1,2001-08-02T19:00:00Z,GULF 28N 91W,1,8,7,3,19
Tropical Storm,Barry,1,2001-08-02T19:00:00Z,PANAMA CITY FL,13,2,1,2,18
Tropical Storm,Barry,1,2001-08-02T19:00:00Z,GULF 28N 93W,0,1,6,8,15
Tropical Storm,Barry,1,2001-08-02T19:00:00Z,PENSACOLA FL,7,8,2,2,19
Tropical Storm,Barry,1,2001-08-02T19:00:00Z,GULF 28N 95W,0,0,1,9,10
Tropical Storm,Barry,1,2001-08-02T19:00:00Z,MOBILE AL,3,11,3,2,19
Tropical Storm,Barry,1,2001-08-02T19:00:00Z,GULF 27N 96W,0,0,0,7,7
Tropical Storm,Barry,1,2001-08-02T19:00:00Z,GULFPORT MS,2,13,3,3,21
Tropical Storm,Barry,1,2001-08-02T19:00:00Z,GULF 25N 96W,0,0,0,5,5
Tropical Storm,Barry,1,2001-08-02T19:00:00Z,BURAS LA,3,15,3,2,23
Tropical Storm,Barry,2,2001-08-02T21:00:00Z,27.2N  86.3W,47,0,0,0,47
Tropical Storm,Barry,2,2001-08-02T21:00:00Z,MOBILE AL,1,9,4,3,17
Tropical Storm,Barry,2,2001-08-02T21:00:00Z,27.6N  87.5W,26,1,1,1,29
Tropical Storm,Barry,2,2001-08-02T21:00:00Z,GULFPORT MS,2,10,5,2,19
Tropical Storm,Barry,2,2001-08-02T21:00:00Z,27.8N  88.8W,14,8,2,1,25
Tropical Storm,Barry,2,2001-08-02T21:00:00Z,BURAS LA,4,13,3,2,22
Tropical Storm,Barry,2,2001-08-02T21:00:00Z,MUHA 230N 824W,0,0,0,2,2
Tropical Storm,Barry,2,2001-08-02T21:00:00Z,NEW ORLEANS LA,1,11,5,3,20
Tropical Storm,Barry,2,2001-08-02T21:00:00Z,MUAN 219N 850W,0,0,0,2,2
Tropical Storm,Barry,2,2001-08-02T21:00:00Z,NEW IBERIA LA,0,5,8,4,17
Tropical Storm,Barry,2,2001-08-02T21:00:00Z,MMMD 210N 897W,0,0,0,2,2
Tropical Storm,Barry,2,2001-08-02T21:00:00Z,PORT ARTHUR TX,0,0,5,7,12
Tropical Storm,Barry,2,2001-08-02T21:00:00Z,MARATHON FL,0,0,1,1,2
Tropical Storm,Barry,2,2001-08-02T21:00:00Z,GALVESTON TX,0,0,3,8,11
Tropical Storm,Barry,2,2001-08-02T21:00:00Z,DAYTONA BEACH FL,0,0,0,2,2
Tropical Storm,Barry,2,2001-08-02T21:00:00Z,FREEPORT TX,0,0,1,8,9
Tropical Storm,Barry,2,2001-08-02T21:00:00Z,JACKSONVILLE FL,0,0,0,2,2
Tropical Storm,Barry,2,2001-08-02T21:00:00Z,PORT O CONNOR TX,0,0,0,7,7
Tropical Storm,Barry,2,2001-08-02T21:00:00Z,KEY WEST FL,0,1,1,1,3
Tropical Storm,Barry,2,2001-08-02T21:00:00Z,CORPUSCHRISTI TX,0,0,0,4,4
Tropical Storm,Barry,2,2001-08-02T21:00:00Z,MARCO ISLAND FL,1,2,0,2,5
Tropical Storm,Barry,2,2001-08-02T21:00:00Z,BROWNSVILLE TX,0,0,0,3,3
Tropical Storm,Barry,2,2001-08-02T21:00:00Z,FT MYERS FL,2,2,0,2,6
Tropical Storm,Barry,2,2001-08-02T21:00:00Z,GULF 29N 85W,13,3,1,1,18
Tropical Storm,Barry,2,2001-08-02T21:00:00Z,VENICE FL,6,1,1,1,9
Tropical Storm,Barry,2,2001-08-02T21:00:00Z,GULF 29N 87W,16,5,2,1,24
Tropical Storm,Barry,2,2001-08-02T21:00:00Z,TAMPA FL,4,1,1,2,8
Tropical Storm,Barry,2,2001-08-02T21:00:00Z,GULF 28N 89W,12,9,2,2,25
Tropical Storm,Barry,2,2001-08-02T21:00:00Z,CEDAR KEY FL,2,2,1,2,7
Tropical Storm,Barry,2,2001-08-02T21:00:00Z,GULF 28N 91W,1,9,6,3,19
Tropical Storm,Barry,2,2001-08-02T21:00:00Z,ST MARKS FL,1,2,2,3,8
Tropical Storm,Barry,2,2001-08-02T21:00:00Z,GULF 28N 93W,0,1,7,6,14
Tropical Storm,Barry,2,2001-08-02T21:00:00Z,APALACHICOLA FL,6,4,1,3,14
Tropical Storm,Barry,2,2001-08-02T21:00:00Z,GULF 28N 95W,0,0,1,8,9
Tropical Storm,Barry,2,2001-08-02T21:00:00Z,PANAMA CITY FL,5,5,2,2,14
Tropical Storm,Barry,2,2001-08-02T21:00:00Z,GULF 27N 96W,0,0,0,6,6
Tropical Storm,Barry,2,2001-08-02T21:00:00Z,PENSACOLA FL,2,8,4,2,16
Tropical Storm,Barry,2,2001-08-02T21:00:00Z,GULF 25N 96W,0,0,0,4,4
Tropical Storm,Barry,3,2001-08-03T03:00:00Z,27.5N  87.0W,48,0,0,0,48
Tropical Storm,Barry,3,2001-08-03T03:00:00Z,GULFPORT MS,6,8,3,3,20
Tropical Storm,Barry,3,2001-08-03T03:00:00Z,27.7N  87.9W,31,1,1,0,33
Tropical Storm,Barry,3,2001-08-03T03:00:00Z,BURAS LA,11,7,3,2,23
Tropical Storm,Barry,3,2001-08-03T03:00:00Z,27.9N  88.9W,20,3,2,1,26
Tropical Storm,Barry,3,2001-08-03T03:00:00Z,NEW ORLEANS LA,4,10,4,2,20
Tropical Storm,Barry,3,2001-08-03T03:00:00Z,MUAN 219N 850W,0,0,0,2,2
Tropical Storm,Barry,3,2001-08-03T03:00:00Z,NEW IBERIA LA,1,8,5,4,18
Tropical Storm,Barry,3,2001-08-03T03:00:00Z,COCOA BEACH FL,0,0,0,2,2
Tropical Storm,Barry,3,2001-08-03T03:00:00Z,PORT ARTHUR TX,0,1,6,6,13
Tropical Storm,Barry,3,2001-08-03T03:00:00Z,DAYTONA BEACH FL,0,0,0,2,2
Tropical Storm,Barry,3,2001-08-03T03:00:00Z,GALVESTON TX,0,0,4,7,11
Tropical Storm,Barry,3,2001-08-03T03:00:00Z,JACKSONVILLE FL,0,0,0,2,2
Tropical Storm,Barry,3,2001-08-03T03:00:00Z,FREEPORT TX,0,0,2,8,10
Tropical Storm,Barry,3,2001-08-03T03:00:00Z,KEY WEST FL,0,0,1,1,2
Tropical Storm,Barry,3,2001-08-03T03:00:00Z,PORT O CONNOR TX,0,0,1,6,7
Tropical Storm,Barry,3,2001-08-03T03:00:00Z,MARCO ISLAND FL,0,1,1,2,4
Tropical Storm,Barry,3,2001-08-03T03:00:00Z,CORPUSCHRISTI TX,0,0,0,5,5
Tropical Storm,Barry,3,2001-08-03T03:00:00Z,FT MYERS FL,1,1,1,2,5
Tropical Storm,Barry,3,2001-08-03T03:00:00Z,BROWNSVILLE TX,0,0,0,3,3
Tropical Storm,Barry,3,2001-08-03T03:00:00Z,VENICE FL,2,2,1,2,7
Tropical Storm,Barry,3,2001-08-03T03:00:00Z,GULF 29N 85W,15,2,1,1,19
Tropical Storm,Barry,3,2001-08-03T03:00:00Z,TAMPA FL,1,2,1,2,6
Tropical Storm,Barry,3,2001-08-03T03:00:00Z,GULF 29N 87W,22,2,1,1,26
Tropical Storm,Barry,3,2001-08-03T03:00:00Z,CEDAR KEY FL,1,1,2,3,7
Tropical Storm,Barry,3,2001-08-03T03:00:00Z,GULF 28N 89W,19,4,1,1,25
Tropical Storm,Barry,3,2001-08-03T03:00:00Z,ST MARKS FL,1,2,2,3,8
Tropical Storm,Barry,3,2001-08-03T03:00:00Z,GULF 28N 91W,4,8,4,4,20
Tropical Storm,Barry,3,2001-08-03T03:00:00Z,APALACHICOLA FL,7,3,1,3,14
Tropical Storm,Barry,3,2001-08-03T03:00:00Z,GULF 28N 93W,0,3,5,6,14
Tropical Storm,Barry,3,2001-08-03T03:00:00Z,PANAMA CITY FL,7,3,2,3,15
Tropical Storm,Barry,3,2001-08-03T03:00:00Z,GULF 28N 95W,0,0,2,8,10
Tropical Storm,Barry,3,2001-08-03T03:00:00Z,PENSACOLA FL,6,5,3,3,17
Tropical Storm,Barry,3,2001-08-03T03:00:00Z,GULF 27N 96W,0,0,0,7,7
Tropical Storm,Barry,3,2001-08-03T03:00:00Z,MOBILE AL,5,6,4,3,18
Tropical Storm,Barry,3,2001-08-03T03:00:00Z,GULF 25N 96W,0,0,0,4,4
Tropical Storm,Barry,4,2001-08-03T09:00:00Z,27.3N  88.2W,57,0,0,0,57
Tropical Storm,Barry,4,2001-08-03T09:00:00Z,NEW ORLEANS LA,6,8,4,3,21
Tropical Storm,Barry,4,2001-08-03T09:00:00Z,27.5N  89.0W,36,0,0,0,36
Tropical Storm,Barry,4,2001-08-03T09:00:00Z,NEW IBERIA LA,2,9,5,4,20
Tropical Storm,Barry,4,2001-08-03T09:00:00Z,27.8N  90.0W,22,2,2,1,27
Tropical Storm,Barry,4,2001-08-03T09:00:00Z,PORT ARTHUR TX,0,4,6,5,15
Tropical Storm,Barry,4,2001-08-03T09:00:00Z,MMMD 210N 897W,0,0,0,2,2
Tropical Storm,Barry,4,2001-08-03T09:00:00Z,GALVESTON TX,0,2,6,6,14
Tropical Storm,Barry,4,2001-08-03T09:00:00Z,JACKSONVILLE FL,0,0,0,2,2
Tropical Storm,Barry,4,2001-08-03T09:00:00Z,FREEPORT TX,0,1,5,6,12
Tropical Storm,Barry,4,2001-08-03T09:00:00Z,MARCO ISLAND FL,0,0,0,2,2
Tropical Storm,Barry,4,2001-08-03T09:00:00Z,PORT O CONNOR TX,0,0,2,6,8
Tropical Storm,Barry,4,2001-08-03T09:00:00Z,FT MYERS FL,0,0,0,2,2
Tropical Storm,Barry,4,2001-08-03T09:00:00Z,CORPUSCHRISTI TX,0,0,1,4,5
Tropical Storm,Barry,4,2001-08-03T09:00:00Z,VENICE FL,0,1,0,2,3
Tropical Storm,Barry,4,2001-08-03T09:00:00Z,BROWNSVILLE TX,0,0,0,4,4
Tropical Storm,Barry,4,2001-08-03T09:00:00Z,TAMPA FL,0,1,0,3,4
Tropical Storm,Barry,4,2001-08-03T09:00:00Z,GULF 29N 85W,4,3,2,3,12
Tropical Storm,Barry,4,2001-08-03T09:00:00Z,CEDAR KEY FL,0,1,0,4,5
Tropical Storm,Barry,4,2001-08-03T09:00:00Z,GULF 29N 87W,15,3,2,1,21
Tropical Storm,Barry,4,2001-08-03T09:00:00Z,ST MARKS FL,0,1,1,5,7
Tropical Storm,Barry,4,2001-08-03T09:00:00Z,GULF 28N 89W,31,1,0,1,33
Tropical Storm,Barry,4,2001-08-03T09:00:00Z,APALACHICOLA FL,2,2,2,4,10
Tropical Storm,Barry,4,2001-08-03T09:00:00Z,GULF 28N 91W,14,5,3,2,24
Tropical Storm,Barry,4,2001-08-03T09:00:00Z,PANAMA CITY FL,2,3,3,4,12
Tropical Storm,Barry,4,2001-08-03T09:00:00Z,GULF 28N 93W,2,7,5,4,18
Tropical Storm,Barry,4,2001-08-03T09:00:00Z,PENSACOLA FL,3,5,3,4,15
Tropical Storm,Barry,4,2001-08-03T09:00:00Z,GULF 28N 95W,0,2,4,6,12
Tropical Storm,Barry,4,2001-08-03T09:00:00Z,MOBILE AL,3,6,4,4,17
Tropical Storm,Barry,4,2001-08-03T09:00:00Z,GULF 27N 96W,0,0,2,6,8
Tropical Storm,Barry,4,2001-08-03T09:00:00Z,GULFPORT MS,5,7,4,3,19
Tropical Storm,Barry,4,2001-08-03T09:00:00Z,GULF 25N 96W,0,0,0,5,5
Tropical Storm,Barry,4,2001-08-03T09:00:00Z,BURAS LA,13,6,2,2,23
Tropical Storm,Barry,5,2001-08-03T15:00:00Z,27.3N  88.8W,64,0,0,0,64
Tropical Storm,Barry,5,2001-08-03T15:00:00Z,NEW IBERIA LA,4,10,4,3,21
Tropical Storm,Barry,5,2001-08-03T15:00:00Z,27.6N  89.7W,39,1,0,0,40
Tropical Storm,Barry,5,2001-08-03T15:00:00Z,PORT ARTHUR TX,0,6,6,5,17
Tropical Storm,Barry,5,2001-08-03T15:00:00Z,27.9N  90.4W,27,1,1,1,30
Tropical Storm,Barry,5,2001-08-03T15:00:00Z,GALVESTON TX,0,5,5,5,15
Tropical Storm,Barry,5,2001-08-03T15:00:00Z,MMMD 210N 897W,0,0,0,2,2
Tropical Storm,Barry,5,2001-08-03T15:00:00Z,FREEPORT TX,0,3,5,5,13
Tropical Storm,Barry,5,2001-08-03T15:00:00Z,VENICE FL,0,0,0,2,2
Tropical Storm,Barry,5,2001-08-03T15:00:00Z,PORT O CONNOR TX,0,1,3,6,10
Tropical Storm,Barry,5,2001-08-03T15:00:00Z,TAMPA FL,0,0,0,3,3
Tropical Storm,Barry,5,2001-08-03T15:00:00Z,CORPUSCHRISTI TX,0,0,1,5,6
Tropical Storm,Barry,5,2001-08-03T15:00:00Z,CEDAR KEY FL,0,0,1,2,3
Tropical Storm,Barry,5,2001-08-03T15:00:00Z,BROWNSVILLE TX,0,0,0,4,4
Tropical Storm,Barry,5,2001-08-03T15:00:00Z,ST MARKS FL,0,0,1,4,5
Tropical Storm,Barry,5,2001-08-03T15:00:00Z,GULF 29N 85W,1,3,2,3,9
Tropical Storm,Barry,5,2001-08-03T15:00:00Z,APALACHICOLA FL,0,2,2,4,8
Tropical Storm,Barry,5,2001-08-03T15:00:00Z,GULF 29N 87W,12,3,2,2,19
Tropical Storm,Barry,5,2001-08-03T15:00:00Z,PANAMA CITY FL,1,2,2,5,10
Tropical Storm,Barry,5,2001-08-03T15:00:00Z,GULF 28N 89W,46,0,0,0,46
Tropical Storm,Barry,5,2001-08-03T15:00:00Z,PENSACOLA FL,2,4,3,5,14
Tropical Storm,Barry,5,2001-08-03T15:00:00Z,GULF 28N 91W,21,3,1,1,26
Tropical Storm,Barry,5,2001-08-03T15:00:00Z,MOBILE AL,2,6,4,4,16
Tropical Storm,Barry,5,2001-08-03T15:00:00Z,GULF 28N 93W,5,8,4,3,20
Tropical Storm,Barry,5,2001-08-03T15:00:00Z,GULFPORT MS,5,7,4,3,19
Tropical Storm,Barry,5,2001-08-03T15:00:00Z,GULF 28N 95W,0,4,4,6,14
Tropical Storm,Barry,5,2001-08-03T15:00:00Z,BURAS LA,15,4,3,1,23
Tropical Storm,Barry,5,2001-08-03T15:00:00Z,GULF 27N 96W,0,1,2,6,9
Tropical Storm,Barry,5,2001-08-03T15:00:00Z,NEW ORLEANS LA,8,8,3,3,22
Tropical Storm,Barry,5,2001-08-03T15:00:00Z,GULF 25N 96W,0,0,1,4,5
Tropical Storm,Barry,6,2001-08-03T21:00:00Z,27.3N  88.8W,53,0,0,0,53
Tropical Storm,Barry,6,2001-08-03T21:00:00Z,NEW IBERIA LA,1,10,5,4,20
Tropical Storm,Barry,6,2001-08-03T21:00:00Z,27.5N  89.6W,33,1,0,1,35
Tropical Storm,Barry,6,2001-08-03T21:00:00Z,PORT ARTHUR TX,0,4,7,5,16
Tropical Storm,Barry,6,2001-08-03T21:00:00Z,27.8N  90.4W,22,3,1,1,27
Tropical Storm,Barry,6,2001-08-03T21:00:00Z,GALVESTON TX,0,3,6,6,15
Tropical Storm,Barry,6,2001-08-03T21:00:00Z,JACKSONVILLE FL,0,0,0,2,2
Tropical Storm,Barry,6,2001-08-03T21:00:00Z,FREEPORT TX,0,2,5,6,13
Tropical Storm,Barry,6,2001-08-03T21:00:00Z,FT MYERS FL,0,0,0,2,2
Tropical Storm,Barry,6,2001-08-03T21:00:00Z,PORT O CONNOR TX,0,0,4,6,10
Tropical Storm,Barry,6,2001-08-03T21:00:00Z,VENICE FL,0,0,1,2,3
Tropical Storm,Barry,6,2001-08-03T21:00:00Z,CORPUSCHRISTI TX,0,0,1,5,6
Tropical Storm,Barry,6,2001-08-03T21:00:00Z,TAMPA FL,0,0,0,3,3
Tropical Storm,Barry,6,2001-08-03T21:00:00Z,BROWNSVILLE TX,0,0,0,4,4
Tropical Storm,Barry,6,2001-08-03T21:00:00Z,CEDAR KEY FL,0,0,1,3,4
Tropical Storm,Barry,6,2001-08-03T21:00:00Z,GULF 29N 85W,2,2,2,4,10
Tropical Storm,Barry,6,2001-08-03T21:00:00Z,ST MARKS FL,0,0,1,5,6
Tropical Storm,Barry,6,2001-08-03T21:00:00Z,GULF 29N 87W,15,2,1,2,20
Tropical Storm,Barry,6,2001-08-03T21:00:00Z,APALACHICOLA FL,1,1,2,5,9
Tropical Storm,Barry,6,2001-08-03T21:00:00Z,GULF 28N 89W,37,0,0,1,38
Tropical Storm,Barry,6,2001-08-03T21:00:00Z,PANAMA CITY FL,1,2,2,5,10
Tropical Storm,Barry,6,2001-08-03T21:00:00Z,GULF 28N 91W,16,6,2,1,25
Tropical Storm,Barry,6,2001-08-03T21:00:00Z,PENSACOLA FL,2,3,3,5,13
Tropical Storm,Barry,6,2001-08-03T21:00:00Z,GULF 28N 93W,2,10,4,3,19
Tropical Storm,Barry,6,2001-08-03T21:00:00Z,MOBILE AL,2,4,4,5,15
Tropical Storm,Barry,6,2001-08-03T21:00:00Z,GULF 28N 95W,0,3,5,5,13
Tropical Storm,Barry,6,2001-08-03T21:00:00Z,GULFPORT MS,3,6,5,4,18
Tropical Storm,Barry,6,2001-08-03T21:00:00Z,GULF 27N 96W,0,0,3,5,8
Tropical Storm,Barry,6,2001-08-03T21:00:00Z,BURAS LA,12,5,3,2,22
Tropical Storm,Barry,6,2001-08-03T21:00:00Z,GULF 25N 96W,0,0,0,4,4
Tropical Storm,Barry,6,2001-08-03T21:00:00Z,NEW ORLEANS LA,4,9,4,3,20
Tropical Storm,Barry,7,2001-08-04T03:00:00Z,27.0N  88.9W,56,0,0,0,56
Tropical Storm,Barry,7,2001-08-04T03:00:00Z,NEW ORLEANS LA,3,9,5,4,21
Tropical Storm,Barry,7,2001-08-04T03:00:00Z,27.4N  89.9W,29,1,1,0,31
Tropical Storm,Barry,7,2001-08-04T03:00:00Z,NEW IBERIA LA,1,9,7,3,20
Tropical Storm,Barry,7,2001-08-04T03:00:00Z,28.3N  90.4W,17,7,1,1,26
Tropical Storm,Barry,7,2001-08-04T03:00:00Z,PORT ARTHUR TX,0,4,8,4,16
Tropical Storm,Barry,7,2001-08-04T03:00:00Z,DAYTONA BEACH FL,0,0,0,2,2
Tropical Storm,Barry,7,2001-08-04T03:00:00Z,GALVESTON TX,0,3,7,5,15
Tropical Storm,Barry,7,2001-08-04T03:00:00Z,JACKSONVILLE FL,0,0,0,2,2
Tropical Storm,Barry,7,2001-08-04T03:00:00Z,FREEPORT TX,0,2,6,5,13
Tropical Storm,Barry,7,2001-08-04T03:00:00Z,SAVANNAH GA,0,0,0,2,2
Tropical Storm,Barry,7,2001-08-04T03:00:00Z,PORT O CONNOR TX,0,1,3,5,9
Tropical Storm,Barry,7,2001-08-04T03:00:00Z,FT MYERS FL,0,0,0,2,2
Tropical Storm,Barry,7,2001-08-04T03:00:00Z,CORPUSCHRISTI TX,0,0,1,4,5
Tropical Storm,Barry,7,2001-08-04T03:00:00Z,VENICE FL,0,0,1,2,3
Tropical Storm,Barry,7,2001-08-04T03:00:00Z,BROWNSVILLE TX,0,0,0,3,3
Tropical Storm,Barry,7,2001-08-04T03:00:00Z,TAMPA FL,0,0,1,3,4
Tropical Storm,Barry,7,2001-08-04T03:00:00Z,GULF 29N 85W,1,2,3,5,11
Tropical Storm,Barry,7,2001-08-04T03:00:00Z,CEDAR KEY FL,0,0,1,4,5
Tropical Storm,Barry,7,2001-08-04T03:00:00Z,GULF 29N 87W,12,2,3,2,19
Tropical Storm,Barry,7,2001-08-04T03:00:00Z,ST MARKS FL,0,0,1,6,7
Tropical Storm,Barry,7,2001-08-04T03:00:00Z,GULF 28N 89W,36,0,0,1,37
Tropical Storm,Barry,7,2001-08-04T03:00:00Z,APALACHICOLA FL,0,2,2,6,10
Tropical Storm,Barry,7,2001-08-04T03:00:00Z,GULF 28N 91W,14,9,2,1,26
Tropical Storm,Barry,7,2001-08-04T03:00:00Z,PANAMA CITY FL,1,1,3,6,11
Tropical Storm,Barry,7,2001-08-04T03:00:00Z,GULF 28N 93W,2,11,4,3,20
Tropical Storm,Barry,7,2001-08-04T03:00:00Z,PENSACOLA FL,1,3,5,5,14
Tropical Storm,Barry,7,2001-08-04T03:00:00Z,GULF 28N 95W,0,3,6,4,13
Tropical Storm,Barry,7,2001-08-04T03:00:00Z,MOBILE AL,1,4,6,5,16
Tropical Storm,Barry,7,2001-08-04T03:00:00Z,GULF 27N 96W,0,1,2,5,8
Tropical Storm,Barry,7,2001-08-04T03:00:00Z,GULFPORT MS,2,6,6,4,18
Tropical Storm,Barry,7,2001-08-04T03:00:00Z,GULF 25N 96W,0,0,0,3,3
Tropical Storm,Barry,7,2001-08-04T03:00:00Z,BURAS LA,10,6,4,2,22
Tropical Storm,Barry,8,2001-08-04T09:00:00Z,27.3N  88.8W,99,0,0,0,99
Tropical Storm,Barry,8,2001-08-04T09:00:00Z,BURAS LA,16,4,3,1,24
Tropical Storm,Barry,8,2001-08-04T09:00:00Z,28.0N  89.0W,40,1,0,0,41
Tropical Storm,Barry,8,2001-08-04T09:00:00Z,NEW ORLEANS LA,9,8,3,3,23
Tropical Storm,Barry,8,2001-08-04T09:00:00Z,29.0N  89.5W,22,2,2,1,27
Tropical Storm,Barry,8,2001-08-04T09:00:00Z,NEW IBERIA LA,3,9,5,3,20
Tropical Storm,Barry,8,2001-08-04T09:00:00Z,DAYTONA BEACH FL,0,0,0,2,2
Tropical Storm,Barry,8,2001-08-04T09:00:00Z,PORT ARTHUR TX,0,3,6,5,14
Tropical Storm,Barry,8,2001-08-04T09:00:00Z,JACKSONVILLE FL,0,0,0,3,3
Tropical Storm,Barry,8,2001-08-04T09:00:00Z,GALVESTON TX,0,1,4,6,11
Tropical Storm,Barry,8,2001-08-04T09:00:00Z,SAVANNAH GA,0,0,0,2,2
Tropical Storm,Barry,8,2001-08-04T09:00:00Z,FREEPORT TX,0,0,2,6,8
Tropical Storm,Barry,8,2001-08-04T09:00:00Z,MARCO ISLAND FL,0,0,0,2,2
Tropical Storm,Barry,8,2001-08-04T09:00:00Z,PORT O CONNOR TX,0,0,1,4,5
Tropical Storm,Barry,8,2001-08-04T09:00:00Z,FT MYERS FL,0,0,0,2,2
Tropical Storm,Barry,8,2001-08-04T09:00:00Z,CORPUSCHRISTI TX,0,0,0,3,3
Tropical Storm,Barry,8,2001-08-04T09:00:00Z,VENICE FL,0,0,0,3,3
Tropical Storm,Barry,8,2001-08-04T09:00:00Z,GULF 29N 85W,1,1,3,6,11
Tropical Storm,Barry,8,2001-08-04T09:00:00Z,TAMPA FL,0,0,0,4,4
Tropical Storm,Barry,8,2001-08-04T09:00:00Z,GULF 29N 87W,15,2,2,2,21
Tropical Storm,Barry,8,2001-08-04T09:00:00Z,CEDAR KEY FL,0,0,0,5,5
Tropical Storm,Barry,8,2001-08-04T09:00:00Z,GULF 28N 89W,40,1,0,0,41
Tropical Storm,Barry,8,2001-08-04T09:00:00Z,ST MARKS FL,0,0,1,6,7
Tropical Storm,Barry,8,2001-08-04T09:00:00Z,GULF 28N 91W,17,4,2,1,24
Tropical Storm,Barry,8,2001-08-04T09:00:00Z,APALACHICOLA FL,0,1,3,6,10
Tropical Storm,Barry,8,2001-08-04T09:00:00Z,GULF 28N 93W,2,5,4,4,15
Tropical Storm,Barry,8,2001-08-04T09:00:00Z,PANAMA CITY FL,0,2,3,7,12
Tropical Storm,Barry,8,2001-08-04T09:00:00Z,GULF 28N 95W,0,0,2,6,8
Tropical Storm,Barry,8,2001-08-04T09:00:00Z,PENSACOLA FL,2,4,5,5,16
Tropical Storm,Barry,8,2001-08-04T09:00:00Z,GULF 27N 96W,0,0,0,4,4
Tropical Storm,Barry,8,2001-08-04T09:00:00Z,MOBILE AL,3,6,5,4,18
Tropical Storm,Barry,8,2001-08-04T09:00:00Z,GULF 25N 96W,0,0,0,2,2
Tropical Storm,Barry,8,2001-08-04T09:00:00Z,GULFPORT MS,6,7,5,3,21
Tropical Storm,Barry,9,2001-08-04T15:00:00Z,28.0N  88.5W,52,0,0,0,52
Tropical Storm,Barry,9,2001-08-04T15:00:00Z,BURAS LA,26,2,1,1,30
Tropical Storm,Barry,9,2001-08-04T15:00:00Z,29.0N  88.5W,34,0,1,0,35
Tropical Storm,Barry,9,2001-08-04T15:00:00Z,NEW ORLEANS LA,16,7,2,1,26
Tropical Storm,Barry,9,2001-08-04T15:00:00Z,30.5N  88.8W,15,7,4,1,27
Tropical Storm,Barry,9,2001-08-04T15:00:00Z,NEW IBERIA LA,4,8,4,3,19
Tropical Storm,Barry,9,2001-08-04T15:00:00Z,DAYTONA BEACH FL,0,0,0,2,2
Tropical Storm,Barry,9,2001-08-04T15:00:00Z,PORT ARTHUR TX,0,1,2,7,10
Tropical Storm,Barry,9,2001-08-04T15:00:00Z,JACKSONVILLE FL,0,0,0,3,3
Tropical Storm,Barry,9,2001-08-04T15:00:00Z,GALVESTON TX,0,0,1,5,6
Tropical Storm,Barry,9,2001-08-04T15:00:00Z,SAVANNAH GA,0,0,0,2,2
Tropical Storm,Barry,9,2001-08-04T15:00:00Z,FREEPORT TX,0,0,0,5,5
Tropical Storm,Barry,9,2001-08-04T15:00:00Z,VENICE FL,0,0,0,2,2
Tropical Storm,Barry,9,2001-08-04T15:00:00Z,PORT O CONNOR TX,0,0,0,3,3
Tropical Storm,Barry,9,2001-08-04T15:00:00Z,TAMPA FL,0,0,0,3,3
Tropical Storm,Barry,9,2001-08-04T15:00:00Z,GULF 29N 85W,2,2,4,3,11
Tropical Storm,Barry,9,2001-08-04T15:00:00Z,CEDAR KEY FL,0,0,0,5,5
Tropical Storm,Barry,9,2001-08-04T15:00:00Z,GULF 29N 87W,21,2,1,1,25
Tropical Storm,Barry,9,2001-08-04T15:00:00Z,ST MARKS FL,0,0,2,6,8
Tropical Storm,Barry,9,2001-08-04T15:00:00Z,GULF 28N 89W,44,1,0,0,45
Tropical Storm,Barry,9,2001-08-04T15:00:00Z,APALACHICOLA FL,1,1,5,4,11
Tropical Storm,Barry,9,2001-08-04T15:00:00Z,GULF 28N 91W,13,4,2,1,20
Tropical Storm,Barry,9,2001-08-04T15:00:00Z,PANAMA CITY FL,2,3,5,4,14
Tropical Storm,Barry,9,2001-08-04T15:00:00Z,GULF 28N 93W,0,2,2,5,9
Tropical Storm,Barry,9,2001-08-04T15:00:00Z,PENSACOLA FL,7,6,6,2,21
Tropical Storm,Barry,9,2001-08-04T15:00:00Z,GULF 28N 95W,0,0,0,4,4
Tropical Storm,Barry,9,2001-08-04T15:00:00Z,MOBILE AL,11,8,4,2,25
Tropical Storm,Barry,9,2001-08-04T15:00:00Z,GULF 27N 96W,0,0,0,2,2
Tropical Storm,Barry,9,2001-08-04T15:00:00Z,GULFPORT MS,16,8,2,1,27
Tropical Storm,Barry,10,2001-08-04T21:00:00Z,29.0N  87.3W,52,0,0,0,52
Tropical Storm,Barry,10,2001-08-04T21:00:00Z,MOBILE AL,23,9,1,0,33
Tropical Storm,Barry,10,2001-08-04T21:00:00Z,31.0N  87.3W,23,11,0,0,34
Tropical Storm,Barry,10,2001-08-04T21:00:00Z,GULFPORT MS,18,9,1,0,28
Tropical Storm,Barry,10,2001-08-04T21:00:00Z,33.0N  88.0W,1,20,3,1,25
Tropical Storm,Barry,10,2001-08-04T21:00:00Z,BURAS LA,21,3,1,0,25
Tropical Storm,Barry,10,2001-08-04T21:00:00Z,JACKSONVILLE FL,0,0,0,3,3
Tropical Storm,Barry,10,2001-08-04T21:00:00Z,NEW ORLEANS LA,7,9,2,1,19
Tropical Storm,Barry,10,2001-08-04T21:00:00Z,SAVANNAH GA,0,0,0,3,3
Tropical Storm,Barry,10,2001-08-04T21:00:00Z,NEW IBERIA LA,0,3,4,3,10
Tropical Storm,Barry,10,2001-08-04T21:00:00Z,CHARLESTON SC,0,0,0,2,2
Tropical Storm,Barry,10,2001-08-04T21:00:00Z,PORT ARTHUR TX,0,0,1,3,4
Tropical Storm,Barry,10,2001-08-04T21:00:00Z,TAMPA FL,0,0,0,2,2
Tropical Storm,Barry,10,2001-08-04T21:00:00Z,GALVESTON TX,0,0,0,2,2
Tropical Storm,Barry,10,2001-08-04T21:00:00Z,CEDAR KEY FL,0,1,1,2,4
Tropical Storm,Barry,10,2001-08-04T21:00:00Z,GULF 29N 85W,15,2,1,0,18
Tropical Storm,Barry,10,2001-08-04T21:00:00Z,ST MARKS FL,4,7,1,1,13
Tropical Storm,Barry,10,2001-08-04T21:00:00Z,GULF 29N 87W,50,0,0,0,50
Tropical Storm,Barry,10,2001-08-04T21:00:00Z,APALACHICOLA FL,14,4,1,0,19
Tropical Storm,Barry,10,2001-08-04T21:00:00Z,GULF 28N 89W,35,0,1,0,36
Tropical Storm,Barry,10,2001-08-04T21:00:00Z,PANAMA CITY FL,22,3,0,1,26
Tropical Storm,Barry,10,2001-08-04T21:00:00Z,GULF 28N 91W,3,5,1,1,10
Tropical Storm,Barry,10,2001-08-04T21:00:00Z,PENSACOLA FL,32,4,0,0,36
Tropical Storm,Barry,10,2001-08-04T21:00:00Z,GULF 28N 93W,0,0,1,2,3
Tropical Storm,Barry,11,2001-08-05T03:00:00Z,29.2N  87.0W,51,1,0,0,52
Tropical Storm,Barry,11,2001-08-05T03:00:00Z,GULFPORT MS,11,11,1,0,23
Tropical Storm,Barry,11,2001-08-05T03:00:00Z,31.2N  87.0W,23,10,1,0,34
Tropical Storm,Barry,11,2001-08-05T03:00:00Z,BURAS LA,10,7,1,1,19
Tropical Storm,Barry,11,2001-08-05T03:00:00Z,33.2N  87.8W,1,19,5,1,26
Tropical Storm,Barry,11,2001-08-05T03:00:00Z,NEW ORLEANS LA,2,8,4,1,15
Tropical Storm,Barry,11,2001-08-05T03:00:00Z,JACKSONVILLE FL,0,0,0,2,2
Tropical Storm,Barry,11,2001-08-05T03:00:00Z,NEW IBERIA LA,0,1,4,3,8
Tropical Storm,Barry,11,2001-08-05T03:00:00Z,SAVANNAH GA,0,0,1,2,3
Tropical Storm,Barry,11,2001-08-05T03:00:00Z,PORT ARTHUR TX,0,0,1,3,4
Tropical Storm,Barry,11,2001-08-05T03:00:00Z,CHARLESTON SC,0,0,0,2,2
Tropical Storm,Barry,11,2001-08-05T03:00:00Z,GALVESTON TX,0,0,0,2,2
Tropical Storm,Barry,11,2001-08-05T03:00:00Z,CEDAR KEY FL,0,1,1,1,3
Tropical Storm,Barry,11,2001-08-05T03:00:00Z,GULF 29N 85W,18,2,0,0,20
Tropical Storm,Barry,11,2001-08-05T03:00:00Z,ST MARKS FL,7,7,0,1,15
Tropical Storm,Barry,11,2001-08-05T03:00:00Z,GULF 29N 87W,56,0,0,0,56
Tropical Storm,Barry,11,2001-08-05T03:00:00Z,APALACHICOLA FL,19,3,0,0,22
Tropical Storm,Barry,11,2001-08-05T03:00:00Z,GULF 28N 89W,22,0,1,0,23
Tropical Storm,Barry,11,2001-08-05T03:00:00Z,PANAMA CITY FL,28,2,0,0,30
Tropical Storm,Barry,11,2001-08-05T03:00:00Z,GULF 28N 91W,0,3,2,1,6
Tropical Storm,Barry,11,2001-08-05T03:00:00Z,PENSACOLA FL,33,2,0,1,36
Tropical Storm,Barry,11,2001-08-05T03:00:00Z,GULF 28N 93W,0,0,1,1,2
Tropical Storm,Barry,11,2001-08-05T03:00:00Z,MOBILE AL,19,9,1,0,29
Tropical Storm,Barry,12,2001-08-05T09:00:00Z,30.2N  86.6W,38,1,0,0,39
Tropical Storm,Barry,12,2001-08-05T09:00:00Z,MOBILE AL,20,2,1,0,23
Tropical Storm,Barry,12,2001-08-05T09:00:00Z,31.8N  87.1W,23,2,1,0,26
Tropical Storm,Barry,12,2001-08-05T09:00:00Z,GULFPORT MS,11,4,2,2,19
Tropical Storm,Barry,12,2001-08-05T09:00:00Z,32.9N  88.0W,10,10,1,2,23
Tropical Storm,Barry,12,2001-08-05T09:00:00Z,BURAS LA,5,5,2,2,14
Tropical Storm,Barry,12,2001-08-05T09:00:00Z,JACKSONVILLE FL,0,0,1,2,3
Tropical Storm,Barry,12,2001-08-05T09:00:00Z,NEW ORLEANS LA,2,4,3,4,13
Tropical Storm,Barry,12,2001-08-05T09:00:00Z,SAVANNAH GA,0,0,0,3,3
Tropical Storm,Barry,12,2001-08-05T09:00:00Z,NEW IBERIA LA,0,1,2,5,8
Tropical Storm,Barry,12,2001-08-05T09:00:00Z,CHARLESTON SC,0,0,0,2,2
Tropical Storm,Barry,12,2001-08-05T09:00:00Z,PORT ARTHUR TX,0,0,0,4,4
Tropical Storm,Barry,12,2001-08-05T09:00:00Z,VENICE FL,0,0,1,1,2
Tropical Storm,Barry,12,2001-08-05T09:00:00Z,GALVESTON TX,0,0,0,3,3
Tropical Storm,Barry,12,2001-08-05T09:00:00Z,TAMPA FL,0,1,0,2,3
Tropical Storm,Barry,12,2001-08-05T09:00:00Z,FREEPORT TX,0,0,0,2,2
Tropical Storm,Barry,12,2001-08-05T09:00:00Z,CEDAR KEY FL,2,1,1,2,6
Tropical Storm,Barry,12,2001-08-05T09:00:00Z,GULF 29N 85W,27,0,1,0,28
Tropical Storm,Barry,12,2001-08-05T09:00:00Z,ST MARKS FL,12,2,0,1,15
Tropical Storm,Barry,12,2001-08-05T09:00:00Z,GULF 29N 87W,56,0,0,0,56
Tropical Storm,Barry,12,2001-08-05T09:00:00Z,APALACHICOLA FL,25,0,1,0,26
Tropical Storm,Barry,12,2001-08-05T09:00:00Z,GULF 28N 89W,5,4,1,1,11
Tropical Storm,Barry,12,2001-08-05T09:00:00Z,PANAMA CITY FL,33,0,0,0,33
Tropical Storm,Barry,12,2001-08-05T09:00:00Z,GULF 28N 91W,0,1,1,4,6
Tropical Storm,Barry,12,2001-08-05T09:00:00Z,PENSACOLA FL,33,1,0,0,34
Tropical Storm,Barry,12,2001-08-05T09:00:00Z,GULF 28N 93W,0,0,0,3,3
Tropical Storm,Barry,14,2001-08-05T15:00:00Z,31.1N  86.7W,38,0,0,0,38
Tropical Storm,Barry,14,2001-08-05T15:00:00Z,PENSACOLA FL,39,0,0,0,39
Tropical Storm,Barry,14,2001-08-05T15:00:00Z,32.4N  87.4W,23,2,0,1,26
Tropical Storm,Barry,14,2001-08-05T15:00:00Z,MOBILE AL,21,1,0,1,23
Tropical Storm,Barry,14,2001-08-05T15:00:00Z,33.3N  88.1W,14,5,1,1,21
Tropical Storm,Barry,14,2001-08-05T15:00:00Z,GULFPORT MS,11,3,1,2,17
Tropical Storm,Barry,14,2001-08-05T15:00:00Z,DAYTONA BEACH FL,0,0,1,2,3
Tropical Storm,Barry,14,2001-08-05T15:00:00Z,BURAS LA,4,3,2,2,11
Tropical Storm,Barry,14,2001-08-05T15:00:00Z,JACKSONVILLE FL,0,1,2,2,5
Tropical Storm,Barry,14,2001-08-05T15:00:00Z,NEW ORLEANS LA,2,4,2,3,11
Tropical Storm,Barry,14,2001-08-05T15:00:00Z,SAVANNAH GA,0,0,1,3,4
Tropical Storm,Barry,14,2001-08-05T15:00:00Z,NEW IBERIA LA,0,1,2,4,7
Tropical Storm,Barry,14,2001-08-05T15:00:00Z,CHARLESTON SC,0,0,0,2,2
Tropical Storm,Barry,14,2001-08-05T15:00:00Z,PORT ARTHUR TX,0,0,0,3,3
Tropical Storm,Barry,14,2001-08-05T15:00:00Z,VENICE FL,0,1,0,1,2
Tropical Storm,Barry,14,2001-08-05T15:00:00Z,GALVESTON TX,0,0,0,2,2
Tropical Storm,Barry,14,2001-08-05T15:00:00Z,TAMPA FL,0,1,1,2,4
Tropical Storm,Barry,14,2001-08-05T15:00:00Z,GULF 29N 85W,40,0,0,0,40
Tropical Storm,Barry,14,2001-08-05T15:00:00Z,CEDAR KEY FL,3,2,1,2,8
Tropical Storm,Barry,14,2001-08-05T15:00:00Z,GULF 29N 87W,99,0,0,0,99
Tropical Storm,Barry,14,2001-08-05T15:00:00Z,ST MARKS FL,16,1,1,0,18
Tropical Storm,Barry,14,2001-08-05T15:00:00Z,GULF 28N 89W,2,2,1,2,7
Tropical Storm,Barry,14,2001-08-05T15:00:00Z,APALACHICOLA FL,35,0,0,0,35
Tropical Storm,Barry,14,2001-08-05T15:00:00Z,GULF 28N 91W,0,0,1,3,4
Tropical Storm,Barry,14,2001-08-05T15:00:00Z,PANAMA CITY FL,48,0,0,0,48
Tropical Storm,Barry,14,2001-08-05T15:00:00Z,GULF 28N 93W,0,0,0,2,2
Tropical Storm,Barry,15,2001-08-05T21:00:00Z,31.7N  86.9W,37,1,0,0,38
Tropical Storm,Barry,15,2001-08-05T21:00:00Z,GULFPORT MS,7,4,2,2,15
Tropical Storm,Barry,15,2001-08-05T21:00:00Z,33.0N  87.7W,25,1,0,1,27
Tropical Storm,Barry,15,2001-08-05T21:00:00Z,BURAS LA,1,3,2,3,9
Tropical Storm,Barry,15,2001-08-05T21:00:00Z,33.5N  88.5W,16,5,1,1,23
Tropical Storm,Barry,15,2001-08-05T21:00:00Z,NEW ORLEANS LA,1,2,2,5,10
Tropical Storm,Barry,15,2001-08-05T21:00:00Z,JACKSONVILLE FL,0,0,1,2,3
Tropical Storm,Barry,15,2001-08-05T21:00:00Z,NEW IBERIA LA,0,0,2,5,7
Tropical Storm,Barry,15,2001-08-05T21:00:00Z,SAVANNAH GA,0,0,0,2,2
Tropical Storm,Barry,15,2001-08-05T21:00:00Z,PORT ARTHUR TX,0,0,0,4,4
Tropical Storm,Barry,15,2001-08-05T21:00:00Z,TAMPA FL,0,0,1,1,2
Tropical Storm,Barry,15,2001-08-05T21:00:00Z,GALVESTON TX,0,0,0,2,2
Tropical Storm,Barry,15,2001-08-05T21:00:00Z,CEDAR KEY FL,1,1,0,2,4
Tropical Storm,Barry,15,2001-08-05T21:00:00Z,FREEPORT TX,0,0,0,2,2
Tropical Storm,Barry,15,2001-08-05T21:00:00Z,ST MARKS FL,12,1,0,1,14
Tropical Storm,Barry,15,2001-08-05T21:00:00Z,GULF 29N 85W,36,0,0,0,36
Tropical Storm,Barry,15,2001-08-05T21:00:00Z,APALACHICOLA FL,31,0,0,0,31
Tropical Storm,Barry,15,2001-08-05T21:00:00Z,GULF 29N 87W,99,0,0,0,99
Tropical Storm,Barry,15,2001-08-05T21:00:00Z,PANAMA CITY FL,47,0,0,0,47
Tropical Storm,Barry,15,2001-08-05T21:00:00Z,GULF 28N 89W,0,1,1,3,5
Tropical Storm,Barry,15,2001-08-05T21:00:00Z,PENSACOLA FL,42,0,0,0,42
Tropical Storm,Barry,15,2001-08-05T21:00:00Z,GULF 28N 91W,0,0,0,4,4
Tropical Storm,Barry,15,2001-08-05T21:00:00Z,MOBILE AL,20,1,1,1,23
Tropical Storm,Barry,15,2001-08-05T21:00:00Z,GULF 28N 93W,0,0,0,2,2
Tropical Storm,Barry,16,2001-08-06T03:00:00Z,32.2N  87.1W,37,1,0,0,38
Tropical Storm,Barry,16,2001-08-06T03:00:00Z,BURAS LA,0,2,2,3,7
Tropical Storm,Barry,16,2001-08-06T03:00:00Z,33.5N  88.0W,24,1,1,1,27
Tropical Storm,Barry,16,2001-08-06T03:00:00Z,NEW ORLEANS LA,0,2,2,4,8
Tropical Storm,Barry,16,2001-08-06T03:00:00Z,34.0N  89.0W,15,5,2,1,23
Tropical Storm,Barry,16,2001-08-06T03:00:00Z,NEW IBERIA LA,0,0,1,5,6
Tropical Storm,Barry,16,2001-08-06T03:00:00Z,JACKSONVILLE FL,0,0,1,1,2
Tropical Storm,Barry,16,2001-08-06T03:00:00Z,PORT ARTHUR TX,0,0,0,4,4
Tropical Storm,Barry,16,2001-08-06T03:00:00Z,SAVANNAH GA,0,0,0,2,2
Tropical Storm,Barry,16,2001-08-06T03:00:00Z,GALVESTON TX,0,0,0,2,2
Tropical Storm,Barry,16,2001-08-06T03:00:00Z,CEDAR KEY FL,1,0,1,1,3
Tropical Storm,Barry,16,2001-08-06T03:00:00Z,FREEPORT TX,0,0,0,2,2
Tropical Storm,Barry,16,2001-08-06T03:00:00Z,ST MARKS FL,14,1,0,1,16
Tropical Storm,Barry,16,2001-08-06T03:00:00Z,GULF 29N 85W,43,0,0,0,43
Tropical Storm,Barry,16,2001-08-06T03:00:00Z,APALACHICOLA FL,48,0,0,0,48
Tropical Storm,Barry,16,2001-08-06T03:00:00Z,GULF 29N 87W,99,0,0,0,99
Tropical Storm,Barry,16,2001-08-06T03:00:00Z,PANAMA CITY FL,99,0,0,0,99
Tropical Storm,Barry,16,2001-08-06T03:00:00Z,GULF 28N 89W,0,1,0,3,4
Tropical Storm,Barry,16,2001-08-06T03:00:00Z,PENSACOLA FL,99,0,0,0,99
Tropical Storm,Barry,16,2001-08-06T03:00:00Z,GULF 28N 91W,0,0,0,3,3
Tropical Storm,Barry,16,2001-08-06T03:00:00Z,MOBILE AL,14,2,1,1,18
Tropical Storm,Barry,16,2001-08-06T03:00:00Z,GULF 28N 93W,0,0,0,2,2
Tropical Storm,Barry,16,2001-08-06T03:00:00Z,GULFPORT MS,4,4,2,3,13
Tropical Depression,Four,1,2001-08-15T15:00:00Z,12.5N  52.0W,48,0,0,0,48
Tropical Depression,Four,1,2001-08-15T15:00:00Z,TAPA 171N 618W,0,0,10,8,18
Tropical Depression,Four,1,2001-08-15T15:00:00Z,13.0N  55.0W,5,28,0,0,33
Tropical Depression,Four,1,2001-08-15T15:00:00Z,TKPK 173N 627W,0,0,6,11,17
Tropical Depression,Four,1,2001-08-15T15:00:00Z,13.5N  58.0W,0,12,14,1,27
Tropical Depression,Four,1,2001-08-15T15:00:00Z,TNCM 181N 631W,0,0,4,11,15
Tropical Depression,Four,1,2001-08-15T15:00:00Z,SVMG 110N 640W,0,0,0,8,8
Tropical Depression,Four,1,2001-08-15T15:00:00Z,TISX 177N 648W,0,0,1,12,13
Tropical Depression,Four,1,2001-08-15T15:00:00Z,TTPP 106N 614W,0,0,2,11,13
Tropical Depression,Four,1,2001-08-15T15:00:00Z,TIST 183N 650W,0,0,1,12,13
Tropical Depression,Four,1,2001-08-15T15:00:00Z,TTPT 112N 608W,0,0,5,10,15
Tropical Depression,Four,1,2001-08-15T15:00:00Z,TJPS 180N 666W,0,0,0,10,10
Tropical Depression,Four,1,2001-08-15T15:00:00Z,TGPY 120N 618W,0,0,4,11,15
Tropical Depression,Four,1,2001-08-15T15:00:00Z,MDSD 185N 697W,0,0,0,3,3
Tropical Depression,Four,1,2001-08-15T15:00:00Z,TBPB 131N 595W,0,2,17,3,22
Tropical Depression,Four,1,2001-08-15T15:00:00Z,TJSJ 184N 661W,0,0,0,10,10
Tropical Depression,Four,1,2001-08-15T15:00:00Z,TVSV 131N 612W,0,0,10,9,19
Tropical Depression,Four,1,2001-08-15T15:00:00Z,MDPP 198N 707W,0,0,0,2,2
Tropical Depression,Four,1,2001-08-15T15:00:00Z,TLPL 138N 610W,0,0,13,7,20
Tropical Depression,Four,1,2001-08-15T15:00:00Z,ST CROIX VI,0,0,1,12,13
Tropical Depression,Four,1,2001-08-15T15:00:00Z,TFFF 146N 610W,0,0,15,6,21
Tropical Depression,Four,1,2001-08-15T15:00:00Z,ST THOMAS VI,0,0,1,12,13
Tropical Depression,Four,1,2001-08-15T15:00:00Z,TDPR 153N 614W,0,0,13,7,20
Tropical Depression,Four,1,2001-08-15T15:00:00Z,SAN JUAN PR,0,0,0,10,10
Tropical Depression,Four,1,2001-08-15T15:00:00Z,TFFR 163N 615W,0,0,12,8,20
Tropical Depression,Four,1,2001-08-15T15:00:00Z,PONCE PR,0,0,0,10,10
Tropical Depression,Four,2,2001-08-15T21:00:00Z,13.0N  54.0W,50,2,0,0,52
Tropical Depression,Four,2,2001-08-15T21:00:00Z,TKPK 173N 627W,0,0,7,12,19
Tropical Depression,Four,2,2001-08-15T21:00:00Z,13.5N  57.5W,1,34,1,0,36
Tropical Depression,Four,2,2001-08-15T21:00:00Z,TNCM 181N 631W,0,0,3,13,16
Tropical Depression,Four,2,2001-08-15T21:00:00Z,14.0N  61.0W,0,3,24,1,28
Tropical Depression,Four,2,2001-08-15T21:00:00Z,TISX 177N 648W,0,0,1,17,18
Tropical Depression,Four,2,2001-08-15T21:00:00Z,TNCC 122N 690W,0,0,0,4,4
Tropical Depression,Four,2,2001-08-15T21:00:00Z,TIST 183N 650W,0,0,0,16,16
Tropical Depression,Four,2,2001-08-15T21:00:00Z,SVMG 110N 640W,0,0,2,6,8
Tropical Depression,Four,2,2001-08-15T21:00:00Z,TJPS 180N 666W,0,0,0,17,17
Tropical Depression,Four,2,2001-08-15T21:00:00Z,TTPP 106N 614W,0,0,5,2,7
Tropical Depression,Four,2,2001-08-15T21:00:00Z,MDSD 185N 697W,0,0,0,10,10
Tropical Depression,Four,2,2001-08-15T21:00:00Z,TTPT 112N 608W,0,1,9,2,12
Tropical Depression,Four,2,2001-08-15T21:00:00Z,MDCB 176N 714W,0,0,0,6,6
Tropical Depression,Four,2,2001-08-15T21:00:00Z,TGPY 120N 618W,0,0,13,3,16
Tropical Depression,Four,2,2001-08-15T21:00:00Z,MTPP 186N 724W,0,0,0,3,3
Tropical Depression,Four,2,2001-08-15T21:00:00Z,TBPB 131N 595W,0,15,13,1,29
Tropical Depression,Four,2,2001-08-15T21:00:00Z,TJSJ 184N 661W,0,0,0,16,16
Tropical Depression,Four,2,2001-08-15T21:00:00Z,TVSV 131N 612W,0,2,21,1,24
Tropical Depression,Four,2,2001-08-15T21:00:00Z,MDPP 198N 707W,0,0,0,5,5
Tropical Depression,Four,2,2001-08-15T21:00:00Z,TLPL 138N 610W,0,3,24,0,27
Tropical Depression,Four,2,2001-08-15T21:00:00Z,ST CROIX VI,0,0,1,17,18
Tropical Depression,Four,2,2001-08-15T21:00:00Z,TFFF 146N 610W,0,3,24,1,28
Tropical Depression,Four,2,2001-08-15T21:00:00Z,ST THOMAS VI,0,0,0,16,16
Tropical Depression,Four,2,2001-08-15T21:00:00Z,TDPR 153N 614W,0,1,23,3,27
Tropical Depression,Four,2,2001-08-15T21:00:00Z,SAN JUAN PR,0,0,0,16,16
Tropical Depression,Four,2,2001-08-15T21:00:00Z,TFFR 163N 615W,0,0,19,4,23
Tropical Depression,Four,2,2001-08-15T21:00:00Z,PONCE PR,0,0,0,17,17
Tropical Depression,Four,2,2001-08-15T21:00:00Z,TAPA 171N 618W,0,0,12,8,20
Tropical Depression,Four,3,2001-08-16T03:00:00Z,13.5N  57.0W,50,2,0,0,52
Tropical Depression,Four,3,2001-08-16T03:00:00Z,TNCM 181N 631W,0,0,9,7,16
Tropical Depression,Four,3,2001-08-16T03:00:00Z,14.0N  60.5W,0,34,0,0,34
Tropical Depression,Four,3,2001-08-16T03:00:00Z,TISX 177N 648W,0,0,7,12,19
Tropical Depression,Four,3,2001-08-16T03:00:00Z,14.5N  63.0W,0,9,15,1,25
Tropical Depression,Four,3,2001-08-16T03:00:00Z,TIST 183N 650W,0,0,3,13,16
Tropical Depression,Four,3,2001-08-16T03:00:00Z,TNCC 122N 690W,0,0,0,5,5
Tropical Depression,Four,3,2001-08-16T03:00:00Z,TJPS 180N 666W,0,0,1,17,18
Tropical Depression,Four,3,2001-08-16T03:00:00Z,SVMG 110N 640W,0,0,4,2,6
Tropical Depression,Four,3,2001-08-16T03:00:00Z,MDSD 185N 697W,0,0,0,13,13
Tropical Depression,Four,3,2001-08-16T03:00:00Z,TTPP 106N 614W,0,2,1,1,4
Tropical Depression,Four,3,2001-08-16T03:00:00Z,MDCB 176N 714W,0,0,0,10,10
Tropical Depression,Four,3,2001-08-16T03:00:00Z,TTPT 112N 608W,0,6,1,1,8
Tropical Depression,Four,3,2001-08-16T03:00:00Z,MTPP 186N 724W,0,0,0,6,6
Tropical Depression,Four,3,2001-08-16T03:00:00Z,TGPY 120N 618W,0,10,4,1,15
Tropical Depression,Four,3,2001-08-16T03:00:00Z,MTCA 183N 738W,0,0,0,3,3
Tropical Depression,Four,3,2001-08-16T03:00:00Z,TBPB 131N 595W,3,30,0,0,33
Tropical Depression,Four,3,2001-08-16T03:00:00Z,TJSJ 184N 661W,0,0,1,15,16
Tropical Depression,Four,3,2001-08-16T03:00:00Z,TVSV 131N 612W,0,23,2,1,26
Tropical Depression,Four,3,2001-08-16T03:00:00Z,MDPP 198N 707W,0,0,0,8,8
Tropical Depression,Four,3,2001-08-16T03:00:00Z,TLPL 138N 610W,0,29,2,0,31
Tropical Depression,Four,3,2001-08-16T03:00:00Z,MBJT 215N 712W,0,0,0,3,3
Tropical Depression,Four,3,2001-08-16T03:00:00Z,TFFF 146N 610W,0,30,2,0,32
Tropical Depression,Four,3,2001-08-16T03:00:00Z,ST CROIX VI,0,0,7,12,19
Tropical Depression,Four,3,2001-08-16T03:00:00Z,TDPR 153N 614W,0,24,5,0,29
Tropical Depression,Four,3,2001-08-16T03:00:00Z,ST THOMAS VI,0,0,3,13,16
Tropical Depression,Four,3,2001-08-16T03:00:00Z,TFFR 163N 615W,0,14,9,1,24
Tropical Depression,Four,3,2001-08-16T03:00:00Z,SAN JUAN PR,0,0,1,15,16
Tropical Depression,Four,3,2001-08-16T03:00:00Z,TAPA 171N 618W,0,5,13,1,19
Tropical Depression,Four,3,2001-08-16T03:00:00Z,PONCE PR,0,0,1,17,18
Tropical Depression,Four,3,2001-08-16T03:00:00Z,TKPK 173N 627W,0,1,15,3,19
Tropical Depression,Four,4,2001-08-16T09:00:00Z,13.6N  60.0W,49,1,1,0,51
Tropical Depression,Four,4,2001-08-16T09:00:00Z,TISX 177N 648W,0,3,16,1,20
Tropical Depression,Four,4,2001-08-16T09:00:00Z,14.3N  63.0W,1,32,1,0,34
Tropical Depression,Four,4,2001-08-16T09:00:00Z,TIST 183N 650W,0,1,14,2,17
Tropical Depression,Four,4,2001-08-16T09:00:00Z,15.0N  66.0W,0,4,21,1,26
Tropical Depression,Four,4,2001-08-16T09:00:00Z,TJPS 180N 666W,0,0,13,7,20
Tropical Depression,Four,4,2001-08-16T09:00:00Z,SKPG 125N 717W,0,0,0,5,5
Tropical Depression,Four,4,2001-08-16T09:00:00Z,MDSD 185N 697W,0,0,1,18,19
Tropical Depression,Four,4,2001-08-16T09:00:00Z,TNCC 122N 690W,0,0,2,6,8
Tropical Depression,Four,4,2001-08-16T09:00:00Z,MDCB 176N 714W,0,0,0,19,19
Tropical Depression,Four,4,2001-08-16T09:00:00Z,SVMG 110N 640W,0,3,2,1,6
Tropical Depression,Four,4,2001-08-16T09:00:00Z,MTPP 186N 724W,0,0,0,16,16
Tropical Depression,Four,4,2001-08-16T09:00:00Z,TTPP 106N 614W,1,2,0,0,3
Tropical Depression,Four,4,2001-08-16T09:00:00Z,MTCA 183N 738W,0,0,0,13,13
Tropical Depression,Four,4,2001-08-16T09:00:00Z,TTPT 112N 608W,4,4,0,0,8
Tropical Depression,Four,4,2001-08-16T09:00:00Z,MKJP 179N 768W,0,0,0,3,3
Tropical Depression,Four,4,2001-08-16T09:00:00Z,TGPY 120N 618W,5,13,1,0,19
Tropical Depression,Four,4,2001-08-16T09:00:00Z,MUGM 200N 751W,0,0,0,7,7
Tropical Depression,Four,4,2001-08-16T09:00:00Z,TBPB 131N 595W,49,1,0,0,50
Tropical Depression,Four,4,2001-08-16T09:00:00Z,TJSJ 184N 661W,0,0,12,6,18
Tropical Depression,Four,4,2001-08-16T09:00:00Z,TVSV 131N 612W,25,12,0,0,37
Tropical Depression,Four,4,2001-08-16T09:00:00Z,MDPP 198N 707W,0,0,0,14,14
Tropical Depression,Four,4,2001-08-16T09:00:00Z,TLPL 138N 610W,34,10,0,0,44
Tropical Depression,Four,4,2001-08-16T09:00:00Z,MBJT 215N 712W,0,0,0,7,7
Tropical Depression,Four,4,2001-08-16T09:00:00Z,TFFF 146N 610W,30,13,0,1,44
Tropical Depression,Four,4,2001-08-16T09:00:00Z,MYMM 224N 730W,0,0,0,3,3
Tropical Depression,Four,4,2001-08-16T09:00:00Z,TDPR 153N 614W,13,24,0,0,37
Tropical Depression,Four,4,2001-08-16T09:00:00Z,ST CROIX VI,0,3,16,1,20
Tropical Depression,Four,4,2001-08-16T09:00:00Z,TFFR 163N 615W,3,24,0,1,28
Tropical Depression,Four,4,2001-08-16T09:00:00Z,ST THOMAS VI,0,1,14,2,17
Tropical Depression,Four,4,2001-08-16T09:00:00Z,TAPA 171N 618W,0,18,2,0,20
Tropical Depression,Four,4,2001-08-16T09:00:00Z,SAN JUAN PR,0,0,12,6,18
Tropical Depression,Four,4,2001-08-16T09:00:00Z,TKPK 173N 627W,0,15,6,0,21
Tropical Depression,Four,4,2001-08-16T09:00:00Z,PONCE PR,0,0,13,7,20
Tropical Depression,Four,4,2001-08-16T09:00:00Z,TNCM 181N 631W,0,6,9,0,15
Tropical Storm,Chantal,5,2001-08-16T15:00:00Z,14.5N  64.0W,47,3,0,0,50
Tropical Storm,Chantal,5,2001-08-16T15:00:00Z,MDCB 176N 714W,0,1,24,1,26
Tropical Storm,Chantal,5,2001-08-16T15:00:00Z,15.0N  68.0W,0,33,3,0,36
Tropical Storm,Chantal,5,2001-08-16T15:00:00Z,MTPP 186N 724W,0,0,16,6,22
Tropical Storm,Chantal,5,2001-08-16T15:00:00Z,16.0N  72.0W,0,1,25,1,27
Tropical Storm,Chantal,5,2001-08-16T15:00:00Z,MTCA 183N 738W,0,0,11,11,22
Tropical Storm,Chantal,5,2001-08-16T15:00:00Z,SKPG 125N 717W,0,0,6,1,7
Tropical Storm,Chantal,5,2001-08-16T15:00:00Z,MKJP 179N 768W,0,0,1,19,20
Tropical Storm,Chantal,5,2001-08-16T15:00:00Z,TNCC 122N 690W,0,5,3,0,8
Tropical Storm,Chantal,5,2001-08-16T15:00:00Z,MKJS 185N 779W,0,0,0,18,18
Tropical Storm,Chantal,5,2001-08-16T15:00:00Z,TGPY 120N 618W,6,0,0,0,6
Tropical Storm,Chantal,5,2001-08-16T15:00:00Z,MWCG 193N 814W,0,0,0,8,8
Tropical Storm,Chantal,5,2001-08-16T15:00:00Z,TBPB 131N 595W,55,0,0,0,55
Tropical Storm,Chantal,5,2001-08-16T15:00:00Z,MUGM 200N 751W,0,0,1,16,17
Tropical Storm,Chantal,5,2001-08-16T15:00:00Z,TVSV 131N 612W,40,0,0,0,40
Tropical Storm,Chantal,5,2001-08-16T15:00:00Z,MUCM 214N 779W,0,0,0,11,11
Tropical Storm,Chantal,5,2001-08-16T15:00:00Z,TLPL 138N 610W,64,0,0,0,64
Tropical Storm,Chantal,5,2001-08-16T15:00:00Z,MUCF 221N 805W,0,0,0,5,5
Tropical Storm,Chantal,5,2001-08-16T15:00:00Z,TFFF 146N 610W,67,0,0,0,67
Tropical Storm,Chantal,5,2001-08-16T15:00:00Z,MUSN 216N 826W,0,0,0,3,3
Tropical Storm,Chantal,5,2001-08-16T15:00:00Z,TDPR 153N 614W,57,0,0,0,57
Tropical Storm,Chantal,5,2001-08-16T15:00:00Z,TJSJ 184N 661W,0,12,2,0,14
Tropical Storm,Chantal,5,2001-08-16T15:00:00Z,TFFR 163N 615W,25,1,0,0,26
Tropical Storm,Chantal,5,2001-08-16T15:00:00Z,MDPP 198N 707W,0,0,10,3,13
Tropical Storm,Chantal,5,2001-08-16T15:00:00Z,TAPA 171N 618W,10,0,0,0,10
Tropical Storm,Chantal,5,2001-08-16T15:00:00Z,MBJT 215N 712W,0,0,2,3,5
Tropical Storm,Chantal,5,2001-08-16T15:00:00Z,TKPK 173N 627W,11,2,0,0,13
Tropical Storm,Chantal,5,2001-08-16T15:00:00Z,MYMM 224N 730W,0,0,0,4,4
Tropical Storm,Chantal,5,2001-08-16T15:00:00Z,TNCM 181N 631W,3,2,0,0,5
Tropical Storm,Chantal,5,2001-08-16T15:00:00Z,MYEG 235N 758W,0,0,0,3,3
Tropical Storm,Chantal,5,2001-08-16T15:00:00Z,TISX 177N 648W,4,14,0,0,18
Tropical Storm,Chantal,5,2001-08-16T15:00:00Z,ST CROIX VI,4,14,0,0,18
Tropical Storm,Chantal,5,2001-08-16T15:00:00Z,TIST 183N 650W,1,9,1,0,11
Tropical Storm,Chantal,5,2001-08-16T15:00:00Z,ST THOMAS VI,1,9,1,0,11
Tropical Storm,Chantal,5,2001-08-16T15:00:00Z,TJPS 180N 666W,0,18,3,0,21
Tropical Storm,Chantal,5,2001-08-16T15:00:00Z,SAN JUAN PR,0,12,2,0,14
Tropical Storm,Chantal,5,2001-08-16T15:00:00Z,MDSD 185N 697W,0,3,18,0,21
Tropical Storm,Chantal,5,2001-08-16T15:00:00Z,PONCE PR,0,18,3,0,21
Tropical Storm,Chantal,6,2001-08-16T21:00:00Z,13.5N  65.5W,48,3,0,0,51
Tropical Storm,Chantal,6,2001-08-16T21:00:00Z,MKJP 179N 768W,0,0,7,17,24
Tropical Storm,Chantal,6,2001-08-16T21:00:00Z,14.5N  70.0W,0,34,2,1,37
Tropical Storm,Chantal,6,2001-08-16T21:00:00Z,MKJS 185N 779W,0,0,2,20,22
Tropical Storm,Chantal,6,2001-08-16T21:00:00Z,16.0N  74.0W,0,1,26,1,28
Tropical Storm,Chantal,6,2001-08-16T21:00:00Z,MWCG 193N 814W,0,0,0,17,17
Tropical Storm,Chantal,6,2001-08-16T21:00:00Z,SKPG 125N 717W,0,6,8,0,14
Tropical Storm,Chantal,6,2001-08-16T21:00:00Z,MUGM 200N 751W,0,0,5,12,17
Tropical Storm,Chantal,6,2001-08-16T21:00:00Z,TNCC 122N 690W,0,17,1,0,18
Tropical Storm,Chantal,6,2001-08-16T21:00:00Z,MUCM 214N 779W,0,0,0,13,13
Tropical Storm,Chantal,6,2001-08-16T21:00:00Z,SVMG 110N 640W,5,0,0,0,5
Tropical Storm,Chantal,6,2001-08-16T21:00:00Z,MUCF 221N 805W,0,0,0,10,10
Tropical Storm,Chantal,6,2001-08-16T21:00:00Z,TTPT 112N 608W,4,0,0,0,4
Tropical Storm,Chantal,6,2001-08-16T21:00:00Z,MUSN 216N 826W,0,0,0,9,9
Tropical Storm,Chantal,6,2001-08-16T21:00:00Z,TGPY 120N 618W,32,0,0,0,32
Tropical Storm,Chantal,6,2001-08-16T21:00:00Z,MUHA 230N 824W,0,0,0,5,5
Tropical Storm,Chantal,6,2001-08-16T21:00:00Z,TBPB 131N 595W,88,0,0,0,88
Tropical Storm,Chantal,6,2001-08-16T21:00:00Z,MUAN 219N 850W,0,0,0,4,4
Tropical Storm,Chantal,6,2001-08-16T21:00:00Z,TVSV 131N 612W,80,0,0,0,80
Tropical Storm,Chantal,6,2001-08-16T21:00:00Z,MMCZ 205N 869W,0,0,0,2,2
Tropical Storm,Chantal,6,2001-08-16T21:00:00Z,TLPL 138N 610W,81,0,0,0,81
Tropical Storm,Chantal,6,2001-08-16T21:00:00Z,TJSJ 184N 661W,0,2,0,0,2
Tropical Storm,Chantal,6,2001-08-16T21:00:00Z,TFFF 146N 610W,54,0,0,0,54
Tropical Storm,Chantal,6,2001-08-16T21:00:00Z,MDPP 198N 707W,0,0,6,1,7
Tropical Storm,Chantal,6,2001-08-16T21:00:00Z,TDPR 153N 614W,22,0,0,0,22
Tropical Storm,Chantal,6,2001-08-16T21:00:00Z,MBJT 215N 712W,0,0,1,1,2
Tropical Storm,Chantal,6,2001-08-16T21:00:00Z,TFFR 163N 615W,2,0,0,0,2
Tropical Storm,Chantal,6,2001-08-16T21:00:00Z,MYMM 224N 730W,0,0,0,2,2
Tropical Storm,Chantal,6,2001-08-16T21:00:00Z,TISX 177N 648W,1,1,0,0,2
Tropical Storm,Chantal,6,2001-08-16T21:00:00Z,MYEG 235N 758W,0,0,0,2,2
Tropical Storm,Chantal,6,2001-08-16T21:00:00Z,TJPS 180N 666W,0,4,1,0,5
Tropical Storm,Chantal,6,2001-08-16T21:00:00Z,MYAK 241N 776W,0,0,0,2,2
Tropical Storm,Chantal,6,2001-08-16T21:00:00Z,MDSD 185N 697W,0,5,7,1,13
Tropical Storm,Chantal,6,2001-08-16T21:00:00Z,ST CROIX VI,1,1,0,0,2
Tropical Storm,Chantal,6,2001-08-16T21:00:00Z,MDCB 176N 714W,0,6,19,1,26
Tropical Storm,Chantal,6,2001-08-16T21:00:00Z,SAN JUAN PR,0,2,0,0,2
Tropical Storm,Chantal,6,2001-08-16T21:00:00Z,MTPP 186N 724W,0,1,18,1,20
Tropical Storm,Chantal,6,2001-08-16T21:00:00Z,PONCE PR,0,4,1,0,5
Tropical Storm,Chantal,6,2001-08-16T21:00:00Z,MTCA 183N 738W,0,0,20,4,24
Tropical Depression,Chantal,8,2001-08-17T15:00:00Z,15.0N  73.5W,46,3,0,0,49
Tropical Depression,Chantal,8,2001-08-17T15:00:00Z,MUCF 221N 805W,0,0,2,5,7
Tropical Depression,Chantal,8,2001-08-17T15:00:00Z,15.5N  77.4W,0,37,1,0,38
Tropical Depression,Chantal,8,2001-08-17T15:00:00Z,MUSN 216N 826W,0,0,3,11,14
Tropical Depression,Chantal,8,2001-08-17T15:00:00Z,16.5N  81.0W,0,2,27,1,30
Tropical Depression,Chantal,8,2001-08-17T15:00:00Z,MUHA 230N 824W,0,0,1,6,7
Tropical Depression,Chantal,8,2001-08-17T15:00:00Z,SKPG 125N 717W,4,0,0,0,4
Tropical Depression,Chantal,8,2001-08-17T15:00:00Z,MUAN 219N 850W,0,0,0,14,14
Tropical Depression,Chantal,8,2001-08-17T15:00:00Z,TNCC 122N 690W,2,0,0,0,2
Tropical Depression,Chantal,8,2001-08-17T15:00:00Z,MMCZ 205N 869W,0,0,0,15,15
Tropical Depression,Chantal,8,2001-08-17T15:00:00Z,MDCB 176N 714W,7,0,0,0,7
Tropical Depression,Chantal,8,2001-08-17T15:00:00Z,MZBZ 175N 883W,0,0,0,10,10
Tropical Depression,Chantal,8,2001-08-17T15:00:00Z,MTPP 186N 724W,1,2,0,0,3
Tropical Depression,Chantal,8,2001-08-17T15:00:00Z,MGPB 157N 886W,0,0,0,5,5
Tropical Depression,Chantal,8,2001-08-17T15:00:00Z,MTCA 183N 738W,2,8,0,0,10
Tropical Depression,Chantal,8,2001-08-17T15:00:00Z,MHNJ 165N 859W,0,0,1,14,15
Tropical Depression,Chantal,8,2001-08-17T15:00:00Z,MKJP 179N 768W,0,25,3,0,28
Tropical Depression,Chantal,8,2001-08-17T15:00:00Z,MNPC 141N 834W,0,0,5,8,13
Tropical Depression,Chantal,8,2001-08-17T15:00:00Z,MKJS 185N 779W,0,13,11,0,24
Tropical Depression,Chantal,8,2001-08-17T15:00:00Z,MNBL 120N 839W,0,0,0,4,4
Tropical Depression,Chantal,8,2001-08-17T15:00:00Z,MWCG 193N 814W,0,0,20,3,23
Tropical Depression,Chantal,8,2001-08-17T15:00:00Z,SKSP 126N 817W,0,0,3,4,7
Tropical Depression,Chantal,8,2001-08-17T15:00:00Z,MUGM 200N 751W,0,1,1,0,2
Tropical Depression,Chantal,8,2001-08-17T15:00:00Z,MMMD 210N 897W,0,0,0,7,7
Tropical Depression,Chantal,8,2001-08-17T15:00:00Z,MUCM 214N 779W,0,0,2,1,3
Tropical Depression,Chantal,8,2001-08-17T15:00:00Z,KEY WEST FL,0,0,0,2,2
Tropical Storm,Chantal,9,2001-08-17T21:00:00Z,15.5N  74.5W,47,1,0,0,48
Tropical Storm,Chantal,9,2001-08-17T21:00:00Z,MUSN 216N 826W,0,0,6,11,17
Tropical Storm,Chantal,9,2001-08-17T21:00:00Z,16.5N  78.0W,0,34,0,0,34
Tropical Storm,Chantal,9,2001-08-17T21:00:00Z,MUHA 230N 824W,0,0,2,10,12
Tropical Storm,Chantal,9,2001-08-17T21:00:00Z,17.5N  81.0W,0,5,21,1,27
Tropical Storm,Chantal,9,2001-08-17T21:00:00Z,MUAN 219N 850W,0,0,1,15,16
Tropical Storm,Chantal,9,2001-08-17T21:00:00Z,SKPG 125N 717W,2,0,0,0,2
Tropical Storm,Chantal,9,2001-08-17T21:00:00Z,MMCZ 205N 869W,0,0,0,15,15
Tropical Storm,Chantal,9,2001-08-17T21:00:00Z,MDCB 176N 714W,8,0,0,0,8
Tropical Storm,Chantal,9,2001-08-17T21:00:00Z,MZBZ 175N 883W,0,0,0,7,7
Tropical Storm,Chantal,9,2001-08-17T21:00:00Z,MTPP 186N 724W,3,1,0,0,4
Tropical Storm,Chantal,9,2001-08-17T21:00:00Z,MGPB 157N 886W,0,0,0,3,3
Tropical Storm,Chantal,9,2001-08-17T21:00:00Z,MTCA 183N 738W,11,5,1,0,17
Tropical Storm,Chantal,9,2001-08-17T21:00:00Z,MHNJ 165N 859W,0,0,1,10,11
Tropical Storm,Chantal,9,2001-08-17T21:00:00Z,MKJP 179N 768W,1,31,0,0,32
Tropical Storm,Chantal,9,2001-08-17T21:00:00Z,MNPC 141N 834W,0,0,3,5,8
Tropical Storm,Chantal,9,2001-08-17T21:00:00Z,MKJS 185N 779W,0,25,3,0,28
Tropical Storm,Chantal,9,2001-08-17T21:00:00Z,SKSP 126N 817W,0,0,2,1,3
Tropical Storm,Chantal,9,2001-08-17T21:00:00Z,MWCG 193N 814W,0,1,21,2,24
Tropical Storm,Chantal,9,2001-08-17T21:00:00Z,MMMD 210N 897W,0,0,0,7,7
Tropical Storm,Chantal,9,2001-08-17T21:00:00Z,MUGM 200N 751W,0,5,1,0,6
Tropical Storm,Chantal,9,2001-08-17T21:00:00Z,MARATHON FL,0,0,0,4,4
Tropical Storm,Chantal,9,2001-08-17T21:00:00Z,MUCM 214N 779W,0,2,5,1,8
Tropical Storm,Chantal,9,2001-08-17T21:00:00Z,KEY WEST FL,0,0,0,6,6
Tropical Storm,Chantal,9,2001-08-17T21:00:00Z,MUCF 221N 805W,0,0,6,6,12
Tropical Storm,Chantal,9,2001-08-17T21:00:00Z,MARCO ISLAND FL,0,0,0,2,2
Tropical Storm,Chantal,10,2001-08-18T03:00:00Z,16.2N  75.5W,47,1,0,0,48
Tropical Storm,Chantal,10,2001-08-18T03:00:00Z,MUSN 216N 826W,0,0,11,8,19
Tropical Storm,Chantal,10,2001-08-18T03:00:00Z,17.1N  78.4W,2,32,1,0,35
Tropical Storm,Chantal,10,2001-08-18T03:00:00Z,MUHA 230N 824W,0,0,4,9,13
Tropical Storm,Chantal,10,2001-08-18T03:00:00Z,18.0N  81.3W,0,8,20,0,28
Tropical Storm,Chantal,10,2001-08-18T03:00:00Z,MUAN 219N 850W,0,0,2,16,18
Tropical Storm,Chantal,10,2001-08-18T03:00:00Z,MDCB 176N 714W,9,0,0,0,9
Tropical Storm,Chantal,10,2001-08-18T03:00:00Z,MMCZ 205N 869W,0,0,0,18,18
Tropical Storm,Chantal,10,2001-08-18T03:00:00Z,MTPP 186N 724W,4,0,0,0,4
Tropical Storm,Chantal,10,2001-08-18T03:00:00Z,MZBZ 175N 883W,0,0,0,10,10
Tropical Storm,Chantal,10,2001-08-18T03:00:00Z,MTCA 183N 738W,19,2,0,0,21
Tropical Storm,Chantal,10,2001-08-18T03:00:00Z,MGPB 157N 886W,0,0,0,4,4
Tropical Storm,Chantal,10,2001-08-18T03:00:00Z,MKJP 179N 768W,11,25,0,0,36
Tropical Storm,Chantal,10,2001-08-18T03:00:00Z,MHNJ 165N 859W,0,0,1,11,12
Tropical Storm,Chantal,10,2001-08-18T03:00:00Z,MKJS 185N 779W,1,30,1,0,32
Tropical Storm,Chantal,10,2001-08-18T03:00:00Z,MNPC 141N 834W,0,0,2,4,6
Tropical Storm,Chantal,10,2001-08-18T03:00:00Z,MWCG 193N 814W,0,4,23,0,27
Tropical Storm,Chantal,10,2001-08-18T03:00:00Z,MMMD 210N 897W,0,0,0,11,11
Tropical Storm,Chantal,10,2001-08-18T03:00:00Z,MUGM 200N 751W,1,5,1,0,7
Tropical Storm,Chantal,10,2001-08-18T03:00:00Z,MARATHON FL,0,0,0,3,3
Tropical Storm,Chantal,10,2001-08-18T03:00:00Z,MUCM 214N 779W,0,3,6,1,10
Tropical Storm,Chantal,10,2001-08-18T03:00:00Z,KEY WEST FL,0,0,1,4,5
Tropical Storm,Chantal,10,2001-08-18T03:00:00Z,MUCF 221N 805W,0,0,10,3,13
Tropical Storm,Chantal,11,2001-08-18T09:00:00Z,16.1N  77.4W,47,1,0,0,48
Tropical Storm,Chantal,11,2001-08-18T09:00:00Z,MUAN 219N 850W,0,0,4,13,17
Tropical Storm,Chantal,11,2001-08-18T09:00:00Z,17.0N  80.1W,3,32,0,0,35
Tropical Storm,Chantal,11,2001-08-18T09:00:00Z,MMCZ 205N 869W,0,0,2,17,19
Tropical Storm,Chantal,11,2001-08-18T09:00:00Z,17.8N  82.6W,0,12,15,1,28
Tropical Storm,Chantal,11,2001-08-18T09:00:00Z,MZBZ 175N 883W,0,0,0,12,12
Tropical Storm,Chantal,11,2001-08-18T09:00:00Z,MTCA 183N 738W,3,0,0,0,3
Tropical Storm,Chantal,11,2001-08-18T09:00:00Z,MGPB 157N 886W,0,0,0,6,6
Tropical Storm,Chantal,11,2001-08-18T09:00:00Z,MKJP 179N 768W,30,3,0,0,33
Tropical Storm,Chantal,11,2001-08-18T09:00:00Z,MHNJ 165N 859W,0,0,5,10,15
Tropical Storm,Chantal,11,2001-08-18T09:00:00Z,MKJS 185N 779W,10,17,0,1,28
Tropical Storm,Chantal,11,2001-08-18T09:00:00Z,MNPC 141N 834W,0,1,3,3,7
Tropical Storm,Chantal,11,2001-08-18T09:00:00Z,MWCG 193N 814W,0,14,12,0,26
Tropical Storm,Chantal,11,2001-08-18T09:00:00Z,SKSP 126N 817W,0,0,1,1,2
Tropical Storm,Chantal,11,2001-08-18T09:00:00Z,MUCM 214N 779W,0,1,1,1,3
Tropical Storm,Chantal,11,2001-08-18T09:00:00Z,MMFR 185N 926W,0,0,0,3,3
Tropical Storm,Chantal,11,2001-08-18T09:00:00Z,MUCF 221N 805W,0,0,5,3,8
Tropical Storm,Chantal,11,2001-08-18T09:00:00Z,MMMD 210N 897W,0,0,0,13,13
Tropical Storm,Chantal,11,2001-08-18T09:00:00Z,MUSN 216N 826W,0,0,11,5,16
Tropical Storm,Chantal,11,2001-08-18T09:00:00Z,KEY WEST FL,0,0,0,3,3
Tropical Storm,Chantal,11,2001-08-18T09:00:00Z,MUHA 230N 824W,0,0,3,6,9
Tropical Storm,Chantal,12,2001-08-18T15:00:00Z,17.0N  80.0W,46,0,0,0,46
Tropical Storm,Chantal,12,2001-08-18T15:00:00Z,MHNJ 165N 859W,0,4,9,2,15
Tropical Storm,Chantal,12,2001-08-18T15:00:00Z,18.0N  82.5W,4,28,0,0,32
Tropical Storm,Chantal,12,2001-08-18T15:00:00Z,MNPC 141N 834W,0,2,1,1,4
Tropical Storm,Chantal,12,2001-08-18T15:00:00Z,19.5N  85.0W,0,8,18,1,27
Tropical Storm,Chantal,12,2001-08-18T15:00:00Z,MMFR 185N 926W,0,0,0,3,3
Tropical Storm,Chantal,12,2001-08-18T15:00:00Z,MKJP 179N 768W,33,0,0,0,33
Tropical Storm,Chantal,12,2001-08-18T15:00:00Z,MMMD 210N 897W,0,0,2,14,16
Tropical Storm,Chantal,12,2001-08-18T15:00:00Z,MKJS 185N 779W,28,0,0,0,28
Tropical Storm,Chantal,12,2001-08-18T15:00:00Z,MARATHON FL,0,0,1,1,2
Tropical Storm,Chantal,12,2001-08-18T15:00:00Z,MWCG 193N 814W,4,24,1,0,29
Tropical Storm,Chantal,12,2001-08-18T15:00:00Z,KEY WEST FL,0,0,2,2,4
Tropical Storm,Chantal,12,2001-08-18T15:00:00Z,MUCF 221N 805W,0,3,4,0,7
Tropical Storm,Chantal,12,2001-08-18T15:00:00Z,MARCO ISLAND FL,0,0,0,2,2
Tropical Storm,Chantal,12,2001-08-18T15:00:00Z,MUSN 216N 826W,0,6,12,1,19
Tropical Storm,Chantal,12,2001-08-18T15:00:00Z,BURAS LA,0,0,0,2,2
Tropical Storm,Chantal,12,2001-08-18T15:00:00Z,MUHA 230N 824W,0,1,8,2,11
Tropical Storm,Chantal,12,2001-08-18T15:00:00Z,GULF 29N 87W,0,0,0,2,2
Tropical Storm,Chantal,12,2001-08-18T15:00:00Z,MUAN 219N 850W,0,1,17,4,22
Tropical Storm,Chantal,12,2001-08-18T15:00:00Z,GULF 28N 89W,0,0,0,5,5
Tropical Storm,Chantal,12,2001-08-18T15:00:00Z,MMCZ 205N 869W,0,0,16,6,22
Tropical Storm,Chantal,12,2001-08-18T15:00:00Z,GULF 28N 91W,0,0,0,4,4
Tropical Storm,Chantal,12,2001-08-18T15:00:00Z,MZBZ 175N 883W,0,0,5,7,12
Tropical Storm,Chantal,12,2001-08-18T15:00:00Z,GULF 28N 93W,0,0,0,2,2
Tropical Storm,Chantal,12,2001-08-18T15:00:00Z,MGPB 157N 886W,0,0,1,3,4
Tropical Storm,Chantal,13,2001-08-18T21:00:00Z,17.0N  82.5W,47,1,0,0,48
Tropical Storm,Chantal,13,2001-08-18T21:00:00Z,MNPC 141N 834W,2,1,0,0,3
Tropical Storm,Chantal,13,2001-08-18T21:00:00Z,18.5N  85.5W,0,36,0,0,36
Tropical Storm,Chantal,13,2001-08-18T21:00:00Z,MMFR 185N 926W,0,0,1,5,6
Tropical Storm,Chantal,13,2001-08-18T21:00:00Z,20.0N  87.5W,0,14,13,1,28
Tropical Storm,Chantal,13,2001-08-18T21:00:00Z,MMMD 210N 897W,0,0,17,5,22
Tropical Storm,Chantal,13,2001-08-18T21:00:00Z,MKJP 179N 768W,3,0,0,0,3
Tropical Storm,Chantal,13,2001-08-18T21:00:00Z,BURAS LA,0,0,0,2,2
Tropical Storm,Chantal,13,2001-08-18T21:00:00Z,MKJS 185N 779W,2,0,0,0,2
Tropical Storm,Chantal,13,2001-08-18T21:00:00Z,GALVESTON TX,0,0,0,2,2
Tropical Storm,Chantal,13,2001-08-18T21:00:00Z,MWCG 193N 814W,20,4,0,0,24
Tropical Storm,Chantal,13,2001-08-18T21:00:00Z,BROWNSVILLE TX,0,0,0,2,2
Tropical Storm,Chantal,13,2001-08-18T21:00:00Z,MUSN 216N 826W,0,5,2,1,8
Tropical Storm,Chantal,13,2001-08-18T21:00:00Z,GULF 28N 89W,0,0,0,5,5
Tropical Storm,Chantal,13,2001-08-18T21:00:00Z,MUHA 230N 824W,0,1,0,1,2
Tropical Storm,Chantal,13,2001-08-18T21:00:00Z,GULF 28N 91W,0,0,0,6,6
Tropical Storm,Chantal,13,2001-08-18T21:00:00Z,MUAN 219N 850W,0,10,7,2,19
Tropical Storm,Chantal,13,2001-08-18T21:00:00Z,GULF 28N 93W,0,0,0,5,5
Tropical Storm,Chantal,13,2001-08-18T21:00:00Z,MMCZ 205N 869W,0,17,11,1,29
Tropical Storm,Chantal,13,2001-08-18T21:00:00Z,GULF 28N 95W,0,0,0,3,3
Tropical Storm,Chantal,13,2001-08-18T21:00:00Z,MZBZ 175N 883W,0,6,9,2,17
Tropical Storm,Chantal,13,2001-08-18T21:00:00Z,GULF 27N 96W,0,0,0,3,3
Tropical Storm,Chantal,13,2001-08-18T21:00:00Z,MGPB 157N 886W,0,1,3,2,6
Tropical Storm,Chantal,13,2001-08-18T21:00:00Z,GULF 25N 96W,0,0,0,4,4
Tropical Storm,Chantal,13,2001-08-18T21:00:00Z,MHNJ 165N 859W,1,20,0,1,22
Tropical Storm,Chantal,14,2001-08-19T03:00:00Z,17.2N  84.2W,47,0,0,0,47
Tropical Storm,Chantal,14,2001-08-19T03:00:00Z,MMVR 192N 961W,0,0,0,2,2
Tropical Storm,Chantal,14,2001-08-19T03:00:00Z,18.0N  86.2W,11,21,1,0,33
Tropical Storm,Chantal,14,2001-08-19T03:00:00Z,MMFR 185N 926W,0,0,1,8,9
Tropical Storm,Chantal,14,2001-08-19T03:00:00Z,19.3N  87.8W,0,20,8,1,29
Tropical Storm,Chantal,14,2001-08-19T03:00:00Z,MMMD 210N 897W,0,1,16,6,23
Tropical Storm,Chantal,14,2001-08-19T03:00:00Z,MWCG 193N 814W,8,1,0,0,9
Tropical Storm,Chantal,14,2001-08-19T03:00:00Z,BROWNSVILLE TX,0,0,0,2,2
Tropical Storm,Chantal,14,2001-08-19T03:00:00Z,MUSN 216N 826W,0,1,1,1,3
Tropical Storm,Chantal,14,2001-08-19T03:00:00Z,GULF 28N 89W,0,0,0,3,3
Tropical Storm,Chantal,14,2001-08-19T03:00:00Z,MUAN 219N 850W,0,5,6,2,13
Tropical Storm,Chantal,14,2001-08-19T03:00:00Z,GULF 28N 91W,0,0,0,4,4
Tropical Storm,Chantal,14,2001-08-19T03:00:00Z,MMCZ 205N 869W,0,17,8,1,26
Tropical Storm,Chantal,14,2001-08-19T03:00:00Z,GULF 28N 93W,0,0,0,4,4
Tropical Storm,Chantal,14,2001-08-19T03:00:00Z,MZBZ 175N 883W,0,16,5,1,22
Tropical Storm,Chantal,14,2001-08-19T03:00:00Z,GULF 28N 95W,0,0,0,3,3
Tropical Storm,Chantal,14,2001-08-19T03:00:00Z,MGPB 157N 886W,0,5,5,1,11
Tropical Storm,Chantal,14,2001-08-19T03:00:00Z,GULF 27N 96W,0,0,0,3,3
Tropical Storm,Chantal,14,2001-08-19T03:00:00Z,MHNJ 165N 859W,20,8,0,1,29
Tropical Storm,Chantal,14,2001-08-19T03:00:00Z,GULF 25N 96W,0,0,0,5,5
Tropical Storm,Chantal,15,2001-08-19T09:00:00Z,16.7N  82.4W,46,0,0,0,46
Tropical Storm,Chantal,15,2001-08-19T09:00:00Z,MGPB 157N 886W,0,1,5,3,9
Tropical Storm,Chantal,15,2001-08-19T09:00:00Z,17.6N  84.4W,11,20,0,0,31
Tropical Storm,Chantal,15,2001-08-19T09:00:00Z,MHNJ 165N 859W,1,18,2,1,22
Tropical Storm,Chantal,15,2001-08-19T09:00:00Z,18.9N  86.3W,0,15,10,1,26
Tropical Storm,Chantal,15,2001-08-19T09:00:00Z,MNPC 141N 834W,3,2,0,0,5
Tropical Storm,Chantal,15,2001-08-19T09:00:00Z,MWCG 193N 814W,11,6,0,0,17
Tropical Storm,Chantal,15,2001-08-19T09:00:00Z,MMFR 185N 926W,0,0,0,6,6
Tropical Storm,Chantal,15,2001-08-19T09:00:00Z,MUCF 221N 805W,0,0,1,1,2
Tropical Storm,Chantal,15,2001-08-19T09:00:00Z,MMMD 210N 897W,0,0,5,13,18
Tropical Storm,Chantal,15,2001-08-19T09:00:00Z,MUSN 216N 826W,0,4,5,2,11
Tropical Storm,Chantal,15,2001-08-19T09:00:00Z,KEY WEST FL,0,0,0,2,2
Tropical Storm,Chantal,15,2001-08-19T09:00:00Z,MUHA 230N 824W,0,0,3,2,5
Tropical Storm,Chantal,15,2001-08-19T09:00:00Z,GULF 28N 89W,0,0,0,4,4
Tropical Storm,Chantal,15,2001-08-19T09:00:00Z,MUAN 219N 850W,0,2,12,4,18
Tropical Storm,Chantal,15,2001-08-19T09:00:00Z,GULF 28N 91W,0,0,0,3,3
Tropical Storm,Chantal,15,2001-08-19T09:00:00Z,MMCZ 205N 869W,0,2,18,3,23
Tropical Storm,Chantal,15,2001-08-19T09:00:00Z,GULF 28N 93W,0,0,0,2,2
Tropical Storm,Chantal,15,2001-08-19T09:00:00Z,MZBZ 175N 883W,0,2,12,3,17
Tropical Storm,Chantal,16,2001-08-19T15:00:00Z,17.7N  84.4W,46,0,0,0,46
Tropical Storm,Chantal,16,2001-08-19T15:00:00Z,GULFPORT MS,0,0,0,2,2
Tropical Storm,Chantal,16,2001-08-19T15:00:00Z,19.0N  86.5W,6,25,0,1,32
Tropical Storm,Chantal,16,2001-08-19T15:00:00Z,BURAS LA,0,0,0,4,4
Tropical Storm,Chantal,16,2001-08-19T15:00:00Z,20.5N  88.5W,0,12,13,1,26
Tropical Storm,Chantal,16,2001-08-19T15:00:00Z,NEW ORLEANS LA,0,0,0,3,3
Tropical Storm,Chantal,16,2001-08-19T15:00:00Z,MWCG 193N 814W,9,1,0,0,10
Tropical Storm,Chantal,16,2001-08-19T15:00:00Z,NEW IBERIA LA,0,0,0,4,4
Tropical Storm,Chantal,16,2001-08-19T15:00:00Z,MUSN 216N 826W,0,4,1,0,5
Tropical Storm,Chantal,16,2001-08-19T15:00:00Z,PORT ARTHUR TX,0,0,0,3,3
Tropical Storm,Chantal,16,2001-08-19T15:00:00Z,MUHA 230N 824W,0,1,0,1,2
Tropical Storm,Chantal,16,2001-08-19T15:00:00Z,GALVESTON TX,0,0,0,4,4
Tropical Storm,Chantal,16,2001-08-19T15:00:00Z,MUAN 219N 850W,0,11,5,0,16
Tropical Storm,Chantal,16,2001-08-19T15:00:00Z,FREEPORT TX,0,0,0,4,4
Tropical Storm,Chantal,16,2001-08-19T15:00:00Z,MMCZ 205N 869W,0,24,3,0,27
Tropical Storm,Chantal,16,2001-08-19T15:00:00Z,PORT O CONNOR TX,0,0,0,3,3
Tropical Storm,Chantal,16,2001-08-19T15:00:00Z,MZBZ 175N 883W,1,16,2,0,19
Tropical Storm,Chantal,16,2001-08-19T15:00:00Z,CORPUSCHRISTI TX,0,0,0,2,2
Tropical Storm,Chantal,16,2001-08-19T15:00:00Z,MGPB 157N 886W,0,4,2,1,7
Tropical Storm,Chantal,16,2001-08-19T15:00:00Z,BROWNSVILLE TX,0,0,0,3,3
Tropical Storm,Chantal,16,2001-08-19T15:00:00Z,MHNJ 165N 859W,19,4,0,0,23
Tropical Storm,Chantal,16,2001-08-19T15:00:00Z,GULF 29N 87W,0,0,0,2,2
Tropical Storm,Chantal,16,2001-08-19T15:00:00Z,MMSO 238N 982W,0,0,0,2,2
Tropical Storm,Chantal,16,2001-08-19T15:00:00Z,GULF 28N 89W,0,0,0,7,7
Tropical Storm,Chantal,16,2001-08-19T15:00:00Z,MMTM 222N 979W,0,0,0,2,2
Tropical Storm,Chantal,16,2001-08-19T15:00:00Z,GULF 28N 91W,0,0,0,9,9
Tropical Storm,Chantal,16,2001-08-19T15:00:00Z,MMTX 210N 974W,0,0,0,2,2
Tropical Storm,Chantal,16,2001-08-19T15:00:00Z,GULF 28N 93W,0,0,0,9,9
Tropical Storm,Chantal,16,2001-08-19T15:00:00Z,MMVR 192N 961W,0,0,0,2,2
Tropical Storm,Chantal,16,2001-08-19T15:00:00Z,GULF 28N 95W,0,0,0,6,6
Tropical Storm,Chantal,16,2001-08-19T15:00:00Z,MMFR 185N 926W,0,0,3,6,9
Tropical Storm,Chantal,16,2001-08-19T15:00:00Z,GULF 27N 96W,0,0,0,6,6
Tropical Storm,Chantal,16,2001-08-19T15:00:00Z,MMMD 210N 897W,0,3,18,2,23
Tropical Storm,Chantal,16,2001-08-19T15:00:00Z,GULF 25N 96W,0,0,0,7,7
Tropical Storm,Chantal,17,2001-08-19T21:00:00Z,18.0N  86.0W,45,0,0,0,45
Tropical Storm,Chantal,17,2001-08-19T21:00:00Z,BURAS LA,0,0,0,2,2
Tropical Storm,Chantal,17,2001-08-19T21:00:00Z,19.0N  88.0W,9,23,0,0,32
Tropical Storm,Chantal,17,2001-08-19T21:00:00Z,NEW IBERIA LA,0,0,0,2,2
Tropical Storm,Chantal,17,2001-08-19T21:00:00Z,20.5N  90.0W,0,11,15,1,27
Tropical Storm,Chantal,17,2001-08-19T21:00:00Z,PORT ARTHUR TX,0,0,0,2,2
Tropical Storm,Chantal,17,2001-08-19T21:00:00Z,MUAN 219N 850W,1,6,2,0,9
Tropical Storm,Chantal,17,2001-08-19T21:00:00Z,GALVESTON TX,0,0,0,4,4
Tropical Storm,Chantal,17,2001-08-19T21:00:00Z,MMCZ 205N 869W,5,21,0,0,26
Tropical Storm,Chantal,17,2001-08-19T21:00:00Z,FREEPORT TX,0,0,0,4,4
Tropical Storm,Chantal,17,2001-08-19T21:00:00Z,MZBZ 175N 883W,11,14,0,0,25
Tropical Storm,Chantal,17,2001-08-19T21:00:00Z,PORT O CONNOR TX,0,0,0,4,4
Tropical Storm,Chantal,17,2001-08-19T21:00:00Z,MGPB 157N 886W,2,5,1,0,8
Tropical Storm,Chantal,17,2001-08-19T21:00:00Z,CORPUSCHRISTI TX,0,0,0,4,4
Tropical Storm,Chantal,17,2001-08-19T21:00:00Z,MHNJ 165N 859W,32,0,0,0,32
Tropical Storm,Chantal,17,2001-08-19T21:00:00Z,BROWNSVILLE TX,0,0,0,6,6
Tropical Storm,Chantal,17,2001-08-19T21:00:00Z,MMSO 238N 982W,0,0,0,5,5
Tropical Storm,Chantal,17,2001-08-19T21:00:00Z,GULF 28N 89W,0,0,0,3,3
Tropical Storm,Chantal,17,2001-08-19T21:00:00Z,MMTM 222N 979W,0,0,0,5,5
Tropical Storm,Chantal,17,2001-08-19T21:00:00Z,GULF 28N 91W,0,0,0,6,6
Tropical Storm,Chantal,17,2001-08-19T21:00:00Z,MMTX 210N 974W,0,0,0,5,5
Tropical Storm,Chantal,17,2001-08-19T21:00:00Z,GULF 28N 93W,0,0,0,7,7
Tropical Storm,Chantal,17,2001-08-19T21:00:00Z,MMVR 192N 961W,0,0,0,5,5
Tropical Storm,Chantal,17,2001-08-19T21:00:00Z,GULF 28N 95W,0,0,0,6,6
Tropical Storm,Chantal,17,2001-08-19T21:00:00Z,MMFR 185N 926W,0,1,9,4,14
Tropical Storm,Chantal,17,2001-08-19T21:00:00Z,GULF 27N 96W,0,0,0,7,7
Tropical Storm,Chantal,17,2001-08-19T21:00:00Z,MMMD 210N 897W,0,10,16,1,27
Tropical Storm,Chantal,17,2001-08-19T21:00:00Z,GULF 25N 96W,0,0,0,10,10
Tropical Storm,Chantal,18,2001-08-20T03:00:00Z,18.8N  87.8W,42,0,0,0,42
Tropical Storm,Chantal,18,2001-08-20T03:00:00Z,MMMD 210N 897W,0,22,2,0,24
Tropical Storm,Chantal,18,2001-08-20T03:00:00Z,19.8N  89.7W,6,22,1,0,29
Tropical Storm,Chantal,18,2001-08-20T03:00:00Z,GALVESTON TX,0,0,0,2,2
Tropical Storm,Chantal,18,2001-08-20T03:00:00Z,21.0N  91.5W,0,16,7,1,24
Tropical Storm,Chantal,18,2001-08-20T03:00:00Z,FREEPORT TX,0,0,0,3,3
Tropical Storm,Chantal,18,2001-08-20T03:00:00Z,MUAN 219N 850W,0,2,1,1,4
Tropical Storm,Chantal,18,2001-08-20T03:00:00Z,PORT O CONNOR TX,0,0,0,4,4
Tropical Storm,Chantal,18,2001-08-20T03:00:00Z,MMCZ 205N 869W,17,5,0,0,22
Tropical Storm,Chantal,18,2001-08-20T03:00:00Z,CORPUSCHRISTI TX,0,0,0,4,4
Tropical Storm,Chantal,18,2001-08-20T03:00:00Z,MZBZ 175N 883W,31,0,0,0,31
Tropical Storm,Chantal,18,2001-08-20T03:00:00Z,BROWNSVILLE TX,0,0,0,8,8
Tropical Storm,Chantal,18,2001-08-20T03:00:00Z,MGPB 157N 886W,1,1,0,1,3
Tropical Storm,Chantal,18,2001-08-20T03:00:00Z,GULF 28N 89W,0,0,0,2,2
Tropical Storm,Chantal,18,2001-08-20T03:00:00Z,MHNJ 165N 859W,40,0,0,1,41
Tropical Storm,Chantal,18,2001-08-20T03:00:00Z,GULF 28N 91W,0,0,0,3,3
Tropical Storm,Chantal,18,2001-08-20T03:00:00Z,MMSO 238N 982W,0,0,1,9,10
Tropical Storm,Chantal,18,2001-08-20T03:00:00Z,GULF 28N 93W,0,0,0,4,4
Tropical Storm,Chantal,18,2001-08-20T03:00:00Z,MMTM 222N 979W,0,0,2,9,11
Tropical Storm,Chantal,18,2001-08-20T03:00:00Z,GULF 28N 95W,0,0,0,5,5
Tropical Storm,Chantal,18,2001-08-20T03:00:00Z,MMTX 210N 974W,0,0,3,9,12
Tropical Storm,Chantal,18,2001-08-20T03:00:00Z,GULF 27N 96W,0,0,0,7,7
Tropical Storm,Chantal,18,2001-08-20T03:00:00Z,MMVR 192N 961W,0,0,4,7,11
Tropical Storm,Chantal,18,2001-08-20T03:00:00Z,GULF 25N 96W,0,0,1,10,11
Tropical Storm,Chantal,18,2001-08-20T03:00:00Z,MMFR 185N 926W,0,10,4,2,16
Tropical Storm,Chantal,19,2001-08-20T09:00:00Z,19.5N  88.5W,42,0,0,0,42
Tropical Storm,Chantal,19,2001-08-20T09:00:00Z,PORT ARTHUR TX,0,0,0,2,2
Tropical Storm,Chantal,19,2001-08-20T09:00:00Z,20.6N  90.3W,5,23,1,0,29
Tropical Storm,Chantal,19,2001-08-20T09:00:00Z,GALVESTON TX,0,0,0,3,3
Tropical Storm,Chantal,19,2001-08-20T09:00:00Z,21.3N  92.0W,0,19,4,1,24
Tropical Storm,Chantal,19,2001-08-20T09:00:00Z,FREEPORT TX,0,0,0,3,3
Tropical Storm,Chantal,19,2001-08-20T09:00:00Z,MUAN 219N 850W,1,0,1,1,3
Tropical Storm,Chantal,19,2001-08-20T09:00:00Z,PORT O CONNOR TX,0,0,0,4,4
Tropical Storm,Chantal,19,2001-08-20T09:00:00Z,MMCZ 205N 869W,26,0,0,1,27
Tropical Storm,Chantal,19,2001-08-20T09:00:00Z,CORPUSCHRISTI TX,0,0,0,5,5
Tropical Storm,Chantal,19,2001-08-20T09:00:00Z,MZBZ 175N 883W,35,0,0,0,35
Tropical Storm,Chantal,19,2001-08-20T09:00:00Z,BROWNSVILLE TX,0,0,0,9,9
Tropical Storm,Chantal,19,2001-08-20T09:00:00Z,MHNJ 165N 859W,45,0,0,0,45
Tropical Storm,Chantal,19,2001-08-20T09:00:00Z,GULF 28N 89W,0,0,0,2,2
Tropical Storm,Chantal,19,2001-08-20T09:00:00Z,MMSO 238N 982W,0,0,1,10,11
Tropical Storm,Chantal,19,2001-08-20T09:00:00Z,GULF 28N 91W,0,0,0,3,3
Tropical Storm,Chantal,19,2001-08-20T09:00:00Z,MMTM 222N 979W,0,0,2,10,12
Tropical Storm,Chantal,19,2001-08-20T09:00:00Z,GULF 28N 93W,0,0,0,5,5
Tropical Storm,Chantal,19,2001-08-20T09:00:00Z,MMTX 210N 974W,0,0,3,9,12
Tropical Storm,Chantal,19,2001-08-20T09:00:00Z,GULF 28N 95W,0,0,0,5,5
Tropical Storm,Chantal,19,2001-08-20T09:00:00Z,MMVR 192N 961W,0,0,4,7,11
Tropical Storm,Chantal,19,2001-08-20T09:00:00Z,GULF 27N 96W,0,0,0,8,8
Tropical Storm,Chantal,19,2001-08-20T09:00:00Z,MMFR 185N 926W,1,8,3,3,15
Tropical Storm,Chantal,19,2001-08-20T09:00:00Z,GULF 25N 96W,0,0,2,10,12
Tropical Storm,Chantal,19,2001-08-20T09:00:00Z,MMMD 210N 897W,5,22,1,0,28
Tropical Storm,Chantal,20,2001-08-20T15:00:00Z,19.3N  90.0W,43,1,0,0,44
Tropical Storm,Chantal,20,2001-08-20T15:00:00Z,MMFR 185N 926W,11,8,1,1,21
Tropical Storm,Chantal,20,2001-08-20T15:00:00Z,20.0N  91.5W,17,11,1,0,29
Tropical Storm,Chantal,20,2001-08-20T15:00:00Z,MMMD 210N 897W,15,6,1,0,22
Tropical Storm,Chantal,20,2001-08-20T15:00:00Z,20.7N  93.0W,0,20,3,1,24
Tropical Storm,Chantal,20,2001-08-20T15:00:00Z,FREEPORT TX,0,0,0,2,2
Tropical Storm,Chantal,20,2001-08-20T15:00:00Z,MMCZ 205N 869W,12,1,0,0,13
Tropical Storm,Chantal,20,2001-08-20T15:00:00Z,PORT O CONNOR TX,0,0,0,3,3
Tropical Storm,Chantal,20,2001-08-20T15:00:00Z,MZBZ 175N 883W,54,0,0,0,54
Tropical Storm,Chantal,20,2001-08-20T15:00:00Z,CORPUSCHRISTI TX,0,0,0,4,4
Tropical Storm,Chantal,20,2001-08-20T15:00:00Z,MGPB 157N 886W,0,0,0,2,2
Tropical Storm,Chantal,20,2001-08-20T15:00:00Z,BROWNSVILLE TX,0,0,0,8,8
Tropical Storm,Chantal,20,2001-08-20T15:00:00Z,MHNJ 165N 859W,99,0,0,0,99
Tropical Storm,Chantal,20,2001-08-20T15:00:00Z,GULF 28N 91W,0,0,0,2,2
Tropical Storm,Chantal,20,2001-08-20T15:00:00Z,MMSO 238N 982W,0,0,2,9,11
Tropical Storm,Chantal,20,2001-08-20T15:00:00Z,GULF 28N 93W,0,0,0,3,3
Tropical Storm,Chantal,20,2001-08-20T15:00:00Z,MMTM 222N 979W,0,0,5,9,14
Tropical Storm,Chantal,20,2001-08-20T15:00:00Z,GULF 28N 95W,0,0,0,3,3
Tropical Storm,Chantal,20,2001-08-20T15:00:00Z,MMTX 210N 974W,0,0,7,8,15
Tropical Storm,Chantal,20,2001-08-20T15:00:00Z,GULF 27N 96W,0,0,0,6,6
Tropical Storm,Chantal,20,2001-08-20T15:00:00Z,MMVR 192N 961W,0,2,7,6,15
Tropical Storm,Chantal,20,2001-08-20T15:00:00Z,GULF 25N 96W,0,0,2,9,11
Tropical Storm,Chantal,21,2001-08-20T21:00:00Z,19.5N  90.5W,45,0,0,0,45
Tropical Storm,Chantal,21,2001-08-20T21:00:00Z,MMMD 210N 897W,20,2,0,1,23
Tropical Storm,Chantal,21,2001-08-20T21:00:00Z,20.0N  92.0W,21,7,1,0,29
Tropical Storm,Chantal,21,2001-08-20T21:00:00Z,FREEPORT TX,0,0,0,2,2
Tropical Storm,Chantal,21,2001-08-20T21:00:00Z,20.5N  93.5W,1,20,2,1,24
Tropical Storm,Chantal,21,2001-08-20T21:00:00Z,PORT O CONNOR TX,0,0,0,2,2
Tropical Storm,Chantal,21,2001-08-20T21:00:00Z,MMCZ 205N 869W,8,0,0,1,9
Tropical Storm,Chantal,21,2001-08-20T21:00:00Z,CORPUSCHRISTI TX,0,0,0,3,3
Tropical Storm,Chantal,21,2001-08-20T21:00:00Z,MZBZ 175N 883W,56,0,0,0,56
Tropical Storm,Chantal,21,2001-08-20T21:00:00Z,BROWNSVILLE TX,0,0,1,7,8
Tropical Storm,Chantal,21,2001-08-20T21:00:00Z,MMSO 238N 982W,0,0,3,9,12
Tropical Storm,Chantal,21,2001-08-20T21:00:00Z,GULF 28N 93W,0,0,0,2,2
Tropical Storm,Chantal,21,2001-08-20T21:00:00Z,MMTM 222N 979W,0,0,7,8,15
Tropical Storm,Chantal,21,2001-08-20T21:00:00Z,GULF 28N 95W,0,0,0,3,3
Tropical Storm,Chantal,21,2001-08-20T21:00:00Z,MMTX 210N 974W,0,1,9,6,16
Tropical Storm,Chantal,21,2001-08-20T21:00:00Z,GULF 27N 96W,0,0,0,5,5
Tropical Storm,Chantal,21,2001-08-20T21:00:00Z,MMVR 192N 961W,0,5,7,4,16
Tropical Storm,Chantal,21,2001-08-20T21:00:00Z,GULF 25N 96W,0,0,2,9,11
Tropical Storm,Chantal,21,2001-08-20T21:00:00Z,MMFR 185N 926W,17,3,1,1,22
Tropical Storm,Chantal,22,2001-08-21T03:00:00Z,19.6N  91.8W,44,0,0,0,44
Tropical Storm,Chantal,22,2001-08-21T03:00:00Z,MMFR 185N 926W,28,0,0,1,29
Tropical Storm,Chantal,22,2001-08-21T03:00:00Z,20.1N  93.3W,21,7,1,0,29
Tropical Storm,Chantal,22,2001-08-21T03:00:00Z,MMMD 210N 897W,22,0,0,1,23
Tropical Storm,Chantal,22,2001-08-21T03:00:00Z,20.5N  95.0W,1,19,3,1,24
Tropical Storm,Chantal,22,2001-08-21T03:00:00Z,PORT O CONNOR TX,0,0,0,2,2
Tropical Storm,Chantal,22,2001-08-21T03:00:00Z,MZBZ 175N 883W,99,0,0,0,99
Tropical Storm,Chantal,22,2001-08-21T03:00:00Z,CORPUSCHRISTI TX,0,0,0,3,3
Tropical Storm,Chantal,22,2001-08-21T03:00:00Z,MMSO 238N 982W,0,0,5,9,14
Tropical Storm,Chantal,22,2001-08-21T03:00:00Z,BROWNSVILLE TX,0,0,1,7,8
Tropical Storm,Chantal,22,2001-08-21T03:00:00Z,MMTM 222N 979W,0,1,11,5,17
Tropical Storm,Chantal,22,2001-08-21T03:00:00Z,GULF 28N 95W,0,0,0,2,2
Tropical Storm,Chantal,22,2001-08-21T03:00:00Z,MMTX 210N 974W,0,4,12,3,19
Tropical Storm,Chantal,22,2001-08-21T03:00:00Z,GULF 27N 96W,0,0,0,5,5
Tropical Storm,Chantal,22,2001-08-21T03:00:00Z,MMVR 192N 961W,0,12,4,3,19
Tropical Storm,Chantal,22,2001-08-21T03:00:00Z,GULF 25N 96W,0,0,3,7,10
Tropical Storm,Chantal,23,2001-08-21T09:00:00Z,19.1N  90.2W,50,0,0,0,50
Tropical Storm,Chantal,23,2001-08-21T09:00:00Z,MMVR 192N 961W,0,2,6,7,15
Tropical Storm,Chantal,23,2001-08-21T09:00:00Z,19.4N  91.2W,28,1,1,0,30
Tropical Storm,Chantal,23,2001-08-21T09:00:00Z,MMFR 185N 926W,14,5,2,1,22
Tropical Storm,Chantal,23,2001-08-21T09:00:00Z,19.7N  92.3W,12,10,2,1,25
Tropical Storm,Chantal,23,2001-08-21T09:00:00Z,MMMD 210N 897W,13,4,2,1,20
Tropical Storm,Chantal,23,2001-08-21T09:00:00Z,MMCZ 205N 869W,3,2,2,1,8
Tropical Storm,Chantal,23,2001-08-21T09:00:00Z,CORPUSCHRISTI TX,0,0,0,2,2
Tropical Storm,Chantal,23,2001-08-21T09:00:00Z,MZBZ 175N 883W,99,0,0,0,99
Tropical Storm,Chantal,23,2001-08-21T09:00:00Z,BROWNSVILLE TX,0,0,0,5,5
Tropical Storm,Chantal,23,2001-08-21T09:00:00Z,MGPB 157N 886W,0,0,1,3,4
Tropical Storm,Chantal,23,2001-08-21T09:00:00Z,GULF 28N 93W,0,0,0,2,2
Tropical Storm,Chantal,23,2001-08-21T09:00:00Z,MMSO 238N 982W,0,0,1,7,8
Tropical Storm,Chantal,23,2001-08-21T09:00:00Z,GULF 28N 95W,0,0,0,2,2
Tropical Storm,Chantal,23,2001-08-21T09:00:00Z,MMTM 222N 979W,0,0,2,8,10
Tropical Storm,Chantal,23,2001-08-21T09:00:00Z,GULF 27N 96W,0,0,0,3,3
Tropical Storm,Chantal,23,2001-08-21T09:00:00Z,MMTX 210N 974W,0,0,4,8,12
Tropical Storm,Chantal,23,2001-08-21T09:00:00Z,GULF 25N 96W,0,0,1,7,8
Tropical Storm,Chantal,24,2001-08-21T15:00:00Z,19.1N  91.7W,44,0,0,0,44
Tropical Storm,Chantal,24,2001-08-21T15:00:00Z,MMVR 192N 961W,0,15,5,2,22
Tropical Storm,Chantal,24,2001-08-21T15:00:00Z,19.5N  93.5W,16,13,0,1,30
Tropical Storm,Chantal,24,2001-08-21T15:00:00Z,MMFR 185N 926W,33,0,0,0,33
Tropical Storm,Chantal,24,2001-08-21T15:00:00Z,19.8N  95.3W,0,21,3,1,25
Tropical Storm,Chantal,24,2001-08-21T15:00:00Z,MMMD 210N 897W,17,1,0,0,18
Tropical Storm,Chantal,24,2001-08-21T15:00:00Z,MZBZ 175N 883W,99,0,0,0,99
Tropical Storm,Chantal,24,2001-08-21T15:00:00Z,CORPUSCHRISTI TX,0,0,0,2,2
Tropical Storm,Chantal,24,2001-08-21T15:00:00Z,MMSO 238N 982W,0,0,2,9,11
Tropical Storm,Chantal,24,2001-08-21T15:00:00Z,BROWNSVILLE TX,0,0,0,5,5
Tropical Storm,Chantal,24,2001-08-21T15:00:00Z,MMTM 222N 979W,0,0,9,7,16
Tropical Storm,Chantal,24,2001-08-21T15:00:00Z,GULF 27N 96W,0,0,0,3,3
Tropical Storm,Chantal,24,2001-08-21T15:00:00Z,MMTX 210N 974W,0,3,12,4,19
Tropical Storm,Chantal,24,2001-08-21T15:00:00Z,GULF 25N 96W,0,0,1,6,7
Tropical Depression,Chantal,25,2001-08-21T21:00:00Z,19.3N  92.4W,44,0,0,0,44
Tropical Depression,Chantal,25,2001-08-21T21:00:00Z,MMVR 192N 961W,1,19,3,1,24
Tropical Depression,Chantal,25,2001-08-21T21:00:00Z,19.6N  94.3W,16,13,1,0,30
Tropical Depression,Chantal,25,2001-08-21T21:00:00Z,MMFR 185N 926W,38,0,0,0,38
Tropical Depression,Chantal,25,2001-08-21T21:00:00Z,19.8N  96.2W,0,20,4,1,25
Tropical Depression,Chantal,25,2001-08-21T21:00:00Z,MMMD 210N 897W,16,0,0,1,17
Tropical Depression,Chantal,25,2001-08-21T21:00:00Z,MZBZ 175N 883W,1,0,0,1,2
Tropical Depression,Chantal,25,2001-08-21T21:00:00Z,CORPUSCHRISTI TX,0,0,0,2,2
Tropical Depression,Chantal,25,2001-08-21T21:00:00Z,MMSO 238N 982W,0,0,3,8,11
Tropical Depression,Chantal,25,2001-08-21T21:00:00Z,BROWNSVILLE TX,0,0,0,5,5
Tropical Depression,Chantal,25,2001-08-21T21:00:00Z,MMTM 222N 979W,0,1,11,5,17
Tropical Depression,Chantal,25,2001-08-21T21:00:00Z,GULF 27N 96W,0,0,0,2,2
Tropical Depression,Chantal,25,2001-08-21T21:00:00Z,MMTX 210N 974W,0,7,11,3,21
Tropical Depression,Chantal,25,2001-08-21T21:00:00Z,GULF 25N 96W,0,0,1,5,6
Tropical Depression,Chantal,26,2001-08-22T03:00:00Z,19.3N  93.2W,43,0,0,0,43
Tropical Depression,Chantal,26,2001-08-22T03:00:00Z,MMTX 210N 974W,0,10,9,0,19
Tropical Depression,Chantal,26,2001-08-22T03:00:00Z,19.5N  94.9W,21,7,1,0,29
Tropical Depression,Chantal,26,2001-08-22T03:00:00Z,MMVR 192N 961W,6,17,2,0,25
Tropical Depression,Chantal,26,2001-08-22T03:00:00Z,19.5N  97.0W,1,17,5,0,23
Tropical Depression,Chantal,26,2001-08-22T03:00:00Z,MMFR 185N 926W,46,0,0,0,46
Tropical Depression,Chantal,26,2001-08-22T03:00:00Z,MMSO 238N 982W,0,0,4,0,4
Tropical Depression,Chantal,26,2001-08-22T03:00:00Z,MMMD 210N 897W,6,0,1,0,7
Tropical Depression,Chantal,26,2001-08-22T03:00:00Z,MMTM 222N 979W,0,2,11,0,13
Tropical Depression,Chantal,27,2001-08-22T09:00:00Z,19.1N  94.0W,45,0,0,0,45
Tropical Depression,Chantal,27,2001-08-22T09:00:00Z,MMTX 210N 974W,0,5,4,5,14
Tropical Depression,Chantal,27,2001-08-22T09:00:00Z,18.7N  95.0W,33,0,0,1,34
Tropical Depression,Chantal,27,2001-08-22T09:00:00Z,MMVR 192N 961W,14,10,2,1,27
Tropical Depression,Chantal,27,2001-08-22T09:00:00Z,17.7N  95.3W,19,2,2,1,24
Tropical Depression,Chantal,27,2001-08-22T09:00:00Z,MMFR 185N 926W,55,0,0,0,55
Tropical Depression,Chantal,27,2001-08-22T09:00:00Z,MZBZ 175N 883W,0,0,0,2,2
Tropical Depression,Chantal,27,2001-08-22T09:00:00Z,MMMD 210N 897W,0,1,0,3,4
Tropical Depression,Chantal,27,2001-08-22T09:00:00Z,MMSO 238N 982W,0,0,0,3,3
Tropical Depression,Chantal,27,2001-08-22T09:00:00Z,GULF 25N 96W,0,0,0,2,2
Tropical Depression,Chantal,27,2001-08-22T09:00:00Z,MMTM 222N 979W,0,0,2,6,8
Tropical Storm,Dean,1,2001-08-22T18:00:00Z,21.7N  71.0W,47,1,0,0,48
Tropical Storm,Dean,1,2001-08-22T18:00:00Z,MDPP 198N 707W,27,0,0,0,27
Tropical Storm,Dean,1,2001-08-22T18:00:00Z,23.2N  72.2W,15,17,1,0,33
Tropical Storm,Dean,1,2001-08-22T18:00:00Z,MBJT 215N 712W,46,0,0,0,46
Tropical Storm,Dean,1,2001-08-22T18:00:00Z,24.6N  72.4W,1,23,2,1,27
Tropical Storm,Dean,1,2001-08-22T18:00:00Z,MYMM 224N 730W,15,15,1,0,31
Tropical Storm,Dean,1,2001-08-22T18:00:00Z,TNCM 181N 631W,11,0,0,0,11
Tropical Storm,Dean,1,2001-08-22T18:00:00Z,MYSM 241N 745W,0,14,5,2,21
Tropical Storm,Dean,1,2001-08-22T18:00:00Z,TISX 177N 648W,99,0,0,0,99
Tropical Storm,Dean,1,2001-08-22T18:00:00Z,MYEG 235N 758W,0,5,6,3,14
Tropical Storm,Dean,1,2001-08-22T18:00:00Z,TIST 183N 650W,99,0,0,0,99
Tropical Storm,Dean,1,2001-08-22T18:00:00Z,MYAK 241N 776W,0,0,2,4,6
Tropical Storm,Dean,1,2001-08-22T18:00:00Z,TJPS 180N 666W,16,0,0,0,16
Tropical Storm,Dean,1,2001-08-22T18:00:00Z,MYNN 251N 775W,0,0,2,5,7
Tropical Storm,Dean,1,2001-08-22T18:00:00Z,MDSD 185N 697W,2,0,0,0,2
Tropical Storm,Dean,1,2001-08-22T18:00:00Z,MYGF 266N 787W,0,0,0,3,3
Tropical Storm,Dean,1,2001-08-22T18:00:00Z,MTPP 186N 724W,1,0,0,1,2
Tropical Storm,Dean,1,2001-08-22T18:00:00Z,ST CROIX VI,99,0,0,0,99
Tropical Storm,Dean,1,2001-08-22T18:00:00Z,MUGM 200N 751W,1,4,1,1,7
Tropical Storm,Dean,1,2001-08-22T18:00:00Z,ST THOMAS VI,99,0,0,0,99
Tropical Storm,Dean,1,2001-08-22T18:00:00Z,MUCM 214N 779W,0,0,1,1,2
Tropical Storm,Dean,1,2001-08-22T18:00:00Z,SAN JUAN PR,99,0,0,0,99
Tropical Storm,Dean,1,2001-08-22T18:00:00Z,TJSJ 184N 661W,99,0,0,0,99
Tropical Storm,Dean,1,2001-08-22T18:00:00Z,PONCE PR,16,0,0,0,16
Tropical Storm,Dean,2,2001-08-22T21:00:00Z,22.4N  71.4W,46,0,0,0,46
Tropical Storm,Dean,2,2001-08-22T21:00:00Z,MYMM 224N 730W,28,4,0,0,32
Tropical Storm,Dean,2,2001-08-22T21:00:00Z,24.2N  72.4W,12,22,0,0,34
Tropical Storm,Dean,2,2001-08-22T21:00:00Z,MYSM 241N 745W,1,19,2,1,23
Tropical Storm,Dean,2,2001-08-22T21:00:00Z,25.5N  72.0W,1,25,1,1,28
Tropical Storm,Dean,2,2001-08-22T21:00:00Z,MYEG 235N 758W,0,8,3,1,12
Tropical Storm,Dean,2,2001-08-22T21:00:00Z,MUGM 200N 751W,0,1,0,1,2
Tropical Storm,Dean,2,2001-08-22T21:00:00Z,MYAK 241N 776W,0,0,2,2,4
Tropical Storm,Dean,2,2001-08-22T21:00:00Z,TJSJ 184N 661W,99,0,0,0,99
Tropical Storm,Dean,2,2001-08-22T21:00:00Z,MYNN 251N 775W,0,0,3,2,5
Tropical Storm,Dean,2,2001-08-22T21:00:00Z,MDPP 198N 707W,18,0,0,0,18
Tropical Storm,Dean,2,2001-08-22T21:00:00Z,MYGF 266N 787W,0,0,0,2,2
Tropical Storm,Dean,2,2001-08-22T21:00:00Z,MBJT 215N 712W,49,0,0,0,49
Tropical Storm,Dean,2,2001-08-22T21:00:00Z,SAN JUAN PR,99,0,0,0,99
Tropical Storm,Dean,3,2001-08-23T03:00:00Z,23.1N  72.3W,46,0,0,0,46
Tropical Storm,Dean,3,2001-08-23T03:00:00Z,MYSM 241N 745W,11,14,1,0,26
Tropical Storm,Dean,3,2001-08-23T03:00:00Z,25.1N  72.5W,16,18,0,0,34
Tropical Storm,Dean,3,2001-08-23T03:00:00Z,MYEG 235N 758W,2,9,0,0,11
Tropical Storm,Dean,3,2001-08-23T03:00:00Z,27.0N  72.0W,0,21,6,1,28
Tropical Storm,Dean,3,2001-08-23T03:00:00Z,MYNN 251N 775W,0,1,1,0,2
Tropical Storm,Dean,3,2001-08-23T03:00:00Z,MDPP 198N 707W,4,0,0,0,4
Tropical Storm,Dean,3,2001-08-23T03:00:00Z,BERMUDA,0,0,0,4,4
Tropical Storm,Dean,3,2001-08-23T03:00:00Z,MBJT 215N 712W,56,0,0,0,56
Tropical Storm,Dean,3,2001-08-23T03:00:00Z,MOREHEAD CITY NC,0,0,0,3,3
Tropical Storm,Dean,3,2001-08-23T03:00:00Z,MYMM 224N 730W,37,0,0,1,38
Tropical Storm,Dean,3,2001-08-23T03:00:00Z,CAPE HATTERAS NC,0,0,0,4,4
Tropical Storm,Dean,4,2001-08-23T09:00:00Z,24.1N  72.5W,51,0,0,0,51
Tropical Storm,Dean,4,2001-08-23T09:00:00Z,BERMUDA,0,0,0,4,4
Tropical Storm,Dean,4,2001-08-23T09:00:00Z,26.1N  72.5W,17,20,0,0,37
Tropical Storm,Dean,4,2001-08-23T09:00:00Z,WILMINGTON NC,0,0,0,2,2
Tropical Storm,Dean,4,2001-08-23T09:00:00Z,27.9N  71.7W,0,21,7,1,29
Tropical Storm,Dean,4,2001-08-23T09:00:00Z,MOREHEAD CITY NC,0,0,0,4,4
Tropical Storm,Dean,4,2001-08-23T09:00:00Z,MBJT 215N 712W,79,0,0,0,79
Tropical Storm,Dean,4,2001-08-23T09:00:00Z,CAPE HATTERAS NC,0,0,0,6,6
Tropical Storm,Dean,4,2001-08-23T09:00:00Z,MYMM 224N 730W,43,0,0,0,43
Tropical Storm,Dean,4,2001-08-23T09:00:00Z,NORFOLK VA,0,0,0,3,3
Tropical Storm,Dean,4,2001-08-23T09:00:00Z,MYSM 241N 745W,20,6,0,0,26
Tropical Storm,Dean,4,2001-08-23T09:00:00Z,OCEAN CITY MD,0,0,0,2,2
Tropical Storm,Dean,4,2001-08-23T09:00:00Z,MYEG 235N 758W,2,5,1,0,8
Tropical Storm,Dean,6,2001-08-27T09:00:00Z,42.0N  55.5W,22,0,0,0,22
Tropical Storm,Dean,6,2001-08-27T09:00:00Z,BURGEO NFLD,1,1,1,0,3
Tropical Storm,Dean,6,2001-08-27T09:00:00Z,43.5N  51.5W,6,9,1,1,17
Tropical Storm,Dean,6,2001-08-27T09:00:00Z,ILE ST PIERRE,2,4,0,1,7
Tropical Storm,Dean,6,2001-08-27T09:00:00Z,45.0N  47.5W,0,8,4,2,14
Tropical Storm,Dean,6,2001-08-27T09:00:00Z,CAPE RACE NFLD,1,8,1,0,10
Tropical Storm,Dean,6,2001-08-27T09:00:00Z,SABLE ISLAND NS,6,1,0,0,7
Tropical Storm,Dean,6,2001-08-27T09:00:00Z,HIBERNIA OILFLD,0,6,4,2,12
Tropical Storm,Dean,6,2001-08-27T09:00:00Z,SYDNEY NS,1,1,0,0,2
Tropical Storm,Dean,7,2001-08-27T15:00:00Z,43.2N  53.8W,26,0,0,0,26
Tropical Storm,Dean,7,2001-08-27T15:00:00Z,BURGEO NFLD,1,1,1,0,3
Tropical Storm,Dean,7,2001-08-27T15:00:00Z,45.4N  49.9W,9,9,0,1,19
Tropical Storm,Dean,7,2001-08-27T15:00:00Z,ILE ST PIERRE,3,4,0,1,8
Tropical Storm,Dean,7,2001-08-27T15:00:00Z,47.4N  45.6W,0,10,3,2,15
Tropical Storm,Dean,7,2001-08-27T15:00:00Z,CAPE RACE NFLD,6,7,0,1,14
Tropical Storm,Dean,7,2001-08-27T15:00:00Z,SABLE ISLAND NS,5,1,0,0,6
Tropical Storm,Dean,7,2001-08-27T15:00:00Z,HIBERNIA OILFLD,2,11,1,1,15
Tropical Storm,Dean,8,2001-08-27T21:00:00Z,45.7N  51.7W,25,0,0,0,25
Tropical Storm,Dean,8,2001-08-27T21:00:00Z,BURGEO NFLD,4,1,0,0,5
Tropical Storm,Dean,8,2001-08-27T21:00:00Z,47.4N  46.9W,4,10,1,1,16
Tropical Storm,Dean,8,2001-08-27T21:00:00Z,ILE ST PIERRE,14,0,1,0,15
Tropical Storm,Dean,8,2001-08-27T21:00:00Z,50.1N  42.9W,0,5,5,3,13
Tropical Storm,Dean,8,2001-08-27T21:00:00Z,CAPE RACE NFLD,21,1,0,0,22
Tropical Storm,Dean,8,2001-08-27T21:00:00Z,SABLE ISLAND NS,6,0,0,0,6
Tropical Storm,Dean,8,2001-08-27T21:00:00Z,HIBERNIA OILFLD,9,7,1,0,17
Tropical Storm,Dean,9,2001-08-28T03:00:00Z,48.2N  50.2W,28,0,0,0,28
Tropical Storm,Dean,9,2001-08-28T03:00:00Z,ILE ST PIERRE,25,0,0,0,25
Tropical Storm,Dean,9,2001-08-28T03:00:00Z,50.2N  46.1W,6,10,1,1,18
Tropical Storm,Dean,9,2001-08-28T03:00:00Z,CAPE RACE NFLD,35,0,0,0,35
Tropical Storm,Dean,9,2001-08-28T03:00:00Z,53.1N  42.0W,0,6,6,2,14
Tropical Storm,Dean,9,2001-08-28T03:00:00Z,HIBERNIA OILFLD,21,2,0,0,23
Tropical Storm,Dean,9,2001-08-28T03:00:00Z,BURGEO NFLD,6,0,1,0,7
Tropical Storm,Dean,10,2001-08-28T09:00:00Z,47.8N  46.6W,28,0,0,0,28
Tropical Storm,Dean,10,2001-08-28T09:00:00Z,CAPE RACE NFLD,24,0,0,0,24
Tropical Storm,Dean,10,2001-08-28T09:00:00Z,50.3N  41.8W,3,12,1,0,16
Tropical Storm,Dean,10,2001-08-28T09:00:00Z,HIBERNIA OILFLD,32,0,0,0,32
Tropical Storm,Dean,10,2001-08-28T09:00:00Z,53.0N  37.0W,0,5,5,0,10
Tropical Storm,Dean,11,2001-08-28T15:00:00Z,48.2N  44.5W,27,0,1,0,28
Tropical Storm,Dean,11,2001-08-28T15:00:00Z,CAPE RACE NFLD,2,0,0,0,2
Tropical Storm,Dean,11,2001-08-28T15:00:00Z,51.1N  39.2W,2,12,1,0,15
Tropical Storm,Dean,11,2001-08-28T15:00:00Z,HIBERNIA OILFLD,31,0,0,0,31
Tropical Storm,Dean,11,2001-08-28T15:00:00Z,54.3N  33.8W,0,4,6,0,10
Tropical Depression,Six,1,2001-09-01T21:00:00Z,14.3N  41.1W,46,0,0,0,46
Tropical Depression,Six,1,2001-09-01T21:00:00Z,16.2N  47.3W,0,11,13,1,25
Tropical Depression,Six,1,2001-09-01T21:00:00Z,15.2N  44.3W,3,29,0,0,32
Tropical Depression,Six,2,2001-09-02T03:00:00Z,14.7N  42.4W,46,0,1,0,47
Tropical Depression,Six,2,2001-09-02T03:00:00Z,16.6N  48.8W,0,11,13,1,25
Tropical Depression,Six,2,2001-09-02T03:00:00Z,15.6N  45.7W,3,29,1,0,33
Tropical Storm,Erin,3,2001-09-02T09:00:00Z,14.5N  43.8W,44,0,0,1,45
Tropical Storm,Erin,3,2001-09-02T09:00:00Z,15.8N  49.1W,0,15,8,1,24
Tropical Storm,Erin,3,2001-09-02T09:00:00Z,15.1N  46.5W,8,23,0,0,31
Tropical Storm,Erin,4,2001-09-02T15:00:00Z,15.1N  44.7W,47,0,0,1,48
Tropical Storm,Erin,4,2001-09-02T15:00:00Z,16.8N  49.8W,0,16,9,1,26
Tropical Storm,Erin,4,2001-09-02T15:00:00Z,16.0N  47.2W,12,22,0,0,34
Tropical Storm,Erin,5,2001-09-02T21:00:00Z,15.4N  46.2W,47,0,0,0,47
Tropical Storm,Erin,5,2001-09-02T21:00:00Z,TDPR 153N 614W,0,0,0,2,2
Tropical Storm,Erin,5,2001-09-02T21:00:00Z,16.1N  48.7W,11,21,1,0,33
Tropical Storm,Erin,5,2001-09-02T21:00:00Z,TFFR 163N 615W,0,0,0,3,3
Tropical Storm,Erin,5,2001-09-02T21:00:00Z,17.0N  51.3W,0,16,9,1,26
Tropical Storm,Erin,5,2001-09-02T21:00:00Z,TAPA 171N 618W,0,0,0,3,3
Tropical Storm,Erin,5,2001-09-02T21:00:00Z,TBPB 131N 595W,0,0,0,2,2
Tropical Storm,Erin,5,2001-09-02T21:00:00Z,TKPK 173N 627W,0,0,0,2,2
Tropical Storm,Erin,5,2001-09-02T21:00:00Z,TFFF 146N 610W,0,0,0,2,2
Tropical Storm,Erin,6,2001-09-03T03:00:00Z,16.3N  47.3W,47,0,0,0,47
Tropical Storm,Erin,6,2001-09-03T03:00:00Z,TDPR 153N 614W,0,0,0,2,2
Tropical Storm,Erin,6,2001-09-03T03:00:00Z,17.2N  50.0W,8,26,0,0,34
Tropical Storm,Erin,6,2001-09-03T03:00:00Z,TFFR 163N 615W,0,0,0,3,3
Tropical Storm,Erin,6,2001-09-03T03:00:00Z,18.2N  52.5W,0,17,8,1,26
Tropical Storm,Erin,6,2001-09-03T03:00:00Z,TAPA 171N 618W,0,0,0,3,3
Tropical Storm,Erin,6,2001-09-03T03:00:00Z,TBPB 131N 595W,0,0,0,2,2
Tropical Storm,Erin,6,2001-09-03T03:00:00Z,TKPK 173N 627W,0,0,0,2,2
Tropical Storm,Erin,6,2001-09-03T03:00:00Z,TFFF 146N 610W,0,0,0,2,2
Tropical Storm,Erin,6,2001-09-03T03:00:00Z,TNCM 181N 631W,0,0,0,2,2
Tropical Storm,Erin,7,2001-09-03T09:00:00Z,16.9N  48.6W,52,0,0,0,52
Tropical Storm,Erin,7,2001-09-03T09:00:00Z,TFFF 146N 610W,0,0,0,3,3
Tropical Storm,Erin,7,2001-09-03T09:00:00Z,17.8N  51.2W,12,25,0,0,37
Tropical Storm,Erin,7,2001-09-03T09:00:00Z,TDPR 153N 614W,0,0,0,4,4
Tropical Storm,Erin,7,2001-09-03T09:00:00Z,18.7N  53.6W,0,20,7,1,28
Tropical Storm,Erin,7,2001-09-03T09:00:00Z,TFFR 163N 615W,0,0,0,5,5
Tropical Storm,Erin,7,2001-09-03T09:00:00Z,TBPB 131N 595W,0,0,0,4,4
Tropical Storm,Erin,7,2001-09-03T09:00:00Z,TAPA 171N 618W,0,0,0,5,5
Tropical Storm,Erin,7,2001-09-03T09:00:00Z,TVSV 131N 612W,0,0,0,2,2
Tropical Storm,Erin,7,2001-09-03T09:00:00Z,TKPK 173N 627W,0,0,0,3,3
Tropical Storm,Erin,7,2001-09-03T09:00:00Z,TLPL 138N 610W,0,0,0,3,3
Tropical Storm,Erin,7,2001-09-03T09:00:00Z,TNCM 181N 631W,0,0,0,3,3
Tropical Storm,Erin,8,2001-09-03T15:00:00Z,17.9N  51.1W,54,0,0,0,54
Tropical Storm,Erin,8,2001-09-03T15:00:00Z,TAPA 171N 618W,0,0,0,2,2
Tropical Storm,Erin,8,2001-09-03T15:00:00Z,18.9N  53.5W,8,30,0,0,38
Tropical Storm,Erin,8,2001-09-03T15:00:00Z,TNCM 181N 631W,0,0,0,2,2
Tropical Storm,Erin,8,2001-09-03T15:00:00Z,19.9N  55.8W,0,15,15,1,31
Tropical Storm,Erin,9,2001-09-03T21:00:00Z,17.7N  53.1W,48,0,0,0,48
Tropical Storm,Erin,9,2001-09-03T21:00:00Z,TAPA 171N 618W,0,0,1,4,5
Tropical Storm,Erin,9,2001-09-03T21:00:00Z,18.8N  55.8W,1,33,0,0,34
Tropical Storm,Erin,9,2001-09-03T21:00:00Z,TKPK 173N 627W,0,0,0,4,4
Tropical Storm,Erin,9,2001-09-03T21:00:00Z,20.2N  58.1W,0,8,18,1,27
Tropical Storm,Erin,9,2001-09-03T21:00:00Z,TNCM 181N 631W,0,0,0,5,5
Tropical Storm,Erin,9,2001-09-03T21:00:00Z,TFFR 163N 615W,0,0,1,3,4
Tropical Storm,Erin,10,2001-09-04T03:00:00Z,18.6N  54.5W,52,0,0,0,52
Tropical Storm,Erin,10,2001-09-04T03:00:00Z,TKPK 173N 627W,0,0,1,2,3
Tropical Storm,Erin,10,2001-09-04T03:00:00Z,19.8N  57.0W,3,31,1,0,35
Tropical Storm,Erin,10,2001-09-04T03:00:00Z,TNCM 181N 631W,0,0,1,4,5
Tropical Storm,Erin,10,2001-09-04T03:00:00Z,21.0N  59.0W,0,14,12,1,27
Tropical Storm,Erin,10,2001-09-04T03:00:00Z,TIST 183N 650W,0,0,0,2,2
Tropical Storm,Erin,10,2001-09-04T03:00:00Z,TFFR 163N 615W,0,0,1,1,2
Tropical Storm,Erin,10,2001-09-04T03:00:00Z,ST THOMAS VI,0,0,0,2,2
Tropical Storm,Erin,10,2001-09-04T03:00:00Z,TAPA 171N 618W,0,0,2,2,4
Tropical Storm,Erin,11,2001-09-04T09:00:00Z,18.9N  56.5W,49,0,0,0,49
Tropical Storm,Erin,11,2001-09-04T09:00:00Z,TISX 177N 648W,0,0,0,3,3
Tropical Storm,Erin,11,2001-09-04T09:00:00Z,20.4N  59.0W,1,32,0,1,34
Tropical Storm,Erin,11,2001-09-04T09:00:00Z,TIST 183N 650W,0,0,1,3,4
Tropical Storm,Erin,11,2001-09-04T09:00:00Z,21.7N  60.5W,0,18,7,1,26
Tropical Storm,Erin,11,2001-09-04T09:00:00Z,TJSJ 184N 661W,0,0,0,2,2
Tropical Storm,Erin,11,2001-09-04T09:00:00Z,TFFR 163N 615W,0,1,1,2,4
Tropical Storm,Erin,11,2001-09-04T09:00:00Z,ST CROIX VI,0,0,0,3,3
Tropical Storm,Erin,11,2001-09-04T09:00:00Z,TAPA 171N 618W,0,1,3,2,6
Tropical Storm,Erin,11,2001-09-04T09:00:00Z,ST THOMAS VI,0,0,1,3,4
Tropical Storm,Erin,11,2001-09-04T09:00:00Z,TKPK 173N 627W,0,0,3,2,5
Tropical Storm,Erin,11,2001-09-04T09:00:00Z,SAN JUAN PR,0,0,0,2,2
Tropical Storm,Erin,11,2001-09-04T09:00:00Z,TNCM 181N 631W,0,0,4,4,8
Tropical Storm,Erin,12,2001-09-04T15:00:00Z,18.5N  58.0W,48,1,0,0,49
Tropical Storm,Erin,12,2001-09-04T15:00:00Z,TNCM 181N 631W,0,2,5,3,10
Tropical Storm,Erin,12,2001-09-04T15:00:00Z,20.0N  60.0W,9,26,0,0,35
Tropical Storm,Erin,12,2001-09-04T15:00:00Z,TISX 177N 648W,0,0,1,3,4
Tropical Storm,Erin,12,2001-09-04T15:00:00Z,21.5N  61.5W,0,20,7,1,28
Tropical Storm,Erin,12,2001-09-04T15:00:00Z,TIST 183N 650W,0,0,1,4,5
Tropical Storm,Erin,12,2001-09-04T15:00:00Z,TDPR 153N 614W,0,1,0,1,2
Tropical Storm,Erin,12,2001-09-04T15:00:00Z,TJSJ 184N 661W,0,0,0,3,3
Tropical Storm,Erin,12,2001-09-04T15:00:00Z,TFFR 163N 615W,0,3,2,1,6
Tropical Storm,Erin,12,2001-09-04T15:00:00Z,ST CROIX VI,0,0,1,3,4
Tropical Storm,Erin,12,2001-09-04T15:00:00Z,TAPA 171N 618W,0,5,3,1,9
Tropical Storm,Erin,12,2001-09-04T15:00:00Z,ST THOMAS VI,0,0,1,4,5
Tropical Storm,Erin,12,2001-09-04T15:00:00Z,TKPK 173N 627W,0,2,3,2,7
Tropical Storm,Erin,12,2001-09-04T15:00:00Z,SAN JUAN PR,0,0,0,3,3
Tropical Storm,Erin,13,2001-09-04T21:00:00Z,19.0N  58.5W,49,0,0,0,49
Tropical Storm,Erin,13,2001-09-04T21:00:00Z,TISX 177N 648W,0,0,3,4,7
Tropical Storm,Erin,13,2001-09-04T21:00:00Z,20.5N  60.5W,7,26,1,0,34
Tropical Storm,Erin,13,2001-09-04T21:00:00Z,TIST 183N 650W,0,0,3,5,8
Tropical Storm,Erin,13,2001-09-04T21:00:00Z,21.5N  62.0W,0,20,5,1,26
Tropical Storm,Erin,13,2001-09-04T21:00:00Z,TJPS 180N 666W,0,0,0,4,4
Tropical Storm,Erin,13,2001-09-04T21:00:00Z,TDPR 153N 614W,0,1,0,1,2
Tropical Storm,Erin,13,2001-09-04T21:00:00Z,TJSJ 184N 661W,0,0,1,5,6
Tropical Storm,Erin,13,2001-09-04T21:00:00Z,TFFR 163N 615W,0,3,1,1,5
Tropical Storm,Erin,13,2001-09-04T21:00:00Z,ST CROIX VI,0,0,3,4,7
Tropical Storm,Erin,13,2001-09-04T21:00:00Z,TAPA 171N 618W,0,6,2,1,9
Tropical Storm,Erin,13,2001-09-04T21:00:00Z,ST THOMAS VI,0,0,3,5,8
Tropical Storm,Erin,13,2001-09-04T21:00:00Z,TKPK 173N 627W,0,3,3,3,9
Tropical Storm,Erin,13,2001-09-04T21:00:00Z,SAN JUAN PR,0,0,1,5,6
Tropical Storm,Erin,13,2001-09-04T21:00:00Z,TNCM 181N 631W,0,4,5,3,12
Tropical Storm,Erin,13,2001-09-04T21:00:00Z,PONCE PR,0,0,0,4,4
Tropical Storm,Erin,14,2001-09-05T03:00:00Z,19.8N  59.5W,52,0,0,0,52
Tropical Storm,Erin,14,2001-09-05T03:00:00Z,TISX 177N 648W,0,0,1,2,3
Tropical Storm,Erin,14,2001-09-05T03:00:00Z,21.0N  61.0W,17,19,0,0,36
Tropical Storm,Erin,14,2001-09-05T03:00:00Z,TIST 183N 650W,0,0,2,2,4
Tropical Storm,Erin,14,2001-09-05T03:00:00Z,22.0N  62.0W,1,25,2,1,29
Tropical Storm,Erin,14,2001-09-05T03:00:00Z,TJSJ 184N 661W,0,0,0,2,2
Tropical Storm,Erin,14,2001-09-05T03:00:00Z,TFFR 163N 615W,0,1,1,1,3
Tropical Storm,Erin,14,2001-09-05T03:00:00Z,ST CROIX VI,0,0,1,2,3
Tropical Storm,Erin,14,2001-09-05T03:00:00Z,TAPA 171N 618W,1,4,1,1,7
Tropical Storm,Erin,14,2001-09-05T03:00:00Z,ST THOMAS VI,0,0,2,2,4
Tropical Storm,Erin,14,2001-09-05T03:00:00Z,TKPK 173N 627W,0,2,2,2,6
Tropical Storm,Erin,14,2001-09-05T03:00:00Z,SAN JUAN PR,0,0,0,2,2
Tropical Storm,Erin,14,2001-09-05T03:00:00Z,TNCM 181N 631W,0,4,3,2,9
Tropical Storm,Erin,15,2001-09-05T09:00:00Z,20.7N  61.4W,56,0,0,0,56
Tropical Storm,Erin,15,2001-09-05T09:00:00Z,TIST 183N 650W,0,3,2,1,6
Tropical Storm,Erin,15,2001-09-05T09:00:00Z,22.0N  62.7W,10,30,0,0,40
Tropical Storm,Erin,15,2001-09-05T09:00:00Z,TJPS 180N 666W,0,0,1,1,2
Tropical Storm,Erin,15,2001-09-05T09:00:00Z,23.2N  64.0W,0,21,10,1,32
Tropical Storm,Erin,15,2001-09-05T09:00:00Z,TJSJ 184N 661W,0,0,2,2,4
Tropical Storm,Erin,15,2001-09-05T09:00:00Z,TAPA 171N 618W,2,0,0,1,3
Tropical Storm,Erin,15,2001-09-05T09:00:00Z,ST CROIX VI,0,2,1,1,4
Tropical Storm,Erin,15,2001-09-05T09:00:00Z,TKPK 173N 627W,2,2,1,0,5
Tropical Storm,Erin,15,2001-09-05T09:00:00Z,ST THOMAS VI,0,3,2,1,6
Tropical Storm,Erin,15,2001-09-05T09:00:00Z,TNCM 181N 631W,6,6,0,1,13
Tropical Storm,Erin,15,2001-09-05T09:00:00Z,SAN JUAN PR,0,0,2,2,4
Tropical Storm,Erin,15,2001-09-05T09:00:00Z,TISX 177N 648W,0,2,1,1,4
Tropical Storm,Erin,15,2001-09-05T09:00:00Z,PONCE PR,0,0,1,1,2
Tropical Storm,Erin,16,2001-09-05T15:00:00Z,19.5N  60.5W,49,0,0,0,49
Tropical Storm,Erin,16,2001-09-05T15:00:00Z,TISX 177N 648W,0,1,6,4,11
Tropical Storm,Erin,16,2001-09-05T15:00:00Z,20.5N  62.0W,12,26,1,0,39
Tropical Storm,Erin,16,2001-09-05T15:00:00Z,TIST 183N 650W,0,1,7,5,13
Tropical Storm,Erin,16,2001-09-05T15:00:00Z,21.0N  63.0W,1,28,3,1,33
Tropical Storm,Erin,16,2001-09-05T15:00:00Z,TJPS 180N 666W,0,0,1,5,6
Tropical Storm,Erin,16,2001-09-05T15:00:00Z,TDPR 153N 614W,0,1,1,1,3
Tropical Storm,Erin,16,2001-09-05T15:00:00Z,TJSJ 184N 661W,0,0,3,6,9
Tropical Storm,Erin,16,2001-09-05T15:00:00Z,TFFR 163N 615W,3,5,0,2,10
Tropical Storm,Erin,16,2001-09-05T15:00:00Z,ST CROIX VI,0,1,6,4,11
Tropical Storm,Erin,16,2001-09-05T15:00:00Z,TAPA 171N 618W,8,8,1,1,18
Tropical Storm,Erin,16,2001-09-05T15:00:00Z,ST THOMAS VI,0,1,7,5,13
Tropical Storm,Erin,16,2001-09-05T15:00:00Z,TKPK 173N 627W,2,11,2,1,16
Tropical Storm,Erin,16,2001-09-05T15:00:00Z,SAN JUAN PR,0,0,3,6,9
Tropical Storm,Erin,16,2001-09-05T15:00:00Z,TNCM 181N 631W,2,14,3,1,20
Tropical Storm,Erin,16,2001-09-05T15:00:00Z,PONCE PR,0,0,1,5,6
Tropical Depression,Erin,18,2001-09-06T21:00:00Z,24.8N  60.2W,45,0,0,0,45
Tropical Depression,Erin,18,2001-09-06T21:00:00Z,26.5N  62.0W,8,9,3,2,22
Tropical Depression,Erin,18,2001-09-06T21:00:00Z,25.5N  61.0W,25,2,1,0,28
Tropical Depression,Erin,18,2001-09-06T21:00:00Z,BERMUDA,0,0,1,7,8
Tropical Depression,Erin,19,2001-09-07T03:00:00Z,25.6N  60.2W,37,0,0,0,37
Tropical Depression,Erin,19,2001-09-07T03:00:00Z,27.2N  62.0W,6,10,3,2,21
Tropical Depression,Erin,19,2001-09-07T03:00:00Z,26.3N  61.0W,21,3,1,1,26
Tropical Depression,Erin,19,2001-09-07T03:00:00Z,BERMUDA,0,0,2,8,10
Tropical Depression,Erin,20,2001-09-07T09:00:00Z,26.3N  58.4W,40,1,0,0,41
Tropical Depression,Erin,20,2001-09-07T09:00:00Z,28.6N  60.6W,6,12,2,2,22
Tropical Depression,Erin,20,2001-09-07T09:00:00Z,27.4N  59.4W,24,2,1,0,27
Tropical Depression,Erin,20,2001-09-07T09:00:00Z,BERMUDA,0,0,3,9,12
Tropical Depression,Erin,21,2001-09-07T15:00:00Z,26.5N  59.5W,36,1,0,0,37
Tropical Depression,Erin,21,2001-09-07T15:00:00Z,29.5N  61.5W,0,13,5,3,21
Tropical Depression,Erin,21,2001-09-07T15:00:00Z,28.0N  60.5W,10,12,1,1,24
Tropical Depression,Erin,21,2001-09-07T15:00:00Z,BERMUDA,0,0,6,9,15
Tropical Storm,Erin,22,2001-09-07T21:00:00Z,28.5N  59.3W,35,0,0,0,35
Tropical Storm,Erin,22,2001-09-07T21:00:00Z,BERMUDA,0,2,10,5,17
Tropical Storm,Erin,22,2001-09-07T21:00:00Z,30.5N  60.0W,14,11,1,0,26
Tropical Storm,Erin,22,2001-09-07T21:00:00Z,NANTUCKET MA,0,0,0,2,2
Tropical Storm,Erin,22,2001-09-07T21:00:00Z,32.5N  62.0W,0,11,10,2,23
Tropical Storm,Erin,23,2001-09-08T03:00:00Z,28.8N  58.8W,42,1,0,0,43
Tropical Storm,Erin,23,2001-09-08T03:00:00Z,MONTAUK POINT NY,0,0,0,2,2
Tropical Storm,Erin,23,2001-09-08T03:00:00Z,30.5N  60.0W,20,6,0,0,26
Tropical Storm,Erin,23,2001-09-08T03:00:00Z,PROVIDENCE RI,0,0,0,2,2
Tropical Storm,Erin,23,2001-09-08T03:00:00Z,32.0N  61.5W,2,14,3,1,20
Tropical Storm,Erin,23,2001-09-08T03:00:00Z,NANTUCKET MA,0,0,0,2,2
Tropical Storm,Erin,23,2001-09-08T03:00:00Z,BERMUDA,0,3,8,4,15
Tropical Storm,Erin,23,2001-09-08T03:00:00Z,HYANNIS MA,0,0,0,2,2
Tropical Storm,Erin,24,2001-09-08T09:00:00Z,29.4N  60.6W,38,0,0,0,38
Tropical Storm,Erin,24,2001-09-08T09:00:00Z,NORFOLK VA,0,0,0,2,2
Tropical Storm,Erin,24,2001-09-08T09:00:00Z,31.0N  61.8W,8,16,1,0,25
Tropical Storm,Erin,24,2001-09-08T09:00:00Z,OCEAN CITY MD,0,0,0,2,2
Tropical Storm,Erin,24,2001-09-08T09:00:00Z,32.5N  63.5W,0,11,7,2,20
Tropical Storm,Erin,24,2001-09-08T09:00:00Z,ATLANTIC CITY NJ,0,0,0,2,2
Tropical Storm,Erin,24,2001-09-08T09:00:00Z,BERMUDA,0,7,9,3,19
Tropical Storm,Erin,24,2001-09-08T09:00:00Z,NANTUCKET MA,0,0,0,2,2
Tropical Storm,Erin,24,2001-09-08T09:00:00Z,CAPE HATTERAS NC,0,0,0,2,2
Tropical Storm,Erin,25,2001-09-08T15:00:00Z,30.5N  61.7W,40,0,0,0,40
Tropical Storm,Erin,25,2001-09-08T15:00:00Z,MONTAUK POINT NY,0,0,0,2,2
Tropical Storm,Erin,25,2001-09-08T15:00:00Z,32.0N  63.0W,18,9,1,0,28
Tropical Storm,Erin,25,2001-09-08T15:00:00Z,NANTUCKET MA,0,0,0,2,2
Tropical Storm,Erin,25,2001-09-08T15:00:00Z,33.5N  64.5W,1,16,4,2,23
Tropical Storm,Erin,25,2001-09-08T15:00:00Z,HYANNIS MA,0,0,0,2,2
Tropical Storm,Erin,25,2001-09-08T15:00:00Z,BERMUDA,3,15,3,1,22
Hurricane,Erin,26,2001-09-08T21:00:00Z,32.5N  64.5W,49,0,0,0,49
Hurricane,Erin,26,2001-09-08T21:00:00Z,ATLANTIC CITY NJ,0,0,0,5,5
Hurricane,Erin,26,2001-09-08T21:00:00Z,34.5N  65.0W,12,14,1,0,27
Hurricane,Erin,26,2001-09-08T21:00:00Z,NEW YORK CITY NY,0,0,0,4,4
Hurricane,Erin,26,2001-09-08T21:00:00Z,36.0N  66.0W,0,12,5,2,19
Hurricane,Erin,26,2001-09-08T21:00:00Z,MONTAUK POINT NY,0,0,0,5,5
Hurricane,Erin,26,2001-09-08T21:00:00Z,BERMUDA,49,0,0,0,49
Hurricane,Erin,26,2001-09-08T21:00:00Z,PROVIDENCE RI,0,0,0,4,4
Hurricane,Erin,26,2001-09-08T21:00:00Z,MOREHEAD CITY NC,0,0,0,2,2
Hurricane,Erin,26,2001-09-08T21:00:00Z,NANTUCKET MA,0,0,0,5,5
Hurricane,Erin,26,2001-09-08T21:00:00Z,CAPE HATTERAS NC,0,0,0,3,3
Hurricane,Erin,26,2001-09-08T21:00:00Z,HYANNIS MA,0,0,0,4,4
Hurricane,Erin,26,2001-09-08T21:00:00Z,NORFOLK VA,0,0,0,3,3
Hurricane,Erin,26,2001-09-08T21:00:00Z,BOSTON MA,0,0,0,3,3
Hurricane,Erin,26,2001-09-08T21:00:00Z,OCEAN CITY MD,0,0,0,5,5
Hurricane,Erin,26,2001-09-08T21:00:00Z,PORTLAND ME,0,0,0,2,2
Hurricane,Erin,27,2001-09-09T03:00:00Z,33.4N  63.7W,43,0,0,0,43
Hurricane,Erin,27,2001-09-09T03:00:00Z,MONTAUK POINT NY,0,0,1,7,8
Hurricane,Erin,27,2001-09-09T03:00:00Z,34.8N  65.2W,15,10,0,1,26
Hurricane,Erin,27,2001-09-09T03:00:00Z,PROVIDENCE RI,0,0,1,6,7
Hurricane,Erin,27,2001-09-09T03:00:00Z,36.5N  66.0W,1,11,4,3,19
Hurricane,Erin,27,2001-09-09T03:00:00Z,NANTUCKET MA,0,0,1,7,8
Hurricane,Erin,27,2001-09-09T03:00:00Z,BERMUDA,36,0,0,0,36
Hurricane,Erin,27,2001-09-09T03:00:00Z,HYANNIS MA,0,0,1,7,8
Hurricane,Erin,27,2001-09-09T03:00:00Z,CAPE HATTERAS NC,0,0,0,3,3
Hurricane,Erin,27,2001-09-09T03:00:00Z,BOSTON MA,0,0,0,6,6
Hurricane,Erin,27,2001-09-09T03:00:00Z,NORFOLK VA,0,0,0,3,3
Hurricane,Erin,27,2001-09-09T03:00:00Z,PORTLAND ME,0,0,0,4,4
Hurricane,Erin,27,2001-09-09T03:00:00Z,OCEAN CITY MD,0,0,1,5,6
Hurricane,Erin,27,2001-09-09T03:00:00Z,BAR HARBOR ME,0,0,0,3,3
Hurricane,Erin,27,2001-09-09T03:00:00Z,ATLANTIC CITY NJ,0,0,1,5,6
Hurricane,Erin,27,2001-09-09T03:00:00Z,EASTPORT ME,0,0,0,2,2
Hurricane,Erin,27,2001-09-09T03:00:00Z,NEW YORK CITY NY,0,0,1,6,7
Hurricane,Erin,27,2001-09-09T03:00:00Z,YARMOUTH NS,0,0,0,3,3
Hurricane,Erin,28,2001-09-09T09:00:00Z,34.1N  65.0W,52,0,0,0,52
Hurricane,Erin,28,2001-09-09T09:00:00Z,MONTAUK POINT NY,0,0,0,5,5
Hurricane,Erin,28,2001-09-09T09:00:00Z,35.7N  66.0W,19,9,0,0,28
Hurricane,Erin,28,2001-09-09T09:00:00Z,PROVIDENCE RI,0,0,0,5,5
Hurricane,Erin,28,2001-09-09T09:00:00Z,37.0N  66.0W,2,15,2,2,21
Hurricane,Erin,28,2001-09-09T09:00:00Z,NANTUCKET MA,0,0,1,5,6
Hurricane,Erin,28,2001-09-09T09:00:00Z,BERMUDA,62,0,0,0,62
Hurricane,Erin,28,2001-09-09T09:00:00Z,HYANNIS MA,0,0,0,5,5
Hurricane,Erin,28,2001-09-09T09:00:00Z,CAPE HATTERAS NC,0,0,1,1,2
Hurricane,Erin,28,2001-09-09T09:00:00Z,BOSTON MA,0,0,0,4,4
Hurricane,Erin,28,2001-09-09T09:00:00Z,NORFOLK VA,0,0,0,3,3
Hurricane,Erin,28,2001-09-09T09:00:00Z,PORTLAND ME,0,0,0,2,2
Hurricane,Erin,28,2001-09-09T09:00:00Z,OCEAN CITY MD,0,0,1,3,4
Hurricane,Erin,28,2001-09-09T09:00:00Z,BAR HARBOR ME,0,0,0,2,2
Hurricane,Erin,28,2001-09-09T09:00:00Z,ATLANTIC CITY NJ,0,0,0,4,4
Hurricane,Erin,28,2001-09-09T09:00:00Z,YARMOUTH NS,0,0,0,2,2
Hurricane,Erin,28,2001-09-09T09:00:00Z,NEW YORK CITY NY,0,0,0,4,4
Hurricane,Erin,29,2001-09-09T15:00:00Z,35.2N  65.2W,36,0,0,1,37
Hurricane,Erin,29,2001-09-09T15:00:00Z,NANTUCKET MA,0,0,1,7,8
Hurricane,Erin,29,2001-09-09T15:00:00Z,36.4N  65.5W,15,6,1,1,23
Hurricane,Erin,29,2001-09-09T15:00:00Z,HYANNIS MA,0,0,1,6,7
Hurricane,Erin,29,2001-09-09T15:00:00Z,37.2N  65.5W,4,11,2,3,20
Hurricane,Erin,29,2001-09-09T15:00:00Z,BOSTON MA,0,0,0,5,5
Hurricane,Erin,29,2001-09-09T15:00:00Z,BERMUDA,66,0,0,0,66
Hurricane,Erin,29,2001-09-09T15:00:00Z,PORTLAND ME,0,0,0,4,4
Hurricane,Erin,29,2001-09-09T15:00:00Z,CAPE HATTERAS NC,0,0,0,2,2
Hurricane,Erin,29,2001-09-09T15:00:00Z,BAR HARBOR ME,0,0,0,4,4
Hurricane,Erin,29,2001-09-09T15:00:00Z,NORFOLK VA,0,0,0,2,2
Hurricane,Erin,29,2001-09-09T15:00:00Z,EASTPORT ME,0,0,0,3,3
Hurricane,Erin,29,2001-09-09T15:00:00Z,OCEAN CITY MD,0,0,1,2,3
Hurricane,Erin,29,2001-09-09T15:00:00Z,ST JOHN NB,0,0,0,2,2
Hurricane,Erin,29,2001-09-09T15:00:00Z,ATLANTIC CITY NJ,0,0,0,4,4
Hurricane,Erin,29,2001-09-09T15:00:00Z,YARMOUTH NS,0,0,0,4,4
Hurricane,Erin,29,2001-09-09T15:00:00Z,NEW YORK CITY NY,0,0,0,4,4
Hurricane,Erin,29,2001-09-09T15:00:00Z,HALIFAX NS,0,0,0,3,3
Hurricane,Erin,29,2001-09-09T15:00:00Z,MONTAUK POINT NY,0,0,1,5,6
Hurricane,Erin,29,2001-09-09T15:00:00Z,SABLE ISLAND NS,0,0,0,2,2
Hurricane,Erin,29,2001-09-09T15:00:00Z,PROVIDENCE RI,0,0,0,6,6
Hurricane,Erin,30,2001-09-09T21:00:00Z,35.6N  64.0W,41,0,0,0,41
Hurricane,Erin,30,2001-09-09T21:00:00Z,PORTLAND ME,0,0,0,3,3
Hurricane,Erin,30,2001-09-09T21:00:00Z,36.5N  64.0W,25,2,0,1,28
Hurricane,Erin,30,2001-09-09T21:00:00Z,BAR HARBOR ME,0,0,0,3,3
Hurricane,Erin,30,2001-09-09T21:00:00Z,37.5N  63.0W,7,8,2,3,20
Hurricane,Erin,30,2001-09-09T21:00:00Z,EASTPORT ME,0,0,0,3,3
Hurricane,Erin,30,2001-09-09T21:00:00Z,BERMUDA,38,0,0,1,39
Hurricane,Erin,30,2001-09-09T21:00:00Z,ST JOHN NB,0,0,0,3,3
Hurricane,Erin,30,2001-09-09T21:00:00Z,NEW YORK CITY NY,0,0,0,2,2
Hurricane,Erin,30,2001-09-09T21:00:00Z,MONCTON NB,0,0,0,2,2
Hurricane,Erin,30,2001-09-09T21:00:00Z,MONTAUK POINT NY,0,0,0,3,3
Hurricane,Erin,30,2001-09-09T21:00:00Z,YARMOUTH NS,0,0,0,5,5
Hurricane,Erin,30,2001-09-09T21:00:00Z,PROVIDENCE RI,0,0,0,4,4
Hurricane,Erin,30,2001-09-09T21:00:00Z,HALIFAX NS,0,0,0,4,4
Hurricane,Erin,30,2001-09-09T21:00:00Z,NANTUCKET MA,0,0,1,4,5
Hurricane,Erin,30,2001-09-09T21:00:00Z,SABLE ISLAND NS,0,0,0,4,4
Hurricane,Erin,30,2001-09-09T21:00:00Z,HYANNIS MA,0,0,1,4,5
Hurricane,Erin,30,2001-09-09T21:00:00Z,EDDY POINT NS,0,0,0,2,2
Hurricane,Erin,30,2001-09-09T21:00:00Z,BOSTON MA,0,0,0,3,3
Hurricane,Erin,31,2001-09-10T03:00:00Z,36.0N  64.0W,38,0,0,0,38
Hurricane,Erin,31,2001-09-10T03:00:00Z,BAR HARBOR ME,0,0,0,4,4
Hurricane,Erin,31,2001-09-10T03:00:00Z,37.0N  63.5W,18,3,1,0,22
Hurricane,Erin,31,2001-09-10T03:00:00Z,EASTPORT ME,0,0,0,4,4
Hurricane,Erin,31,2001-09-10T03:00:00Z,38.2N  61.5W,0,6,7,3,16
Hurricane,Erin,31,2001-09-10T03:00:00Z,ST JOHN NB,0,0,0,4,4
Hurricane,Erin,31,2001-09-10T03:00:00Z,BERMUDA,1,2,1,1,5
Hurricane,Erin,31,2001-09-10T03:00:00Z,MONCTON NB,0,0,0,3,3
Hurricane,Erin,31,2001-09-10T03:00:00Z,MONTAUK POINT NY,0,0,1,1,2
Hurricane,Erin,31,2001-09-10T03:00:00Z,YARMOUTH NS,0,0,1,5,6
Hurricane,Erin,31,2001-09-10T03:00:00Z,PROVIDENCE RI,0,0,1,2,3
Hurricane,Erin,31,2001-09-10T03:00:00Z,HALIFAX NS,0,0,0,5,5
Hurricane,Erin,31,2001-09-10T03:00:00Z,NANTUCKET MA,0,0,2,2,4
Hurricane,Erin,31,2001-09-10T03:00:00Z,SABLE ISLAND NS,0,0,0,6,6
Hurricane,Erin,31,2001-09-10T03:00:00Z,HYANNIS MA,0,0,1,3,4
Hurricane,Erin,31,2001-09-10T03:00:00Z,SYDNEY NS,0,0,0,3,3
Hurricane,Erin,31,2001-09-10T03:00:00Z,BOSTON MA,0,0,1,2,3
Hurricane,Erin,31,2001-09-10T03:00:00Z,EDDY POINT NS,0,0,0,4,4
Hurricane,Erin,31,2001-09-10T03:00:00Z,PORTLAND ME,0,0,0,3,3
Hurricane,Erin,31,2001-09-10T03:00:00Z,PTX BASQUES NFLD,0,0,0,2,2
Hurricane,Erin,32,2001-09-10T09:00:00Z,37.1N  64.8W,39,0,0,0,39
Hurricane,Erin,32,2001-09-10T09:00:00Z,ST JOHN NB,0,0,0,5,5
Hurricane,Erin,32,2001-09-10T09:00:00Z,38.2N  63.2W,8,9,2,2,21
Hurricane,Erin,32,2001-09-10T09:00:00Z,MONCTON NB,0,0,0,5,5
Hurricane,Erin,32,2001-09-10T09:00:00Z,39.0N  61.0W,0,5,7,4,16
Hurricane,Erin,32,2001-09-10T09:00:00Z,YARMOUTH NS,0,0,1,5,6
Hurricane,Erin,32,2001-09-10T09:00:00Z,PROVIDENCE RI,0,0,1,1,2
Hurricane,Erin,32,2001-09-10T09:00:00Z,HALIFAX NS,0,0,0,7,7
Hurricane,Erin,32,2001-09-10T09:00:00Z,NANTUCKET MA,0,0,2,2,4
Hurricane,Erin,32,2001-09-10T09:00:00Z,SABLE ISLAND NS,0,0,0,8,8
Hurricane,Erin,32,2001-09-10T09:00:00Z,HYANNIS MA,0,0,2,1,3
Hurricane,Erin,32,2001-09-10T09:00:00Z,SYDNEY NS,0,0,0,5,5
Hurricane,Erin,32,2001-09-10T09:00:00Z,BOSTON MA,0,0,1,1,2
Hurricane,Erin,32,2001-09-10T09:00:00Z,EDDY POINT NS,0,0,0,6,6
Hurricane,Erin,32,2001-09-10T09:00:00Z,PORTLAND ME,0,0,0,2,2
Hurricane,Erin,32,2001-09-10T09:00:00Z,PTX BASQUES NFLD,0,0,0,3,3
Hurricane,Erin,32,2001-09-10T09:00:00Z,BAR HARBOR ME,0,0,1,3,4
Hurricane,Erin,32,2001-09-10T09:00:00Z,BURGEO NFLD,0,0,0,2,2
Hurricane,Erin,32,2001-09-10T09:00:00Z,EASTPORT ME,0,0,0,4,4
Hurricane,Erin,32,2001-09-10T09:00:00Z,ILE ST PIERRE,0,0,0,2,2
Hurricane,Erin,33,2001-09-10T15:00:00Z,37.5N  64.3W,31,1,0,0,32
Hurricane,Erin,33,2001-09-10T15:00:00Z,HALIFAX NS,0,0,1,6,7
Hurricane,Erin,33,2001-09-10T15:00:00Z,38.2N  62.4W,7,11,2,1,21
Hurricane,Erin,33,2001-09-10T15:00:00Z,SABLE ISLAND NS,0,0,1,8,9
Hurricane,Erin,33,2001-09-10T15:00:00Z,39.0N  60.5W,0,5,8,3,16
Hurricane,Erin,33,2001-09-10T15:00:00Z,SYDNEY NS,0,0,0,6,6
Hurricane,Erin,33,2001-09-10T15:00:00Z,NANTUCKET MA,0,0,1,1,2
Hurricane,Erin,33,2001-09-10T15:00:00Z,EDDY POINT NS,0,0,0,7,7
Hurricane,Erin,33,2001-09-10T15:00:00Z,BAR HARBOR ME,0,0,0,2,2
Hurricane,Erin,33,2001-09-10T15:00:00Z,PTX BASQUES NFLD,0,0,0,4,4
Hurricane,Erin,33,2001-09-10T15:00:00Z,EASTPORT ME,0,0,0,3,3
Hurricane,Erin,33,2001-09-10T15:00:00Z,BURGEO NFLD,0,0,0,4,4
Hurricane,Erin,33,2001-09-10T15:00:00Z,ST JOHN NB,0,0,0,4,4
Hurricane,Erin,33,2001-09-10T15:00:00Z,ILE ST PIERRE,0,0,0,4,4
Hurricane,Erin,33,2001-09-10T15:00:00Z,MONCTON NB,0,0,0,4,4
Hurricane,Erin,33,2001-09-10T15:00:00Z,CAPE RACE NFLD,0,0,0,2,2
Hurricane,Erin,33,2001-09-10T15:00:00Z,YARMOUTH NS,0,0,1,5,6
Hurricane,Erin,34,2001-09-10T21:00:00Z,37.5N  64.0W,29,1,0,0,30
Hurricane,Erin,34,2001-09-10T21:00:00Z,HALIFAX NS,0,0,2,5,7
Hurricane,Erin,34,2001-09-10T21:00:00Z,38.4N  62.0W,3,14,3,1,21
Hurricane,Erin,34,2001-09-10T21:00:00Z,SABLE ISLAND NS,0,0,2,8,10
Hurricane,Erin,34,2001-09-10T21:00:00Z,39.5N  59.5W,0,2,11,3,16
Hurricane,Erin,34,2001-09-10T21:00:00Z,SYDNEY NS,0,0,0,6,6
Hurricane,Erin,34,2001-09-10T21:00:00Z,BAR HARBOR ME,0,0,0,2,2
Hurricane,Erin,34,2001-09-10T21:00:00Z,EDDY POINT NS,0,0,0,7,7
Hurricane,Erin,34,2001-09-10T21:00:00Z,EASTPORT ME,0,0,1,2,3
Hurricane,Erin,34,2001-09-10T21:00:00Z,PTX BASQUES NFLD,0,0,0,5,5
Hurricane,Erin,34,2001-09-10T21:00:00Z,ST JOHN NB,0,0,1,2,3
Hurricane,Erin,34,2001-09-10T21:00:00Z,BURGEO NFLD,0,0,0,5,5
Hurricane,Erin,34,2001-09-10T21:00:00Z,MONCTON NB,0,0,0,4,4
Hurricane,Erin,34,2001-09-10T21:00:00Z,ILE ST PIERRE,0,0,0,5,5
Hurricane,Erin,34,2001-09-10T21:00:00Z,YARMOUTH NS,0,0,2,3,5
Hurricane,Erin,34,2001-09-10T21:00:00Z,CAPE RACE NFLD,0,0,0,3,3
Hurricane,Erin,35,2001-09-11T03:00:00Z,38.4N  64.0W,26,0,1,0,27
Hurricane,Erin,35,2001-09-11T03:00:00Z,HALIFAX NS,0,1,4,4,9
Hurricane,Erin,35,2001-09-11T03:00:00Z,39.0N  62.0W,4,10,3,1,18
Hurricane,Erin,35,2001-09-11T03:00:00Z,SABLE ISLAND NS,0,0,4,7,11
Hurricane,Erin,35,2001-09-11T03:00:00Z,39.5N  59.5W,0,4,8,3,15
Hurricane,Erin,35,2001-09-11T03:00:00Z,SYDNEY NS,0,0,1,7,8
Hurricane,Erin,35,2001-09-11T03:00:00Z,BERMUDA,1,1,1,0,3
Hurricane,Erin,35,2001-09-11T03:00:00Z,EDDY POINT NS,0,0,2,6,8
Hurricane,Erin,35,2001-09-11T03:00:00Z,BAR HARBOR ME,0,1,1,1,3
Hurricane,Erin,35,2001-09-11T03:00:00Z,PTX BASQUES NFLD,0,0,0,6,6
Hurricane,Erin,35,2001-09-11T03:00:00Z,EASTPORT ME,0,1,2,1,4
Hurricane,Erin,35,2001-09-11T03:00:00Z,BURGEO NFLD,0,0,0,6,6
Hurricane,Erin,35,2001-09-11T03:00:00Z,ST JOHN NB,0,1,2,2,5
Hurricane,Erin,35,2001-09-11T03:00:00Z,ILE ST PIERRE,0,0,0,6,6
Hurricane,Erin,35,2001-09-11T03:00:00Z,MONCTON NB,0,0,2,3,5
Hurricane,Erin,35,2001-09-11T03:00:00Z,CAPE RACE NFLD,0,0,0,4,4
Hurricane,Erin,35,2001-09-11T03:00:00Z,YARMOUTH NS,0,3,3,1,7
Hurricane,Erin,36,2001-09-11T09:00:00Z,38.8N  63.8W,25,1,1,0,27
Hurricane,Erin,36,2001-09-11T09:00:00Z,HALIFAX NS,0,2,4,3,9
Hurricane,Erin,36,2001-09-11T09:00:00Z,39.3N  61.7W,4,10,3,1,18
Hurricane,Erin,36,2001-09-11T09:00:00Z,SABLE ISLAND NS,0,1,5,6,12
Hurricane,Erin,36,2001-09-11T09:00:00Z,40.0N  59.3W,0,4,8,3,15
Hurricane,Erin,36,2001-09-11T09:00:00Z,SYDNEY NS,0,0,2,7,9
Hurricane,Erin,36,2001-09-11T09:00:00Z,BERMUDA,1,1,1,0,3
Hurricane,Erin,36,2001-09-11T09:00:00Z,EDDY POINT NS,0,0,4,5,9
Hurricane,Erin,36,2001-09-11T09:00:00Z,BAR HARBOR ME,0,0,1,1,2
Hurricane,Erin,36,2001-09-11T09:00:00Z,PTX BASQUES NFLD,0,0,0,7,7
Hurricane,Erin,36,2001-09-11T09:00:00Z,EASTPORT ME,0,1,1,1,3
Hurricane,Erin,36,2001-09-11T09:00:00Z,BURGEO NFLD,0,0,0,7,7
Hurricane,Erin,36,2001-09-11T09:00:00Z,ST JOHN NB,0,1,2,2,5
Hurricane,Erin,36,2001-09-11T09:00:00Z,ILE ST PIERRE,0,0,0,7,7
Hurricane,Erin,36,2001-09-11T09:00:00Z,MONCTON NB,0,0,2,3,5
Hurricane,Erin,36,2001-09-11T09:00:00Z,CAPE RACE NFLD,0,0,0,5,5
Hurricane,Erin,36,2001-09-11T09:00:00Z,YARMOUTH NS,1,3,2,1,7
Hurricane,Erin,37,2001-09-11T15:00:00Z,38.9N  62.6W,33,1,0,0,34
Hurricane,Erin,37,2001-09-11T15:00:00Z,SABLE ISLAND NS,0,2,7,4,13
Hurricane,Erin,37,2001-09-11T15:00:00Z,39.5N  60.5W,11,8,2,1,22
Hurricane,Erin,37,2001-09-11T15:00:00Z,SYDNEY NS,0,0,3,6,9
Hurricane,Erin,37,2001-09-11T15:00:00Z,40.5N  58.0W,0,9,5,3,17
Hurricane,Erin,37,2001-09-11T15:00:00Z,EDDY POINT NS,0,0,5,4,9
Hurricane,Erin,37,2001-09-11T15:00:00Z,BAR HARBOR ME,0,0,1,1,2
Hurricane,Erin,37,2001-09-11T15:00:00Z,PTX BASQUES NFLD,0,0,1,6,7
Hurricane,Erin,37,2001-09-11T15:00:00Z,EASTPORT ME,0,0,2,1,3
Hurricane,Erin,37,2001-09-11T15:00:00Z,BURGEO NFLD,0,0,1,7,8
Hurricane,Erin,37,2001-09-11T15:00:00Z,ST JOHN NB,0,0,2,2,4
Hurricane,Erin,37,2001-09-11T15:00:00Z,ILE ST PIERRE,0,0,1,8,9
Hurricane,Erin,37,2001-09-11T15:00:00Z,MONCTON NB,0,0,2,3,5
Hurricane,Erin,37,2001-09-11T15:00:00Z,CAPE RACE NFLD,0,0,0,8,8
Hurricane,Erin,37,2001-09-11T15:00:00Z,YARMOUTH NS,0,2,3,1,6
Hurricane,Erin,37,2001-09-11T15:00:00Z,HIBERNIA OILFLD,0,0,0,4,4
Hurricane,Erin,37,2001-09-11T15:00:00Z,HALIFAX NS,0,1,5,3,9
Hurricane,Erin,38,2001-09-11T21:00:00Z,39.0N  61.7W,29,1,0,0,30
Hurricane,Erin,38,2001-09-11T21:00:00Z,SABLE ISLAND NS,0,3,7,4,14
Hurricane,Erin,38,2001-09-11T21:00:00Z,39.8N  59.5W,7,13,2,1,23
Hurricane,Erin,38,2001-09-11T21:00:00Z,SYDNEY NS,0,0,2,7,9
Hurricane,Erin,38,2001-09-11T21:00:00Z,41.0N  57.5W,0,10,6,2,18
Hurricane,Erin,38,2001-09-11T21:00:00Z,EDDY POINT NS,0,0,4,5,9
Hurricane,Erin,38,2001-09-11T21:00:00Z,EASTPORT ME,0,0,0,2,2
Hurricane,Erin,38,2001-09-11T21:00:00Z,PTX BASQUES NFLD,0,0,1,6,7
Hurricane,Erin,38,2001-09-11T21:00:00Z,ST JOHN NB,0,0,1,1,2
Hurricane,Erin,38,2001-09-11T21:00:00Z,BURGEO NFLD,0,0,1,7,8
Hurricane,Erin,38,2001-09-11T21:00:00Z,MONCTON NB,0,0,1,2,3
Hurricane,Erin,38,2001-09-11T21:00:00Z,ILE ST PIERRE,0,0,1,9,10
Hurricane,Erin,38,2001-09-11T21:00:00Z,YARMOUTH NS,0,1,1,2,4
Hurricane,Erin,38,2001-09-11T21:00:00Z,CAPE RACE NFLD,0,0,0,9,9
Hurricane,Erin,38,2001-09-11T21:00:00Z,HALIFAX NS,0,1,3,3,7
Hurricane,Erin,38,2001-09-11T21:00:00Z,HIBERNIA OILFLD,0,0,0,5,5
Hurricane,Erin,39,2001-09-12T03:00:00Z,38.7N  61.2W,33,0,0,0,33
Hurricane,Erin,39,2001-09-12T03:00:00Z,SABLE ISLAND NS,0,3,9,3,15
Hurricane,Erin,39,2001-09-12T03:00:00Z,39.9N  59.6W,9,9,2,1,21
Hurricane,Erin,39,2001-09-12T03:00:00Z,SYDNEY NS,0,0,5,5,10
Hurricane,Erin,39,2001-09-12T03:00:00Z,42.0N  57.5W,0,6,9,2,17
Hurricane,Erin,39,2001-09-12T03:00:00Z,EDDY POINT NS,0,1,5,4,10
Hurricane,Erin,39,2001-09-12T03:00:00Z,EASTPORT ME,0,0,1,2,3
Hurricane,Erin,39,2001-09-12T03:00:00Z,PTX BASQUES NFLD,0,0,2,7,9
Hurricane,Erin,39,2001-09-12T03:00:00Z,ST JOHN NB,0,0,1,3,4
Hurricane,Erin,39,2001-09-12T03:00:00Z,BURGEO NFLD,0,0,2,8,10
Hurricane,Erin,39,2001-09-12T03:00:00Z,MONCTON NB,0,0,1,4,5
Hurricane,Erin,39,2001-09-12T03:00:00Z,ILE ST PIERRE,0,0,3,8,11
Hurricane,Erin,39,2001-09-12T03:00:00Z,YARMOUTH NS,0,1,1,3,5
Hurricane,Erin,39,2001-09-12T03:00:00Z,CAPE RACE NFLD,0,0,1,9,10
Hurricane,Erin,39,2001-09-12T03:00:00Z,HALIFAX NS,0,1,4,4,9
Hurricane,Erin,39,2001-09-12T03:00:00Z,HIBERNIA OILFLD,0,0,0,6,6
Hurricane,Erin,40,2001-09-12T09:00:00Z,38.7N  59.9W,32,0,0,0,32
Hurricane,Erin,40,2001-09-12T09:00:00Z,SABLE ISLAND NS,0,4,6,3,13
Hurricane,Erin,40,2001-09-12T09:00:00Z,40.0N  58.2W,9,10,1,1,21
Hurricane,Erin,40,2001-09-12T09:00:00Z,SYDNEY NS,0,0,3,5,8
Hurricane,Erin,40,2001-09-12T09:00:00Z,41.4N  56.7W,0,11,4,2,17
Hurricane,Erin,40,2001-09-12T09:00:00Z,EDDY POINT NS,0,1,3,4,8
Hurricane,Erin,40,2001-09-12T09:00:00Z,EASTPORT ME,0,0,1,1,2
Hurricane,Erin,40,2001-09-12T09:00:00Z,PTX BASQUES NFLD,0,0,1,5,6
Hurricane,Erin,40,2001-09-12T09:00:00Z,ST JOHN NB,0,0,1,2,3
Hurricane,Erin,40,2001-09-12T09:00:00Z,BURGEO NFLD,0,0,1,6,7
Hurricane,Erin,40,2001-09-12T09:00:00Z,MONCTON NB,0,0,1,2,3
Hurricane,Erin,40,2001-09-12T09:00:00Z,ILE ST PIERRE,0,0,2,7,9
Hurricane,Erin,40,2001-09-12T09:00:00Z,YARMOUTH NS,0,0,2,2,4
Hurricane,Erin,40,2001-09-12T09:00:00Z,CAPE RACE NFLD,0,0,2,7,9
Hurricane,Erin,40,2001-09-12T09:00:00Z,HALIFAX NS,0,1,3,3,7
Hurricane,Erin,40,2001-09-12T09:00:00Z,HIBERNIA OILFLD,0,0,0,5,5
Hurricane,Erin,41,2001-09-12T15:00:00Z,39.5N  59.0W,28,0,1,0,29
Hurricane,Erin,41,2001-09-12T15:00:00Z,SYDNEY NS,0,1,3,4,8
Hurricane,Erin,41,2001-09-12T15:00:00Z,41.0N  57.0W,8,9,1,1,19
Hurricane,Erin,41,2001-09-12T15:00:00Z,EDDY POINT NS,0,1,3,4,8
Hurricane,Erin,41,2001-09-12T15:00:00Z,43.0N  56.0W,1,10,3,2,16
Hurricane,Erin,41,2001-09-12T15:00:00Z,PTX BASQUES NFLD,0,0,3,4,7
Hurricane,Erin,41,2001-09-12T15:00:00Z,ST JOHN NB,0,0,0,2,2
Hurricane,Erin,41,2001-09-12T15:00:00Z,BURGEO NFLD,0,0,4,5,9
Hurricane,Erin,41,2001-09-12T15:00:00Z,MONCTON NB,0,0,0,2,2
Hurricane,Erin,41,2001-09-12T15:00:00Z,ILE ST PIERRE,0,1,5,5,11
Hurricane,Erin,41,2001-09-12T15:00:00Z,YARMOUTH NS,0,0,0,2,2
Hurricane,Erin,41,2001-09-12T15:00:00Z,CAPE RACE NFLD,0,1,4,6,11
Hurricane,Erin,41,2001-09-12T15:00:00Z,HALIFAX NS,0,1,1,3,5
Hurricane,Erin,41,2001-09-12T15:00:00Z,HIBERNIA OILFLD,0,0,1,5,6
Hurricane,Erin,41,2001-09-12T15:00:00Z,SABLE ISLAND NS,1,6,3,3,13
Hurricane,Erin,42,2001-09-12T21:00:00Z,39.5N  59.2W,28,0,0,1,29
Hurricane,Erin,42,2001-09-12T21:00:00Z,SABLE ISLAND NS,0,7,6,1,14
Hurricane,Erin,42,2001-09-12T21:00:00Z,41.5N  57.0W,9,11,1,0,21
Hurricane,Erin,42,2001-09-12T21:00:00Z,SYDNEY NS,0,0,6,4,10
Hurricane,Erin,42,2001-09-12T21:00:00Z,44.0N  54.5W,0,10,6,1,17
Hurricane,Erin,42,2001-09-12T21:00:00Z,EDDY POINT NS,0,1,5,3,9
Hurricane,Erin,42,2001-09-12T21:00:00Z,BAR HARBOR ME,0,0,0,2,2
Hurricane,Erin,42,2001-09-12T21:00:00Z,PTX BASQUES NFLD,0,0,3,6,9
Hurricane,Erin,42,2001-09-12T21:00:00Z,EASTPORT ME,0,0,1,2,3
Hurricane,Erin,42,2001-09-12T21:00:00Z,BURGEO NFLD,0,0,4,6,10
Hurricane,Erin,42,2001-09-12T21:00:00Z,ST JOHN NB,0,0,1,2,3
Hurricane,Erin,42,2001-09-12T21:00:00Z,ILE ST PIERRE,0,1,7,5,13
Hurricane,Erin,42,2001-09-12T21:00:00Z,MONCTON NB,0,0,1,3,4
Hurricane,Erin,42,2001-09-12T21:00:00Z,CAPE RACE NFLD,0,1,9,4,14
Hurricane,Erin,42,2001-09-12T21:00:00Z,YARMOUTH NS,0,0,2,2,4
Hurricane,Erin,42,2001-09-12T21:00:00Z,HIBERNIA OILFLD,0,0,6,6,12
Hurricane,Erin,42,2001-09-12T21:00:00Z,HALIFAX NS,0,1,4,2,7
Hurricane,Erin,43,2001-09-13T03:00:00Z,40.4N  58.2W,27,1,0,0,28
Hurricane,Erin,43,2001-09-13T03:00:00Z,SYDNEY NS,0,1,7,3,11
Hurricane,Erin,43,2001-09-13T03:00:00Z,42.9N  55.8W,6,16,1,0,23
Hurricane,Erin,43,2001-09-13T03:00:00Z,EDDY POINT NS,0,1,6,3,10
Hurricane,Erin,43,2001-09-13T03:00:00Z,46.0N  53.5W,0,8,10,1,19
Hurricane,Erin,43,2001-09-13T03:00:00Z,PTX BASQUES NFLD,0,0,5,6,11
Hurricane,Erin,43,2001-09-13T03:00:00Z,ST JOHN NB,0,0,1,1,2
Hurricane,Erin,43,2001-09-13T03:00:00Z,BURGEO NFLD,0,1,7,5,13
Hurricane,Erin,43,2001-09-13T03:00:00Z,MONCTON NB,0,0,1,2,3
Hurricane,Erin,43,2001-09-13T03:00:00Z,ILE ST PIERRE,0,3,10,3,16
Hurricane,Erin,43,2001-09-13T03:00:00Z,YARMOUTH NS,0,0,1,1,2
Hurricane,Erin,43,2001-09-13T03:00:00Z,CAPE RACE NFLD,0,5,11,2,18
Hurricane,Erin,43,2001-09-13T03:00:00Z,HALIFAX NS,0,1,3,3,7
Hurricane,Erin,43,2001-09-13T03:00:00Z,HIBERNIA OILFLD,0,2,9,4,15
Hurricane,Erin,43,2001-09-13T03:00:00Z,SABLE ISLAND NS,1,9,5,1,16
Hurricane,Erin,44,2001-09-13T09:00:00Z,41.6N  57.2W,25,1,0,0,26
Hurricane,Erin,44,2001-09-13T09:00:00Z,SYDNEY NS,1,7,3,0,11
Hurricane,Erin,44,2001-09-13T09:00:00Z,44.3N  54.8W,4,11,1,1,17
Hurricane,Erin,44,2001-09-13T09:00:00Z,EDDY POINT NS,1,7,1,1,10
Hurricane,Erin,44,2001-09-13T09:00:00Z,48.0N  52.0W,0,4,7,3,14
Hurricane,Erin,44,2001-09-13T09:00:00Z,PTX BASQUES NFLD,0,6,4,1,11
Hurricane,Erin,44,2001-09-13T09:00:00Z,ST JOHN NB,0,1,0,1,2
Hurricane,Erin,44,2001-09-13T09:00:00Z,BURGEO NFLD,0,7,5,1,13
Hurricane,Erin,44,2001-09-13T09:00:00Z,MONCTON NB,0,1,2,0,3
Hurricane,Erin,44,2001-09-13T09:00:00Z,ILE ST PIERRE,0,10,4,0,14
Hurricane,Erin,44,2001-09-13T09:00:00Z,HALIFAX NS,1,3,2,0,6
Hurricane,Erin,44,2001-09-13T09:00:00Z,CAPE RACE NFLD,0,8,5,1,14
Hurricane,Erin,44,2001-09-13T09:00:00Z,SABLE ISLAND NS,8,6,1,0,15
Hurricane,Erin,44,2001-09-13T09:00:00Z,HIBERNIA OILFLD,0,1,6,4,11
Hurricane,Erin,45,2001-09-13T15:00:00Z,43.0N  57.0W,26,1,0,0,27
Hurricane,Erin,45,2001-09-13T15:00:00Z,EDDY POINT NS,3,6,1,0,10
Hurricane,Erin,45,2001-09-13T15:00:00Z,46.5N  53.5W,1,14,2,0,17
Hurricane,Erin,45,2001-09-13T15:00:00Z,PTX BASQUES NFLD,1,7,2,0,10
Hurricane,Erin,45,2001-09-13T15:00:00Z,50.5N  50.0W,0,3,9,0,12
Hurricane,Erin,45,2001-09-13T15:00:00Z,BURGEO NFLD,1,10,2,0,13
Hurricane,Erin,45,2001-09-13T15:00:00Z,HALIFAX NS,2,1,1,0,4
Hurricane,Erin,45,2001-09-13T15:00:00Z,ILE ST PIERRE,2,13,1,0,16
Hurricane,Erin,45,2001-09-13T15:00:00Z,SABLE ISLAND NS,16,2,1,0,19
Hurricane,Erin,45,2001-09-13T15:00:00Z,CAPE RACE NFLD,1,13,2,0,16
Hurricane,Erin,45,2001-09-13T15:00:00Z,SYDNEY NS,3,8,0,0,11
Hurricane,Erin,45,2001-09-13T15:00:00Z,HIBERNIA OILFLD,0,5,6,0,11
Hurricane,Erin,46,2001-09-13T21:00:00Z,44.1N  56.0W,26,2,0,0,28
Hurricane,Erin,46,2001-09-13T21:00:00Z,PTX BASQUES NFLD,3,6,1,0,10
Hurricane,Erin,46,2001-09-13T21:00:00Z,48.0N  52.0W,0,16,2,0,18
Hurricane,Erin,46,2001-09-13T21:00:00Z,BURGEO NFLD,3,11,0,0,14
Hurricane,Erin,46,2001-09-13T21:00:00Z,53.0N  47.0W,0,1,11,0,12
Hurricane,Erin,46,2001-09-13T21:00:00Z,ILE ST PIERRE,7,12,1,0,20
Hurricane,Erin,46,2001-09-13T21:00:00Z,SABLE ISLAND NS,20,1,0,0,21
Hurricane,Erin,46,2001-09-13T21:00:00Z,CAPE RACE NFLD,2,17,1,0,20
Hurricane,Erin,46,2001-09-13T21:00:00Z,SYDNEY NS,6,4,0,0,10
Hurricane,Erin,46,2001-09-13T21:00:00Z,HIBERNIA OILFLD,0,7,6,0,13
Hurricane,Erin,46,2001-09-13T21:00:00Z,EDDY POINT NS,5,1,0,0,6
Hurricane,Erin,47,2001-09-14T03:00:00Z,45.7N  53.8W,25,3,0,0,28
Hurricane,Erin,47,2001-09-14T03:00:00Z,BURGEO NFLD,2,1,1,0,4
Hurricane,Erin,47,2001-09-14T03:00:00Z,50.0N  49.0W,1,16,2,0,19
Hurricane,Erin,47,2001-09-14T03:00:00Z,ILE ST PIERRE,11,4,0,0,15
Hurricane,Erin,47,2001-09-14T03:00:00Z,56.0N  43.4W,0,2,10,0,12
Hurricane,Erin,47,2001-09-14T03:00:00Z,CAPE RACE NFLD,19,6,0,0,25
Hurricane,Erin,47,2001-09-14T03:00:00Z,SABLE ISLAND NS,2,0,0,0,2
Hurricane,Erin,47,2001-09-14T03:00:00Z,HIBERNIA OILFLD,1,14,2,0,17
Hurricane,Erin,48,2001-09-14T09:00:00Z,48.5N  51.0W,25,3,0,0,28
Hurricane,Erin,48,2001-09-14T09:00:00Z,BURGEO NFLD,7,0,0,0,7
Hurricane,Erin,48,2001-09-14T09:00:00Z,53.5N  46.5W,0,13,0,0,13
Hurricane,Erin,48,2001-09-14T09:00:00Z,ILE ST PIERRE,22,0,0,0,22
Hurricane,Erin,48,2001-09-14T09:00:00Z,SABLE ISLAND NS,36,0,0,0,36
Hurricane,Erin,48,2001-09-14T09:00:00Z,CAPE RACE NFLD,32,0,0,0,32
Hurricane,Erin,48,2001-09-14T09:00:00Z,PTX BASQUES NFLD,2,0,0,0,2
Hurricane,Erin,48,2001-09-14T09:00:00Z,HIBERNIA OILFLD,18,4,0,0,22
Hurricane,Erin,49,2001-09-14T15:00:00Z,51.0N  49.0W,27,0,0,0,27
Hurricane,Erin,49,2001-09-14T15:00:00Z,CAPE RACE NFLD,43,0,0,0,43
Hurricane,Erin,49,2001-09-14T15:00:00Z,BURGEO NFLD,2,0,0,0,2
Hurricane,Erin,49,2001-09-14T15:00:00Z,HIBERNIA OILFLD,20,0,0,0,20
Hurricane,Erin,49,2001-09-14T15:00:00Z,ILE ST PIERRE,16,0,0,0,16
Hurricane,Erin,50,2001-09-14T21:00:00Z,54.5N  46.5W,29,0,0,0,29
Hurricane,Erin,50,2001-09-14T21:00:00Z,CAPE RACE NFLD,56,0,0,0,56
Hurricane,Erin,50,2001-09-14T21:00:00Z,ILE ST PIERRE,2,0,0,0,2
Hurricane,Erin,50,2001-09-14T21:00:00Z,HIBERNIA OILFLD,14,0,0,0,14
Tropical Storm,Erin,51,2001-09-15T03:00:00Z,57.4N  45.7W,31,0,0,0,31
Tropical Storm,Erin,51,2001-09-15T03:00:00Z,HIBERNIA OILFLD,3,0,0,0,3
Tropical Storm,Erin,51,2001-09-15T03:00:00Z,CAPE RACE NFLD,99,0,0,0,99
Tropical Depression,Seven,1,2001-09-07T21:00:00Z,15.5N  37.0W,48,0,1,0,49
Tropical Depression,Seven,1,2001-09-07T21:00:00Z,16.5N  42.0W,0,21,4,1,26
Tropical Depression,Seven,1,2001-09-07T21:00:00Z,16.0N  40.0W,5,28,0,0,33
Tropical Depression,Seven,2,2001-09-08T03:00:00Z,15.6N  36.6W,48,0,0,0,48
Tropical Depression,Seven,2,2001-09-08T03:00:00Z,16.5N  42.5W,0,14,11,1,26
Tropical Depression,Seven,2,2001-09-08T03:00:00Z,16.0N  39.7W,4,29,0,0,33
Tropical Depression,Seven,3,2001-09-08T09:00:00Z,16.3N  36.6W,48,0,0,0,48
Tropical Depression,Seven,3,2001-09-08T09:00:00Z,17.3N  42.3W,0,13,13,1,27
Tropical Depression,Seven,3,2001-09-08T09:00:00Z,16.7N  39.4W,6,28,0,0,34
Tropical Depression,Seven,4,2001-09-08T15:00:00Z,16.0N  38.5W,51,0,0,0,51
Tropical Depression,Seven,4,2001-09-08T15:00:00Z,17.5N  44.0W,0,19,8,1,28
Tropical Depression,Seven,4,2001-09-08T15:00:00Z,17.0N  41.5W,7,30,0,0,37
Tropical Depression,Seven,6,2001-09-10T09:00:00Z,16.5N  47.6W,57,0,0,0,57
Tropical Depression,Seven,6,2001-09-10T09:00:00Z,18.6N  50.2W,8,22,0,1,31
Tropical Depression,Seven,6,2001-09-10T09:00:00Z,17.5N  49.0W,34,6,0,0,40
Tropical Depression,Seven,7,2001-09-10T15:00:00Z,18.0N  48.5W,52,0,0,0,52
Tropical Depression,Seven,7,2001-09-10T15:00:00Z,20.0N  50.5W,5,19,2,1,27
Tropical Depression,Seven,7,2001-09-10T15:00:00Z,19.0N  49.5W,30,5,0,1,36
Tropical Depression,Seven,8,2001-09-10T21:00:00Z,19.0N  49.5W,53,0,0,0,53
Tropical Depression,Seven,8,2001-09-10T21:00:00Z,21.0N  51.5W,11,15,2,1,29
Tropical Depression,Seven,8,2001-09-10T21:00:00Z,20.0N  50.5W,34,3,0,0,37
Tropical Depression,Seven,9,2001-09-11T03:00:00Z,19.1N  50.1W,50,0,0,0,50
Tropical Depression,Seven,9,2001-09-11T03:00:00Z,21.5N  51.5W,11,11,2,1,25
Tropical Depression,Seven,9,2001-09-11T03:00:00Z,20.2N  51.0W,31,2,0,0,33
Tropical Depression,Seven,10,2001-09-11T09:00:00Z,19.8N  50.7W,36,1,0,0,37
Tropical Depression,Seven,10,2001-09-11T09:00:00Z,22.3N  52.2W,5,11,3,3,22
Tropical Depression,Seven,10,2001-09-11T09:00:00Z,21.0N  51.5W,20,4,1,0,25
Tropical Storm,Felix,11,2001-09-11T15:00:00Z,21.5N  49.5W,34,0,0,0,34
Tropical Storm,Felix,11,2001-09-11T15:00:00Z,25.0N  49.5W,0,14,4,3,21
Tropical Storm,Felix,11,2001-09-11T15:00:00Z,23.5N  49.5W,8,15,1,1,25
Tropical Storm,Felix,12,2001-09-11T21:00:00Z,22.5N  49.5W,28,2,0,0,30
Tropical Storm,Felix,12,2001-09-11T21:00:00Z,26.0N  50.0W,0,12,5,3,20
Tropical Storm,Felix,12,2001-09-11T21:00:00Z,24.5N  50.0W,2,19,1,2,24
Tropical Storm,Felix,13,2001-09-12T03:00:00Z,23.8N  49.8W,47,1,0,0,48
Tropical Storm,Felix,13,2001-09-12T03:00:00Z,27.3N  49.4W,0,19,4,1,24
Tropical Storm,Felix,13,2001-09-12T03:00:00Z,25.6N  50.0W,9,21,1,0,31
Tropical Storm,Felix,14,2001-09-12T09:00:00Z,24.6N  49.9W,35,1,0,0,36
Tropical Storm,Felix,14,2001-09-12T09:00:00Z,28.5N  48.7W,1,17,3,1,22
Tropical Storm,Felix,14,2001-09-12T09:00:00Z,26.7N  49.9W,15,11,1,1,28
Tropical Storm,Felix,15,2001-09-12T15:00:00Z,25.0N  49.0W,33,0,0,0,33
Tropical Storm,Felix,15,2001-09-12T15:00:00Z,28.7N  45.0W,0,10,8,2,20
Tropical Storm,Felix,15,2001-09-12T15:00:00Z,27.0N  47.5W,10,14,1,0,25
Tropical Storm,Felix,16,2001-09-12T21:00:00Z,26.5N  48.5W,40,1,0,0,41
Tropical Storm,Felix,16,2001-09-12T21:00:00Z,30.0N  43.0W,0,8,9,2,19
Tropical Storm,Felix,16,2001-09-12T21:00:00Z,28.5N  46.0W,7,19,1,0,27
Hurricane,Felix,17,2001-09-13T03:00:00Z,27.6N  47.6W,41,0,0,0,41
Hurricane,Felix,17,2001-09-13T03:00:00Z,30.7N  42.5W,0,2,13,3,18
Hurricane,Felix,17,2001-09-13T03:00:00Z,29.5N  45.4W,3,21,2,0,26
Hurricane,Felix,18,2001-09-13T09:00:00Z,29.0N  47.0W,30,0,0,1,31
Hurricane,Felix,18,2001-09-13T09:00:00Z,31.6N  41.7W,0,7,9,2,18
Hurricane,Felix,18,2001-09-13T09:00:00Z,30.6N  44.7W,4,16,1,0,21
Hurricane,Felix,19,2001-09-13T15:00:00Z,29.5N  45.0W,27,1,0,0,28
Hurricane,Felix,19,2001-09-13T15:00:00Z,32.0N  38.0W,0,6,8,2,16
Hurricane,Felix,19,2001-09-13T15:00:00Z,30.5N  41.5W,2,16,1,1,20
Hurricane,Felix,20,2001-09-13T21:00:00Z,30.5N  43.9W,23,2,0,0,25
Hurricane,Felix,20,2001-09-13T21:00:00Z,32.0N  36.5W,0,5,6,3,14
Hurricane,Felix,20,2001-09-13T21:00:00Z,31.5N  40.0W,2,13,2,1,18
Hurricane,Felix,21,2001-09-14T03:00:00Z,30.9N  42.4W,26,1,0,1,28
Hurricane,Felix,21,2001-09-14T03:00:00Z,32.9N  36.1W,0,3,10,2,15
Hurricane,Felix,21,2001-09-14T03:00:00Z,31.7N  39.4W,5,13,3,0,21
Hurricane,Felix,22,2001-09-14T09:00:00Z,31.8N  41.0W,25,1,0,0,26
Hurricane,Felix,22,2001-09-14T09:00:00Z,33.1N  34.9W,0,7,3,3,13
Hurricane,Felix,22,2001-09-14T09:00:00Z,32.3N  38.0W,8,7,1,1,17
Hurricane,Felix,23,2001-09-14T15:00:00Z,32.0N  39.8W,23,1,0,0,24
Hurricane,Felix,23,2001-09-14T15:00:00Z,34.0N  33.0W,0,4,6,3,13
Hurricane,Felix,23,2001-09-14T15:00:00Z,32.6N  36.4W,5,10,1,1,17
Hurricane,Felix,24,2001-09-14T21:00:00Z,32.5N  38.2W,24,1,0,0,25
Hurricane,Felix,24,2001-09-14T21:00:00Z,34.0N  32.0W,0,9,4,3,16
Hurricane,Felix,24,2001-09-14T21:00:00Z,32.7N  35.0W,6,10,1,1,18
Hurricane,Felix,25,2001-09-15T03:00:00Z,32.3N  36.1W,30,0,0,0,30
Hurricane,Felix,25,2001-09-15T03:00:00Z,35.0N  30.8W,1,10,3,2,16
Hurricane,Felix,25,2001-09-15T03:00:00Z,33.2N  32.9W,9,9,1,1,20
Hurricane,Felix,26,2001-09-15T09:00:00Z,32.7N  35.5W,31,0,0,0,31
Hurricane,Felix,26,2001-09-15T09:00:00Z,36.0N  30.7W,0,10,4,2,16
Hurricane,Felix,26,2001-09-15T09:00:00Z,34.1N  32.9W,8,10,1,1,20
Hurricane,Felix,27,2001-09-15T15:00:00Z,32.9N  33.3W,29,1,0,0,30
Hurricane,Felix,27,2001-09-15T15:00:00Z,36.0N  30.0W,1,11,3,2,17
Hurricane,Felix,27,2001-09-15T15:00:00Z,34.7N  31.3W,9,8,2,1,20
Hurricane,Felix,28,2001-09-15T21:00:00Z,34.2N  32.0W,27,1,0,0,28
Hurricane,Felix,28,2001-09-15T21:00:00Z,36.4N  29.6W,7,7,3,1,18
Hurricane,Felix,28,2001-09-15T21:00:00Z,35.5N  30.5W,15,3,2,1,21
Hurricane,Felix,29,2001-09-16T03:00:00Z,34.5N  31.3W,27,1,0,0,28
Hurricane,Felix,29,2001-09-16T03:00:00Z,36.0N  29.0W,11,5,2,1,19
Hurricane,Felix,29,2001-09-16T03:00:00Z,35.5N  30.0W,17,3,1,0,21
Hurricane,Felix,30,2001-09-16T09:00:00Z,35.3N  30.6W,27,1,0,0,28
Hurricane,Felix,30,2001-09-16T09:00:00Z,36.5N  28.5W,13,4,1,1,19
Hurricane,Felix,30,2001-09-16T09:00:00Z,36.0N  29.6W,19,2,1,0,22
Hurricane,Felix,31,2001-09-16T15:00:00Z,36.0N  30.0W,30,0,0,1,31
Hurricane,Felix,31,2001-09-16T15:00:00Z,37.2N  27.8W,13,4,1,1,19
Hurricane,Felix,31,2001-09-16T15:00:00Z,36.9N  29.0W,18,2,1,1,22
Hurricane,Felix,32,2001-09-16T21:00:00Z,36.4N  29.7W,29,1,0,0,30
Hurricane,Felix,32,2001-09-16T21:00:00Z,37.2N  28.2W,14,3,1,2,20
Hurricane,Felix,32,2001-09-16T21:00:00Z,37.0N  29.0W,19,1,1,1,22
Hurricane,Felix,33,2001-09-17T03:00:00Z,36.9N  30.0W,42,0,0,0,42
Hurricane,Felix,33,2001-09-17T03:00:00Z,37.0N  28.0W,17,2,1,1,21
Hurricane,Felix,33,2001-09-17T03:00:00Z,37.0N  29.3W,30,1,0,0,31
Hurricane,Felix,34,2001-09-17T09:00:00Z,36.4N  29.4W,39,0,0,0,39
Hurricane,Felix,34,2001-09-17T09:00:00Z,36.5N  27.0W,13,4,1,1,19
Hurricane,Felix,34,2001-09-17T09:00:00Z,36.5N  28.2W,23,1,0,1,25
Tropical Storm,Felix,35,2001-09-17T15:00:00Z,34.9N  29.5W,45,0,0,0,45
Tropical Storm,Felix,35,2001-09-17T15:00:00Z,35.3N  26.4W,12,4,2,1,19
Tropical Storm,Felix,35,2001-09-17T15:00:00Z,35.2N  28.0W,21,1,1,1,24
Tropical Storm,Felix,36,2001-09-17T21:00:00Z,34.7N  29.3W,37,0,0,0,37
Tropical Storm,Felix,36,2001-09-17T21:00:00Z,34.8N  27.0W,15,3,1,1,20
Tropical Storm,Felix,36,2001-09-17T21:00:00Z,34.8N  28.0W,22,1,1,0,24
Tropical Storm,Felix,37,2001-09-18T03:00:00Z,34.0N  32.3W,99,0,0,0,99
Tropical Storm,Felix,37,2001-09-18T03:00:00Z,33.0N  33.0W,21,1,1,1,24
Tropical Storm,Felix,37,2001-09-18T03:00:00Z,33.5N  32.5W,32,0,1,0,33
Tropical Storm,Felix,38,2001-09-18T09:00:00Z,33.8N  32.6W,99,0,0,0,99
Tropical Storm,Felix,38,2001-09-18T09:00:00Z,33.0N  33.0W,25,1,0,1,27
Tropical Storm,Felix,38,2001-09-18T09:00:00Z,33.3N  32.7W,32,1,0,0,33
Tropical Storm,Felix,39,2001-09-18T15:00:00Z,33.6N  32.2W,45,0,0,0,45
Tropical Storm,Felix,39,2001-09-18T15:00:00Z,32.3N  33.0W,19,2,0,1,22
Tropical Storm,Felix,39,2001-09-18T15:00:00Z,32.8N  32.6W,25,1,0,1,27
Tropical Depression,Felix,40,2001-09-18T21:00:00Z,33.9N  31.4W,99,0,0,0,99
Tropical Depression,Felix,40,2001-09-18T21:00:00Z,32.9N  32.1W,20,1,1,1,23
Tropical Depression,Felix,40,2001-09-18T21:00:00Z,33.4N  31.7W,29,0,0,1,30
Tropical Depression,Felix,41,2001-09-19T03:00:00Z,33.6N  31.6W,99,0,0,0,99
Tropical Depression,Felix,41,2001-09-19T03:00:00Z,32.5N  32.5W,20,1,1,1,23
Tropical Depression,Felix,41,2001-09-19T03:00:00Z,33.0N  32.0W,28,1,0,0,29
Tropical Depression,Eight,1,2001-09-11T21:00:00Z,25.4N  85.2W,99,0,0,0,99
Tropical Depression,Eight,1,2001-09-11T21:00:00Z,MARCO ISLAND FL,5,5,3,3,16
Tropical Depression,Eight,1,2001-09-11T21:00:00Z,26.0N  85.5W,64,0,0,0,64
Tropical Depression,Eight,1,2001-09-11T21:00:00Z,FT MYERS FL,4,6,3,4,17
Tropical Depression,Eight,1,2001-09-11T21:00:00Z,26.5N  85.5W,48,0,0,1,49
Tropical Depression,Eight,1,2001-09-11T21:00:00Z,VENICE FL,6,6,3,3,18
Tropical Depression,Eight,1,2001-09-11T21:00:00Z,MUCF 221N 805W,0,0,0,3,3
Tropical Depression,Eight,1,2001-09-11T21:00:00Z,TAMPA FL,2,5,5,4,16
Tropical Depression,Eight,1,2001-09-11T21:00:00Z,MUSN 216N 826W,0,0,1,3,4
Tropical Depression,Eight,1,2001-09-11T21:00:00Z,CEDAR KEY FL,0,3,5,6,14
Tropical Depression,Eight,1,2001-09-11T21:00:00Z,MUHA 230N 824W,2,1,2,4,9
Tropical Depression,Eight,1,2001-09-11T21:00:00Z,ST MARKS FL,0,1,3,9,13
Tropical Depression,Eight,1,2001-09-11T21:00:00Z,MUAN 219N 850W,1,1,1,4,7
Tropical Depression,Eight,1,2001-09-11T21:00:00Z,APALACHICOLA FL,0,2,5,7,14
Tropical Depression,Eight,1,2001-09-11T21:00:00Z,MMCZ 205N 869W,0,0,0,2,2
Tropical Depression,Eight,1,2001-09-11T21:00:00Z,PANAMA CITY FL,0,1,5,8,14
Tropical Depression,Eight,1,2001-09-11T21:00:00Z,MYAK 241N 776W,0,0,0,2,2
Tropical Depression,Eight,1,2001-09-11T21:00:00Z,PENSACOLA FL,0,0,3,8,11
Tropical Depression,Eight,1,2001-09-11T21:00:00Z,MYNN 251N 775W,0,0,0,3,3
Tropical Depression,Eight,1,2001-09-11T21:00:00Z,MOBILE AL,0,0,2,8,10
Tropical Depression,Eight,1,2001-09-11T21:00:00Z,MYGF 266N 787W,0,0,1,6,7
Tropical Depression,Eight,1,2001-09-11T21:00:00Z,GULFPORT MS,0,0,2,8,10
Tropical Depression,Eight,1,2001-09-11T21:00:00Z,MMMD 210N 897W,0,0,0,2,2
Tropical Depression,Eight,1,2001-09-11T21:00:00Z,BURAS LA,0,1,4,6,11
Tropical Depression,Eight,1,2001-09-11T21:00:00Z,MARATHON FL,2,3,2,4,11
Tropical Depression,Eight,1,2001-09-11T21:00:00Z,NEW ORLEANS LA,0,0,2,7,9
Tropical Depression,Eight,1,2001-09-11T21:00:00Z,MIAMI FL,1,2,3,5,11
Tropical Depression,Eight,1,2001-09-11T21:00:00Z,NEW IBERIA LA,0,0,1,5,6
Tropical Depression,Eight,1,2001-09-11T21:00:00Z,W PALM BEACH FL,0,2,3,6,11
Tropical Depression,Eight,1,2001-09-11T21:00:00Z,PORT ARTHUR TX,0,0,0,2,2
Tropical Depression,Eight,1,2001-09-11T21:00:00Z,FT PIERCE FL,0,2,3,6,11
Tropical Depression,Eight,1,2001-09-11T21:00:00Z,GALVESTON TX,0,0,0,2,2
Tropical Depression,Eight,1,2001-09-11T21:00:00Z,COCOA BEACH FL,0,1,4,6,11
Tropical Depression,Eight,1,2001-09-11T21:00:00Z,GULF 29N 85W,1,5,5,6,17
Tropical Depression,Eight,1,2001-09-11T21:00:00Z,DAYTONA BEACH FL,0,1,2,8,11
Tropical Depression,Eight,1,2001-09-11T21:00:00Z,GULF 29N 87W,1,4,6,6,17
Tropical Depression,Eight,1,2001-09-11T21:00:00Z,JACKSONVILLE FL,0,0,1,8,9
Tropical Depression,Eight,1,2001-09-11T21:00:00Z,GULF 28N 89W,1,6,6,4,17
Tropical Depression,Eight,1,2001-09-11T21:00:00Z,SAVANNAH GA,0,0,0,6,6
Tropical Depression,Eight,1,2001-09-11T21:00:00Z,GULF 28N 91W,0,1,5,5,11
Tropical Depression,Eight,1,2001-09-11T21:00:00Z,CHARLESTON SC,0,0,0,4,4
Tropical Depression,Eight,1,2001-09-11T21:00:00Z,GULF 28N 93W,0,0,2,3,5
Tropical Depression,Eight,1,2001-09-11T21:00:00Z,MYRTLE BEACH SC,0,0,0,2,2
Tropical Depression,Eight,1,2001-09-11T21:00:00Z,GULF 28N 95W,0,0,0,2,2
Tropical Depression,Eight,1,2001-09-11T21:00:00Z,KEY WEST FL,4,4,2,3,13
Tropical Depression,Eight,2,2001-09-12T03:00:00Z,25.6N  85.4W,99,0,0,0,99
Tropical Depression,Eight,2,2001-09-12T03:00:00Z,MARCO ISLAND FL,4,6,2,3,15
Tropical Depression,Eight,2,2001-09-12T03:00:00Z,26.2N  85.5W,76,0,0,0,76
Tropical Depression,Eight,2,2001-09-12T03:00:00Z,FT MYERS FL,4,6,4,3,17
Tropical Depression,Eight,2,2001-09-12T03:00:00Z,27.0N  85.5W,35,0,0,1,36
Tropical Depression,Eight,2,2001-09-12T03:00:00Z,VENICE FL,6,6,4,2,18
Tropical Depression,Eight,2,2001-09-12T03:00:00Z,MUCF 221N 805W,0,0,0,2,2
Tropical Depression,Eight,2,2001-09-12T03:00:00Z,TAMPA FL,2,6,5,4,17
Tropical Depression,Eight,2,2001-09-12T03:00:00Z,MUSN 216N 826W,0,0,0,3,3
Tropical Depression,Eight,2,2001-09-12T03:00:00Z,CEDAR KEY FL,0,4,6,6,16
Tropical Depression,Eight,2,2001-09-12T03:00:00Z,MUHA 230N 824W,2,1,1,3,7
Tropical Depression,Eight,2,2001-09-12T03:00:00Z,ST MARKS FL,0,1,5,8,14
Tropical Depression,Eight,2,2001-09-12T03:00:00Z,MUAN 219N 850W,1,1,0,3,5
Tropical Depression,Eight,2,2001-09-12T03:00:00Z,APALACHICOLA FL,0,3,7,6,16
Tropical Depression,Eight,2,2001-09-12T03:00:00Z,MYAK 241N 776W,0,0,0,2,2
Tropical Depression,Eight,2,2001-09-12T03:00:00Z,PANAMA CITY FL,0,2,6,7,15
Tropical Depression,Eight,2,2001-09-12T03:00:00Z,MYNN 251N 775W,0,0,0,3,3
Tropical Depression,Eight,2,2001-09-12T03:00:00Z,PENSACOLA FL,0,0,5,8,13
Tropical Depression,Eight,2,2001-09-12T03:00:00Z,MYGF 266N 787W,0,0,2,4,6
Tropical Depression,Eight,2,2001-09-12T03:00:00Z,MOBILE AL,0,0,3,8,11
Tropical Depression,Eight,2,2001-09-12T03:00:00Z,MARATHON FL,1,3,2,4,10
Tropical Depression,Eight,2,2001-09-12T03:00:00Z,GULFPORT MS,0,0,3,8,11
Tropical Depression,Eight,2,2001-09-12T03:00:00Z,MIAMI FL,0,3,2,5,10
Tropical Depression,Eight,2,2001-09-12T03:00:00Z,BURAS LA,0,1,5,6,12
Tropical Depression,Eight,2,2001-09-12T03:00:00Z,W PALM BEACH FL,0,2,3,5,10
Tropical Depression,Eight,2,2001-09-12T03:00:00Z,NEW ORLEANS LA,0,0,3,6,9
Tropical Depression,Eight,2,2001-09-12T03:00:00Z,FT PIERCE FL,0,2,4,5,11
Tropical Depression,Eight,2,2001-09-12T03:00:00Z,NEW IBERIA LA,0,0,1,5,6
Tropical Depression,Eight,2,2001-09-12T03:00:00Z,COCOA BEACH FL,0,2,4,6,12
Tropical Depression,Eight,2,2001-09-12T03:00:00Z,PORT ARTHUR TX,0,0,0,2,2
Tropical Depression,Eight,2,2001-09-12T03:00:00Z,DAYTONA BEACH FL,0,1,4,7,12
Tropical Depression,Eight,2,2001-09-12T03:00:00Z,GALVESTON TX,0,0,0,2,2
Tropical Depression,Eight,2,2001-09-12T03:00:00Z,JACKSONVILLE FL,0,0,2,9,11
Tropical Depression,Eight,2,2001-09-12T03:00:00Z,GULF 29N 85W,1,6,6,5,18
Tropical Depression,Eight,2,2001-09-12T03:00:00Z,SAVANNAH GA,0,0,0,7,7
Tropical Depression,Eight,2,2001-09-12T03:00:00Z,GULF 29N 87W,1,5,7,5,18
Tropical Depression,Eight,2,2001-09-12T03:00:00Z,CHARLESTON SC,0,0,0,4,4
Tropical Depression,Eight,2,2001-09-12T03:00:00Z,GULF 28N 89W,1,6,6,4,17
Tropical Depression,Eight,2,2001-09-12T03:00:00Z,MYRTLE BEACH SC,0,0,0,3,3
Tropical Depression,Eight,2,2001-09-12T03:00:00Z,GULF 28N 91W,0,1,5,5,11
Tropical Depression,Eight,2,2001-09-12T03:00:00Z,WILMINGTON NC,0,0,0,2,2
Tropical Depression,Eight,2,2001-09-12T03:00:00Z,GULF 28N 93W,0,0,2,3,5
Tropical Depression,Eight,2,2001-09-12T03:00:00Z,KEY WEST FL,3,4,2,3,12
Tropical Depression,Eight,2,2001-09-12T03:00:00Z,GULF 28N 95W,0,0,0,2,2
Tropical Depression,Eight,3,2001-09-12T09:00:00Z,26.4N  86.6W,70,0,0,0,70
Tropical Depression,Eight,3,2001-09-12T09:00:00Z,FT MYERS FL,1,3,3,5,12
Tropical Depression,Eight,3,2001-09-12T09:00:00Z,27.2N  86.7W,43,0,0,0,43
Tropical Depression,Eight,3,2001-09-12T09:00:00Z,VENICE FL,2,4,4,4,14
Tropical Depression,Eight,3,2001-09-12T09:00:00Z,28.0N  86.0W,23,2,1,1,27
Tropical Depression,Eight,3,2001-09-12T09:00:00Z,TAMPA FL,1,4,4,6,15
Tropical Depression,Eight,3,2001-09-12T09:00:00Z,MUCF 221N 805W,0,0,0,2,2
Tropical Depression,Eight,3,2001-09-12T09:00:00Z,CEDAR KEY FL,1,2,6,6,15
Tropical Depression,Eight,3,2001-09-12T09:00:00Z,MUSN 216N 826W,0,0,0,2,2
Tropical Depression,Eight,3,2001-09-12T09:00:00Z,ST MARKS FL,0,3,6,7,16
Tropical Depression,Eight,3,2001-09-12T09:00:00Z,MUHA 230N 824W,0,0,1,3,4
Tropical Depression,Eight,3,2001-09-12T09:00:00Z,APALACHICOLA FL,2,6,6,4,18
Tropical Depression,Eight,3,2001-09-12T09:00:00Z,MUAN 219N 850W,0,0,0,3,3
Tropical Depression,Eight,3,2001-09-12T09:00:00Z,PANAMA CITY FL,2,6,6,4,18
Tropical Depression,Eight,3,2001-09-12T09:00:00Z,MYAK 241N 776W,0,0,0,2,2
Tropical Depression,Eight,3,2001-09-12T09:00:00Z,PENSACOLA FL,1,6,6,5,18
Tropical Depression,Eight,3,2001-09-12T09:00:00Z,MYNN 251N 775W,0,0,0,2,2
Tropical Depression,Eight,3,2001-09-12T09:00:00Z,MOBILE AL,1,5,6,5,17
Tropical Depression,Eight,3,2001-09-12T09:00:00Z,MYGF 266N 787W,0,0,0,5,5
Tropical Depression,Eight,3,2001-09-12T09:00:00Z,GULFPORT MS,1,6,6,4,17
Tropical Depression,Eight,3,2001-09-12T09:00:00Z,MARATHON FL,0,1,1,4,6
Tropical Depression,Eight,3,2001-09-12T09:00:00Z,BURAS LA,3,9,4,3,19
Tropical Depression,Eight,3,2001-09-12T09:00:00Z,MIAMI FL,0,0,2,5,7
Tropical Depression,Eight,3,2001-09-12T09:00:00Z,NEW ORLEANS LA,1,6,5,3,15
Tropical Depression,Eight,3,2001-09-12T09:00:00Z,W PALM BEACH FL,0,0,2,6,8
Tropical Depression,Eight,3,2001-09-12T09:00:00Z,NEW IBERIA LA,0,3,4,4,11
Tropical Depression,Eight,3,2001-09-12T09:00:00Z,FT PIERCE FL,0,0,2,7,9
Tropical Depression,Eight,3,2001-09-12T09:00:00Z,PORT ARTHUR TX,0,0,1,4,5
Tropical Depression,Eight,3,2001-09-12T09:00:00Z,COCOA BEACH FL,0,0,3,7,10
Tropical Depression,Eight,3,2001-09-12T09:00:00Z,GALVESTON TX,0,0,1,2,3
Tropical Depression,Eight,3,2001-09-12T09:00:00Z,DAYTONA BEACH FL,0,0,3,7,10
Tropical Depression,Eight,3,2001-09-12T09:00:00Z,FREEPORT TX,0,0,0,2,2
Tropical Depression,Eight,3,2001-09-12T09:00:00Z,JACKSONVILLE FL,0,0,2,8,10
Tropical Depression,Eight,3,2001-09-12T09:00:00Z,GULF 29N 85W,6,6,5,3,20
Tropical Depression,Eight,3,2001-09-12T09:00:00Z,SAVANNAH GA,0,0,0,7,7
Tropical Depression,Eight,3,2001-09-12T09:00:00Z,GULF 29N 87W,11,7,3,2,23
Tropical Depression,Eight,3,2001-09-12T09:00:00Z,CHARLESTON SC,0,0,0,5,5
Tropical Depression,Eight,3,2001-09-12T09:00:00Z,GULF 28N 89W,13,7,2,1,23
Tropical Depression,Eight,3,2001-09-12T09:00:00Z,MYRTLE BEACH SC,0,0,0,3,3
Tropical Depression,Eight,3,2001-09-12T09:00:00Z,GULF 28N 91W,2,7,4,2,15
Tropical Depression,Eight,3,2001-09-12T09:00:00Z,WILMINGTON NC,0,0,0,2,2
Tropical Depression,Eight,3,2001-09-12T09:00:00Z,GULF 28N 93W,0,2,2,3,7
Tropical Depression,Eight,3,2001-09-12T09:00:00Z,KEY WEST FL,0,2,1,4,7
Tropical Depression,Eight,3,2001-09-12T09:00:00Z,GULF 28N 95W,0,0,0,2,2
Tropical Depression,Eight,3,2001-09-12T09:00:00Z,MARCO ISLAND FL,1,2,3,5,11
Tropical Depression,Eight,4,2001-09-12T15:00:00Z,26.5N  87.0W,59,0,0,0,59
Tropical Depression,Eight,4,2001-09-12T15:00:00Z,FT MYERS FL,1,3,5,5,14
Tropical Depression,Eight,4,2001-09-12T15:00:00Z,27.5N  86.5W,30,1,1,0,32
Tropical Depression,Eight,4,2001-09-12T15:00:00Z,VENICE FL,1,6,5,5,17
Tropical Depression,Eight,4,2001-09-12T15:00:00Z,28.0N  85.5W,14,7,3,1,25
Tropical Depression,Eight,4,2001-09-12T15:00:00Z,TAMPA FL,0,5,6,6,17
Tropical Depression,Eight,4,2001-09-12T15:00:00Z,MUCF 221N 805W,0,0,0,2,2
Tropical Depression,Eight,4,2001-09-12T15:00:00Z,CEDAR KEY FL,0,3,7,6,16
Tropical Depression,Eight,4,2001-09-12T15:00:00Z,MUSN 216N 826W,0,0,0,2,2
Tropical Depression,Eight,4,2001-09-12T15:00:00Z,ST MARKS FL,0,1,7,8,16
Tropical Depression,Eight,4,2001-09-12T15:00:00Z,MUHA 230N 824W,0,0,1,4,5
Tropical Depression,Eight,4,2001-09-12T15:00:00Z,APALACHICOLA FL,1,5,7,5,18
Tropical Depression,Eight,4,2001-09-12T15:00:00Z,MUAN 219N 850W,0,0,0,3,3
Tropical Depression,Eight,4,2001-09-12T15:00:00Z,PANAMA CITY FL,0,5,8,5,18
Tropical Depression,Eight,4,2001-09-12T15:00:00Z,MYAK 241N 776W,0,0,0,2,2
Tropical Depression,Eight,4,2001-09-12T15:00:00Z,PENSACOLA FL,0,4,7,5,16
Tropical Depression,Eight,4,2001-09-12T15:00:00Z,MYNN 251N 775W,0,0,0,3,3
Tropical Depression,Eight,4,2001-09-12T15:00:00Z,MOBILE AL,0,3,7,5,15
Tropical Depression,Eight,4,2001-09-12T15:00:00Z,MYGF 266N 787W,0,0,1,6,7
Tropical Depression,Eight,4,2001-09-12T15:00:00Z,GULFPORT MS,0,5,6,4,15
Tropical Depression,Eight,4,2001-09-12T15:00:00Z,MARATHON FL,0,1,2,5,8
Tropical Depression,Eight,4,2001-09-12T15:00:00Z,BURAS LA,3,9,4,2,18
Tropical Depression,Eight,4,2001-09-12T15:00:00Z,MIAMI FL,0,0,3,6,9
Tropical Depression,Eight,4,2001-09-12T15:00:00Z,NEW ORLEANS LA,1,5,5,3,14
Tropical Depression,Eight,4,2001-09-12T15:00:00Z,W PALM BEACH FL,0,0,3,7,10
Tropical Depression,Eight,4,2001-09-12T15:00:00Z,NEW IBERIA LA,0,2,4,3,9
Tropical Depression,Eight,4,2001-09-12T15:00:00Z,FT PIERCE FL,0,0,4,7,11
Tropical Depression,Eight,4,2001-09-12T15:00:00Z,PORT ARTHUR TX,0,0,1,2,3
Tropical Depression,Eight,4,2001-09-12T15:00:00Z,COCOA BEACH FL,0,0,4,8,12
Tropical Depression,Eight,4,2001-09-12T15:00:00Z,GALVESTON TX,0,0,1,1,2
Tropical Depression,Eight,4,2001-09-12T15:00:00Z,DAYTONA BEACH FL,0,0,3,9,12
Tropical Depression,Eight,4,2001-09-12T15:00:00Z,GULF 29N 85W,3,8,6,3,20
Tropical Depression,Eight,4,2001-09-12T15:00:00Z,JACKSONVILLE FL,0,0,2,9,11
Tropical Depression,Eight,4,2001-09-12T15:00:00Z,GULF 29N 87W,8,9,4,2,23
Tropical Depression,Eight,4,2001-09-12T15:00:00Z,SAVANNAH GA,0,0,0,7,7
Tropical Depression,Eight,4,2001-09-12T15:00:00Z,GULF 28N 89W,17,7,1,1,26
Tropical Depression,Eight,4,2001-09-12T15:00:00Z,CHARLESTON SC,0,0,0,5,5
Tropical Depression,Eight,4,2001-09-12T15:00:00Z,GULF 28N 91W,4,9,2,2,17
Tropical Depression,Eight,4,2001-09-12T15:00:00Z,MYRTLE BEACH SC,0,0,0,3,3
Tropical Depression,Eight,4,2001-09-12T15:00:00Z,GULF 28N 93W,0,3,2,2,7
Tropical Depression,Eight,4,2001-09-12T15:00:00Z,KEY WEST FL,0,1,3,5,9
Tropical Depression,Eight,4,2001-09-12T15:00:00Z,GULF 28N 95W,0,0,0,2,2
Tropical Depression,Eight,4,2001-09-12T15:00:00Z,MARCO ISLAND FL,0,3,5,5,13
Tropical Depression,Eight,5,2001-09-12T21:00:00Z,26.2N  86.2W,99,0,0,0,99
Tropical Depression,Eight,5,2001-09-12T21:00:00Z,FT MYERS FL,2,5,4,3,14
Tropical Depression,Eight,5,2001-09-12T21:00:00Z,27.2N  86.1W,30,0,1,0,31
Tropical Depression,Eight,5,2001-09-12T21:00:00Z,VENICE FL,5,7,3,2,17
Tropical Depression,Eight,5,2001-09-12T21:00:00Z,27.9N  85.2W,19,3,1,2,25
Tropical Depression,Eight,5,2001-09-12T21:00:00Z,TAMPA FL,3,8,4,3,18
Tropical Depression,Eight,5,2001-09-12T21:00:00Z,MUHA 230N 824W,0,0,0,3,3
Tropical Depression,Eight,5,2001-09-12T21:00:00Z,CEDAR KEY FL,2,7,5,4,18
Tropical Depression,Eight,5,2001-09-12T21:00:00Z,MUAN 219N 850W,0,0,0,2,2
Tropical Depression,Eight,5,2001-09-12T21:00:00Z,ST MARKS FL,0,5,6,5,16
Tropical Depression,Eight,5,2001-09-12T21:00:00Z,MYNN 251N 775W,0,0,0,2,2
Tropical Depression,Eight,5,2001-09-12T21:00:00Z,APALACHICOLA FL,2,7,5,4,18
Tropical Depression,Eight,5,2001-09-12T21:00:00Z,MYGF 266N 787W,0,0,2,4,6
Tropical Depression,Eight,5,2001-09-12T21:00:00Z,PANAMA CITY FL,1,6,5,5,17
Tropical Depression,Eight,5,2001-09-12T21:00:00Z,MARATHON FL,0,0,2,4,6
Tropical Depression,Eight,5,2001-09-12T21:00:00Z,PENSACOLA FL,0,2,6,5,13
Tropical Depression,Eight,5,2001-09-12T21:00:00Z,MIAMI FL,0,1,2,5,8
Tropical Depression,Eight,5,2001-09-12T21:00:00Z,MOBILE AL,0,1,4,6,11
Tropical Depression,Eight,5,2001-09-12T21:00:00Z,W PALM BEACH FL,0,2,3,5,10
Tropical Depression,Eight,5,2001-09-12T21:00:00Z,GULFPORT MS,0,1,4,5,10
Tropical Depression,Eight,5,2001-09-12T21:00:00Z,FT PIERCE FL,0,3,4,5,12
Tropical Depression,Eight,5,2001-09-12T21:00:00Z,BURAS LA,0,4,4,4,12
Tropical Depression,Eight,5,2001-09-12T21:00:00Z,COCOA BEACH FL,0,4,4,5,13
Tropical Depression,Eight,5,2001-09-12T21:00:00Z,NEW ORLEANS LA,0,1,3,5,9
Tropical Depression,Eight,5,2001-09-12T21:00:00Z,DAYTONA BEACH FL,0,4,5,5,14
Tropical Depression,Eight,5,2001-09-12T21:00:00Z,NEW IBERIA LA,0,0,2,3,5
Tropical Depression,Eight,5,2001-09-12T21:00:00Z,JACKSONVILLE FL,0,1,6,6,13
Tropical Depression,Eight,5,2001-09-12T21:00:00Z,PORT ARTHUR TX,0,0,0,2,2
Tropical Depression,Eight,5,2001-09-12T21:00:00Z,SAVANNAH GA,0,0,1,8,9
Tropical Depression,Eight,5,2001-09-12T21:00:00Z,GULF 29N 85W,6,8,4,2,20
Tropical Depression,Eight,5,2001-09-12T21:00:00Z,CHARLESTON SC,0,0,0,6,6
Tropical Depression,Eight,5,2001-09-12T21:00:00Z,GULF 29N 87W,4,9,4,2,19
Tropical Depression,Eight,5,2001-09-12T21:00:00Z,MYRTLE BEACH SC,0,0,0,4,4
Tropical Depression,Eight,5,2001-09-12T21:00:00Z,GULF 28N 89W,4,9,3,2,18
Tropical Depression,Eight,5,2001-09-12T21:00:00Z,WILMINGTON NC,0,0,0,3,3
Tropical Depression,Eight,5,2001-09-12T21:00:00Z,GULF 28N 91W,0,5,4,3,12
Tropical Depression,Eight,5,2001-09-12T21:00:00Z,MOREHEAD CITY NC,0,0,0,2,2
Tropical Depression,Eight,5,2001-09-12T21:00:00Z,GULF 28N 93W,0,1,2,2,5
Tropical Depression,Eight,5,2001-09-12T21:00:00Z,KEY WEST FL,0,1,1,4,6
Tropical Depression,Eight,5,2001-09-12T21:00:00Z,GULF 28N 95W,0,0,0,2,2
Tropical Depression,Eight,5,2001-09-12T21:00:00Z,MARCO ISLAND FL,1,4,3,4,12
Tropical Depression,Eight,6,2001-09-13T03:00:00Z,25.6N  86.5W,99,0,0,0,99
Tropical Depression,Eight,6,2001-09-13T03:00:00Z,FT MYERS FL,1,3,5,5,14
Tropical Depression,Eight,6,2001-09-13T03:00:00Z,26.2N  86.6W,55,0,0,0,55
Tropical Depression,Eight,6,2001-09-13T03:00:00Z,VENICE FL,1,4,5,5,15
Tropical Depression,Eight,6,2001-09-13T03:00:00Z,27.0N  86.0W,33,0,1,0,34
Tropical Depression,Eight,6,2001-09-13T03:00:00Z,TAMPA FL,0,2,6,7,15
Tropical Depression,Eight,6,2001-09-13T03:00:00Z,MUCF 221N 805W,0,0,0,2,2
Tropical Depression,Eight,6,2001-09-13T03:00:00Z,CEDAR KEY FL,0,1,5,8,14
Tropical Depression,Eight,6,2001-09-13T03:00:00Z,MUSN 216N 826W,0,0,0,3,3
Tropical Depression,Eight,6,2001-09-13T03:00:00Z,ST MARKS FL,0,0,5,9,14
Tropical Depression,Eight,6,2001-09-13T03:00:00Z,MUHA 230N 824W,1,1,2,3,7
Tropical Depression,Eight,6,2001-09-13T03:00:00Z,APALACHICOLA FL,0,2,7,7,16
Tropical Depression,Eight,6,2001-09-13T03:00:00Z,MUAN 219N 850W,0,1,0,3,4
Tropical Depression,Eight,6,2001-09-13T03:00:00Z,PANAMA CITY FL,0,1,7,7,15
Tropical Depression,Eight,6,2001-09-13T03:00:00Z,MYAK 241N 776W,0,0,0,2,2
Tropical Depression,Eight,6,2001-09-13T03:00:00Z,PENSACOLA FL,0,1,6,7,14
Tropical Depression,Eight,6,2001-09-13T03:00:00Z,MYNN 251N 775W,0,0,0,2,2
Tropical Depression,Eight,6,2001-09-13T03:00:00Z,MOBILE AL,0,1,6,6,13
Tropical Depression,Eight,6,2001-09-13T03:00:00Z,MYGF 266N 787W,0,0,0,5,5
Tropical Depression,Eight,6,2001-09-13T03:00:00Z,GULFPORT MS,0,2,6,5,13
Tropical Depression,Eight,6,2001-09-13T03:00:00Z,MARATHON FL,0,2,3,4,9
Tropical Depression,Eight,6,2001-09-13T03:00:00Z,BURAS LA,1,6,5,4,16
Tropical Depression,Eight,6,2001-09-13T03:00:00Z,MIAMI FL,0,1,2,5,8
Tropical Depression,Eight,6,2001-09-13T03:00:00Z,NEW ORLEANS LA,0,3,5,4,12
Tropical Depression,Eight,6,2001-09-13T03:00:00Z,W PALM BEACH FL,0,0,2,6,8
Tropical Depression,Eight,6,2001-09-13T03:00:00Z,NEW IBERIA LA,0,1,3,4,8
Tropical Depression,Eight,6,2001-09-13T03:00:00Z,FT PIERCE FL,0,0,2,7,9
Tropical Depression,Eight,6,2001-09-13T03:00:00Z,PORT ARTHUR TX,0,0,1,2,3
Tropical Depression,Eight,6,2001-09-13T03:00:00Z,COCOA BEACH FL,0,0,2,8,10
Tropical Depression,Eight,6,2001-09-13T03:00:00Z,GALVESTON TX,0,0,0,2,2
Tropical Depression,Eight,6,2001-09-13T03:00:00Z,DAYTONA BEACH FL,0,0,1,9,10
Tropical Depression,Eight,6,2001-09-13T03:00:00Z,GULF 29N 85W,1,4,8,5,18
Tropical Depression,Eight,6,2001-09-13T03:00:00Z,JACKSONVILLE FL,0,0,1,8,9
Tropical Depression,Eight,6,2001-09-13T03:00:00Z,GULF 29N 87W,3,7,6,4,20
Tropical Depression,Eight,6,2001-09-13T03:00:00Z,SAVANNAH GA,0,0,0,6,6
Tropical Depression,Eight,6,2001-09-13T03:00:00Z,GULF 28N 89W,9,8,3,1,21
Tropical Depression,Eight,6,2001-09-13T03:00:00Z,CHARLESTON SC,0,0,0,4,4
Tropical Depression,Eight,6,2001-09-13T03:00:00Z,GULF 28N 91W,2,7,3,3,15
Tropical Depression,Eight,6,2001-09-13T03:00:00Z,MYRTLE BEACH SC,0,0,0,2,2
Tropical Depression,Eight,6,2001-09-13T03:00:00Z,GULF 28N 93W,0,2,2,3,7
Tropical Depression,Eight,6,2001-09-13T03:00:00Z,KEY WEST FL,1,3,3,3,10
Tropical Depression,Eight,6,2001-09-13T03:00:00Z,GULF 28N 95W,0,0,0,2,2
Tropical Depression,Eight,6,2001-09-13T03:00:00Z,MARCO ISLAND FL,1,3,4,5,13
Tropical Depression,Eight,7,2001-09-13T09:00:00Z,25.6N  86.2W,99,0,0,0,99
Tropical Depression,Eight,7,2001-09-13T09:00:00Z,MARCO ISLAND FL,1,6,4,4,15
Tropical Depression,Eight,7,2001-09-13T09:00:00Z,26.2N  86.2W,80,0,0,0,80
Tropical Depression,Eight,7,2001-09-13T09:00:00Z,FT MYERS FL,2,6,4,4,16
Tropical Depression,Eight,7,2001-09-13T09:00:00Z,27.0N  85.8W,27,1,1,1,30
Tropical Depression,Eight,7,2001-09-13T09:00:00Z,VENICE FL,3,7,4,4,18
Tropical Depression,Eight,7,2001-09-13T09:00:00Z,MUCF 221N 805W,0,0,0,2,2
Tropical Depression,Eight,7,2001-09-13T09:00:00Z,TAMPA FL,1,5,6,5,17
Tropical Depression,Eight,7,2001-09-13T09:00:00Z,MUSN 216N 826W,0,0,0,2,2
Tropical Depression,Eight,7,2001-09-13T09:00:00Z,CEDAR KEY FL,0,2,7,6,15
Tropical Depression,Eight,7,2001-09-13T09:00:00Z,MUHA 230N 824W,0,1,1,4,6
Tropical Depression,Eight,7,2001-09-13T09:00:00Z,ST MARKS FL,0,1,5,8,14
Tropical Depression,Eight,7,2001-09-13T09:00:00Z,MUAN 219N 850W,0,0,1,3,4
Tropical Depression,Eight,7,2001-09-13T09:00:00Z,APALACHICOLA FL,0,2,7,7,16
Tropical Depression,Eight,7,2001-09-13T09:00:00Z,MYAK 241N 776W,0,0,0,2,2
Tropical Depression,Eight,7,2001-09-13T09:00:00Z,PANAMA CITY FL,0,1,7,7,15
Tropical Depression,Eight,7,2001-09-13T09:00:00Z,MYNN 251N 775W,0,0,0,3,3
Tropical Depression,Eight,7,2001-09-13T09:00:00Z,PENSACOLA FL,0,0,5,7,12
Tropical Depression,Eight,7,2001-09-13T09:00:00Z,MYGF 266N 787W,0,0,2,5,7
Tropical Depression,Eight,7,2001-09-13T09:00:00Z,MOBILE AL,0,0,3,7,10
Tropical Depression,Eight,7,2001-09-13T09:00:00Z,MARATHON FL,0,2,3,4,9
Tropical Depression,Eight,7,2001-09-13T09:00:00Z,GULFPORT MS,0,0,4,6,10
Tropical Depression,Eight,7,2001-09-13T09:00:00Z,MIAMI FL,0,2,3,5,10
Tropical Depression,Eight,7,2001-09-13T09:00:00Z,BURAS LA,0,2,5,5,12
Tropical Depression,Eight,7,2001-09-13T09:00:00Z,W PALM BEACH FL,0,1,4,5,10
Tropical Depression,Eight,7,2001-09-13T09:00:00Z,NEW ORLEANS LA,0,0,4,5,9
Tropical Depression,Eight,7,2001-09-13T09:00:00Z,FT PIERCE FL,0,1,4,6,11
Tropical Depression,Eight,7,2001-09-13T09:00:00Z,NEW IBERIA LA,0,0,1,4,5
Tropical Depression,Eight,7,2001-09-13T09:00:00Z,COCOA BEACH FL,0,1,4,7,12
Tropical Depression,Eight,7,2001-09-13T09:00:00Z,PORT ARTHUR TX,0,0,0,2,2
Tropical Depression,Eight,7,2001-09-13T09:00:00Z,DAYTONA BEACH FL,0,0,4,8,12
Tropical Depression,Eight,7,2001-09-13T09:00:00Z,GULF 29N 85W,1,5,7,5,18
Tropical Depression,Eight,7,2001-09-13T09:00:00Z,JACKSONVILLE FL,0,0,2,8,10
Tropical Depression,Eight,7,2001-09-13T09:00:00Z,GULF 29N 87W,1,6,7,4,18
Tropical Depression,Eight,7,2001-09-13T09:00:00Z,SAVANNAH GA,0,0,0,7,7
Tropical Depression,Eight,7,2001-09-13T09:00:00Z,GULF 28N 89W,4,7,5,2,18
Tropical Depression,Eight,7,2001-09-13T09:00:00Z,CHARLESTON SC,0,0,0,4,4
Tropical Depression,Eight,7,2001-09-13T09:00:00Z,GULF 28N 91W,0,4,5,3,12
Tropical Depression,Eight,7,2001-09-13T09:00:00Z,MYRTLE BEACH SC,0,0,0,3,3
Tropical Depression,Eight,7,2001-09-13T09:00:00Z,GULF 28N 93W,0,0,2,3,5
Tropical Depression,Eight,7,2001-09-13T09:00:00Z,WILMINGTON NC,0,0,0,2,2
Tropical Depression,Eight,7,2001-09-13T09:00:00Z,GULF 28N 95W,0,0,0,2,2
Tropical Depression,Eight,7,2001-09-13T09:00:00Z,KEY WEST FL,1,3,3,3,10
Tropical Storm,Gabrielle,8,2001-09-13T15:00:00Z,26.0N  85.5W,99,0,0,0,99
Tropical Storm,Gabrielle,8,2001-09-13T15:00:00Z,KEY WEST FL,3,5,3,2,13
Tropical Storm,Gabrielle,8,2001-09-13T15:00:00Z,27.0N  85.5W,23,2,1,1,27
Tropical Storm,Gabrielle,8,2001-09-13T15:00:00Z,MARCO ISLAND FL,4,5,4,2,15
Tropical Storm,Gabrielle,8,2001-09-13T15:00:00Z,28.0N  85.0W,11,7,3,2,23
Tropical Storm,Gabrielle,8,2001-09-13T15:00:00Z,FT MYERS FL,4,6,3,3,16
Tropical Storm,Gabrielle,8,2001-09-13T15:00:00Z,MUCF 221N 805W,0,0,1,2,3
Tropical Storm,Gabrielle,8,2001-09-13T15:00:00Z,VENICE FL,6,6,3,3,18
Tropical Storm,Gabrielle,8,2001-09-13T15:00:00Z,MUSN 216N 826W,0,0,1,1,2
Tropical Storm,Gabrielle,8,2001-09-13T15:00:00Z,TAMPA FL,2,6,5,4,17
Tropical Storm,Gabrielle,8,2001-09-13T15:00:00Z,MUHA 230N 824W,1,3,1,2,7
Tropical Storm,Gabrielle,8,2001-09-13T15:00:00Z,CEDAR KEY FL,0,5,6,5,16
Tropical Storm,Gabrielle,8,2001-09-13T15:00:00Z,MUAN 219N 850W,0,1,0,1,2
Tropical Storm,Gabrielle,8,2001-09-13T15:00:00Z,ST MARKS FL,0,3,7,6,16
Tropical Storm,Gabrielle,8,2001-09-13T15:00:00Z,MYAK 241N 776W,0,0,0,3,3
Tropical Storm,Gabrielle,8,2001-09-13T15:00:00Z,APALACHICOLA FL,1,7,6,4,18
Tropical Storm,Gabrielle,8,2001-09-13T15:00:00Z,MYNN 251N 775W,0,0,1,3,4
Tropical Storm,Gabrielle,8,2001-09-13T15:00:00Z,PANAMA CITY FL,0,7,6,5,18
Tropical Storm,Gabrielle,8,2001-09-13T15:00:00Z,MYGF 266N 787W,0,0,2,5,7
Tropical Storm,Gabrielle,8,2001-09-13T15:00:00Z,PENSACOLA FL,0,5,7,4,16
Tropical Storm,Gabrielle,8,2001-09-13T15:00:00Z,MARATHON FL,1,4,3,3,11
Tropical Storm,Gabrielle,8,2001-09-13T15:00:00Z,MOBILE AL,0,4,6,5,15
Tropical Storm,Gabrielle,8,2001-09-13T15:00:00Z,MIAMI FL,0,3,4,4,11
Tropical Storm,Gabrielle,8,2001-09-13T15:00:00Z,GULFPORT MS,0,4,6,4,14
Tropical Storm,Gabrielle,8,2001-09-13T15:00:00Z,W PALM BEACH FL,0,2,4,5,11
Tropical Storm,Gabrielle,8,2001-09-13T15:00:00Z,BURAS LA,0,6,4,3,13
Tropical Storm,Gabrielle,8,2001-09-13T15:00:00Z,FT PIERCE FL,0,1,4,7,12
Tropical Storm,Gabrielle,8,2001-09-13T15:00:00Z,NEW ORLEANS LA,0,3,4,4,11
Tropical Storm,Gabrielle,8,2001-09-13T15:00:00Z,COCOA BEACH FL,0,1,4,7,12
Tropical Storm,Gabrielle,8,2001-09-13T15:00:00Z,NEW IBERIA LA,0,1,2,3,6
Tropical Storm,Gabrielle,8,2001-09-13T15:00:00Z,DAYTONA BEACH FL,0,0,4,8,12
Tropical Storm,Gabrielle,8,2001-09-13T15:00:00Z,PORT ARTHUR TX,0,0,0,2,2
Tropical Storm,Gabrielle,8,2001-09-13T15:00:00Z,JACKSONVILLE FL,0,0,3,8,11
Tropical Storm,Gabrielle,8,2001-09-13T15:00:00Z,GULF 29N 85W,3,9,5,3,20
Tropical Storm,Gabrielle,8,2001-09-13T15:00:00Z,SAVANNAH GA,0,0,0,8,8
Tropical Storm,Gabrielle,8,2001-09-13T15:00:00Z,GULF 29N 87W,3,11,4,2,20
Tropical Storm,Gabrielle,8,2001-09-13T15:00:00Z,CHARLESTON SC,0,0,0,5,5
Tropical Storm,Gabrielle,8,2001-09-13T15:00:00Z,GULF 28N 89W,3,8,3,2,16
Tropical Storm,Gabrielle,8,2001-09-13T15:00:00Z,MYRTLE BEACH SC,0,0,0,3,3
Tropical Storm,Gabrielle,8,2001-09-13T15:00:00Z,GULF 28N 91W,0,2,2,4,8
Tropical Storm,Gabrielle,8,2001-09-13T15:00:00Z,WILMINGTON NC,0,0,0,2,2
Tropical Storm,Gabrielle,8,2001-09-13T15:00:00Z,GULF 28N 93W,0,0,0,2,2
Tropical Storm,Gabrielle,9,2001-09-13T21:00:00Z,27.0N  82.8W,37,0,0,0,37
Tropical Storm,Gabrielle,9,2001-09-13T21:00:00Z,CHARLESTON SC,0,1,5,6,12
Tropical Storm,Gabrielle,9,2001-09-13T21:00:00Z,28.0N  82.0W,21,1,1,1,24
Tropical Storm,Gabrielle,9,2001-09-13T21:00:00Z,MYRTLE BEACH SC,0,0,3,7,10
Tropical Storm,Gabrielle,9,2001-09-13T21:00:00Z,29.0N  81.0W,6,7,3,2,18
Tropical Storm,Gabrielle,9,2001-09-13T21:00:00Z,WILMINGTON NC,0,0,1,7,8
Tropical Storm,Gabrielle,9,2001-09-13T21:00:00Z,MUCM 214N 779W,0,0,0,2,2
Tropical Storm,Gabrielle,9,2001-09-13T21:00:00Z,MOREHEAD CITY NC,0,0,0,7,7
Tropical Storm,Gabrielle,9,2001-09-13T21:00:00Z,MUCF 221N 805W,0,0,2,2,4
Tropical Storm,Gabrielle,9,2001-09-13T21:00:00Z,CAPE HATTERAS NC,0,0,0,5,5
Tropical Storm,Gabrielle,9,2001-09-13T21:00:00Z,MUSN 216N 826W,0,1,1,1,3
Tropical Storm,Gabrielle,9,2001-09-13T21:00:00Z,NORFOLK VA,0,0,0,4,4
Tropical Storm,Gabrielle,9,2001-09-13T21:00:00Z,MUHA 230N 824W,1,3,2,1,7
Tropical Storm,Gabrielle,9,2001-09-13T21:00:00Z,OCEAN CITY MD,0,0,0,2,2
Tropical Storm,Gabrielle,9,2001-09-13T21:00:00Z,MUAN 219N 850W,0,1,0,1,2
Tropical Storm,Gabrielle,9,2001-09-13T21:00:00Z,KEY WEST FL,8,3,2,1,14
Tropical Storm,Gabrielle,9,2001-09-13T21:00:00Z,MYSM 241N 745W,0,0,0,2,2
Tropical Storm,Gabrielle,9,2001-09-13T21:00:00Z,MARCO ISLAND FL,18,2,1,0,21
Tropical Storm,Gabrielle,9,2001-09-13T21:00:00Z,MYEG 235N 758W,0,0,0,2,2
Tropical Storm,Gabrielle,9,2001-09-13T21:00:00Z,FT MYERS FL,23,1,1,0,25
Tropical Storm,Gabrielle,9,2001-09-13T21:00:00Z,MYAK 241N 776W,0,0,1,4,5
Tropical Storm,Gabrielle,9,2001-09-13T21:00:00Z,VENICE FL,31,1,0,0,32
Tropical Storm,Gabrielle,9,2001-09-13T21:00:00Z,MYNN 251N 775W,0,0,2,4,6
Tropical Storm,Gabrielle,9,2001-09-13T21:00:00Z,TAMPA FL,24,1,1,0,26
Tropical Storm,Gabrielle,9,2001-09-13T21:00:00Z,MYGF 266N 787W,0,3,3,5,11
Tropical Storm,Gabrielle,9,2001-09-13T21:00:00Z,CEDAR KEY FL,15,4,2,0,21
Tropical Storm,Gabrielle,9,2001-09-13T21:00:00Z,MARATHON FL,5,4,2,2,13
Tropical Storm,Gabrielle,9,2001-09-13T21:00:00Z,ST MARKS FL,4,8,3,1,16
Tropical Storm,Gabrielle,9,2001-09-13T21:00:00Z,MIAMI FL,4,5,2,3,14
Tropical Storm,Gabrielle,9,2001-09-13T21:00:00Z,APALACHICOLA FL,4,7,3,1,15
Tropical Storm,Gabrielle,9,2001-09-13T21:00:00Z,W PALM BEACH FL,4,5,3,3,15
Tropical Storm,Gabrielle,9,2001-09-13T21:00:00Z,PANAMA CITY FL,1,6,3,2,12
Tropical Storm,Gabrielle,9,2001-09-13T21:00:00Z,FT PIERCE FL,5,6,3,2,16
Tropical Storm,Gabrielle,9,2001-09-13T21:00:00Z,PENSACOLA FL,0,1,3,1,5
Tropical Storm,Gabrielle,9,2001-09-13T21:00:00Z,COCOA BEACH FL,6,7,2,3,18
Tropical Storm,Gabrielle,9,2001-09-13T21:00:00Z,MOBILE AL,0,0,1,1,2
Tropical Storm,Gabrielle,9,2001-09-13T21:00:00Z,DAYTONA BEACH FL,6,7,3,2,18
Tropical Storm,Gabrielle,9,2001-09-13T21:00:00Z,GULF 29N 85W,8,5,2,1,16
Tropical Storm,Gabrielle,9,2001-09-13T21:00:00Z,JACKSONVILLE FL,2,8,4,3,17
Tropical Storm,Gabrielle,9,2001-09-13T21:00:00Z,GULF 29N 87W,0,4,2,1,7
Tropical Storm,Gabrielle,9,2001-09-13T21:00:00Z,SAVANNAH GA,0,4,5,5,14
Tropical Storm,Gabrielle,10,2001-09-14T03:00:00Z,27.0N  82.4W,38,0,1,0,39
Tropical Storm,Gabrielle,10,2001-09-14T03:00:00Z,SAVANNAH GA,0,7,4,3,14
Tropical Storm,Gabrielle,10,2001-09-14T03:00:00Z,28.1N  81.4W,23,2,0,1,26
Tropical Storm,Gabrielle,10,2001-09-14T03:00:00Z,CHARLESTON SC,0,3,5,5,13
Tropical Storm,Gabrielle,10,2001-09-14T03:00:00Z,29.0N  80.5W,13,4,2,1,20
Tropical Storm,Gabrielle,10,2001-09-14T03:00:00Z,MYRTLE BEACH SC,0,1,4,6,11
Tropical Storm,Gabrielle,10,2001-09-14T03:00:00Z,MUCM 214N 779W,0,0,0,2,2
Tropical Storm,Gabrielle,10,2001-09-14T03:00:00Z,WILMINGTON NC,0,0,3,7,10
Tropical Storm,Gabrielle,10,2001-09-14T03:00:00Z,MUCF 221N 805W,0,1,1,2,4
Tropical Storm,Gabrielle,10,2001-09-14T03:00:00Z,MOREHEAD CITY NC,0,0,1,7,8
Tropical Storm,Gabrielle,10,2001-09-14T03:00:00Z,MUSN 216N 826W,0,1,1,1,3
Tropical Storm,Gabrielle,10,2001-09-14T03:00:00Z,CAPE HATTERAS NC,0,0,0,6,6
Tropical Storm,Gabrielle,10,2001-09-14T03:00:00Z,MUHA 230N 824W,2,3,2,1,8
Tropical Storm,Gabrielle,10,2001-09-14T03:00:00Z,NORFOLK VA,0,0,0,5,5
Tropical Storm,Gabrielle,10,2001-09-14T03:00:00Z,MUAN 219N 850W,0,1,0,1,2
Tropical Storm,Gabrielle,10,2001-09-14T03:00:00Z,OCEAN CITY MD,0,0,0,3,3
Tropical Storm,Gabrielle,10,2001-09-14T03:00:00Z,MYSM 241N 745W,0,0,0,2,2
Tropical Storm,Gabrielle,10,2001-09-14T03:00:00Z,KEY WEST FL,12,2,1,1,16
Tropical Storm,Gabrielle,10,2001-09-14T03:00:00Z,MYEG 235N 758W,0,0,0,2,2
Tropical Storm,Gabrielle,10,2001-09-14T03:00:00Z,MARCO ISLAND FL,26,1,0,0,27
Tropical Storm,Gabrielle,10,2001-09-14T03:00:00Z,MYAK 241N 776W,0,0,2,3,5
Tropical Storm,Gabrielle,10,2001-09-14T03:00:00Z,FT MYERS FL,33,0,0,0,33
Tropical Storm,Gabrielle,10,2001-09-14T03:00:00Z,MYNN 251N 775W,0,1,1,5,7
Tropical Storm,Gabrielle,10,2001-09-14T03:00:00Z,VENICE FL,38,0,0,1,39
Tropical Storm,Gabrielle,10,2001-09-14T03:00:00Z,MYGF 266N 787W,2,4,3,4,13
Tropical Storm,Gabrielle,10,2001-09-14T03:00:00Z,TAMPA FL,28,1,0,0,29
Tropical Storm,Gabrielle,10,2001-09-14T03:00:00Z,MARATHON FL,9,3,1,2,15
Tropical Storm,Gabrielle,10,2001-09-14T03:00:00Z,CEDAR KEY FL,15,3,1,1,20
Tropical Storm,Gabrielle,10,2001-09-14T03:00:00Z,MIAMI FL,10,3,2,1,16
Tropical Storm,Gabrielle,10,2001-09-14T03:00:00Z,ST MARKS FL,2,6,3,1,12
Tropical Storm,Gabrielle,10,2001-09-14T03:00:00Z,W PALM BEACH FL,12,3,2,1,18
Tropical Storm,Gabrielle,10,2001-09-14T03:00:00Z,APALACHICOLA FL,2,4,2,2,10
Tropical Storm,Gabrielle,10,2001-09-14T03:00:00Z,FT PIERCE FL,16,2,2,1,21
Tropical Storm,Gabrielle,10,2001-09-14T03:00:00Z,PANAMA CITY FL,0,3,2,2,7
Tropical Storm,Gabrielle,10,2001-09-14T03:00:00Z,COCOA BEACH FL,17,3,1,1,22
Tropical Storm,Gabrielle,10,2001-09-14T03:00:00Z,PENSACOLA FL,0,0,1,1,2
Tropical Storm,Gabrielle,10,2001-09-14T03:00:00Z,DAYTONA BEACH FL,15,3,2,1,21
Tropical Storm,Gabrielle,10,2001-09-14T03:00:00Z,GULF 29N 85W,4,4,2,1,11
Tropical Storm,Gabrielle,10,2001-09-14T03:00:00Z,JACKSONVILLE FL,5,8,3,2,18
Tropical Storm,Gabrielle,10,2001-09-14T03:00:00Z,GULF 29N 87W,0,1,1,1,3
Tropical Storm,Gabrielle,11,2001-09-14T09:00:00Z,28.2N  81.0W,41,0,0,0,41
Tropical Storm,Gabrielle,11,2001-09-14T09:00:00Z,MOREHEAD CITY NC,0,1,5,4,10
Tropical Storm,Gabrielle,11,2001-09-14T09:00:00Z,29.5N  80.0W,21,2,0,0,23
Tropical Storm,Gabrielle,11,2001-09-14T09:00:00Z,CAPE HATTERAS NC,0,0,4,6,10
Tropical Storm,Gabrielle,11,2001-09-14T09:00:00Z,30.5N  78.0W,2,10,2,2,16
Tropical Storm,Gabrielle,11,2001-09-14T09:00:00Z,NORFOLK VA,0,0,2,5,7
Tropical Storm,Gabrielle,11,2001-09-14T09:00:00Z,MUCM 214N 779W,0,0,1,1,2
Tropical Storm,Gabrielle,11,2001-09-14T09:00:00Z,OCEAN CITY MD,0,0,1,5,6
Tropical Storm,Gabrielle,11,2001-09-14T09:00:00Z,MUCF 221N 805W,0,1,1,1,3
Tropical Storm,Gabrielle,11,2001-09-14T09:00:00Z,ATLANTIC CITY NJ,0,0,0,5,5
Tropical Storm,Gabrielle,11,2001-09-14T09:00:00Z,MUHA 230N 824W,0,1,1,1,3
Tropical Storm,Gabrielle,11,2001-09-14T09:00:00Z,NEW YORK CITY NY,0,0,0,4,4
Tropical Storm,Gabrielle,11,2001-09-14T09:00:00Z,MYSM 241N 745W,0,0,1,3,4
Tropical Storm,Gabrielle,11,2001-09-14T09:00:00Z,MONTAUK POINT NY,0,0,0,3,3
Tropical Storm,Gabrielle,11,2001-09-14T09:00:00Z,MYEG 235N 758W,0,0,2,2,4
Tropical Storm,Gabrielle,11,2001-09-14T09:00:00Z,PROVIDENCE RI,0,0,0,3,3
Tropical Storm,Gabrielle,11,2001-09-14T09:00:00Z,MYAK 241N 776W,0,2,3,1,6
Tropical Storm,Gabrielle,11,2001-09-14T09:00:00Z,NANTUCKET MA,0,0,0,3,3
Tropical Storm,Gabrielle,11,2001-09-14T09:00:00Z,MYNN 251N 775W,0,3,4,2,9
Tropical Storm,Gabrielle,11,2001-09-14T09:00:00Z,HYANNIS MA,0,0,0,2,2
Tropical Storm,Gabrielle,11,2001-09-14T09:00:00Z,MYGF 266N 787W,8,5,1,1,15
Tropical Storm,Gabrielle,11,2001-09-14T09:00:00Z,BOSTON MA,0,0,0,2,2
Tropical Storm,Gabrielle,11,2001-09-14T09:00:00Z,MARATHON FL,6,3,1,1,11
Tropical Storm,Gabrielle,11,2001-09-14T09:00:00Z,KEY WEST FL,6,2,1,0,9
Tropical Storm,Gabrielle,11,2001-09-14T09:00:00Z,MIAMI FL,15,1,1,0,17
Tropical Storm,Gabrielle,11,2001-09-14T09:00:00Z,MARCO ISLAND FL,69,0,0,0,69
Tropical Storm,Gabrielle,11,2001-09-14T09:00:00Z,W PALM BEACH FL,23,1,0,0,24
Tropical Storm,Gabrielle,11,2001-09-14T09:00:00Z,FT MYERS FL,78,0,0,0,78
Tropical Storm,Gabrielle,11,2001-09-14T09:00:00Z,FT PIERCE FL,32,1,0,0,33
Tropical Storm,Gabrielle,11,2001-09-14T09:00:00Z,VENICE FL,74,0,0,0,74
Tropical Storm,Gabrielle,11,2001-09-14T09:00:00Z,COCOA BEACH FL,36,0,0,0,36
Tropical Storm,Gabrielle,11,2001-09-14T09:00:00Z,TAMPA FL,40,0,0,0,40
Tropical Storm,Gabrielle,11,2001-09-14T09:00:00Z,DAYTONA BEACH FL,27,1,0,0,28
Tropical Storm,Gabrielle,11,2001-09-14T09:00:00Z,CEDAR KEY FL,16,1,1,0,18
Tropical Storm,Gabrielle,11,2001-09-14T09:00:00Z,JACKSONVILLE FL,12,4,1,0,17
Tropical Storm,Gabrielle,11,2001-09-14T09:00:00Z,ST MARKS FL,2,4,0,1,7
Tropical Storm,Gabrielle,11,2001-09-14T09:00:00Z,SAVANNAH GA,2,7,2,1,12
Tropical Storm,Gabrielle,11,2001-09-14T09:00:00Z,APALACHICOLA FL,1,2,1,0,4
Tropical Storm,Gabrielle,11,2001-09-14T09:00:00Z,CHARLESTON SC,0,7,3,2,12
Tropical Storm,Gabrielle,11,2001-09-14T09:00:00Z,PANAMA CITY FL,0,1,1,0,2
Tropical Storm,Gabrielle,11,2001-09-14T09:00:00Z,MYRTLE BEACH SC,0,5,4,2,11
Tropical Storm,Gabrielle,11,2001-09-14T09:00:00Z,GULF 29N 85W,1,3,0,1,5
Tropical Storm,Gabrielle,11,2001-09-14T09:00:00Z,WILMINGTON NC,0,3,5,2,10
Tropical Storm,Gabrielle,12,2001-09-14T15:00:00Z,30.1N  80.3W,34,0,0,0,34
Tropical Storm,Gabrielle,12,2001-09-14T15:00:00Z,CAPE HATTERAS NC,0,2,9,3,14
Tropical Storm,Gabrielle,12,2001-09-14T15:00:00Z,31.4N  78.5W,10,10,1,0,21
Tropical Storm,Gabrielle,12,2001-09-14T15:00:00Z,NORFOLK VA,0,1,6,4,11
Tropical Storm,Gabrielle,12,2001-09-14T15:00:00Z,32.5N  76.0W,0,10,6,2,18
Tropical Storm,Gabrielle,12,2001-09-14T15:00:00Z,OCEAN CITY MD,0,0,3,6,9
Tropical Storm,Gabrielle,12,2001-09-14T15:00:00Z,MYSM 241N 745W,0,0,0,2,2
Tropical Storm,Gabrielle,12,2001-09-14T15:00:00Z,ATLANTIC CITY NJ,0,0,1,6,7
Tropical Storm,Gabrielle,12,2001-09-14T15:00:00Z,MYNN 251N 775W,0,1,2,0,3
Tropical Storm,Gabrielle,12,2001-09-14T15:00:00Z,NEW YORK CITY NY,0,0,0,6,6
Tropical Storm,Gabrielle,12,2001-09-14T15:00:00Z,MYGF 266N 787W,4,4,1,1,10
Tropical Storm,Gabrielle,12,2001-09-14T15:00:00Z,MONTAUK POINT NY,0,0,0,5,5
Tropical Storm,Gabrielle,12,2001-09-14T15:00:00Z,BERMUDA,0,0,0,2,2
Tropical Storm,Gabrielle,12,2001-09-14T15:00:00Z,PROVIDENCE RI,0,0,0,5,5
Tropical Storm,Gabrielle,12,2001-09-14T15:00:00Z,MIAMI FL,4,1,1,0,6
Tropical Storm,Gabrielle,12,2001-09-14T15:00:00Z,NANTUCKET MA,0,0,0,5,5
Tropical Storm,Gabrielle,12,2001-09-14T15:00:00Z,W PALM BEACH FL,13,1,1,0,15
Tropical Storm,Gabrielle,12,2001-09-14T15:00:00Z,HYANNIS MA,0,0,0,4,4
Tropical Storm,Gabrielle,12,2001-09-14T15:00:00Z,FT PIERCE FL,39,0,0,0,39
Tropical Storm,Gabrielle,12,2001-09-14T15:00:00Z,BOSTON MA,0,0,0,4,4
Tropical Storm,Gabrielle,12,2001-09-14T15:00:00Z,COCOA BEACH FL,59,0,0,0,59
Tropical Storm,Gabrielle,12,2001-09-14T15:00:00Z,PORTLAND ME,0,0,0,2,2
Tropical Storm,Gabrielle,12,2001-09-14T15:00:00Z,DAYTONA BEACH FL,58,0,0,0,58
Tropical Storm,Gabrielle,12,2001-09-14T15:00:00Z,MARCO ISLAND FL,21,0,1,0,22
Tropical Storm,Gabrielle,12,2001-09-14T15:00:00Z,JACKSONVILLE FL,23,1,0,0,24
Tropical Storm,Gabrielle,12,2001-09-14T15:00:00Z,FT MYERS FL,99,0,0,0,99
Tropical Storm,Gabrielle,12,2001-09-14T15:00:00Z,SAVANNAH GA,12,4,0,0,16
Tropical Storm,Gabrielle,12,2001-09-14T15:00:00Z,VENICE FL,99,0,0,0,99
Tropical Storm,Gabrielle,12,2001-09-14T15:00:00Z,CHARLESTON SC,7,8,1,0,16
Tropical Storm,Gabrielle,12,2001-09-14T15:00:00Z,TAMPA FL,99,0,0,0,99
Tropical Storm,Gabrielle,12,2001-09-14T15:00:00Z,MYRTLE BEACH SC,1,11,3,1,16
Tropical Storm,Gabrielle,12,2001-09-14T15:00:00Z,CEDAR KEY FL,19,0,0,0,19
Tropical Storm,Gabrielle,12,2001-09-14T15:00:00Z,WILMINGTON NC,0,9,5,1,15
Tropical Storm,Gabrielle,12,2001-09-14T15:00:00Z,ST MARKS FL,1,0,1,0,2
Tropical Storm,Gabrielle,12,2001-09-14T15:00:00Z,MOREHEAD CITY NC,0,6,7,2,15
Tropical Storm,Gabrielle,13,2001-09-14T21:00:00Z,30.6N  79.4W,26,1,0,0,27
Tropical Storm,Gabrielle,13,2001-09-14T21:00:00Z,CAPE HATTERAS NC,0,6,6,2,14
Tropical Storm,Gabrielle,13,2001-09-14T21:00:00Z,31.7N  77.5W,7,10,2,0,19
Tropical Storm,Gabrielle,13,2001-09-14T21:00:00Z,NORFOLK VA,0,3,4,3,10
Tropical Storm,Gabrielle,13,2001-09-14T21:00:00Z,33.0N  75.0W,0,8,7,2,17
Tropical Storm,Gabrielle,13,2001-09-14T21:00:00Z,OCEAN CITY MD,0,1,4,3,8
Tropical Storm,Gabrielle,13,2001-09-14T21:00:00Z,MYSM 241N 745W,0,0,1,1,2
Tropical Storm,Gabrielle,13,2001-09-14T21:00:00Z,ATLANTIC CITY NJ,0,0,2,5,7
Tropical Storm,Gabrielle,13,2001-09-14T21:00:00Z,MYAK 241N 776W,0,1,1,1,3
Tropical Storm,Gabrielle,13,2001-09-14T21:00:00Z,NEW YORK CITY NY,0,0,1,5,6
Tropical Storm,Gabrielle,13,2001-09-14T21:00:00Z,MYNN 251N 775W,0,3,2,0,5
Tropical Storm,Gabrielle,13,2001-09-14T21:00:00Z,MONTAUK POINT NY,0,0,1,5,6
Tropical Storm,Gabrielle,13,2001-09-14T21:00:00Z,MYGF 266N 787W,6,4,1,0,11
Tropical Storm,Gabrielle,13,2001-09-14T21:00:00Z,PROVIDENCE RI,0,0,0,6,6
Tropical Storm,Gabrielle,13,2001-09-14T21:00:00Z,BERMUDA,0,0,0,3,3
Tropical Storm,Gabrielle,13,2001-09-14T21:00:00Z,NANTUCKET MA,0,0,0,6,6
Tropical Storm,Gabrielle,13,2001-09-14T21:00:00Z,MARATHON FL,1,1,0,0,2
Tropical Storm,Gabrielle,13,2001-09-14T21:00:00Z,HYANNIS MA,0,0,0,6,6
Tropical Storm,Gabrielle,13,2001-09-14T21:00:00Z,MIAMI FL,5,2,0,1,8
Tropical Storm,Gabrielle,13,2001-09-14T21:00:00Z,BOSTON MA,0,0,0,5,5
Tropical Storm,Gabrielle,13,2001-09-14T21:00:00Z,W PALM BEACH FL,13,1,1,0,15
Tropical Storm,Gabrielle,13,2001-09-14T21:00:00Z,PORTLAND ME,0,0,0,3,3
Tropical Storm,Gabrielle,13,2001-09-14T21:00:00Z,FT PIERCE FL,86,0,0,0,86
Tropical Storm,Gabrielle,13,2001-09-14T21:00:00Z,BAR HARBOR ME,0,0,0,3,3
Tropical Storm,Gabrielle,13,2001-09-14T21:00:00Z,COCOA BEACH FL,99,0,0,0,99
Tropical Storm,Gabrielle,13,2001-09-14T21:00:00Z,EASTPORT ME,0,0,0,2,2
Tropical Storm,Gabrielle,13,2001-09-14T21:00:00Z,DAYTONA BEACH FL,99,0,0,0,99
Tropical Storm,Gabrielle,13,2001-09-14T21:00:00Z,YARMOUTH NS,0,0,0,2,2
Tropical Storm,Gabrielle,13,2001-09-14T21:00:00Z,JACKSONVILLE FL,16,0,0,0,16
Tropical Storm,Gabrielle,13,2001-09-14T21:00:00Z,MARCO ISLAND FL,2,2,0,0,4
Tropical Storm,Gabrielle,13,2001-09-14T21:00:00Z,SAVANNAH GA,9,2,0,0,11
Tropical Storm,Gabrielle,13,2001-09-14T21:00:00Z,FT MYERS FL,8,0,1,0,9
Tropical Storm,Gabrielle,13,2001-09-14T21:00:00Z,CHARLESTON SC,10,3,0,1,14
Tropical Storm,Gabrielle,13,2001-09-14T21:00:00Z,VENICE FL,50,0,0,0,50
Tropical Storm,Gabrielle,13,2001-09-14T21:00:00Z,MYRTLE BEACH SC,6,6,1,0,13
Tropical Storm,Gabrielle,13,2001-09-14T21:00:00Z,TAMPA FL,99,0,0,0,99
Tropical Storm,Gabrielle,13,2001-09-14T21:00:00Z,WILMINGTON NC,2,9,2,0,13
Tropical Storm,Gabrielle,13,2001-09-14T21:00:00Z,CEDAR KEY FL,6,0,0,0,6
Tropical Storm,Gabrielle,13,2001-09-14T21:00:00Z,MOREHEAD CITY NC,1,8,4,1,14
Tropical Storm,Gabrielle,14,2001-09-15T03:00:00Z,31.5N  78.5W,28,0,1,0,29
Tropical Storm,Gabrielle,14,2001-09-15T03:00:00Z,CAPE HATTERAS NC,0,4,7,1,12
Tropical Storm,Gabrielle,14,2001-09-15T03:00:00Z,32.5N  76.0W,1,14,2,0,17
Tropical Storm,Gabrielle,14,2001-09-15T03:00:00Z,NORFOLK VA,0,1,5,2,8
Tropical Storm,Gabrielle,14,2001-09-15T03:00:00Z,33.5N  73.0W,0,2,9,2,13
Tropical Storm,Gabrielle,14,2001-09-15T03:00:00Z,OCEAN CITY MD,0,0,4,3,7
Tropical Storm,Gabrielle,14,2001-09-15T03:00:00Z,MBJT 215N 712W,0,0,0,2,2
Tropical Storm,Gabrielle,14,2001-09-15T03:00:00Z,ATLANTIC CITY NJ,0,0,2,4,6
Tropical Storm,Gabrielle,14,2001-09-15T03:00:00Z,MYMM 224N 730W,0,0,0,2,2
Tropical Storm,Gabrielle,14,2001-09-15T03:00:00Z,NEW YORK CITY NY,0,0,1,4,5
Tropical Storm,Gabrielle,14,2001-09-15T03:00:00Z,MYSM 241N 745W,0,0,1,2,3
Tropical Storm,Gabrielle,14,2001-09-15T03:00:00Z,MONTAUK POINT NY,0,0,1,5,6
Tropical Storm,Gabrielle,14,2001-09-15T03:00:00Z,MYGF 266N 787W,0,2,0,0,2
Tropical Storm,Gabrielle,14,2001-09-15T03:00:00Z,PROVIDENCE RI,0,0,0,6,6
Tropical Storm,Gabrielle,14,2001-09-15T03:00:00Z,BERMUDA,0,0,0,4,4
Tropical Storm,Gabrielle,14,2001-09-15T03:00:00Z,NANTUCKET MA,0,0,0,6,6
Tropical Storm,Gabrielle,14,2001-09-15T03:00:00Z,FT PIERCE FL,4,0,0,0,4
Tropical Storm,Gabrielle,14,2001-09-15T03:00:00Z,HYANNIS MA,0,0,0,6,6
Tropical Storm,Gabrielle,14,2001-09-15T03:00:00Z,COCOA BEACH FL,99,0,0,0,99
Tropical Storm,Gabrielle,14,2001-09-15T03:00:00Z,BOSTON MA,0,0,0,5,5
Tropical Storm,Gabrielle,14,2001-09-15T03:00:00Z,DAYTONA BEACH FL,99,0,0,0,99
Tropical Storm,Gabrielle,14,2001-09-15T03:00:00Z,PORTLAND ME,0,0,0,4,4
Tropical Storm,Gabrielle,14,2001-09-15T03:00:00Z,JACKSONVILLE FL,66,0,0,0,66
Tropical Storm,Gabrielle,14,2001-09-15T03:00:00Z,BAR HARBOR ME,0,0,0,4,4
Tropical Storm,Gabrielle,14,2001-09-15T03:00:00Z,SAVANNAH GA,24,0,0,0,24
Tropical Storm,Gabrielle,14,2001-09-15T03:00:00Z,EASTPORT ME,0,0,0,4,4
Tropical Storm,Gabrielle,14,2001-09-15T03:00:00Z,CHARLESTON SC,17,2,0,0,19
Tropical Storm,Gabrielle,14,2001-09-15T03:00:00Z,ST JOHN NB,0,0,0,3,3
Tropical Storm,Gabrielle,14,2001-09-15T03:00:00Z,MYRTLE BEACH SC,5,9,1,0,15
Tropical Storm,Gabrielle,14,2001-09-15T03:00:00Z,MONCTON NB,0,0,0,2,2
Tropical Storm,Gabrielle,14,2001-09-15T03:00:00Z,WILMINGTON NC,1,11,1,0,13
Tropical Storm,Gabrielle,14,2001-09-15T03:00:00Z,YARMOUTH NS,0,0,0,4,4
Tropical Storm,Gabrielle,14,2001-09-15T03:00:00Z,MOREHEAD CITY NC,0,9,3,0,12
Tropical Storm,Gabrielle,14,2001-09-15T03:00:00Z,HALIFAX NS,0,0,0,3,3
Tropical Storm,Gabrielle,15,2001-09-15T09:00:00Z,30.0N  77.5W,39,0,0,1,40
Tropical Storm,Gabrielle,15,2001-09-15T09:00:00Z,NORFOLK VA,0,1,3,1,5
Tropical Storm,Gabrielle,15,2001-09-15T09:00:00Z,31.5N  74.5W,3,16,1,0,20
Tropical Storm,Gabrielle,15,2001-09-15T09:00:00Z,OCEAN CITY MD,0,0,3,1,4
Tropical Storm,Gabrielle,15,2001-09-15T09:00:00Z,33.0N  71.5W,0,5,8,2,15
Tropical Storm,Gabrielle,15,2001-09-15T09:00:00Z,ATLANTIC CITY NJ,0,0,1,2,3
Tropical Storm,Gabrielle,15,2001-09-15T09:00:00Z,MYSM 241N 745W,0,0,1,1,2
Tropical Storm,Gabrielle,15,2001-09-15T09:00:00Z,NEW YORK CITY NY,0,0,1,2,3
Tropical Storm,Gabrielle,15,2001-09-15T09:00:00Z,MYNN 251N 775W,0,1,1,0,2
Tropical Storm,Gabrielle,15,2001-09-15T09:00:00Z,MONTAUK POINT NY,0,0,1,3,4
Tropical Storm,Gabrielle,15,2001-09-15T09:00:00Z,MYGF 266N 787W,3,3,0,1,7
Tropical Storm,Gabrielle,15,2001-09-15T09:00:00Z,PROVIDENCE RI,0,0,0,3,3
Tropical Storm,Gabrielle,15,2001-09-15T09:00:00Z,BERMUDA,0,0,0,7,7
Tropical Storm,Gabrielle,15,2001-09-15T09:00:00Z,NANTUCKET MA,0,0,1,4,5
Tropical Storm,Gabrielle,15,2001-09-15T09:00:00Z,W PALM BEACH FL,3,1,1,0,5
Tropical Storm,Gabrielle,15,2001-09-15T09:00:00Z,HYANNIS MA,0,0,0,4,4
Tropical Storm,Gabrielle,15,2001-09-15T09:00:00Z,FT PIERCE FL,61,0,0,0,61
Tropical Storm,Gabrielle,15,2001-09-15T09:00:00Z,BOSTON MA,0,0,0,3,3
Tropical Storm,Gabrielle,15,2001-09-15T09:00:00Z,COCOA BEACH FL,99,0,0,0,99
Tropical Storm,Gabrielle,15,2001-09-15T09:00:00Z,PORTLAND ME,0,0,0,2,2
Tropical Storm,Gabrielle,15,2001-09-15T09:00:00Z,DAYTONA BEACH FL,99,0,0,0,99
Tropical Storm,Gabrielle,15,2001-09-15T09:00:00Z,BAR HARBOR ME,0,0,0,2,2
Tropical Storm,Gabrielle,15,2001-09-15T09:00:00Z,JACKSONVILLE FL,30,0,0,0,30
Tropical Storm,Gabrielle,15,2001-09-15T09:00:00Z,EASTPORT ME,0,0,0,2,2
Tropical Storm,Gabrielle,15,2001-09-15T09:00:00Z,SAVANNAH GA,7,2,0,0,9
Tropical Storm,Gabrielle,15,2001-09-15T09:00:00Z,ST JOHN NB,0,0,0,2,2
Tropical Storm,Gabrielle,15,2001-09-15T09:00:00Z,CHARLESTON SC,5,4,1,0,10
Tropical Storm,Gabrielle,15,2001-09-15T09:00:00Z,YARMOUTH NS,0,0,0,3,3
Tropical Storm,Gabrielle,15,2001-09-15T09:00:00Z,MYRTLE BEACH SC,2,6,1,0,9
Tropical Storm,Gabrielle,15,2001-09-15T09:00:00Z,HALIFAX NS,0,0,0,2,2
Tropical Storm,Gabrielle,15,2001-09-15T09:00:00Z,WILMINGTON NC,0,7,2,0,9
Tropical Storm,Gabrielle,15,2001-09-15T09:00:00Z,TAMPA FL,7,0,0,0,7
Tropical Storm,Gabrielle,15,2001-09-15T09:00:00Z,MOREHEAD CITY NC,0,7,3,0,10
Tropical Storm,Gabrielle,15,2001-09-15T09:00:00Z,CEDAR KEY FL,11,0,0,0,11
Tropical Storm,Gabrielle,15,2001-09-15T09:00:00Z,CAPE HATTERAS NC,0,6,3,1,10
Tropical Storm,Gabrielle,16,2001-09-15T15:00:00Z,30.2N  76.7W,34,1,0,0,35
Tropical Storm,Gabrielle,16,2001-09-15T15:00:00Z,MYRTLE BEACH SC,2,3,0,0,5
Tropical Storm,Gabrielle,16,2001-09-15T15:00:00Z,31.9N  73.7W,2,15,1,1,19
Tropical Storm,Gabrielle,16,2001-09-15T15:00:00Z,WILMINGTON NC,1,4,1,0,6
Tropical Storm,Gabrielle,16,2001-09-15T15:00:00Z,33.7N  70.5W,0,5,7,2,14
Tropical Storm,Gabrielle,16,2001-09-15T15:00:00Z,MOREHEAD CITY NC,1,5,1,0,7
Tropical Storm,Gabrielle,16,2001-09-15T15:00:00Z,MYSM 241N 745W,0,0,1,1,2
Tropical Storm,Gabrielle,16,2001-09-15T15:00:00Z,CAPE HATTERAS NC,0,5,2,1,8
Tropical Storm,Gabrielle,16,2001-09-15T15:00:00Z,MYNN 251N 775W,0,2,1,0,3
Tropical Storm,Gabrielle,16,2001-09-15T15:00:00Z,NORFOLK VA,0,1,1,1,3
Tropical Storm,Gabrielle,16,2001-09-15T15:00:00Z,MYGF 266N 787W,11,1,0,0,12
Tropical Storm,Gabrielle,16,2001-09-15T15:00:00Z,OCEAN CITY MD,0,0,1,1,2
Tropical Storm,Gabrielle,16,2001-09-15T15:00:00Z,BERMUDA,0,0,1,6,7
Tropical Storm,Gabrielle,16,2001-09-15T15:00:00Z,MONTAUK POINT NY,0,0,0,2,2
Tropical Storm,Gabrielle,16,2001-09-15T15:00:00Z,W PALM BEACH FL,6,1,0,0,7
Tropical Storm,Gabrielle,16,2001-09-15T15:00:00Z,PROVIDENCE RI,0,0,0,2,2
Tropical Storm,Gabrielle,16,2001-09-15T15:00:00Z,FT PIERCE FL,52,0,0,0,52
Tropical Storm,Gabrielle,16,2001-09-15T15:00:00Z,NANTUCKET MA,0,0,1,2,3
Tropical Storm,Gabrielle,16,2001-09-15T15:00:00Z,COCOA BEACH FL,99,0,0,0,99
Tropical Storm,Gabrielle,16,2001-09-15T15:00:00Z,HYANNIS MA,0,0,0,2,2
Tropical Storm,Gabrielle,16,2001-09-15T15:00:00Z,DAYTONA BEACH FL,99,0,0,0,99
Tropical Storm,Gabrielle,16,2001-09-15T15:00:00Z,YARMOUTH NS,0,0,0,2,2
Tropical Storm,Gabrielle,16,2001-09-15T15:00:00Z,JACKSONVILLE FL,3,0,0,0,3
Tropical Storm,Gabrielle,16,2001-09-15T15:00:00Z,HALIFAX NS,0,0,0,2,2
Tropical Storm,Gabrielle,16,2001-09-15T15:00:00Z,SAVANNAH GA,1,1,0,0,2
Tropical Storm,Gabrielle,16,2001-09-15T15:00:00Z,SABLE ISLAND NS,0,0,0,3,3
Tropical Storm,Gabrielle,16,2001-09-15T15:00:00Z,CHARLESTON SC,2,2,0,0,4
Tropical Storm,Gabrielle,16,2001-09-15T15:00:00Z,EDDY POINT NS,0,0,0,2,2
Tropical Storm,Gabrielle,17,2001-09-15T21:00:00Z,32.6N  73.9W,28,0,0,0,28
Tropical Storm,Gabrielle,17,2001-09-15T21:00:00Z,HYANNIS MA,0,0,2,3,5
Tropical Storm,Gabrielle,17,2001-09-15T21:00:00Z,34.1N  71.0W,4,12,2,0,18
Tropical Storm,Gabrielle,17,2001-09-15T21:00:00Z,BOSTON MA,0,0,1,3,4
Tropical Storm,Gabrielle,17,2001-09-15T21:00:00Z,36.0N  67.5W,0,5,7,2,14
Tropical Storm,Gabrielle,17,2001-09-15T21:00:00Z,PORTLAND ME,0,0,0,3,3
Tropical Storm,Gabrielle,17,2001-09-15T21:00:00Z,BERMUDA,0,0,3,4,7
Tropical Storm,Gabrielle,17,2001-09-15T21:00:00Z,BAR HARBOR ME,0,0,0,4,4
Tropical Storm,Gabrielle,17,2001-09-15T21:00:00Z,CHARLESTON SC,1,0,1,0,2
Tropical Storm,Gabrielle,17,2001-09-15T21:00:00Z,EASTPORT ME,0,0,0,4,4
Tropical Storm,Gabrielle,17,2001-09-15T21:00:00Z,MYRTLE BEACH SC,3,1,1,0,5
Tropical Storm,Gabrielle,17,2001-09-15T21:00:00Z,ST JOHN NB,0,0,0,4,4
Tropical Storm,Gabrielle,17,2001-09-15T21:00:00Z,WILMINGTON NC,5,3,0,0,8
Tropical Storm,Gabrielle,17,2001-09-15T21:00:00Z,MONCTON NB,0,0,0,4,4
Tropical Storm,Gabrielle,17,2001-09-15T21:00:00Z,MOREHEAD CITY NC,8,3,1,0,12
Tropical Storm,Gabrielle,17,2001-09-15T21:00:00Z,YARMOUTH NS,0,0,1,5,6
Tropical Storm,Gabrielle,17,2001-09-15T21:00:00Z,CAPE HATTERAS NC,6,5,1,0,12
Tropical Storm,Gabrielle,17,2001-09-15T21:00:00Z,HALIFAX NS,0,0,1,5,6
Tropical Storm,Gabrielle,17,2001-09-15T21:00:00Z,NORFOLK VA,0,3,1,1,5
Tropical Storm,Gabrielle,17,2001-09-15T21:00:00Z,SABLE ISLAND NS,0,0,0,7,7
Tropical Storm,Gabrielle,17,2001-09-15T21:00:00Z,OCEAN CITY MD,0,1,2,1,4
Tropical Storm,Gabrielle,17,2001-09-15T21:00:00Z,SYDNEY NS,0,0,0,4,4
Tropical Storm,Gabrielle,17,2001-09-15T21:00:00Z,ATLANTIC CITY NJ,0,1,0,2,3
Tropical Storm,Gabrielle,17,2001-09-15T21:00:00Z,EDDY POINT NS,0,0,0,5,5
Tropical Storm,Gabrielle,17,2001-09-15T21:00:00Z,NEW YORK CITY NY,0,0,1,2,3
Tropical Storm,Gabrielle,17,2001-09-15T21:00:00Z,PTX BASQUES NFLD,0,0,0,3,3
Tropical Storm,Gabrielle,17,2001-09-15T21:00:00Z,MONTAUK POINT NY,0,0,2,2,4
Tropical Storm,Gabrielle,17,2001-09-15T21:00:00Z,BURGEO NFLD,0,0,0,3,3
Tropical Storm,Gabrielle,17,2001-09-15T21:00:00Z,PROVIDENCE RI,0,0,1,3,4
Tropical Storm,Gabrielle,17,2001-09-15T21:00:00Z,ILE ST PIERRE,0,0,0,3,3
Tropical Storm,Gabrielle,17,2001-09-15T21:00:00Z,NANTUCKET MA,0,0,3,3,6
Tropical Storm,Gabrielle,17,2001-09-15T21:00:00Z,CAPE RACE NFLD,0,0,0,2,2
Tropical Storm,Gabrielle,18,2001-09-16T03:00:00Z,33.3N  72.6W,28,0,0,0,28
Tropical Storm,Gabrielle,18,2001-09-16T03:00:00Z,HYANNIS MA,0,0,2,4,6
Tropical Storm,Gabrielle,18,2001-09-16T03:00:00Z,34.7N  70.0W,5,11,1,1,18
Tropical Storm,Gabrielle,18,2001-09-16T03:00:00Z,BOSTON MA,0,0,1,3,4
Tropical Storm,Gabrielle,18,2001-09-16T03:00:00Z,36.1N  67.3W,0,7,5,2,14
Tropical Storm,Gabrielle,18,2001-09-16T03:00:00Z,PORTLAND ME,0,0,1,2,3
Tropical Storm,Gabrielle,18,2001-09-16T03:00:00Z,BERMUDA,0,1,2,4,7
Tropical Storm,Gabrielle,18,2001-09-16T03:00:00Z,BAR HARBOR ME,0,0,1,3,4
Tropical Storm,Gabrielle,18,2001-09-16T03:00:00Z,MYRTLE BEACH SC,1,1,0,0,2
Tropical Storm,Gabrielle,18,2001-09-16T03:00:00Z,EASTPORT ME,0,0,0,4,4
Tropical Storm,Gabrielle,18,2001-09-16T03:00:00Z,WILMINGTON NC,3,2,0,0,5
Tropical Storm,Gabrielle,18,2001-09-16T03:00:00Z,ST JOHN NB,0,0,0,4,4
Tropical Storm,Gabrielle,18,2001-09-16T03:00:00Z,MOREHEAD CITY NC,8,2,0,0,10
Tropical Storm,Gabrielle,18,2001-09-16T03:00:00Z,MONCTON NB,0,0,0,4,4
Tropical Storm,Gabrielle,18,2001-09-16T03:00:00Z,CAPE HATTERAS NC,9,2,1,0,12
Tropical Storm,Gabrielle,18,2001-09-16T03:00:00Z,YARMOUTH NS,0,0,1,5,6
Tropical Storm,Gabrielle,18,2001-09-16T03:00:00Z,NORFOLK VA,1,2,1,0,4
Tropical Storm,Gabrielle,18,2001-09-16T03:00:00Z,HALIFAX NS,0,0,1,5,6
Tropical Storm,Gabrielle,18,2001-09-16T03:00:00Z,OCEAN CITY MD,0,2,1,1,4
Tropical Storm,Gabrielle,18,2001-09-16T03:00:00Z,SABLE ISLAND NS,0,0,0,6,6
Tropical Storm,Gabrielle,18,2001-09-16T03:00:00Z,ATLANTIC CITY NJ,0,1,1,1,3
Tropical Storm,Gabrielle,18,2001-09-16T03:00:00Z,SYDNEY NS,0,0,0,4,4
Tropical Storm,Gabrielle,18,2001-09-16T03:00:00Z,NEW YORK CITY NY,0,0,1,2,3
Tropical Storm,Gabrielle,18,2001-09-16T03:00:00Z,EDDY POINT NS,0,0,0,5,5
Tropical Storm,Gabrielle,18,2001-09-16T03:00:00Z,MONTAUK POINT NY,0,0,2,2,4
Tropical Storm,Gabrielle,18,2001-09-16T03:00:00Z,PTX BASQUES NFLD,0,0,0,2,2
Tropical Storm,Gabrielle,18,2001-09-16T03:00:00Z,PROVIDENCE RI,0,0,2,2,4
Tropical Storm,Gabrielle,18,2001-09-16T03:00:00Z,BURGEO NFLD,0,0,0,2,2
Tropical Storm,Gabrielle,18,2001-09-16T03:00:00Z,NANTUCKET MA,0,1,2,3,6
Tropical Storm,Gabrielle,18,2001-09-16T03:00:00Z,ILE ST PIERRE,0,0,0,2,2
Tropical Storm,Gabrielle,19,2001-09-16T09:00:00Z,33.0N  71.5W,33,1,0,0,34
Tropical Storm,Gabrielle,19,2001-09-16T09:00:00Z,HALIFAX NS,0,0,0,3,3
Tropical Storm,Gabrielle,19,2001-09-16T09:00:00Z,34.0N  68.5W,4,16,1,1,22
Tropical Storm,Gabrielle,19,2001-09-16T09:00:00Z,SABLE ISLAND NS,0,0,0,5,5
Tropical Storm,Gabrielle,19,2001-09-16T09:00:00Z,35.5N  65.5W,0,5,9,2,16
Tropical Storm,Gabrielle,19,2001-09-16T09:00:00Z,SYDNEY NS,0,0,0,3,3
Tropical Storm,Gabrielle,19,2001-09-16T09:00:00Z,BERMUDA,0,2,7,3,12
Tropical Storm,Gabrielle,19,2001-09-16T09:00:00Z,EDDY POINT NS,0,0,0,3,3
Tropical Storm,Gabrielle,19,2001-09-16T09:00:00Z,MOREHEAD CITY NC,2,1,0,0,3
Tropical Storm,Gabrielle,19,2001-09-16T09:00:00Z,PTX BASQUES NFLD,0,0,0,2,2
Tropical Storm,Gabrielle,19,2001-09-16T09:00:00Z,CAPE HATTERAS NC,4,2,0,0,6
Tropical Storm,Gabrielle,19,2001-09-16T09:00:00Z,BURGEO NFLD,0,0,0,2,2
Tropical Storm,Gabrielle,19,2001-09-16T09:00:00Z,NANTUCKET MA,0,0,1,1,2
Tropical Storm,Gabrielle,19,2001-09-16T09:00:00Z,ILE ST PIERRE,0,0,0,3,3
Tropical Storm,Gabrielle,19,2001-09-16T09:00:00Z,YARMOUTH NS,0,0,0,2,2
Tropical Storm,Gabrielle,19,2001-09-16T09:00:00Z,CAPE RACE NFLD,0,0,0,2,2
Tropical Storm,Gabrielle,20,2001-09-16T15:00:00Z,33.9N  68.2W,29,1,0,0,30
Tropical Storm,Gabrielle,20,2001-09-16T15:00:00Z,SYDNEY NS,0,0,0,3,3
Tropical Storm,Gabrielle,20,2001-09-16T15:00:00Z,35.3N  65.5W,6,14,1,1,22
Tropical Storm,Gabrielle,20,2001-09-16T15:00:00Z,EDDY POINT NS,0,0,0,3,3
Tropical Storm,Gabrielle,20,2001-09-16T15:00:00Z,36.7N  63.3W,0,11,5,2,18
Tropical Storm,Gabrielle,20,2001-09-16T15:00:00Z,PTX BASQUES NFLD,0,0,0,2,2
Tropical Storm,Gabrielle,20,2001-09-16T15:00:00Z,BERMUDA,3,8,2,1,14
Tropical Storm,Gabrielle,20,2001-09-16T15:00:00Z,BURGEO NFLD,0,0,0,2,2
Tropical Storm,Gabrielle,20,2001-09-16T15:00:00Z,YARMOUTH NS,0,0,0,2,2
Tropical Storm,Gabrielle,20,2001-09-16T15:00:00Z,ILE ST PIERRE,0,0,0,3,3
Tropical Storm,Gabrielle,20,2001-09-16T15:00:00Z,HALIFAX NS,0,0,0,3,3
Tropical Storm,Gabrielle,20,2001-09-16T15:00:00Z,CAPE RACE NFLD,0,0,0,3,3
Tropical Storm,Gabrielle,20,2001-09-16T15:00:00Z,SABLE ISLAND NS,0,0,0,6,6
Tropical Storm,Gabrielle,21,2001-09-16T21:00:00Z,34.5N  66.5W,23,1,0,0,24
Tropical Storm,Gabrielle,21,2001-09-16T21:00:00Z,SYDNEY NS,0,0,0,3,3
Tropical Storm,Gabrielle,21,2001-09-16T21:00:00Z,36.0N  63.5W,3,11,2,1,17
Tropical Storm,Gabrielle,21,2001-09-16T21:00:00Z,EDDY POINT NS,0,0,0,3,3
Tropical Storm,Gabrielle,21,2001-09-16T21:00:00Z,37.5N  60.5W,0,7,5,2,14
Tropical Storm,Gabrielle,21,2001-09-16T21:00:00Z,PTX BASQUES NFLD,0,0,0,2,2
Tropical Storm,Gabrielle,21,2001-09-16T21:00:00Z,BERMUDA,4,5,2,1,12
Tropical Storm,Gabrielle,21,2001-09-16T21:00:00Z,BURGEO NFLD,0,0,0,3,3
Tropical Storm,Gabrielle,21,2001-09-16T21:00:00Z,YARMOUTH NS,0,0,0,2,2
Tropical Storm,Gabrielle,21,2001-09-16T21:00:00Z,ILE ST PIERRE,0,0,1,4,5
Tropical Storm,Gabrielle,21,2001-09-16T21:00:00Z,HALIFAX NS,0,0,0,3,3
Tropical Storm,Gabrielle,21,2001-09-16T21:00:00Z,CAPE RACE NFLD,0,0,1,4,5
Tropical Storm,Gabrielle,21,2001-09-16T21:00:00Z,SABLE ISLAND NS,0,0,2,5,7
Tropical Storm,Gabrielle,21,2001-09-16T21:00:00Z,HIBERNIA OILFLD,0,0,0,4,4
Hurricane,Gabrielle,22,2001-09-17T03:00:00Z,36.5N  64.5W,26,2,0,0,28
Hurricane,Gabrielle,22,2001-09-17T03:00:00Z,SABLE ISLAND NS,0,1,6,4,11
Hurricane,Gabrielle,22,2001-09-17T03:00:00Z,38.0N  62.0W,5,14,2,0,21
Hurricane,Gabrielle,22,2001-09-17T03:00:00Z,SYDNEY NS,0,0,1,6,7
Hurricane,Gabrielle,22,2001-09-17T03:00:00Z,39.5N  59.5W,0,12,4,2,18
Hurricane,Gabrielle,22,2001-09-17T03:00:00Z,EDDY POINT NS,0,0,2,5,7
Hurricane,Gabrielle,22,2001-09-17T03:00:00Z,BERMUDA,5,2,0,1,8
Hurricane,Gabrielle,22,2001-09-17T03:00:00Z,PTX BASQUES NFLD,0,0,0,5,5
Hurricane,Gabrielle,22,2001-09-17T03:00:00Z,ST JOHN NB,0,0,0,2,2
Hurricane,Gabrielle,22,2001-09-17T03:00:00Z,BURGEO NFLD,0,0,1,5,6
Hurricane,Gabrielle,22,2001-09-17T03:00:00Z,MONCTON NB,0,0,0,2,2
Hurricane,Gabrielle,22,2001-09-17T03:00:00Z,ILE ST PIERRE,0,0,1,7,8
Hurricane,Gabrielle,22,2001-09-17T03:00:00Z,YARMOUTH NS,0,0,1,2,3
Hurricane,Gabrielle,22,2001-09-17T03:00:00Z,CAPE RACE NFLD,0,0,1,8,9
Hurricane,Gabrielle,22,2001-09-17T03:00:00Z,HALIFAX NS,0,0,2,4,6
Hurricane,Gabrielle,22,2001-09-17T03:00:00Z,HIBERNIA OILFLD,0,0,0,6,6
Hurricane,Gabrielle,23,2001-09-17T09:00:00Z,37.5N  60.5W,21,1,0,0,22
Hurricane,Gabrielle,23,2001-09-17T09:00:00Z,SYDNEY NS,0,1,3,3,7
Hurricane,Gabrielle,23,2001-09-17T09:00:00Z,39.5N  57.5W,6,11,1,1,19
Hurricane,Gabrielle,23,2001-09-17T09:00:00Z,EDDY POINT NS,0,1,3,2,6
Hurricane,Gabrielle,23,2001-09-17T09:00:00Z,41.5N  54.5W,0,9,5,2,16
Hurricane,Gabrielle,23,2001-09-17T09:00:00Z,PTX BASQUES NFLD,0,0,3,3,6
Hurricane,Gabrielle,23,2001-09-17T09:00:00Z,BERMUDA,8,1,0,0,9
Hurricane,Gabrielle,23,2001-09-17T09:00:00Z,BURGEO NFLD,0,0,3,4,7
Hurricane,Gabrielle,23,2001-09-17T09:00:00Z,MONCTON NB,0,0,1,1,2
Hurricane,Gabrielle,23,2001-09-17T09:00:00Z,ILE ST PIERRE,0,1,5,4,10
Hurricane,Gabrielle,23,2001-09-17T09:00:00Z,HALIFAX NS,0,1,1,2,4
Hurricane,Gabrielle,23,2001-09-17T09:00:00Z,CAPE RACE NFLD,0,1,4,6,11
Hurricane,Gabrielle,23,2001-09-17T09:00:00Z,SABLE ISLAND NS,0,5,4,2,11
Hurricane,Gabrielle,23,2001-09-17T09:00:00Z,HIBERNIA OILFLD,0,0,2,7,9
Hurricane,Gabrielle,24,2001-09-17T15:00:00Z,38.7N  60.2W,24,1,0,0,25
Hurricane,Gabrielle,24,2001-09-17T15:00:00Z,EDDY POINT NS,0,1,4,2,7
Hurricane,Gabrielle,24,2001-09-17T15:00:00Z,40.4N  57.8W,8,10,2,0,20
Hurricane,Gabrielle,24,2001-09-17T15:00:00Z,PTX BASQUES NFLD,0,0,3,3,6
Hurricane,Gabrielle,24,2001-09-17T15:00:00Z,42.9N  53.7W,0,6,9,2,17
Hurricane,Gabrielle,24,2001-09-17T15:00:00Z,BURGEO NFLD,0,0,4,4,8
Hurricane,Gabrielle,24,2001-09-17T15:00:00Z,HALIFAX NS,0,1,2,1,4
Hurricane,Gabrielle,24,2001-09-17T15:00:00Z,ILE ST PIERRE,0,1,7,3,11
Hurricane,Gabrielle,24,2001-09-17T15:00:00Z,SABLE ISLAND NS,1,6,5,1,13
Hurricane,Gabrielle,24,2001-09-17T15:00:00Z,CAPE RACE NFLD,0,1,7,5,13
Hurricane,Gabrielle,24,2001-09-17T15:00:00Z,SYDNEY NS,0,1,4,2,7
Hurricane,Gabrielle,24,2001-09-17T15:00:00Z,HIBERNIA OILFLD,0,0,3,9,12
Hurricane,Gabrielle,25,2001-09-17T21:00:00Z,39.9N  58.8W,26,1,0,0,27
Hurricane,Gabrielle,25,2001-09-17T21:00:00Z,PTX BASQUES NFLD,0,0,2,2,4
Hurricane,Gabrielle,25,2001-09-17T21:00:00Z,41.9N  56.1W,5,14,3,1,23
Hurricane,Gabrielle,25,2001-09-17T21:00:00Z,BURGEO NFLD,0,1,4,2,7
Hurricane,Gabrielle,25,2001-09-17T21:00:00Z,45.3N  50.9W,0,4,13,2,19
Hurricane,Gabrielle,25,2001-09-17T21:00:00Z,ILE ST PIERRE,0,3,7,2,12
Hurricane,Gabrielle,25,2001-09-17T21:00:00Z,SABLE ISLAND NS,1,6,4,1,12
Hurricane,Gabrielle,25,2001-09-17T21:00:00Z,CAPE RACE NFLD,0,3,12,2,17
Hurricane,Gabrielle,25,2001-09-17T21:00:00Z,SYDNEY NS,0,1,3,1,5
Hurricane,Gabrielle,25,2001-09-17T21:00:00Z,HIBERNIA OILFLD,0,0,11,4,15
Hurricane,Gabrielle,25,2001-09-17T21:00:00Z,EDDY POINT NS,0,1,2,1,4
Tropical Storm,Gabrielle,26,2001-09-18T03:00:00Z,41.3N  55.4W,20,1,1,0,22
Tropical Storm,Gabrielle,26,2001-09-18T03:00:00Z,PTX BASQUES NFLD,0,1,1,1,3
Tropical Storm,Gabrielle,26,2001-09-18T03:00:00Z,44.0N  51.5W,3,13,1,0,17
Tropical Storm,Gabrielle,26,2001-09-18T03:00:00Z,BURGEO NFLD,0,3,2,0,5
Tropical Storm,Gabrielle,26,2001-09-18T03:00:00Z,46.5N  47.0W,0,5,7,2,14
Tropical Storm,Gabrielle,26,2001-09-18T03:00:00Z,ILE ST PIERRE,1,5,3,0,9
Tropical Storm,Gabrielle,26,2001-09-18T03:00:00Z,SABLE ISLAND NS,1,2,1,0,4
Tropical Storm,Gabrielle,26,2001-09-18T03:00:00Z,CAPE RACE NFLD,1,10,2,1,14
Tropical Storm,Gabrielle,26,2001-09-18T03:00:00Z,SYDNEY NS,0,1,1,0,2
Tropical Storm,Gabrielle,26,2001-09-18T03:00:00Z,HIBERNIA OILFLD,0,6,7,1,14
Tropical Storm,Gabrielle,27,2001-09-18T09:00:00Z,42.0N  55.0W,26,1,0,0,27
Tropical Storm,Gabrielle,27,2001-09-18T09:00:00Z,BURGEO NFLD,0,1,1,0,2
Tropical Storm,Gabrielle,27,2001-09-18T09:00:00Z,44.5N  51.0W,5,13,1,0,19
Tropical Storm,Gabrielle,27,2001-09-18T09:00:00Z,ILE ST PIERRE,1,4,1,0,6
Tropical Storm,Gabrielle,27,2001-09-18T09:00:00Z,47.0N  47.0W,0,7,6,1,14
Tropical Storm,Gabrielle,27,2001-09-18T09:00:00Z,CAPE RACE NFLD,1,9,1,1,12
Tropical Storm,Gabrielle,27,2001-09-18T09:00:00Z,SABLE ISLAND NS,6,1,0,0,7
Tropical Storm,Gabrielle,27,2001-09-18T09:00:00Z,HIBERNIA OILFLD,0,8,5,1,14
Tropical Storm,Gabrielle,28,2001-09-18T15:00:00Z,43.4N  53.3W,23,1,0,0,24
Tropical Storm,Gabrielle,28,2001-09-18T15:00:00Z,BURGEO NFLD,1,0,0,1,2
Tropical Storm,Gabrielle,28,2001-09-18T15:00:00Z,45.7N  49.4W,7,9,1,0,17
Tropical Storm,Gabrielle,28,2001-09-18T15:00:00Z,ILE ST PIERRE,3,2,1,0,6
Tropical Storm,Gabrielle,28,2001-09-18T15:00:00Z,47.9N  44.9W,0,8,4,2,14
Tropical Storm,Gabrielle,28,2001-09-18T15:00:00Z,CAPE RACE NFLD,6,6,0,0,12
Tropical Storm,Gabrielle,28,2001-09-18T15:00:00Z,SABLE ISLAND NS,3,0,0,0,3
Tropical Storm,Gabrielle,28,2001-09-18T15:00:00Z,HIBERNIA OILFLD,2,10,2,1,15
Tropical Storm,Gabrielle,29,2001-09-18T21:00:00Z,44.9N  52.1W,25,0,0,1,26
Tropical Storm,Gabrielle,29,2001-09-18T21:00:00Z,BURGEO NFLD,2,1,0,0,3
Tropical Storm,Gabrielle,29,2001-09-18T21:00:00Z,47.3N  47.7W,3,11,1,0,15
Tropical Storm,Gabrielle,29,2001-09-18T21:00:00Z,ILE ST PIERRE,8,2,0,0,10
Tropical Storm,Gabrielle,29,2001-09-18T21:00:00Z,49.3N  42.2W,0,2,6,4,12
Tropical Storm,Gabrielle,29,2001-09-18T21:00:00Z,CAPE RACE NFLD,16,2,0,1,19
Tropical Storm,Gabrielle,29,2001-09-18T21:00:00Z,SABLE ISLAND NS,2,0,0,1,3
Tropical Storm,Gabrielle,29,2001-09-18T21:00:00Z,HIBERNIA OILFLD,4,10,1,1,16
Tropical Storm,Gabrielle,30,2001-09-19T03:00:00Z,47.3N  49.5W,29,0,0,0,29
Tropical Storm,Gabrielle,30,2001-09-19T03:00:00Z,ILE ST PIERRE,11,0,0,0,11
Tropical Storm,Gabrielle,30,2001-09-19T03:00:00Z,50.2N  44.6W,2,13,1,1,17
Tropical Storm,Gabrielle,30,2001-09-19T03:00:00Z,CAPE RACE NFLD,31,0,0,0,31
Tropical Storm,Gabrielle,30,2001-09-19T03:00:00Z,53.0N  39.0W,0,2,7,4,13
Tropical Storm,Gabrielle,30,2001-09-19T03:00:00Z,HIBERNIA OILFLD,25,2,0,0,27
Tropical Storm,Gabrielle,30,2001-09-19T03:00:00Z,BURGEO NFLD,1,0,1,0,2
Tropical Depression,Nine,1,2001-09-19T21:00:00Z,15.0N  87.5W,46,0,0,0,46
Tropical Depression,Nine,1,2001-09-19T21:00:00Z,MMSO 238N 982W,0,0,0,4,4
Tropical Depression,Nine,1,2001-09-19T21:00:00Z,15.9N  89.8W,6,26,0,0,32
Tropical Depression,Nine,1,2001-09-19T21:00:00Z,MMTM 222N 979W,0,0,0,7,7
Tropical Depression,Nine,1,2001-09-19T21:00:00Z,16.9N  91.8W,0,15,11,1,27
Tropical Depression,Nine,1,2001-09-19T21:00:00Z,MMTX 210N 974W,0,0,0,10,10
Tropical Depression,Nine,1,2001-09-19T21:00:00Z,MMCZ 205N 869W,0,1,1,1,3
Tropical Depression,Nine,1,2001-09-19T21:00:00Z,MMVR 192N 961W,0,0,2,13,15
Tropical Depression,Nine,1,2001-09-19T21:00:00Z,MZBZ 175N 883W,7,20,0,0,27
Tropical Depression,Nine,1,2001-09-19T21:00:00Z,MMFR 185N 926W,0,3,17,4,24
Tropical Depression,Nine,1,2001-09-19T21:00:00Z,MGPB 157N 886W,30,8,0,0,38
Tropical Depression,Nine,1,2001-09-19T21:00:00Z,MMMD 210N 897W,0,1,7,3,11
Tropical Depression,Nine,1,2001-09-19T21:00:00Z,MHNJ 165N 859W,35,0,0,1,36
Tropical Depression,Nine,1,2001-09-19T21:00:00Z,GULF 25N 96W,0,0,0,3,3
Tropical Depression,Nine,1,2001-09-19T21:00:00Z,MNPC 141N 834W,99,0,0,0,99
Tropical Depression,Ten,1,2001-09-21T15:00:00Z,26.6N  66.4W,64,0,0,0,64
Tropical Depression,Ten,1,2001-09-21T15:00:00Z,MYRTLE BEACH SC,0,0,0,3,3
Tropical Depression,Ten,1,2001-09-21T15:00:00Z,28.0N  67.7W,21,12,1,0,34
Tropical Depression,Ten,1,2001-09-21T15:00:00Z,WILMINGTON NC,0,0,0,3,3
Tropical Depression,Ten,1,2001-09-21T15:00:00Z,29.5N  69.0W,0,15,5,1,21
Tropical Depression,Ten,1,2001-09-21T15:00:00Z,MOREHEAD CITY NC,0,0,0,4,4
Tropical Depression,Ten,1,2001-09-21T15:00:00Z,BERMUDA,0,0,3,6,9
Tropical Depression,Ten,1,2001-09-21T15:00:00Z,CAPE HATTERAS NC,0,0,0,4,4
Tropical Depression,Ten,1,2001-09-21T15:00:00Z,SAVANNAH GA,0,0,0,2,2
Tropical Depression,Ten,1,2001-09-21T15:00:00Z,NORFOLK VA,0,0,0,2,2
Tropical Depression,Ten,1,2001-09-21T15:00:00Z,CHARLESTON SC,0,0,0,2,2
Tropical Depression,Ten,2,2001-09-21T21:00:00Z,28.4N  68.4W,57,0,0,0,57
Tropical Depression,Ten,2,2001-09-21T21:00:00Z,MOREHEAD CITY NC,0,0,0,7,7
Tropical Depression,Ten,2,2001-09-21T21:00:00Z,29.7N  69.4W,24,9,0,0,33
Tropical Depression,Ten,2,2001-09-21T21:00:00Z,CAPE HATTERAS NC,0,0,0,8,8
Tropical Depression,Ten,2,2001-09-21T21:00:00Z,31.5N  70.0W,0,13,5,2,20
Tropical Depression,Ten,2,2001-09-21T21:00:00Z,NORFOLK VA,0,0,0,6,6
Tropical Depression,Ten,2,2001-09-21T21:00:00Z,BERMUDA,0,0,4,5,9
Tropical Depression,Ten,2,2001-09-21T21:00:00Z,OCEAN CITY MD,0,0,0,4,4
Tropical Depression,Ten,2,2001-09-21T21:00:00Z,SAVANNAH GA,0,0,0,2,2
Tropical Depression,Ten,2,2001-09-21T21:00:00Z,ATLANTIC CITY NJ,0,0,0,3,3
Tropical Depression,Ten,2,2001-09-21T21:00:00Z,CHARLESTON SC,0,0,0,3,3
Tropical Depression,Ten,2,2001-09-21T21:00:00Z,NEW YORK CITY NY,0,0,0,2,2
Tropical Depression,Ten,2,2001-09-21T21:00:00Z,MYRTLE BEACH SC,0,0,0,5,5
Tropical Depression,Ten,2,2001-09-21T21:00:00Z,MONTAUK POINT NY,0,0,0,2,2
Tropical Depression,Ten,2,2001-09-21T21:00:00Z,WILMINGTON NC,0,0,0,6,6
Tropical Depression,Ten,3,2001-09-22T03:00:00Z,29.5N  68.5W,38,0,0,0,38
Tropical Depression,Ten,3,2001-09-22T03:00:00Z,NORFOLK VA,0,0,1,7,8
Tropical Depression,Ten,3,2001-09-22T03:00:00Z,31.5N  69.5W,4,16,1,1,22
Tropical Depression,Ten,3,2001-09-22T03:00:00Z,OCEAN CITY MD,0,0,0,8,8
Tropical Depression,Ten,3,2001-09-22T03:00:00Z,33.5N  70.0W,0,6,8,3,17
Tropical Depression,Ten,3,2001-09-22T03:00:00Z,ATLANTIC CITY NJ,0,0,0,6,6
Tropical Depression,Ten,3,2001-09-22T03:00:00Z,BERMUDA,0,3,4,4,11
Tropical Depression,Ten,3,2001-09-22T03:00:00Z,NEW YORK CITY NY,0,0,0,5,5
Tropical Depression,Ten,3,2001-09-22T03:00:00Z,CHARLESTON SC,0,0,0,3,3
Tropical Depression,Ten,3,2001-09-22T03:00:00Z,MONTAUK POINT NY,0,0,0,4,4
Tropical Depression,Ten,3,2001-09-22T03:00:00Z,MYRTLE BEACH SC,0,0,1,4,5
Tropical Depression,Ten,3,2001-09-22T03:00:00Z,PROVIDENCE RI,0,0,0,3,3
Tropical Depression,Ten,3,2001-09-22T03:00:00Z,WILMINGTON NC,0,0,2,5,7
Tropical Depression,Ten,3,2001-09-22T03:00:00Z,NANTUCKET MA,0,0,0,3,3
Tropical Depression,Ten,3,2001-09-22T03:00:00Z,MOREHEAD CITY NC,0,0,3,6,9
Tropical Depression,Ten,3,2001-09-22T03:00:00Z,HYANNIS MA,0,0,0,3,3
Tropical Depression,Ten,3,2001-09-22T03:00:00Z,CAPE HATTERAS NC,0,0,3,7,10
Tropical Depression,Ten,3,2001-09-22T03:00:00Z,BOSTON MA,0,0,0,2,2
Tropical Depression,Ten,4,2001-09-22T09:00:00Z,31.0N  68.6W,41,0,0,0,41
Tropical Depression,Ten,4,2001-09-22T09:00:00Z,ATLANTIC CITY NJ,0,0,1,7,8
Tropical Depression,Ten,4,2001-09-22T09:00:00Z,32.8N  69.4W,11,12,1,1,25
Tropical Depression,Ten,4,2001-09-22T09:00:00Z,NEW YORK CITY NY,0,0,0,7,7
Tropical Depression,Ten,4,2001-09-22T09:00:00Z,35.0N  69.5W,0,8,8,3,19
Tropical Depression,Ten,4,2001-09-22T09:00:00Z,MONTAUK POINT NY,0,0,0,7,7
Tropical Depression,Ten,4,2001-09-22T09:00:00Z,BERMUDA,1,4,3,3,11
Tropical Depression,Ten,4,2001-09-22T09:00:00Z,PROVIDENCE RI,0,0,0,6,6
Tropical Depression,Ten,4,2001-09-22T09:00:00Z,MYRTLE BEACH SC,0,0,1,1,2
Tropical Depression,Ten,4,2001-09-22T09:00:00Z,NANTUCKET MA,0,0,0,6,6
Tropical Depression,Ten,4,2001-09-22T09:00:00Z,WILMINGTON NC,0,0,1,3,4
Tropical Depression,Ten,4,2001-09-22T09:00:00Z,HYANNIS MA,0,0,0,6,6
Tropical Depression,Ten,4,2001-09-22T09:00:00Z,MOREHEAD CITY NC,0,0,3,4,7
Tropical Depression,Ten,4,2001-09-22T09:00:00Z,BOSTON MA,0,0,0,5,5
Tropical Depression,Ten,4,2001-09-22T09:00:00Z,CAPE HATTERAS NC,0,0,5,5,10
Tropical Depression,Ten,4,2001-09-22T09:00:00Z,PORTLAND ME,0,0,0,3,3
Tropical Depression,Ten,4,2001-09-22T09:00:00Z,NORFOLK VA,0,0,2,7,9
Tropical Depression,Ten,4,2001-09-22T09:00:00Z,BAR HARBOR ME,0,0,0,2,2
Tropical Depression,Ten,4,2001-09-22T09:00:00Z,OCEAN CITY MD,0,0,2,7,9
Tropical Depression,Ten,5,2001-09-22T15:00:00Z,31.0N  68.5W,41,0,0,0,41
Tropical Depression,Ten,5,2001-09-22T15:00:00Z,MONTAUK POINT NY,0,0,0,8,8
Tropical Depression,Ten,5,2001-09-22T15:00:00Z,32.5N  69.0W,15,7,1,0,23
Tropical Depression,Ten,5,2001-09-22T15:00:00Z,PROVIDENCE RI,0,0,0,8,8
Tropical Depression,Ten,5,2001-09-22T15:00:00Z,35.0N  69.0W,0,4,9,3,16
Tropical Depression,Ten,5,2001-09-22T15:00:00Z,NANTUCKET MA,0,0,0,8,8
Tropical Depression,Ten,5,2001-09-22T15:00:00Z,BERMUDA,1,4,5,2,12
Tropical Depression,Ten,5,2001-09-22T15:00:00Z,HYANNIS MA,0,0,0,8,8
Tropical Depression,Ten,5,2001-09-22T15:00:00Z,WILMINGTON NC,0,0,1,2,3
Tropical Depression,Ten,5,2001-09-22T15:00:00Z,BOSTON MA,0,0,0,7,7
Tropical Depression,Ten,5,2001-09-22T15:00:00Z,MOREHEAD CITY NC,0,0,3,3,6
Tropical Depression,Ten,5,2001-09-22T15:00:00Z,PORTLAND ME,0,0,0,5,5
Tropical Depression,Ten,5,2001-09-22T15:00:00Z,CAPE HATTERAS NC,0,0,5,3,8
Tropical Depression,Ten,5,2001-09-22T15:00:00Z,BAR HARBOR ME,0,0,0,4,4
Tropical Depression,Ten,5,2001-09-22T15:00:00Z,NORFOLK VA,0,0,2,5,7
Tropical Depression,Ten,5,2001-09-22T15:00:00Z,EASTPORT ME,0,0,0,3,3
Tropical Depression,Ten,5,2001-09-22T15:00:00Z,OCEAN CITY MD,0,0,1,8,9
Tropical Depression,Ten,5,2001-09-22T15:00:00Z,ST JOHN NB,0,0,0,2,2
Tropical Depression,Ten,5,2001-09-22T15:00:00Z,ATLANTIC CITY NJ,0,0,1,7,8
Tropical Depression,Ten,5,2001-09-22T15:00:00Z,YARMOUTH NS,0,0,0,3,3
Tropical Depression,Ten,5,2001-09-22T15:00:00Z,NEW YORK CITY NY,0,0,0,8,8
Tropical Storm,Humberto,6,2001-09-22T21:00:00Z,31.0N  68.7W,52,0,0,0,52
Tropical Storm,Humberto,6,2001-09-22T21:00:00Z,MONTAUK POINT NY,0,0,0,10,10
Tropical Storm,Humberto,6,2001-09-22T21:00:00Z,32.5N  69.5W,16,5,2,0,23
Tropical Storm,Humberto,6,2001-09-22T21:00:00Z,PROVIDENCE RI,0,0,0,10,10
Tropical Storm,Humberto,6,2001-09-22T21:00:00Z,34.5N  69.5W,0,10,5,2,17
Tropical Storm,Humberto,6,2001-09-22T21:00:00Z,NANTUCKET MA,0,0,0,10,10
Tropical Storm,Humberto,6,2001-09-22T21:00:00Z,BERMUDA,1,4,4,2,11
Tropical Storm,Humberto,6,2001-09-22T21:00:00Z,HYANNIS MA,0,0,0,10,10
Tropical Storm,Humberto,6,2001-09-22T21:00:00Z,MYRTLE BEACH SC,0,0,1,1,2
Tropical Storm,Humberto,6,2001-09-22T21:00:00Z,BOSTON MA,0,0,0,9,9
Tropical Storm,Humberto,6,2001-09-22T21:00:00Z,WILMINGTON NC,0,0,2,2,4
Tropical Storm,Humberto,6,2001-09-22T21:00:00Z,PORTLAND ME,0,0,0,7,7
Tropical Storm,Humberto,6,2001-09-22T21:00:00Z,MOREHEAD CITY NC,0,0,3,3,6
Tropical Storm,Humberto,6,2001-09-22T21:00:00Z,BAR HARBOR ME,0,0,0,6,6
Tropical Storm,Humberto,6,2001-09-22T21:00:00Z,CAPE HATTERAS NC,0,0,5,4,9
Tropical Storm,Humberto,6,2001-09-22T21:00:00Z,EASTPORT ME,0,0,0,4,4
Tropical Storm,Humberto,6,2001-09-22T21:00:00Z,NORFOLK VA,0,0,2,5,7
Tropical Storm,Humberto,6,2001-09-22T21:00:00Z,ST JOHN NB,0,0,0,3,3
Tropical Storm,Humberto,6,2001-09-22T21:00:00Z,OCEAN CITY MD,0,0,1,8,9
Tropical Storm,Humberto,6,2001-09-22T21:00:00Z,MONCTON NB,0,0,0,2,2
Tropical Storm,Humberto,6,2001-09-22T21:00:00Z,ATLANTIC CITY NJ,0,0,1,8,9
Tropical Storm,Humberto,6,2001-09-22T21:00:00Z,YARMOUTH NS,0,0,0,5,5
Tropical Storm,Humberto,6,2001-09-22T21:00:00Z,NEW YORK CITY NY,0,0,0,9,9
Tropical Storm,Humberto,6,2001-09-22T21:00:00Z,HALIFAX NS,0,0,0,3,3
Tropical Storm,Humberto,7,2001-09-23T03:00:00Z,32.1N  68.9W,41,0,0,0,41
Tropical Storm,Humberto,7,2001-09-23T03:00:00Z,NANTUCKET MA,0,0,0,10,10
Tropical Storm,Humberto,7,2001-09-23T03:00:00Z,33.9N  69.1W,12,10,1,1,24
Tropical Storm,Humberto,7,2001-09-23T03:00:00Z,HYANNIS MA,0,0,0,9,9
Tropical Storm,Humberto,7,2001-09-23T03:00:00Z,36.0N  68.5W,0,7,7,3,17
Tropical Storm,Humberto,7,2001-09-23T03:00:00Z,BOSTON MA,0,0,0,8,8
Tropical Storm,Humberto,7,2001-09-23T03:00:00Z,BERMUDA,2,4,3,2,11
Tropical Storm,Humberto,7,2001-09-23T03:00:00Z,PORTLAND ME,0,0,0,7,7
Tropical Storm,Humberto,7,2001-09-23T03:00:00Z,MOREHEAD CITY NC,0,0,2,1,3
Tropical Storm,Humberto,7,2001-09-23T03:00:00Z,BAR HARBOR ME,0,0,0,6,6
Tropical Storm,Humberto,7,2001-09-23T03:00:00Z,CAPE HATTERAS NC,0,1,3,2,6
Tropical Storm,Humberto,7,2001-09-23T03:00:00Z,EASTPORT ME,0,0,0,6,6
Tropical Storm,Humberto,7,2001-09-23T03:00:00Z,NORFOLK VA,0,0,2,3,5
Tropical Storm,Humberto,7,2001-09-23T03:00:00Z,ST JOHN NB,0,0,0,5,5
Tropical Storm,Humberto,7,2001-09-23T03:00:00Z,OCEAN CITY MD,0,0,2,5,7
Tropical Storm,Humberto,7,2001-09-23T03:00:00Z,MONCTON NB,0,0,0,3,3
Tropical Storm,Humberto,7,2001-09-23T03:00:00Z,ATLANTIC CITY NJ,0,0,1,6,7
Tropical Storm,Humberto,7,2001-09-23T03:00:00Z,YARMOUTH NS,0,0,0,7,7
Tropical Storm,Humberto,7,2001-09-23T03:00:00Z,NEW YORK CITY NY,0,0,0,7,7
Tropical Storm,Humberto,7,2001-09-23T03:00:00Z,HALIFAX NS,0,0,0,4,4
Tropical Storm,Humberto,7,2001-09-23T03:00:00Z,MONTAUK POINT NY,0,0,0,9,9
Tropical Storm,Humberto,7,2001-09-23T03:00:00Z,SABLE ISLAND NS,0,0,0,3,3
Tropical Storm,Humberto,7,2001-09-23T03:00:00Z,PROVIDENCE RI,0,0,0,9,9
Tropical Storm,Humberto,7,2001-09-23T03:00:00Z,EDDY POINT NS,0,0,0,2,2
Tropical Storm,Humberto,8,2001-09-23T09:00:00Z,33.2N  68.3W,35,0,0,0,35
Tropical Storm,Humberto,8,2001-09-23T09:00:00Z,HYANNIS MA,0,0,1,8,9
Tropical Storm,Humberto,8,2001-09-23T09:00:00Z,35.0N  68.3W,6,13,2,0,21
Tropical Storm,Humberto,8,2001-09-23T09:00:00Z,BOSTON MA,0,0,0,8,8
Tropical Storm,Humberto,8,2001-09-23T09:00:00Z,37.0N  67.5W,0,4,9,3,16
Tropical Storm,Humberto,8,2001-09-23T09:00:00Z,PORTLAND ME,0,0,0,7,7
Tropical Storm,Humberto,8,2001-09-23T09:00:00Z,BERMUDA,5,4,2,1,12
Tropical Storm,Humberto,8,2001-09-23T09:00:00Z,BAR HARBOR ME,0,0,0,7,7
Tropical Storm,Humberto,8,2001-09-23T09:00:00Z,CAPE HATTERAS NC,0,1,2,0,3
Tropical Storm,Humberto,8,2001-09-23T09:00:00Z,EASTPORT ME,0,0,0,7,7
Tropical Storm,Humberto,8,2001-09-23T09:00:00Z,NORFOLK VA,0,0,2,1,3
Tropical Storm,Humberto,8,2001-09-23T09:00:00Z,ST JOHN NB,0,0,0,6,6
Tropical Storm,Humberto,8,2001-09-23T09:00:00Z,OCEAN CITY MD,0,0,3,2,5
Tropical Storm,Humberto,8,2001-09-23T09:00:00Z,MONCTON NB,0,0,0,5,5
Tropical Storm,Humberto,8,2001-09-23T09:00:00Z,ATLANTIC CITY NJ,0,0,2,4,6
Tropical Storm,Humberto,8,2001-09-23T09:00:00Z,YARMOUTH NS,0,0,0,8,8
Tropical Storm,Humberto,8,2001-09-23T09:00:00Z,NEW YORK CITY NY,0,0,2,4,6
Tropical Storm,Humberto,8,2001-09-23T09:00:00Z,HALIFAX NS,0,0,0,7,7
Tropical Storm,Humberto,8,2001-09-23T09:00:00Z,MONTAUK POINT NY,0,0,2,6,8
Tropical Storm,Humberto,8,2001-09-23T09:00:00Z,SABLE ISLAND NS,0,0,0,5,5
Tropical Storm,Humberto,8,2001-09-23T09:00:00Z,PROVIDENCE RI,0,0,1,7,8
Tropical Storm,Humberto,8,2001-09-23T09:00:00Z,SYDNEY NS,0,0,0,3,3
Tropical Storm,Humberto,8,2001-09-23T09:00:00Z,NANTUCKET MA,0,0,1,9,10
Tropical Storm,Humberto,8,2001-09-23T09:00:00Z,EDDY POINT NS,0,0,0,4,4
Tropical Storm,Humberto,9,2001-09-23T15:00:00Z,34.5N  68.0W,29,2,0,0,31
Tropical Storm,Humberto,9,2001-09-23T15:00:00Z,BAR HARBOR ME,0,0,1,8,9
Tropical Storm,Humberto,9,2001-09-23T15:00:00Z,36.9N  67.5W,1,16,3,0,20
Tropical Storm,Humberto,9,2001-09-23T15:00:00Z,EASTPORT ME,0,0,0,9,9
Tropical Storm,Humberto,9,2001-09-23T15:00:00Z,39.2N  66.3W,0,2,11,3,16
Tropical Storm,Humberto,9,2001-09-23T15:00:00Z,ST JOHN NB,0,0,0,9,9
Tropical Storm,Humberto,9,2001-09-23T15:00:00Z,BERMUDA,5,4,1,0,10
Tropical Storm,Humberto,9,2001-09-23T15:00:00Z,MONCTON NB,0,0,0,8,8
Tropical Storm,Humberto,9,2001-09-23T15:00:00Z,OCEAN CITY MD,0,1,1,1,3
Tropical Storm,Humberto,9,2001-09-23T15:00:00Z,YARMOUTH NS,0,0,1,10,11
Tropical Storm,Humberto,9,2001-09-23T15:00:00Z,ATLANTIC CITY NJ,0,1,2,1,4
Tropical Storm,Humberto,9,2001-09-23T15:00:00Z,HALIFAX NS,0,0,0,10,10
Tropical Storm,Humberto,9,2001-09-23T15:00:00Z,NEW YORK CITY NY,0,0,4,2,6
Tropical Storm,Humberto,9,2001-09-23T15:00:00Z,SABLE ISLAND NS,0,0,0,9,9
Tropical Storm,Humberto,9,2001-09-23T15:00:00Z,MONTAUK POINT NY,0,0,6,3,9
Tropical Storm,Humberto,9,2001-09-23T15:00:00Z,SYDNEY NS,0,0,0,7,7
Tropical Storm,Humberto,9,2001-09-23T15:00:00Z,PROVIDENCE RI,0,0,6,3,9
Tropical Storm,Humberto,9,2001-09-23T15:00:00Z,EDDY POINT NS,0,0,0,8,8
Tropical Storm,Humberto,9,2001-09-23T15:00:00Z,NANTUCKET MA,0,0,8,4,12
Tropical Storm,Humberto,9,2001-09-23T15:00:00Z,PTX BASQUES NFLD,0,0,0,5,5
Tropical Storm,Humberto,9,2001-09-23T15:00:00Z,HYANNIS MA,0,0,7,4,11
Tropical Storm,Humberto,9,2001-09-23T15:00:00Z,BURGEO NFLD,0,0,0,4,4
Tropical Storm,Humberto,9,2001-09-23T15:00:00Z,BOSTON MA,0,0,4,5,9
Tropical Storm,Humberto,9,2001-09-23T15:00:00Z,ILE ST PIERRE,0,0,0,4,4
Tropical Storm,Humberto,9,2001-09-23T15:00:00Z,PORTLAND ME,0,0,2,6,8
Tropical Storm,Humberto,9,2001-09-23T15:00:00Z,CAPE RACE NFLD,0,0,0,2,2
Hurricane,Humberto,10,2001-09-23T21:00:00Z,35.2N  67.4W,29,1,0,0,30
Hurricane,Humberto,10,2001-09-23T21:00:00Z,EASTPORT ME,0,0,3,7,10
Hurricane,Humberto,10,2001-09-23T21:00:00Z,37.6N  66.5W,1,17,2,0,20
Hurricane,Humberto,10,2001-09-23T21:00:00Z,ST JOHN NB,0,0,2,7,9
Hurricane,Humberto,10,2001-09-23T21:00:00Z,40.0N  65.0W,0,2,11,3,16
Hurricane,Humberto,10,2001-09-23T21:00:00Z,MONCTON NB,0,0,1,8,9
Hurricane,Humberto,10,2001-09-23T21:00:00Z,BERMUDA,9,2,1,0,12
Hurricane,Humberto,10,2001-09-23T21:00:00Z,YARMOUTH NS,0,0,4,7,11
Hurricane,Humberto,10,2001-09-23T21:00:00Z,NEW YORK CITY NY,0,0,2,1,3
Hurricane,Humberto,10,2001-09-23T21:00:00Z,HALIFAX NS,0,0,1,9,10
Hurricane,Humberto,10,2001-09-23T21:00:00Z,MONTAUK POINT NY,0,1,5,1,7
Hurricane,Humberto,10,2001-09-23T21:00:00Z,SABLE ISLAND NS,0,0,0,9,9
Hurricane,Humberto,10,2001-09-23T21:00:00Z,PROVIDENCE RI,0,1,5,2,8
Hurricane,Humberto,10,2001-09-23T21:00:00Z,SYDNEY NS,0,0,0,7,7
Hurricane,Humberto,10,2001-09-23T21:00:00Z,NANTUCKET MA,0,2,8,1,11
Hurricane,Humberto,10,2001-09-23T21:00:00Z,EDDY POINT NS,0,0,0,9,9
Hurricane,Humberto,10,2001-09-23T21:00:00Z,HYANNIS MA,0,1,7,2,10
Hurricane,Humberto,10,2001-09-23T21:00:00Z,PTX BASQUES NFLD,0,0,0,6,6
Hurricane,Humberto,10,2001-09-23T21:00:00Z,BOSTON MA,0,1,5,2,8
Hurricane,Humberto,10,2001-09-23T21:00:00Z,BURGEO NFLD,0,0,0,5,5
Hurricane,Humberto,10,2001-09-23T21:00:00Z,PORTLAND ME,0,0,4,4,8
Hurricane,Humberto,10,2001-09-23T21:00:00Z,ILE ST PIERRE,0,0,0,4,4
Hurricane,Humberto,10,2001-09-23T21:00:00Z,BAR HARBOR ME,0,0,4,5,9
Hurricane,Humberto,10,2001-09-23T21:00:00Z,CAPE RACE NFLD,0,0,0,2,2
Hurricane,Humberto,11,2001-09-24T03:00:00Z,36.5N  66.4W,29,1,0,0,30
Hurricane,Humberto,11,2001-09-24T03:00:00Z,ST JOHN NB,0,0,5,4,9
Hurricane,Humberto,11,2001-09-24T03:00:00Z,38.6N  65.4W,7,9,2,1,19
Hurricane,Humberto,11,2001-09-24T03:00:00Z,MONCTON NB,0,0,3,6,9
Hurricane,Humberto,11,2001-09-24T03:00:00Z,40.5N  63.5W,0,5,7,3,15
Hurricane,Humberto,11,2001-09-24T03:00:00Z,YARMOUTH NS,0,2,7,3,12
Hurricane,Humberto,11,2001-09-24T03:00:00Z,BERMUDA,5,3,1,0,9
Hurricane,Humberto,11,2001-09-24T03:00:00Z,HALIFAX NS,0,0,5,6,11
Hurricane,Humberto,11,2001-09-24T03:00:00Z,MONTAUK POINT NY,0,2,2,0,4
Hurricane,Humberto,11,2001-09-24T03:00:00Z,SABLE ISLAND NS,0,0,1,9,10
Hurricane,Humberto,11,2001-09-24T03:00:00Z,PROVIDENCE RI,0,2,3,0,5
Hurricane,Humberto,11,2001-09-24T03:00:00Z,SYDNEY NS,0,0,0,8,8
Hurricane,Humberto,11,2001-09-24T03:00:00Z,NANTUCKET MA,0,6,2,1,9
Hurricane,Humberto,11,2001-09-24T03:00:00Z,EDDY POINT NS,0,0,1,8,9
Hurricane,Humberto,11,2001-09-24T03:00:00Z,HYANNIS MA,0,4,3,1,8
Hurricane,Humberto,11,2001-09-24T03:00:00Z,PTX BASQUES NFLD,0,0,0,7,7
Hurricane,Humberto,11,2001-09-24T03:00:00Z,BOSTON MA,0,2,3,1,6
Hurricane,Humberto,11,2001-09-24T03:00:00Z,BURGEO NFLD,0,0,0,6,6
Hurricane,Humberto,11,2001-09-24T03:00:00Z,PORTLAND ME,0,1,4,1,6
Hurricane,Humberto,11,2001-09-24T03:00:00Z,ILE ST PIERRE,0,0,0,6,6
Hurricane,Humberto,11,2001-09-24T03:00:00Z,BAR HARBOR ME,0,1,5,2,8
Hurricane,Humberto,11,2001-09-24T03:00:00Z,CAPE RACE NFLD,0,0,0,3,3
Hurricane,Humberto,11,2001-09-24T03:00:00Z,EASTPORT ME,0,1,5,3,9
Hurricane,Humberto,12,2001-09-24T09:00:00Z,37.8N  64.5W,27,1,0,0,28
Hurricane,Humberto,12,2001-09-24T09:00:00Z,MONCTON NB,0,1,3,3,7
Hurricane,Humberto,12,2001-09-24T09:00:00Z,39.5N  62.5W,7,8,1,1,17
Hurricane,Humberto,12,2001-09-24T09:00:00Z,YARMOUTH NS,0,4,3,1,8
Hurricane,Humberto,12,2001-09-24T09:00:00Z,40.5N  60.0W,0,8,3,3,14
Hurricane,Humberto,12,2001-09-24T09:00:00Z,HALIFAX NS,0,3,4,3,10
Hurricane,Humberto,12,2001-09-24T09:00:00Z,BERMUDA,1,2,1,0,4
Hurricane,Humberto,12,2001-09-24T09:00:00Z,SABLE ISLAND NS,0,3,4,4,11
Hurricane,Humberto,12,2001-09-24T09:00:00Z,PROVIDENCE RI,0,1,0,1,2
Hurricane,Humberto,12,2001-09-24T09:00:00Z,SYDNEY NS,0,1,3,5,9
Hurricane,Humberto,12,2001-09-24T09:00:00Z,NANTUCKET MA,0,2,1,1,4
Hurricane,Humberto,12,2001-09-24T09:00:00Z,EDDY POINT NS,0,1,5,3,9
Hurricane,Humberto,12,2001-09-24T09:00:00Z,HYANNIS MA,0,2,1,0,3
Hurricane,Humberto,12,2001-09-24T09:00:00Z,PTX BASQUES NFLD,0,0,2,5,7
Hurricane,Humberto,12,2001-09-24T09:00:00Z,BOSTON MA,0,1,0,1,2
Hurricane,Humberto,12,2001-09-24T09:00:00Z,BURGEO NFLD,0,0,2,5,7
Hurricane,Humberto,12,2001-09-24T09:00:00Z,PORTLAND ME,0,1,1,0,2
Hurricane,Humberto,12,2001-09-24T09:00:00Z,ILE ST PIERRE,0,0,1,7,8
Hurricane,Humberto,12,2001-09-24T09:00:00Z,BAR HARBOR ME,0,2,1,1,4
Hurricane,Humberto,12,2001-09-24T09:00:00Z,CAPE RACE NFLD,0,0,0,6,6
Hurricane,Humberto,12,2001-09-24T09:00:00Z,EASTPORT ME,0,2,2,2,6
Hurricane,Humberto,12,2001-09-24T09:00:00Z,HIBERNIA OILFLD,0,0,0,3,3
Hurricane,Humberto,12,2001-09-24T09:00:00Z,ST JOHN NB,0,2,3,1,6
Hurricane,Humberto,13,2001-09-24T15:00:00Z,38.9N  63.7W,26,0,1,0,27
Hurricane,Humberto,13,2001-09-24T15:00:00Z,YARMOUTH NS,0,6,2,0,8
Hurricane,Humberto,13,2001-09-24T15:00:00Z,40.6N  61.5W,6,8,2,0,16
Hurricane,Humberto,13,2001-09-24T15:00:00Z,HALIFAX NS,0,6,3,1,10
Hurricane,Humberto,13,2001-09-24T15:00:00Z,42.1N  58.5W,0,6,4,3,13
Hurricane,Humberto,13,2001-09-24T15:00:00Z,SABLE ISLAND NS,0,5,5,2,12
Hurricane,Humberto,13,2001-09-24T15:00:00Z,BERMUDA,0,1,0,1,2
Hurricane,Humberto,13,2001-09-24T15:00:00Z,SYDNEY NS,0,2,5,3,10
Hurricane,Humberto,13,2001-09-24T15:00:00Z,NANTUCKET MA,0,2,1,0,3
Hurricane,Humberto,13,2001-09-24T15:00:00Z,EDDY POINT NS,0,3,5,2,10
Hurricane,Humberto,13,2001-09-24T15:00:00Z,HYANNIS MA,0,2,0,0,2
Hurricane,Humberto,13,2001-09-24T15:00:00Z,PTX BASQUES NFLD,0,1,3,4,8
Hurricane,Humberto,13,2001-09-24T15:00:00Z,PORTLAND ME,0,1,1,0,2
Hurricane,Humberto,13,2001-09-24T15:00:00Z,BURGEO NFLD,0,0,4,5,9
Hurricane,Humberto,13,2001-09-24T15:00:00Z,BAR HARBOR ME,0,2,1,1,4
Hurricane,Humberto,13,2001-09-24T15:00:00Z,ILE ST PIERRE,0,0,4,5,9
Hurricane,Humberto,13,2001-09-24T15:00:00Z,EASTPORT ME,0,3,2,0,5
Hurricane,Humberto,13,2001-09-24T15:00:00Z,CAPE RACE NFLD,0,0,1,7,8
Hurricane,Humberto,13,2001-09-24T15:00:00Z,ST JOHN NB,0,3,3,1,7
Hurricane,Humberto,13,2001-09-24T15:00:00Z,HIBERNIA OILFLD,0,0,0,5,5
Hurricane,Humberto,13,2001-09-24T15:00:00Z,MONCTON NB,0,2,4,1,7
Hurricane,Humberto,14,2001-09-24T21:00:00Z,40.0N  62.6W,24,0,1,0,25
Hurricane,Humberto,14,2001-09-24T21:00:00Z,SABLE ISLAND NS,1,10,2,1,14
Hurricane,Humberto,14,2001-09-24T21:00:00Z,41.5N  59.9W,7,8,1,0,16
Hurricane,Humberto,14,2001-09-24T21:00:00Z,SYDNEY NS,0,5,4,2,11
Hurricane,Humberto,14,2001-09-24T21:00:00Z,42.9N  56.1W,0,6,5,2,13
Hurricane,Humberto,14,2001-09-24T21:00:00Z,EDDY POINT NS,0,7,3,1,11
Hurricane,Humberto,14,2001-09-24T21:00:00Z,BAR HARBOR ME,0,1,1,0,2
Hurricane,Humberto,14,2001-09-24T21:00:00Z,PTX BASQUES NFLD,0,2,5,2,9
Hurricane,Humberto,14,2001-09-24T21:00:00Z,EASTPORT ME,0,3,1,0,4
Hurricane,Humberto,14,2001-09-24T21:00:00Z,BURGEO NFLD,0,2,5,2,9
Hurricane,Humberto,14,2001-09-24T21:00:00Z,ST JOHN NB,0,4,1,0,5
Hurricane,Humberto,14,2001-09-24T21:00:00Z,ILE ST PIERRE,0,2,5,3,10
Hurricane,Humberto,14,2001-09-24T21:00:00Z,MONCTON NB,0,4,1,1,6
Hurricane,Humberto,14,2001-09-24T21:00:00Z,CAPE RACE NFLD,0,0,5,5,10
Hurricane,Humberto,14,2001-09-24T21:00:00Z,YARMOUTH NS,2,4,1,0,7
Hurricane,Humberto,14,2001-09-24T21:00:00Z,HIBERNIA OILFLD,0,0,1,6,7
Hurricane,Humberto,14,2001-09-24T21:00:00Z,HALIFAX NS,1,7,2,0,10
Hurricane,Humberto,15,2001-09-25T03:00:00Z,40.3N  60.2W,18,2,0,0,20
Hurricane,Humberto,15,2001-09-25T03:00:00Z,EDDY POINT NS,1,5,1,1,8
Hurricane,Humberto,15,2001-09-25T03:00:00Z,41.5N  57.0W,3,12,1,1,17
Hurricane,Humberto,15,2001-09-25T03:00:00Z,PTX BASQUES NFLD,0,3,2,0,5
Hurricane,Humberto,15,2001-09-25T03:00:00Z,42.0N  53.0W,0,5,7,2,14
Hurricane,Humberto,15,2001-09-25T03:00:00Z,BURGEO NFLD,0,3,3,1,7
Hurricane,Humberto,15,2001-09-25T03:00:00Z,HALIFAX NS,2,3,0,1,6
Hurricane,Humberto,15,2001-09-25T03:00:00Z,ILE ST PIERRE,0,4,5,1,10
Hurricane,Humberto,15,2001-09-25T03:00:00Z,SABLE ISLAND NS,4,8,1,1,14
Hurricane,Humberto,15,2001-09-25T03:00:00Z,CAPE RACE NFLD,0,2,7,2,11
Hurricane,Humberto,15,2001-09-25T03:00:00Z,SYDNEY NS,1,4,2,1,8
Hurricane,Humberto,15,2001-09-25T03:00:00Z,HIBERNIA OILFLD,0,0,3,6,9
Hurricane,Humberto,16,2001-09-25T09:00:00Z,40.3N  59.8W,23,1,0,0,24
Hurricane,Humberto,16,2001-09-25T09:00:00Z,EDDY POINT NS,2,3,1,0,6
Hurricane,Humberto,16,2001-09-25T09:00:00Z,41.5N  56.0W,3,12,2,0,17
Hurricane,Humberto,16,2001-09-25T09:00:00Z,PTX BASQUES NFLD,0,2,1,0,3
Hurricane,Humberto,16,2001-09-25T09:00:00Z,42.0N  51.0W,0,3,9,2,14
Hurricane,Humberto,16,2001-09-25T09:00:00Z,BURGEO NFLD,0,3,1,1,5
Hurricane,Humberto,16,2001-09-25T09:00:00Z,HALIFAX NS,2,2,0,0,4
Hurricane,Humberto,16,2001-09-25T09:00:00Z,ILE ST PIERRE,0,5,3,0,8
Hurricane,Humberto,16,2001-09-25T09:00:00Z,SABLE ISLAND NS,6,6,0,0,12
Hurricane,Humberto,16,2001-09-25T09:00:00Z,CAPE RACE NFLD,0,4,5,1,10
Hurricane,Humberto,16,2001-09-25T09:00:00Z,SYDNEY NS,1,4,0,0,5
Hurricane,Humberto,16,2001-09-25T09:00:00Z,HIBERNIA OILFLD,0,0,6,4,10
Hurricane,Humberto,17,2001-09-25T15:00:00Z,41.0N  57.5W,25,1,0,0,26
Hurricane,Humberto,17,2001-09-25T15:00:00Z,PTX BASQUES NFLD,0,1,1,0,2
Hurricane,Humberto,17,2001-09-25T15:00:00Z,42.0N  53.5W,3,12,1,1,17
Hurricane,Humberto,17,2001-09-25T15:00:00Z,BURGEO NFLD,0,2,1,1,4
Hurricane,Humberto,17,2001-09-25T15:00:00Z,42.5N  49.0W,0,6,5,2,13
Hurricane,Humberto,17,2001-09-25T15:00:00Z,ILE ST PIERRE,0,4,2,1,7
Hurricane,Humberto,17,2001-09-25T15:00:00Z,SABLE ISLAND NS,7,3,0,1,11
Hurricane,Humberto,17,2001-09-25T15:00:00Z,CAPE RACE NFLD,0,5,3,1,9
Hurricane,Humberto,17,2001-09-25T15:00:00Z,SYDNEY NS,0,2,1,0,3
Hurricane,Humberto,17,2001-09-25T15:00:00Z,HIBERNIA OILFLD,0,1,5,3,9
Hurricane,Humberto,17,2001-09-25T15:00:00Z,EDDY POINT NS,1,1,1,0,3
Hurricane,Humberto,18,2001-09-25T21:00:00Z,41.5N  57.0W,24,1,0,0,25
Hurricane,Humberto,18,2001-09-25T21:00:00Z,ILE ST PIERRE,0,3,1,0,4
Hurricane,Humberto,18,2001-09-25T21:00:00Z,41.5N  53.0W,3,12,1,1,17
Hurricane,Humberto,18,2001-09-25T21:00:00Z,CAPE RACE NFLD,0,4,2,1,7
Hurricane,Humberto,18,2001-09-25T21:00:00Z,42.0N  48.0W,0,4,7,2,13
Hurricane,Humberto,18,2001-09-25T21:00:00Z,HIBERNIA OILFLD,0,1,5,2,8
Hurricane,Humberto,18,2001-09-25T21:00:00Z,SABLE ISLAND NS,6,2,1,0,9
Hurricane,Humberto,19,2001-09-26T03:00:00Z,41.5N  55.5W,24,1,0,0,25
Hurricane,Humberto,19,2001-09-26T03:00:00Z,ILE ST PIERRE,0,2,1,0,3
Hurricane,Humberto,19,2001-09-26T03:00:00Z,42.0N  52.0W,6,9,1,1,17
Hurricane,Humberto,19,2001-09-26T03:00:00Z,CAPE RACE NFLD,0,4,2,1,7
Hurricane,Humberto,19,2001-09-26T03:00:00Z,42.5N  46.5W,0,4,7,2,13
Hurricane,Humberto,19,2001-09-26T03:00:00Z,HIBERNIA OILFLD,0,3,4,1,8
Hurricane,Humberto,19,2001-09-26T03:00:00Z,SABLE ISLAND NS,4,1,0,0,5
Hurricane,Humberto,20,2001-09-26T09:00:00Z,42.1N  54.3W,23,0,0,0,23
Hurricane,Humberto,20,2001-09-26T09:00:00Z,ILE ST PIERRE,0,1,1,0,2
Hurricane,Humberto,20,2001-09-26T09:00:00Z,42.5N  49.6W,2,13,1,0,16
Hurricane,Humberto,20,2001-09-26T09:00:00Z,CAPE RACE NFLD,2,4,1,0,7
Hurricane,Humberto,20,2001-09-26T09:00:00Z,42.5N  44.0W,0,4,7,0,11
Hurricane,Humberto,20,2001-09-26T09:00:00Z,HIBERNIA OILFLD,0,6,3,0,9
Hurricane,Humberto,21,2001-09-26T15:00:00Z,42.5N  50.0W,27,3,0,0,30
Hurricane,Humberto,21,2001-09-26T15:00:00Z,42.0N  33.0W,0,1,10,0,11
Hurricane,Humberto,21,2001-09-26T15:00:00Z,42.5N  41.5W,0,16,2,0,18
Hurricane,Humberto,21,2001-09-26T15:00:00Z,HIBERNIA OILFLD,1,2,0,0,3
Hurricane,Humberto,22,2001-09-26T21:00:00Z,42.5N  46.0W,26,2,0,0,28
Hurricane,Humberto,22,2001-09-26T21:00:00Z,41.5N  30.0W,0,2,9,0,11
Hurricane,Humberto,22,2001-09-26T21:00:00Z,42.0N  38.0W,1,15,2,0,18
Hurricane,Humberto,22,2001-09-26T21:00:00Z,HIBERNIA OILFLD,2,0,0,0,2
Hurricane,Humberto,23,2001-09-27T03:00:00Z,42.5N  42.5W,28,2,0,0,30
Hurricane,Humberto,23,2001-09-27T03:00:00Z,42.0N  35.0W,0,14,0,0,14
Tropical Storm,Humberto,24,2001-09-27T09:00:00Z,41.5N  37.5W,26,3,0,0,29
Tropical Storm,Humberto,24,2001-09-27T09:00:00Z,41.5N  30.0W,0,15,0,0,15
Tropical Storm,Humberto,25,2001-09-27T15:00:00Z,41.0N  33.0W,28,3,0,0,31
Tropical Storm,Humberto,25,2001-09-27T15:00:00Z,41.0N  25.0W,0,15,0,0,15
Tropical Depression,Eleven,1,2001-10-04T21:00:00Z,15.0N  66.0W,48,0,0,0,48
Tropical Depression,Eleven,1,2001-10-04T21:00:00Z,MTPP 186N 724W,0,0,21,3,24
Tropical Depression,Eleven,1,2001-10-04T21:00:00Z,16.0N  68.5W,5,28,1,0,34
Tropical Depression,Eleven,1,2001-10-04T21:00:00Z,MTCA 183N 738W,0,0,13,9,22
Tropical Depression,Eleven,1,2001-10-04T21:00:00Z,17.0N  71.5W,0,5,22,1,28
Tropical Depression,Eleven,1,2001-10-04T21:00:00Z,MKJP 179N 768W,0,0,1,14,15
Tropical Depression,Eleven,1,2001-10-04T21:00:00Z,SKPG 125N 717W,0,1,2,3,6
Tropical Depression,Eleven,1,2001-10-04T21:00:00Z,MKJS 185N 779W,0,0,0,12,12
Tropical Depression,Eleven,1,2001-10-04T21:00:00Z,TNCC 122N 690W,1,3,1,1,6
Tropical Depression,Eleven,1,2001-10-04T21:00:00Z,MWCG 193N 814W,0,0,0,2,2
Tropical Depression,Eleven,1,2001-10-04T21:00:00Z,TGPY 120N 618W,15,0,0,0,15
Tropical Depression,Eleven,1,2001-10-04T21:00:00Z,MUGM 200N 751W,0,0,3,15,18
Tropical Depression,Eleven,1,2001-10-04T21:00:00Z,TBPB 131N 595W,99,0,0,0,99
Tropical Depression,Eleven,1,2001-10-04T21:00:00Z,MUCM 214N 779W,0,0,0,11,11
Tropical Depression,Eleven,1,2001-10-04T21:00:00Z,TVSV 131N 612W,99,0,0,0,99
Tropical Depression,Eleven,1,2001-10-04T21:00:00Z,MUCF 221N 805W,0,0,0,4,4
Tropical Depression,Eleven,1,2001-10-04T21:00:00Z,TLPL 138N 610W,99,0,0,0,99
Tropical Depression,Eleven,1,2001-10-04T21:00:00Z,TJSJ 184N 661W,4,14,0,0,18
Tropical Depression,Eleven,1,2001-10-04T21:00:00Z,TFFF 146N 610W,81,0,0,0,81
Tropical Depression,Eleven,1,2001-10-04T21:00:00Z,MDPP 198N 707W,0,1,17,2,20
Tropical Depression,Eleven,1,2001-10-04T21:00:00Z,TDPR 153N 614W,49,0,0,0,49
Tropical Depression,Eleven,1,2001-10-04T21:00:00Z,MBJT 215N 712W,0,0,6,6,12
Tropical Depression,Eleven,1,2001-10-04T21:00:00Z,TFFR 163N 615W,8,0,0,0,8
Tropical Depression,Eleven,1,2001-10-04T21:00:00Z,MYMM 224N 730W,0,0,1,9,10
Tropical Depression,Eleven,1,2001-10-04T21:00:00Z,TAPA 171N 618W,2,0,0,0,2
Tropical Depression,Eleven,1,2001-10-04T21:00:00Z,MYSM 241N 745W,0,0,0,5,5
Tropical Depression,Eleven,1,2001-10-04T21:00:00Z,TKPK 173N 627W,6,1,0,0,7
Tropical Depression,Eleven,1,2001-10-04T21:00:00Z,MYEG 235N 758W,0,0,0,7,7
Tropical Depression,Eleven,1,2001-10-04T21:00:00Z,TNCM 181N 631W,2,1,0,0,3
Tropical Depression,Eleven,1,2001-10-04T21:00:00Z,MYAK 241N 776W,0,0,0,5,5
Tropical Depression,Eleven,1,2001-10-04T21:00:00Z,TISX 177N 648W,15,4,0,0,19
Tropical Depression,Eleven,1,2001-10-04T21:00:00Z,MYNN 251N 775W,0,0,0,3,3
Tropical Depression,Eleven,1,2001-10-04T21:00:00Z,TIST 183N 650W,6,7,0,0,13
Tropical Depression,Eleven,1,2001-10-04T21:00:00Z,ST CROIX VI,15,4,0,0,19
Tropical Depression,Eleven,1,2001-10-04T21:00:00Z,TJPS 180N 666W,6,18,0,0,24
Tropical Depression,Eleven,1,2001-10-04T21:00:00Z,ST THOMAS VI,6,7,0,0,13
Tropical Depression,Eleven,1,2001-10-04T21:00:00Z,MDSD 185N 697W,0,13,15,0,28
Tropical Depression,Eleven,1,2001-10-04T21:00:00Z,SAN JUAN PR,4,14,0,0,18
Tropical Depression,Eleven,1,2001-10-04T21:00:00Z,MDCB 176N 714W,0,5,23,0,28
Tropical Depression,Eleven,1,2001-10-04T21:00:00Z,PONCE PR,6,18,0,0,24
Tropical Depression,Eleven,2,2001-10-05T03:00:00Z,15.8N  67.1W,50,0,0,0,50
Tropical Depression,Eleven,2,2001-10-05T03:00:00Z,MUCM 214N 779W,0,0,0,15,15
Tropical Depression,Eleven,2,2001-10-05T03:00:00Z,16.9N  69.5W,7,28,0,0,35
Tropical Depression,Eleven,2,2001-10-05T03:00:00Z,MUCF 221N 805W,0,0,0,8,8
Tropical Depression,Eleven,2,2001-10-05T03:00:00Z,17.5N  72.0W,0,13,14,1,28
Tropical Depression,Eleven,2,2001-10-05T03:00:00Z,MUSN 216N 826W,0,0,0,2,2
Tropical Depression,Eleven,2,2001-10-05T03:00:00Z,SKPG 125N 717W,0,0,1,2,3
Tropical Depression,Eleven,2,2001-10-05T03:00:00Z,MUHA 230N 824W,0,0,0,2,2
Tropical Depression,Eleven,2,2001-10-05T03:00:00Z,TNCC 122N 690W,0,1,0,1,2
Tropical Depression,Eleven,2,2001-10-05T03:00:00Z,TJSJ 184N 661W,15,5,0,0,20
Tropical Depression,Eleven,2,2001-10-05T03:00:00Z,TVSV 131N 612W,99,0,0,0,99
Tropical Depression,Eleven,2,2001-10-05T03:00:00Z,MDPP 198N 707W,0,10,11,1,22
Tropical Depression,Eleven,2,2001-10-05T03:00:00Z,TLPL 138N 610W,99,0,0,0,99
Tropical Depression,Eleven,2,2001-10-05T03:00:00Z,MBJT 215N 712W,0,1,8,3,12
Tropical Depression,Eleven,2,2001-10-05T03:00:00Z,TFFF 146N 610W,81,0,0,0,81
Tropical Depression,Eleven,2,2001-10-05T03:00:00Z,MYMM 224N 730W,0,0,3,8,11
Tropical Depression,Eleven,2,2001-10-05T03:00:00Z,TDPR 153N 614W,17,0,0,0,17
Tropical Depression,Eleven,2,2001-10-05T03:00:00Z,MYSM 241N 745W,0,0,0,6,6
Tropical Depression,Eleven,2,2001-10-05T03:00:00Z,TISX 177N 648W,16,1,0,0,17
Tropical Depression,Eleven,2,2001-10-05T03:00:00Z,MYEG 235N 758W,0,0,0,10,10
Tropical Depression,Eleven,2,2001-10-05T03:00:00Z,TIST 183N 650W,8,2,0,0,10
Tropical Depression,Eleven,2,2001-10-05T03:00:00Z,MYAK 241N 776W,0,0,0,8,8
Tropical Depression,Eleven,2,2001-10-05T03:00:00Z,TJPS 180N 666W,24,5,0,0,29
Tropical Depression,Eleven,2,2001-10-05T03:00:00Z,MYNN 251N 775W,0,0,0,5,5
Tropical Depression,Eleven,2,2001-10-05T03:00:00Z,MDSD 185N 697W,1,26,2,1,30
Tropical Depression,Eleven,2,2001-10-05T03:00:00Z,ST CROIX VI,16,1,0,0,17
Tropical Depression,Eleven,2,2001-10-05T03:00:00Z,MDCB 176N 714W,0,20,9,1,30
Tropical Depression,Eleven,2,2001-10-05T03:00:00Z,ST THOMAS VI,8,2,0,0,10
Tropical Depression,Eleven,2,2001-10-05T03:00:00Z,MTPP 186N 724W,0,6,19,2,27
Tropical Depression,Eleven,2,2001-10-05T03:00:00Z,SAN JUAN PR,15,5,0,0,20
Tropical Depression,Eleven,2,2001-10-05T03:00:00Z,MTCA 183N 738W,0,1,18,5,24
Tropical Depression,Eleven,2,2001-10-05T03:00:00Z,PONCE PR,24,5,0,0,29
Tropical Depression,Eleven,2,2001-10-05T03:00:00Z,MKJP 179N 768W,0,0,2,16,18
Tropical Depression,Eleven,2,2001-10-05T03:00:00Z,MARATHON FL,0,0,0,3,3
Tropical Depression,Eleven,2,2001-10-05T03:00:00Z,MKJS 185N 779W,0,0,0,16,16
Tropical Depression,Eleven,2,2001-10-05T03:00:00Z,MIAMI FL,0,0,0,2,2
Tropical Depression,Eleven,2,2001-10-05T03:00:00Z,MWCG 193N 814W,0,0,0,5,5
Tropical Depression,Eleven,2,2001-10-05T03:00:00Z,KEY WEST FL,0,0,0,2,2
Tropical Depression,Eleven,2,2001-10-05T03:00:00Z,MUGM 200N 751W,0,0,7,14,21
Tropical Depression,Eleven,3,2001-10-05T09:00:00Z,16.0N  68.2W,52,0,0,0,52
Tropical Depression,Eleven,3,2001-10-05T09:00:00Z,MUSN 216N 826W,0,0,0,5,5
Tropical Depression,Eleven,3,2001-10-05T09:00:00Z,16.9N  70.7W,7,31,0,0,38
Tropical Depression,Eleven,3,2001-10-05T09:00:00Z,MUHA 230N 824W,0,0,0,4,4
Tropical Depression,Eleven,3,2001-10-05T09:00:00Z,17.5N  73.2W,0,13,17,0,30
Tropical Depression,Eleven,3,2001-10-05T09:00:00Z,TJSJ 184N 661W,6,1,0,0,7
Tropical Depression,Eleven,3,2001-10-05T09:00:00Z,SKPG 125N 717W,0,1,1,2,4
Tropical Depression,Eleven,3,2001-10-05T09:00:00Z,MDPP 198N 707W,0,16,5,0,21
Tropical Depression,Eleven,3,2001-10-05T09:00:00Z,TISX 177N 648W,3,0,0,0,3
Tropical Depression,Eleven,3,2001-10-05T09:00:00Z,MBJT 215N 712W,0,2,5,2,9
Tropical Depression,Eleven,3,2001-10-05T09:00:00Z,TJPS 180N 666W,19,2,0,0,21
Tropical Depression,Eleven,3,2001-10-05T09:00:00Z,MYMM 224N 730W,0,0,4,5,9
Tropical Depression,Eleven,3,2001-10-05T09:00:00Z,MDSD 185N 697W,7,24,0,0,31
Tropical Depression,Eleven,3,2001-10-05T09:00:00Z,MYSM 241N 745W,0,0,0,4,4
Tropical Depression,Eleven,3,2001-10-05T09:00:00Z,MDCB 176N 714W,1,32,2,1,36
Tropical Depression,Eleven,3,2001-10-05T09:00:00Z,MYEG 235N 758W,0,0,0,9,9
Tropical Depression,Eleven,3,2001-10-05T09:00:00Z,MTPP 186N 724W,0,19,12,0,31
Tropical Depression,Eleven,3,2001-10-05T09:00:00Z,MYAK 241N 776W,0,0,0,8,8
Tropical Depression,Eleven,3,2001-10-05T09:00:00Z,MTCA 183N 738W,0,5,23,1,29
Tropical Depression,Eleven,3,2001-10-05T09:00:00Z,MYNN 251N 775W,0,0,0,4,4
Tropical Depression,Eleven,3,2001-10-05T09:00:00Z,MKJP 179N 768W,0,0,5,16,21
Tropical Depression,Eleven,3,2001-10-05T09:00:00Z,ST CROIX VI,3,0,0,0,3
Tropical Depression,Eleven,3,2001-10-05T09:00:00Z,MKJS 185N 779W,0,0,1,18,19
Tropical Depression,Eleven,3,2001-10-05T09:00:00Z,SAN JUAN PR,6,1,0,0,7
Tropical Depression,Eleven,3,2001-10-05T09:00:00Z,MWCG 193N 814W,0,0,0,9,9
Tropical Depression,Eleven,3,2001-10-05T09:00:00Z,PONCE PR,19,2,0,0,21
Tropical Depression,Eleven,3,2001-10-05T09:00:00Z,MUGM 200N 751W,0,0,15,8,23
Tropical Depression,Eleven,3,2001-10-05T09:00:00Z,MARATHON FL,0,0,0,4,4
Tropical Depression,Eleven,3,2001-10-05T09:00:00Z,MUCM 214N 779W,0,0,1,16,17
Tropical Depression,Eleven,3,2001-10-05T09:00:00Z,MIAMI FL,0,0,0,2,2
Tropical Depression,Eleven,3,2001-10-05T09:00:00Z,MUCF 221N 805W,0,0,0,11,11
Tropical Depression,Eleven,3,2001-10-05T09:00:00Z,KEY WEST FL,0,0,0,3,3
Tropical Depression,Eleven,4,2001-10-05T15:00:00Z,16.3N  70.0W,48,0,0,0,48
Tropical Depression,Eleven,4,2001-10-05T15:00:00Z,MUAN 219N 850W,0,0,0,3,3
Tropical Depression,Eleven,4,2001-10-05T15:00:00Z,17.0N  72.5W,7,27,0,0,34
Tropical Depression,Eleven,4,2001-10-05T15:00:00Z,MDPP 198N 707W,0,13,2,0,15
Tropical Depression,Eleven,4,2001-10-05T15:00:00Z,17.5N  75.0W,0,14,13,1,28
Tropical Depression,Eleven,4,2001-10-05T15:00:00Z,MBJT 215N 712W,0,2,3,0,5
Tropical Depression,Eleven,4,2001-10-05T15:00:00Z,TJPS 180N 666W,6,0,0,0,6
Tropical Depression,Eleven,4,2001-10-05T15:00:00Z,MYMM 224N 730W,0,0,4,2,6
Tropical Depression,Eleven,4,2001-10-05T15:00:00Z,MDSD 185N 697W,15,9,0,0,24
Tropical Depression,Eleven,4,2001-10-05T15:00:00Z,MYSM 241N 745W,0,0,0,4,4
Tropical Depression,Eleven,4,2001-10-05T15:00:00Z,MDCB 176N 714W,16,20,0,0,36
Tropical Depression,Eleven,4,2001-10-05T15:00:00Z,MYEG 235N 758W,0,0,1,7,8
Tropical Depression,Eleven,4,2001-10-05T15:00:00Z,MTPP 186N 724W,1,28,1,0,30
Tropical Depression,Eleven,4,2001-10-05T15:00:00Z,MYAK 241N 776W,0,0,0,8,8
Tropical Depression,Eleven,4,2001-10-05T15:00:00Z,MTCA 183N 738W,0,24,6,0,30
Tropical Depression,Eleven,4,2001-10-05T15:00:00Z,MYNN 251N 775W,0,0,0,4,4
Tropical Depression,Eleven,4,2001-10-05T15:00:00Z,MKJP 179N 768W,0,1,19,4,24
Tropical Depression,Eleven,4,2001-10-05T15:00:00Z,MYGF 266N 787W,0,0,0,2,2
Tropical Depression,Eleven,4,2001-10-05T15:00:00Z,MKJS 185N 779W,0,0,12,10,22
Tropical Depression,Eleven,4,2001-10-05T15:00:00Z,PONCE PR,6,0,0,0,6
Tropical Depression,Eleven,4,2001-10-05T15:00:00Z,MWCG 193N 814W,0,0,0,13,13
Tropical Depression,Eleven,4,2001-10-05T15:00:00Z,MARATHON FL,0,0,0,5,5
Tropical Depression,Eleven,4,2001-10-05T15:00:00Z,MUGM 200N 751W,0,2,19,2,23
Tropical Depression,Eleven,4,2001-10-05T15:00:00Z,MIAMI FL,0,0,0,3,3
Tropical Depression,Eleven,4,2001-10-05T15:00:00Z,MUCM 214N 779W,0,0,4,13,17
Tropical Depression,Eleven,4,2001-10-05T15:00:00Z,W PALM BEACH FL,0,0,0,2,2
Tropical Depression,Eleven,4,2001-10-05T15:00:00Z,MUCF 221N 805W,0,0,0,13,13
Tropical Depression,Eleven,4,2001-10-05T15:00:00Z,KEY WEST FL,0,0,0,5,5
Tropical Depression,Eleven,4,2001-10-05T15:00:00Z,MUSN 216N 826W,0,0,0,9,9
Tropical Depression,Eleven,4,2001-10-05T15:00:00Z,MARCO ISLAND FL,0,0,0,2,2
Tropical Depression,Eleven,4,2001-10-05T15:00:00Z,MUHA 230N 824W,0,0,0,7,7
Tropical Storm,Iris,5,2001-10-05T21:00:00Z,17.2N  72.0W,48,0,0,1,49
Tropical Storm,Iris,5,2001-10-05T21:00:00Z,MHNJ 165N 859W,0,0,0,3,3
Tropical Storm,Iris,5,2001-10-05T21:00:00Z,18.0N  75.0W,3,34,0,0,37
Tropical Storm,Iris,5,2001-10-05T21:00:00Z,MNPC 141N 834W,0,0,0,2,2
Tropical Storm,Iris,5,2001-10-05T21:00:00Z,18.5N  78.0W,0,8,20,1,29
Tropical Storm,Iris,5,2001-10-05T21:00:00Z,MDPP 198N 707W,9,5,0,0,14
Tropical Storm,Iris,5,2001-10-05T21:00:00Z,TJPS 180N 666W,5,0,0,0,5
Tropical Storm,Iris,5,2001-10-05T21:00:00Z,MBJT 215N 712W,0,2,0,0,2
Tropical Storm,Iris,5,2001-10-05T21:00:00Z,MDSD 185N 697W,38,0,0,0,38
Tropical Storm,Iris,5,2001-10-05T21:00:00Z,MYMM 224N 730W,0,1,1,1,3
Tropical Storm,Iris,5,2001-10-05T21:00:00Z,MDCB 176N 714W,52,0,0,0,52
Tropical Storm,Iris,5,2001-10-05T21:00:00Z,MYEG 235N 758W,0,0,3,2,5
Tropical Storm,Iris,5,2001-10-05T21:00:00Z,MTPP 186N 724W,31,9,0,0,40
Tropical Storm,Iris,5,2001-10-05T21:00:00Z,MYAK 241N 776W,0,0,2,5,7
Tropical Storm,Iris,5,2001-10-05T21:00:00Z,MTCA 183N 738W,15,25,0,0,40
Tropical Storm,Iris,5,2001-10-05T21:00:00Z,MYNN 251N 775W,0,0,0,4,4
Tropical Storm,Iris,5,2001-10-05T21:00:00Z,MKJP 179N 768W,0,22,9,0,31
Tropical Storm,Iris,5,2001-10-05T21:00:00Z,MYGF 266N 787W,0,0,0,2,2
Tropical Storm,Iris,5,2001-10-05T21:00:00Z,MKJS 185N 779W,0,9,20,0,29
Tropical Storm,Iris,5,2001-10-05T21:00:00Z,PONCE PR,5,0,0,0,5
Tropical Storm,Iris,5,2001-10-05T21:00:00Z,MWCG 193N 814W,0,0,8,13,21
Tropical Storm,Iris,5,2001-10-05T21:00:00Z,MARATHON FL,0,0,0,10,10
Tropical Storm,Iris,5,2001-10-05T21:00:00Z,MUGM 200N 751W,0,26,4,0,30
Tropical Storm,Iris,5,2001-10-05T21:00:00Z,MIAMI FL,0,0,0,5,5
Tropical Storm,Iris,5,2001-10-05T21:00:00Z,MUCM 214N 779W,0,1,19,2,22
Tropical Storm,Iris,5,2001-10-05T21:00:00Z,W PALM BEACH FL,0,0,0,3,3
Tropical Storm,Iris,5,2001-10-05T21:00:00Z,MUCF 221N 805W,0,0,6,13,19
Tropical Storm,Iris,5,2001-10-05T21:00:00Z,KEY WEST FL,0,0,0,11,11
Tropical Storm,Iris,5,2001-10-05T21:00:00Z,MUSN 216N 826W,0,0,1,16,17
Tropical Storm,Iris,5,2001-10-05T21:00:00Z,MARCO ISLAND FL,0,0,0,5,5
Tropical Storm,Iris,5,2001-10-05T21:00:00Z,MUHA 230N 824W,0,0,0,15,15
Tropical Storm,Iris,5,2001-10-05T21:00:00Z,FT MYERS FL,0,0,0,4,4
Tropical Storm,Iris,5,2001-10-05T21:00:00Z,MUAN 219N 850W,0,0,0,12,12
Tropical Storm,Iris,5,2001-10-05T21:00:00Z,VENICE FL,0,0,0,3,3
Tropical Storm,Iris,5,2001-10-05T21:00:00Z,MMCZ 205N 869W,0,0,0,6,6
Tropical Storm,Iris,6,2001-10-06T03:00:00Z,17.2N  74.0W,47,0,0,0,47
Tropical Storm,Iris,6,2001-10-06T03:00:00Z,MUAN 219N 850W,0,0,0,17,17
Tropical Storm,Iris,6,2001-10-06T03:00:00Z,18.1N  76.4W,4,28,1,0,33
Tropical Storm,Iris,6,2001-10-06T03:00:00Z,MMCZ 205N 869W,0,0,0,14,14
Tropical Storm,Iris,6,2001-10-06T03:00:00Z,19.0N  79.0W,0,9,17,1,27
Tropical Storm,Iris,6,2001-10-06T03:00:00Z,MZBZ 175N 883W,0,0,0,5,5
Tropical Storm,Iris,6,2001-10-06T03:00:00Z,MDSD 185N 697W,5,0,0,0,5
Tropical Storm,Iris,6,2001-10-06T03:00:00Z,MHNJ 165N 859W,0,0,0,8,8
Tropical Storm,Iris,6,2001-10-06T03:00:00Z,MDCB 176N 714W,57,1,0,0,58
Tropical Storm,Iris,6,2001-10-06T03:00:00Z,MNPC 141N 834W,0,0,0,3,3
Tropical Storm,Iris,6,2001-10-06T03:00:00Z,MTPP 186N 724W,36,0,0,0,36
Tropical Storm,Iris,6,2001-10-06T03:00:00Z,MYEG 235N 758W,0,0,3,1,4
Tropical Storm,Iris,6,2001-10-06T03:00:00Z,MTCA 183N 738W,41,1,0,0,42
Tropical Storm,Iris,6,2001-10-06T03:00:00Z,MYAK 241N 776W,0,0,3,2,5
Tropical Storm,Iris,6,2001-10-06T03:00:00Z,MKJP 179N 768W,2,28,1,0,31
Tropical Storm,Iris,6,2001-10-06T03:00:00Z,MYNN 251N 775W,0,0,1,1,2
Tropical Storm,Iris,6,2001-10-06T03:00:00Z,MKJS 185N 779W,0,22,7,0,29
Tropical Storm,Iris,6,2001-10-06T03:00:00Z,MMMD 210N 897W,0,0,0,5,5
Tropical Storm,Iris,6,2001-10-06T03:00:00Z,MWCG 193N 814W,0,0,14,8,22
Tropical Storm,Iris,6,2001-10-06T03:00:00Z,MARATHON FL,0,0,1,7,8
Tropical Storm,Iris,6,2001-10-06T03:00:00Z,MUGM 200N 751W,3,22,0,0,25
Tropical Storm,Iris,6,2001-10-06T03:00:00Z,MIAMI FL,0,0,0,3,3
Tropical Storm,Iris,6,2001-10-06T03:00:00Z,MUCM 214N 779W,0,4,17,0,21
Tropical Storm,Iris,6,2001-10-06T03:00:00Z,KEY WEST FL,0,0,1,9,10
Tropical Storm,Iris,6,2001-10-06T03:00:00Z,MUCF 221N 805W,0,0,11,8,19
Tropical Storm,Iris,6,2001-10-06T03:00:00Z,MARCO ISLAND FL,0,0,0,4,4
Tropical Storm,Iris,6,2001-10-06T03:00:00Z,MUSN 216N 826W,0,0,4,16,20
Tropical Storm,Iris,6,2001-10-06T03:00:00Z,FT MYERS FL,0,0,0,3,3
Tropical Storm,Iris,6,2001-10-06T03:00:00Z,MUHA 230N 824W,0,0,2,14,16
Tropical Storm,Iris,6,2001-10-06T03:00:00Z,VENICE FL,0,0,0,2,2
Tropical Storm,Iris,7,2001-10-06T09:00:00Z,17.8N  75.0W,48,0,0,0,48
Tropical Storm,Iris,7,2001-10-06T09:00:00Z,MUAN 219N 850W,0,0,1,18,19
Tropical Storm,Iris,7,2001-10-06T09:00:00Z,18.6N  77.5W,6,28,0,0,34
Tropical Storm,Iris,7,2001-10-06T09:00:00Z,MMCZ 205N 869W,0,0,0,16,16
Tropical Storm,Iris,7,2001-10-06T09:00:00Z,19.0N  80.0W,0,14,12,1,27
Tropical Storm,Iris,7,2001-10-06T09:00:00Z,MZBZ 175N 883W,0,0,0,7,7
Tropical Storm,Iris,7,2001-10-06T09:00:00Z,MDSD 185N 697W,4,0,0,0,4
Tropical Storm,Iris,7,2001-10-06T09:00:00Z,MGPB 157N 886W,0,0,0,2,2
Tropical Storm,Iris,7,2001-10-06T09:00:00Z,MDCB 176N 714W,70,0,0,0,70
Tropical Storm,Iris,7,2001-10-06T09:00:00Z,MHNJ 165N 859W,0,0,0,10,10
Tropical Storm,Iris,7,2001-10-06T09:00:00Z,MTPP 186N 724W,45,0,0,0,45
Tropical Storm,Iris,7,2001-10-06T09:00:00Z,MNPC 141N 834W,0,0,0,3,3
Tropical Storm,Iris,7,2001-10-06T09:00:00Z,MTCA 183N 738W,54,0,0,0,54
Tropical Storm,Iris,7,2001-10-06T09:00:00Z,MYEG 235N 758W,0,1,1,0,2
Tropical Storm,Iris,7,2001-10-06T09:00:00Z,MKJP 179N 768W,22,13,0,0,35
Tropical Storm,Iris,7,2001-10-06T09:00:00Z,MYAK 241N 776W,0,0,3,1,4
Tropical Storm,Iris,7,2001-10-06T09:00:00Z,MKJS 185N 779W,3,29,0,0,32
Tropical Storm,Iris,7,2001-10-06T09:00:00Z,MMMD 210N 897W,0,0,0,8,8
Tropical Storm,Iris,7,2001-10-06T09:00:00Z,MWCG 193N 814W,0,2,20,3,25
Tropical Storm,Iris,7,2001-10-06T09:00:00Z,MARATHON FL,0,0,1,7,8
Tropical Storm,Iris,7,2001-10-06T09:00:00Z,MUGM 200N 751W,19,10,0,0,29
Tropical Storm,Iris,7,2001-10-06T09:00:00Z,MIAMI FL,0,0,0,2,2
Tropical Storm,Iris,7,2001-10-06T09:00:00Z,MUCM 214N 779W,0,15,7,0,22
Tropical Storm,Iris,7,2001-10-06T09:00:00Z,KEY WEST FL,0,0,1,8,9
Tropical Storm,Iris,7,2001-10-06T09:00:00Z,MUCF 221N 805W,0,1,16,3,20
Tropical Storm,Iris,7,2001-10-06T09:00:00Z,MARCO ISLAND FL,0,0,0,3,3
Tropical Storm,Iris,7,2001-10-06T09:00:00Z,MUSN 216N 826W,0,0,11,10,21
Tropical Storm,Iris,7,2001-10-06T09:00:00Z,FT MYERS FL,0,0,0,2,2
Tropical Storm,Iris,7,2001-10-06T09:00:00Z,MUHA 230N 824W,0,0,5,12,17
Tropical Storm,Iris,8,2001-10-06T15:00:00Z,18.5N  76.5W,47,0,0,1,48
Tropical Storm,Iris,8,2001-10-06T15:00:00Z,MUAN 219N 850W,0,0,7,13,20
Tropical Storm,Iris,8,2001-10-06T15:00:00Z,19.0N  79.5W,3,31,0,1,35
Tropical Storm,Iris,8,2001-10-06T15:00:00Z,MMCZ 205N 869W,0,0,2,15,17
Tropical Storm,Iris,8,2001-10-06T15:00:00Z,19.5N  82.0W,0,12,14,1,27
Tropical Storm,Iris,8,2001-10-06T15:00:00Z,MZBZ 175N 883W,0,0,0,8,8
Tropical Storm,Iris,8,2001-10-06T15:00:00Z,MDCB 176N 714W,99,0,0,0,99
Tropical Storm,Iris,8,2001-10-06T15:00:00Z,MGPB 157N 886W,0,0,0,3,3
Tropical Storm,Iris,8,2001-10-06T15:00:00Z,MTPP 186N 724W,50,0,0,0,50
Tropical Storm,Iris,8,2001-10-06T15:00:00Z,MHNJ 165N 859W,0,0,1,8,9
Tropical Storm,Iris,8,2001-10-06T15:00:00Z,MTCA 183N 738W,69,0,0,0,69
Tropical Storm,Iris,8,2001-10-06T15:00:00Z,MNPC 141N 834W,0,0,0,2,2
Tropical Storm,Iris,8,2001-10-06T15:00:00Z,MKJP 179N 768W,40,1,0,0,41
Tropical Storm,Iris,8,2001-10-06T15:00:00Z,MYAK 241N 776W,0,0,1,1,2
Tropical Storm,Iris,8,2001-10-06T15:00:00Z,MKJS 185N 779W,29,10,0,0,39
Tropical Storm,Iris,8,2001-10-06T15:00:00Z,MMMD 210N 897W,0,0,0,10,10
Tropical Storm,Iris,8,2001-10-06T15:00:00Z,MWCG 193N 814W,0,20,8,0,28
Tropical Storm,Iris,8,2001-10-06T15:00:00Z,MARATHON FL,0,0,2,4,6
Tropical Storm,Iris,8,2001-10-06T15:00:00Z,MUGM 200N 751W,32,1,0,0,33
Tropical Storm,Iris,8,2001-10-06T15:00:00Z,KEY WEST FL,0,0,2,6,8
Tropical Storm,Iris,8,2001-10-06T15:00:00Z,MUCM 214N 779W,1,20,0,1,22
Tropical Storm,Iris,8,2001-10-06T15:00:00Z,MARCO ISLAND FL,0,0,0,3,3
Tropical Storm,Iris,8,2001-10-06T15:00:00Z,MUCF 221N 805W,0,6,12,1,19
Tropical Storm,Iris,8,2001-10-06T15:00:00Z,FT MYERS FL,0,0,0,2,2
Tropical Storm,Iris,8,2001-10-06T15:00:00Z,MUSN 216N 826W,0,1,18,4,23
Tropical Storm,Iris,8,2001-10-06T15:00:00Z,GULF 28N 89W,0,0,0,2,2
Tropical Storm,Iris,8,2001-10-06T15:00:00Z,MUHA 230N 824W,0,0,11,5,16
Hurricane,Iris,9,2001-10-06T21:00:00Z,18.5N  78.0W,47,1,0,0,48
Hurricane,Iris,9,2001-10-06T21:00:00Z,MUSN 216N 826W,0,14,11,0,25
Hurricane,Iris,9,2001-10-06T21:00:00Z,19.5N  81.0W,2,34,0,0,36
Hurricane,Iris,9,2001-10-06T21:00:00Z,MUHA 230N 824W,0,3,11,2,16
Hurricane,Iris,9,2001-10-06T21:00:00Z,19.5N  83.5W,0,14,12,0,26
Hurricane,Iris,9,2001-10-06T21:00:00Z,MUAN 219N 850W,0,1,16,4,21
Hurricane,Iris,9,2001-10-06T21:00:00Z,MDCB 176N 714W,99,0,0,0,99
Hurricane,Iris,9,2001-10-06T21:00:00Z,MMCZ 205N 869W,0,0,10,11,21
Hurricane,Iris,9,2001-10-06T21:00:00Z,MTPP 186N 724W,22,0,0,0,22
Hurricane,Iris,9,2001-10-06T21:00:00Z,MZBZ 175N 883W,0,0,1,11,12
Hurricane,Iris,9,2001-10-06T21:00:00Z,MTCA 183N 738W,70,0,0,0,70
Hurricane,Iris,9,2001-10-06T21:00:00Z,MGPB 157N 886W,0,0,0,5,5
Hurricane,Iris,9,2001-10-06T21:00:00Z,MKJP 179N 768W,55,0,0,0,55
Hurricane,Iris,9,2001-10-06T21:00:00Z,MHNJ 165N 859W,0,0,2,8,10
Hurricane,Iris,9,2001-10-06T21:00:00Z,MKJS 185N 779W,48,1,0,0,49
Hurricane,Iris,9,2001-10-06T21:00:00Z,MNPC 141N 834W,0,0,0,2,2
Hurricane,Iris,9,2001-10-06T21:00:00Z,MWCG 193N 814W,1,32,0,0,33
Hurricane,Iris,9,2001-10-06T21:00:00Z,MMFR 185N 926W,0,0,0,4,4
Hurricane,Iris,9,2001-10-06T21:00:00Z,MUGM 200N 751W,20,0,0,0,20
Hurricane,Iris,9,2001-10-06T21:00:00Z,MMMD 210N 897W,0,0,0,14,14
Hurricane,Iris,9,2001-10-06T21:00:00Z,MUCM 214N 779W,7,13,0,0,20
Hurricane,Iris,9,2001-10-06T21:00:00Z,MARATHON FL,0,0,2,1,3
Hurricane,Iris,9,2001-10-06T21:00:00Z,MUCF 221N 805W,0,17,4,0,21
Hurricane,Iris,9,2001-10-06T21:00:00Z,KEY WEST FL,0,0,3,2,5
Hurricane,Iris,10,2001-10-07T03:00:00Z,18.8N  79.5W,47,0,0,0,47
Hurricane,Iris,10,2001-10-07T03:00:00Z,MUSN 216N 826W,0,20,4,0,24
Hurricane,Iris,10,2001-10-07T03:00:00Z,19.1N  82.1W,8,26,0,0,34
Hurricane,Iris,10,2001-10-07T03:00:00Z,MUHA 230N 824W,0,5,7,0,12
Hurricane,Iris,10,2001-10-07T03:00:00Z,19.0N  84.6W,0,14,12,1,27
Hurricane,Iris,10,2001-10-07T03:00:00Z,MUAN 219N 850W,0,3,16,2,21
Hurricane,Iris,10,2001-10-07T03:00:00Z,MTCA 183N 738W,40,0,0,0,40
Hurricane,Iris,10,2001-10-07T03:00:00Z,MMCZ 205N 869W,0,0,17,6,23
Hurricane,Iris,10,2001-10-07T03:00:00Z,MKJP 179N 768W,73,0,0,0,73
Hurricane,Iris,10,2001-10-07T03:00:00Z,MZBZ 175N 883W,0,0,4,12,16
Hurricane,Iris,10,2001-10-07T03:00:00Z,MKJS 185N 779W,61,0,0,0,61
Hurricane,Iris,10,2001-10-07T03:00:00Z,MGPB 157N 886W,0,0,0,9,9
Hurricane,Iris,10,2001-10-07T03:00:00Z,MWCG 193N 814W,19,18,0,0,37
Hurricane,Iris,10,2001-10-07T03:00:00Z,MHNJ 165N 859W,0,0,7,7,14
Hurricane,Iris,10,2001-10-07T03:00:00Z,MUGM 200N 751W,3,0,0,0,3
Hurricane,Iris,10,2001-10-07T03:00:00Z,MMFR 185N 926W,0,0,0,8,8
Hurricane,Iris,10,2001-10-07T03:00:00Z,MUCM 214N 779W,10,3,0,0,13
Hurricane,Iris,10,2001-10-07T03:00:00Z,MMMD 210N 897W,0,0,1,16,17
Hurricane,Iris,10,2001-10-07T03:00:00Z,MUCF 221N 805W,1,15,0,1,17
Hurricane,Iris,10,2001-10-07T03:00:00Z,KEY WEST FL,0,0,2,0,2
Hurricane,Iris,11,2001-10-07T09:00:00Z,18.3N  80.7W,47,0,0,0,47
Hurricane,Iris,11,2001-10-07T09:00:00Z,MUHA 230N 824W,0,2,3,0,5
Hurricane,Iris,11,2001-10-07T09:00:00Z,18.5N  83.5W,6,28,0,0,34
Hurricane,Iris,11,2001-10-07T09:00:00Z,MUAN 219N 850W,0,5,11,2,18
Hurricane,Iris,11,2001-10-07T09:00:00Z,18.5N  86.0W,0,14,12,1,27
Hurricane,Iris,11,2001-10-07T09:00:00Z,MMCZ 205N 869W,0,3,19,2,24
Hurricane,Iris,11,2001-10-07T09:00:00Z,MKJP 179N 768W,89,0,0,0,89
Hurricane,Iris,11,2001-10-07T09:00:00Z,MZBZ 175N 883W,0,0,13,6,19
Hurricane,Iris,11,2001-10-07T09:00:00Z,MKJS 185N 779W,68,0,0,0,68
Hurricane,Iris,11,2001-10-07T09:00:00Z,MGPB 157N 886W,0,0,3,9,12
Hurricane,Iris,11,2001-10-07T09:00:00Z,MWCG 193N 814W,36,5,0,0,41
Hurricane,Iris,11,2001-10-07T09:00:00Z,MHNJ 165N 859W,0,5,9,3,17
Hurricane,Iris,11,2001-10-07T09:00:00Z,MUCM 214N 779W,1,1,0,0,2
Hurricane,Iris,11,2001-10-07T09:00:00Z,MMVR 192N 961W,0,0,0,3,3
Hurricane,Iris,11,2001-10-07T09:00:00Z,MUCF 221N 805W,1,4,1,0,6
Hurricane,Iris,11,2001-10-07T09:00:00Z,MMFR 185N 926W,0,0,0,12,12
Hurricane,Iris,11,2001-10-07T09:00:00Z,MUSN 216N 826W,0,15,2,0,17
Hurricane,Iris,11,2001-10-07T09:00:00Z,MMMD 210N 897W,0,0,5,14,19
Hurricane,Iris,12,2001-10-07T15:00:00Z,18.5N  83.0W,46,1,0,0,47
Hurricane,Iris,12,2001-10-07T15:00:00Z,MGPB 157N 886W,0,1,8,3,12
Hurricane,Iris,12,2001-10-07T15:00:00Z,18.5N  86.0W,2,32,0,0,34
Hurricane,Iris,12,2001-10-07T15:00:00Z,MHNJ 165N 859W,1,13,3,0,17
Hurricane,Iris,12,2001-10-07T15:00:00Z,18.5N  89.0W,0,6,20,1,27
Hurricane,Iris,12,2001-10-07T15:00:00Z,MMSO 238N 982W,0,0,0,3,3
Hurricane,Iris,12,2001-10-07T15:00:00Z,MKJP 179N 768W,99,0,0,0,99
Hurricane,Iris,12,2001-10-07T15:00:00Z,MMTM 222N 979W,0,0,0,5,5
Hurricane,Iris,12,2001-10-07T15:00:00Z,MKJS 185N 779W,76,0,0,0,76
Hurricane,Iris,12,2001-10-07T15:00:00Z,MMTX 210N 974W,0,0,0,7,7
Hurricane,Iris,12,2001-10-07T15:00:00Z,MWCG 193N 814W,53,0,0,0,53
Hurricane,Iris,12,2001-10-07T15:00:00Z,MMVR 192N 961W,0,0,0,10,10
Hurricane,Iris,12,2001-10-07T15:00:00Z,MUSN 216N 826W,6,8,0,0,14
Hurricane,Iris,12,2001-10-07T15:00:00Z,MMFR 185N 926W,0,0,6,13,19
Hurricane,Iris,12,2001-10-07T15:00:00Z,MUAN 219N 850W,0,12,3,0,15
Hurricane,Iris,12,2001-10-07T15:00:00Z,MMMD 210N 897W,0,1,18,3,22
Hurricane,Iris,12,2001-10-07T15:00:00Z,MMCZ 205N 869W,0,20,8,0,28
Hurricane,Iris,12,2001-10-07T15:00:00Z,BROWNSVILLE TX,0,0,0,2,2
Hurricane,Iris,12,2001-10-07T15:00:00Z,MZBZ 175N 883W,0,10,14,1,25
Hurricane,Iris,12,2001-10-07T15:00:00Z,GULF 25N 96W,0,0,0,5,5
Hurricane,Iris,13,2001-10-07T21:00:00Z,18.0N  85.5W,49,0,0,0,49
Hurricane,Iris,13,2001-10-07T21:00:00Z,MHNJ 165N 859W,23,3,1,0,27
Hurricane,Iris,13,2001-10-07T21:00:00Z,18.0N  88.5W,2,32,1,0,35
Hurricane,Iris,13,2001-10-07T21:00:00Z,MMSO 238N 982W,0,0,0,7,7
Hurricane,Iris,13,2001-10-07T21:00:00Z,18.0N  91.5W,0,6,21,1,28
Hurricane,Iris,13,2001-10-07T21:00:00Z,MMTM 222N 979W,0,0,0,12,12
Hurricane,Iris,13,2001-10-07T21:00:00Z,MKJS 185N 779W,15,0,0,0,15
Hurricane,Iris,13,2001-10-07T21:00:00Z,MMTX 210N 974W,0,0,0,15,15
Hurricane,Iris,13,2001-10-07T21:00:00Z,MWCG 193N 814W,38,0,0,0,38
Hurricane,Iris,13,2001-10-07T21:00:00Z,MMVR 192N 961W,0,0,2,17,19
Hurricane,Iris,13,2001-10-07T21:00:00Z,MUAN 219N 850W,2,3,0,0,5
Hurricane,Iris,13,2001-10-07T21:00:00Z,MMFR 185N 926W,0,1,23,2,26
Hurricane,Iris,13,2001-10-07T21:00:00Z,MMCZ 205N 869W,5,22,0,0,27
Hurricane,Iris,13,2001-10-07T21:00:00Z,MMMD 210N 897W,0,13,10,0,23
Hurricane,Iris,13,2001-10-07T21:00:00Z,MZBZ 175N 883W,3,29,1,0,33
Hurricane,Iris,13,2001-10-07T21:00:00Z,BROWNSVILLE TX,0,0,0,2,2
Hurricane,Iris,13,2001-10-07T21:00:00Z,MGPB 157N 886W,0,13,3,0,16
Hurricane,Iris,13,2001-10-07T21:00:00Z,GULF 25N 96W,0,0,0,4,4
Hurricane,Iris,14,2001-10-08T03:00:00Z,17.4N  86.7W,44,1,0,0,45
Hurricane,Iris,14,2001-10-08T03:00:00Z,MMSO 238N 982W,0,0,0,5,5
Hurricane,Iris,14,2001-10-08T03:00:00Z,17.3N  89.8W,2,30,1,0,33
Hurricane,Iris,14,2001-10-08T03:00:00Z,MMTM 222N 979W,0,0,0,10,10
Hurricane,Iris,14,2001-10-08T03:00:00Z,17.2N  93.0W,0,5,20,1,26
Hurricane,Iris,14,2001-10-08T03:00:00Z,MMTX 210N 974W,0,0,1,13,14
Hurricane,Iris,14,2001-10-08T03:00:00Z,MWCG 193N 814W,12,0,0,0,12
Hurricane,Iris,14,2001-10-08T03:00:00Z,MMVR 192N 961W,0,0,9,11,20
Hurricane,Iris,14,2001-10-08T03:00:00Z,MMCZ 205N 869W,6,10,0,0,16
Hurricane,Iris,14,2001-10-08T03:00:00Z,MMFR 185N 926W,0,8,20,1,29
Hurricane,Iris,14,2001-10-08T03:00:00Z,MZBZ 175N 883W,23,15,0,1,39
Hurricane,Iris,14,2001-10-08T03:00:00Z,MMMD 210N 897W,0,10,5,0,15
Hurricane,Iris,14,2001-10-08T03:00:00Z,MGPB 157N 886W,6,14,0,0,20
Hurricane,Iris,14,2001-10-08T03:00:00Z,GULF 25N 96W,0,0,0,2,2
Hurricane,Iris,14,2001-10-08T03:00:00Z,MHNJ 165N 859W,35,0,0,0,35
Hurricane,Iris,15,2001-10-08T09:00:00Z,16.8N  88.5W,47,0,0,0,47
Hurricane,Iris,15,2001-10-08T09:00:00Z,MMSO 238N 982W,0,0,0,3,3
Hurricane,Iris,15,2001-10-08T09:00:00Z,16.6N  91.5W,1,30,1,0,32
Hurricane,Iris,15,2001-10-08T09:00:00Z,MMTM 222N 979W,0,0,0,6,6
Hurricane,Iris,15,2001-10-08T09:00:00Z,16.5N  94.5W,0,9,15,1,25
Hurricane,Iris,15,2001-10-08T09:00:00Z,MMTX 210N 974W,0,0,1,9,10
Hurricane,Iris,15,2001-10-08T09:00:00Z,MMCZ 205N 869W,1,0,0,1,2
Hurricane,Iris,15,2001-10-08T09:00:00Z,MMVR 192N 961W,0,0,10,6,16
Hurricane,Iris,15,2001-10-08T09:00:00Z,MZBZ 175N 883W,46,0,0,0,46
Hurricane,Iris,15,2001-10-08T09:00:00Z,MMFR 185N 926W,0,13,9,0,22
Hurricane,Iris,15,2001-10-08T09:00:00Z,MGPB 157N 886W,34,1,0,0,35
Hurricane,Iris,15,2001-10-08T09:00:00Z,MMMD 210N 897W,0,1,1,1,3
Hurricane,Iris,15,2001-10-08T09:00:00Z,MHNJ 165N 859W,67,0,1,0,68
Hurricane,Iris,16,2001-10-08T15:00:00Z,15.9N  90.9W,47,1,0,0,48
Hurricane,Iris,16,2001-10-08T15:00:00Z,MHNJ 165N 859W,99,0,0,0,99
Hurricane,Iris,16,2001-10-08T15:00:00Z,15.5N  94.0W,1,30,1,0,32
Hurricane,Iris,16,2001-10-08T15:00:00Z,MMTM 222N 979W,0,0,0,4,4
Hurricane,Iris,16,2001-10-08T15:00:00Z,15.5N  96.5W,0,13,10,1,24
Hurricane,Iris,16,2001-10-08T15:00:00Z,MMTX 210N 974W,0,0,1,5,6
Hurricane,Iris,16,2001-10-08T15:00:00Z,MZBZ 175N 883W,62,0,0,0,62
Hurricane,Iris,16,2001-10-08T15:00:00Z,MMVR 192N 961W,0,1,7,4,12
Hurricane,Iris,16,2001-10-08T15:00:00Z,MGPB 157N 886W,57,0,0,0,57
Hurricane,Iris,16,2001-10-08T15:00:00Z,MMFR 185N 926W,0,12,2,0,14
Hurricane,Iris,17,2001-10-08T21:00:00Z,15.7N  92.9W,46,0,0,0,46
Hurricane,Iris,17,2001-10-08T21:00:00Z,MHNJ 165N 859W,99,0,0,0,99
Hurricane,Iris,17,2001-10-08T21:00:00Z,MZBZ 175N 883W,74,0,0,0,74
Hurricane,Iris,17,2001-10-08T21:00:00Z,MMFR 185N 926W,7,0,0,0,7
Hurricane,Iris,17,2001-10-08T21:00:00Z,MGPB 157N 886W,73,0,0,0,73
Hurricane,Iris,18,2001-10-09T03:00:00Z,15.9N  95.9W,47,0,0,0,47
Hurricane,Iris,18,2001-10-09T03:00:00Z,MGPB 157N 886W,99,0,0,0,99
Hurricane,Iris,18,2001-10-09T03:00:00Z,MZBZ 175N 883W,99,0,0,0,99
Hurricane,Iris,18,2001-10-09T03:00:00Z,MMFR 185N 926W,6,0,0,0,6
Tropical Depression,Twelve,1,2001-10-06T15:00:00Z,12.5N  55.5W,53,0,0,0,53
Tropical Depression,Twelve,1,2001-10-06T15:00:00Z,TFFR 163N 615W,0,2,16,5,23
Tropical Depression,Twelve,1,2001-10-06T15:00:00Z,13.5N  58.5W,1,37,0,0,38
Tropical Depression,Twelve,1,2001-10-06T15:00:00Z,TAPA 171N 618W,0,0,13,7,20
Tropical Depression,Twelve,1,2001-10-06T15:00:00Z,14.0N  60.5W,0,16,11,1,28
Tropical Depression,Twelve,1,2001-10-06T15:00:00Z,TKPK 173N 627W,0,0,8,11,19
Tropical Depression,Twelve,1,2001-10-06T15:00:00Z,SVMG 110N 640W,0,0,1,6,7
Tropical Depression,Twelve,1,2001-10-06T15:00:00Z,TNCM 181N 631W,0,0,4,12,16
Tropical Depression,Twelve,1,2001-10-06T15:00:00Z,TTPP 106N 614W,0,1,6,4,11
Tropical Depression,Twelve,1,2001-10-06T15:00:00Z,TISX 177N 648W,0,0,1,14,15
Tropical Depression,Twelve,1,2001-10-06T15:00:00Z,TTPT 112N 608W,0,4,8,4,16
Tropical Depression,Twelve,1,2001-10-06T15:00:00Z,TIST 183N 650W,0,0,0,13,13
Tropical Depression,Twelve,1,2001-10-06T15:00:00Z,TGPY 120N 618W,0,2,11,5,18
Tropical Depression,Twelve,1,2001-10-06T15:00:00Z,TJPS 180N 666W,0,0,0,9,9
Tropical Depression,Twelve,1,2001-10-06T15:00:00Z,TBPB 131N 595W,0,27,3,1,31
Tropical Depression,Twelve,1,2001-10-06T15:00:00Z,TJSJ 184N 661W,0,0,0,10,10
Tropical Depression,Twelve,1,2001-10-06T15:00:00Z,TVSV 131N 612W,0,7,14,3,24
Tropical Depression,Twelve,1,2001-10-06T15:00:00Z,ST CROIX VI,0,0,1,14,15
Tropical Depression,Twelve,1,2001-10-06T15:00:00Z,TLPL 138N 610W,0,10,14,2,26
Tropical Depression,Twelve,1,2001-10-06T15:00:00Z,ST THOMAS VI,0,0,0,13,13
Tropical Depression,Twelve,1,2001-10-06T15:00:00Z,TFFF 146N 610W,0,9,16,2,27
Tropical Depression,Twelve,1,2001-10-06T15:00:00Z,SAN JUAN PR,0,0,0,10,10
Tropical Depression,Twelve,1,2001-10-06T15:00:00Z,TDPR 153N 614W,0,4,18,3,25
Tropical Depression,Twelve,1,2001-10-06T15:00:00Z,PONCE PR,0,0,0,9,9
Tropical Depression,Twelve,2,2001-10-06T21:00:00Z,11.8N  56.5W,47,0,0,0,47
Tropical Depression,Twelve,2,2001-10-06T21:00:00Z,TFFR 163N 615W,0,2,17,2,21
Tropical Depression,Twelve,2,2001-10-06T21:00:00Z,12.5N  59.0W,2,31,0,0,33
Tropical Depression,Twelve,2,2001-10-06T21:00:00Z,TAPA 171N 618W,0,0,13,5,18
Tropical Depression,Twelve,2,2001-10-06T21:00:00Z,13.5N  61.5W,0,7,19,2,28
Tropical Depression,Twelve,2,2001-10-06T21:00:00Z,TKPK 173N 627W,0,0,10,7,17
Tropical Depression,Twelve,2,2001-10-06T21:00:00Z,TNCC 122N 690W,0,0,0,2,2
Tropical Depression,Twelve,2,2001-10-06T21:00:00Z,TNCM 181N 631W,0,0,5,9,14
Tropical Depression,Twelve,2,2001-10-06T21:00:00Z,SVMG 110N 640W,0,0,4,8,12
Tropical Depression,Twelve,2,2001-10-06T21:00:00Z,TISX 177N 648W,0,0,2,13,15
Tropical Depression,Twelve,2,2001-10-06T21:00:00Z,TTPP 106N 614W,0,4,11,2,17
Tropical Depression,Twelve,2,2001-10-06T21:00:00Z,TIST 183N 650W,0,0,1,12,13
Tropical Depression,Twelve,2,2001-10-06T21:00:00Z,TTPT 112N 608W,0,12,9,1,22
Tropical Depression,Twelve,2,2001-10-06T21:00:00Z,TJPS 180N 666W,0,0,0,11,11
Tropical Depression,Twelve,2,2001-10-06T21:00:00Z,TGPY 120N 618W,0,4,17,1,22
Tropical Depression,Twelve,2,2001-10-06T21:00:00Z,MDSD 185N 697W,0,0,0,3,3
Tropical Depression,Twelve,2,2001-10-06T21:00:00Z,TBPB 131N 595W,0,30,2,0,32
Tropical Depression,Twelve,2,2001-10-06T21:00:00Z,TJSJ 184N 661W,0,0,0,11,11
Tropical Depression,Twelve,2,2001-10-06T21:00:00Z,TVSV 131N 612W,0,11,16,1,28
Tropical Depression,Twelve,2,2001-10-06T21:00:00Z,ST CROIX VI,0,0,2,13,15
Tropical Depression,Twelve,2,2001-10-06T21:00:00Z,TLPL 138N 610W,0,12,17,0,29
Tropical Depression,Twelve,2,2001-10-06T21:00:00Z,ST THOMAS VI,0,0,1,12,13
Tropical Depression,Twelve,2,2001-10-06T21:00:00Z,TFFF 146N 610W,0,9,18,1,28
Tropical Depression,Twelve,2,2001-10-06T21:00:00Z,SAN JUAN PR,0,0,0,11,11
Tropical Depression,Twelve,2,2001-10-06T21:00:00Z,TDPR 153N 614W,0,4,20,1,25
Tropical Depression,Twelve,2,2001-10-06T21:00:00Z,PONCE PR,0,0,0,11,11
Tropical Storm,Jerry,3,2001-10-07T03:00:00Z,12.2N  58.5W,48,0,0,0,48
Tropical Storm,Jerry,3,2001-10-07T03:00:00Z,TKPK 173N 627W,0,2,10,4,16
Tropical Storm,Jerry,3,2001-10-07T03:00:00Z,12.8N  60.7W,10,23,0,1,34
Tropical Storm,Jerry,3,2001-10-07T03:00:00Z,TNCM 181N 631W,0,0,7,6,13
Tropical Storm,Jerry,3,2001-10-07T03:00:00Z,13.5N  62.8W,0,16,10,1,27
Tropical Storm,Jerry,3,2001-10-07T03:00:00Z,TISX 177N 648W,0,0,6,10,16
Tropical Storm,Jerry,3,2001-10-07T03:00:00Z,TNCC 122N 690W,0,0,0,7,7
Tropical Storm,Jerry,3,2001-10-07T03:00:00Z,TIST 183N 650W,0,0,3,11,14
Tropical Storm,Jerry,3,2001-10-07T03:00:00Z,SVMG 110N 640W,0,2,9,4,15
Tropical Storm,Jerry,3,2001-10-07T03:00:00Z,TJPS 180N 666W,0,0,1,14,15
Tropical Storm,Jerry,3,2001-10-07T03:00:00Z,TTPP 106N 614W,1,15,2,0,18
Tropical Storm,Jerry,3,2001-10-07T03:00:00Z,MDSD 185N 697W,0,0,0,10,10
Tropical Storm,Jerry,3,2001-10-07T03:00:00Z,TTPT 112N 608W,7,17,1,0,25
Tropical Storm,Jerry,3,2001-10-07T03:00:00Z,MDCB 176N 714W,0,0,0,7,7
Tropical Storm,Jerry,3,2001-10-07T03:00:00Z,TGPY 120N 618W,1,22,2,1,26
Tropical Storm,Jerry,3,2001-10-07T03:00:00Z,MTPP 186N 724W,0,0,0,3,3
Tropical Storm,Jerry,3,2001-10-07T03:00:00Z,TBPB 131N 595W,35,5,0,0,40
Tropical Storm,Jerry,3,2001-10-07T03:00:00Z,TJSJ 184N 661W,0,0,1,13,14
Tropical Storm,Jerry,3,2001-10-07T03:00:00Z,TVSV 131N 612W,4,27,1,0,32
Tropical Storm,Jerry,3,2001-10-07T03:00:00Z,MDPP 198N 707W,0,0,0,6,6
Tropical Storm,Jerry,3,2001-10-07T03:00:00Z,TLPL 138N 610W,4,27,1,0,32
Tropical Storm,Jerry,3,2001-10-07T03:00:00Z,MBJT 215N 712W,0,0,0,2,2
Tropical Storm,Jerry,3,2001-10-07T03:00:00Z,TFFF 146N 610W,2,25,2,0,29
Tropical Storm,Jerry,3,2001-10-07T03:00:00Z,ST CROIX VI,0,0,6,10,16
Tropical Storm,Jerry,3,2001-10-07T03:00:00Z,TDPR 153N 614W,0,20,4,1,25
Tropical Storm,Jerry,3,2001-10-07T03:00:00Z,ST THOMAS VI,0,0,3,11,14
Tropical Storm,Jerry,3,2001-10-07T03:00:00Z,TFFR 163N 615W,0,11,7,1,19
Tropical Storm,Jerry,3,2001-10-07T03:00:00Z,SAN JUAN PR,0,0,1,13,14
Tropical Storm,Jerry,3,2001-10-07T03:00:00Z,TAPA 171N 618W,0,4,9,3,16
Tropical Storm,Jerry,3,2001-10-07T03:00:00Z,PONCE PR,0,0,1,14,15
Tropical Storm,Jerry,4,2001-10-07T09:00:00Z,12.8N  61.2W,52,0,0,0,52
Tropical Storm,Jerry,4,2001-10-07T09:00:00Z,TISX 177N 648W,0,5,12,1,18
Tropical Storm,Jerry,4,2001-10-07T09:00:00Z,13.8N  63.9W,1,33,0,0,34
Tropical Storm,Jerry,4,2001-10-07T09:00:00Z,TIST 183N 650W,0,2,11,2,15
Tropical Storm,Jerry,4,2001-10-07T09:00:00Z,14.6N  66.4W,0,8,17,1,26
Tropical Storm,Jerry,4,2001-10-07T09:00:00Z,TJPS 180N 666W,0,1,14,4,19
Tropical Storm,Jerry,4,2001-10-07T09:00:00Z,SKPG 125N 717W,0,0,0,7,7
Tropical Storm,Jerry,4,2001-10-07T09:00:00Z,MDSD 185N 697W,0,0,2,16,18
Tropical Storm,Jerry,4,2001-10-07T09:00:00Z,TNCC 122N 690W,0,0,5,6,11
Tropical Storm,Jerry,4,2001-10-07T09:00:00Z,MDCB 176N 714W,0,0,1,17,18
Tropical Storm,Jerry,4,2001-10-07T09:00:00Z,SVMG 110N 640W,1,13,1,0,15
Tropical Storm,Jerry,4,2001-10-07T09:00:00Z,MTPP 186N 724W,0,0,0,16,16
Tropical Storm,Jerry,4,2001-10-07T09:00:00Z,TTPP 106N 614W,22,2,0,0,24
Tropical Storm,Jerry,4,2001-10-07T09:00:00Z,MTCA 183N 738W,0,0,0,12,12
Tropical Storm,Jerry,4,2001-10-07T09:00:00Z,TTPT 112N 608W,40,0,0,0,40
Tropical Storm,Jerry,4,2001-10-07T09:00:00Z,MKJP 179N 768W,0,0,0,3,3
Tropical Storm,Jerry,4,2001-10-07T09:00:00Z,TGPY 120N 618W,39,2,0,0,41
Tropical Storm,Jerry,4,2001-10-07T09:00:00Z,MUGM 200N 751W,0,0,0,7,7
Tropical Storm,Jerry,4,2001-10-07T09:00:00Z,TBPB 131N 595W,67,0,0,0,67
Tropical Storm,Jerry,4,2001-10-07T09:00:00Z,TJSJ 184N 661W,0,1,12,4,17
Tropical Storm,Jerry,4,2001-10-07T09:00:00Z,TVSV 131N 612W,52,0,0,0,52
Tropical Storm,Jerry,4,2001-10-07T09:00:00Z,MDPP 198N 707W,0,0,0,15,15
Tropical Storm,Jerry,4,2001-10-07T09:00:00Z,TLPL 138N 610W,51,0,0,0,51
Tropical Storm,Jerry,4,2001-10-07T09:00:00Z,MBJT 215N 712W,0,0,0,9,9
Tropical Storm,Jerry,4,2001-10-07T09:00:00Z,TFFF 146N 610W,41,2,0,0,43
Tropical Storm,Jerry,4,2001-10-07T09:00:00Z,MYMM 224N 730W,0,0,0,6,6
Tropical Storm,Jerry,4,2001-10-07T09:00:00Z,TDPR 153N 614W,24,10,0,0,34
Tropical Storm,Jerry,4,2001-10-07T09:00:00Z,ST CROIX VI,0,5,12,1,18
Tropical Storm,Jerry,4,2001-10-07T09:00:00Z,TFFR 163N 615W,7,15,0,0,22
Tropical Storm,Jerry,4,2001-10-07T09:00:00Z,ST THOMAS VI,0,2,11,2,15
Tropical Storm,Jerry,4,2001-10-07T09:00:00Z,TAPA 171N 618W,1,13,1,0,15
Tropical Storm,Jerry,4,2001-10-07T09:00:00Z,SAN JUAN PR,0,1,12,4,17
Tropical Storm,Jerry,4,2001-10-07T09:00:00Z,TKPK 173N 627W,0,14,2,0,16
Tropical Storm,Jerry,4,2001-10-07T09:00:00Z,PONCE PR,0,1,14,4,19
Tropical Storm,Jerry,4,2001-10-07T09:00:00Z,TNCM 181N 631W,0,6,5,1,12
Tropical Storm,Jerry,5,2001-10-07T15:00:00Z,13.2N  64.0W,54,1,0,0,55
Tropical Storm,Jerry,5,2001-10-07T15:00:00Z,TJPS 180N 666W,0,3,7,1,11
Tropical Storm,Jerry,5,2001-10-07T15:00:00Z,14.0N  67.1W,0,35,0,0,35
Tropical Storm,Jerry,5,2001-10-07T15:00:00Z,MDSD 185N 697W,0,0,8,7,15
Tropical Storm,Jerry,5,2001-10-07T15:00:00Z,14.7N  69.6W,0,8,18,0,26
Tropical Storm,Jerry,5,2001-10-07T15:00:00Z,MDCB 176N 714W,0,0,8,12,20
Tropical Storm,Jerry,5,2001-10-07T15:00:00Z,SKPG 125N 717W,0,0,7,5,12
Tropical Storm,Jerry,5,2001-10-07T15:00:00Z,MTPP 186N 724W,0,0,1,15,16
Tropical Storm,Jerry,5,2001-10-07T15:00:00Z,TNCC 122N 690W,0,7,6,1,14
Tropical Storm,Jerry,5,2001-10-07T15:00:00Z,MTCA 183N 738W,0,0,0,16,16
Tropical Storm,Jerry,5,2001-10-07T15:00:00Z,SVMG 110N 640W,9,1,0,0,10
Tropical Storm,Jerry,5,2001-10-07T15:00:00Z,MKJP 179N 768W,0,0,0,11,11
Tropical Storm,Jerry,5,2001-10-07T15:00:00Z,TTPP 106N 614W,10,0,0,0,10
Tropical Storm,Jerry,5,2001-10-07T15:00:00Z,MKJS 185N 779W,0,0,0,7,7
Tropical Storm,Jerry,5,2001-10-07T15:00:00Z,TTPT 112N 608W,48,0,0,0,48
Tropical Storm,Jerry,5,2001-10-07T15:00:00Z,MUGM 200N 751W,0,0,0,10,10
Tropical Storm,Jerry,5,2001-10-07T15:00:00Z,TGPY 120N 618W,67,0,0,0,67
Tropical Storm,Jerry,5,2001-10-07T15:00:00Z,MUCM 214N 779W,0,0,0,2,2
Tropical Storm,Jerry,5,2001-10-07T15:00:00Z,TBPB 131N 595W,89,0,0,0,89
Tropical Storm,Jerry,5,2001-10-07T15:00:00Z,TJSJ 184N 661W,0,2,4,1,7
Tropical Storm,Jerry,5,2001-10-07T15:00:00Z,TVSV 131N 612W,82,0,0,0,82
Tropical Storm,Jerry,5,2001-10-07T15:00:00Z,MDPP 198N 707W,0,0,1,9,10
Tropical Storm,Jerry,5,2001-10-07T15:00:00Z,TLPL 138N 610W,69,0,0,0,69
Tropical Storm,Jerry,5,2001-10-07T15:00:00Z,MBJT 215N 712W,0,0,0,4,4
Tropical Storm,Jerry,5,2001-10-07T15:00:00Z,TFFF 146N 610W,33,0,0,0,33
Tropical Storm,Jerry,5,2001-10-07T15:00:00Z,MYMM 224N 730W,0,0,0,2,2
Tropical Storm,Jerry,5,2001-10-07T15:00:00Z,TDPR 153N 614W,14,0,0,0,14
Tropical Storm,Jerry,5,2001-10-07T15:00:00Z,ST CROIX VI,0,5,2,0,7
Tropical Storm,Jerry,5,2001-10-07T15:00:00Z,TFFR 163N 615W,2,0,0,0,2
Tropical Storm,Jerry,5,2001-10-07T15:00:00Z,ST THOMAS VI,0,2,2,0,4
Tropical Storm,Jerry,5,2001-10-07T15:00:00Z,TKPK 173N 627W,1,1,0,0,2
Tropical Storm,Jerry,5,2001-10-07T15:00:00Z,SAN JUAN PR,0,2,4,1,7
Tropical Storm,Jerry,5,2001-10-07T15:00:00Z,TISX 177N 648W,0,5,2,0,7
Tropical Storm,Jerry,5,2001-10-07T15:00:00Z,PONCE PR,0,3,7,1,11
Tropical Storm,Jerry,5,2001-10-07T15:00:00Z,TIST 183N 650W,0,2,2,0,4
Tropical Storm,Jerry,6,2001-10-07T21:00:00Z,14.0N  65.8W,49,0,0,0,49
Tropical Storm,Jerry,6,2001-10-07T21:00:00Z,MTPP 186N 724W,0,0,16,5,21
Tropical Storm,Jerry,6,2001-10-07T21:00:00Z,14.8N  68.7W,1,32,0,0,33
Tropical Storm,Jerry,6,2001-10-07T21:00:00Z,MTCA 183N 738W,0,0,11,10,21
Tropical Storm,Jerry,6,2001-10-07T21:00:00Z,15.8N  71.7W,0,4,21,1,26
Tropical Storm,Jerry,6,2001-10-07T21:00:00Z,MKJP 179N 768W,0,0,1,15,16
Tropical Storm,Jerry,6,2001-10-07T21:00:00Z,SKPG 125N 717W,0,2,9,2,13
Tropical Storm,Jerry,6,2001-10-07T21:00:00Z,MKJS 185N 779W,0,0,0,14,14
Tropical Storm,Jerry,6,2001-10-07T21:00:00Z,TNCC 122N 690W,1,13,2,0,16
Tropical Storm,Jerry,6,2001-10-07T21:00:00Z,MWCG 193N 814W,0,0,0,3,3
Tropical Storm,Jerry,6,2001-10-07T21:00:00Z,SVMG 110N 640W,5,0,0,0,5
Tropical Storm,Jerry,6,2001-10-07T21:00:00Z,MUGM 200N 751W,0,0,2,14,16
Tropical Storm,Jerry,6,2001-10-07T21:00:00Z,TTPT 112N 608W,21,0,0,0,21
Tropical Storm,Jerry,6,2001-10-07T21:00:00Z,MUCM 214N 779W,0,0,0,10,10
Tropical Storm,Jerry,6,2001-10-07T21:00:00Z,TGPY 120N 618W,61,0,0,0,61
Tropical Storm,Jerry,6,2001-10-07T21:00:00Z,MUCF 221N 805W,0,0,0,3,3
Tropical Storm,Jerry,6,2001-10-07T21:00:00Z,TBPB 131N 595W,99,0,0,0,99
Tropical Storm,Jerry,6,2001-10-07T21:00:00Z,TJSJ 184N 661W,1,9,2,0,12
Tropical Storm,Jerry,6,2001-10-07T21:00:00Z,TVSV 131N 612W,97,0,0,0,97
Tropical Storm,Jerry,6,2001-10-07T21:00:00Z,MDPP 198N 707W,0,0,12,2,14
Tropical Storm,Jerry,6,2001-10-07T21:00:00Z,TLPL 138N 610W,91,0,0,0,91
Tropical Storm,Jerry,6,2001-10-07T21:00:00Z,MBJT 215N 712W,0,0,3,5,8
Tropical Storm,Jerry,6,2001-10-07T21:00:00Z,TFFF 146N 610W,63,0,0,0,63
Tropical Storm,Jerry,6,2001-10-07T21:00:00Z,MYMM 224N 730W,0,0,1,6,7
Tropical Storm,Jerry,6,2001-10-07T21:00:00Z,TDPR 153N 614W,33,0,0,0,33
Tropical Storm,Jerry,6,2001-10-07T21:00:00Z,MYSM 241N 745W,0,0,0,4,4
Tropical Storm,Jerry,6,2001-10-07T21:00:00Z,TFFR 163N 615W,5,0,0,0,5
Tropical Storm,Jerry,6,2001-10-07T21:00:00Z,MYEG 235N 758W,0,0,0,6,6
Tropical Storm,Jerry,6,2001-10-07T21:00:00Z,TAPA 171N 618W,2,0,0,0,2
Tropical Storm,Jerry,6,2001-10-07T21:00:00Z,MYAK 241N 776W,0,0,0,4,4
Tropical Storm,Jerry,6,2001-10-07T21:00:00Z,TKPK 173N 627W,4,0,0,0,4
Tropical Storm,Jerry,6,2001-10-07T21:00:00Z,MYNN 251N 775W,0,0,0,2,2
Tropical Storm,Jerry,6,2001-10-07T21:00:00Z,TISX 177N 648W,7,6,0,0,13
Tropical Storm,Jerry,6,2001-10-07T21:00:00Z,ST CROIX VI,7,6,0,0,13
Tropical Storm,Jerry,6,2001-10-07T21:00:00Z,TIST 183N 650W,3,4,1,0,8
Tropical Storm,Jerry,6,2001-10-07T21:00:00Z,ST THOMAS VI,3,4,1,0,8
Tropical Storm,Jerry,6,2001-10-07T21:00:00Z,TJPS 180N 666W,1,15,1,0,17
Tropical Storm,Jerry,6,2001-10-07T21:00:00Z,SAN JUAN PR,1,9,2,0,12
Tropical Storm,Jerry,6,2001-10-07T21:00:00Z,MDSD 185N 697W,0,6,14,0,20
Tropical Storm,Jerry,6,2001-10-07T21:00:00Z,PONCE PR,1,15,1,0,17
Tropical Storm,Jerry,6,2001-10-07T21:00:00Z,MDCB 176N 714W,0,3,21,1,25
Tropical Storm,Jerry,7,2001-10-08T03:00:00Z,14.8N  65.1W,51,0,0,0,51
Tropical Storm,Jerry,7,2001-10-08T03:00:00Z,MDCB 176N 714W,0,1,18,6,25
Tropical Storm,Jerry,7,2001-10-08T03:00:00Z,15.5N  67.5W,7,29,0,0,36
Tropical Storm,Jerry,7,2001-10-08T03:00:00Z,MTPP 186N 724W,0,0,10,13,23
Tropical Storm,Jerry,7,2001-10-08T03:00:00Z,16.2N  69.8W,0,13,15,1,29
Tropical Storm,Jerry,7,2001-10-08T03:00:00Z,MTCA 183N 738W,0,0,3,18,21
Tropical Storm,Jerry,7,2001-10-08T03:00:00Z,SKPG 125N 717W,0,0,3,5,8
Tropical Storm,Jerry,7,2001-10-08T03:00:00Z,MKJP 179N 768W,0,0,0,13,13
Tropical Storm,Jerry,7,2001-10-08T03:00:00Z,TNCC 122N 690W,0,3,6,1,10
Tropical Storm,Jerry,7,2001-10-08T03:00:00Z,MKJS 185N 779W,0,0,0,9,9
Tropical Storm,Jerry,7,2001-10-08T03:00:00Z,TGPY 120N 618W,15,0,0,0,15
Tropical Storm,Jerry,7,2001-10-08T03:00:00Z,MUGM 200N 751W,0,0,0,17,17
Tropical Storm,Jerry,7,2001-10-08T03:00:00Z,TBPB 131N 595W,99,0,0,0,99
Tropical Storm,Jerry,7,2001-10-08T03:00:00Z,MUCM 214N 779W,0,0,0,8,8
Tropical Storm,Jerry,7,2001-10-08T03:00:00Z,TVSV 131N 612W,99,0,0,0,99
Tropical Storm,Jerry,7,2001-10-08T03:00:00Z,MUCF 221N 805W,0,0,0,2,2
Tropical Storm,Jerry,7,2001-10-08T03:00:00Z,TLPL 138N 610W,99,0,0,0,99
Tropical Storm,Jerry,7,2001-10-08T03:00:00Z,TJSJ 184N 661W,1,15,1,0,17
Tropical Storm,Jerry,7,2001-10-08T03:00:00Z,TFFF 146N 610W,92,0,0,0,92
Tropical Storm,Jerry,7,2001-10-08T03:00:00Z,MDPP 198N 707W,0,0,12,6,18
Tropical Storm,Jerry,7,2001-10-08T03:00:00Z,TDPR 153N 614W,63,0,0,0,63
Tropical Storm,Jerry,7,2001-10-08T03:00:00Z,MBJT 215N 712W,0,0,2,9,11
Tropical Storm,Jerry,7,2001-10-08T03:00:00Z,TFFR 163N 615W,9,1,0,0,10
Tropical Storm,Jerry,7,2001-10-08T03:00:00Z,MYMM 224N 730W,0,0,0,9,9
Tropical Storm,Jerry,7,2001-10-08T03:00:00Z,TAPA 171N 618W,2,0,0,0,2
Tropical Storm,Jerry,7,2001-10-08T03:00:00Z,MYSM 241N 745W,0,0,0,3,3
Tropical Storm,Jerry,7,2001-10-08T03:00:00Z,TKPK 173N 627W,6,1,0,0,7
Tropical Storm,Jerry,7,2001-10-08T03:00:00Z,MYEG 235N 758W,0,0,0,5,5
Tropical Storm,Jerry,7,2001-10-08T03:00:00Z,TNCM 181N 631W,2,1,0,0,3
Tropical Storm,Jerry,7,2001-10-08T03:00:00Z,MYAK 241N 776W,0,0,0,2,2
Tropical Storm,Jerry,7,2001-10-08T03:00:00Z,TISX 177N 648W,9,9,0,1,19
Tropical Storm,Jerry,7,2001-10-08T03:00:00Z,ST CROIX VI,9,9,0,1,19
Tropical Storm,Jerry,7,2001-10-08T03:00:00Z,TIST 183N 650W,3,9,0,1,13
Tropical Storm,Jerry,7,2001-10-08T03:00:00Z,ST THOMAS VI,3,9,0,1,13
Tropical Storm,Jerry,7,2001-10-08T03:00:00Z,TJPS 180N 666W,1,21,1,0,23
Tropical Storm,Jerry,7,2001-10-08T03:00:00Z,SAN JUAN PR,1,15,1,0,17
Tropical Storm,Jerry,7,2001-10-08T03:00:00Z,MDSD 185N 697W,0,5,17,2,24
Tropical Storm,Jerry,7,2001-10-08T03:00:00Z,PONCE PR,1,21,1,0,23
Tropical Storm,Jerry,8,2001-10-08T09:00:00Z,15.6N  67.1W,52,0,0,0,52
Tropical Storm,Jerry,8,2001-10-08T09:00:00Z,MWCG 193N 814W,0,0,0,5,5
Tropical Storm,Jerry,8,2001-10-08T09:00:00Z,16.4N  69.4W,8,29,0,0,37
Tropical Storm,Jerry,8,2001-10-08T09:00:00Z,MUGM 200N 751W,0,0,3,16,19
Tropical Storm,Jerry,8,2001-10-08T09:00:00Z,17.0N  71.5W,0,16,11,1,28
Tropical Storm,Jerry,8,2001-10-08T09:00:00Z,MUCM 214N 779W,0,0,0,13,13
Tropical Storm,Jerry,8,2001-10-08T09:00:00Z,SKPG 125N 717W,0,1,2,2,5
Tropical Storm,Jerry,8,2001-10-08T09:00:00Z,MUCF 221N 805W,0,0,0,6,6
Tropical Storm,Jerry,8,2001-10-08T09:00:00Z,TNCC 122N 690W,0,2,1,0,3
Tropical Storm,Jerry,8,2001-10-08T09:00:00Z,MUSN 216N 826W,0,0,0,2,2
Tropical Storm,Jerry,8,2001-10-08T09:00:00Z,TGPY 120N 618W,10,0,0,0,10
Tropical Storm,Jerry,8,2001-10-08T09:00:00Z,MUHA 230N 824W,0,0,0,2,2
Tropical Storm,Jerry,8,2001-10-08T09:00:00Z,TVSV 131N 612W,99,0,0,0,99
Tropical Storm,Jerry,8,2001-10-08T09:00:00Z,TJSJ 184N 661W,11,5,0,0,16
Tropical Storm,Jerry,8,2001-10-08T09:00:00Z,TLPL 138N 610W,99,0,0,0,99
Tropical Storm,Jerry,8,2001-10-08T09:00:00Z,MDPP 198N 707W,0,5,12,2,19
Tropical Storm,Jerry,8,2001-10-08T09:00:00Z,TFFF 146N 610W,40,0,0,0,40
Tropical Storm,Jerry,8,2001-10-08T09:00:00Z,MBJT 215N 712W,0,0,6,4,10
Tropical Storm,Jerry,8,2001-10-08T09:00:00Z,TDPR 153N 614W,35,0,0,0,35
Tropical Storm,Jerry,8,2001-10-08T09:00:00Z,MYMM 224N 730W,0,0,1,8,9
Tropical Storm,Jerry,8,2001-10-08T09:00:00Z,TISX 177N 648W,15,1,0,0,16
Tropical Storm,Jerry,8,2001-10-08T09:00:00Z,MYSM 241N 745W,0,0,0,4,4
Tropical Storm,Jerry,8,2001-10-08T09:00:00Z,TIST 183N 650W,6,1,0,0,7
Tropical Storm,Jerry,8,2001-10-08T09:00:00Z,MYEG 235N 758W,0,0,0,7,7
Tropical Storm,Jerry,8,2001-10-08T09:00:00Z,TJPS 180N 666W,20,5,0,0,25
Tropical Storm,Jerry,8,2001-10-08T09:00:00Z,MYAK 241N 776W,0,0,0,5,5
Tropical Storm,Jerry,8,2001-10-08T09:00:00Z,MDSD 185N 697W,0,23,3,1,27
Tropical Storm,Jerry,8,2001-10-08T09:00:00Z,MYNN 251N 775W,0,0,0,2,2
Tropical Storm,Jerry,8,2001-10-08T09:00:00Z,MDCB 176N 714W,0,15,12,1,28
Tropical Storm,Jerry,8,2001-10-08T09:00:00Z,ST CROIX VI,15,1,0,0,16
Tropical Storm,Jerry,8,2001-10-08T09:00:00Z,MTPP 186N 724W,0,3,19,3,25
Tropical Storm,Jerry,8,2001-10-08T09:00:00Z,ST THOMAS VI,6,1,0,0,7
Tropical Storm,Jerry,8,2001-10-08T09:00:00Z,MTCA 183N 738W,0,0,15,9,24
Tropical Storm,Jerry,8,2001-10-08T09:00:00Z,SAN JUAN PR,11,5,0,0,16
Tropical Storm,Jerry,8,2001-10-08T09:00:00Z,MKJP 179N 768W,0,0,1,16,17
Tropical Storm,Jerry,8,2001-10-08T09:00:00Z,PONCE PR,20,5,0,0,25
Tropical Storm,Jerry,8,2001-10-08T09:00:00Z,MKJS 185N 779W,0,0,0,15,15
Tropical Storm,Jerry,9,2001-10-08T15:00:00Z,15.5N  70.0W,48,0,0,0,48
Tropical Storm,Jerry,9,2001-10-08T15:00:00Z,MUSN 216N 826W,0,0,0,8,8
Tropical Storm,Jerry,9,2001-10-08T15:00:00Z,16.3N  72.5W,6,28,0,0,34
Tropical Storm,Jerry,9,2001-10-08T15:00:00Z,MUHA 230N 824W,0,0,0,6,6
Tropical Storm,Jerry,9,2001-10-08T15:00:00Z,17.0N  75.0W,0,13,14,1,28
Tropical Storm,Jerry,9,2001-10-08T15:00:00Z,MUAN 219N 850W,0,0,0,3,3
Tropical Storm,Jerry,9,2001-10-08T15:00:00Z,SKPG 125N 717W,1,1,0,0,2
Tropical Storm,Jerry,9,2001-10-08T15:00:00Z,MDPP 198N 707W,0,7,3,0,10
Tropical Storm,Jerry,9,2001-10-08T15:00:00Z,TJPS 180N 666W,3,0,0,0,3
Tropical Storm,Jerry,9,2001-10-08T15:00:00Z,MBJT 215N 712W,0,0,2,1,3
Tropical Storm,Jerry,9,2001-10-08T15:00:00Z,MDSD 185N 697W,7,10,0,0,17
Tropical Storm,Jerry,9,2001-10-08T15:00:00Z,MYMM 224N 730W,0,0,2,2,4
Tropical Storm,Jerry,9,2001-10-08T15:00:00Z,MDCB 176N 714W,8,24,0,0,32
Tropical Storm,Jerry,9,2001-10-08T15:00:00Z,MYSM 241N 745W,0,0,0,2,2
Tropical Storm,Jerry,9,2001-10-08T15:00:00Z,MTPP 186N 724W,0,22,3,0,25
Tropical Storm,Jerry,9,2001-10-08T15:00:00Z,MYEG 235N 758W,0,0,0,6,6
Tropical Storm,Jerry,9,2001-10-08T15:00:00Z,MTCA 183N 738W,0,18,10,0,28
Tropical Storm,Jerry,9,2001-10-08T15:00:00Z,MYAK 241N 776W,0,0,0,5,5
Tropical Storm,Jerry,9,2001-10-08T15:00:00Z,MKJP 179N 768W,0,1,18,4,23
Tropical Storm,Jerry,9,2001-10-08T15:00:00Z,MYNN 251N 775W,0,0,0,3,3
Tropical Storm,Jerry,9,2001-10-08T15:00:00Z,MKJS 185N 779W,0,0,11,10,21
Tropical Storm,Jerry,9,2001-10-08T15:00:00Z,PONCE PR,3,0,0,0,3
Tropical Storm,Jerry,9,2001-10-08T15:00:00Z,MWCG 193N 814W,0,0,0,13,13
Tropical Storm,Jerry,9,2001-10-08T15:00:00Z,MARATHON FL,0,0,0,4,4
Tropical Storm,Jerry,9,2001-10-08T15:00:00Z,MUGM 200N 751W,0,1,16,3,20
Tropical Storm,Jerry,9,2001-10-08T15:00:00Z,MIAMI FL,0,0,0,2,2
Tropical Storm,Jerry,9,2001-10-08T15:00:00Z,MUCM 214N 779W,0,0,2,13,15
Tropical Storm,Jerry,9,2001-10-08T15:00:00Z,KEY WEST FL,0,0,0,4,4
Tropical Storm,Jerry,9,2001-10-08T15:00:00Z,MUCF 221N 805W,0,0,0,11,11
Tropical Storm,One,1,2001-10-12T21:00:00Z,36.0N  66.2W,35,0,1,0,36
Tropical Storm,One,1,2001-10-12T21:00:00Z,PORTLAND ME,0,1,3,5,9
Tropical Storm,One,1,2001-10-12T21:00:00Z,37.4N  65.7W,12,4,2,1,19
Tropical Storm,One,1,2001-10-12T21:00:00Z,BAR HARBOR ME,0,0,3,6,9
Tropical Storm,One,1,2001-10-12T21:00:00Z,39.0N  65.0W,1,8,4,3,16
Tropical Storm,One,1,2001-10-12T21:00:00Z,EASTPORT ME,0,0,2,7,9
Tropical Storm,One,1,2001-10-12T21:00:00Z,BERMUDA,6,3,1,1,11
Tropical Storm,One,1,2001-10-12T21:00:00Z,ST JOHN NB,0,0,1,7,8
Tropical Storm,One,1,2001-10-12T21:00:00Z,ATLANTIC CITY NJ,0,1,1,1,3
Tropical Storm,One,1,2001-10-12T21:00:00Z,MONCTON NB,0,0,0,7,7
Tropical Storm,One,1,2001-10-12T21:00:00Z,NEW YORK CITY NY,0,1,2,2,5
Tropical Storm,One,1,2001-10-12T21:00:00Z,YARMOUTH NS,0,0,3,7,10
Tropical Storm,One,1,2001-10-12T21:00:00Z,MONTAUK POINT NY,0,3,3,3,9
Tropical Storm,One,1,2001-10-12T21:00:00Z,HALIFAX NS,0,0,1,7,8
Tropical Storm,One,1,2001-10-12T21:00:00Z,PROVIDENCE RI,0,3,4,2,9
Tropical Storm,One,1,2001-10-12T21:00:00Z,SABLE ISLAND NS,0,0,0,6,6
Tropical Storm,One,1,2001-10-12T21:00:00Z,NANTUCKET MA,0,5,4,3,12
Tropical Storm,One,1,2001-10-12T21:00:00Z,SYDNEY NS,0,0,0,4,4
Tropical Storm,One,1,2001-10-12T21:00:00Z,HYANNIS MA,0,4,4,3,11
Tropical Storm,One,1,2001-10-12T21:00:00Z,EDDY POINT NS,0,0,0,6,6
Tropical Storm,One,1,2001-10-12T21:00:00Z,BOSTON MA,0,2,4,3,9
Tropical Storm,One,1,2001-10-12T21:00:00Z,PTX BASQUES NFLD,0,0,0,2,2
Tropical Storm,One,2,2001-10-13T03:00:00Z,37.0N  65.0W,28,1,0,0,29
Tropical Storm,One,2,2001-10-13T03:00:00Z,ST JOHN NB,0,2,5,3,10
Tropical Storm,One,2,2001-10-13T03:00:00Z,39.0N  64.0W,9,6,1,1,17
Tropical Storm,One,2,2001-10-13T03:00:00Z,MONCTON NB,0,1,5,4,10
Tropical Storm,One,2,2001-10-13T03:00:00Z,41.0N  62.5W,0,8,3,3,14
Tropical Storm,One,2,2001-10-13T03:00:00Z,YARMOUTH NS,0,4,5,3,12
Tropical Storm,One,2,2001-10-13T03:00:00Z,BERMUDA,3,3,1,0,7
Tropical Storm,One,2,2001-10-13T03:00:00Z,HALIFAX NS,0,2,5,5,12
Tropical Storm,One,2,2001-10-13T03:00:00Z,MONTAUK POINT NY,0,1,1,1,3
Tropical Storm,One,2,2001-10-13T03:00:00Z,SABLE ISLAND NS,0,1,4,6,11
Tropical Storm,One,2,2001-10-13T03:00:00Z,PROVIDENCE RI,0,2,1,1,4
Tropical Storm,One,2,2001-10-13T03:00:00Z,SYDNEY NS,0,0,3,6,9
Tropical Storm,One,2,2001-10-13T03:00:00Z,NANTUCKET MA,0,4,2,1,7
Tropical Storm,One,2,2001-10-13T03:00:00Z,EDDY POINT NS,0,1,3,6,10
Tropical Storm,One,2,2001-10-13T03:00:00Z,HYANNIS MA,0,3,2,1,6
Tropical Storm,One,2,2001-10-13T03:00:00Z,PTX BASQUES NFLD,0,0,1,7,8
Tropical Storm,One,2,2001-10-13T03:00:00Z,BOSTON MA,0,2,1,2,5
Tropical Storm,One,2,2001-10-13T03:00:00Z,BURGEO NFLD,0,0,1,5,6
Tropical Storm,One,2,2001-10-13T03:00:00Z,PORTLAND ME,0,2,2,2,6
Tropical Storm,One,2,2001-10-13T03:00:00Z,ILE ST PIERRE,0,0,0,5,5
Tropical Storm,One,2,2001-10-13T03:00:00Z,BAR HARBOR ME,0,2,4,2,8
Tropical Storm,One,2,2001-10-13T03:00:00Z,CAPE RACE NFLD,0,0,0,3,3
Tropical Storm,One,2,2001-10-13T03:00:00Z,EASTPORT ME,0,2,5,3,10
Tropical Storm,Karen,3,2001-10-13T09:00:00Z,37.8N  63.6W,31,0,1,0,32
Tropical Storm,Karen,3,2001-10-13T09:00:00Z,ST JOHN NB,0,2,4,3,9
Tropical Storm,Karen,3,2001-10-13T09:00:00Z,39.6N  62.5W,11,4,1,2,18
Tropical Storm,Karen,3,2001-10-13T09:00:00Z,MONCTON NB,0,2,3,4,9
Tropical Storm,Karen,3,2001-10-13T09:00:00Z,41.5N  60.8W,1,7,3,3,14
Tropical Storm,Karen,3,2001-10-13T09:00:00Z,YARMOUTH NS,0,4,3,3,10
Tropical Storm,Karen,3,2001-10-13T09:00:00Z,BERMUDA,0,3,1,1,5
Tropical Storm,Karen,3,2001-10-13T09:00:00Z,HALIFAX NS,0,4,4,3,11
Tropical Storm,Karen,3,2001-10-13T09:00:00Z,MONTAUK POINT NY,0,0,1,1,2
Tropical Storm,Karen,3,2001-10-13T09:00:00Z,SABLE ISLAND NS,0,3,4,5,12
Tropical Storm,Karen,3,2001-10-13T09:00:00Z,PROVIDENCE RI,0,1,0,1,2
Tropical Storm,Karen,3,2001-10-13T09:00:00Z,SYDNEY NS,0,1,3,6,10
Tropical Storm,Karen,3,2001-10-13T09:00:00Z,NANTUCKET MA,0,2,1,1,4
Tropical Storm,Karen,3,2001-10-13T09:00:00Z,EDDY POINT NS,0,2,4,5,11
Tropical Storm,Karen,3,2001-10-13T09:00:00Z,HYANNIS MA,0,1,2,1,4
Tropical Storm,Karen,3,2001-10-13T09:00:00Z,PTX BASQUES NFLD,0,0,2,6,8
Tropical Storm,Karen,3,2001-10-13T09:00:00Z,BOSTON MA,0,1,1,1,3
Tropical Storm,Karen,3,2001-10-13T09:00:00Z,BURGEO NFLD,0,0,2,5,7
Tropical Storm,Karen,3,2001-10-13T09:00:00Z,PORTLAND ME,0,1,1,1,3
Tropical Storm,Karen,3,2001-10-13T09:00:00Z,ILE ST PIERRE,0,0,1,6,7
Tropical Storm,Karen,3,2001-10-13T09:00:00Z,BAR HARBOR ME,0,2,2,2,6
Tropical Storm,Karen,3,2001-10-13T09:00:00Z,CAPE RACE NFLD,0,0,0,4,4
Tropical Storm,Karen,3,2001-10-13T09:00:00Z,EASTPORT ME,0,2,3,3,8
Tropical Storm,Karen,4,2001-10-13T15:00:00Z,41.0N  62.5W,23,1,0,0,24
Tropical Storm,Karen,4,2001-10-13T15:00:00Z,SABLE ISLAND NS,1,13,3,0,17
Tropical Storm,Karen,4,2001-10-13T15:00:00Z,43.5N  61.0W,2,15,1,0,18
Tropical Storm,Karen,4,2001-10-13T15:00:00Z,SYDNEY NS,0,8,6,1,15
Tropical Storm,Karen,4,2001-10-13T15:00:00Z,46.0N  59.0W,0,7,6,2,15
Tropical Storm,Karen,4,2001-10-13T15:00:00Z,EDDY POINT NS,0,12,3,1,16
Tropical Storm,Karen,4,2001-10-13T15:00:00Z,BAR HARBOR ME,0,2,1,1,4
Tropical Storm,Karen,4,2001-10-13T15:00:00Z,PTX BASQUES NFLD,0,3,8,3,14
Tropical Storm,Karen,4,2001-10-13T15:00:00Z,EASTPORT ME,1,4,1,1,7
Tropical Storm,Karen,4,2001-10-13T15:00:00Z,BURGEO NFLD,0,1,9,3,13
Tropical Storm,Karen,4,2001-10-13T15:00:00Z,ST JOHN NB,0,7,2,1,10
Tropical Storm,Karen,4,2001-10-13T15:00:00Z,ILE ST PIERRE,0,1,7,4,12
Tropical Storm,Karen,4,2001-10-13T15:00:00Z,MONCTON NB,0,8,3,1,12
Tropical Storm,Karen,4,2001-10-13T15:00:00Z,CAPE RACE NFLD,0,0,3,6,9
Tropical Storm,Karen,4,2001-10-13T15:00:00Z,YARMOUTH NS,3,7,0,1,11
Tropical Storm,Karen,4,2001-10-13T15:00:00Z,HIBERNIA OILFLD,0,0,0,4,4
Tropical Storm,Karen,4,2001-10-13T15:00:00Z,HALIFAX NS,1,13,1,1,16
Hurricane,Karen,5,2001-10-13T21:00:00Z,39.7N  64.4W,34,0,0,0,34
Hurricane,Karen,5,2001-10-13T21:00:00Z,EASTPORT ME,0,4,5,4,13
Hurricane,Karen,5,2001-10-13T21:00:00Z,40.9N  64.2W,18,3,1,0,22
Hurricane,Karen,5,2001-10-13T21:00:00Z,ST JOHN NB,0,3,5,4,12
Hurricane,Karen,5,2001-10-13T21:00:00Z,42.0N  64.0W,8,6,2,2,18
Hurricane,Karen,5,2001-10-13T21:00:00Z,MONCTON NB,0,1,4,6,11
Hurricane,Karen,5,2001-10-13T21:00:00Z,NEW YORK CITY NY,0,0,1,1,2
Hurricane,Karen,5,2001-10-13T21:00:00Z,YARMOUTH NS,1,7,4,3,15
Hurricane,Karen,5,2001-10-13T21:00:00Z,MONTAUK POINT NY,0,2,2,1,5
Hurricane,Karen,5,2001-10-13T21:00:00Z,HALIFAX NS,0,4,4,4,12
Hurricane,Karen,5,2001-10-13T21:00:00Z,PROVIDENCE RI,0,3,2,2,7
Hurricane,Karen,5,2001-10-13T21:00:00Z,SABLE ISLAND NS,0,1,3,5,9
Hurricane,Karen,5,2001-10-13T21:00:00Z,NANTUCKET MA,1,5,3,1,10
Hurricane,Karen,5,2001-10-13T21:00:00Z,SYDNEY NS,0,0,1,6,7
Hurricane,Karen,5,2001-10-13T21:00:00Z,HYANNIS MA,1,5,2,2,10
Hurricane,Karen,5,2001-10-13T21:00:00Z,EDDY POINT NS,0,1,2,6,9
Hurricane,Karen,5,2001-10-13T21:00:00Z,BOSTON MA,0,4,2,2,8
Hurricane,Karen,5,2001-10-13T21:00:00Z,PTX BASQUES NFLD,0,0,0,4,4
Hurricane,Karen,5,2001-10-13T21:00:00Z,PORTLAND ME,0,4,3,3,10
Hurricane,Karen,5,2001-10-13T21:00:00Z,BURGEO NFLD,0,0,0,3,3
Hurricane,Karen,5,2001-10-13T21:00:00Z,BAR HARBOR ME,0,5,4,3,12
Hurricane,Karen,5,2001-10-13T21:00:00Z,ILE ST PIERRE,0,0,0,3,3
Hurricane,Karen,6,2001-10-14T03:00:00Z,41.0N  63.4W,38,0,0,1,39
Hurricane,Karen,6,2001-10-14T03:00:00Z,YARMOUTH NS,4,10,1,0,15
Hurricane,Karen,6,2001-10-14T03:00:00Z,43.1N  63.2W,15,4,1,1,21
Hurricane,Karen,6,2001-10-14T03:00:00Z,HALIFAX NS,4,11,2,1,18
Hurricane,Karen,6,2001-10-14T03:00:00Z,46.0N  61.0W,0,8,6,2,16
Hurricane,Karen,6,2001-10-14T03:00:00Z,SABLE ISLAND NS,2,8,3,2,15
Hurricane,Karen,6,2001-10-14T03:00:00Z,NANTUCKET MA,0,2,1,1,4
Hurricane,Karen,6,2001-10-14T03:00:00Z,SYDNEY NS,0,6,6,3,15
Hurricane,Karen,6,2001-10-14T03:00:00Z,HYANNIS MA,0,2,1,0,3
Hurricane,Karen,6,2001-10-14T03:00:00Z,EDDY POINT NS,1,9,5,1,16
Hurricane,Karen,6,2001-10-14T03:00:00Z,BOSTON MA,0,1,1,0,2
Hurricane,Karen,6,2001-10-14T03:00:00Z,PTX BASQUES NFLD,0,2,7,4,13
Hurricane,Karen,6,2001-10-14T03:00:00Z,PORTLAND ME,0,2,2,0,4
Hurricane,Karen,6,2001-10-14T03:00:00Z,BURGEO NFLD,0,1,5,5,11
Hurricane,Karen,6,2001-10-14T03:00:00Z,BAR HARBOR ME,0,6,3,1,10
Hurricane,Karen,6,2001-10-14T03:00:00Z,ILE ST PIERRE,0,0,4,6,10
Hurricane,Karen,6,2001-10-14T03:00:00Z,EASTPORT ME,1,9,2,1,13
Hurricane,Karen,6,2001-10-14T03:00:00Z,CAPE RACE NFLD,0,0,1,6,7
Hurricane,Karen,6,2001-10-14T03:00:00Z,ST JOHN NB,1,10,3,1,15
Hurricane,Karen,6,2001-10-14T03:00:00Z,HIBERNIA OILFLD,0,0,0,3,3
Hurricane,Karen,6,2001-10-14T03:00:00Z,MONCTON NB,0,11,3,1,15
Hurricane,Karen,7,2001-10-14T09:00:00Z,42.6N  63.2W,26,0,0,1,27
Hurricane,Karen,7,2001-10-14T09:00:00Z,YARMOUTH NS,11,5,1,0,17
Hurricane,Karen,7,2001-10-14T09:00:00Z,45.3N  62.7W,6,12,1,1,20
Hurricane,Karen,7,2001-10-14T09:00:00Z,HALIFAX NS,11,8,1,0,20
Hurricane,Karen,7,2001-10-14T09:00:00Z,48.0N  59.0W,0,6,9,1,16
Hurricane,Karen,7,2001-10-14T09:00:00Z,SABLE ISLAND NS,8,7,2,0,17
Hurricane,Karen,7,2001-10-14T09:00:00Z,NANTUCKET MA,1,1,0,0,2
Hurricane,Karen,7,2001-10-14T09:00:00Z,SYDNEY NS,1,11,5,1,18
Hurricane,Karen,7,2001-10-14T09:00:00Z,HYANNIS MA,1,1,0,0,2
Hurricane,Karen,7,2001-10-14T09:00:00Z,EDDY POINT NS,4,12,3,0,19
Hurricane,Karen,7,2001-10-14T09:00:00Z,PORTLAND ME,1,1,1,0,3
Hurricane,Karen,7,2001-10-14T09:00:00Z,PTX BASQUES NFLD,0,7,8,2,17
Hurricane,Karen,7,2001-10-14T09:00:00Z,BAR HARBOR ME,2,6,1,0,9
Hurricane,Karen,7,2001-10-14T09:00:00Z,BURGEO NFLD,0,4,9,2,15
Hurricane,Karen,7,2001-10-14T09:00:00Z,EASTPORT ME,4,8,1,1,14
Hurricane,Karen,7,2001-10-14T09:00:00Z,ILE ST PIERRE,0,2,7,3,12
Hurricane,Karen,7,2001-10-14T09:00:00Z,ST JOHN NB,4,11,1,0,16
Hurricane,Karen,7,2001-10-14T09:00:00Z,CAPE RACE NFLD,0,0,3,6,9
Hurricane,Karen,7,2001-10-14T09:00:00Z,MONCTON NB,3,13,1,1,18
Hurricane,Karen,7,2001-10-14T09:00:00Z,HIBERNIA OILFLD,0,0,0,4,4
Hurricane,Karen,8,2001-10-14T15:00:00Z,42.8N  62.0W,26,0,0,0,26
Hurricane,Karen,8,2001-10-14T15:00:00Z,SABLE ISLAND NS,13,4,0,1,18
Hurricane,Karen,8,2001-10-14T15:00:00Z,45.3N  61.2W,9,7,1,0,17
Hurricane,Karen,8,2001-10-14T15:00:00Z,SYDNEY NS,3,10,2,1,16
Hurricane,Karen,8,2001-10-14T15:00:00Z,48.0N  58.0W,0,6,6,2,14
Hurricane,Karen,8,2001-10-14T15:00:00Z,EDDY POINT NS,8,7,2,0,17
Hurricane,Karen,8,2001-10-14T15:00:00Z,BAR HARBOR ME,1,2,1,0,4
Hurricane,Karen,8,2001-10-14T15:00:00Z,PTX BASQUES NFLD,1,8,4,2,15
Hurricane,Karen,8,2001-10-14T15:00:00Z,EASTPORT ME,2,5,1,0,8
Hurricane,Karen,8,2001-10-14T15:00:00Z,BURGEO NFLD,0,6,6,2,14
Hurricane,Karen,8,2001-10-14T15:00:00Z,ST JOHN NB,4,6,0,1,11
Hurricane,Karen,8,2001-10-14T15:00:00Z,ILE ST PIERRE,0,5,5,3,13
Hurricane,Karen,8,2001-10-14T15:00:00Z,MONCTON NB,3,8,1,1,13
Hurricane,Karen,8,2001-10-14T15:00:00Z,CAPE RACE NFLD,0,1,4,5,10
Hurricane,Karen,8,2001-10-14T15:00:00Z,YARMOUTH NS,7,4,0,1,12
Hurricane,Karen,8,2001-10-14T15:00:00Z,HIBERNIA OILFLD,0,0,1,5,6
Hurricane,Karen,8,2001-10-14T15:00:00Z,HALIFAX NS,13,4,0,1,18
Tropical Storm,Karen,9,2001-10-14T21:00:00Z,46.6N  63.3W,23,3,0,0,26
Tropical Storm,Karen,9,2001-10-14T21:00:00Z,SABLE ISLAND NS,15,2,0,0,17
Tropical Storm,Karen,9,2001-10-14T21:00:00Z,52.1N  59.8W,0,12,0,0,12
Tropical Storm,Karen,9,2001-10-14T21:00:00Z,SYDNEY NS,14,7,0,0,21
Tropical Storm,Karen,9,2001-10-14T21:00:00Z,BAR HARBOR ME,10,1,0,0,11
Tropical Storm,Karen,9,2001-10-14T21:00:00Z,EDDY POINT NS,22,3,0,0,25
Tropical Storm,Karen,9,2001-10-14T21:00:00Z,EASTPORT ME,21,1,0,0,22
Tropical Storm,Karen,9,2001-10-14T21:00:00Z,PTX BASQUES NFLD,6,13,0,0,19
Tropical Storm,Karen,9,2001-10-14T21:00:00Z,ST JOHN NB,26,0,0,0,26
Tropical Storm,Karen,9,2001-10-14T21:00:00Z,BURGEO NFLD,3,11,0,0,14
Tropical Storm,Karen,9,2001-10-14T21:00:00Z,MONCTON NB,25,2,0,0,27
Tropical Storm,Karen,9,2001-10-14T21:00:00Z,ILE ST PIERRE,1,8,0,0,9
Tropical Storm,Karen,9,2001-10-14T21:00:00Z,YARMOUTH NS,32,0,0,0,32
Tropical Storm,Karen,9,2001-10-14T21:00:00Z,CAPE RACE NFLD,0,3,0,0,3
Tropical Storm,Karen,9,2001-10-14T21:00:00Z,HALIFAX NS,33,0,0,0,33
Tropical Storm,Karen,10,2001-10-15T03:00:00Z,48.0N  62.0W,21,2,0,0,23
Tropical Storm,Karen,10,2001-10-15T03:00:00Z,SABLE ISLAND NS,19,0,0,0,19
Tropical Storm,Karen,10,2001-10-15T03:00:00Z,51.5N  58.0W,1,14,0,0,15
Tropical Storm,Karen,10,2001-10-15T03:00:00Z,SYDNEY NS,22,1,0,0,23
Tropical Storm,Karen,10,2001-10-15T03:00:00Z,BAR HARBOR ME,2,0,0,0,2
Tropical Storm,Karen,10,2001-10-15T03:00:00Z,EDDY POINT NS,29,0,0,0,29
Tropical Storm,Karen,10,2001-10-15T03:00:00Z,EASTPORT ME,10,0,0,0,10
Tropical Storm,Karen,10,2001-10-15T03:00:00Z,PTX BASQUES NFLD,16,5,0,0,21
Tropical Storm,Karen,10,2001-10-15T03:00:00Z,ST JOHN NB,21,0,0,0,21
Tropical Storm,Karen,10,2001-10-15T03:00:00Z,BURGEO NFLD,9,8,0,0,17
Tropical Storm,Karen,10,2001-10-15T03:00:00Z,MONCTON NB,26,0,0,0,26
Tropical Storm,Karen,10,2001-10-15T03:00:00Z,ILE ST PIERRE,5,8,0,0,13
Tropical Storm,Karen,10,2001-10-15T03:00:00Z,YARMOUTH NS,27,0,0,0,27
Tropical Storm,Karen,10,2001-10-15T03:00:00Z,CAPE RACE NFLD,0,6,0,0,6
Tropical Storm,Karen,10,2001-10-15T03:00:00Z,HALIFAX NS,40,0,0,0,40
Tropical Depression,Fourteen,1,2001-10-27T15:00:00Z,27.2N  36.5W,40,0,0,0,40
Tropical Depression,Fourteen,1,2001-10-27T15:00:00Z,27.7N  40.8W,1,11,4,2,18
Tropical Depression,Fourteen,1,2001-10-27T15:00:00Z,27.4N  38.6W,15,6,1,1,23
Tropical Depression,Fourteen,2,2001-10-27T21:00:00Z,28.0N  38.7W,33,1,0,0,34
Tropical Depression,Fourteen,2,2001-10-27T21:00:00Z,28.8N  42.9W,2,10,4,2,18
Tropical Depression,Fourteen,2,2001-10-27T21:00:00Z,28.2N  40.8W,16,4,1,2,23
Tropical Depression,Fourteen,3,2001-10-28T03:00:00Z,27.9N  40.9W,44,0,0,0,44
Tropical Depression,Fourteen,3,2001-10-28T03:00:00Z,28.6N  44.1W,13,5,2,2,22
Tropical Depression,Fourteen,3,2001-10-28T03:00:00Z,28.1N  42.5W,29,1,0,0,30
Tropical Depression,Fourteen,4,2001-10-28T09:00:00Z,27.5N  42.2W,52,0,0,0,52
Tropical Depression,Fourteen,4,2001-10-28T09:00:00Z,28.7N  45.4W,15,6,1,2,24
Tropical Depression,Fourteen,4,2001-10-28T09:00:00Z,27.7N  44.0W,32,1,0,0,33
Tropical Depression,Fourteen,5,2001-10-28T15:00:00Z,27.7N  43.6W,42,0,0,0,42
Tropical Depression,Fourteen,5,2001-10-28T15:00:00Z,29.8N  46.3W,6,9,2,2,19
Tropical Depression,Fourteen,5,2001-10-28T15:00:00Z,28.3N  45.2W,25,1,0,1,27
Tropical Depression,Fourteen,6,2001-10-28T21:00:00Z,27.7N  45.6W,48,0,0,0,48
Tropical Depression,Fourteen,6,2001-10-28T21:00:00Z,30.0N  47.2W,8,9,3,1,21
Tropical Depression,Fourteen,6,2001-10-28T21:00:00Z,28.3N  47.1W,29,2,0,0,31
Tropical Depression,Fourteen,7,2001-10-29T03:00:00Z,27.7N  45.2W,40,0,0,0,40
Tropical Depression,Fourteen,7,2001-10-29T03:00:00Z,31.7N  45.8W,1,8,6,2,17
Tropical Depression,Fourteen,7,2001-10-29T03:00:00Z,29.3N  46.3W,18,4,1,0,23
Tropical Depression,Fourteen,8,2001-10-29T09:00:00Z,28.8N  45.3W,43,0,0,0,43
Tropical Depression,Fourteen,8,2001-10-29T09:00:00Z,34.0N  44.0W,0,2,13,3,18
Tropical Depression,Fourteen,8,2001-10-29T09:00:00Z,31.0N  46.0W,11,11,2,0,24
Tropical Depression,Fourteen,9,2001-10-29T15:00:00Z,30.0N  46.1W,37,1,0,0,38
Tropical Depression,Fourteen,9,2001-10-29T15:00:00Z,36.5N  43.0W,0,1,13,0,14
Tropical Depression,Fourteen,9,2001-10-29T15:00:00Z,32.7N  45.4W,4,16,3,0,23
Tropical Depression,Fourteen,10,2001-10-29T21:00:00Z,31.3N  45.6W,36,0,1,0,37
Tropical Depression,Fourteen,10,2001-10-29T21:00:00Z,38.5N  40.5W,0,1,15,0,16
Tropical Depression,Fourteen,10,2001-10-29T21:00:00Z,34.5N  43.8W,2,20,3,0,25
Tropical Storm,Lorenzo,11,2001-10-30T03:00:00Z,32.9N  45.4W,27,2,0,0,29
Tropical Storm,Lorenzo,11,2001-10-30T03:00:00Z,41.0N  38.0W,0,1,13,0,14
Tropical Storm,Lorenzo,11,2001-10-30T03:00:00Z,36.3N  42.5W,0,18,4,0,22
Tropical Storm,Lorenzo,12,2001-10-30T09:00:00Z,34.5N  44.0W,23,2,0,0,25
Tropical Storm,Lorenzo,12,2001-10-30T09:00:00Z,37.0N  41.0W,1,13,0,0,14
Tropical Storm,Lorenzo,13,2001-10-30T15:00:00Z,37.6N  41.9W,22,0,0,0,22
Tropical Storm,Lorenzo,14,2001-10-30T21:00:00Z,41.6N  40.5W,25,0,0,0,25
Tropical Storm,Lorenzo,15,2001-10-31T03:00:00Z,45.3N  38.0W,28,0,0,0,28
Tropical Depression,Fifteen,1,2001-10-29T21:00:00Z,14.7N  84.1W,47,0,0,0,47
Tropical Depression,Fifteen,1,2001-10-29T21:00:00Z,MZBZ 175N 883W,0,6,7,4,17
Tropical Depression,Fifteen,1,2001-10-29T21:00:00Z,15.9N  84.7W,25,4,0,0,29
Tropical Depression,Fifteen,1,2001-10-29T21:00:00Z,MGPB 157N 886W,0,3,6,4,13
Tropical Depression,Fifteen,1,2001-10-29T21:00:00Z,17.0N  85.5W,10,14,1,1,26
Tropical Depression,Fifteen,1,2001-10-29T21:00:00Z,MHNJ 165N 859W,13,11,1,1,26
Tropical Depression,Fifteen,1,2001-10-29T21:00:00Z,MKJS 185N 779W,0,0,0,2,2
Tropical Depression,Fifteen,1,2001-10-29T21:00:00Z,MNPC 141N 834W,99,0,0,0,99
Tropical Depression,Fifteen,1,2001-10-29T21:00:00Z,MWCG 193N 814W,0,0,1,7,8
Tropical Depression,Fifteen,1,2001-10-29T21:00:00Z,MNBL 120N 839W,23,1,0,0,24
Tropical Depression,Fifteen,1,2001-10-29T21:00:00Z,MUCF 221N 805W,0,0,0,3,3
Tropical Depression,Fifteen,1,2001-10-29T21:00:00Z,SKSP 126N 817W,10,1,1,0,12
Tropical Depression,Fifteen,1,2001-10-29T21:00:00Z,MUSN 216N 826W,0,0,1,6,7
Tropical Depression,Fifteen,1,2001-10-29T21:00:00Z,MMFR 185N 926W,0,0,0,5,5
Tropical Depression,Fifteen,1,2001-10-29T21:00:00Z,MUHA 230N 824W,0,0,0,4,4
Tropical Depression,Fifteen,1,2001-10-29T21:00:00Z,MMMD 210N 897W,0,0,4,7,11
Tropical Depression,Fifteen,1,2001-10-29T21:00:00Z,MUAN 219N 850W,0,0,3,7,10
Tropical Depression,Fifteen,1,2001-10-29T21:00:00Z,KEY WEST FL,0,0,0,2,2
Tropical Depression,Fifteen,1,2001-10-29T21:00:00Z,MMCZ 205N 869W,0,2,9,5,16
Tropical Depression,Fifteen,2,2001-10-30T03:00:00Z,15.6N  84.2W,54,0,0,0,54
Tropical Depression,Fifteen,2,2001-10-30T03:00:00Z,MHNJ 165N 859W,17,8,2,0,27
Tropical Depression,Fifteen,2,2001-10-30T03:00:00Z,16.6N  84.9W,26,3,1,0,30
Tropical Depression,Fifteen,2,2001-10-30T03:00:00Z,MNPC 141N 834W,99,0,0,0,99
Tropical Depression,Fifteen,2,2001-10-30T03:00:00Z,18.0N  85.1W,8,15,2,1,26
Tropical Depression,Fifteen,2,2001-10-30T03:00:00Z,MNBL 120N 839W,2,1,1,1,5
Tropical Depression,Fifteen,2,2001-10-30T03:00:00Z,MKJS 185N 779W,0,0,0,2,2
Tropical Depression,Fifteen,2,2001-10-30T03:00:00Z,SKSP 126N 817W,1,0,1,1,3
Tropical Depression,Fifteen,2,2001-10-30T03:00:00Z,MWCG 193N 814W,0,2,3,6,11
Tropical Depression,Fifteen,2,2001-10-30T03:00:00Z,MMFR 185N 926W,0,0,0,4,4
Tropical Depression,Fifteen,2,2001-10-30T03:00:00Z,MUCM 214N 779W,0,0,0,2,2
Tropical Depression,Fifteen,2,2001-10-30T03:00:00Z,MMMD 210N 897W,0,0,3,8,11
Tropical Depression,Fifteen,2,2001-10-30T03:00:00Z,MUCF 221N 805W,0,0,1,5,6
Tropical Depression,Fifteen,2,2001-10-30T03:00:00Z,MARATHON FL,0,0,0,4,4
Tropical Depression,Fifteen,2,2001-10-30T03:00:00Z,MUSN 216N 826W,0,0,5,7,12
Tropical Depression,Fifteen,2,2001-10-30T03:00:00Z,MIAMI FL,0,0,0,2,2
Tropical Depression,Fifteen,2,2001-10-30T03:00:00Z,MUHA 230N 824W,0,0,2,7,9
Tropical Depression,Fifteen,2,2001-10-30T03:00:00Z,KEY WEST FL,0,0,0,5,5
Tropical Depression,Fifteen,2,2001-10-30T03:00:00Z,MUAN 219N 850W,0,1,8,7,16
Tropical Depression,Fifteen,2,2001-10-30T03:00:00Z,MARCO ISLAND FL,0,0,0,3,3
Tropical Depression,Fifteen,2,2001-10-30T03:00:00Z,MMCZ 205N 869W,0,4,10,5,19
Tropical Depression,Fifteen,2,2001-10-30T03:00:00Z,FT MYERS FL,0,0,0,2,2
Tropical Depression,Fifteen,2,2001-10-30T03:00:00Z,MZBZ 175N 883W,0,7,7,3,17
Tropical Depression,Fifteen,2,2001-10-30T03:00:00Z,VENICE FL,0,0,0,2,2
Tropical Depression,Fifteen,2,2001-10-30T03:00:00Z,MGPB 157N 886W,0,5,5,3,13
Tropical Depression,Fifteen,3,2001-10-30T09:00:00Z,16.0N  85.0W,56,0,0,0,56
Tropical Depression,Fifteen,3,2001-10-30T09:00:00Z,MHNJ 165N 859W,31,1,0,0,32
Tropical Depression,Fifteen,3,2001-10-30T09:00:00Z,17.2N  85.3W,28,1,1,0,30
Tropical Depression,Fifteen,3,2001-10-30T09:00:00Z,MNPC 141N 834W,99,0,0,0,99
Tropical Depression,Fifteen,3,2001-10-30T09:00:00Z,18.3N  85.4W,13,11,1,1,26
Tropical Depression,Fifteen,3,2001-10-30T09:00:00Z,MNBL 120N 839W,0,1,0,1,2
Tropical Depression,Fifteen,3,2001-10-30T09:00:00Z,MKJS 185N 779W,0,0,0,2,2
Tropical Depression,Fifteen,3,2001-10-30T09:00:00Z,MMFR 185N 926W,0,0,0,5,5
Tropical Depression,Fifteen,3,2001-10-30T09:00:00Z,MWCG 193N 814W,0,1,4,5,10
Tropical Depression,Fifteen,3,2001-10-30T09:00:00Z,MMMD 210N 897W,0,0,5,7,12
Tropical Depression,Fifteen,3,2001-10-30T09:00:00Z,MUCM 214N 779W,0,0,0,2,2
Tropical Depression,Fifteen,3,2001-10-30T09:00:00Z,MARATHON FL,0,0,0,4,4
Tropical Depression,Fifteen,3,2001-10-30T09:00:00Z,MUCF 221N 805W,0,0,1,5,6
Tropical Depression,Fifteen,3,2001-10-30T09:00:00Z,MIAMI FL,0,0,0,2,2
Tropical Depression,Fifteen,3,2001-10-30T09:00:00Z,MUSN 216N 826W,0,1,4,7,12
Tropical Depression,Fifteen,3,2001-10-30T09:00:00Z,KEY WEST FL,0,0,0,5,5
Tropical Depression,Fifteen,3,2001-10-30T09:00:00Z,MUHA 230N 824W,0,0,2,7,9
Tropical Depression,Fifteen,3,2001-10-30T09:00:00Z,MARCO ISLAND FL,0,0,0,3,3
Tropical Depression,Fifteen,3,2001-10-30T09:00:00Z,MUAN 219N 850W,0,2,8,6,16
Tropical Depression,Fifteen,3,2001-10-30T09:00:00Z,FT MYERS FL,0,0,0,2,2
Tropical Depression,Fifteen,3,2001-10-30T09:00:00Z,MMCZ 205N 869W,0,8,7,4,19
Tropical Depression,Fifteen,3,2001-10-30T09:00:00Z,VENICE FL,0,0,0,2,2
Tropical Depression,Fifteen,3,2001-10-30T09:00:00Z,MZBZ 175N 883W,2,10,3,3,18
Tropical Depression,Fifteen,3,2001-10-30T09:00:00Z,GULF 28N 89W,0,0,0,2,2
Tropical Depression,Fifteen,3,2001-10-30T09:00:00Z,MGPB 157N 886W,1,6,3,3,13
Tropical Depression,Fifteen,4,2001-10-30T15:00:00Z,15.9N  85.0W,47,0,0,0,47
Tropical Depression,Fifteen,4,2001-10-30T15:00:00Z,MZBZ 175N 883W,3,8,4,2,17
Tropical Depression,Fifteen,4,2001-10-30T15:00:00Z,16.9N  85.2W,30,1,1,0,32
Tropical Depression,Fifteen,4,2001-10-30T15:00:00Z,MGPB 157N 886W,1,4,3,3,11
Tropical Depression,Fifteen,4,2001-10-30T15:00:00Z,18.0N  85.4W,15,8,1,1,25
Tropical Depression,Fifteen,4,2001-10-30T15:00:00Z,MHNJ 165N 859W,34,0,1,0,35
Tropical Depression,Fifteen,4,2001-10-30T15:00:00Z,MKJS 185N 779W,0,0,0,2,2
Tropical Depression,Fifteen,4,2001-10-30T15:00:00Z,MNPC 141N 834W,99,0,0,0,99
Tropical Depression,Fifteen,4,2001-10-30T15:00:00Z,MWCG 193N 814W,0,0,3,6,9
Tropical Depression,Fifteen,4,2001-10-30T15:00:00Z,MNBL 120N 839W,4,1,1,0,6
Tropical Depression,Fifteen,4,2001-10-30T15:00:00Z,MUCM 214N 779W,0,0,0,2,2
Tropical Depression,Fifteen,4,2001-10-30T15:00:00Z,SKSP 126N 817W,0,1,1,1,3
Tropical Depression,Fifteen,4,2001-10-30T15:00:00Z,MUCF 221N 805W,0,0,0,5,5
Tropical Depression,Fifteen,4,2001-10-30T15:00:00Z,MMFR 185N 926W,0,0,0,4,4
Tropical Depression,Fifteen,4,2001-10-30T15:00:00Z,MUSN 216N 826W,0,0,2,8,10
Tropical Depression,Fifteen,4,2001-10-30T15:00:00Z,MMMD 210N 897W,0,1,4,7,12
Tropical Depression,Fifteen,4,2001-10-30T15:00:00Z,MUHA 230N 824W,0,0,0,7,7
Tropical Depression,Fifteen,4,2001-10-30T15:00:00Z,MARATHON FL,0,0,0,3,3
Tropical Depression,Fifteen,4,2001-10-30T15:00:00Z,MUAN 219N 850W,0,1,5,7,13
Tropical Depression,Fifteen,4,2001-10-30T15:00:00Z,KEY WEST FL,0,0,0,3,3
Tropical Depression,Fifteen,4,2001-10-30T15:00:00Z,MMCZ 205N 869W,0,7,7,4,18
Tropical Depression,Fifteen,4,2001-10-30T15:00:00Z,MARCO ISLAND FL,0,0,0,2,2
Tropical Depression,Fifteen,5,2001-10-30T21:00:00Z,14.7N  83.8W,56,0,0,0,56
Tropical Depression,Fifteen,5,2001-10-30T21:00:00Z,MZBZ 175N 883W,0,1,7,6,14
Tropical Depression,Fifteen,5,2001-10-30T21:00:00Z,15.9N  84.1W,28,2,0,1,31
Tropical Depression,Fifteen,5,2001-10-30T21:00:00Z,MGPB 157N 886W,0,1,5,5,11
Tropical Depression,Fifteen,5,2001-10-30T21:00:00Z,17.2N  84.4W,11,12,2,1,26
Tropical Depression,Fifteen,5,2001-10-30T21:00:00Z,MHNJ 165N 859W,7,12,3,1,23
Tropical Depression,Fifteen,5,2001-10-30T21:00:00Z,MKJP 179N 768W,0,0,0,2,2
Tropical Depression,Fifteen,5,2001-10-30T21:00:00Z,MNPC 141N 834W,99,0,0,0,99
Tropical Depression,Fifteen,5,2001-10-30T21:00:00Z,MKJS 185N 779W,0,0,0,3,3
Tropical Depression,Fifteen,5,2001-10-30T21:00:00Z,MNBL 120N 839W,99,0,0,0,99
Tropical Depression,Fifteen,5,2001-10-30T21:00:00Z,MWCG 193N 814W,0,1,5,6,12
Tropical Depression,Fifteen,5,2001-10-30T21:00:00Z,SKSP 126N 817W,10,1,1,0,12
Tropical Depression,Fifteen,5,2001-10-30T21:00:00Z,MUCM 214N 779W,0,0,0,2,2
Tropical Depression,Fifteen,5,2001-10-30T21:00:00Z,MRLM 100N 831W,1,0,1,0,2
Tropical Depression,Fifteen,5,2001-10-30T21:00:00Z,MUCF 221N 805W,0,0,0,5,5
Tropical Depression,Fifteen,5,2001-10-30T21:00:00Z,MMFR 185N 926W,0,0,0,3,3
Tropical Depression,Fifteen,5,2001-10-30T21:00:00Z,MUSN 216N 826W,0,0,4,6,10
Tropical Depression,Fifteen,5,2001-10-30T21:00:00Z,MMMD 210N 897W,0,0,1,7,8
Tropical Depression,Fifteen,5,2001-10-30T21:00:00Z,MUHA 230N 824W,0,0,1,5,6
Tropical Depression,Fifteen,5,2001-10-30T21:00:00Z,MARATHON FL,0,0,0,2,2
Tropical Depression,Fifteen,5,2001-10-30T21:00:00Z,MUAN 219N 850W,0,0,5,7,12
Tropical Depression,Fifteen,5,2001-10-30T21:00:00Z,KEY WEST FL,0,0,0,3,3
Tropical Depression,Fifteen,5,2001-10-30T21:00:00Z,MMCZ 205N 869W,0,1,7,6,14
Tropical Depression,Fifteen,6,2001-10-31T03:00:00Z,15.6N  84.0W,62,0,0,0,62
Tropical Depression,Fifteen,6,2001-10-31T03:00:00Z,MHNJ 165N 859W,16,6,2,0,24
Tropical Depression,Fifteen,6,2001-10-31T03:00:00Z,16.7N  84.3W,33,1,1,0,35
Tropical Depression,Fifteen,6,2001-10-31T03:00:00Z,MNPC 141N 834W,99,0,0,0,99
Tropical Depression,Fifteen,6,2001-10-31T03:00:00Z,17.8N  84.4W,12,14,2,0,28
Tropical Depression,Fifteen,6,2001-10-31T03:00:00Z,MNBL 120N 839W,0,1,1,2,4
Tropical Depression,Fifteen,6,2001-10-31T03:00:00Z,MKJP 179N 768W,0,0,0,2,2
Tropical Depression,Fifteen,6,2001-10-31T03:00:00Z,SKSP 126N 817W,0,1,0,2,3
Tropical Depression,Fifteen,6,2001-10-31T03:00:00Z,MKJS 185N 779W,0,0,0,4,4
Tropical Depression,Fifteen,6,2001-10-31T03:00:00Z,MYAK 241N 776W,0,0,0,2,2
Tropical Depression,Fifteen,6,2001-10-31T03:00:00Z,MWCG 193N 814W,0,2,6,5,13
Tropical Depression,Fifteen,6,2001-10-31T03:00:00Z,MMFR 185N 926W,0,0,0,2,2
Tropical Depression,Fifteen,6,2001-10-31T03:00:00Z,MUCM 214N 779W,0,0,0,3,3
Tropical Depression,Fifteen,6,2001-10-31T03:00:00Z,MMMD 210N 897W,0,0,1,7,8
Tropical Depression,Fifteen,6,2001-10-31T03:00:00Z,MUCF 221N 805W,0,0,1,7,8
Tropical Depression,Fifteen,6,2001-10-31T03:00:00Z,MARATHON FL,0,0,0,4,4
Tropical Depression,Fifteen,6,2001-10-31T03:00:00Z,MUSN 216N 826W,0,0,6,7,13
Tropical Depression,Fifteen,6,2001-10-31T03:00:00Z,MIAMI FL,0,0,0,2,2
Tropical Depression,Fifteen,6,2001-10-31T03:00:00Z,MUHA 230N 824W,0,0,2,8,10
Tropical Depression,Fifteen,6,2001-10-31T03:00:00Z,KEY WEST FL,0,0,0,6,6
Tropical Depression,Fifteen,6,2001-10-31T03:00:00Z,MUAN 219N 850W,0,1,7,7,15
Tropical Depression,Fifteen,6,2001-10-31T03:00:00Z,MARCO ISLAND FL,0,0,0,3,3
Tropical Depression,Fifteen,6,2001-10-31T03:00:00Z,MMCZ 205N 869W,0,2,9,5,16
Tropical Depression,Fifteen,6,2001-10-31T03:00:00Z,FT MYERS FL,0,0,0,2,2
Tropical Depression,Fifteen,6,2001-10-31T03:00:00Z,MZBZ 175N 883W,0,2,6,5,13
Tropical Depression,Fifteen,6,2001-10-31T03:00:00Z,VENICE FL,0,0,0,2,2
Tropical Depression,Fifteen,6,2001-10-31T03:00:00Z,MGPB 157N 886W,0,1,3,4,8
Tropical Depression,Fifteen,7,2001-10-31T09:00:00Z,15.4N  84.3W,61,0,0,0,61
Tropical Depression,Fifteen,7,2001-10-31T09:00:00Z,MZBZ 175N 883W,0,4,6,5,15
Tropical Depression,Fifteen,7,2001-10-31T09:00:00Z,16.3N  84.5W,32,0,1,0,33
Tropical Depression,Fifteen,7,2001-10-31T09:00:00Z,MGPB 157N 886W,0,2,5,4,11
Tropical Depression,Fifteen,7,2001-10-31T09:00:00Z,17.4N  84.7W,18,5,2,1,26
Tropical Depression,Fifteen,7,2001-10-31T09:00:00Z,MHNJ 165N 859W,19,4,2,1,26
Tropical Depression,Fifteen,7,2001-10-31T09:00:00Z,MKJS 185N 779W,0,0,0,3,3
Tropical Depression,Fifteen,7,2001-10-31T09:00:00Z,MNPC 141N 834W,99,0,0,0,99
Tropical Depression,Fifteen,7,2001-10-31T09:00:00Z,MWCG 193N 814W,0,1,4,6,11
Tropical Depression,Fifteen,7,2001-10-31T09:00:00Z,MNBL 120N 839W,6,3,1,1,11
Tropical Depression,Fifteen,7,2001-10-31T09:00:00Z,MUCM 214N 779W,0,0,0,2,2
Tropical Depression,Fifteen,7,2001-10-31T09:00:00Z,SKSP 126N 817W,2,2,1,1,6
Tropical Depression,Fifteen,7,2001-10-31T09:00:00Z,MUCF 221N 805W,0,0,0,5,5
Tropical Depression,Fifteen,7,2001-10-31T09:00:00Z,MMFR 185N 926W,0,0,0,4,4
Tropical Depression,Fifteen,7,2001-10-31T09:00:00Z,MUSN 216N 826W,0,0,3,7,10
Tropical Depression,Fifteen,7,2001-10-31T09:00:00Z,MMMD 210N 897W,0,0,1,8,9
Tropical Depression,Fifteen,7,2001-10-31T09:00:00Z,MUHA 230N 824W,0,0,1,6,7
Tropical Depression,Fifteen,7,2001-10-31T09:00:00Z,MARATHON FL,0,0,0,3,3
Tropical Depression,Fifteen,7,2001-10-31T09:00:00Z,MUAN 219N 850W,0,1,5,7,13
Tropical Depression,Fifteen,7,2001-10-31T09:00:00Z,KEY WEST FL,0,0,0,3,3
Tropical Depression,Fifteen,7,2001-10-31T09:00:00Z,MMCZ 205N 869W,0,3,7,6,16
Tropical Depression,Fifteen,7,2001-10-31T09:00:00Z,MARCO ISLAND FL,0,0,0,2,2
Tropical Depression,Fifteen,8,2001-10-31T15:00:00Z,16.4N  84.1W,52,0,0,0,52
Tropical Depression,Fifteen,8,2001-10-31T15:00:00Z,MHNJ 165N 859W,22,1,1,1,25
Tropical Depression,Fifteen,8,2001-10-31T15:00:00Z,17.3N  84.5W,30,1,0,0,31
Tropical Depression,Fifteen,8,2001-10-31T15:00:00Z,MNPC 141N 834W,99,0,0,0,99
Tropical Depression,Fifteen,8,2001-10-31T15:00:00Z,18.3N  84.9W,12,11,2,1,26
Tropical Depression,Fifteen,8,2001-10-31T15:00:00Z,MNBL 120N 839W,0,0,1,1,2
Tropical Depression,Fifteen,8,2001-10-31T15:00:00Z,MKJS 185N 779W,0,0,0,2,2
Tropical Depression,Fifteen,8,2001-10-31T15:00:00Z,SKSP 126N 817W,0,0,1,1,2
Tropical Depression,Fifteen,8,2001-10-31T15:00:00Z,MWCG 193N 814W,0,2,4,5,11
Tropical Depression,Fifteen,8,2001-10-31T15:00:00Z,MMFR 185N 926W,0,0,0,3,3
Tropical Depression,Fifteen,8,2001-10-31T15:00:00Z,MUCM 214N 779W,0,0,0,2,2
Tropical Depression,Fifteen,8,2001-10-31T15:00:00Z,MMMD 210N 897W,0,0,3,8,11
Tropical Depression,Fifteen,8,2001-10-31T15:00:00Z,MUCF 221N 805W,0,0,1,5,6
Tropical Depression,Fifteen,8,2001-10-31T15:00:00Z,MARATHON FL,0,0,0,4,4
Tropical Depression,Fifteen,8,2001-10-31T15:00:00Z,MUSN 216N 826W,0,1,5,6,12
Tropical Depression,Fifteen,8,2001-10-31T15:00:00Z,MIAMI FL,0,0,0,2,2
Tropical Depression,Fifteen,8,2001-10-31T15:00:00Z,MUHA 230N 824W,0,0,2,7,9
Tropical Depression,Fifteen,8,2001-10-31T15:00:00Z,KEY WEST FL,0,0,0,5,5
Tropical Depression,Fifteen,8,2001-10-31T15:00:00Z,MUAN 219N 850W,0,2,8,6,16
Tropical Depression,Fifteen,8,2001-10-31T15:00:00Z,MARCO ISLAND FL,0,0,0,3,3
Tropical Depression,Fifteen,8,2001-10-31T15:00:00Z,MMCZ 205N 869W,0,7,6,5,18
Tropical Depression,Fifteen,8,2001-10-31T15:00:00Z,FT MYERS FL,0,0,0,2,2
Tropical Depression,Fifteen,8,2001-10-31T15:00:00Z,MZBZ 175N 883W,1,3,4,5,13
Tropical Depression,Fifteen,8,2001-10-31T15:00:00Z,VENICE FL,0,0,0,2,2
Tropical Depression,Fifteen,8,2001-10-31T15:00:00Z,MGPB 157N 886W,0,1,2,5,8
Tropical Depression,Fifteen,8,2001-10-31T15:00:00Z,GULF 28N 89W,0,0,0,2,2
Tropical Depression,Fifteen,9,2001-10-31T21:00:00Z,16.9N  83.8W,60,0,0,0,60
Tropical Depression,Fifteen,9,2001-10-31T21:00:00Z,MHNJ 165N 859W,9,4,3,1,17
Tropical Depression,Fifteen,9,2001-10-31T21:00:00Z,17.9N  84.2W,34,0,1,0,35
Tropical Depression,Fifteen,9,2001-10-31T21:00:00Z,MNPC 141N 834W,99,0,0,0,99
Tropical Depression,Fifteen,9,2001-10-31T21:00:00Z,18.8N  84.5W,18,9,1,1,29
Tropical Depression,Fifteen,9,2001-10-31T21:00:00Z,MMFR 185N 926W,0,0,0,2,2
Tropical Depression,Fifteen,9,2001-10-31T21:00:00Z,MKJS 185N 779W,0,0,0,3,3
Tropical Depression,Fifteen,9,2001-10-31T21:00:00Z,MMMD 210N 897W,0,0,1,8,9
Tropical Depression,Fifteen,9,2001-10-31T21:00:00Z,MWCG 193N 814W,0,6,4,4,14
Tropical Depression,Fifteen,9,2001-10-31T21:00:00Z,MARATHON FL,0,0,0,5,5
Tropical Depression,Fifteen,9,2001-10-31T21:00:00Z,MUCM 214N 779W,0,0,0,3,3
Tropical Depression,Fifteen,9,2001-10-31T21:00:00Z,MIAMI FL,0,0,0,3,3
Tropical Depression,Fifteen,9,2001-10-31T21:00:00Z,MUCF 221N 805W,0,0,2,6,8
Tropical Depression,Fifteen,9,2001-10-31T21:00:00Z,W PALM BEACH FL,0,0,0,2,2
Tropical Depression,Fifteen,9,2001-10-31T21:00:00Z,MUSN 216N 826W,0,3,7,5,15
Tropical Depression,Fifteen,9,2001-10-31T21:00:00Z,KEY WEST FL,0,0,1,6,7
Tropical Depression,Fifteen,9,2001-10-31T21:00:00Z,MUHA 230N 824W,0,0,4,7,11
Tropical Depression,Fifteen,9,2001-10-31T21:00:00Z,MARCO ISLAND FL,0,0,0,4,4
Tropical Depression,Fifteen,9,2001-10-31T21:00:00Z,MUAN 219N 850W,0,5,8,4,17
Tropical Depression,Fifteen,9,2001-10-31T21:00:00Z,FT MYERS FL,0,0,0,3,3
Tropical Depression,Fifteen,9,2001-10-31T21:00:00Z,MMCZ 205N 869W,0,6,7,5,18
Tropical Depression,Fifteen,9,2001-10-31T21:00:00Z,VENICE FL,0,0,0,3,3
Tropical Depression,Fifteen,9,2001-10-31T21:00:00Z,MZBZ 175N 883W,0,1,4,5,10
Tropical Depression,Fifteen,9,2001-10-31T21:00:00Z,GULF 28N 89W,0,0,0,2,2
Tropical Depression,Fifteen,9,2001-10-31T21:00:00Z,MGPB 157N 886W,0,0,1,4,5
Tropical Storm,Michelle,10,2001-11-01T03:00:00Z,18.0N  83.8W,55,0,0,0,55
Tropical Storm,Michelle,10,2001-11-01T03:00:00Z,MMMD 210N 897W,0,0,1,8,9
Tropical Storm,Michelle,10,2001-11-01T03:00:00Z,18.9N  84.1W,36,1,0,0,37
Tropical Storm,Michelle,10,2001-11-01T03:00:00Z,MARATHON FL,0,0,1,7,8
Tropical Storm,Michelle,10,2001-11-01T03:00:00Z,20.0N  84.4W,18,9,1,1,29
Tropical Storm,Michelle,10,2001-11-01T03:00:00Z,MIAMI FL,0,0,0,5,5
Tropical Storm,Michelle,10,2001-11-01T03:00:00Z,MKJS 185N 779W,0,0,0,2,2
Tropical Storm,Michelle,10,2001-11-01T03:00:00Z,W PALM BEACH FL,0,0,0,3,3
Tropical Storm,Michelle,10,2001-11-01T03:00:00Z,MWCG 193N 814W,2,7,3,3,15
Tropical Storm,Michelle,10,2001-11-01T03:00:00Z,FT PIERCE FL,0,0,0,2,2
Tropical Storm,Michelle,10,2001-11-01T03:00:00Z,MUCM 214N 779W,0,0,0,3,3
Tropical Storm,Michelle,10,2001-11-01T03:00:00Z,COCOA BEACH FL,0,0,0,2,2
Tropical Storm,Michelle,10,2001-11-01T03:00:00Z,MUCF 221N 805W,0,0,3,7,10
Tropical Storm,Michelle,10,2001-11-01T03:00:00Z,KEY WEST FL,0,0,3,7,10
Tropical Storm,Michelle,10,2001-11-01T03:00:00Z,MUSN 216N 826W,0,9,6,3,18
Tropical Storm,Michelle,10,2001-11-01T03:00:00Z,MARCO ISLAND FL,0,0,1,6,7
Tropical Storm,Michelle,10,2001-11-01T03:00:00Z,MUHA 230N 824W,0,2,7,6,15
Tropical Storm,Michelle,10,2001-11-01T03:00:00Z,FT MYERS FL,0,0,0,6,6
Tropical Storm,Michelle,10,2001-11-01T03:00:00Z,MUAN 219N 850W,1,13,5,3,22
Tropical Storm,Michelle,10,2001-11-01T03:00:00Z,VENICE FL,0,0,0,5,5
Tropical Storm,Michelle,10,2001-11-01T03:00:00Z,MMCZ 205N 869W,1,8,5,4,18
Tropical Storm,Michelle,10,2001-11-01T03:00:00Z,TAMPA FL,0,0,0,3,3
Tropical Storm,Michelle,10,2001-11-01T03:00:00Z,MZBZ 175N 883W,0,0,3,4,7
Tropical Storm,Michelle,10,2001-11-01T03:00:00Z,CEDAR KEY FL,0,0,0,2,2
Tropical Storm,Michelle,10,2001-11-01T03:00:00Z,MGPB 157N 886W,0,0,0,3,3
Tropical Storm,Michelle,10,2001-11-01T03:00:00Z,APALACHICOLA FL,0,0,0,2,2
Tropical Storm,Michelle,10,2001-11-01T03:00:00Z,MHNJ 165N 859W,4,3,3,2,12
Tropical Storm,Michelle,10,2001-11-01T03:00:00Z,GULF 29N 85W,0,0,0,3,3
Tropical Storm,Michelle,10,2001-11-01T03:00:00Z,MNPC 141N 834W,0,1,1,1,3
Tropical Storm,Michelle,10,2001-11-01T03:00:00Z,GULF 29N 87W,0,0,0,2,2
Tropical Storm,Michelle,10,2001-11-01T03:00:00Z,MYAK 241N 776W,0,0,0,2,2
Tropical Storm,Michelle,10,2001-11-01T03:00:00Z,GULF 28N 89W,0,0,0,3,3
Tropical Storm,Michelle,10,2001-11-01T03:00:00Z,MYNN 251N 775W,0,0,0,2,2
Tropical Storm,Michelle,10,2001-11-01T03:00:00Z,GULF 28N 91W,0,0,0,2,2
Tropical Storm,Michelle,10,2001-11-01T03:00:00Z,MYGF 266N 787W,0,0,0,2,2
Tropical Storm,Michelle,11,2001-11-01T09:00:00Z,18.4N  84.3W,57,0,0,0,57
Tropical Storm,Michelle,11,2001-11-01T09:00:00Z,MYGF 266N 787W,0,0,0,2,2
Tropical Storm,Michelle,11,2001-11-01T09:00:00Z,19.3N  84.5W,36,1,0,0,37
Tropical Storm,Michelle,11,2001-11-01T09:00:00Z,MMFR 185N 926W,0,0,0,2,2
Tropical Storm,Michelle,11,2001-11-01T09:00:00Z,20.0N  84.5W,24,3,0,1,28
Tropical Storm,Michelle,11,2001-11-01T09:00:00Z,MMMD 210N 897W,0,1,3,7,11
Tropical Storm,Michelle,11,2001-11-01T09:00:00Z,MKJS 185N 779W,0,0,0,2,2
Tropical Storm,Michelle,11,2001-11-01T09:00:00Z,MARATHON FL,0,0,1,7,8
Tropical Storm,Michelle,11,2001-11-01T09:00:00Z,MWCG 193N 814W,6,4,2,3,15
Tropical Storm,Michelle,11,2001-11-01T09:00:00Z,MIAMI FL,0,0,0,5,5
Tropical Storm,Michelle,11,2001-11-01T09:00:00Z,MUCM 214N 779W,0,0,0,4,4
Tropical Storm,Michelle,11,2001-11-01T09:00:00Z,W PALM BEACH FL,0,0,0,3,3
Tropical Storm,Michelle,11,2001-11-01T09:00:00Z,MUCF 221N 805W,0,1,3,6,10
Tropical Storm,Michelle,11,2001-11-01T09:00:00Z,FT PIERCE FL,0,0,0,2,2
Tropical Storm,Michelle,11,2001-11-01T09:00:00Z,MUSN 216N 826W,2,8,4,4,18
Tropical Storm,Michelle,11,2001-11-01T09:00:00Z,COCOA BEACH FL,0,0,0,2,2
Tropical Storm,Michelle,11,2001-11-01T09:00:00Z,MUHA 230N 824W,0,3,6,5,14
Tropical Storm,Michelle,11,2001-11-01T09:00:00Z,KEY WEST FL,0,0,3,7,10
Tropical Storm,Michelle,11,2001-11-01T09:00:00Z,MUAN 219N 850W,3,12,4,2,21
Tropical Storm,Michelle,11,2001-11-01T09:00:00Z,MARCO ISLAND FL,0,0,1,5,6
Tropical Storm,Michelle,11,2001-11-01T09:00:00Z,MMCZ 205N 869W,4,10,4,2,20
Tropical Storm,Michelle,11,2001-11-01T09:00:00Z,FT MYERS FL,0,0,0,5,5
Tropical Storm,Michelle,11,2001-11-01T09:00:00Z,MZBZ 175N 883W,0,3,4,4,11
Tropical Storm,Michelle,11,2001-11-01T09:00:00Z,VENICE FL,0,0,0,5,5
Tropical Storm,Michelle,11,2001-11-01T09:00:00Z,MGPB 157N 886W,0,0,2,3,5
Tropical Storm,Michelle,11,2001-11-01T09:00:00Z,TAMPA FL,0,0,0,3,3
Tropical Storm,Michelle,11,2001-11-01T09:00:00Z,MHNJ 165N 859W,16,1,1,1,19
Tropical Storm,Michelle,11,2001-11-01T09:00:00Z,CEDAR KEY FL,0,0,0,2,2
Tropical Storm,Michelle,11,2001-11-01T09:00:00Z,MNPC 141N 834W,0,1,0,2,3
Tropical Storm,Michelle,11,2001-11-01T09:00:00Z,GULF 29N 85W,0,0,0,2,2
Tropical Storm,Michelle,11,2001-11-01T09:00:00Z,MYAK 241N 776W,0,0,0,2,2
Tropical Storm,Michelle,11,2001-11-01T09:00:00Z,GULF 29N 87W,0,0,0,2,2
Tropical Storm,Michelle,11,2001-11-01T09:00:00Z,MYNN 251N 775W,0,0,0,2,2
Tropical Storm,Michelle,11,2001-11-01T09:00:00Z,GULF 28N 89W,0,0,0,3,3
Tropical Storm,Michelle,12,2001-11-01T15:00:00Z,19.0N  84.9W,56,1,0,0,57
Tropical Storm,Michelle,12,2001-11-01T15:00:00Z,MMMD 210N 897W,0,2,5,5,12
Tropical Storm,Michelle,12,2001-11-01T15:00:00Z,19.8N  85.0W,37,1,0,0,38
Tropical Storm,Michelle,12,2001-11-01T15:00:00Z,MARATHON FL,0,0,1,7,8
Tropical Storm,Michelle,12,2001-11-01T15:00:00Z,20.5N  85.0W,24,2,1,1,28
Tropical Storm,Michelle,12,2001-11-01T15:00:00Z,MIAMI FL,0,0,0,5,5
Tropical Storm,Michelle,12,2001-11-01T15:00:00Z,MKJS 185N 779W,0,0,0,2,2
Tropical Storm,Michelle,12,2001-11-01T15:00:00Z,W PALM BEACH FL,0,0,0,3,3
Tropical Storm,Michelle,12,2001-11-01T15:00:00Z,MWCG 193N 814W,4,2,2,4,12
Tropical Storm,Michelle,12,2001-11-01T15:00:00Z,FT PIERCE FL,0,0,0,3,3
Tropical Storm,Michelle,12,2001-11-01T15:00:00Z,MUCM 214N 779W,0,0,0,3,3
Tropical Storm,Michelle,12,2001-11-01T15:00:00Z,COCOA BEACH FL,0,0,0,2,2
Tropical Storm,Michelle,12,2001-11-01T15:00:00Z,MUCF 221N 805W,0,0,3,6,9
Tropical Storm,Michelle,12,2001-11-01T15:00:00Z,KEY WEST FL,0,0,3,7,10
Tropical Storm,Michelle,12,2001-11-01T15:00:00Z,MUSN 216N 826W,3,6,4,4,17
Tropical Storm,Michelle,12,2001-11-01T15:00:00Z,MARCO ISLAND FL,0,0,1,6,7
Tropical Storm,Michelle,12,2001-11-01T15:00:00Z,MUHA 230N 824W,0,3,5,6,14
Tropical Storm,Michelle,12,2001-11-01T15:00:00Z,FT MYERS FL,0,0,0,6,6
Tropical Storm,Michelle,12,2001-11-01T15:00:00Z,MUAN 219N 850W,6,11,3,2,22
Tropical Storm,Michelle,12,2001-11-01T15:00:00Z,VENICE FL,0,0,0,5,5
Tropical Storm,Michelle,12,2001-11-01T15:00:00Z,MMCZ 205N 869W,11,8,2,2,23
Tropical Storm,Michelle,12,2001-11-01T15:00:00Z,TAMPA FL,0,0,0,4,4
Tropical Storm,Michelle,12,2001-11-01T15:00:00Z,MZBZ 175N 883W,1,4,2,4,11
Tropical Storm,Michelle,12,2001-11-01T15:00:00Z,CEDAR KEY FL,0,0,0,2,2
Tropical Storm,Michelle,12,2001-11-01T15:00:00Z,MGPB 157N 886W,0,0,1,3,4
Tropical Storm,Michelle,12,2001-11-01T15:00:00Z,APALACHICOLA FL,0,0,0,2,2
Tropical Storm,Michelle,12,2001-11-01T15:00:00Z,MHNJ 165N 859W,23,1,0,0,24
Tropical Storm,Michelle,12,2001-11-01T15:00:00Z,PANAMA CITY FL,0,0,0,2,2
Tropical Storm,Michelle,12,2001-11-01T15:00:00Z,MNPC 141N 834W,0,0,0,2,2
Tropical Storm,Michelle,12,2001-11-01T15:00:00Z,GULF 29N 85W,0,0,0,3,3
Tropical Storm,Michelle,12,2001-11-01T15:00:00Z,MYAK 241N 776W,0,0,0,3,3
Tropical Storm,Michelle,12,2001-11-01T15:00:00Z,GULF 29N 87W,0,0,0,3,3
Tropical Storm,Michelle,12,2001-11-01T15:00:00Z,MYNN 251N 775W,0,0,0,2,2
Tropical Storm,Michelle,12,2001-11-01T15:00:00Z,GULF 28N 89W,0,0,0,3,3
Tropical Storm,Michelle,12,2001-11-01T15:00:00Z,MYGF 266N 787W,0,0,0,2,2
Tropical Storm,Michelle,12,2001-11-01T15:00:00Z,GULF 28N 91W,0,0,0,2,2
Tropical Storm,Michelle,12,2001-11-01T15:00:00Z,MMFR 185N 926W,0,0,0,2,2
Tropical Storm,Michelle,13,2001-11-01T21:00:00Z,18.4N  84.6W,61,0,0,0,61
Tropical Storm,Michelle,13,2001-11-01T21:00:00Z,MMMD 210N 897W,0,1,4,5,10
Tropical Storm,Michelle,13,2001-11-01T21:00:00Z,19.4N  84.7W,31,1,1,0,33
Tropical Storm,Michelle,13,2001-11-01T21:00:00Z,MARATHON FL,0,0,0,8,8
Tropical Storm,Michelle,13,2001-11-01T21:00:00Z,20.5N  84.5W,10,11,2,1,24
Tropical Storm,Michelle,13,2001-11-01T21:00:00Z,MIAMI FL,0,0,0,5,5
Tropical Storm,Michelle,13,2001-11-01T21:00:00Z,MKJS 185N 779W,0,0,0,3,3
Tropical Storm,Michelle,13,2001-11-01T21:00:00Z,W PALM BEACH FL,0,0,0,3,3
Tropical Storm,Michelle,13,2001-11-01T21:00:00Z,MWCG 193N 814W,0,3,5,5,13
Tropical Storm,Michelle,13,2001-11-01T21:00:00Z,FT PIERCE FL,0,0,0,2,2
Tropical Storm,Michelle,13,2001-11-01T21:00:00Z,MUCM 214N 779W,0,0,0,4,4
Tropical Storm,Michelle,13,2001-11-01T21:00:00Z,COCOA BEACH FL,0,0,0,2,2
Tropical Storm,Michelle,13,2001-11-01T21:00:00Z,MUCF 221N 805W,0,0,2,8,10
Tropical Storm,Michelle,13,2001-11-01T21:00:00Z,KEY WEST FL,0,0,1,8,9
Tropical Storm,Michelle,13,2001-11-01T21:00:00Z,MUSN 216N 826W,0,3,7,6,16
Tropical Storm,Michelle,13,2001-11-01T21:00:00Z,MARCO ISLAND FL,0,0,0,6,6
Tropical Storm,Michelle,13,2001-11-01T21:00:00Z,MUHA 230N 824W,0,0,5,8,13
Tropical Storm,Michelle,13,2001-11-01T21:00:00Z,FT MYERS FL,0,0,0,5,5
Tropical Storm,Michelle,13,2001-11-01T21:00:00Z,MUAN 219N 850W,0,12,6,3,21
Tropical Storm,Michelle,13,2001-11-01T21:00:00Z,VENICE FL,0,0,0,5,5
Tropical Storm,Michelle,13,2001-11-01T21:00:00Z,MMCZ 205N 869W,5,13,3,1,22
Tropical Storm,Michelle,13,2001-11-01T21:00:00Z,TAMPA FL,0,0,0,3,3
Tropical Storm,Michelle,13,2001-11-01T21:00:00Z,MZBZ 175N 883W,1,2,2,3,8
Tropical Storm,Michelle,13,2001-11-01T21:00:00Z,CEDAR KEY FL,0,0,0,2,2
Tropical Storm,Michelle,13,2001-11-01T21:00:00Z,MGPB 157N 886W,0,0,0,2,2
Tropical Storm,Michelle,13,2001-11-01T21:00:00Z,APALACHICOLA FL,0,0,0,2,2
Tropical Storm,Michelle,13,2001-11-01T21:00:00Z,MHNJ 165N 859W,14,2,0,1,17
Tropical Storm,Michelle,13,2001-11-01T21:00:00Z,GULF 29N 85W,0,0,0,3,3
Tropical Storm,Michelle,13,2001-11-01T21:00:00Z,MNPC 141N 834W,0,0,1,2,3
Tropical Storm,Michelle,13,2001-11-01T21:00:00Z,GULF 29N 87W,0,0,0,2,2
Tropical Storm,Michelle,13,2001-11-01T21:00:00Z,MYAK 241N 776W,0,0,0,3,3
Tropical Storm,Michelle,13,2001-11-01T21:00:00Z,GULF 28N 89W,0,0,0,3,3
Tropical Storm,Michelle,13,2001-11-01T21:00:00Z,MYNN 251N 775W,0,0,0,2,2
Tropical Storm,Michelle,13,2001-11-01T21:00:00Z,GULF 28N 91W,0,0,0,2,2
Tropical Storm,Michelle,13,2001-11-01T21:00:00Z,MYGF 266N 787W,0,0,0,2,2
Tropical Storm,Michelle,14,2001-11-02T03:00:00Z,19.0N  84.1W,48,0,0,0,48
Tropical Storm,Michelle,14,2001-11-02T03:00:00Z,MIAMI FL,0,0,1,7,8
Tropical Storm,Michelle,14,2001-11-02T03:00:00Z,20.0N  84.2W,26,1,1,1,29
Tropical Storm,Michelle,14,2001-11-02T03:00:00Z,W PALM BEACH FL,0,0,0,6,6
Tropical Storm,Michelle,14,2001-11-02T03:00:00Z,21.1N  84.1W,11,11,1,2,25
Tropical Storm,Michelle,14,2001-11-02T03:00:00Z,FT PIERCE FL,0,0,0,5,5
Tropical Storm,Michelle,14,2001-11-02T03:00:00Z,MKJP 179N 768W,0,0,0,2,2
Tropical Storm,Michelle,14,2001-11-02T03:00:00Z,COCOA BEACH FL,0,0,0,4,4
Tropical Storm,Michelle,14,2001-11-02T03:00:00Z,MKJS 185N 779W,0,0,0,3,3
Tropical Storm,Michelle,14,2001-11-02T03:00:00Z,DAYTONA BEACH FL,0,0,0,3,3
Tropical Storm,Michelle,14,2001-11-02T03:00:00Z,MWCG 193N 814W,5,4,3,3,15
Tropical Storm,Michelle,14,2001-11-02T03:00:00Z,KEY WEST FL,0,0,5,8,13
Tropical Storm,Michelle,14,2001-11-02T03:00:00Z,MUCM 214N 779W,0,0,0,5,5
Tropical Storm,Michelle,14,2001-11-02T03:00:00Z,MARCO ISLAND FL,0,0,2,8,10
Tropical Storm,Michelle,14,2001-11-02T03:00:00Z,MUCF 221N 805W,0,1,4,7,12
Tropical Storm,Michelle,14,2001-11-02T03:00:00Z,FT MYERS FL,0,0,1,8,9
Tropical Storm,Michelle,14,2001-11-02T03:00:00Z,MUSN 216N 826W,1,11,4,3,19
Tropical Storm,Michelle,14,2001-11-02T03:00:00Z,VENICE FL,0,0,1,7,8
Tropical Storm,Michelle,14,2001-11-02T03:00:00Z,MUHA 230N 824W,0,5,7,5,17
Tropical Storm,Michelle,14,2001-11-02T03:00:00Z,TAMPA FL,0,0,0,6,6
Tropical Storm,Michelle,14,2001-11-02T03:00:00Z,MUAN 219N 850W,4,14,3,1,22
Tropical Storm,Michelle,14,2001-11-02T03:00:00Z,CEDAR KEY FL,0,0,0,4,4
Tropical Storm,Michelle,14,2001-11-02T03:00:00Z,MMCZ 205N 869W,5,6,3,3,17
Tropical Storm,Michelle,14,2001-11-02T03:00:00Z,ST MARKS FL,0,0,0,2,2
Tropical Storm,Michelle,14,2001-11-02T03:00:00Z,MZBZ 175N 883W,0,0,1,3,4
Tropical Storm,Michelle,14,2001-11-02T03:00:00Z,APALACHICOLA FL,0,0,0,3,3
Tropical Storm,Michelle,14,2001-11-02T03:00:00Z,MHNJ 165N 859W,1,3,2,2,8
Tropical Storm,Michelle,14,2001-11-02T03:00:00Z,PANAMA CITY FL,0,0,0,3,3
Tropical Storm,Michelle,14,2001-11-02T03:00:00Z,MNPC 141N 834W,0,0,1,1,2
Tropical Storm,Michelle,14,2001-11-02T03:00:00Z,PENSACOLA FL,0,0,0,2,2
Tropical Storm,Michelle,14,2001-11-02T03:00:00Z,MYEG 235N 758W,0,0,0,2,2
Tropical Storm,Michelle,14,2001-11-02T03:00:00Z,BURAS LA,0,0,0,2,2
Tropical Storm,Michelle,14,2001-11-02T03:00:00Z,MYAK 241N 776W,0,0,0,5,5
Tropical Storm,Michelle,14,2001-11-02T03:00:00Z,GULF 29N 85W,0,0,0,5,5
Tropical Storm,Michelle,14,2001-11-02T03:00:00Z,MYNN 251N 775W,0,0,0,4,4
Tropical Storm,Michelle,14,2001-11-02T03:00:00Z,GULF 29N 87W,0,0,0,4,4
Tropical Storm,Michelle,14,2001-11-02T03:00:00Z,MYGF 266N 787W,0,0,0,4,4
Tropical Storm,Michelle,14,2001-11-02T03:00:00Z,GULF 28N 89W,0,0,0,4,4
Tropical Storm,Michelle,14,2001-11-02T03:00:00Z,MMMD 210N 897W,0,0,1,5,6
Tropical Storm,Michelle,14,2001-11-02T03:00:00Z,GULF 28N 91W,0,0,0,2,2
Tropical Storm,Michelle,14,2001-11-02T03:00:00Z,MARATHON FL,0,0,3,8,11
Tropical Storm,Michelle,15,2001-11-02T09:00:00Z,19.2N  84.2W,49,0,0,0,49
Tropical Storm,Michelle,15,2001-11-02T09:00:00Z,MARATHON FL,0,0,3,9,12
Tropical Storm,Michelle,15,2001-11-02T09:00:00Z,20.2N  84.2W,26,1,1,0,28
Tropical Storm,Michelle,15,2001-11-02T09:00:00Z,MIAMI FL,0,0,1,7,8
Tropical Storm,Michelle,15,2001-11-02T09:00:00Z,21.3N  83.9W,7,12,2,2,23
Tropical Storm,Michelle,15,2001-11-02T09:00:00Z,W PALM BEACH FL,0,0,0,6,6
Tropical Storm,Michelle,15,2001-11-02T09:00:00Z,MKJP 179N 768W,0,0,0,2,2
Tropical Storm,Michelle,15,2001-11-02T09:00:00Z,FT PIERCE FL,0,0,0,5,5
Tropical Storm,Michelle,15,2001-11-02T09:00:00Z,MKJS 185N 779W,0,0,0,4,4
Tropical Storm,Michelle,15,2001-11-02T09:00:00Z,COCOA BEACH FL,0,0,0,4,4
Tropical Storm,Michelle,15,2001-11-02T09:00:00Z,MWCG 193N 814W,9,3,2,2,16
Tropical Storm,Michelle,15,2001-11-02T09:00:00Z,DAYTONA BEACH FL,0,0,0,3,3
Tropical Storm,Michelle,15,2001-11-02T09:00:00Z,MUGM 200N 751W,0,0,0,2,2
Tropical Storm,Michelle,15,2001-11-02T09:00:00Z,JACKSONVILLE FL,0,0,0,2,2
Tropical Storm,Michelle,15,2001-11-02T09:00:00Z,MUCM 214N 779W,0,0,0,6,6
Tropical Storm,Michelle,15,2001-11-02T09:00:00Z,KEY WEST FL,0,0,5,8,13
Tropical Storm,Michelle,15,2001-11-02T09:00:00Z,MUCF 221N 805W,0,1,5,7,13
Tropical Storm,Michelle,15,2001-11-02T09:00:00Z,MARCO ISLAND FL,0,0,2,8,10
Tropical Storm,Michelle,15,2001-11-02T09:00:00Z,MUSN 216N 826W,1,11,4,3,19
Tropical Storm,Michelle,15,2001-11-02T09:00:00Z,FT MYERS FL,0,0,1,8,9
Tropical Storm,Michelle,15,2001-11-02T09:00:00Z,MUHA 230N 824W,0,4,7,6,17
Tropical Storm,Michelle,15,2001-11-02T09:00:00Z,VENICE FL,0,0,1,7,8
Tropical Storm,Michelle,15,2001-11-02T09:00:00Z,MUAN 219N 850W,2,15,3,2,22
Tropical Storm,Michelle,15,2001-11-02T09:00:00Z,TAMPA FL,0,0,0,6,6
Tropical Storm,Michelle,15,2001-11-02T09:00:00Z,MMCZ 205N 869W,9,5,2,2,18
Tropical Storm,Michelle,15,2001-11-02T09:00:00Z,CEDAR KEY FL,0,0,0,4,4
Tropical Storm,Michelle,15,2001-11-02T09:00:00Z,MZBZ 175N 883W,0,0,1,2,3
Tropical Storm,Michelle,15,2001-11-02T09:00:00Z,ST MARKS FL,0,0,0,2,2
Tropical Storm,Michelle,15,2001-11-02T09:00:00Z,MHNJ 165N 859W,1,1,2,2,6
Tropical Storm,Michelle,15,2001-11-02T09:00:00Z,APALACHICOLA FL,0,0,0,3,3
Tropical Storm,Michelle,15,2001-11-02T09:00:00Z,MYEG 235N 758W,0,0,0,3,3
Tropical Storm,Michelle,15,2001-11-02T09:00:00Z,PANAMA CITY FL,0,0,0,3,3
Tropical Storm,Michelle,15,2001-11-02T09:00:00Z,MYAK 241N 776W,0,0,0,5,5
Tropical Storm,Michelle,15,2001-11-02T09:00:00Z,PENSACOLA FL,0,0,0,2,2
Tropical Storm,Michelle,15,2001-11-02T09:00:00Z,MYNN 251N 775W,0,0,0,4,4
Tropical Storm,Michelle,15,2001-11-02T09:00:00Z,GULF 29N 85W,0,0,0,5,5
Tropical Storm,Michelle,15,2001-11-02T09:00:00Z,MYGF 266N 787W,0,0,0,5,5
Tropical Storm,Michelle,15,2001-11-02T09:00:00Z,GULF 29N 87W,0,0,0,4,4
Tropical Storm,Michelle,15,2001-11-02T09:00:00Z,MMMD 210N 897W,0,1,1,3,5
Tropical Storm,Michelle,15,2001-11-02T09:00:00Z,GULF 28N 89W,0,0,0,3,3
Hurricane,Michelle,16,2001-11-02T15:00:00Z,19.6N  84.1W,55,0,0,0,55
Hurricane,Michelle,16,2001-11-02T15:00:00Z,MMMD 210N 897W,0,0,1,2,3
Hurricane,Michelle,16,2001-11-02T15:00:00Z,20.7N  84.0W,31,0,1,0,32
Hurricane,Michelle,16,2001-11-02T15:00:00Z,MARATHON FL,0,1,6,8,15
Hurricane,Michelle,16,2001-11-02T15:00:00Z,21.5N  83.5W,16,9,1,1,27
Hurricane,Michelle,16,2001-11-02T15:00:00Z,MIAMI FL,0,0,2,9,11
Hurricane,Michelle,16,2001-11-02T15:00:00Z,MKJP 179N 768W,0,0,0,2,2
Hurricane,Michelle,16,2001-11-02T15:00:00Z,W PALM BEACH FL,0,0,1,8,9
Hurricane,Michelle,16,2001-11-02T15:00:00Z,MKJS 185N 779W,0,0,0,4,4
Hurricane,Michelle,16,2001-11-02T15:00:00Z,FT PIERCE FL,0,0,0,8,8
Hurricane,Michelle,16,2001-11-02T15:00:00Z,MWCG 193N 814W,6,5,2,3,16
Hurricane,Michelle,16,2001-11-02T15:00:00Z,COCOA BEACH FL,0,0,0,6,6
Hurricane,Michelle,16,2001-11-02T15:00:00Z,MUGM 200N 751W,0,0,0,2,2
Hurricane,Michelle,16,2001-11-02T15:00:00Z,DAYTONA BEACH FL,0,0,0,5,5
Hurricane,Michelle,16,2001-11-02T15:00:00Z,MUCM 214N 779W,0,0,0,8,8
Hurricane,Michelle,16,2001-11-02T15:00:00Z,JACKSONVILLE FL,0,0,0,2,2
Hurricane,Michelle,16,2001-11-02T15:00:00Z,MUCF 221N 805W,0,2,6,7,15
Hurricane,Michelle,16,2001-11-02T15:00:00Z,KEY WEST FL,0,2,8,6,16
Hurricane,Michelle,16,2001-11-02T15:00:00Z,MUSN 216N 826W,7,11,3,2,23
Hurricane,Michelle,16,2001-11-02T15:00:00Z,MARCO ISLAND FL,0,0,4,9,13
Hurricane,Michelle,16,2001-11-02T15:00:00Z,MUHA 230N 824W,0,11,5,4,20
Hurricane,Michelle,16,2001-11-02T15:00:00Z,FT MYERS FL,0,0,3,9,12
Hurricane,Michelle,16,2001-11-02T15:00:00Z,MUAN 219N 850W,13,10,1,1,25
Hurricane,Michelle,16,2001-11-02T15:00:00Z,VENICE FL,0,0,3,8,11
Hurricane,Michelle,16,2001-11-02T15:00:00Z,MMCZ 205N 869W,5,6,3,1,15
Hurricane,Michelle,16,2001-11-02T15:00:00Z,TAMPA FL,0,0,1,7,8
Hurricane,Michelle,16,2001-11-02T15:00:00Z,MZBZ 175N 883W,0,0,1,1,2
Hurricane,Michelle,16,2001-11-02T15:00:00Z,CEDAR KEY FL,0,0,0,5,5
Hurricane,Michelle,16,2001-11-02T15:00:00Z,MHNJ 165N 859W,0,2,1,2,5
Hurricane,Michelle,16,2001-11-02T15:00:00Z,ST MARKS FL,0,0,0,3,3
Hurricane,Michelle,16,2001-11-02T15:00:00Z,MYSM 241N 745W,0,0,0,2,2
Hurricane,Michelle,16,2001-11-02T15:00:00Z,APALACHICOLA FL,0,0,0,4,4
Hurricane,Michelle,16,2001-11-02T15:00:00Z,MYEG 235N 758W,0,0,0,4,4
Hurricane,Michelle,16,2001-11-02T15:00:00Z,PANAMA CITY FL,0,0,0,3,3
Hurricane,Michelle,16,2001-11-02T15:00:00Z,MYAK 241N 776W,0,0,0,8,8
Hurricane,Michelle,16,2001-11-02T15:00:00Z,GULF 29N 85W,0,0,0,5,5
Hurricane,Michelle,16,2001-11-02T15:00:00Z,MYNN 251N 775W,0,0,0,7,7
Hurricane,Michelle,16,2001-11-02T15:00:00Z,GULF 29N 87W,0,0,0,3,3
Hurricane,Michelle,16,2001-11-02T15:00:00Z,MYGF 266N 787W,0,0,0,7,7
Hurricane,Michelle,16,2001-11-02T15:00:00Z,GULF 28N 89W,0,0,0,2,2
Hurricane,Michelle,17,2001-11-02T21:00:00Z,19.7N  84.4W,59,0,0,0,59
Hurricane,Michelle,17,2001-11-02T21:00:00Z,MMMD 210N 897W,0,0,1,2,3
Hurricane,Michelle,17,2001-11-02T21:00:00Z,20.8N  84.1W,31,1,0,0,32
Hurricane,Michelle,17,2001-11-02T21:00:00Z,MARATHON FL,0,0,7,9,16
Hurricane,Michelle,17,2001-11-02T21:00:00Z,22.0N  83.5W,9,12,3,1,25
Hurricane,Michelle,17,2001-11-02T21:00:00Z,MIAMI FL,0,0,2,11,13
Hurricane,Michelle,17,2001-11-02T21:00:00Z,MKJP 179N 768W,0,0,0,2,2
Hurricane,Michelle,17,2001-11-02T21:00:00Z,W PALM BEACH FL,0,0,1,11,12
Hurricane,Michelle,17,2001-11-02T21:00:00Z,MKJS 185N 779W,0,0,0,3,3
Hurricane,Michelle,17,2001-11-02T21:00:00Z,FT PIERCE FL,0,0,1,9,10
Hurricane,Michelle,17,2001-11-02T21:00:00Z,MWCG 193N 814W,4,4,3,2,13
Hurricane,Michelle,17,2001-11-02T21:00:00Z,COCOA BEACH FL,0,0,0,9,9
Hurricane,Michelle,17,2001-11-02T21:00:00Z,MUGM 200N 751W,0,0,0,3,3
Hurricane,Michelle,17,2001-11-02T21:00:00Z,DAYTONA BEACH FL,0,0,0,7,7
Hurricane,Michelle,17,2001-11-02T21:00:00Z,MUCM 214N 779W,0,0,0,9,9
Hurricane,Michelle,17,2001-11-02T21:00:00Z,JACKSONVILLE FL,0,0,0,4,4
Hurricane,Michelle,17,2001-11-02T21:00:00Z,MUCF 221N 805W,0,2,6,7,15
Hurricane,Michelle,17,2001-11-02T21:00:00Z,KEY WEST FL,0,2,9,6,17
Hurricane,Michelle,17,2001-11-02T21:00:00Z,MUSN 216N 826W,6,11,3,2,22
Hurricane,Michelle,17,2001-11-02T21:00:00Z,MARCO ISLAND FL,0,0,5,9,14
Hurricane,Michelle,17,2001-11-02T21:00:00Z,MUHA 230N 824W,0,10,6,4,20
Hurricane,Michelle,17,2001-11-02T21:00:00Z,FT MYERS FL,0,0,4,9,13
Hurricane,Michelle,17,2001-11-02T21:00:00Z,MUAN 219N 850W,16,8,2,1,27
Hurricane,Michelle,17,2001-11-02T21:00:00Z,VENICE FL,0,0,3,9,12
Hurricane,Michelle,17,2001-11-02T21:00:00Z,MMCZ 205N 869W,8,5,2,2,17
Hurricane,Michelle,17,2001-11-02T21:00:00Z,TAMPA FL,0,0,1,9,10
Hurricane,Michelle,17,2001-11-02T21:00:00Z,MZBZ 175N 883W,0,0,1,1,2
Hurricane,Michelle,17,2001-11-02T21:00:00Z,CEDAR KEY FL,0,0,0,7,7
Hurricane,Michelle,17,2001-11-02T21:00:00Z,MHNJ 165N 859W,1,2,1,1,5
Hurricane,Michelle,17,2001-11-02T21:00:00Z,ST MARKS FL,0,0,0,4,4
Hurricane,Michelle,17,2001-11-02T21:00:00Z,MYMM 224N 730W,0,0,0,2,2
Hurricane,Michelle,17,2001-11-02T21:00:00Z,APALACHICOLA FL,0,0,0,4,4
Hurricane,Michelle,17,2001-11-02T21:00:00Z,MYSM 241N 745W,0,0,0,5,5
Hurricane,Michelle,17,2001-11-02T21:00:00Z,PANAMA CITY FL,0,0,0,3,3
Hurricane,Michelle,17,2001-11-02T21:00:00Z,MYEG 235N 758W,0,0,0,7,7
Hurricane,Michelle,17,2001-11-02T21:00:00Z,GULF 29N 85W,0,0,0,6,6
Hurricane,Michelle,17,2001-11-02T21:00:00Z,MYAK 241N 776W,0,0,0,10,10
Hurricane,Michelle,17,2001-11-02T21:00:00Z,GULF 29N 87W,0,0,0,4,4
Hurricane,Michelle,17,2001-11-02T21:00:00Z,MYNN 251N 775W,0,0,0,10,10
Hurricane,Michelle,17,2001-11-02T21:00:00Z,GULF 28N 89W,0,0,0,2,2
Hurricane,Michelle,17,2001-11-02T21:00:00Z,MYGF 266N 787W,0,0,0,10,10
Hurricane,Michelle,18,2001-11-03T03:00:00Z,21.0N  84.0W,50,0,0,0,50
Hurricane,Michelle,18,2001-11-03T03:00:00Z,MARATHON FL,0,3,13,4,20
Hurricane,Michelle,18,2001-11-03T03:00:00Z,22.0N  83.5W,28,4,0,0,32
Hurricane,Michelle,18,2001-11-03T03:00:00Z,MIAMI FL,0,0,9,9,18
Hurricane,Michelle,18,2001-11-03T03:00:00Z,23.0N  82.0W,1,15,6,1,23
Hurricane,Michelle,18,2001-11-03T03:00:00Z,W PALM BEACH FL,0,0,5,11,16
Hurricane,Michelle,18,2001-11-03T03:00:00Z,MKJP 179N 768W,0,0,0,2,2
Hurricane,Michelle,18,2001-11-03T03:00:00Z,FT PIERCE FL,0,0,3,12,15
Hurricane,Michelle,18,2001-11-03T03:00:00Z,MKJS 185N 779W,0,0,0,3,3
Hurricane,Michelle,18,2001-11-03T03:00:00Z,COCOA BEACH FL,0,0,2,11,13
Hurricane,Michelle,18,2001-11-03T03:00:00Z,MWCG 193N 814W,4,4,2,2,12
Hurricane,Michelle,18,2001-11-03T03:00:00Z,DAYTONA BEACH FL,0,0,1,9,10
Hurricane,Michelle,18,2001-11-03T03:00:00Z,MUGM 200N 751W,0,0,0,4,4
Hurricane,Michelle,18,2001-11-03T03:00:00Z,JACKSONVILLE FL,0,0,0,6,6
Hurricane,Michelle,18,2001-11-03T03:00:00Z,MUCM 214N 779W,0,0,2,9,11
Hurricane,Michelle,18,2001-11-03T03:00:00Z,SAVANNAH GA,0,0,0,3,3
Hurricane,Michelle,18,2001-11-03T03:00:00Z,MUCF 221N 805W,0,5,10,3,18
Hurricane,Michelle,18,2001-11-03T03:00:00Z,CHARLESTON SC,0,0,0,2,2
Hurricane,Michelle,18,2001-11-03T03:00:00Z,MUSN 216N 826W,19,6,1,0,26
Hurricane,Michelle,18,2001-11-03T03:00:00Z,KEY WEST FL,0,7,12,3,22
Hurricane,Michelle,18,2001-11-03T03:00:00Z,MUHA 230N 824W,3,17,4,1,25
Hurricane,Michelle,18,2001-11-03T03:00:00Z,MARCO ISLAND FL,0,1,12,5,18
Hurricane,Michelle,18,2001-11-03T03:00:00Z,MUAN 219N 850W,29,1,0,0,30
Hurricane,Michelle,18,2001-11-03T03:00:00Z,FT MYERS FL,0,1,10,6,17
Hurricane,Michelle,18,2001-11-03T03:00:00Z,MMCZ 205N 869W,3,2,1,1,7
Hurricane,Michelle,18,2001-11-03T03:00:00Z,VENICE FL,0,0,9,6,15
Hurricane,Michelle,18,2001-11-03T03:00:00Z,MBJT 215N 712W,0,0,0,2,2
Hurricane,Michelle,18,2001-11-03T03:00:00Z,TAMPA FL,0,0,5,7,12
Hurricane,Michelle,18,2001-11-03T03:00:00Z,MYMM 224N 730W,0,0,0,5,5
Hurricane,Michelle,18,2001-11-03T03:00:00Z,CEDAR KEY FL,0,0,1,8,9
Hurricane,Michelle,18,2001-11-03T03:00:00Z,MYSM 241N 745W,0,0,0,10,10
Hurricane,Michelle,18,2001-11-03T03:00:00Z,ST MARKS FL,0,0,0,4,4
Hurricane,Michelle,18,2001-11-03T03:00:00Z,MYEG 235N 758W,0,0,0,11,11
Hurricane,Michelle,18,2001-11-03T03:00:00Z,APALACHICOLA FL,0,0,0,4,4
Hurricane,Michelle,18,2001-11-03T03:00:00Z,MYAK 241N 776W,0,0,2,13,15
Hurricane,Michelle,18,2001-11-03T03:00:00Z,PANAMA CITY FL,0,0,0,3,3
Hurricane,Michelle,18,2001-11-03T03:00:00Z,MYNN 251N 775W,0,0,1,14,15
Hurricane,Michelle,18,2001-11-03T03:00:00Z,GULF 29N 85W,0,0,1,5,6
Hurricane,Michelle,18,2001-11-03T03:00:00Z,MYGF 266N 787W,0,0,2,13,15
Hurricane,Michelle,18,2001-11-03T03:00:00Z,GULF 29N 87W,0,0,0,2,2
Hurricane,Michelle,19,2001-11-03T09:00:00Z,20.9N  84.3W,58,0,0,0,58
Hurricane,Michelle,19,2001-11-03T09:00:00Z,MARATHON FL,0,4,16,3,23
Hurricane,Michelle,19,2001-11-03T09:00:00Z,22.0N  83.6W,28,2,1,0,31
Hurricane,Michelle,19,2001-11-03T09:00:00Z,MIAMI FL,0,0,13,7,20
Hurricane,Michelle,19,2001-11-03T09:00:00Z,23.3N  81.4W,1,9,13,1,24
Hurricane,Michelle,19,2001-11-03T09:00:00Z,W PALM BEACH FL,0,0,9,9,18
Hurricane,Michelle,19,2001-11-03T09:00:00Z,MKJS 185N 779W,0,0,0,3,3
Hurricane,Michelle,19,2001-11-03T09:00:00Z,FT PIERCE FL,0,0,6,10,16
Hurricane,Michelle,19,2001-11-03T09:00:00Z,MWCG 193N 814W,2,4,5,1,12
Hurricane,Michelle,19,2001-11-03T09:00:00Z,COCOA BEACH FL,0,0,4,10,14
Hurricane,Michelle,19,2001-11-03T09:00:00Z,MUGM 200N 751W,0,0,0,4,4
Hurricane,Michelle,19,2001-11-03T09:00:00Z,DAYTONA BEACH FL,0,0,2,9,11
Hurricane,Michelle,19,2001-11-03T09:00:00Z,MUCM 214N 779W,0,0,2,10,12
Hurricane,Michelle,19,2001-11-03T09:00:00Z,JACKSONVILLE FL,0,0,0,7,7
Hurricane,Michelle,19,2001-11-03T09:00:00Z,MUCF 221N 805W,0,4,13,2,19
Hurricane,Michelle,19,2001-11-03T09:00:00Z,SAVANNAH GA,0,0,0,3,3
Hurricane,Michelle,19,2001-11-03T09:00:00Z,MUSN 216N 826W,18,5,2,1,26
Hurricane,Michelle,19,2001-11-03T09:00:00Z,CHARLESTON SC,0,0,0,2,2
Hurricane,Michelle,19,2001-11-03T09:00:00Z,MUHA 230N 824W,5,15,7,0,27
Hurricane,Michelle,19,2001-11-03T09:00:00Z,KEY WEST FL,0,9,14,1,24
Hurricane,Michelle,19,2001-11-03T09:00:00Z,MUAN 219N 850W,31,1,0,0,32
Hurricane,Michelle,19,2001-11-03T09:00:00Z,MARCO ISLAND FL,0,2,15,3,20
Hurricane,Michelle,19,2001-11-03T09:00:00Z,MMCZ 205N 869W,10,2,0,0,12
Hurricane,Michelle,19,2001-11-03T09:00:00Z,FT MYERS FL,0,1,13,4,18
Hurricane,Michelle,19,2001-11-03T09:00:00Z,MBJT 215N 712W,0,0,0,3,3
Hurricane,Michelle,19,2001-11-03T09:00:00Z,VENICE FL,0,1,11,4,16
Hurricane,Michelle,19,2001-11-03T09:00:00Z,MYMM 224N 730W,0,0,0,7,7
Hurricane,Michelle,19,2001-11-03T09:00:00Z,TAMPA FL,0,0,7,6,13
Hurricane,Michelle,19,2001-11-03T09:00:00Z,MYSM 241N 745W,0,0,0,11,11
Hurricane,Michelle,19,2001-11-03T09:00:00Z,CEDAR KEY FL,0,0,2,7,9
Hurricane,Michelle,19,2001-11-03T09:00:00Z,MYEG 235N 758W,0,0,0,13,13
Hurricane,Michelle,19,2001-11-03T09:00:00Z,ST MARKS FL,0,0,0,4,4
Hurricane,Michelle,19,2001-11-03T09:00:00Z,MYAK 241N 776W,0,0,3,14,17
Hurricane,Michelle,19,2001-11-03T09:00:00Z,APALACHICOLA FL,0,0,0,3,3
Hurricane,Michelle,19,2001-11-03T09:00:00Z,MYNN 251N 775W,0,0,2,15,17
Hurricane,Michelle,19,2001-11-03T09:00:00Z,PANAMA CITY FL,0,0,0,2,2
Hurricane,Michelle,19,2001-11-03T09:00:00Z,MYGF 266N 787W,0,0,4,13,17
Hurricane,Michelle,19,2001-11-03T09:00:00Z,GULF 29N 85W,0,0,1,3,4
Hurricane,Michelle,20,2001-11-03T15:00:00Z,21.3N  83.6W,48,0,0,0,48
Hurricane,Michelle,20,2001-11-03T15:00:00Z,MYGF 266N 787W,0,0,6,11,17
Hurricane,Michelle,20,2001-11-03T15:00:00Z,22.4N  82.4W,16,13,1,0,30
Hurricane,Michelle,20,2001-11-03T15:00:00Z,MARATHON FL,0,11,9,2,22
Hurricane,Michelle,20,2001-11-03T15:00:00Z,23.3N  80.5W,0,12,9,1,22
Hurricane,Michelle,20,2001-11-03T15:00:00Z,MIAMI FL,0,2,13,4,19
Hurricane,Michelle,20,2001-11-03T15:00:00Z,MKJP 179N 768W,0,0,0,2,2
Hurricane,Michelle,20,2001-11-03T15:00:00Z,W PALM BEACH FL,0,0,10,7,17
Hurricane,Michelle,20,2001-11-03T15:00:00Z,MKJS 185N 779W,0,0,1,3,4
Hurricane,Michelle,20,2001-11-03T15:00:00Z,FT PIERCE FL,0,0,6,9,15
Hurricane,Michelle,20,2001-11-03T15:00:00Z,MWCG 193N 814W,4,6,2,0,12
Hurricane,Michelle,20,2001-11-03T15:00:00Z,COCOA BEACH FL,0,0,4,9,13
Hurricane,Michelle,20,2001-11-03T15:00:00Z,MUGM 200N 751W,0,0,0,5,5
Hurricane,Michelle,20,2001-11-03T15:00:00Z,DAYTONA BEACH FL,0,0,1,8,9
Hurricane,Michelle,20,2001-11-03T15:00:00Z,MUCM 214N 779W,0,0,6,7,13
Hurricane,Michelle,20,2001-11-03T15:00:00Z,JACKSONVILLE FL,0,0,0,5,5
Hurricane,Michelle,20,2001-11-03T15:00:00Z,MUCF 221N 805W,0,13,7,1,21
Hurricane,Michelle,20,2001-11-03T15:00:00Z,SAVANNAH GA,0,0,0,3,3
Hurricane,Michelle,20,2001-11-03T15:00:00Z,MUSN 216N 826W,28,4,0,0,32
Hurricane,Michelle,20,2001-11-03T15:00:00Z,CHARLESTON SC,0,0,0,2,2
Hurricane,Michelle,20,2001-11-03T15:00:00Z,MUHA 230N 824W,9,19,1,0,29
Hurricane,Michelle,20,2001-11-03T15:00:00Z,MYRTLE BEACH SC,0,0,0,2,2
Hurricane,Michelle,20,2001-11-03T15:00:00Z,MUAN 219N 850W,28,1,0,0,29
Hurricane,Michelle,20,2001-11-03T15:00:00Z,KEY WEST FL,0,16,6,1,23
Hurricane,Michelle,20,2001-11-03T15:00:00Z,MMCZ 205N 869W,1,1,0,0,2
Hurricane,Michelle,20,2001-11-03T15:00:00Z,MARCO ISLAND FL,0,5,10,3,18
Hurricane,Michelle,20,2001-11-03T15:00:00Z,MDPP 198N 707W,0,0,0,2,2
Hurricane,Michelle,20,2001-11-03T15:00:00Z,FT MYERS FL,0,2,10,4,16
Hurricane,Michelle,20,2001-11-03T15:00:00Z,MBJT 215N 712W,0,0,0,4,4
Hurricane,Michelle,20,2001-11-03T15:00:00Z,VENICE FL,0,1,8,4,13
Hurricane,Michelle,20,2001-11-03T15:00:00Z,MYMM 224N 730W,0,0,0,8,8
Hurricane,Michelle,20,2001-11-03T15:00:00Z,TAMPA FL,0,0,4,6,10
Hurricane,Michelle,20,2001-11-03T15:00:00Z,MYSM 241N 745W,0,0,0,12,12
Hurricane,Michelle,20,2001-11-03T15:00:00Z,CEDAR KEY FL,0,0,1,5,6
Hurricane,Michelle,20,2001-11-03T15:00:00Z,MYEG 235N 758W,0,0,1,13,14
Hurricane,Michelle,20,2001-11-03T15:00:00Z,ST MARKS FL,0,0,0,2,2
Hurricane,Michelle,20,2001-11-03T15:00:00Z,MYAK 241N 776W,0,0,7,10,17
Hurricane,Michelle,20,2001-11-03T15:00:00Z,APALACHICOLA FL,0,0,0,2,2
Hurricane,Michelle,20,2001-11-03T15:00:00Z,MYNN 251N 775W,0,0,5,12,17
Hurricane,Michelle,20,2001-11-03T15:00:00Z,GULF 29N 85W,0,0,0,3,3
Hurricane,Michelle,21,2001-11-03T21:00:00Z,21.7N  83.0W,50,0,0,0,50
Hurricane,Michelle,21,2001-11-03T21:00:00Z,MIAMI FL,0,10,11,2,23
Hurricane,Michelle,21,2001-11-03T21:00:00Z,23.1N  81.4W,12,18,1,0,31
Hurricane,Michelle,21,2001-11-03T21:00:00Z,W PALM BEACH FL,0,4,13,3,20
Hurricane,Michelle,21,2001-11-03T21:00:00Z,24.2N  79.0W,0,7,15,1,23
Hurricane,Michelle,21,2001-11-03T21:00:00Z,FT PIERCE FL,0,2,11,4,17
Hurricane,Michelle,21,2001-11-03T21:00:00Z,MKJS 185N 779W,0,0,1,1,2
Hurricane,Michelle,21,2001-11-03T21:00:00Z,COCOA BEACH FL,0,1,7,6,14
Hurricane,Michelle,21,2001-11-03T21:00:00Z,MWCG 193N 814W,7,5,1,0,13
Hurricane,Michelle,21,2001-11-03T21:00:00Z,DAYTONA BEACH FL,0,0,3,7,10
Hurricane,Michelle,21,2001-11-03T21:00:00Z,MUGM 200N 751W,0,0,0,3,3
Hurricane,Michelle,21,2001-11-03T21:00:00Z,JACKSONVILLE FL,0,0,1,4,5
Hurricane,Michelle,21,2001-11-03T21:00:00Z,MUCM 214N 779W,0,1,8,4,13
Hurricane,Michelle,21,2001-11-03T21:00:00Z,SAVANNAH GA,0,0,0,3,3
Hurricane,Michelle,21,2001-11-03T21:00:00Z,MUCF 221N 805W,6,16,2,1,25
Hurricane,Michelle,21,2001-11-03T21:00:00Z,CHARLESTON SC,0,0,0,4,4
Hurricane,Michelle,21,2001-11-03T21:00:00Z,MUSN 216N 826W,46,0,0,0,46
Hurricane,Michelle,21,2001-11-03T21:00:00Z,MYRTLE BEACH SC,0,0,0,3,3
Hurricane,Michelle,21,2001-11-03T21:00:00Z,MUHA 230N 824W,25,8,1,0,34
Hurricane,Michelle,21,2001-11-03T21:00:00Z,WILMINGTON NC,0,0,0,3,3
Hurricane,Michelle,21,2001-11-03T21:00:00Z,MUAN 219N 850W,25,0,0,0,25
Hurricane,Michelle,21,2001-11-03T21:00:00Z,MOREHEAD CITY NC,0,0,0,3,3
Hurricane,Michelle,21,2001-11-03T21:00:00Z,MBJT 215N 712W,0,0,0,3,3
Hurricane,Michelle,21,2001-11-03T21:00:00Z,CAPE HATTERAS NC,0,0,0,2,2
Hurricane,Michelle,21,2001-11-03T21:00:00Z,MYMM 224N 730W,0,0,0,7,7
Hurricane,Michelle,21,2001-11-03T21:00:00Z,KEY WEST FL,3,22,2,0,27
Hurricane,Michelle,21,2001-11-03T21:00:00Z,MYSM 241N 745W,0,0,1,12,13
Hurricane,Michelle,21,2001-11-03T21:00:00Z,MARCO ISLAND FL,0,12,7,1,20
Hurricane,Michelle,21,2001-11-03T21:00:00Z,MYEG 235N 758W,0,0,4,11,15
Hurricane,Michelle,21,2001-11-03T21:00:00Z,FT MYERS FL,0,7,9,1,17
Hurricane,Michelle,21,2001-11-03T21:00:00Z,MYAK 241N 776W,0,1,14,5,20
Hurricane,Michelle,21,2001-11-03T21:00:00Z,VENICE FL,0,4,7,2,13
Hurricane,Michelle,21,2001-11-03T21:00:00Z,MYNN 251N 775W,0,0,14,7,21
Hurricane,Michelle,21,2001-11-03T21:00:00Z,TAMPA FL,0,1,5,4,10
Hurricane,Michelle,21,2001-11-03T21:00:00Z,MYGF 266N 787W,0,1,14,6,21
Hurricane,Michelle,21,2001-11-03T21:00:00Z,CEDAR KEY FL,0,0,1,4,5
Hurricane,Michelle,21,2001-11-03T21:00:00Z,MARATHON FL,1,21,4,1,27
Hurricane,Michelle,22,2001-11-04T03:00:00Z,23.0N  81.7W,41,0,0,0,41
Hurricane,Michelle,22,2001-11-04T03:00:00Z,MARATHON FL,15,11,0,0,26
Hurricane,Michelle,22,2001-11-04T03:00:00Z,24.0N  79.0W,7,17,2,0,26
Hurricane,Michelle,22,2001-11-04T03:00:00Z,MIAMI FL,2,17,3,0,22
Hurricane,Michelle,22,2001-11-04T03:00:00Z,26.0N  75.0W,0,1,15,3,19
Hurricane,Michelle,22,2001-11-04T03:00:00Z,W PALM BEACH FL,0,12,6,0,18
Hurricane,Michelle,22,2001-11-04T03:00:00Z,MWCG 193N 814W,10,1,0,0,11
Hurricane,Michelle,22,2001-11-04T03:00:00Z,FT PIERCE FL,0,7,7,1,15
Hurricane,Michelle,22,2001-11-04T03:00:00Z,MUGM 200N 751W,0,1,2,1,4
Hurricane,Michelle,22,2001-11-04T03:00:00Z,COCOA BEACH FL,0,3,8,0,11
Hurricane,Michelle,22,2001-11-04T03:00:00Z,MUCM 214N 779W,2,11,3,0,16
Hurricane,Michelle,22,2001-11-04T03:00:00Z,DAYTONA BEACH FL,0,1,4,1,6
Hurricane,Michelle,22,2001-11-04T03:00:00Z,MUCF 221N 805W,33,1,0,0,34
Hurricane,Michelle,22,2001-11-04T03:00:00Z,JACKSONVILLE FL,0,0,2,0,2
Hurricane,Michelle,22,2001-11-04T03:00:00Z,MUSN 216N 826W,65,0,0,0,65
Hurricane,Michelle,22,2001-11-04T03:00:00Z,CHARLESTON SC,0,0,1,1,2
Hurricane,Michelle,22,2001-11-04T03:00:00Z,MUHA 230N 824W,41,0,1,0,42
Hurricane,Michelle,22,2001-11-04T03:00:00Z,MYRTLE BEACH SC,0,0,0,2,2
Hurricane,Michelle,22,2001-11-04T03:00:00Z,MUAN 219N 850W,16,0,0,0,16
Hurricane,Michelle,22,2001-11-04T03:00:00Z,WILMINGTON NC,0,0,0,2,2
Hurricane,Michelle,22,2001-11-04T03:00:00Z,MBJT 215N 712W,0,0,1,3,4
Hurricane,Michelle,22,2001-11-04T03:00:00Z,MOREHEAD CITY NC,0,0,0,3,3
Hurricane,Michelle,22,2001-11-04T03:00:00Z,MYMM 224N 730W,0,0,6,3,9
Hurricane,Michelle,22,2001-11-04T03:00:00Z,CAPE HATTERAS NC,0,0,0,3,3
Hurricane,Michelle,22,2001-11-04T03:00:00Z,MYSM 241N 745W,0,1,13,2,16
Hurricane,Michelle,22,2001-11-04T03:00:00Z,KEY WEST FL,20,6,0,1,27
Hurricane,Michelle,22,2001-11-04T03:00:00Z,MYEG 235N 758W,0,5,12,1,18
Hurricane,Michelle,22,2001-11-04T03:00:00Z,MARCO ISLAND FL,2,15,1,0,18
Hurricane,Michelle,22,2001-11-04T03:00:00Z,MYAK 241N 776W,1,15,7,0,23
Hurricane,Michelle,22,2001-11-04T03:00:00Z,FT MYERS FL,1,11,2,1,15
Hurricane,Michelle,22,2001-11-04T03:00:00Z,MYNN 251N 775W,0,12,10,1,23
Hurricane,Michelle,22,2001-11-04T03:00:00Z,VENICE FL,0,7,3,0,10
Hurricane,Michelle,22,2001-11-04T03:00:00Z,MYGF 266N 787W,0,9,11,0,20
Hurricane,Michelle,22,2001-11-04T03:00:00Z,TAMPA FL,0,3,3,0,6
Hurricane,Michelle,22,2001-11-04T03:00:00Z,BERMUDA,0,0,0,10,10
Hurricane,Michelle,22,2001-11-04T03:00:00Z,CEDAR KEY FL,0,1,1,0,2
Hurricane,Michelle,23,2001-11-04T09:00:00Z,23.4N  80.6W,44,0,0,0,44
Hurricane,Michelle,23,2001-11-04T09:00:00Z,MYGF 266N 787W,0,17,7,0,24
Hurricane,Michelle,23,2001-11-04T09:00:00Z,25.1N  77.9W,2,24,3,0,29
Hurricane,Michelle,23,2001-11-04T09:00:00Z,BERMUDA,0,0,0,9,9
Hurricane,Michelle,23,2001-11-04T09:00:00Z,27.5N  73.5W,0,0,15,4,19
Hurricane,Michelle,23,2001-11-04T09:00:00Z,MARATHON FL,22,10,0,0,32
Hurricane,Michelle,23,2001-11-04T09:00:00Z,MWCG 193N 814W,6,0,0,0,6
Hurricane,Michelle,23,2001-11-04T09:00:00Z,MIAMI FL,3,22,1,0,26
Hurricane,Michelle,23,2001-11-04T09:00:00Z,MUGM 200N 751W,0,1,1,0,2
Hurricane,Michelle,23,2001-11-04T09:00:00Z,W PALM BEACH FL,0,17,4,0,21
Hurricane,Michelle,23,2001-11-04T09:00:00Z,MUCM 214N 779W,6,10,1,0,17
Hurricane,Michelle,23,2001-11-04T09:00:00Z,FT PIERCE FL,0,10,6,0,16
Hurricane,Michelle,23,2001-11-04T09:00:00Z,MUCF 221N 805W,51,0,0,0,51
Hurricane,Michelle,23,2001-11-04T09:00:00Z,COCOA BEACH FL,0,4,6,1,11
Hurricane,Michelle,23,2001-11-04T09:00:00Z,MUSN 216N 826W,79,0,0,0,79
Hurricane,Michelle,23,2001-11-04T09:00:00Z,DAYTONA BEACH FL,0,1,4,0,5
Hurricane,Michelle,23,2001-11-04T09:00:00Z,MUHA 230N 824W,46,0,0,0,46
Hurricane,Michelle,23,2001-11-04T09:00:00Z,MOREHEAD CITY NC,0,0,0,2,2
Hurricane,Michelle,23,2001-11-04T09:00:00Z,MUAN 219N 850W,13,1,0,0,14
Hurricane,Michelle,23,2001-11-04T09:00:00Z,CAPE HATTERAS NC,0,0,0,2,2
Hurricane,Michelle,23,2001-11-04T09:00:00Z,MBJT 215N 712W,0,0,2,2,4
Hurricane,Michelle,23,2001-11-04T09:00:00Z,KEY WEST FL,25,6,0,0,31
Hurricane,Michelle,23,2001-11-04T09:00:00Z,MYMM 224N 730W,0,1,7,1,9
Hurricane,Michelle,23,2001-11-04T09:00:00Z,MARCO ISLAND FL,2,17,0,0,19
Hurricane,Michelle,23,2001-11-04T09:00:00Z,MYSM 241N 745W,0,5,14,0,19
Hurricane,Michelle,23,2001-11-04T09:00:00Z,FT MYERS FL,1,12,2,0,15
Hurricane,Michelle,23,2001-11-04T09:00:00Z,MYEG 235N 758W,0,15,7,0,22
Hurricane,Michelle,23,2001-11-04T09:00:00Z,VENICE FL,0,7,1,0,8
Hurricane,Michelle,23,2001-11-04T09:00:00Z,MYAK 241N 776W,6,22,2,0,30
Hurricane,Michelle,23,2001-11-04T09:00:00Z,TAMPA FL,0,3,1,0,4
Hurricane,Michelle,23,2001-11-04T09:00:00Z,MYNN 251N 775W,1,23,5,0,29
Hurricane,Michelle,24,2001-11-04T15:00:00Z,24.3N  78.9W,45,2,0,0,47
Hurricane,Michelle,24,2001-11-04T15:00:00Z,MYNN 251N 775W,24,16,0,0,40
Hurricane,Michelle,24,2001-11-04T15:00:00Z,26.5N  74.5W,0,22,3,0,25
Hurricane,Michelle,24,2001-11-04T15:00:00Z,MYGF 266N 787W,9,18,0,0,27
Hurricane,Michelle,24,2001-11-04T15:00:00Z,29.0N  70.0W,0,0,13,3,16
Hurricane,Michelle,24,2001-11-04T15:00:00Z,BERMUDA,0,0,0,11,11
Hurricane,Michelle,24,2001-11-04T15:00:00Z,MUCM 214N 779W,7,3,0,0,10
Hurricane,Michelle,24,2001-11-04T15:00:00Z,MARATHON FL,31,1,0,0,32
Hurricane,Michelle,24,2001-11-04T15:00:00Z,MUCF 221N 805W,71,0,0,0,71
Hurricane,Michelle,24,2001-11-04T15:00:00Z,MIAMI FL,20,6,0,0,26
Hurricane,Michelle,24,2001-11-04T15:00:00Z,MUSN 216N 826W,99,0,0,0,99
Hurricane,Michelle,24,2001-11-04T15:00:00Z,W PALM BEACH FL,6,9,0,0,15
Hurricane,Michelle,24,2001-11-04T15:00:00Z,MUHA 230N 824W,43,0,0,0,43
Hurricane,Michelle,24,2001-11-04T15:00:00Z,FT PIERCE FL,1,5,0,0,6
Hurricane,Michelle,24,2001-11-04T15:00:00Z,MBJT 215N 712W,0,0,2,0,2
Hurricane,Michelle,24,2001-11-04T15:00:00Z,COCOA BEACH FL,0,2,0,0,2
Hurricane,Michelle,24,2001-11-04T15:00:00Z,MYMM 224N 730W,0,3,3,0,6
Hurricane,Michelle,24,2001-11-04T15:00:00Z,SABLE ISLAND NS,0,0,0,2,2
Hurricane,Michelle,24,2001-11-04T15:00:00Z,MYSM 241N 745W,0,17,2,0,19
Hurricane,Michelle,24,2001-11-04T15:00:00Z,KEY WEST FL,23,1,0,0,24
Hurricane,Michelle,24,2001-11-04T15:00:00Z,MYEG 235N 758W,4,19,0,0,23
Hurricane,Michelle,24,2001-11-04T15:00:00Z,MARCO ISLAND FL,5,2,0,0,7
Hurricane,Michelle,24,2001-11-04T15:00:00Z,MYAK 241N 776W,31,9,0,0,40
Hurricane,Michelle,24,2001-11-04T15:00:00Z,FT MYERS FL,1,1,0,0,2
Hurricane,Michelle,25,2001-11-04T21:00:00Z,25.8N  76.5W,25,4,0,0,29
Hurricane,Michelle,25,2001-11-04T21:00:00Z,MYGF 266N 787W,16,0,0,0,16
Hurricane,Michelle,25,2001-11-04T21:00:00Z,28.0N  71.5W,0,17,4,0,21
Hurricane,Michelle,25,2001-11-04T21:00:00Z,BERMUDA,0,0,11,6,17
Hurricane,Michelle,25,2001-11-04T21:00:00Z,31.5N  65.5W,0,0,14,3,17
Hurricane,Michelle,25,2001-11-04T21:00:00Z,MARATHON FL,8,0,0,0,8
Hurricane,Michelle,25,2001-11-04T21:00:00Z,MUCM 214N 779W,7,1,0,0,8
Hurricane,Michelle,25,2001-11-04T21:00:00Z,MIAMI FL,6,0,0,0,6
Hurricane,Michelle,25,2001-11-04T21:00:00Z,MUCF 221N 805W,99,0,0,0,99
Hurricane,Michelle,25,2001-11-04T21:00:00Z,W PALM BEACH FL,2,0,0,0,2
Hurricane,Michelle,25,2001-11-04T21:00:00Z,MUSN 216N 826W,99,0,0,0,99
Hurricane,Michelle,25,2001-11-04T21:00:00Z,SABLE ISLAND NS,0,0,0,5,5
Hurricane,Michelle,25,2001-11-04T21:00:00Z,MUHA 230N 824W,16,0,0,0,16
Hurricane,Michelle,25,2001-11-04T21:00:00Z,SYDNEY NS,0,0,0,2,2
Hurricane,Michelle,25,2001-11-04T21:00:00Z,MBJT 215N 712W,0,1,1,0,2
Hurricane,Michelle,25,2001-11-04T21:00:00Z,EDDY POINT NS,0,0,0,2,2
Hurricane,Michelle,25,2001-11-04T21:00:00Z,MYMM 224N 730W,0,5,1,0,6
Hurricane,Michelle,25,2001-11-04T21:00:00Z,PTX BASQUES NFLD,0,0,0,2,2
Hurricane,Michelle,25,2001-11-04T21:00:00Z,MYSM 241N 745W,5,14,1,0,20
Hurricane,Michelle,25,2001-11-04T21:00:00Z,BURGEO NFLD,0,0,0,3,3
Hurricane,Michelle,25,2001-11-04T21:00:00Z,MYEG 235N 758W,14,7,0,0,21
Hurricane,Michelle,25,2001-11-04T21:00:00Z,ILE ST PIERRE,0,0,0,4,4
Hurricane,Michelle,25,2001-11-04T21:00:00Z,MYAK 241N 776W,37,1,0,0,38
Hurricane,Michelle,25,2001-11-04T21:00:00Z,CAPE RACE NFLD,0,0,0,5,5
Hurricane,Michelle,25,2001-11-04T21:00:00Z,MYNN 251N 775W,35,1,0,0,36
Hurricane,Michelle,25,2001-11-04T21:00:00Z,HIBERNIA OILFLD,0,0,0,3,3
Hurricane,Michelle,26,2001-11-05T03:00:00Z,25.8N  76.0W,23,3,0,0,26
Hurricane,Michelle,26,2001-11-05T03:00:00Z,MYEG 235N 758W,16,4,0,0,20
Hurricane,Michelle,26,2001-11-05T03:00:00Z,27.5N  72.5W,1,16,2,1,20
Hurricane,Michelle,26,2001-11-05T03:00:00Z,MYAK 241N 776W,45,0,0,0,45
Hurricane,Michelle,26,2001-11-05T03:00:00Z,29.0N  68.0W,0,1,12,2,15
Hurricane,Michelle,26,2001-11-05T03:00:00Z,MYNN 251N 775W,39,0,0,0,39
Hurricane,Michelle,26,2001-11-05T03:00:00Z,MUGM 200N 751W,0,1,1,0,2
Hurricane,Michelle,26,2001-11-05T03:00:00Z,MYGF 266N 787W,15,0,0,0,15
Hurricane,Michelle,26,2001-11-05T03:00:00Z,MUCM 214N 779W,9,1,0,0,10
Hurricane,Michelle,26,2001-11-05T03:00:00Z,BERMUDA,0,0,4,7,11
Hurricane,Michelle,26,2001-11-05T03:00:00Z,MUCF 221N 805W,99,0,0,0,99
Hurricane,Michelle,26,2001-11-05T03:00:00Z,MARATHON FL,8,0,0,0,8
Hurricane,Michelle,26,2001-11-05T03:00:00Z,MDPP 198N 707W,0,0,1,1,2
Hurricane,Michelle,26,2001-11-05T03:00:00Z,MIAMI FL,7,0,0,0,7
Hurricane,Michelle,26,2001-11-05T03:00:00Z,MBJT 215N 712W,0,1,3,0,4
Hurricane,Michelle,26,2001-11-05T03:00:00Z,W PALM BEACH FL,2,0,0,0,2
Hurricane,Michelle,26,2001-11-05T03:00:00Z,MYMM 224N 730W,0,6,2,1,9
Hurricane,Michelle,26,2001-11-05T03:00:00Z,SABLE ISLAND NS,0,0,0,2,2
Hurricane,Michelle,26,2001-11-05T03:00:00Z,MYSM 241N 745W,6,12,0,0,18
Hurricane,Michelle,26,2001-11-05T03:00:00Z,CAPE RACE NFLD,0,0,0,2,2
Hurricane,Michelle,27,2001-11-05T09:00:00Z,26.5N  74.1W,34,5,0,0,39
Hurricane,Michelle,27,2001-11-05T09:00:00Z,MYAK 241N 776W,78,0,0,0,78
Hurricane,Michelle,27,2001-11-05T09:00:00Z,28.0N  70.1W,0,20,5,0,25
Hurricane,Michelle,27,2001-11-05T09:00:00Z,MYNN 251N 775W,70,0,0,0,70
Hurricane,Michelle,27,2001-11-05T09:00:00Z,30.2N  65.4W,0,0,12,4,16
Hurricane,Michelle,27,2001-11-05T09:00:00Z,MYGF 266N 787W,7,0,0,0,7
Hurricane,Michelle,27,2001-11-05T09:00:00Z,MUCF 221N 805W,24,0,0,0,24
Hurricane,Michelle,27,2001-11-05T09:00:00Z,BERMUDA,0,0,7,7,14
Hurricane,Michelle,27,2001-11-05T09:00:00Z,MBJT 215N 712W,0,1,0,1,2
Hurricane,Michelle,27,2001-11-05T09:00:00Z,SABLE ISLAND NS,0,0,0,3,3
Hurricane,Michelle,27,2001-11-05T09:00:00Z,MYMM 224N 730W,1,3,0,0,4
Hurricane,Michelle,27,2001-11-05T09:00:00Z,ILE ST PIERRE,0,0,0,2,2
Hurricane,Michelle,27,2001-11-05T09:00:00Z,MYSM 241N 745W,27,3,0,0,30
Hurricane,Michelle,27,2001-11-05T09:00:00Z,CAPE RACE NFLD,0,0,0,2,2
Hurricane,Michelle,27,2001-11-05T09:00:00Z,MYEG 235N 758W,31,0,0,0,31
Hurricane,Michelle,28,2001-11-05T15:00:00Z,27.0N  72.1W,28,2,0,0,30
Hurricane,Michelle,28,2001-11-05T15:00:00Z,MYEG 235N 758W,35,0,0,0,35
Hurricane,Michelle,28,2001-11-05T15:00:00Z,28.0N  68.0W,1,15,2,1,19
Hurricane,Michelle,28,2001-11-05T15:00:00Z,MYAK 241N 776W,99,0,0,0,99
Hurricane,Michelle,28,2001-11-05T15:00:00Z,30.0N  64.0W,0,2,9,2,13
Hurricane,Michelle,28,2001-11-05T15:00:00Z,MYNN 251N 775W,99,0,0,0,99
Hurricane,Michelle,28,2001-11-05T15:00:00Z,MBJT 215N 712W,0,3,1,1,5
Hurricane,Michelle,28,2001-11-05T15:00:00Z,MYGF 266N 787W,2,0,0,0,2
Hurricane,Michelle,28,2001-11-05T15:00:00Z,MYMM 224N 730W,3,4,1,0,8
Hurricane,Michelle,28,2001-11-05T15:00:00Z,BERMUDA,0,1,8,3,12
Hurricane,Michelle,28,2001-11-05T15:00:00Z,MYSM 241N 745W,37,0,0,0,37
Hurricane,Michelle,28,2001-11-05T15:00:00Z,SABLE ISLAND NS,0,0,0,2,2
Hurricane,Michelle,29,2001-11-05T21:00:00Z,28.3N  68.9W,27,3,0,0,30
Hurricane,Michelle,29,2001-11-05T21:00:00Z,MYSM 241N 745W,6,0,0,0,6
Hurricane,Michelle,29,2001-11-05T21:00:00Z,29.5N  64.5W,1,18,3,0,22
Hurricane,Michelle,29,2001-11-05T21:00:00Z,MYNN 251N 775W,47,0,0,0,47
Hurricane,Michelle,29,2001-11-05T21:00:00Z,31.0N  60.0W,0,2,12,2,16
Hurricane,Michelle,29,2001-11-05T21:00:00Z,BERMUDA,0,10,4,1,15
Hurricane,Michelle,30,2001-11-06T03:00:00Z,29.0N  66.0W,28,5,0,0,33
Hurricane,Michelle,30,2001-11-06T03:00:00Z,BERMUDA,2,11,1,1,15
Hurricane,Michelle,30,2001-11-06T03:00:00Z,31.0N  61.0W,1,19,2,1,23
Hurricane,Michelle,30,2001-11-06T03:00:00Z,HIBERNIA OILFLD,0,0,0,2,2
Hurricane,Michelle,30,2001-11-06T03:00:00Z,33.5N  56.5W,0,2,12,2,16
Hurricane,Michelle,31,2001-11-06T09:00:00Z,29.6N  63.6W,25,7,0,0,32
Hurricane,Michelle,31,2001-11-06T09:00:00Z,34.5N  54.2W,0,1,14,2,17
Hurricane,Michelle,31,2001-11-06T09:00:00Z,31.9N  58.7W,0,20,3,1,24
Hurricane,Michelle,31,2001-11-06T09:00:00Z,BERMUDA,4,5,0,0,9
Hurricane,Michelle,32,2001-11-06T15:00:00Z,30.5N  57.5W,18,8,0,0,26
Hurricane,Michelle,32,2001-11-06T15:00:00Z,40.0N  40.0W,0,0,10,0,10
Hurricane,Michelle,32,2001-11-06T15:00:00Z,35.0N  50.0W,0,15,6,0,21
Hurricane,Noel,1,2001-11-05T16:00:00Z,44.0N  51.0W,18,3,0,0,21
Hurricane,Noel,1,2001-11-05T16:00:00Z,BURGEO NFLD,1,4,0,0,5
Hurricane,Noel,1,2001-11-05T16:00:00Z,51.0N  50.0W,0,8,0,0,8
Hurricane,Noel,1,2001-11-05T16:00:00Z,ILE ST PIERRE,3,5,0,0,8
Hurricane,Noel,1,2001-11-05T16:00:00Z,SYDNEY NS,1,1,0,0,2
Hurricane,Noel,1,2001-11-05T16:00:00Z,CAPE RACE NFLD,5,9,0,0,14
Hurricane,Noel,1,2001-11-05T16:00:00Z,PTX BASQUES NFLD,1,2,0,0,3
Hurricane,Noel,1,2001-11-05T16:00:00Z,HIBERNIA OILFLD,2,11,0,0,13
Hurricane,Noel,2,2001-11-05T21:00:00Z,46.0N  50.0W,24,5,0,0,29
Hurricane,Noel,2,2001-11-05T21:00:00Z,ILE ST PIERRE,1,4,0,0,5
Hurricane,Noel,2,2001-11-05T21:00:00Z,51.5N  51.0W,0,15,0,0,15
Hurricane,Noel,2,2001-11-05T21:00:00Z,CAPE RACE NFLD,10,8,0,0,18
Hurricane,Noel,2,2001-11-05T21:00:00Z,BURGEO NFLD,0,2,0,0,2
Hurricane,Noel,2,2001-11-05T21:00:00Z,HIBERNIA OILFLD,11,12,0,0,23
Tropical Storm,Noel,3,2001-11-06T03:00:00Z,47.5N  48.5W,26,3,0,0,29
Tropical Storm,Noel,3,2001-11-06T03:00:00Z,CAPE RACE NFLD,9,2,0,0,11
Tropical Storm,Noel,3,2001-11-06T03:00:00Z,53.0N  48.0W,0,14,0,0,14
Tropical Storm,Noel,3,2001-11-06T03:00:00Z,HIBERNIA OILFLD,27,2,0,0,29
Tropical Storm,Noel,4,2001-11-06T09:00:00Z,50.2N  48.0W,27,0,0,0,27
Tropical Storm,Noel,4,2001-11-06T09:00:00Z,HIBERNIA OILFLD,37,0,0,0,37
Tropical Storm,Noel,4,2001-11-06T09:00:00Z,CAPE RACE NFLD,3,0,0,0,3
Tropical Storm,Two,1,2001-11-24T21:00:00Z,32.0N  50.0W,33,0,0,0,33
Tropical Storm,Two,1,2001-11-24T21:00:00Z,HALIFAX NS,0,0,0,2,2
Tropical Storm,Two,1,2001-11-24T21:00:00Z,33.0N  50.9W,19,2,1,1,23
Tropical Storm,Two,1,2001-11-24T21:00:00Z,SABLE ISLAND NS,0,0,0,3,3
Tropical Storm,Two,1,2001-11-24T21:00:00Z,33.8N  52.0W,10,6,2,1,19
Tropical Storm,Two,1,2001-11-24T21:00:00Z,SYDNEY NS,0,0,0,2,2
Tropical Storm,Two,1,2001-11-24T21:00:00Z,BERMUDA,0,0,0,2,2
Tropical Storm,Two,1,2001-11-24T21:00:00Z,EDDY POINT NS,0,0,0,2,2
Tropical Storm,Two,2,2001-11-25T03:00:00Z,32.5N  52.9W,41,0,0,0,41
Tropical Storm,Two,2,2001-11-25T03:00:00Z,33.0N  55.5W,18,2,1,1,22
Tropical Storm,Two,2,2001-11-25T03:00:00Z,32.8N  54.2W,26,1,0,1,28
Tropical Storm,Two,2,2001-11-25T03:00:00Z,BERMUDA,0,0,0,4,4
Tropical Storm,Two,3,2001-11-25T09:00:00Z,32.5N  54.7W,50,0,0,0,50
Tropical Storm,Two,3,2001-11-25T09:00:00Z,32.4N  56.7W,22,1,1,1,25
Tropical Storm,Two,3,2001-11-25T09:00:00Z,32.5N  55.7W,32,1,0,0,33
Tropical Storm,Two,3,2001-11-25T09:00:00Z,BERMUDA,0,0,3,5,8
Tropical Storm,Two,4,2001-11-25T15:00:00Z,32.0N  56.4W,56,0,0,0,56
Tropical Storm,Two,4,2001-11-25T15:00:00Z,32.2N  58.3W,26,1,0,1,28
Tropical Storm,Two,4,2001-11-25T15:00:00Z,32.3N  57.4W,38,0,0,0,38
Tropical Storm,Two,4,2001-11-25T15:00:00Z,BERMUDA,0,3,4,4,11
Tropical Storm,Two,5,2001-11-25T21:00:00Z,30.6N  58.5W,52,0,0,0,52
Tropical Storm,Two,5,2001-11-25T21:00:00Z,30.7N  59.7W,27,1,1,0,29
Tropical Storm,Two,5,2001-11-25T21:00:00Z,30.8N  59.1W,39,0,0,0,39
Tropical Storm,Two,5,2001-11-25T21:00:00Z,BERMUDA,0,1,5,7,13
Tropical Storm,Two,6,2001-11-26T03:00:00Z,30.2N  56.8W,99,0,0,0,99
Tropical Storm,Two,6,2001-11-26T03:00:00Z,30.2N  58.2W,32,1,0,0,33
Tropical Storm,Two,6,2001-11-26T03:00:00Z,30.5N  57.5W,45,0,0,0,45
Tropical Storm,Two,6,2001-11-26T03:00:00Z,BERMUDA,0,1,3,3,7
Tropical Storm,Two,7,2001-11-26T09:00:00Z,30.5N  56.0W,99,0,0,0,99
Tropical Storm,Two,7,2001-11-26T09:00:00Z,30.5N  56.0W,99,0,0,0,99
Tropical Storm,Two,7,2001-11-26T09:00:00Z,30.5N  56.0W,99,0,0,0,99
Tropical Storm,Two,7,2001-11-26T09:00:00Z,BERMUDA,0,0,1,5,6
Tropical Storm,Olga,8,2001-11-26T15:00:00Z,31.2N  56.7W,99,0,0,0,99
Tropical Storm,Olga,8,2001-11-26T15:00:00Z,31.5N  57.7W,28,1,0,1,30
Tropical Storm,Olga,8,2001-11-26T15:00:00Z,31.3N  57.1W,44,0,0,0,44
Tropical Storm,Olga,8,2001-11-26T15:00:00Z,BERMUDA,0,0,3,5,8
Hurricane,Olga,9,2001-11-26T21:00:00Z,32.3N  56.5W,99,0,0,0,99
Hurricane,Olga,9,2001-11-26T21:00:00Z,BERMUDA,0,0,1,4,5
Hurricane,Olga,9,2001-11-26T21:00:00Z,32.3N  56.9W,51,0,0,0,51
Hurricane,Olga,9,2001-11-26T21:00:00Z,SABLE ISLAND NS,0,0,0,2,2
Hurricane,Olga,9,2001-11-26T21:00:00Z,32.2N  57.3W,42,0,0,0,42
Hurricane,Olga,10,2001-11-27T03:00:00Z,32.7N  56.9W,99,0,0,0,99
Hurricane,Olga,10,2001-11-27T03:00:00Z,32.2N  57.5W,47,0,0,0,47
Hurricane,Olga,10,2001-11-27T03:00:00Z,32.5N  57.2W,99,0,0,0,99
Hurricane,Olga,10,2001-11-27T03:00:00Z,BERMUDA,0,0,2,4,6
Hurricane,Olga,11,2001-11-27T09:00:00Z,32.5N  57.5W,99,0,0,0,99
Hurricane,Olga,11,2001-11-27T09:00:00Z,31.5N  58.0W,27,1,0,1,29
Hurricane,Olga,11,2001-11-27T09:00:00Z,32.5N  57.5W,99,0,0,0,99
Hurricane,Olga,11,2001-11-27T09:00:00Z,BERMUDA,0,3,2,3,8
Hurricane,Olga,12,2001-11-27T15:00:00Z,31.5N  57.0W,99,0,0,0,99
Hurricane,Olga,12,2001-11-27T15:00:00Z,31.0N  57.5W,99,0,0,0,99
Hurricane,Olga,12,2001-11-27T15:00:00Z,31.5N  57.0W,99,0,0,0,99
Hurricane,Olga,12,2001-11-27T15:00:00Z,BERMUDA,0,3,3,4,10
Hurricane,Olga,13,2001-11-27T21:00:00Z,32.0N  56.4W,99,0,0,0,99
Hurricane,Olga,13,2001-11-27T21:00:00Z,30.0N  57.4W,15,3,2,1,21
Hurricane,Olga,13,2001-11-27T21:00:00Z,30.9N  56.9W,24,1,1,0,26
Hurricane,Olga,13,2001-11-27T21:00:00Z,BERMUDA,0,0,1,4,5
Hurricane,Olga,14,2001-11-28T03:00:00Z,32.0N  56.0W,99,0,0,0,99
Hurricane,Olga,14,2001-11-28T03:00:00Z,30.0N  58.0W,11,4,3,1,19
Hurricane,Olga,14,2001-11-28T03:00:00Z,31.0N  57.0W,25,1,1,0,27
Hurricane,Olga,14,2001-11-28T03:00:00Z,BERMUDA,0,2,4,4,10
Hurricane,Olga,15,2001-11-28T09:00:00Z,32.5N  56.0W,99,0,0,0,99
Hurricane,Olga,15,2001-11-28T09:00:00Z,29.5N  59.5W,4,8,4,2,18
Hurricane,Olga,15,2001-11-28T09:00:00Z,31.0N  57.5W,17,4,1,1,23
Hurricane,Olga,15,2001-11-28T09:00:00Z,BERMUDA,0,3,5,3,11
Hurricane,Olga,16,2001-11-28T15:00:00Z,31.5N  57.7W,47,0,0,0,47
Hurricane,Olga,16,2001-11-28T15:00:00Z,MBJT 215N 712W,0,0,0,2,2
Hurricane,Olga,16,2001-11-28T15:00:00Z,30.6N  59.2W,19,2,1,1,23
Hurricane,Olga,16,2001-11-28T15:00:00Z,BERMUDA,1,5,3,3,12
Hurricane,Olga,16,2001-11-28T15:00:00Z,29.6N  60.9W,9,5,3,1,18
Hurricane,Olga,17,2001-11-28T21:00:00Z,29.0N  59.9W,32,0,0,0,32
Hurricane,Olga,17,2001-11-28T21:00:00Z,MDPP 198N 707W,0,0,0,4,4
Hurricane,Olga,17,2001-11-28T21:00:00Z,27.9N  62.1W,17,4,1,1,23
Hurricane,Olga,17,2001-11-28T21:00:00Z,MBJT 215N 712W,0,0,1,4,5
Hurricane,Olga,17,2001-11-28T21:00:00Z,27.1N  64.2W,5,11,2,2,20
Hurricane,Olga,17,2001-11-28T21:00:00Z,MYMM 224N 730W,0,0,0,4,4
Hurricane,Olga,17,2001-11-28T21:00:00Z,TIST 183N 650W,0,0,0,2,2
Hurricane,Olga,17,2001-11-28T21:00:00Z,MYSM 241N 745W,0,0,0,3,3
Hurricane,Olga,17,2001-11-28T21:00:00Z,TJPS 180N 666W,0,0,0,2,2
Hurricane,Olga,17,2001-11-28T21:00:00Z,MYEG 235N 758W,0,0,0,2,2
Hurricane,Olga,17,2001-11-28T21:00:00Z,MDSD 185N 697W,0,0,0,3,3
Hurricane,Olga,17,2001-11-28T21:00:00Z,BERMUDA,1,4,4,3,12
Hurricane,Olga,17,2001-11-28T21:00:00Z,MDCB 176N 714W,0,0,0,2,2
Hurricane,Olga,17,2001-11-28T21:00:00Z,ST THOMAS VI,0,0,0,2,2
Hurricane,Olga,17,2001-11-28T21:00:00Z,MTPP 186N 724W,0,0,0,2,2
Hurricane,Olga,17,2001-11-28T21:00:00Z,SAN JUAN PR,0,0,0,2,2
Hurricane,Olga,17,2001-11-28T21:00:00Z,MUGM 200N 751W,0,0,0,2,2
Hurricane,Olga,17,2001-11-28T21:00:00Z,PONCE PR,0,0,0,2,2
Hurricane,Olga,17,2001-11-28T21:00:00Z,TJSJ 184N 661W,0,0,0,2,2
Hurricane,Olga,18,2001-11-29T03:00:00Z,27.5N  61.5W,56,0,0,0,56
Hurricane,Olga,18,2001-11-29T03:00:00Z,TJSJ 184N 661W,0,0,0,2,2
Hurricane,Olga,18,2001-11-29T03:00:00Z,26.5N  63.7W,8,24,0,1,33
Hurricane,Olga,18,2001-11-29T03:00:00Z,MDPP 198N 707W,0,0,0,6,6
Hurricane,Olga,18,2001-11-29T03:00:00Z,26.0N  66.0W,0,17,4,1,22
Hurricane,Olga,18,2001-11-29T03:00:00Z,MBJT 215N 712W,0,0,0,8,8
Hurricane,Olga,18,2001-11-29T03:00:00Z,TJPS 180N 666W,0,0,0,2,2
Hurricane,Olga,18,2001-11-29T03:00:00Z,MYMM 224N 730W,0,0,0,6,6
Hurricane,Olga,18,2001-11-29T03:00:00Z,MDSD 185N 697W,0,0,0,4,4
Hurricane,Olga,18,2001-11-29T03:00:00Z,MYSM 241N 745W,0,0,0,5,5
Hurricane,Olga,18,2001-11-29T03:00:00Z,MDCB 176N 714W,0,0,0,3,3
Hurricane,Olga,18,2001-11-29T03:00:00Z,MYEG 235N 758W,0,0,0,3,3
Hurricane,Olga,18,2001-11-29T03:00:00Z,MTPP 186N 724W,0,0,0,3,3
Hurricane,Olga,18,2001-11-29T03:00:00Z,BERMUDA,0,0,1,3,4
Hurricane,Olga,18,2001-11-29T03:00:00Z,MTCA 183N 738W,0,0,0,2,2
Hurricane,Olga,18,2001-11-29T03:00:00Z,SAN JUAN PR,0,0,0,2,2
Hurricane,Olga,18,2001-11-29T03:00:00Z,MUGM 200N 751W,0,0,0,2,2
Hurricane,Olga,18,2001-11-29T03:00:00Z,PONCE PR,0,0,0,2,2
Tropical Storm,Olga,19,2001-11-29T09:00:00Z,26.4N  63.5W,46,0,0,0,46
Tropical Storm,Olga,19,2001-11-29T09:00:00Z,MYSM 241N 745W,0,0,0,9,9
Tropical Storm,Olga,19,2001-11-29T09:00:00Z,25.9N  66.3W,4,28,1,0,33
Tropical Storm,Olga,19,2001-11-29T09:00:00Z,MYEG 235N 758W,0,0,0,5,5
Tropical Storm,Olga,19,2001-11-29T09:00:00Z,25.7N  68.1W,0,19,5,2,26
Tropical Storm,Olga,19,2001-11-29T09:00:00Z,MYAK 241N 776W,0,0,0,2,2
Tropical Storm,Olga,19,2001-11-29T09:00:00Z,MBJT 215N 712W,0,0,1,5,6
Tropical Storm,Olga,19,2001-11-29T09:00:00Z,MYNN 251N 775W,0,0,0,3,3
Tropical Storm,Olga,19,2001-11-29T09:00:00Z,MYMM 224N 730W,0,0,0,7,7
Tropical Storm,Olga,20,2001-11-29T15:00:00Z,26.1N  65.2W,59,0,0,0,59
Tropical Storm,Olga,20,2001-11-29T15:00:00Z,MUCM 214N 779W,0,0,0,3,3
Tropical Storm,Olga,20,2001-11-29T15:00:00Z,25.6N  67.6W,7,28,0,0,35
Tropical Storm,Olga,20,2001-11-29T15:00:00Z,MDPP 198N 707W,0,0,2,3,5
Tropical Storm,Olga,20,2001-11-29T15:00:00Z,25.5N  69.4W,0,22,1,1,24
Tropical Storm,Olga,20,2001-11-29T15:00:00Z,MBJT 215N 712W,0,0,6,5,11
Tropical Storm,Olga,20,2001-11-29T15:00:00Z,MDSD 185N 697W,0,0,0,2,2
Tropical Storm,Olga,20,2001-11-29T15:00:00Z,MYMM 224N 730W,0,0,5,7,12
Tropical Storm,Olga,20,2001-11-29T15:00:00Z,MDCB 176N 714W,0,0,0,2,2
Tropical Storm,Olga,20,2001-11-29T15:00:00Z,MYSM 241N 745W,0,0,2,8,10
Tropical Storm,Olga,20,2001-11-29T15:00:00Z,MTPP 186N 724W,0,0,0,4,4
Tropical Storm,Olga,20,2001-11-29T15:00:00Z,MYEG 235N 758W,0,0,1,6,7
Tropical Storm,Olga,20,2001-11-29T15:00:00Z,MTCA 183N 738W,0,0,0,3,3
Tropical Storm,Olga,20,2001-11-29T15:00:00Z,MYAK 241N 776W,0,0,0,4,4
Tropical Storm,Olga,20,2001-11-29T15:00:00Z,MKJP 179N 768W,0,0,0,2,2
Tropical Storm,Olga,20,2001-11-29T15:00:00Z,MYNN 251N 775W,0,0,0,4,4
Tropical Storm,Olga,20,2001-11-29T15:00:00Z,MKJS 185N 779W,0,0,0,2,2
Tropical Storm,Olga,20,2001-11-29T15:00:00Z,MYGF 266N 787W,0,0,0,2,2
Tropical Storm,Olga,20,2001-11-29T15:00:00Z,MUGM 200N 751W,0,0,0,5,5
Tropical Storm,Olga,20,2001-11-29T15:00:00Z,BERMUDA,0,0,0,2,2
Tropical Storm,Olga,21,2001-11-29T21:00:00Z,24.8N  67.5W,59,0,0,0,59
Tropical Storm,Olga,21,2001-11-29T21:00:00Z,MBJT 215N 712W,0,6,5,1,12
Tropical Storm,Olga,21,2001-11-29T21:00:00Z,24.5N  70.1W,5,30,0,0,35
Tropical Storm,Olga,21,2001-11-29T21:00:00Z,MYMM 224N 730W,0,5,9,2,16
Tropical Storm,Olga,21,2001-11-29T21:00:00Z,24.5N  72.2W,0,19,4,0,23
Tropical Storm,Olga,21,2001-11-29T21:00:00Z,MYSM 241N 745W,0,2,11,4,17
Tropical Storm,Olga,21,2001-11-29T21:00:00Z,MTPP 186N 724W,0,0,1,2,3
Tropical Storm,Olga,21,2001-11-29T21:00:00Z,MYEG 235N 758W,0,0,8,6,14
Tropical Storm,Olga,21,2001-11-29T21:00:00Z,MTCA 183N 738W,0,0,1,3,4
Tropical Storm,Olga,21,2001-11-29T21:00:00Z,MYAK 241N 776W,0,0,2,8,10
Tropical Storm,Olga,21,2001-11-29T21:00:00Z,MKJP 179N 768W,0,0,0,4,4
Tropical Storm,Olga,21,2001-11-29T21:00:00Z,MYNN 251N 775W,0,0,2,8,10
Tropical Storm,Olga,21,2001-11-29T21:00:00Z,MKJS 185N 779W,0,0,0,5,5
Tropical Storm,Olga,21,2001-11-29T21:00:00Z,MYGF 266N 787W,0,0,0,6,6
Tropical Storm,Olga,21,2001-11-29T21:00:00Z,MWCG 193N 814W,0,0,0,2,2
Tropical Storm,Olga,21,2001-11-29T21:00:00Z,MARATHON FL,0,0,0,3,3
Tropical Storm,Olga,21,2001-11-29T21:00:00Z,MUGM 200N 751W,0,0,3,6,9
Tropical Storm,Olga,21,2001-11-29T21:00:00Z,MIAMI FL,0,0,0,4,4
Tropical Storm,Olga,21,2001-11-29T21:00:00Z,MUCM 214N 779W,0,0,1,8,9
Tropical Storm,Olga,21,2001-11-29T21:00:00Z,W PALM BEACH FL,0,0,0,3,3
Tropical Storm,Olga,21,2001-11-29T21:00:00Z,MUCF 221N 805W,0,0,0,4,4
Tropical Storm,Olga,21,2001-11-29T21:00:00Z,FT PIERCE FL,0,0,0,2,2
Tropical Storm,Olga,21,2001-11-29T21:00:00Z,MUSN 216N 826W,0,0,0,2,2
Tropical Storm,Olga,21,2001-11-29T21:00:00Z,COCOA BEACH FL,0,0,0,2,2
Tropical Storm,Olga,21,2001-11-29T21:00:00Z,MUHA 230N 824W,0,0,0,2,2
Tropical Storm,Olga,21,2001-11-29T21:00:00Z,KEY WEST FL,0,0,0,2,2
Tropical Storm,Olga,21,2001-11-29T21:00:00Z,MDPP 198N 707W,0,0,2,2,4
Tropical Storm,Olga,21,2001-11-29T21:00:00Z,MARCO ISLAND FL,0,0,0,2,2
Tropical Storm,Olga,22,2001-11-30T03:00:00Z,23.8N  68.5W,60,0,0,0,60
Tropical Storm,Olga,22,2001-11-30T03:00:00Z,MDPP 198N 707W,0,3,3,2,8
Tropical Storm,Olga,22,2001-11-30T03:00:00Z,23.5N  70.5W,16,20,0,0,36
Tropical Storm,Olga,22,2001-11-30T03:00:00Z,MBJT 215N 712W,0,15,2,1,18
Tropical Storm,Olga,22,2001-11-30T03:00:00Z,23.5N  72.0W,0,24,1,0,25
Tropical Storm,Olga,22,2001-11-30T03:00:00Z,MYMM 224N 730W,0,12,6,1,19
Tropical Storm,Olga,22,2001-11-30T03:00:00Z,MDSD 185N 697W,0,0,1,1,2
Tropical Storm,Olga,22,2001-11-30T03:00:00Z,MYSM 241N 745W,0,3,9,4,16
Tropical Storm,Olga,22,2001-11-30T03:00:00Z,MDCB 176N 714W,0,0,1,2,3
Tropical Storm,Olga,22,2001-11-30T03:00:00Z,MYEG 235N 758W,0,0,7,7,14
Tropical Storm,Olga,22,2001-11-30T03:00:00Z,MTPP 186N 724W,0,0,3,4,7
Tropical Storm,Olga,22,2001-11-30T03:00:00Z,MYAK 241N 776W,0,0,1,8,9
Tropical Storm,Olga,22,2001-11-30T03:00:00Z,MTCA 183N 738W,0,0,2,5,7
Tropical Storm,Olga,22,2001-11-30T03:00:00Z,MYNN 251N 775W,0,0,1,7,8
Tropical Storm,Olga,22,2001-11-30T03:00:00Z,MKJP 179N 768W,0,0,0,6,6
Tropical Storm,Olga,22,2001-11-30T03:00:00Z,MYGF 266N 787W,0,0,0,4,4
Tropical Storm,Olga,22,2001-11-30T03:00:00Z,MKJS 185N 779W,0,0,0,6,6
Tropical Storm,Olga,22,2001-11-30T03:00:00Z,MARATHON FL,0,0,0,2,2
Tropical Storm,Olga,22,2001-11-30T03:00:00Z,MWCG 193N 814W,0,0,0,2,2
Tropical Storm,Olga,22,2001-11-30T03:00:00Z,MIAMI FL,0,0,0,3,3
Tropical Storm,Olga,22,2001-11-30T03:00:00Z,MUGM 200N 751W,0,0,5,6,11
Tropical Storm,Olga,22,2001-11-30T03:00:00Z,W PALM BEACH FL,0,0,0,2,2
Tropical Storm,Olga,22,2001-11-30T03:00:00Z,MUCM 214N 779W,0,0,1,8,9
Tropical Storm,Olga,22,2001-11-30T03:00:00Z,FT PIERCE FL,0,0,0,2,2
Tropical Storm,Olga,22,2001-11-30T03:00:00Z,MUCF 221N 805W,0,0,0,4,4
Tropical Storm,Olga,22,2001-11-30T03:00:00Z,KEY WEST FL,0,0,0,2,2
Tropical Storm,Olga,23,2001-11-30T09:00:00Z,23.8N  70.0W,62,0,0,0,62
Tropical Storm,Olga,23,2001-11-30T09:00:00Z,MYMM 224N 730W,0,19,2,1,22
Tropical Storm,Olga,23,2001-11-30T09:00:00Z,23.5N  71.5W,30,9,0,0,39
Tropical Storm,Olga,23,2001-11-30T09:00:00Z,MYSM 241N 745W,0,11,5,3,19
Tropical Storm,Olga,23,2001-11-30T09:00:00Z,23.5N  73.0W,2,21,1,1,25
Tropical Storm,Olga,23,2001-11-30T09:00:00Z,MYEG 235N 758W,0,2,9,5,16
Tropical Storm,Olga,23,2001-11-30T09:00:00Z,MTPP 186N 724W,0,0,2,2,4
Tropical Storm,Olga,23,2001-11-30T09:00:00Z,MYAK 241N 776W,0,0,4,8,12
Tropical Storm,Olga,23,2001-11-30T09:00:00Z,MTCA 183N 738W,0,0,2,3,5
Tropical Storm,Olga,23,2001-11-30T09:00:00Z,MYNN 251N 775W,0,0,3,8,11
Tropical Storm,Olga,23,2001-11-30T09:00:00Z,MKJP 179N 768W,0,0,1,5,6
Tropical Storm,Olga,23,2001-11-30T09:00:00Z,MYGF 266N 787W,0,0,0,6,6
Tropical Storm,Olga,23,2001-11-30T09:00:00Z,MKJS 185N 779W,0,0,1,6,7
Tropical Storm,Olga,23,2001-11-30T09:00:00Z,MARATHON FL,0,0,0,4,4
Tropical Storm,Olga,23,2001-11-30T09:00:00Z,MWCG 193N 814W,0,0,0,4,4
Tropical Storm,Olga,23,2001-11-30T09:00:00Z,MIAMI FL,0,0,0,4,4
Tropical Storm,Olga,23,2001-11-30T09:00:00Z,MUGM 200N 751W,0,1,6,4,11
Tropical Storm,Olga,23,2001-11-30T09:00:00Z,W PALM BEACH FL,0,0,0,4,4
Tropical Storm,Olga,23,2001-11-30T09:00:00Z,MUCM 214N 779W,0,0,3,8,11
Tropical Storm,Olga,23,2001-11-30T09:00:00Z,FT PIERCE FL,0,0,0,2,2
Tropical Storm,Olga,23,2001-11-30T09:00:00Z,MUCF 221N 805W,0,0,0,6,6
Tropical Storm,Olga,23,2001-11-30T09:00:00Z,COCOA BEACH FL,0,0,0,2,2
Tropical Storm,Olga,23,2001-11-30T09:00:00Z,MUSN 216N 826W,0,0,0,3,3
Tropical Storm,Olga,23,2001-11-30T09:00:00Z,KEY WEST FL,0,0,0,3,3
Tropical Storm,Olga,23,2001-11-30T09:00:00Z,MUHA 230N 824W,0,0,0,3,3
Tropical Storm,Olga,23,2001-11-30T09:00:00Z,MARCO ISLAND FL,0,0,0,2,2
Tropical Storm,Olga,23,2001-11-30T09:00:00Z,MDPP 198N 707W,0,2,1,1,4
Tropical Storm,Olga,23,2001-11-30T09:00:00Z,FT MYERS FL,0,0,0,2,2
Tropical Storm,Olga,23,2001-11-30T09:00:00Z,MBJT 215N 712W,2,12,1,1,16
Tropical Depression,Olga,24,2001-11-30T15:00:00Z,23.0N  71.0W,64,0,0,0,64
Tropical Depression,Olga,24,2001-11-30T15:00:00Z,MBJT 215N 712W,21,3,0,1,25
Tropical Depression,Olga,24,2001-11-30T15:00:00Z,23.0N  72.5W,34,6,0,0,40
Tropical Depression,Olga,24,2001-11-30T15:00:00Z,MYMM 224N 730W,12,18,0,0,30
Tropical Depression,Olga,24,2001-11-30T15:00:00Z,23.0N  74.0W,2,21,1,1,25
Tropical Depression,Olga,24,2001-11-30T15:00:00Z,MYSM 241N 745W,1,16,3,1,21
Tropical Depression,Olga,24,2001-11-30T15:00:00Z,MTPP 186N 724W,0,1,1,2,4
Tropical Depression,Olga,24,2001-11-30T15:00:00Z,MYEG 235N 758W,0,8,7,3,18
Tropical Depression,Olga,24,2001-11-30T15:00:00Z,MTCA 183N 738W,0,0,3,3,6
Tropical Depression,Olga,24,2001-11-30T15:00:00Z,MYAK 241N 776W,0,0,7,6,13
Tropical Depression,Olga,24,2001-11-30T15:00:00Z,MKJP 179N 768W,0,0,2,5,7
Tropical Depression,Olga,24,2001-11-30T15:00:00Z,MYNN 251N 775W,0,0,5,7,12
Tropical Depression,Olga,24,2001-11-30T15:00:00Z,MKJS 185N 779W,0,0,2,6,8
Tropical Depression,Olga,24,2001-11-30T15:00:00Z,MYGF 266N 787W,0,0,1,5,6
Tropical Depression,Olga,24,2001-11-30T15:00:00Z,MWCG 193N 814W,0,0,0,5,5
Tropical Depression,Olga,24,2001-11-30T15:00:00Z,MARATHON FL,0,0,0,4,4
Tropical Depression,Olga,24,2001-11-30T15:00:00Z,MUGM 200N 751W,0,3,7,3,13
Tropical Depression,Olga,24,2001-11-30T15:00:00Z,MIAMI FL,0,0,0,4,4
Tropical Depression,Olga,24,2001-11-30T15:00:00Z,MUCM 214N 779W,0,0,7,6,13
Tropical Depression,Olga,24,2001-11-30T15:00:00Z,W PALM BEACH FL,0,0,0,4,4
Tropical Depression,Olga,24,2001-11-30T15:00:00Z,MUCF 221N 805W,0,0,1,6,7
Tropical Depression,Olga,24,2001-11-30T15:00:00Z,FT PIERCE FL,0,0,0,2,2
Tropical Depression,Olga,24,2001-11-30T15:00:00Z,MUSN 216N 826W,0,0,0,4,4
Tropical Depression,Olga,24,2001-11-30T15:00:00Z,KEY WEST FL,0,0,0,3,3
Tropical Depression,Olga,24,2001-11-30T15:00:00Z,MUHA 230N 824W,0,0,0,3,3
Tropical Depression,Olga,24,2001-11-30T15:00:00Z,MARCO ISLAND FL,0,0,0,2,2
Tropical Depression,Olga,24,2001-11-30T15:00:00Z,MDPP 198N 707W,0,2,1,1,4
Tropical Depression,Olga,24,2001-11-30T15:00:00Z,FT MYERS FL,0,0,0,2,2
Tropical Depression,Olga,25,2001-11-30T21:00:00Z,22.8N  70.0W,56,0,0,0,56
Tropical Depression,Olga,25,2001-11-30T21:00:00Z,MBJT 215N 712W,21,3,1,1,26
Tropical Depression,Olga,25,2001-11-30T21:00:00Z,22.8N  71.5W,35,2,0,0,37
Tropical Depression,Olga,25,2001-11-30T21:00:00Z,MYMM 224N 730W,8,14,2,1,25
Tropical Depression,Olga,25,2001-11-30T21:00:00Z,22.8N  72.5W,18,10,1,0,29
Tropical Depression,Olga,25,2001-11-30T21:00:00Z,MYSM 241N 745W,0,10,6,5,21
Tropical Depression,Olga,25,2001-11-30T21:00:00Z,MDSD 185N 697W,0,0,1,1,2
Tropical Depression,Olga,25,2001-11-30T21:00:00Z,MYEG 235N 758W,0,3,7,8,18
Tropical Depression,Olga,25,2001-11-30T21:00:00Z,MDCB 176N 714W,0,0,0,2,2
Tropical Depression,Olga,25,2001-11-30T21:00:00Z,MYAK 241N 776W,0,0,3,10,13
Tropical Depression,Olga,25,2001-11-30T21:00:00Z,MTPP 186N 724W,0,0,2,4,6
Tropical Depression,Olga,25,2001-11-30T21:00:00Z,MYNN 251N 775W,0,0,2,10,12
Tropical Depression,Olga,25,2001-11-30T21:00:00Z,MTCA 183N 738W,0,0,1,4,5
Tropical Depression,Olga,25,2001-11-30T21:00:00Z,MYGF 266N 787W,0,0,0,7,7
Tropical Depression,Olga,25,2001-11-30T21:00:00Z,MKJP 179N 768W,0,0,0,3,3
Tropical Depression,Olga,25,2001-11-30T21:00:00Z,MARATHON FL,0,0,0,4,4
Tropical Depression,Olga,25,2001-11-30T21:00:00Z,MKJS 185N 779W,0,0,0,4,4
Tropical Depression,Olga,25,2001-11-30T21:00:00Z,MIAMI FL,0,0,0,5,5
Tropical Depression,Olga,25,2001-11-30T21:00:00Z,MWCG 193N 814W,0,0,0,2,2
Tropical Depression,Olga,25,2001-11-30T21:00:00Z,W PALM BEACH FL,0,0,0,4,4
Tropical Depression,Olga,25,2001-11-30T21:00:00Z,MUGM 200N 751W,0,1,4,7,12
Tropical Depression,Olga,25,2001-11-30T21:00:00Z,FT PIERCE FL,0,0,0,3,3
Tropical Depression,Olga,25,2001-11-30T21:00:00Z,MUCM 214N 779W,0,0,1,10,11
Tropical Depression,Olga,25,2001-11-30T21:00:00Z,COCOA BEACH FL,0,0,0,2,2
Tropical Depression,Olga,25,2001-11-30T21:00:00Z,MUCF 221N 805W,0,0,0,6,6
Tropical Depression,Olga,25,2001-11-30T21:00:00Z,KEY WEST FL,0,0,0,3,3
Tropical Depression,Olga,25,2001-11-30T21:00:00Z,MUSN 216N 826W,0,0,0,2,2
Tropical Depression,Olga,25,2001-11-30T21:00:00Z,MARCO ISLAND FL,0,0,0,2,2
Tropical Depression,Olga,25,2001-11-30T21:00:00Z,MUHA 230N 824W,0,0,0,3,3
Tropical Depression,Olga,25,2001-11-30T21:00:00Z,FT MYERS FL,0,0,0,2,2
Tropical Depression,Olga,25,2001-11-30T21:00:00Z,MDPP 198N 707W,1,4,2,3,10
Tropical Depression,Olga,26,2001-12-01T03:00:00Z,23.0N  70.3W,52,0,0,0,52
Tropical Depression,Olga,26,2001-12-01T03:00:00Z,MBJT 215N 712W,16,3,1,1,21
Tropical Depression,Olga,26,2001-12-01T03:00:00Z,23.0N  71.5W,33,1,0,0,34
Tropical Depression,Olga,26,2001-12-01T03:00:00Z,MYMM 224N 730W,8,12,2,2,24
Tropical Depression,Olga,26,2001-12-01T03:00:00Z,23.0N  72.5W,17,8,1,1,27
Tropical Depression,Olga,26,2001-12-01T03:00:00Z,MYSM 241N 745W,0,10,6,4,20
Tropical Depression,Olga,26,2001-12-01T03:00:00Z,MTPP 186N 724W,0,0,2,2,4
Tropical Depression,Olga,26,2001-12-01T03:00:00Z,MYEG 235N 758W,0,4,8,6,18
Tropical Depression,Olga,26,2001-12-01T03:00:00Z,MTCA 183N 738W,0,0,1,3,4
Tropical Depression,Olga,26,2001-12-01T03:00:00Z,MYAK 241N 776W,0,0,4,9,13
Tropical Depression,Olga,26,2001-12-01T03:00:00Z,MKJP 179N 768W,0,0,0,3,3
Tropical Depression,Olga,26,2001-12-01T03:00:00Z,MYNN 251N 775W,0,0,3,9,12
Tropical Depression,Olga,26,2001-12-01T03:00:00Z,MKJS 185N 779W,0,0,0,4,4
Tropical Depression,Olga,26,2001-12-01T03:00:00Z,MYGF 266N 787W,0,0,0,7,7
Tropical Depression,Olga,26,2001-12-01T03:00:00Z,MWCG 193N 814W,0,0,0,2,2
Tropical Depression,Olga,26,2001-12-01T03:00:00Z,MARATHON FL,0,0,0,4,4
Tropical Depression,Olga,26,2001-12-01T03:00:00Z,MUGM 200N 751W,0,1,5,5,11
Tropical Depression,Olga,26,2001-12-01T03:00:00Z,MIAMI FL,0,0,0,5,5
Tropical Depression,Olga,26,2001-12-01T03:00:00Z,MUCM 214N 779W,0,0,3,8,11
Tropical Depression,Olga,26,2001-12-01T03:00:00Z,W PALM BEACH FL,0,0,0,4,4
Tropical Depression,Olga,26,2001-12-01T03:00:00Z,MUCF 221N 805W,0,0,0,6,6
Tropical Depression,Olga,26,2001-12-01T03:00:00Z,FT PIERCE FL,0,0,0,2,2
Tropical Depression,Olga,26,2001-12-01T03:00:00Z,MUSN 216N 826W,0,0,0,2,2
Tropical Depression,Olga,26,2001-12-01T03:00:00Z,KEY WEST FL,0,0,0,3,3
Tropical Depression,Olga,26,2001-12-01T03:00:00Z,MUHA 230N 824W,0,0,0,2,2
Tropical Depression,Olga,26,2001-12-01T03:00:00Z,MARCO ISLAND FL,0,0,0,2,2
Tropical Depression,Olga,26,2001-12-01T03:00:00Z,MDPP 198N 707W,0,3,1,3,7
Tropical Depression,Olga,27,2001-12-01T09:00:00Z,22.6N  71.0W,53,0,0,0,53
Tropical Depression,Olga,27,2001-12-01T09:00:00Z,MYMM 224N 730W,21,6,1,0,28
Tropical Depression,Olga,27,2001-12-01T09:00:00Z,22.7N  72.2W,36,0,1,0,37
Tropical Depression,Olga,27,2001-12-01T09:00:00Z,MYSM 241N 745W,1,13,5,3,22
Tropical Depression,Olga,27,2001-12-01T09:00:00Z,22.9N  73.3W,17,9,1,1,28
Tropical Depression,Olga,27,2001-12-01T09:00:00Z,MYEG 235N 758W,0,7,7,5,19
Tropical Depression,Olga,27,2001-12-01T09:00:00Z,MTPP 186N 724W,0,1,1,2,4
Tropical Depression,Olga,27,2001-12-01T09:00:00Z,MYAK 241N 776W,0,0,6,9,15
Tropical Depression,Olga,27,2001-12-01T09:00:00Z,MTCA 183N 738W,0,0,2,2,4
Tropical Depression,Olga,27,2001-12-01T09:00:00Z,MYNN 251N 775W,0,0,4,10,14
Tropical Depression,Olga,27,2001-12-01T09:00:00Z,MKJP 179N 768W,0,0,0,4,4
Tropical Depression,Olga,27,2001-12-01T09:00:00Z,MYGF 266N 787W,0,0,0,8,8
Tropical Depression,Olga,27,2001-12-01T09:00:00Z,MKJS 185N 779W,0,0,0,5,5
Tropical Depression,Olga,27,2001-12-01T09:00:00Z,MARATHON FL,0,0,0,5,5
Tropical Depression,Olga,27,2001-12-01T09:00:00Z,MWCG 193N 814W,0,0,0,2,2
Tropical Depression,Olga,27,2001-12-01T09:00:00Z,MIAMI FL,0,0,0,6,6
Tropical Depression,Olga,27,2001-12-01T09:00:00Z,MUGM 200N 751W,0,3,5,4,12
Tropical Depression,Olga,27,2001-12-01T09:00:00Z,W PALM BEACH FL,0,0,0,5,5
Tropical Depression,Olga,27,2001-12-01T09:00:00Z,MUCM 214N 779W,0,0,4,8,12
Tropical Depression,Olga,27,2001-12-01T09:00:00Z,FT PIERCE FL,0,0,0,3,3
Tropical Depression,Olga,27,2001-12-01T09:00:00Z,MUCF 221N 805W,0,0,0,7,7
Tropical Depression,Olga,27,2001-12-01T09:00:00Z,COCOA BEACH FL,0,0,0,2,2
Tropical Depression,Olga,27,2001-12-01T09:00:00Z,MUSN 216N 826W,0,0,0,2,2
Tropical Depression,Olga,27,2001-12-01T09:00:00Z,KEY WEST FL,0,0,0,4,4
Tropical Depression,Olga,27,2001-12-01T09:00:00Z,MUHA 230N 824W,0,0,0,3,3
Tropical Depression,Olga,27,2001-12-01T09:00:00Z,MARCO ISLAND FL,0,0,0,3,3
Tropical Depression,Olga,27,2001-12-01T09:00:00Z,MDPP 198N 707W,2,3,2,1,8
Tropical Depression,Olga,27,2001-12-01T09:00:00Z,FT MYERS FL,0,0,0,2,2
Tropical Depression,Olga,27,2001-12-01T09:00:00Z,MBJT 215N 712W,30,0,1,0,31
Tropical Depression,Olga,28,2001-12-01T15:00:00Z,23.1N  70.6W,74,0,0,0,74
Tropical Depression,Olga,28,2001-12-01T15:00:00Z,MYEG 235N 758W,0,6,8,4,18
Tropical Depression,Olga,28,2001-12-01T15:00:00Z,23.6N  71.8W,45,2,0,0,47
Tropical Depression,Olga,28,2001-12-01T15:00:00Z,MYAK 241N 776W,0,0,6,7,13
Tropical Depression,Olga,28,2001-12-01T15:00:00Z,24.2N  72.8W,21,12,1,0,34
Tropical Depression,Olga,28,2001-12-01T15:00:00Z,MYNN 251N 775W,0,0,6,7,13
Tropical Depression,Olga,28,2001-12-01T15:00:00Z,MWCG 193N 814W,0,0,0,2,2
Tropical Depression,Olga,28,2001-12-01T15:00:00Z,MYGF 266N 787W,0,0,1,7,8
Tropical Depression,Olga,28,2001-12-01T15:00:00Z,MUGM 200N 751W,0,0,1,3,4
Tropical Depression,Olga,28,2001-12-01T15:00:00Z,MARATHON FL,0,0,0,5,5
Tropical Depression,Olga,28,2001-12-01T15:00:00Z,MUCM 214N 779W,0,0,1,6,7
Tropical Depression,Olga,28,2001-12-01T15:00:00Z,MIAMI FL,0,0,0,6,6
Tropical Depression,Olga,28,2001-12-01T15:00:00Z,MUCF 221N 805W,0,0,0,6,6
Tropical Depression,Olga,28,2001-12-01T15:00:00Z,W PALM BEACH FL,0,0,0,5,5
Tropical Depression,Olga,28,2001-12-01T15:00:00Z,MUSN 216N 826W,0,0,0,3,3
Tropical Depression,Olga,28,2001-12-01T15:00:00Z,FT PIERCE FL,0,0,0,3,3
Tropical Depression,Olga,28,2001-12-01T15:00:00Z,MUHA 230N 824W,0,0,0,4,4
Tropical Depression,Olga,28,2001-12-01T15:00:00Z,COCOA BEACH FL,0,0,0,2,2
Tropical Depression,Olga,28,2001-12-01T15:00:00Z,MDPP 198N 707W,0,0,1,1,2
Tropical Depression,Olga,28,2001-12-01T15:00:00Z,KEY WEST FL,0,0,0,4,4
Tropical Depression,Olga,28,2001-12-01T15:00:00Z,MBJT 215N 712W,17,2,1,0,20
Tropical Depression,Olga,28,2001-12-01T15:00:00Z,MARCO ISLAND FL,0,0,0,3,3
Tropical Depression,Olga,28,2001-12-01T15:00:00Z,MYMM 224N 730W,14,9,1,1,25
Tropical Depression,Olga,28,2001-12-01T15:00:00Z,FT MYERS FL,0,0,0,3,3
Tropical Depression,Olga,28,2001-12-01T15:00:00Z,MYSM 241N 745W,2,16,4,2,24
Tropical Depression,Olga,28,2001-12-01T15:00:00Z,VENICE FL,0,0,0,2,2
Tropical Depression,Olga,29,2001-12-01T21:00:00Z,24.2N  71.1W,54,0,0,0,54
Tropical Depression,Olga,29,2001-12-01T21:00:00Z,MYGF 266N 787W,0,0,2,6,8
Tropical Depression,Olga,29,2001-12-01T21:00:00Z,25.0N  72.0W,35,0,1,0,36
Tropical Depression,Olga,29,2001-12-01T21:00:00Z,MARATHON FL,0,0,0,5,5
Tropical Depression,Olga,29,2001-12-01T21:00:00Z,25.5N  72.5W,21,6,1,1,29
Tropical Depression,Olga,29,2001-12-01T21:00:00Z,MIAMI FL,0,0,0,6,6
Tropical Depression,Olga,29,2001-12-01T21:00:00Z,MUGM 200N 751W,0,0,0,2,2
Tropical Depression,Olga,29,2001-12-01T21:00:00Z,W PALM BEACH FL,0,0,0,6,6
Tropical Depression,Olga,29,2001-12-01T21:00:00Z,MUCM 214N 779W,0,0,1,3,4
Tropical Depression,Olga,29,2001-12-01T21:00:00Z,FT PIERCE FL,0,0,0,5,5
Tropical Depression,Olga,29,2001-12-01T21:00:00Z,MUCF 221N 805W,0,0,0,3,3
Tropical Depression,Olga,29,2001-12-01T21:00:00Z,COCOA BEACH FL,0,0,0,3,3
Tropical Depression,Olga,29,2001-12-01T21:00:00Z,MUHA 230N 824W,0,0,0,3,3
Tropical Depression,Olga,29,2001-12-01T21:00:00Z,DAYTONA BEACH FL,0,0,0,2,2
Tropical Depression,Olga,29,2001-12-01T21:00:00Z,MBJT 215N 712W,18,0,0,1,19
Tropical Depression,Olga,29,2001-12-01T21:00:00Z,KEY WEST FL,0,0,0,4,4
Tropical Depression,Olga,29,2001-12-01T21:00:00Z,MYMM 224N 730W,12,4,1,1,18
Tropical Depression,Olga,29,2001-12-01T21:00:00Z,MARCO ISLAND FL,0,0,0,4,4
Tropical Depression,Olga,29,2001-12-01T21:00:00Z,MYSM 241N 745W,2,13,3,2,20
Tropical Depression,Olga,29,2001-12-01T21:00:00Z,FT MYERS FL,0,0,0,3,3
Tropical Depression,Olga,29,2001-12-01T21:00:00Z,MYEG 235N 758W,0,5,5,4,14
Tropical Depression,Olga,29,2001-12-01T21:00:00Z,VENICE FL,0,0,0,3,3
Tropical Depression,Olga,29,2001-12-01T21:00:00Z,MYAK 241N 776W,0,0,5,6,11
Tropical Depression,Olga,29,2001-12-01T21:00:00Z,TAMPA FL,0,0,0,2,2
Tropical Depression,Olga,29,2001-12-01T21:00:00Z,MYNN 251N 775W,0,0,5,7,12
Tropical Storm,Olga,30,2001-12-02T03:00:00Z,24.7N  70.2W,66,0,0,0,66
Tropical Storm,Olga,30,2001-12-02T03:00:00Z,MARATHON FL,0,0,0,3,3
Tropical Storm,Olga,30,2001-12-02T03:00:00Z,25.3N  70.8W,36,1,0,0,37
Tropical Storm,Olga,30,2001-12-02T03:00:00Z,MIAMI FL,0,0,0,5,5
Tropical Storm,Olga,30,2001-12-02T03:00:00Z,26.0N  71.5W,16,6,2,1,25
Tropical Storm,Olga,30,2001-12-02T03:00:00Z,W PALM BEACH FL,0,0,0,5,5
Tropical Storm,Olga,30,2001-12-02T03:00:00Z,MUGM 200N 751W,0,0,1,2,3
Tropical Storm,Olga,30,2001-12-02T03:00:00Z,FT PIERCE FL,0,0,0,5,5
Tropical Storm,Olga,30,2001-12-02T03:00:00Z,MUCM 214N 779W,0,0,0,3,3
Tropical Storm,Olga,30,2001-12-02T03:00:00Z,COCOA BEACH FL,0,0,0,4,4
Tropical Storm,Olga,30,2001-12-02T03:00:00Z,MUCF 221N 805W,0,0,0,2,2
Tropical Storm,Olga,30,2001-12-02T03:00:00Z,DAYTONA BEACH FL,0,0,0,3,3
Tropical Storm,Olga,30,2001-12-02T03:00:00Z,MDPP 198N 707W,0,0,1,2,3
Tropical Storm,Olga,30,2001-12-02T03:00:00Z,JACKSONVILLE FL,0,0,0,2,2
Tropical Storm,Olga,30,2001-12-02T03:00:00Z,MBJT 215N 712W,2,3,3,3,11
Tropical Storm,Olga,30,2001-12-02T03:00:00Z,KEY WEST FL,0,0,0,2,2
Tropical Storm,Olga,30,2001-12-02T03:00:00Z,MYMM 224N 730W,3,6,3,3,15
Tropical Storm,Olga,30,2001-12-02T03:00:00Z,MARCO ISLAND FL,0,0,0,3,3
Tropical Storm,Olga,30,2001-12-02T03:00:00Z,MYSM 241N 745W,1,7,5,4,17
Tropical Storm,Olga,30,2001-12-02T03:00:00Z,FT MYERS FL,0,0,0,3,3
Tropical Storm,Olga,30,2001-12-02T03:00:00Z,MYEG 235N 758W,0,2,5,5,12
Tropical Storm,Olga,30,2001-12-02T03:00:00Z,VENICE FL,0,0,0,2,2
Tropical Storm,Olga,30,2001-12-02T03:00:00Z,MYAK 241N 776W,0,0,2,7,9
Tropical Storm,Olga,30,2001-12-02T03:00:00Z,TAMPA FL,0,0,0,2,2
Tropical Storm,Olga,30,2001-12-02T03:00:00Z,MYNN 251N 775W,0,0,3,7,10
Tropical Storm,Olga,30,2001-12-02T03:00:00Z,CEDAR KEY FL,0,0,0,2,2
Tropical Storm,Olga,30,2001-12-02T03:00:00Z,MYGF 266N 787W,0,0,1,7,8
Tropical Storm,Olga,31,2001-12-02T09:00:00Z,26.4N  70.0W,43,0,0,0,43
Tropical Storm,Olga,31,2001-12-02T09:00:00Z,FT PIERCE FL,0,0,0,2,2
Tropical Storm,Olga,31,2001-12-02T09:00:00Z,27.5N  70.2W,28,1,0,0,29
Tropical Storm,Olga,31,2001-12-02T09:00:00Z,COCOA BEACH FL,0,0,0,2,2
Tropical Storm,Olga,31,2001-12-02T09:00:00Z,28.0N  70.5W,22,1,1,1,25
Tropical Storm,Olga,31,2001-12-02T09:00:00Z,DAYTONA BEACH FL,0,0,0,2,2
Tropical Storm,Olga,31,2001-12-02T09:00:00Z,MBJT 215N 712W,0,0,1,1,2
Tropical Storm,Olga,31,2001-12-02T09:00:00Z,JACKSONVILLE FL,0,0,0,2,2
Tropical Storm,Olga,31,2001-12-02T09:00:00Z,MYMM 224N 730W,0,1,0,2,3
Tropical Storm,Olga,31,2001-12-02T09:00:00Z,SAVANNAH GA,0,0,0,2,2
Tropical Storm,Olga,31,2001-12-02T09:00:00Z,MYSM 241N 745W,0,2,1,2,5
Tropical Storm,Olga,31,2001-12-02T09:00:00Z,CHARLESTON SC,0,0,0,3,3
Tropical Storm,Olga,31,2001-12-02T09:00:00Z,MYEG 235N 758W,0,0,1,1,2
Tropical Storm,Olga,31,2001-12-02T09:00:00Z,MYRTLE BEACH SC,0,0,0,3,3
Tropical Storm,Olga,31,2001-12-02T09:00:00Z,MYNN 251N 775W,0,0,1,2,3
Tropical Storm,Olga,31,2001-12-02T09:00:00Z,WILMINGTON NC,0,0,0,3,3
Tropical Storm,Olga,31,2001-12-02T09:00:00Z,MYGF 266N 787W,0,0,1,2,3
Tropical Storm,Olga,31,2001-12-02T09:00:00Z,MOREHEAD CITY NC,0,0,0,3,3
Tropical Storm,Olga,31,2001-12-02T09:00:00Z,BERMUDA,0,0,1,2,3
Tropical Storm,Olga,31,2001-12-02T09:00:00Z,CAPE HATTERAS NC,0,0,0,3,3
Tropical Storm,Olga,31,2001-12-02T09:00:00Z,W PALM BEACH FL,0,0,0,2,2
Tropical Storm,Olga,32,2001-12-02T15:00:00Z,27.8N  69.6W,42,0,0,0,42
Tropical Storm,Olga,32,2001-12-02T15:00:00Z,MYRTLE BEACH SC,0,0,0,3,3
Tropical Storm,Olga,32,2001-12-02T15:00:00Z,28.4N  69.5W,24,1,0,1,26
Tropical Storm,Olga,32,2001-12-02T15:00:00Z,WILMINGTON NC,0,0,0,4,4
Tropical Storm,Olga,32,2001-12-02T15:00:00Z,28.7N  69.5W,19,2,1,1,23
Tropical Storm,Olga,32,2001-12-02T15:00:00Z,MOREHEAD CITY NC,0,0,1,3,4
Tropical Storm,Olga,32,2001-12-02T15:00:00Z,MYSM 241N 745W,0,0,0,2,2
Tropical Storm,Olga,32,2001-12-02T15:00:00Z,CAPE HATTERAS NC,0,0,1,4,5
Tropical Storm,Olga,32,2001-12-02T15:00:00Z,BERMUDA,0,0,1,3,4
Tropical Storm,Olga,32,2001-12-02T15:00:00Z,NORFOLK VA,0,0,0,2,2
Tropical Storm,Olga,32,2001-12-02T15:00:00Z,CHARLESTON SC,0,0,0,2,2
Tropical Storm,Olga,33,2001-12-02T21:00:00Z,29.0N  69.7W,24,1,1,1,27
Tropical Storm,Olga,33,2001-12-02T21:00:00Z,BERMUDA,0,0,3,4,7
Tropical Storm,Olga,33,2001-12-02T21:00:00Z,29.4N  68.9W,13,5,1,2,21
Tropical Storm,Olga,33,2001-12-02T21:00:00Z,SAN JUAN PR,0,0,0,2,2
Tropical Storm,Olga,33,2001-12-02T21:00:00Z,28.8N  69.0W,21,2,1,1,25
Tropical Storm,Olga,33,2001-12-02T21:00:00Z,MIAMI FL,0,0,0,2,2
Tropical Storm,Olga,33,2001-12-02T21:00:00Z,MDSD 185N 697W,0,0,0,2,2
Tropical Storm,Olga,33,2001-12-02T21:00:00Z,W PALM BEACH FL,0,0,0,2,2
Tropical Storm,Olga,33,2001-12-02T21:00:00Z,TJSJ 184N 661W,0,0,0,2,2
Tropical Storm,Olga,33,2001-12-02T21:00:00Z,FT PIERCE FL,0,0,0,2,2
Tropical Storm,Olga,33,2001-12-02T21:00:00Z,MDPP 198N 707W,0,0,0,3,3
Tropical Storm,Olga,33,2001-12-02T21:00:00Z,COCOA BEACH FL,0,0,0,2,2
Tropical Storm,Olga,33,2001-12-02T21:00:00Z,MBJT 215N 712W,0,0,1,4,5
Tropical Storm,Olga,33,2001-12-02T21:00:00Z,DAYTONA BEACH FL,0,0,0,2,2
Tropical Storm,Olga,33,2001-12-02T21:00:00Z,MYMM 224N 730W,0,0,0,5,5
Tropical Storm,Olga,33,2001-12-02T21:00:00Z,CHARLESTON SC,0,0,0,2,2
Tropical Storm,Olga,33,2001-12-02T21:00:00Z,MYSM 241N 745W,0,0,0,5,5
Tropical Storm,Olga,33,2001-12-02T21:00:00Z,MYRTLE BEACH SC,0,0,0,2,2
Tropical Storm,Olga,33,2001-12-02T21:00:00Z,MYEG 235N 758W,0,0,0,4,4
Tropical Storm,Olga,33,2001-12-02T21:00:00Z,WILMINGTON NC,0,0,0,3,3
Tropical Storm,Olga,33,2001-12-02T21:00:00Z,MYAK 241N 776W,0,0,0,3,3
Tropical Storm,Olga,33,2001-12-02T21:00:00Z,MOREHEAD CITY NC,0,0,1,2,3
Tropical Storm,Olga,33,2001-12-02T21:00:00Z,MYNN 251N 775W,0,0,0,3,3
Tropical Storm,Olga,33,2001-12-02T21:00:00Z,CAPE HATTERAS NC,0,0,1,3,4
Tropical Storm,Olga,33,2001-12-02T21:00:00Z,MYGF 266N 787W,0,0,0,3,3
Tropical Storm,Olga,33,2001-12-02T21:00:00Z,NORFOLK VA,0,0,0,2,2
Tropical Storm,Olga,34,2001-12-03T03:00:00Z,29.0N  69.6W,38,0,0,0,38
Tropical Storm,Olga,34,2001-12-03T03:00:00Z,ST CROIX VI,0,0,0,2,2
Tropical Storm,Olga,34,2001-12-03T03:00:00Z,29.4N  69.0W,21,2,1,0,24
Tropical Storm,Olga,34,2001-12-03T03:00:00Z,ST THOMAS VI,0,0,0,3,3
Tropical Storm,Olga,34,2001-12-03T03:00:00Z,29.0N  68.3W,18,2,2,1,23
Tropical Storm,Olga,34,2001-12-03T03:00:00Z,SAN JUAN PR,0,0,0,2,2
Tropical Storm,Olga,34,2001-12-03T03:00:00Z,TAPA 171N 618W,0,0,0,2,2
Tropical Storm,Olga,34,2001-12-03T03:00:00Z,PONCE PR,0,0,0,2,2
Tropical Storm,Olga,34,2001-12-03T03:00:00Z,TKPK 173N 627W,0,0,0,2,2
Tropical Storm,Olga,34,2001-12-03T03:00:00Z,WILMINGTON NC,0,0,0,2,2
Tropical Storm,Olga,34,2001-12-03T03:00:00Z,TNCM 181N 631W,0,0,0,2,2
Tropical Storm,Olga,34,2001-12-03T03:00:00Z,MOREHEAD CITY NC,0,0,0,3,3
Tropical Storm,Olga,34,2001-12-03T03:00:00Z,TISX 177N 648W,0,0,0,2,2
Tropical Storm,Olga,34,2001-12-03T03:00:00Z,CAPE HATTERAS NC,0,0,0,4,4
Tropical Storm,Olga,34,2001-12-03T03:00:00Z,TIST 183N 650W,0,0,0,3,3
Tropical Storm,Olga,34,2001-12-03T03:00:00Z,NORFOLK VA,0,0,0,3,3
Tropical Storm,Olga,34,2001-12-03T03:00:00Z,TJPS 180N 666W,0,0,0,2,2
Tropical Storm,Olga,34,2001-12-03T03:00:00Z,OCEAN CITY MD,0,0,0,3,3
Tropical Storm,Olga,34,2001-12-03T03:00:00Z,TJSJ 184N 661W,0,0,0,2,2
Tropical Storm,Olga,34,2001-12-03T03:00:00Z,ATLANTIC CITY NJ,0,0,0,2,2
Tropical Storm,Olga,34,2001-12-03T03:00:00Z,MBJT 215N 712W,0,0,0,2,2
Tropical Storm,Olga,34,2001-12-03T03:00:00Z,NEW YORK CITY NY,0,0,0,2,2
Tropical Storm,Olga,34,2001-12-03T03:00:00Z,BERMUDA,0,0,2,4,6
Tropical Storm,Olga,35,2001-12-03T09:00:00Z,28.6N  69.4W,56,0,0,0,56
Tropical Storm,Olga,35,2001-12-03T09:00:00Z,MYMM 224N 730W,0,0,1,3,4
Tropical Storm,Olga,35,2001-12-03T09:00:00Z,28.5N  68.8W,39,0,0,0,39
Tropical Storm,Olga,35,2001-12-03T09:00:00Z,MYSM 241N 745W,0,0,0,3,3
Tropical Storm,Olga,35,2001-12-03T09:00:00Z,28.0N  69.5W,99,0,0,0,99
Tropical Storm,Olga,35,2001-12-03T09:00:00Z,MYEG 235N 758W,0,0,0,2,2
Tropical Storm,Olga,35,2001-12-03T09:00:00Z,TISX 177N 648W,0,0,0,2,2
Tropical Storm,Olga,35,2001-12-03T09:00:00Z,BERMUDA,0,0,1,3,4
Tropical Storm,Olga,35,2001-12-03T09:00:00Z,TIST 183N 650W,0,0,0,3,3
Tropical Storm,Olga,35,2001-12-03T09:00:00Z,ST CROIX VI,0,0,0,2,2
Tropical Storm,Olga,35,2001-12-03T09:00:00Z,TJPS 180N 666W,0,0,1,2,3
Tropical Storm,Olga,35,2001-12-03T09:00:00Z,ST THOMAS VI,0,0,0,3,3
Tropical Storm,Olga,35,2001-12-03T09:00:00Z,MDSD 185N 697W,0,0,1,3,4
Tropical Storm,Olga,35,2001-12-03T09:00:00Z,SAN JUAN PR,0,0,1,3,4
Tropical Storm,Olga,35,2001-12-03T09:00:00Z,MDCB 176N 714W,0,0,0,2,2
Tropical Storm,Olga,35,2001-12-03T09:00:00Z,PONCE PR,0,0,1,2,3
Tropical Storm,Olga,35,2001-12-03T09:00:00Z,MTPP 186N 724W,0,0,0,2,2
Tropical Storm,Olga,35,2001-12-03T09:00:00Z,MOREHEAD CITY NC,0,0,0,2,2
Tropical Storm,Olga,35,2001-12-03T09:00:00Z,TJSJ 184N 661W,0,0,1,3,4
Tropical Storm,Olga,35,2001-12-03T09:00:00Z,CAPE HATTERAS NC,0,0,0,3,3
Tropical Storm,Olga,35,2001-12-03T09:00:00Z,MDPP 198N 707W,0,0,1,4,5
Tropical Storm,Olga,35,2001-12-03T09:00:00Z,NORFOLK VA,0,0,0,2,2
Tropical Storm,Olga,35,2001-12-03T09:00:00Z,MBJT 215N 712W,0,0,2,5,7
Tropical Storm,Olga,35,2001-12-03T09:00:00Z,OCEAN CITY MD,0,0,0,2,2
Tropical Storm,Olga,36,2001-12-03T15:00:00Z,29.3N  68.0W,36,0,0,0,36
Tropical Storm,Olga,36,2001-12-03T15:00:00Z,MYEG 235N 758W,0,0,0,3,3
Tropical Storm,Olga,36,2001-12-03T15:00:00Z,29.5N  67.0W,22,2,0,1,25
Tropical Storm,Olga,36,2001-12-03T15:00:00Z,MYAK 241N 776W,0,0,0,2,2
Tropical Storm,Olga,36,2001-12-03T15:00:00Z,28.5N  68.0W,40,0,0,0,40
Tropical Storm,Olga,36,2001-12-03T15:00:00Z,MYNN 251N 775W,0,0,0,3,3
Tropical Storm,Olga,36,2001-12-03T15:00:00Z,MDSD 185N 697W,0,0,0,2,2
Tropical Storm,Olga,36,2001-12-03T15:00:00Z,MYGF 266N 787W,0,0,0,2,2
Tropical Storm,Olga,36,2001-12-03T15:00:00Z,MTPP 186N 724W,0,0,0,2,2
Tropical Storm,Olga,36,2001-12-03T15:00:00Z,BERMUDA,0,4,3,2,9
Tropical Storm,Olga,36,2001-12-03T15:00:00Z,MUGM 200N 751W,0,0,0,2,2
Tropical Storm,Olga,36,2001-12-03T15:00:00Z,WILMINGTON NC,0,0,0,2,2
Tropical Storm,Olga,36,2001-12-03T15:00:00Z,MDPP 198N 707W,0,0,0,3,3
Tropical Storm,Olga,36,2001-12-03T15:00:00Z,MOREHEAD CITY NC,0,0,0,3,3
Tropical Storm,Olga,36,2001-12-03T15:00:00Z,MBJT 215N 712W,0,0,1,4,5
Tropical Storm,Olga,36,2001-12-03T15:00:00Z,CAPE HATTERAS NC,0,0,1,2,3
Tropical Storm,Olga,36,2001-12-03T15:00:00Z,MYMM 224N 730W,0,0,1,4,5
Tropical Storm,Olga,36,2001-12-03T15:00:00Z,NORFOLK VA,0,0,0,2,2
Tropical Storm,Olga,36,2001-12-03T15:00:00Z,MYSM 241N 745W,0,0,1,4,5
Tropical Storm,Olga,37,2001-12-03T21:00:00Z,28.2N  67.8W,32,0,1,0,33
Tropical Storm,Olga,37,2001-12-03T21:00:00Z,MUCM 214N 779W,0,0,0,3,3
Tropical Storm,Olga,37,2001-12-03T21:00:00Z,27.5N  67.8W,34,0,0,0,34
Tropical Storm,Olga,37,2001-12-03T21:00:00Z,MDPP 198N 707W,0,0,1,3,4
Tropical Storm,Olga,37,2001-12-03T21:00:00Z,27.0N  68.0W,33,1,0,0,34
Tropical Storm,Olga,37,2001-12-03T21:00:00Z,MBJT 215N 712W,0,1,3,5,9
Tropical Storm,Olga,37,2001-12-03T21:00:00Z,MDSD 185N 697W,0,0,0,2,2
Tropical Storm,Olga,37,2001-12-03T21:00:00Z,MYMM 224N 730W,0,2,4,4,10
Tropical Storm,Olga,37,2001-12-03T21:00:00Z,MDCB 176N 714W,0,0,0,2,2
Tropical Storm,Olga,37,2001-12-03T21:00:00Z,MYSM 241N 745W,0,2,3,5,10
Tropical Storm,Olga,37,2001-12-03T21:00:00Z,MTPP 186N 724W,0,0,1,2,3
Tropical Storm,Olga,37,2001-12-03T21:00:00Z,MYEG 235N 758W,0,1,2,4,7
Tropical Storm,Olga,37,2001-12-03T21:00:00Z,MTCA 183N 738W,0,0,0,3,3
Tropical Storm,Olga,37,2001-12-03T21:00:00Z,MYAK 241N 776W,0,0,1,3,4
Tropical Storm,Olga,37,2001-12-03T21:00:00Z,MKJP 179N 768W,0,0,0,2,2
Tropical Storm,Olga,37,2001-12-03T21:00:00Z,MYNN 251N 775W,0,0,1,3,4
Tropical Storm,Olga,37,2001-12-03T21:00:00Z,MKJS 185N 779W,0,0,0,2,2
Tropical Storm,Olga,37,2001-12-03T21:00:00Z,MYGF 266N 787W,0,0,0,2,2
Tropical Storm,Olga,37,2001-12-03T21:00:00Z,MUGM 200N 751W,0,0,1,4,5
Tropical Storm,Olga,37,2001-12-03T21:00:00Z,BERMUDA,1,2,2,3,8
Tropical Depression,Olga,38,2001-12-04T03:00:00Z,27.5N  67.5W,99,0,0,0,99
Tropical Depression,Olga,38,2001-12-04T03:00:00Z,MYMM 224N 730W,0,2,6,0,8
Tropical Depression,Olga,38,2001-12-04T03:00:00Z,26.0N  68.0W,43,0,0,0,43
Tropical Depression,Olga,38,2001-12-04T03:00:00Z,MYSM 241N 745W,0,2,7,0,9
Tropical Depression,Olga,38,2001-12-04T03:00:00Z,25.0N  70.0W,6,10,2,0,18
Tropical Depression,Olga,38,2001-12-04T03:00:00Z,MYEG 235N 758W,0,1,5,0,6
Tropical Depression,Olga,38,2001-12-04T03:00:00Z,MUGM 200N 751W,0,0,2,0,2
Tropical Depression,Olga,38,2001-12-04T03:00:00Z,MYAK 241N 776W,0,0,3,0,3
Tropical Depression,Olga,38,2001-12-04T03:00:00Z,MDPP 198N 707W,0,0,2,0,2
Tropical Depression,Olga,38,2001-12-04T03:00:00Z,MYNN 251N 775W,0,0,3,0,3
Tropical Depression,Olga,38,2001-12-04T03:00:00Z,MBJT 215N 712W,0,2,5,0,7
Tropical Depression,Olga,39,2001-12-04T09:00:00Z,26.3N  68.4W,45,0,0,0,45
Tropical Depression,Olga,39,2001-12-04T09:00:00Z,MYNN 251N 775W,0,1,6,7,14
Tropical Depression,Olga,39,2001-12-04T09:00:00Z,25.2N  70.0W,24,2,1,0,27
Tropical Depression,Olga,39,2001-12-04T09:00:00Z,MYGF 266N 787W,0,0,4,8,12
Tropical Depression,Olga,39,2001-12-04T09:00:00Z,24.5N  72.2W,3,15,2,1,21
Tropical Depression,Olga,39,2001-12-04T09:00:00Z,SAN JUAN PR,0,0,0,2,2
Tropical Depression,Olga,39,2001-12-04T09:00:00Z,TJPS 180N 666W,0,0,0,2,2
Tropical Depression,Olga,39,2001-12-04T09:00:00Z,PONCE PR,0,0,0,2,2
Tropical Depression,Olga,39,2001-12-04T09:00:00Z,MDSD 185N 697W,0,0,1,3,4
Tropical Depression,Olga,39,2001-12-04T09:00:00Z,MARATHON FL,0,0,1,8,9
Tropical Depression,Olga,39,2001-12-04T09:00:00Z,MDCB 176N 714W,0,0,0,4,4
Tropical Depression,Olga,39,2001-12-04T09:00:00Z,MIAMI FL,0,0,2,8,10
Tropical Depression,Olga,39,2001-12-04T09:00:00Z,MTPP 186N 724W,0,0,1,5,6
Tropical Depression,Olga,39,2001-12-04T09:00:00Z,W PALM BEACH FL,0,0,2,8,10
Tropical Depression,Olga,39,2001-12-04T09:00:00Z,MTCA 183N 738W,0,0,1,4,5
Tropical Depression,Olga,39,2001-12-04T09:00:00Z,FT PIERCE FL,0,0,1,8,9
Tropical Depression,Olga,39,2001-12-04T09:00:00Z,MKJP 179N 768W,0,0,0,4,4
Tropical Depression,Olga,39,2001-12-04T09:00:00Z,COCOA BEACH FL,0,0,1,7,8
Tropical Depression,Olga,39,2001-12-04T09:00:00Z,MKJS 185N 779W,0,0,0,4,4
Tropical Depression,Olga,39,2001-12-04T09:00:00Z,DAYTONA BEACH FL,0,0,0,6,6
Tropical Depression,Olga,39,2001-12-04T09:00:00Z,MWCG 193N 814W,0,0,0,3,3
Tropical Depression,Olga,39,2001-12-04T09:00:00Z,JACKSONVILLE FL,0,0,0,4,4
Tropical Depression,Olga,39,2001-12-04T09:00:00Z,MUGM 200N 751W,0,0,2,7,9
Tropical Depression,Olga,39,2001-12-04T09:00:00Z,SAVANNAH GA,0,0,0,2,2
Tropical Depression,Olga,39,2001-12-04T09:00:00Z,MUCM 214N 779W,0,0,2,8,10
Tropical Depression,Olga,39,2001-12-04T09:00:00Z,KEY WEST FL,0,0,0,8,8
Tropical Depression,Olga,39,2001-12-04T09:00:00Z,MUCF 221N 805W,0,0,0,8,8
Tropical Depression,Olga,39,2001-12-04T09:00:00Z,MARCO ISLAND FL,0,0,0,9,9
Tropical Depression,Olga,39,2001-12-04T09:00:00Z,MUSN 216N 826W,0,0,0,5,5
Tropical Depression,Olga,39,2001-12-04T09:00:00Z,FT MYERS FL,0,0,0,8,8
Tropical Depression,Olga,39,2001-12-04T09:00:00Z,MUHA 230N 824W,0,0,0,6,6
Tropical Depression,Olga,39,2001-12-04T09:00:00Z,VENICE FL,0,0,0,7,7
Tropical Depression,Olga,39,2001-12-04T09:00:00Z,MUAN 219N 850W,0,0,0,2,2
Tropical Depression,Olga,39,2001-12-04T09:00:00Z,TAMPA FL,0,0,0,7,7
Tropical Depression,Olga,39,2001-12-04T09:00:00Z,TJSJ 184N 661W,0,0,0,2,2
Tropical Depression,Olga,39,2001-12-04T09:00:00Z,CEDAR KEY FL,0,0,0,5,5
Tropical Depression,Olga,39,2001-12-04T09:00:00Z,MDPP 198N 707W,0,0,3,5,8
Tropical Depression,Olga,39,2001-12-04T09:00:00Z,ST MARKS FL,0,0,0,3,3
Tropical Depression,Olga,39,2001-12-04T09:00:00Z,MBJT 215N 712W,0,3,6,4,13
Tropical Depression,Olga,39,2001-12-04T09:00:00Z,APALACHICOLA FL,0,0,0,3,3
Tropical Depression,Olga,39,2001-12-04T09:00:00Z,MYMM 224N 730W,0,5,7,4,16
Tropical Depression,Olga,39,2001-12-04T09:00:00Z,PANAMA CITY FL,0,0,0,3,3
Tropical Depression,Olga,39,2001-12-04T09:00:00Z,MYSM 241N 745W,0,7,7,3,17
Tropical Depression,Olga,39,2001-12-04T09:00:00Z,PENSACOLA FL,0,0,0,2,2
Tropical Depression,Olga,39,2001-12-04T09:00:00Z,MYEG 235N 758W,0,2,8,5,15
Tropical Depression,Olga,39,2001-12-04T09:00:00Z,GULF 29N 85W,0,0,0,4,4
Tropical Depression,Olga,39,2001-12-04T09:00:00Z,MYAK 241N 776W,0,0,6,7,13
Tropical Depression,Olga,39,2001-12-04T09:00:00Z,GULF 29N 87W,0,0,0,2,2
Tropical Depression,Olga,40,2001-12-04T15:00:00Z,26.0N  69.0W,47,0,0,0,47
Tropical Depression,Olga,40,2001-12-04T15:00:00Z,MYEG 235N 758W,0,2,10,4,16
Tropical Depression,Olga,40,2001-12-04T15:00:00Z,24.8N  71.0W,17,10,1,0,28
Tropical Depression,Olga,40,2001-12-04T15:00:00Z,MYAK 241N 776W,0,0,6,8,14
Tropical Depression,Olga,40,2001-12-04T15:00:00Z,24.5N  73.5W,1,14,4,1,20
Tropical Depression,Olga,40,2001-12-04T15:00:00Z,MYNN 251N 775W,0,0,7,7,14
Tropical Depression,Olga,40,2001-12-04T15:00:00Z,MDSD 185N 697W,0,0,1,1,2
Tropical Depression,Olga,40,2001-12-04T15:00:00Z,MYGF 266N 787W,0,0,2,9,11
Tropical Depression,Olga,40,2001-12-04T15:00:00Z,MDCB 176N 714W,0,0,1,1,2
Tropical Depression,Olga,40,2001-12-04T15:00:00Z,MARATHON FL,0,0,0,9,9
Tropical Depression,Olga,40,2001-12-04T15:00:00Z,MTPP 186N 724W,0,0,3,2,5
Tropical Depression,Olga,40,2001-12-04T15:00:00Z,MIAMI FL,0,0,1,9,10
Tropical Depression,Olga,40,2001-12-04T15:00:00Z,MTCA 183N 738W,0,0,2,4,6
Tropical Depression,Olga,40,2001-12-04T15:00:00Z,W PALM BEACH FL,0,0,1,8,9
Tropical Depression,Olga,40,2001-12-04T15:00:00Z,MKJP 179N 768W,0,0,1,5,6
Tropical Depression,Olga,40,2001-12-04T15:00:00Z,FT PIERCE FL,0,0,0,8,8
Tropical Depression,Olga,40,2001-12-04T15:00:00Z,MKJS 185N 779W,0,0,0,7,7
Tropical Depression,Olga,40,2001-12-04T15:00:00Z,COCOA BEACH FL,0,0,0,7,7
Tropical Depression,Olga,40,2001-12-04T15:00:00Z,MWCG 193N 814W,0,0,0,6,6
Tropical Depression,Olga,40,2001-12-04T15:00:00Z,DAYTONA BEACH FL,0,0,0,5,5
Tropical Depression,Olga,40,2001-12-04T15:00:00Z,MUGM 200N 751W,0,0,5,6,11
Tropical Depression,Olga,40,2001-12-04T15:00:00Z,JACKSONVILLE FL,0,0,0,3,3
Tropical Depression,Olga,40,2001-12-04T15:00:00Z,MUCM 214N 779W,0,0,3,9,12
Tropical Depression,Olga,40,2001-12-04T15:00:00Z,SAVANNAH GA,0,0,0,2,2
Tropical Depression,Olga,40,2001-12-04T15:00:00Z,MUCF 221N 805W,0,0,0,10,10
Tropical Depression,Olga,40,2001-12-04T15:00:00Z,CHARLESTON SC,0,0,0,2,2
Tropical Depression,Olga,40,2001-12-04T15:00:00Z,MUSN 216N 826W,0,0,0,6,6
Tropical Depression,Olga,40,2001-12-04T15:00:00Z,MYRTLE BEACH SC,0,0,0,2,2
Tropical Depression,Olga,40,2001-12-04T15:00:00Z,MUHA 230N 824W,0,0,0,7,7
Tropical Depression,Olga,40,2001-12-04T15:00:00Z,KEY WEST FL,0,0,0,8,8
Tropical Depression,Olga,40,2001-12-04T15:00:00Z,MUAN 219N 850W,0,0,0,3,3
Tropical Depression,Olga,40,2001-12-04T15:00:00Z,MARCO ISLAND FL,0,0,0,7,7
Tropical Depression,Olga,40,2001-12-04T15:00:00Z,MDPP 198N 707W,0,1,4,1,6
Tropical Depression,Olga,40,2001-12-04T15:00:00Z,FT MYERS FL,0,0,0,6,6
Tropical Depression,Olga,40,2001-12-04T15:00:00Z,MBJT 215N 712W,0,7,5,1,13
Tropical Depression,Olga,40,2001-12-04T15:00:00Z,VENICE FL,0,0,0,5,5
Tropical Depression,Olga,40,2001-12-04T15:00:00Z,MYMM 224N 730W,0,9,7,1,17
Tropical Depression,Olga,40,2001-12-04T15:00:00Z,TAMPA FL,0,0,0,4,4
Tropical Depression,Olga,40,2001-12-04T15:00:00Z,MYSM 241N 745W,0,8,8,3,19
Tropical Depression,Olga,40,2001-12-04T15:00:00Z,CEDAR KEY FL,0,0,0,3,3
Tropical Depression,One,1,2002-07-14T21:00:00Z,37.1N  67.3W,22,5,0,0,27
Tropical Depression,One,1,2002-07-14T21:00:00Z,MONCTON NB,0,0,1,3,4
Tropical Depression,One,1,2002-07-14T21:00:00Z,39.0N  62.0W,0,14,4,1,19
Tropical Depression,One,1,2002-07-14T21:00:00Z,YARMOUTH NS,0,1,1,2,4
Tropical Depression,One,1,2002-07-14T21:00:00Z,42.0N  56.0W,0,1,8,3,12
Tropical Depression,One,1,2002-07-14T21:00:00Z,HALIFAX NS,0,2,2,3,7
Tropical Depression,One,1,2002-07-14T21:00:00Z,BERMUDA,0,1,1,1,3
Tropical Depression,One,1,2002-07-14T21:00:00Z,SABLE ISLAND NS,0,3,7,2,12
Tropical Depression,One,1,2002-07-14T21:00:00Z,WILMINGTON NC,99,0,0,0,99
Tropical Depression,One,1,2002-07-14T21:00:00Z,SYDNEY NS,0,1,3,4,8
Tropical Depression,One,1,2002-07-14T21:00:00Z,MOREHEAD CITY NC,99,0,0,0,99
Tropical Depression,One,1,2002-07-14T21:00:00Z,EDDY POINT NS,0,1,3,4,8
Tropical Depression,One,1,2002-07-14T21:00:00Z,CAPE HATTERAS NC,99,0,0,0,99
Tropical Depression,One,1,2002-07-14T21:00:00Z,PTX BASQUES NFLD,0,0,2,5,7
Tropical Depression,One,1,2002-07-14T21:00:00Z,NANTUCKET MA,0,1,0,1,2
Tropical Depression,One,1,2002-07-14T21:00:00Z,BURGEO NFLD,0,0,3,5,8
Tropical Depression,One,1,2002-07-14T21:00:00Z,BAR HARBOR ME,0,0,0,2,2
Tropical Depression,One,1,2002-07-14T21:00:00Z,ILE ST PIERRE,0,0,4,6,10
Tropical Depression,One,1,2002-07-14T21:00:00Z,EASTPORT ME,0,0,0,2,2
Tropical Depression,One,1,2002-07-14T21:00:00Z,CAPE RACE NFLD,0,0,4,5,9
Tropical Depression,One,1,2002-07-14T21:00:00Z,ST JOHN NB,0,0,1,2,3
Tropical Depression,One,1,2002-07-14T21:00:00Z,HIBERNIA OILFLD,0,0,1,4,5
Tropical Depression,One,2,2002-07-15T03:00:00Z,38.0N  66.0W,25,5,0,0,30
Tropical Depression,One,2,2002-07-15T03:00:00Z,HALIFAX NS,0,2,2,3,7
Tropical Depression,One,2,2002-07-15T03:00:00Z,40.0N  60.0W,0,14,3,0,17
Tropical Depression,One,2,2002-07-15T03:00:00Z,SABLE ISLAND NS,0,6,6,2,14
Tropical Depression,One,2,2002-07-15T03:00:00Z,43.0N  56.0W,0,3,9,2,14
Tropical Depression,One,2,2002-07-15T03:00:00Z,SYDNEY NS,0,1,4,4,9
Tropical Depression,One,2,2002-07-15T03:00:00Z,BERMUDA,0,1,0,1,2
Tropical Depression,One,2,2002-07-15T03:00:00Z,EDDY POINT NS,0,2,4,3,9
Tropical Depression,One,2,2002-07-15T03:00:00Z,CAPE HATTERAS NC,99,0,0,0,99
Tropical Depression,One,2,2002-07-15T03:00:00Z,PTX BASQUES NFLD,0,0,3,5,8
Tropical Depression,One,2,2002-07-15T03:00:00Z,BAR HARBOR ME,0,0,0,2,2
Tropical Depression,One,2,2002-07-15T03:00:00Z,BURGEO NFLD,0,0,4,5,9
Tropical Depression,One,2,2002-07-15T03:00:00Z,EASTPORT ME,0,0,0,3,3
Tropical Depression,One,2,2002-07-15T03:00:00Z,ILE ST PIERRE,0,1,5,5,11
Tropical Depression,One,2,2002-07-15T03:00:00Z,ST JOHN NB,0,0,1,3,4
Tropical Depression,One,2,2002-07-15T03:00:00Z,CAPE RACE NFLD,0,0,5,5,10
Tropical Depression,One,2,2002-07-15T03:00:00Z,MONCTON NB,0,0,1,3,4
Tropical Depression,One,2,2002-07-15T03:00:00Z,HIBERNIA OILFLD,0,0,1,5,6
Tropical Depression,One,2,2002-07-15T03:00:00Z,YARMOUTH NS,0,1,1,2,4
Tropical Depression,One,3,2002-07-15T09:00:00Z,38.8N  63.3W,16,7,0,0,23
Tropical Depression,One,3,2002-07-15T09:00:00Z,YARMOUTH NS,0,0,1,4,5
Tropical Depression,One,3,2002-07-15T09:00:00Z,41.3N  58.3W,0,15,1,1,17
Tropical Depression,One,3,2002-07-15T09:00:00Z,HALIFAX NS,0,1,2,4,7
Tropical Depression,One,3,2002-07-15T09:00:00Z,44.0N  56.9W,0,9,4,2,15
Tropical Depression,One,3,2002-07-15T09:00:00Z,SABLE ISLAND NS,0,7,4,2,13
Tropical Depression,One,3,2002-07-15T09:00:00Z,NANTUCKET MA,0,0,0,2,2
Tropical Depression,One,3,2002-07-15T09:00:00Z,SYDNEY NS,0,1,4,5,10
Tropical Depression,One,3,2002-07-15T09:00:00Z,HYANNIS MA,0,0,0,2,2
Tropical Depression,One,3,2002-07-15T09:00:00Z,EDDY POINT NS,0,1,4,4,9
Tropical Depression,One,3,2002-07-15T09:00:00Z,PORTLAND ME,0,0,0,2,2
Tropical Depression,One,3,2002-07-15T09:00:00Z,PTX BASQUES NFLD,0,0,4,5,9
Tropical Depression,One,3,2002-07-15T09:00:00Z,BAR HARBOR ME,0,0,0,3,3
Tropical Depression,One,3,2002-07-15T09:00:00Z,BURGEO NFLD,0,1,4,6,11
Tropical Depression,One,3,2002-07-15T09:00:00Z,EASTPORT ME,0,0,0,3,3
Tropical Depression,One,3,2002-07-15T09:00:00Z,ILE ST PIERRE,0,2,6,4,12
Tropical Depression,One,3,2002-07-15T09:00:00Z,ST JOHN NB,0,0,0,4,4
Tropical Depression,One,3,2002-07-15T09:00:00Z,CAPE RACE NFLD,0,1,7,4,12
Tropical Depression,One,3,2002-07-15T09:00:00Z,MONCTON NB,0,0,1,4,5
Tropical Depression,One,3,2002-07-15T09:00:00Z,HIBERNIA OILFLD,0,0,2,4,6
Tropical Storm,Arthur,4,2002-07-15T15:00:00Z,40.1N  60.5W,23,3,0,1,27
Tropical Storm,Arthur,4,2002-07-15T15:00:00Z,MONCTON NB,0,0,3,4,7
Tropical Storm,Arthur,4,2002-07-15T15:00:00Z,42.5N  57.8W,2,13,1,1,17
Tropical Storm,Arthur,4,2002-07-15T15:00:00Z,YARMOUTH NS,0,0,2,4,6
Tropical Storm,Arthur,4,2002-07-15T15:00:00Z,45.1N  57.2W,0,9,4,2,15
Tropical Storm,Arthur,4,2002-07-15T15:00:00Z,HALIFAX NS,0,3,3,4,10
Tropical Storm,Arthur,4,2002-07-15T15:00:00Z,PROVIDENCE RI,0,0,0,2,2
Tropical Storm,Arthur,4,2002-07-15T15:00:00Z,SABLE ISLAND NS,3,11,1,2,17
Tropical Storm,Arthur,4,2002-07-15T15:00:00Z,NANTUCKET MA,0,0,0,2,2
Tropical Storm,Arthur,4,2002-07-15T15:00:00Z,SYDNEY NS,0,6,4,3,13
Tropical Storm,Arthur,4,2002-07-15T15:00:00Z,HYANNIS MA,0,0,0,2,2
Tropical Storm,Arthur,4,2002-07-15T15:00:00Z,EDDY POINT NS,0,6,4,2,12
Tropical Storm,Arthur,4,2002-07-15T15:00:00Z,BOSTON MA,0,0,0,2,2
Tropical Storm,Arthur,4,2002-07-15T15:00:00Z,PTX BASQUES NFLD,0,3,5,4,12
Tropical Storm,Arthur,4,2002-07-15T15:00:00Z,PORTLAND ME,0,0,0,2,2
Tropical Storm,Arthur,4,2002-07-15T15:00:00Z,BURGEO NFLD,0,3,6,3,12
Tropical Storm,Arthur,4,2002-07-15T15:00:00Z,BAR HARBOR ME,0,0,0,4,4
Tropical Storm,Arthur,4,2002-07-15T15:00:00Z,ILE ST PIERRE,0,4,6,3,13
Tropical Storm,Arthur,4,2002-07-15T15:00:00Z,EASTPORT ME,0,0,1,4,5
Tropical Storm,Arthur,4,2002-07-15T15:00:00Z,CAPE RACE NFLD,0,1,5,4,10
Tropical Storm,Arthur,4,2002-07-15T15:00:00Z,ST JOHN NB,0,0,2,4,6
Tropical Storm,Arthur,4,2002-07-15T15:00:00Z,HIBERNIA OILFLD,0,0,1,3,4
Tropical Storm,Arthur,5,2002-07-15T21:00:00Z,41.3N  59.1W,21,1,1,0,23
Tropical Storm,Arthur,5,2002-07-15T21:00:00Z,YARMOUTH NS,0,2,3,3,8
Tropical Storm,Arthur,5,2002-07-15T21:00:00Z,43.5N  58.9W,11,6,1,1,19
Tropical Storm,Arthur,5,2002-07-15T21:00:00Z,HALIFAX NS,1,6,3,2,12
Tropical Storm,Arthur,5,2002-07-15T21:00:00Z,45.3N  58.5W,3,10,2,2,17
Tropical Storm,Arthur,5,2002-07-15T21:00:00Z,SABLE ISLAND NS,9,7,1,1,18
Tropical Storm,Arthur,5,2002-07-15T21:00:00Z,NANTUCKET MA,0,0,0,2,2
Tropical Storm,Arthur,5,2002-07-15T21:00:00Z,SYDNEY NS,1,9,3,3,16
Tropical Storm,Arthur,5,2002-07-15T21:00:00Z,HYANNIS MA,0,0,0,2,2
Tropical Storm,Arthur,5,2002-07-15T21:00:00Z,EDDY POINT NS,2,8,3,2,15
Tropical Storm,Arthur,5,2002-07-15T21:00:00Z,PORTLAND ME,0,0,1,1,2
Tropical Storm,Arthur,5,2002-07-15T21:00:00Z,PTX BASQUES NFLD,0,7,4,3,14
Tropical Storm,Arthur,5,2002-07-15T21:00:00Z,BAR HARBOR ME,0,0,2,2,4
Tropical Storm,Arthur,5,2002-07-15T21:00:00Z,BURGEO NFLD,0,7,4,3,14
Tropical Storm,Arthur,5,2002-07-15T21:00:00Z,EASTPORT ME,0,1,2,3,6
Tropical Storm,Arthur,5,2002-07-15T21:00:00Z,ILE ST PIERRE,0,7,4,3,14
Tropical Storm,Arthur,5,2002-07-15T21:00:00Z,ST JOHN NB,0,2,3,3,8
Tropical Storm,Arthur,5,2002-07-15T21:00:00Z,CAPE RACE NFLD,0,2,4,4,10
Tropical Storm,Arthur,5,2002-07-15T21:00:00Z,MONCTON NB,0,3,4,3,10
Tropical Storm,Arthur,5,2002-07-15T21:00:00Z,HIBERNIA OILFLD,0,0,1,3,4
Tropical Storm,Arthur,6,2002-07-16T03:00:00Z,43.0N  58.0W,20,1,0,0,21
Tropical Storm,Arthur,6,2002-07-16T03:00:00Z,SABLE ISLAND NS,12,2,1,0,15
Tropical Storm,Arthur,6,2002-07-16T03:00:00Z,45.0N  57.5W,12,3,1,0,16
Tropical Storm,Arthur,6,2002-07-16T03:00:00Z,SYDNEY NS,3,6,2,0,11
Tropical Storm,Arthur,6,2002-07-16T03:00:00Z,46.0N  57.0W,8,5,1,0,14
Tropical Storm,Arthur,6,2002-07-16T03:00:00Z,EDDY POINT NS,2,6,2,0,10
Tropical Storm,Arthur,6,2002-07-16T03:00:00Z,EASTPORT ME,0,0,2,0,2
Tropical Storm,Arthur,6,2002-07-16T03:00:00Z,PTX BASQUES NFLD,2,6,2,0,10
Tropical Storm,Arthur,6,2002-07-16T03:00:00Z,ST JOHN NB,0,1,2,0,3
Tropical Storm,Arthur,6,2002-07-16T03:00:00Z,BURGEO NFLD,3,6,3,0,12
Tropical Storm,Arthur,6,2002-07-16T03:00:00Z,MONCTON NB,0,2,2,0,4
Tropical Storm,Arthur,6,2002-07-16T03:00:00Z,ILE ST PIERRE,5,6,2,0,13
Tropical Storm,Arthur,6,2002-07-16T03:00:00Z,YARMOUTH NS,0,1,2,0,3
Tropical Storm,Arthur,6,2002-07-16T03:00:00Z,CAPE RACE NFLD,1,6,2,0,9
Tropical Storm,Arthur,6,2002-07-16T03:00:00Z,HALIFAX NS,0,4,2,0,6
Tropical Storm,Arthur,6,2002-07-16T03:00:00Z,HIBERNIA OILFLD,0,1,1,0,2
Tropical Storm,Arthur,7,2002-07-16T09:00:00Z,46.0N  55.5W,26,0,1,0,27
Tropical Storm,Arthur,7,2002-07-16T09:00:00Z,EDDY POINT NS,1,4,2,0,7
Tropical Storm,Arthur,7,2002-07-16T09:00:00Z,48.0N  56.0W,15,4,2,0,21
Tropical Storm,Arthur,7,2002-07-16T09:00:00Z,PTX BASQUES NFLD,5,6,4,0,15
Tropical Storm,Arthur,7,2002-07-16T09:00:00Z,56.0N  52.8W,0,1,6,0,7
Tropical Storm,Arthur,7,2002-07-16T09:00:00Z,BURGEO NFLD,12,4,3,0,19
Tropical Storm,Arthur,7,2002-07-16T09:00:00Z,HALIFAX NS,0,1,1,0,2
Tropical Storm,Arthur,7,2002-07-16T09:00:00Z,ILE ST PIERRE,21,1,1,0,23
Tropical Storm,Arthur,7,2002-07-16T09:00:00Z,SABLE ISLAND NS,3,4,2,0,9
Tropical Storm,Arthur,7,2002-07-16T09:00:00Z,CAPE RACE NFLD,19,2,1,0,22
Tropical Storm,Arthur,7,2002-07-16T09:00:00Z,SYDNEY NS,3,6,2,0,11
Tropical Storm,Arthur,7,2002-07-16T09:00:00Z,HIBERNIA OILFLD,1,3,1,0,5
Tropical Storm,Arthur,8,2002-07-16T15:00:00Z,48.1N  54.5W,25,3,0,0,28
Tropical Storm,Arthur,8,2002-07-16T15:00:00Z,BURGEO NFLD,14,3,0,0,17
Tropical Storm,Arthur,8,2002-07-16T15:00:00Z,54.0N  51.0W,0,14,0,0,14
Tropical Storm,Arthur,8,2002-07-16T15:00:00Z,ILE ST PIERRE,25,1,0,0,26
Tropical Storm,Arthur,8,2002-07-16T15:00:00Z,SYDNEY NS,2,0,0,0,2
Tropical Storm,Arthur,8,2002-07-16T15:00:00Z,CAPE RACE NFLD,29,1,0,0,30
Tropical Storm,Arthur,8,2002-07-16T15:00:00Z,PTX BASQUES NFLD,5,1,0,0,6
Tropical Storm,Arthur,8,2002-07-16T15:00:00Z,HIBERNIA OILFLD,5,6,0,0,11
Tropical Storm,Arthur,9,2002-07-16T21:00:00Z,50.0N  52.3W,29,1,0,0,30
Tropical Storm,Arthur,9,2002-07-16T21:00:00Z,ILE ST PIERRE,6,1,0,0,7
Tropical Storm,Arthur,9,2002-07-16T21:00:00Z,55.0N  49.0W,0,14,0,0,14
Tropical Storm,Arthur,9,2002-07-16T21:00:00Z,CAPE RACE NFLD,40,0,0,0,40
Tropical Storm,Arthur,9,2002-07-16T21:00:00Z,BURGEO NFLD,2,0,0,0,2
Tropical Storm,Arthur,9,2002-07-16T21:00:00Z,HIBERNIA OILFLD,17,2,0,0,19
Tropical Depression,Two,1,2002-08-04T21:00:00Z,30.5N  90.0W,33,0,0,0,33
Tropical Depression,Two,1,2002-08-04T21:00:00Z,PORT ARTHUR TX,1,8,4,0,13
Tropical Depression,Two,1,2002-08-04T21:00:00Z,30.9N  91.7W,18,3,1,0,22
Tropical Depression,Two,1,2002-08-04T21:00:00Z,GALVESTON TX,0,4,5,0,9
Tropical Depression,Two,1,2002-08-04T21:00:00Z,31.5N  93.5W,3,11,3,0,17
Tropical Depression,Two,1,2002-08-04T21:00:00Z,FREEPORT TX,0,2,4,0,6
Tropical Depression,Two,1,2002-08-04T21:00:00Z,PANAMA CITY FL,3,0,0,0,3
Tropical Depression,Two,1,2002-08-04T21:00:00Z,PORT O CONNOR TX,0,0,3,0,3
Tropical Depression,Two,1,2002-08-04T21:00:00Z,PENSACOLA FL,28,0,0,0,28
Tropical Depression,Two,1,2002-08-04T21:00:00Z,GULF 29N 87W,38,0,0,0,38
Tropical Depression,Two,1,2002-08-04T21:00:00Z,MOBILE AL,52,0,0,0,52
Tropical Depression,Two,1,2002-08-04T21:00:00Z,GULF 28N 89W,99,0,0,0,99
Tropical Depression,Two,1,2002-08-04T21:00:00Z,GULFPORT MS,51,0,0,0,51
Tropical Depression,Two,1,2002-08-04T21:00:00Z,GULF 28N 91W,6,5,2,0,13
Tropical Depression,Two,1,2002-08-04T21:00:00Z,BURAS LA,36,0,0,0,36
Tropical Depression,Two,1,2002-08-04T21:00:00Z,GULF 28N 93W,1,5,3,0,9
Tropical Depression,Two,1,2002-08-04T21:00:00Z,NEW ORLEANS LA,27,0,1,0,28
Tropical Depression,Two,1,2002-08-04T21:00:00Z,GULF 28N 95W,0,1,4,0,5
Tropical Depression,Two,1,2002-08-04T21:00:00Z,NEW IBERIA LA,12,6,1,0,19
Tropical Storm,Bertha,2,2002-08-04T23:30:00Z,30.5N  91.2W,49,0,0,0,49
Tropical Storm,Bertha,2,2002-08-04T23:30:00Z,GALVESTON TX,2,9,4,0,15
Tropical Storm,Bertha,2,2002-08-04T23:30:00Z,30.9N  92.8W,26,2,1,0,29
Tropical Storm,Bertha,2,2002-08-04T23:30:00Z,FREEPORT TX,1,6,5,0,12
Tropical Storm,Bertha,2,2002-08-04T23:30:00Z,31.4N  94.5W,9,13,2,0,24
Tropical Storm,Bertha,2,2002-08-04T23:30:00Z,PORT O CONNOR TX,0,1,5,0,6
Tropical Storm,Bertha,2,2002-08-04T23:30:00Z,PENSACOLA FL,15,0,0,0,15
Tropical Storm,Bertha,2,2002-08-04T23:30:00Z,CORPUSCHRISTI TX,0,0,2,0,2
Tropical Storm,Bertha,2,2002-08-04T23:30:00Z,MOBILE AL,50,0,0,0,50
Tropical Storm,Bertha,2,2002-08-04T23:30:00Z,GULF 29N 87W,2,0,1,0,3
Tropical Storm,Bertha,2,2002-08-04T23:30:00Z,GULFPORT MS,99,0,0,0,99
Tropical Storm,Bertha,2,2002-08-04T23:30:00Z,GULF 28N 89W,6,2,0,0,8
Tropical Storm,Bertha,2,2002-08-04T23:30:00Z,BURAS LA,99,0,0,0,99
Tropical Storm,Bertha,2,2002-08-04T23:30:00Z,GULF 28N 91W,12,2,1,0,15
Tropical Storm,Bertha,2,2002-08-04T23:30:00Z,NEW ORLEANS LA,74,0,0,0,74
Tropical Storm,Bertha,2,2002-08-04T23:30:00Z,GULF 28N 93W,4,5,2,0,11
Tropical Storm,Bertha,2,2002-08-04T23:30:00Z,NEW IBERIA LA,34,0,0,0,34
Tropical Storm,Bertha,2,2002-08-04T23:30:00Z,GULF 28N 95W,0,3,5,0,8
Tropical Storm,Bertha,2,2002-08-04T23:30:00Z,PORT ARTHUR TX,10,9,2,0,21
Tropical Storm,Bertha,2,2002-08-04T23:30:00Z,GULF 27N 96W,0,0,2,0,2
Tropical Storm,Bertha,3,2002-08-05T03:00:00Z,30.6N  91.9W,43,0,0,0,43
Tropical Storm,Bertha,3,2002-08-05T03:00:00Z,PORT ARTHUR TX,17,5,0,0,22
Tropical Storm,Bertha,3,2002-08-05T03:00:00Z,31.1N  93.6W,24,4,0,0,28
Tropical Storm,Bertha,3,2002-08-05T03:00:00Z,GALVESTON TX,6,7,0,0,13
Tropical Storm,Bertha,3,2002-08-05T03:00:00Z,PENSACOLA FL,3,1,0,0,4
Tropical Storm,Bertha,3,2002-08-05T03:00:00Z,FREEPORT TX,2,6,0,0,8
Tropical Storm,Bertha,3,2002-08-05T03:00:00Z,MOBILE AL,33,0,0,0,33
Tropical Storm,Bertha,3,2002-08-05T03:00:00Z,GULF 29N 87W,1,1,0,0,2
Tropical Storm,Bertha,3,2002-08-05T03:00:00Z,GULFPORT MS,99,0,0,0,99
Tropical Storm,Bertha,3,2002-08-05T03:00:00Z,GULF 28N 89W,7,1,0,0,8
Tropical Storm,Bertha,3,2002-08-05T03:00:00Z,BURAS LA,99,0,0,0,99
Tropical Storm,Bertha,3,2002-08-05T03:00:00Z,GULF 28N 91W,15,1,0,0,16
Tropical Storm,Bertha,3,2002-08-05T03:00:00Z,NEW ORLEANS LA,99,0,0,0,99
Tropical Storm,Bertha,3,2002-08-05T03:00:00Z,GULF 28N 93W,6,2,0,0,8
Tropical Storm,Bertha,3,2002-08-05T03:00:00Z,NEW IBERIA LA,42,0,0,0,42
Tropical Storm,Bertha,3,2002-08-05T03:00:00Z,GULF 28N 95W,1,2,0,0,3
Tropical Storm,Bertha,4,2002-08-05T09:00:00Z,30.5N  92.0W,49,0,0,0,49
Tropical Storm,Bertha,4,2002-08-05T09:00:00Z,GALVESTON TX,7,5,0,0,12
Tropical Storm,Bertha,4,2002-08-05T09:00:00Z,30.8N  93.0W,30,1,0,0,31
Tropical Storm,Bertha,4,2002-08-05T09:00:00Z,FREEPORT TX,3,5,0,0,8
Tropical Storm,Bertha,4,2002-08-05T09:00:00Z,PENSACOLA FL,2,1,0,0,3
Tropical Storm,Bertha,4,2002-08-05T09:00:00Z,PORT O CONNOR TX,0,2,0,0,2
Tropical Storm,Bertha,4,2002-08-05T09:00:00Z,MOBILE AL,14,1,0,0,15
Tropical Storm,Bertha,4,2002-08-05T09:00:00Z,GULF 29N 87W,1,1,0,0,2
Tropical Storm,Bertha,4,2002-08-05T09:00:00Z,GULFPORT MS,99,0,0,0,99
Tropical Storm,Bertha,4,2002-08-05T09:00:00Z,GULF 28N 89W,4,2,0,0,6
Tropical Storm,Bertha,4,2002-08-05T09:00:00Z,BURAS LA,99,0,0,0,99
Tropical Storm,Bertha,4,2002-08-05T09:00:00Z,GULF 28N 91W,14,1,0,0,15
Tropical Storm,Bertha,4,2002-08-05T09:00:00Z,NEW ORLEANS LA,99,0,0,0,99
Tropical Storm,Bertha,4,2002-08-05T09:00:00Z,GULF 28N 93W,7,2,0,0,9
Tropical Storm,Bertha,4,2002-08-05T09:00:00Z,NEW IBERIA LA,52,0,0,0,52
Tropical Storm,Bertha,4,2002-08-05T09:00:00Z,GULF 28N 95W,1,2,0,0,3
Tropical Storm,Bertha,4,2002-08-05T09:00:00Z,PORT ARTHUR TX,17,4,0,0,21
Tropical Depression,Bertha,5,2002-08-05T15:00:00Z,32.0N  93.1W,50,0,0,0,50
Tropical Depression,Bertha,5,2002-08-05T15:00:00Z,NEW ORLEANS LA,99,0,0,0,99
Tropical Depression,Bertha,5,2002-08-05T15:00:00Z,32.5N  94.7W,26,3,0,0,29
Tropical Depression,Bertha,5,2002-08-05T15:00:00Z,NEW IBERIA LA,42,0,0,0,42
Tropical Depression,Bertha,5,2002-08-05T15:00:00Z,,99,0,0,0,99
Tropical Depression,Bertha,5,2002-08-05T15:00:00Z,PORT ARTHUR TX,12,3,0,0,15
Tropical Depression,Bertha,5,2002-08-05T15:00:00Z,MOBILE AL,9,0,0,0,9
Tropical Depression,Bertha,5,2002-08-05T15:00:00Z,GALVESTON TX,2,5,0,0,7
Tropical Depression,Bertha,5,2002-08-05T15:00:00Z,GULFPORT MS,99,0,0,0,99
Tropical Depression,Bertha,5,2002-08-05T15:00:00Z,FREEPORT TX,1,2,0,0,3
Tropical Depression,Bertha,5,2002-08-05T15:00:00Z,BURAS LA,1,1,0,0,2
Tropical Depression,Bertha,13,2002-08-07T21:00:00Z,28.5N  95.0W,46,0,0,0,46
Tropical Depression,Bertha,13,2002-08-07T21:00:00Z,PORT O CONNOR TX,24,2,0,0,26
Tropical Depression,Bertha,13,2002-08-07T21:00:00Z,28.5N  96.4W,24,2,1,0,27
Tropical Depression,Bertha,13,2002-08-07T21:00:00Z,CORPUSCHRISTI TX,14,7,1,0,22
Tropical Depression,Bertha,13,2002-08-07T21:00:00Z,28.5N  98.0W,9,12,2,0,23
Tropical Depression,Bertha,13,2002-08-07T21:00:00Z,BROWNSVILLE TX,5,5,2,0,12
Tropical Depression,Bertha,13,2002-08-07T21:00:00Z,MMSO 238N 982W,0,1,1,0,2
Tropical Depression,Bertha,13,2002-08-07T21:00:00Z,GULF 28N 93W,99,0,0,0,99
Tropical Depression,Bertha,13,2002-08-07T21:00:00Z,NEW IBERIA LA,6,2,0,0,8
Tropical Depression,Bertha,13,2002-08-07T21:00:00Z,GULF 28N 95W,39,0,0,0,39
Tropical Depression,Bertha,13,2002-08-07T21:00:00Z,PORT ARTHUR TX,65,0,0,0,65
Tropical Depression,Bertha,13,2002-08-07T21:00:00Z,GULF 27N 96W,18,1,1,0,20
Tropical Depression,Bertha,13,2002-08-07T21:00:00Z,GALVESTON TX,48,0,0,0,48
Tropical Depression,Bertha,13,2002-08-07T21:00:00Z,GULF 25N 96W,2,2,1,0,5
Tropical Depression,Bertha,13,2002-08-07T21:00:00Z,FREEPORT TX,35,0,0,0,35
Tropical Depression,Bertha,14,2002-08-08T03:00:00Z,28.2N  96.2W,42,0,0,0,42
Tropical Depression,Bertha,14,2002-08-08T03:00:00Z,PORT O CONNOR TX,39,0,1,0,40
Tropical Depression,Bertha,14,2002-08-08T03:00:00Z,28.2N  97.6W,26,1,1,0,28
Tropical Depression,Bertha,14,2002-08-08T03:00:00Z,CORPUSCHRISTI TX,25,1,1,0,27
Tropical Depression,Bertha,14,2002-08-08T03:00:00Z,28.2N  99.2W,12,9,2,0,23
Tropical Depression,Bertha,14,2002-08-08T03:00:00Z,BROWNSVILLE TX,7,3,1,0,11
Tropical Depression,Bertha,14,2002-08-08T03:00:00Z,NEW IBERIA LA,2,2,1,0,5
Tropical Depression,Bertha,14,2002-08-08T03:00:00Z,GULF 28N 93W,99,0,0,0,99
Tropical Depression,Bertha,14,2002-08-08T03:00:00Z,PORT ARTHUR TX,48,0,0,0,48
Tropical Depression,Bertha,14,2002-08-08T03:00:00Z,GULF 28N 95W,58,0,0,0,58
Tropical Depression,Bertha,14,2002-08-08T03:00:00Z,GALVESTON TX,99,0,0,0,99
Tropical Depression,Bertha,14,2002-08-08T03:00:00Z,GULF 27N 96W,21,0,1,0,22
Tropical Depression,Bertha,14,2002-08-08T03:00:00Z,FREEPORT TX,57,0,0,0,57
Tropical Depression,Bertha,14,2002-08-08T03:00:00Z,GULF 25N 96W,1,0,1,0,2
Tropical Depression,Bertha,15,2002-08-08T09:00:00Z,27.4N  97.5W,42,0,0,0,42
Tropical Depression,Bertha,15,2002-08-08T09:00:00Z,PORT O CONNOR TX,64,0,0,0,64
Tropical Depression,Bertha,15,2002-08-08T09:00:00Z,27.5N  99.3W,19,8,0,0,27
Tropical Depression,Bertha,15,2002-08-08T09:00:00Z,CORPUSCHRISTI TX,43,0,0,0,43
Tropical Depression,Bertha,15,2002-08-08T09:00:00Z,,99,0,0,0,99
Tropical Depression,Bertha,15,2002-08-08T09:00:00Z,BROWNSVILLE TX,20,0,0,0,20
Tropical Depression,Bertha,15,2002-08-08T09:00:00Z,MMSO 238N 982W,1,1,0,0,2
Tropical Depression,Bertha,15,2002-08-08T09:00:00Z,GULF 28N 93W,8,0,0,0,8
Tropical Depression,Bertha,15,2002-08-08T09:00:00Z,PORT ARTHUR TX,3,1,0,0,4
Tropical Depression,Bertha,15,2002-08-08T09:00:00Z,GULF 28N 95W,99,0,0,0,99
Tropical Depression,Bertha,15,2002-08-08T09:00:00Z,GALVESTON TX,85,0,0,0,85
Tropical Depression,Bertha,15,2002-08-08T09:00:00Z,GULF 27N 96W,50,0,0,0,50
Tropical Depression,Bertha,15,2002-08-08T09:00:00Z,FREEPORT TX,82,0,0,0,82
Tropical Depression,Bertha,15,2002-08-08T09:00:00Z,GULF 25N 96W,3,0,0,0,3
Tropical Depression,Bertha,16,2002-08-08T15:00:00Z,27.0N  99.0W,41,0,0,0,41
Tropical Depression,Bertha,16,2002-08-08T15:00:00Z,PORT O CONNOR TX,99,0,0,0,99
Tropical Depression,Bertha,16,2002-08-08T15:00:00Z,27.0N 100.5W,27,2,0,0,29
Tropical Depression,Bertha,16,2002-08-08T15:00:00Z,CORPUSCHRISTI TX,68,0,0,0,68
Tropical Depression,Bertha,16,2002-08-08T15:00:00Z,,99,0,0,0,99
Tropical Depression,Bertha,16,2002-08-08T15:00:00Z,BROWNSVILLE TX,23,1,0,0,24
Tropical Depression,Bertha,16,2002-08-08T15:00:00Z,GALVESTON TX,15,1,0,0,16
Tropical Depression,Bertha,16,2002-08-08T15:00:00Z,GULF 28N 95W,99,0,0,0,99
Tropical Depression,Bertha,16,2002-08-08T15:00:00Z,FREEPORT TX,75,0,0,0,75
Tropical Depression,Bertha,16,2002-08-08T15:00:00Z,GULF 27N 96W,99,0,0,0,99
Tropical Depression,Bertha,17,2002-08-08T21:00:00Z,27.0N  99.0W,45,0,0,0,45
Tropical Depression,Bertha,17,2002-08-08T21:00:00Z,CORPUSCHRISTI TX,74,0,0,0,74
Tropical Depression,Bertha,17,2002-08-08T21:00:00Z,26.8N 101.4W,18,12,0,0,30
Tropical Depression,Bertha,17,2002-08-08T21:00:00Z,BROWNSVILLE TX,39,0,0,0,39
Tropical Depression,Bertha,17,2002-08-08T21:00:00Z,,99,0,0,0,99
Tropical Depression,Bertha,17,2002-08-08T21:00:00Z,GULF 28N 95W,30,0,0,0,30
Tropical Depression,Bertha,17,2002-08-08T21:00:00Z,GALVESTON TX,1,1,0,0,2
Tropical Depression,Bertha,17,2002-08-08T21:00:00Z,GULF 27N 96W,99,0,0,0,99
Tropical Depression,Bertha,17,2002-08-08T21:00:00Z,FREEPORT TX,5,2,0,0,7
Tropical Depression,Bertha,17,2002-08-08T21:00:00Z,GULF 25N 96W,2,0,0,0,2
Tropical Depression,Bertha,17,2002-08-08T21:00:00Z,PORT O CONNOR TX,72,0,0,0,72
Tropical Depression,Bertha,18,2002-08-09T03:00:00Z,26.9N  99.0W,46,0,0,0,46
Tropical Depression,Bertha,18,2002-08-09T03:00:00Z,CORPUSCHRISTI TX,64,0,0,0,64
Tropical Depression,Bertha,18,2002-08-09T03:00:00Z,,99,0,0,0,99
Tropical Depression,Bertha,18,2002-08-09T03:00:00Z,BROWNSVILLE TX,38,0,0,0,38
Tropical Depression,Bertha,18,2002-08-09T03:00:00Z,,99,0,0,0,99
Tropical Depression,Bertha,18,2002-08-09T03:00:00Z,GULF 28N 95W,8,0,0,0,8
Tropical Depression,Bertha,18,2002-08-09T03:00:00Z,FREEPORT TX,4,0,0,0,4
Tropical Depression,Bertha,18,2002-08-09T03:00:00Z,GULF 27N 96W,99,0,0,0,99
Tropical Depression,Bertha,18,2002-08-09T03:00:00Z,PORT O CONNOR TX,45,0,0,0,45
Tropical Depression,Bertha,18,2002-08-09T03:00:00Z,GULF 25N 96W,2,0,0,0,2
Tropical Depression,Bertha,19,2002-08-09T09:00:00Z,26.5N  99.5W,49,0,0,0,49
Tropical Depression,Bertha,19,2002-08-09T09:00:00Z,PORT O CONNOR TX,11,0,0,0,11
Tropical Depression,Bertha,19,2002-08-09T09:00:00Z,,99,0,0,0,99
Tropical Depression,Bertha,19,2002-08-09T09:00:00Z,CORPUSCHRISTI TX,78,0,0,0,78
Tropical Depression,Bertha,19,2002-08-09T09:00:00Z,,99,0,0,0,99
Tropical Depression,Bertha,19,2002-08-09T09:00:00Z,BROWNSVILLE TX,99,0,0,0,99
Tropical Depression,Bertha,19,2002-08-09T09:00:00Z,MMSO 238N 982W,2,0,0,0,2
Tropical Depression,Bertha,19,2002-08-09T09:00:00Z,GULF 27N 96W,99,0,0,0,99
Tropical Depression,Bertha,20,2002-08-09T15:00:00Z,,99,0,0,0,99
Tropical Depression,Bertha,20,2002-08-09T15:00:00Z,PORT O CONNOR TX,2,0,0,0,2
Tropical Depression,Bertha,20,2002-08-09T15:00:00Z,,99,0,0,0,99
Tropical Depression,Bertha,20,2002-08-09T15:00:00Z,CORPUSCHRISTI TX,99,0,0,0,99
Tropical Depression,Bertha,20,2002-08-09T15:00:00Z,,99,0,0,0,99
Tropical Depression,Bertha,20,2002-08-09T15:00:00Z,BROWNSVILLE TX,22,0,0,0,22
Tropical Depression,Three,1,2002-08-05T21:00:00Z,31.2N  75.2W,30,1,0,0,31
Tropical Depression,Three,1,2002-08-05T21:00:00Z,SAVANNAH GA,0,1,1,2,4
Tropical Depression,Three,1,2002-08-05T21:00:00Z,30.9N  74.0W,16,5,1,1,23
Tropical Depression,Three,1,2002-08-05T21:00:00Z,CHARLESTON SC,1,2,1,2,6
Tropical Depression,Three,1,2002-08-05T21:00:00Z,31.0N  72.0W,1,10,4,2,17
Tropical Depression,Three,1,2002-08-05T21:00:00Z,MYRTLE BEACH SC,1,2,1,3,7
Tropical Depression,Three,1,2002-08-05T21:00:00Z,MYGF 266N 787W,0,0,1,1,2
Tropical Depression,Three,1,2002-08-05T21:00:00Z,WILMINGTON NC,1,2,1,3,7
Tropical Depression,Three,1,2002-08-05T21:00:00Z,BERMUDA,0,0,1,9,10
Tropical Depression,Three,1,2002-08-05T21:00:00Z,MOREHEAD CITY NC,1,2,1,4,8
Tropical Depression,Three,1,2002-08-05T21:00:00Z,FT PIERCE FL,0,1,1,0,2
Tropical Depression,Three,1,2002-08-05T21:00:00Z,CAPE HATTERAS NC,0,1,2,5,8
Tropical Depression,Three,1,2002-08-05T21:00:00Z,COCOA BEACH FL,0,1,1,1,3
Tropical Depression,Three,1,2002-08-05T21:00:00Z,NORFOLK VA,0,0,0,4,4
Tropical Depression,Three,1,2002-08-05T21:00:00Z,DAYTONA BEACH FL,0,1,2,1,4
Tropical Depression,Three,1,2002-08-05T21:00:00Z,OCEAN CITY MD,0,0,0,3,3
Tropical Depression,Three,1,2002-08-05T21:00:00Z,JACKSONVILLE FL,0,1,1,1,3
Tropical Depression,Three,1,2002-08-05T21:00:00Z,ATLANTIC CITY NJ,0,0,0,2,2
Tropical Depression,Three,2,2002-08-06T03:00:00Z,30.3N  75.3W,40,0,0,0,40
Tropical Depression,Three,2,2002-08-06T03:00:00Z,NANTUCKET MA,0,0,0,8,8
Tropical Depression,Three,2,2002-08-06T03:00:00Z,30.4N  72.8W,6,19,1,0,26
Tropical Depression,Three,2,2002-08-06T03:00:00Z,HYANNIS MA,0,0,0,7,7
Tropical Depression,Three,2,2002-08-06T03:00:00Z,32.1N  69.4W,0,2,17,1,20
Tropical Depression,Three,2,2002-08-06T03:00:00Z,BOSTON MA,0,0,0,5,5
Tropical Depression,Three,2,2002-08-06T03:00:00Z,BERMUDA,0,0,3,11,14
Tropical Depression,Three,2,2002-08-06T03:00:00Z,PORTLAND ME,0,0,0,4,4
Tropical Depression,Three,2,2002-08-06T03:00:00Z,WILMINGTON NC,0,1,1,0,2
Tropical Depression,Three,2,2002-08-06T03:00:00Z,BAR HARBOR ME,0,0,0,5,5
Tropical Depression,Three,2,2002-08-06T03:00:00Z,MOREHEAD CITY NC,0,2,1,1,4
Tropical Depression,Three,2,2002-08-06T03:00:00Z,EASTPORT ME,0,0,0,4,4
Tropical Depression,Three,2,2002-08-06T03:00:00Z,CAPE HATTERAS NC,0,1,3,1,5
Tropical Depression,Three,2,2002-08-06T03:00:00Z,ST JOHN NB,0,0,0,4,4
Tropical Depression,Three,2,2002-08-06T03:00:00Z,NORFOLK VA,0,0,1,1,2
Tropical Depression,Three,2,2002-08-06T03:00:00Z,MONCTON NB,0,0,0,3,3
Tropical Depression,Three,2,2002-08-06T03:00:00Z,OCEAN CITY MD,0,0,1,1,2
Tropical Depression,Three,2,2002-08-06T03:00:00Z,YARMOUTH NS,0,0,0,6,6
Tropical Depression,Three,2,2002-08-06T03:00:00Z,ATLANTIC CITY NJ,0,0,0,2,2
Tropical Depression,Three,2,2002-08-06T03:00:00Z,HALIFAX NS,0,0,0,5,5
Tropical Depression,Three,2,2002-08-06T03:00:00Z,NEW YORK CITY NY,0,0,0,3,3
Tropical Depression,Three,2,2002-08-06T03:00:00Z,SABLE ISLAND NS,0,0,0,3,3
Tropical Depression,Three,2,2002-08-06T03:00:00Z,MONTAUK POINT NY,0,0,0,5,5
Tropical Depression,Three,2,2002-08-06T03:00:00Z,EDDY POINT NS,0,0,0,2,2
Tropical Depression,Three,2,2002-08-06T03:00:00Z,PROVIDENCE RI,0,0,0,5,5
Tropical Depression,Three,3,2002-08-06T09:00:00Z,30.0N  75.0W,39,0,0,0,39
Tropical Depression,Three,3,2002-08-06T09:00:00Z,PORTLAND ME,0,0,0,4,4
Tropical Depression,Three,3,2002-08-06T09:00:00Z,31.0N  72.0W,1,25,1,0,27
Tropical Depression,Three,3,2002-08-06T09:00:00Z,BAR HARBOR ME,0,0,0,6,6
Tropical Depression,Three,3,2002-08-06T09:00:00Z,33.0N  68.5W,0,2,17,2,21
Tropical Depression,Three,3,2002-08-06T09:00:00Z,EASTPORT ME,0,0,0,6,6
Tropical Depression,Three,3,2002-08-06T09:00:00Z,BERMUDA,0,0,6,8,14
Tropical Depression,Three,3,2002-08-06T09:00:00Z,ST JOHN NB,0,0,0,6,6
Tropical Depression,Three,3,2002-08-06T09:00:00Z,MOREHEAD CITY NC,0,2,1,0,3
Tropical Depression,Three,3,2002-08-06T09:00:00Z,MONCTON NB,0,0,0,6,6
Tropical Depression,Three,3,2002-08-06T09:00:00Z,CAPE HATTERAS NC,0,1,3,1,5
Tropical Depression,Three,3,2002-08-06T09:00:00Z,YARMOUTH NS,0,0,0,9,9
Tropical Depression,Three,3,2002-08-06T09:00:00Z,OCEAN CITY MD,0,0,1,1,2
Tropical Depression,Three,3,2002-08-06T09:00:00Z,HALIFAX NS,0,0,0,8,8
Tropical Depression,Three,3,2002-08-06T09:00:00Z,ATLANTIC CITY NJ,0,0,0,2,2
Tropical Depression,Three,3,2002-08-06T09:00:00Z,SABLE ISLAND NS,0,0,0,8,8
Tropical Depression,Three,3,2002-08-06T09:00:00Z,NEW YORK CITY NY,0,0,0,2,2
Tropical Depression,Three,3,2002-08-06T09:00:00Z,SYDNEY NS,0,0,0,4,4
Tropical Depression,Three,3,2002-08-06T09:00:00Z,MONTAUK POINT NY,0,0,0,4,4
Tropical Depression,Three,3,2002-08-06T09:00:00Z,EDDY POINT NS,0,0,0,6,6
Tropical Depression,Three,3,2002-08-06T09:00:00Z,PROVIDENCE RI,0,0,0,5,5
Tropical Depression,Three,3,2002-08-06T09:00:00Z,PTX BASQUES NFLD,0,0,0,2,2
Tropical Depression,Three,3,2002-08-06T09:00:00Z,NANTUCKET MA,0,0,0,8,8
Tropical Depression,Three,3,2002-08-06T09:00:00Z,BURGEO NFLD,0,0,0,2,2
Tropical Depression,Three,3,2002-08-06T09:00:00Z,HYANNIS MA,0,0,0,7,7
Tropical Depression,Three,3,2002-08-06T09:00:00Z,ILE ST PIERRE,0,0,0,2,2
Tropical Depression,Three,3,2002-08-06T09:00:00Z,BOSTON MA,0,0,0,5,5
Tropical Depression,Three,4,2002-08-06T15:00:00Z,30.0N  74.0W,32,1,1,0,34
Tropical Depression,Three,4,2002-08-06T15:00:00Z,ST JOHN NB,0,0,0,5,5
Tropical Depression,Three,4,2002-08-06T15:00:00Z,30.5N  71.5W,4,19,6,0,29
Tropical Depression,Three,4,2002-08-06T15:00:00Z,MONCTON NB,0,0,0,6,6
Tropical Depression,Three,4,2002-08-06T15:00:00Z,35.0N  66.5W,0,0,14,6,20
Tropical Depression,Three,4,2002-08-06T15:00:00Z,YARMOUTH NS,0,0,0,7,7
Tropical Depression,Three,4,2002-08-06T15:00:00Z,BERMUDA,0,0,5,2,7
Tropical Depression,Three,4,2002-08-06T15:00:00Z,HALIFAX NS,0,0,0,9,9
Tropical Depression,Three,4,2002-08-06T15:00:00Z,CAPE HATTERAS NC,0,0,1,1,2
Tropical Depression,Three,4,2002-08-06T15:00:00Z,SABLE ISLAND NS,0,0,0,12,12
Tropical Depression,Three,4,2002-08-06T15:00:00Z,MONTAUK POINT NY,0,0,0,2,2
Tropical Depression,Three,4,2002-08-06T15:00:00Z,SYDNEY NS,0,0,0,9,9
Tropical Depression,Three,4,2002-08-06T15:00:00Z,PROVIDENCE RI,0,0,0,3,3
Tropical Depression,Three,4,2002-08-06T15:00:00Z,EDDY POINT NS,0,0,0,9,9
Tropical Depression,Three,4,2002-08-06T15:00:00Z,NANTUCKET MA,0,0,0,4,4
Tropical Depression,Three,4,2002-08-06T15:00:00Z,PTX BASQUES NFLD,0,0,0,7,7
Tropical Depression,Three,4,2002-08-06T15:00:00Z,HYANNIS MA,0,0,0,4,4
Tropical Depression,Three,4,2002-08-06T15:00:00Z,BURGEO NFLD,0,0,0,7,7
Tropical Depression,Three,4,2002-08-06T15:00:00Z,BOSTON MA,0,0,0,3,3
Tropical Depression,Three,4,2002-08-06T15:00:00Z,ILE ST PIERRE,0,0,0,8,8
Tropical Depression,Three,4,2002-08-06T15:00:00Z,PORTLAND ME,0,0,0,3,3
Tropical Depression,Three,4,2002-08-06T15:00:00Z,CAPE RACE NFLD,0,0,0,6,6
Tropical Depression,Three,4,2002-08-06T15:00:00Z,BAR HARBOR ME,0,0,0,4,4
Tropical Depression,Three,4,2002-08-06T15:00:00Z,HIBERNIA OILFLD,0,0,0,3,3
Tropical Depression,Three,4,2002-08-06T15:00:00Z,EASTPORT ME,0,0,0,5,5
Tropical Depression,Three,5,2002-08-06T21:00:00Z,31.0N  73.0W,34,5,0,0,39
Tropical Depression,Three,5,2002-08-06T21:00:00Z,YARMOUTH NS,0,0,0,7,7
Tropical Depression,Three,5,2002-08-06T21:00:00Z,33.0N  69.0W,0,24,7,0,31
Tropical Depression,Three,5,2002-08-06T21:00:00Z,HALIFAX NS,0,0,0,11,11
Tropical Depression,Three,5,2002-08-06T21:00:00Z,38.5N  63.0W,0,0,15,6,21
Tropical Depression,Three,5,2002-08-06T21:00:00Z,SABLE ISLAND NS,0,0,1,16,17
Tropical Depression,Three,5,2002-08-06T21:00:00Z,BERMUDA,0,1,4,0,5
Tropical Depression,Three,5,2002-08-06T21:00:00Z,SYDNEY NS,0,0,0,13,13
Tropical Depression,Three,5,2002-08-06T21:00:00Z,NANTUCKET MA,0,0,0,2,2
Tropical Depression,Three,5,2002-08-06T21:00:00Z,EDDY POINT NS,0,0,0,13,13
Tropical Depression,Three,5,2002-08-06T21:00:00Z,HYANNIS MA,0,0,0,2,2
Tropical Depression,Three,5,2002-08-06T21:00:00Z,PTX BASQUES NFLD,0,0,0,12,12
Tropical Depression,Three,5,2002-08-06T21:00:00Z,BAR HARBOR ME,0,0,0,3,3
Tropical Depression,Three,5,2002-08-06T21:00:00Z,BURGEO NFLD,0,0,0,13,13
Tropical Depression,Three,5,2002-08-06T21:00:00Z,EASTPORT ME,0,0,0,4,4
Tropical Depression,Three,5,2002-08-06T21:00:00Z,ILE ST PIERRE,0,0,0,14,14
Tropical Depression,Three,5,2002-08-06T21:00:00Z,ST JOHN NB,0,0,0,5,5
Tropical Depression,Three,5,2002-08-06T21:00:00Z,CAPE RACE NFLD,0,0,0,12,12
Tropical Depression,Three,5,2002-08-06T21:00:00Z,MONCTON NB,0,0,0,6,6
Tropical Depression,Three,5,2002-08-06T21:00:00Z,HIBERNIA OILFLD,0,0,0,5,5
Tropical Storm,Cristobal,6,2002-08-06T23:30:00Z,31.0N  73.0W,34,5,0,0,39
Tropical Storm,Cristobal,6,2002-08-06T23:30:00Z,YARMOUTH NS,0,0,0,7,7
Tropical Storm,Cristobal,6,2002-08-06T23:30:00Z,33.0N  69.0W,0,24,7,0,31
Tropical Storm,Cristobal,6,2002-08-06T23:30:00Z,HALIFAX NS,0,0,0,11,11
Tropical Storm,Cristobal,6,2002-08-06T23:30:00Z,38.5N  63.0W,0,0,15,6,21
Tropical Storm,Cristobal,6,2002-08-06T23:30:00Z,SABLE ISLAND NS,0,0,1,16,17
Tropical Storm,Cristobal,6,2002-08-06T23:30:00Z,BERMUDA,0,1,4,0,5
Tropical Storm,Cristobal,6,2002-08-06T23:30:00Z,SYDNEY NS,0,0,0,13,13
Tropical Storm,Cristobal,6,2002-08-06T23:30:00Z,NANTUCKET MA,0,0,0,2,2
Tropical Storm,Cristobal,6,2002-08-06T23:30:00Z,EDDY POINT NS,0,0,0,13,13
Tropical Storm,Cristobal,6,2002-08-06T23:30:00Z,HYANNIS MA,0,0,0,2,2
Tropical Storm,Cristobal,6,2002-08-06T23:30:00Z,PTX BASQUES NFLD,0,0,0,12,12
Tropical Storm,Cristobal,6,2002-08-06T23:30:00Z,BAR HARBOR ME,0,0,0,3,3
Tropical Storm,Cristobal,6,2002-08-06T23:30:00Z,BURGEO NFLD,0,0,0,13,13
Tropical Storm,Cristobal,6,2002-08-06T23:30:00Z,EASTPORT ME,0,0,0,4,4
Tropical Storm,Cristobal,6,2002-08-06T23:30:00Z,ILE ST PIERRE,0,0,0,14,14
Tropical Storm,Cristobal,6,2002-08-06T23:30:00Z,ST JOHN NB,0,0,0,5,5
Tropical Storm,Cristobal,6,2002-08-06T23:30:00Z,CAPE RACE NFLD,0,0,0,12,12
Tropical Storm,Cristobal,6,2002-08-06T23:30:00Z,MONCTON NB,0,0,0,6,6
Tropical Storm,Cristobal,6,2002-08-06T23:30:00Z,HIBERNIA OILFLD,0,0,0,5,5
Tropical Storm,Cristobal,7,2002-08-07T03:00:00Z,30.4N  72.7W,41,7,0,0,48
Tropical Storm,Cristobal,7,2002-08-07T03:00:00Z,37.5N  61.7W,0,0,16,0,16
Tropical Storm,Cristobal,7,2002-08-07T03:00:00Z,33.7N  67.3W,0,23,6,0,29
Tropical Storm,Cristobal,7,2002-08-07T03:00:00Z,BERMUDA,0,7,4,0,11
Tropical Storm,Cristobal,8,2002-08-07T09:00:00Z,29.4N  74.0W,44,6,0,0,50
Tropical Storm,Cristobal,8,2002-08-07T09:00:00Z,37.0N  63.0W,0,0,18,0,18
Tropical Storm,Cristobal,8,2002-08-07T09:00:00Z,33.0N  69.0W,0,27,5,0,32
Tropical Storm,Cristobal,8,2002-08-07T09:00:00Z,BERMUDA,0,2,9,0,11
Tropical Storm,Cristobal,9,2002-08-07T15:00:00Z,31.0N  72.0W,48,8,0,0,56
Tropical Storm,Cristobal,9,2002-08-07T15:00:00Z,BERMUDA,0,2,0,0,2
Tropical Storm,Cristobal,9,2002-08-07T15:00:00Z,35.0N  66.0W,0,25,6,0,31
Tropical Storm,Cristobal,9,2002-08-07T15:00:00Z,SABLE ISLAND NS,0,0,7,0,7
Tropical Storm,Cristobal,9,2002-08-07T15:00:00Z,42.0N  58.0W,0,0,14,0,14
Tropical Storm,Cristobal,10,2002-08-07T21:00:00Z,34.0N  70.0W,28,8,0,0,36
Tropical Storm,Cristobal,10,2002-08-07T21:00:00Z,EDDY POINT NS,0,0,5,0,5
Tropical Storm,Cristobal,10,2002-08-07T21:00:00Z,38.0N  66.0W,1,23,7,0,31
Tropical Storm,Cristobal,10,2002-08-07T21:00:00Z,PTX BASQUES NFLD,0,0,2,0,2
Tropical Storm,Cristobal,10,2002-08-07T21:00:00Z,43.0N  59.0W,0,1,17,0,18
Tropical Storm,Cristobal,10,2002-08-07T21:00:00Z,BURGEO NFLD,0,0,3,0,3
Tropical Storm,Cristobal,10,2002-08-07T21:00:00Z,HALIFAX NS,0,0,3,0,3
Tropical Storm,Cristobal,10,2002-08-07T21:00:00Z,ILE ST PIERRE,0,0,5,0,5
Tropical Storm,Cristobal,10,2002-08-07T21:00:00Z,SABLE ISLAND NS,0,0,15,0,15
Tropical Storm,Cristobal,10,2002-08-07T21:00:00Z,CAPE RACE NFLD,0,0,4,0,4
Tropical Storm,Cristobal,10,2002-08-07T21:00:00Z,SYDNEY NS,0,0,4,0,4
Tropical Storm,Cristobal,11,2002-08-08T03:00:00Z,31.8N  71.3W,43,0,0,0,43
Tropical Storm,Cristobal,11,2002-08-08T03:00:00Z,BERMUDA,0,4,6,0,10
Tropical Storm,Cristobal,11,2002-08-08T03:00:00Z,34.5N  68.0W,0,20,5,0,25
Tropical Storm,Cristobal,11,2002-08-08T03:00:00Z,HALIFAX NS,0,0,2,0,2
Tropical Storm,Cristobal,11,2002-08-08T03:00:00Z,39.5N  62.5W,0,0,12,0,12
Tropical Storm,Cristobal,11,2002-08-08T03:00:00Z,SABLE ISLAND NS,0,0,3,0,3
Tropical Storm,Cristobal,12,2002-08-08T09:00:00Z,30.0N  72.5W,28,1,0,1,30
Tropical Storm,Cristobal,12,2002-08-08T09:00:00Z,MYNN 251N 775W,0,0,1,1,2
Tropical Storm,Cristobal,12,2002-08-08T09:00:00Z,30.5N  70.8W,10,9,1,2,22
Tropical Storm,Cristobal,12,2002-08-08T09:00:00Z,MYGF 266N 787W,0,0,1,2,3
Tropical Storm,Cristobal,12,2002-08-08T09:00:00Z,31.0N  69.0W,1,10,4,3,18
Tropical Storm,Cristobal,12,2002-08-08T09:00:00Z,BERMUDA,0,0,4,7,11
Tropical Storm,Cristobal,12,2002-08-08T09:00:00Z,MYSM 241N 745W,0,0,1,1,2
Tropical Storm,Cristobal,13,2002-08-08T15:00:00Z,31.0N  70.0W,33,0,0,0,33
Tropical Storm,Cristobal,13,2002-08-08T15:00:00Z,BERMUDA,0,9,8,1,18
Tropical Storm,Cristobal,13,2002-08-08T15:00:00Z,31.6N  68.0W,14,6,1,1,22
Tropical Storm,Cristobal,13,2002-08-08T15:00:00Z,SABLE ISLAND NS,0,0,0,2,2
Tropical Storm,Cristobal,13,2002-08-08T15:00:00Z,33.0N  65.0W,0,10,7,1,18
Tropical Storm,Cristobal,14,2002-08-08T21:00:00Z,36.0N  65.0W,18,4,0,0,22
Tropical Storm,Cristobal,14,2002-08-08T21:00:00Z,HALIFAX NS,0,4,0,0,4
Tropical Storm,Cristobal,14,2002-08-08T21:00:00Z,40.0N  63.0W,2,16,0,0,18
Tropical Storm,Cristobal,14,2002-08-08T21:00:00Z,SABLE ISLAND NS,0,5,0,0,5
Tropical Storm,Cristobal,14,2002-08-08T21:00:00Z,BERMUDA,12,2,0,0,14
Tropical Storm,Cristobal,14,2002-08-08T21:00:00Z,EDDY POINT NS,0,3,0,0,3
Tropical Storm,Cristobal,14,2002-08-08T21:00:00Z,YARMOUTH NS,0,4,0,0,4
Tropical Depression,Four,1,2002-08-29T15:00:00Z,10.5N  37.5W,48,0,0,0,48
Tropical Depression,Four,1,2002-08-29T15:00:00Z,12.5N  42.5W,0,18,7,1,26
Tropical Depression,Four,1,2002-08-29T15:00:00Z,11.5N  40.0W,13,21,0,0,34
Tropical Storm,Dolly,2,2002-08-29T21:00:00Z,10.0N  37.0W,46,0,0,0,46
Tropical Storm,Dolly,2,2002-08-29T21:00:00Z,11.0N  41.5W,0,16,8,1,25
Tropical Storm,Dolly,2,2002-08-29T21:00:00Z,10.5N  39.0W,22,10,0,0,32
Tropical Storm,Dolly,3,2002-08-30T03:00:00Z,10.0N  38.0W,45,0,0,0,45
Tropical Storm,Dolly,3,2002-08-30T03:00:00Z,11.1N  42.8W,0,17,8,1,26
Tropical Storm,Dolly,3,2002-08-30T03:00:00Z,10.5N  40.3W,16,16,1,0,33
Tropical Storm,Dolly,4,2002-08-30T09:00:00Z,10.5N  39.2W,45,0,0,0,45
Tropical Storm,Dolly,4,2002-08-30T09:00:00Z,11.6N  43.8W,0,19,5,2,26
Tropical Storm,Dolly,4,2002-08-30T09:00:00Z,11.0N  41.5W,16,16,0,0,32
Tropical Storm,Dolly,5,2002-08-30T15:00:00Z,11.0N  42.0W,45,0,0,0,45
Tropical Storm,Dolly,5,2002-08-30T15:00:00Z,12.5N  47.0W,0,18,8,1,27
Tropical Storm,Dolly,5,2002-08-30T15:00:00Z,11.8N  44.5W,13,21,0,0,34
Tropical Storm,Dolly,6,2002-08-30T21:00:00Z,12.0N  44.0W,48,0,0,0,48
Tropical Storm,Dolly,6,2002-08-30T21:00:00Z,13.5N  48.0W,0,21,4,1,26
Tropical Storm,Dolly,6,2002-08-30T21:00:00Z,12.7N  46.0W,22,12,0,0,34
Tropical Storm,Dolly,7,2002-08-31T03:00:00Z,13.6N  44.7W,45,0,0,0,45
Tropical Storm,Dolly,7,2002-08-31T03:00:00Z,15.6N  49.2W,0,18,5,2,25
Tropical Storm,Dolly,7,2002-08-31T03:00:00Z,14.6N  47.0W,13,17,1,0,31
Tropical Storm,Dolly,8,2002-08-31T09:00:00Z,14.2N  46.2W,46,0,0,0,46
Tropical Storm,Dolly,8,2002-08-31T09:00:00Z,16.5N  50.0W,0,26,1,1,28
Tropical Storm,Dolly,8,2002-08-31T09:00:00Z,15.5N  48.7W,9,25,0,1,35
Tropical Storm,Dolly,9,2002-08-31T15:00:00Z,15.5N  48.5W,50,0,0,0,50
Tropical Storm,Dolly,9,2002-08-31T15:00:00Z,17.5N  51.5W,3,18,5,1,27
Tropical Storm,Dolly,9,2002-08-31T15:00:00Z,16.5N  49.5W,38,1,0,0,39
Tropical Storm,Dolly,10,2002-08-31T21:00:00Z,16.0N  51.0W,51,0,0,0,51
Tropical Storm,Dolly,10,2002-08-31T21:00:00Z,18.5N  53.5W,6,19,1,1,27
Tropical Storm,Dolly,10,2002-08-31T21:00:00Z,17.0N  52.5W,31,5,0,0,36
Tropical Storm,Dolly,11,2002-09-01T03:00:00Z,16.0N  52.6W,48,0,0,0,48
Tropical Storm,Dolly,11,2002-09-01T03:00:00Z,19.1N  55.3W,0,22,5,1,28
Tropical Storm,Dolly,11,2002-09-01T03:00:00Z,17.5N  54.4W,7,26,1,0,34
Tropical Storm,Dolly,12,2002-09-01T09:00:00Z,16.8N  53.4W,50,0,0,0,50
Tropical Storm,Dolly,12,2002-09-01T09:00:00Z,19.8N  54.9W,2,22,3,1,28
Tropical Storm,Dolly,12,2002-09-01T09:00:00Z,18.3N  54.5W,20,14,0,0,34
Tropical Storm,Dolly,13,2002-09-01T15:00:00Z,17.8N  54.0W,54,0,0,0,54
Tropical Storm,Dolly,13,2002-09-01T15:00:00Z,20.7N  55.0W,0,29,4,1,34
Tropical Storm,Dolly,13,2002-09-01T15:00:00Z,19.3N  54.7W,16,25,0,0,41
Tropical Storm,Dolly,14,2002-09-01T21:00:00Z,18.8N  54.6W,50,0,0,0,50
Tropical Storm,Dolly,14,2002-09-01T21:00:00Z,21.5N  55.3W,11,15,1,2,29
Tropical Storm,Dolly,14,2002-09-01T21:00:00Z,20.2N  55.1W,31,4,0,0,35
Tropical Storm,Dolly,15,2002-09-02T03:00:00Z,19.2N  53.5W,36,0,0,0,36
Tropical Storm,Dolly,15,2002-09-02T03:00:00Z,22.2N  54.0W,2,14,3,3,22
Tropical Storm,Dolly,15,2002-09-02T03:00:00Z,20.8N  53.8W,16,7,1,1,25
Tropical Storm,Dolly,16,2002-09-02T09:00:00Z,19.9N  53.7W,36,0,0,0,36
Tropical Storm,Dolly,16,2002-09-02T09:00:00Z,22.7N  53.9W,3,13,3,3,22
Tropical Storm,Dolly,16,2002-09-02T09:00:00Z,21.4N  54.0W,16,6,2,1,25
Tropical Storm,Dolly,17,2002-09-02T15:00:00Z,22.0N  53.6W,28,1,0,0,29
Tropical Storm,Dolly,17,2002-09-02T15:00:00Z,25.9N  53.6W,0,9,8,3,20
Tropical Storm,Dolly,17,2002-09-02T15:00:00Z,24.0N  53.7W,2,18,2,1,23
Tropical Storm,Dolly,18,2002-09-02T21:00:00Z,21.9N  54.3W,33,0,0,0,33
Tropical Storm,Dolly,18,2002-09-02T21:00:00Z,26.0N  54.7W,0,9,9,3,21
Tropical Storm,Dolly,18,2002-09-02T21:00:00Z,23.9N  54.5W,5,17,1,1,24
Tropical Storm,Dolly,19,2002-09-03T03:00:00Z,22.5N  54.0W,38,0,0,0,38
Tropical Storm,Dolly,19,2002-09-03T03:00:00Z,26.1N  54.0W,0,14,9,1,24
Tropical Storm,Dolly,19,2002-09-03T03:00:00Z,24.0N  54.0W,17,9,1,1,28
Tropical Storm,Dolly,20,2002-09-03T09:00:00Z,22.8N  55.0W,32,0,1,0,33
Tropical Storm,Dolly,20,2002-09-03T09:00:00Z,26.0N  55.0W,0,12,5,3,20
Tropical Storm,Dolly,20,2002-09-03T09:00:00Z,24.3N  55.1W,11,9,2,1,23
Tropical Storm,Dolly,21,2002-09-03T15:00:00Z,24.0N  53.2W,54,0,0,0,54
Tropical Storm,Dolly,21,2002-09-03T15:00:00Z,29.5N  52.5W,0,12,7,2,21
Tropical Storm,Dolly,21,2002-09-03T15:00:00Z,27.0N  53.0W,5,26,0,0,31
Tropical Storm,Dolly,22,2002-09-03T21:00:00Z,27.0N  51.5W,25,1,0,0,26
Tropical Storm,Dolly,22,2002-09-03T21:00:00Z,CAPE RACE NFLD,0,0,0,2,2
Tropical Storm,Dolly,22,2002-09-03T21:00:00Z,29.5N  51.0W,8,8,2,1,19
Tropical Storm,Dolly,22,2002-09-03T21:00:00Z,HIBERNIA OILFLD,0,0,0,2,2
Tropical Storm,Dolly,22,2002-09-03T21:00:00Z,32.0N  50.0W,0,8,5,2,15
Tropical Storm,Dolly,23,2002-09-04T03:00:00Z,27.6N  52.1W,43,0,0,0,43
Tropical Storm,Dolly,23,2002-09-04T03:00:00Z,33.0N  51.0W,0,7,11,2,20
Tropical Storm,Dolly,23,2002-09-04T03:00:00Z,30.1N  51.8W,8,18,1,0,27
Tropical Storm,Dolly,24,2002-09-04T09:00:00Z,28.1N  52.1W,38,0,0,0,38
Tropical Storm,Dolly,24,2002-09-04T09:00:00Z,ILE ST PIERRE,0,0,0,2,2
Tropical Storm,Dolly,24,2002-09-04T09:00:00Z,31.0N  51.4W,6,21,1,0,28
Tropical Storm,Dolly,24,2002-09-04T09:00:00Z,CAPE RACE NFLD,0,0,0,4,4
Tropical Storm,Dolly,24,2002-09-04T09:00:00Z,34.0N  50.4W,0,9,10,1,20
Tropical Storm,Dolly,24,2002-09-04T09:00:00Z,HIBERNIA OILFLD,0,0,0,3,3
Tropical Depression,Dolly,25,2002-09-04T15:00:00Z,28.0N  51.5W,35,0,0,0,35
Tropical Depression,Five,1,2002-09-01T21:00:00Z,30.0N  80.6W,63,0,0,0,63
Tropical Depression,Five,1,2002-09-01T21:00:00Z,NORFOLK VA,0,0,1,5,6
Tropical Depression,Five,1,2002-09-01T21:00:00Z,30.6N  80.7W,46,0,0,0,46
Tropical Depression,Five,1,2002-09-01T21:00:00Z,OCEAN CITY MD,0,0,0,2,2
Tropical Depression,Five,1,2002-09-01T21:00:00Z,31.7N  80.6W,23,2,1,1,27
Tropical Depression,Five,1,2002-09-01T21:00:00Z,FT MYERS FL,0,0,1,2,3
Tropical Depression,Five,1,2002-09-01T21:00:00Z,MYGF 266N 787W,0,0,0,2,2
Tropical Depression,Five,1,2002-09-01T21:00:00Z,VENICE FL,1,0,1,2,4
Tropical Depression,Five,1,2002-09-01T21:00:00Z,W PALM BEACH FL,1,0,1,1,3
Tropical Depression,Five,1,2002-09-01T21:00:00Z,TAMPA FL,5,2,1,2,10
Tropical Depression,Five,1,2002-09-01T21:00:00Z,FT PIERCE FL,16,0,0,1,17
Tropical Depression,Five,1,2002-09-01T21:00:00Z,CEDAR KEY FL,10,3,1,1,15
Tropical Depression,Five,1,2002-09-01T21:00:00Z,COCOA BEACH FL,37,0,0,0,37
Tropical Depression,Five,1,2002-09-01T21:00:00Z,ST MARKS FL,3,6,3,2,14
Tropical Depression,Five,1,2002-09-01T21:00:00Z,DAYTONA BEACH FL,47,0,0,0,47
Tropical Depression,Five,1,2002-09-01T21:00:00Z,APALACHICOLA FL,1,3,3,3,10
Tropical Depression,Five,1,2002-09-01T21:00:00Z,JACKSONVILLE FL,32,1,0,0,33
Tropical Depression,Five,1,2002-09-01T21:00:00Z,PANAMA CITY FL,0,2,3,4,9
Tropical Depression,Five,1,2002-09-01T21:00:00Z,SAVANNAH GA,15,5,2,2,24
Tropical Depression,Five,1,2002-09-01T21:00:00Z,PENSACOLA FL,0,0,2,4,6
Tropical Depression,Five,1,2002-09-01T21:00:00Z,CHARLESTON SC,5,9,4,3,21
Tropical Depression,Five,1,2002-09-01T21:00:00Z,MOBILE AL,0,0,1,3,4
Tropical Depression,Five,1,2002-09-01T21:00:00Z,MYRTLE BEACH SC,0,8,6,4,18
Tropical Depression,Five,1,2002-09-01T21:00:00Z,GULFPORT MS,0,0,0,3,3
Tropical Depression,Five,1,2002-09-01T21:00:00Z,WILMINGTON NC,0,3,7,5,15
Tropical Depression,Five,1,2002-09-01T21:00:00Z,BURAS LA,0,0,0,2,2
Tropical Depression,Five,1,2002-09-01T21:00:00Z,MOREHEAD CITY NC,0,1,5,6,12
Tropical Depression,Five,1,2002-09-01T21:00:00Z,GULF 29N 85W,0,3,1,4,8
Tropical Depression,Five,1,2002-09-01T21:00:00Z,CAPE HATTERAS NC,0,0,3,6,9
Tropical Depression,Five,1,2002-09-01T21:00:00Z,GULF 29N 87W,0,0,1,3,4
Tropical Depression,Five,2,2002-09-02T03:00:00Z,30.6N  80.4W,72,0,0,0,72
Tropical Depression,Five,2,2002-09-02T03:00:00Z,CAPE HATTERAS NC,0,0,1,4,5
Tropical Depression,Five,2,2002-09-02T03:00:00Z,31.2N  80.5W,53,0,0,0,53
Tropical Depression,Five,2,2002-09-02T03:00:00Z,NORFOLK VA,0,0,0,3,3
Tropical Depression,Five,2,2002-09-02T03:00:00Z,31.7N  80.4W,35,0,0,0,35
Tropical Depression,Five,2,2002-09-02T03:00:00Z,FT MYERS FL,0,0,0,2,2
Tropical Depression,Five,2,2002-09-02T03:00:00Z,MYGF 266N 787W,0,0,1,3,4
Tropical Depression,Five,2,2002-09-02T03:00:00Z,VENICE FL,0,0,0,3,3
Tropical Depression,Five,2,2002-09-02T03:00:00Z,MIAMI FL,0,0,0,2,2
Tropical Depression,Five,2,2002-09-02T03:00:00Z,TAMPA FL,0,1,1,3,5
Tropical Depression,Five,2,2002-09-02T03:00:00Z,W PALM BEACH FL,0,0,1,2,3
Tropical Depression,Five,2,2002-09-02T03:00:00Z,CEDAR KEY FL,1,3,2,3,9
Tropical Depression,Five,2,2002-09-02T03:00:00Z,FT PIERCE FL,0,1,1,4,6
Tropical Depression,Five,2,2002-09-02T03:00:00Z,ST MARKS FL,1,4,3,3,11
Tropical Depression,Five,2,2002-09-02T03:00:00Z,COCOA BEACH FL,3,2,1,3,9
Tropical Depression,Five,2,2002-09-02T03:00:00Z,APALACHICOLA FL,0,1,2,4,7
Tropical Depression,Five,2,2002-09-02T03:00:00Z,DAYTONA BEACH FL,16,1,1,1,19
Tropical Depression,Five,2,2002-09-02T03:00:00Z,PANAMA CITY FL,0,1,2,3,6
Tropical Depression,Five,2,2002-09-02T03:00:00Z,JACKSONVILLE FL,31,1,0,0,32
Tropical Depression,Five,2,2002-09-02T03:00:00Z,PENSACOLA FL,0,0,1,3,4
Tropical Depression,Five,2,2002-09-02T03:00:00Z,SAVANNAH GA,23,2,1,0,26
Tropical Depression,Five,2,2002-09-02T03:00:00Z,MOBILE AL,0,0,0,3,3
Tropical Depression,Five,2,2002-09-02T03:00:00Z,CHARLESTON SC,6,8,3,2,19
Tropical Depression,Five,2,2002-09-02T03:00:00Z,GULFPORT MS,0,0,0,2,2
Tropical Depression,Five,2,2002-09-02T03:00:00Z,MYRTLE BEACH SC,0,5,5,5,15
Tropical Depression,Five,2,2002-09-02T03:00:00Z,GULF 29N 85W,0,0,1,4,5
Tropical Depression,Five,2,2002-09-02T03:00:00Z,WILMINGTON NC,0,1,5,5,11
Tropical Depression,Five,2,2002-09-02T03:00:00Z,GULF 29N 87W,0,0,0,2,2
Tropical Depression,Five,2,2002-09-02T03:00:00Z,MOREHEAD CITY NC,0,0,2,6,8
Tropical Storm,Edouard,3,2002-09-02T09:00:00Z,31.1N  80.6W,99,0,0,0,99
Tropical Storm,Edouard,3,2002-09-02T09:00:00Z,CAPE HATTERAS NC,0,0,1,4,5
Tropical Storm,Edouard,3,2002-09-02T09:00:00Z,31.6N  80.6W,58,0,0,0,58
Tropical Storm,Edouard,3,2002-09-02T09:00:00Z,NORFOLK VA,0,0,0,3,3
Tropical Storm,Edouard,3,2002-09-02T09:00:00Z,32.0N  80.4W,39,0,1,0,40
Tropical Storm,Edouard,3,2002-09-02T09:00:00Z,FT MYERS FL,0,0,0,2,2
Tropical Storm,Edouard,3,2002-09-02T09:00:00Z,MYGF 266N 787W,0,0,0,3,3
Tropical Storm,Edouard,3,2002-09-02T09:00:00Z,VENICE FL,0,0,0,3,3
Tropical Storm,Edouard,3,2002-09-02T09:00:00Z,MIAMI FL,0,0,0,2,2
Tropical Storm,Edouard,3,2002-09-02T09:00:00Z,TAMPA FL,0,0,1,4,5
Tropical Storm,Edouard,3,2002-09-02T09:00:00Z,W PALM BEACH FL,0,0,0,3,3
Tropical Storm,Edouard,3,2002-09-02T09:00:00Z,CEDAR KEY FL,1,1,2,4,8
Tropical Storm,Edouard,3,2002-09-02T09:00:00Z,FT PIERCE FL,0,0,1,4,5
Tropical Storm,Edouard,3,2002-09-02T09:00:00Z,ST MARKS FL,1,3,2,4,10
Tropical Storm,Edouard,3,2002-09-02T09:00:00Z,COCOA BEACH FL,0,1,2,4,7
Tropical Storm,Edouard,3,2002-09-02T09:00:00Z,APALACHICOLA FL,0,1,1,4,6
Tropical Storm,Edouard,3,2002-09-02T09:00:00Z,DAYTONA BEACH FL,41,0,0,0,41
Tropical Storm,Edouard,3,2002-09-02T09:00:00Z,PANAMA CITY FL,0,1,1,4,6
Tropical Storm,Edouard,3,2002-09-02T09:00:00Z,JACKSONVILLE FL,31,1,0,0,32
Tropical Storm,Edouard,3,2002-09-02T09:00:00Z,PENSACOLA FL,0,0,1,3,4
Tropical Storm,Edouard,3,2002-09-02T09:00:00Z,SAVANNAH GA,34,0,0,1,35
Tropical Storm,Edouard,3,2002-09-02T09:00:00Z,MOBILE AL,0,0,0,3,3
Tropical Storm,Edouard,3,2002-09-02T09:00:00Z,CHARLESTON SC,12,5,2,2,21
Tropical Storm,Edouard,3,2002-09-02T09:00:00Z,GULFPORT MS,0,0,0,2,2
Tropical Storm,Edouard,3,2002-09-02T09:00:00Z,MYRTLE BEACH SC,1,6,5,4,16
Tropical Storm,Edouard,3,2002-09-02T09:00:00Z,GULF 29N 85W,0,0,1,3,4
Tropical Storm,Edouard,3,2002-09-02T09:00:00Z,WILMINGTON NC,0,2,5,5,12
Tropical Storm,Edouard,3,2002-09-02T09:00:00Z,GULF 29N 87W,0,0,0,2,2
Tropical Storm,Edouard,3,2002-09-02T09:00:00Z,MOREHEAD CITY NC,0,0,3,6,9
Tropical Storm,Edouard,4,2002-09-02T15:00:00Z,31.2N  79.4W,99,0,0,0,99
Tropical Storm,Edouard,4,2002-09-02T15:00:00Z,WILMINGTON NC,0,3,3,4,10
Tropical Storm,Edouard,4,2002-09-02T15:00:00Z,31.3N  79.6W,99,0,0,0,99
Tropical Storm,Edouard,4,2002-09-02T15:00:00Z,MOREHEAD CITY NC,0,0,1,4,5
Tropical Storm,Edouard,4,2002-09-02T15:00:00Z,31.3N  80.0W,99,0,0,0,99
Tropical Storm,Edouard,4,2002-09-02T15:00:00Z,CAPE HATTERAS NC,0,0,0,2,2
Tropical Storm,Edouard,4,2002-09-02T15:00:00Z,MUCF 221N 805W,0,0,0,2,2
Tropical Storm,Edouard,4,2002-09-02T15:00:00Z,NORFOLK VA,0,0,0,2,2
Tropical Storm,Edouard,4,2002-09-02T15:00:00Z,MUHA 230N 824W,0,0,0,3,3
Tropical Storm,Edouard,4,2002-09-02T15:00:00Z,KEY WEST FL,0,0,1,5,6
Tropical Storm,Edouard,4,2002-09-02T15:00:00Z,MYAK 241N 776W,0,0,0,2,2
Tropical Storm,Edouard,4,2002-09-02T15:00:00Z,MARCO ISLAND FL,0,1,3,6,10
Tropical Storm,Edouard,4,2002-09-02T15:00:00Z,MYNN 251N 775W,0,0,0,4,4
Tropical Storm,Edouard,4,2002-09-02T15:00:00Z,FT MYERS FL,0,1,5,5,11
Tropical Storm,Edouard,4,2002-09-02T15:00:00Z,MYGF 266N 787W,0,2,2,5,9
Tropical Storm,Edouard,4,2002-09-02T15:00:00Z,VENICE FL,0,1,5,6,12
Tropical Storm,Edouard,4,2002-09-02T15:00:00Z,MARATHON FL,0,0,2,4,6
Tropical Storm,Edouard,4,2002-09-02T15:00:00Z,TAMPA FL,0,3,6,5,14
Tropical Storm,Edouard,4,2002-09-02T15:00:00Z,MIAMI FL,0,1,3,5,9
Tropical Storm,Edouard,4,2002-09-02T15:00:00Z,CEDAR KEY FL,0,3,7,5,15
Tropical Storm,Edouard,4,2002-09-02T15:00:00Z,W PALM BEACH FL,0,3,4,5,12
Tropical Storm,Edouard,4,2002-09-02T15:00:00Z,ST MARKS FL,0,1,5,7,13
Tropical Storm,Edouard,4,2002-09-02T15:00:00Z,FT PIERCE FL,1,5,5,3,14
Tropical Storm,Edouard,4,2002-09-02T15:00:00Z,APALACHICOLA FL,0,0,3,7,10
Tropical Storm,Edouard,4,2002-09-02T15:00:00Z,COCOA BEACH FL,2,8,4,3,17
Tropical Storm,Edouard,4,2002-09-02T15:00:00Z,PANAMA CITY FL,0,0,2,7,9
Tropical Storm,Edouard,4,2002-09-02T15:00:00Z,DAYTONA BEACH FL,4,9,4,2,19
Tropical Storm,Edouard,4,2002-09-02T15:00:00Z,PENSACOLA FL,0,0,0,5,5
Tropical Storm,Edouard,4,2002-09-02T15:00:00Z,JACKSONVILLE FL,7,8,3,3,21
Tropical Storm,Edouard,4,2002-09-02T15:00:00Z,MOBILE AL,0,0,0,3,3
Tropical Storm,Edouard,4,2002-09-02T15:00:00Z,SAVANNAH GA,18,3,2,1,24
Tropical Storm,Edouard,4,2002-09-02T15:00:00Z,GULFPORT MS,0,0,0,2,2
Tropical Storm,Edouard,4,2002-09-02T15:00:00Z,CHARLESTON SC,16,4,1,2,23
Tropical Storm,Edouard,4,2002-09-02T15:00:00Z,GULF 29N 85W,0,0,2,7,9
Tropical Storm,Edouard,4,2002-09-02T15:00:00Z,MYRTLE BEACH SC,4,6,3,3,16
Tropical Storm,Edouard,4,2002-09-02T15:00:00Z,GULF 29N 87W,0,0,0,5,5
Tropical Storm,Edouard,5,2002-09-02T21:00:00Z,30.9N  78.9W,99,0,0,0,99
Tropical Storm,Edouard,5,2002-09-02T21:00:00Z,KEY WEST FL,0,0,0,4,4
Tropical Storm,Edouard,5,2002-09-02T21:00:00Z,31.0N  79.4W,99,0,0,0,99
Tropical Storm,Edouard,5,2002-09-02T21:00:00Z,MARCO ISLAND FL,0,0,2,5,7
Tropical Storm,Edouard,5,2002-09-02T21:00:00Z,30.7N  80.0W,99,0,0,0,99
Tropical Storm,Edouard,5,2002-09-02T21:00:00Z,FT MYERS FL,0,1,2,6,9
Tropical Storm,Edouard,5,2002-09-02T21:00:00Z,MUHA 230N 824W,0,0,0,2,2
Tropical Storm,Edouard,5,2002-09-02T21:00:00Z,VENICE FL,0,2,4,5,11
Tropical Storm,Edouard,5,2002-09-02T21:00:00Z,MYAK 241N 776W,0,0,0,2,2
Tropical Storm,Edouard,5,2002-09-02T21:00:00Z,TAMPA FL,1,5,4,5,15
Tropical Storm,Edouard,5,2002-09-02T21:00:00Z,MYNN 251N 775W,0,0,0,3,3
Tropical Storm,Edouard,5,2002-09-02T21:00:00Z,CEDAR KEY FL,2,8,4,3,17
Tropical Storm,Edouard,5,2002-09-02T21:00:00Z,MYGF 266N 787W,0,1,0,6,7
Tropical Storm,Edouard,5,2002-09-02T21:00:00Z,ST MARKS FL,1,7,5,4,17
Tropical Storm,Edouard,5,2002-09-02T21:00:00Z,MARATHON FL,0,0,0,4,4
Tropical Storm,Edouard,5,2002-09-02T21:00:00Z,APALACHICOLA FL,0,5,5,5,15
Tropical Storm,Edouard,5,2002-09-02T21:00:00Z,MIAMI FL,0,0,1,5,6
Tropical Storm,Edouard,5,2002-09-02T21:00:00Z,PANAMA CITY FL,0,3,6,5,14
Tropical Storm,Edouard,5,2002-09-02T21:00:00Z,W PALM BEACH FL,1,1,1,6,9
Tropical Storm,Edouard,5,2002-09-02T21:00:00Z,PENSACOLA FL,0,1,3,6,10
Tropical Storm,Edouard,5,2002-09-02T21:00:00Z,FT PIERCE FL,6,1,2,4,13
Tropical Storm,Edouard,5,2002-09-02T21:00:00Z,MOBILE AL,0,0,2,6,8
Tropical Storm,Edouard,5,2002-09-02T21:00:00Z,COCOA BEACH FL,11,2,2,2,17
Tropical Storm,Edouard,5,2002-09-02T21:00:00Z,GULFPORT MS,0,0,1,6,7
Tropical Storm,Edouard,5,2002-09-02T21:00:00Z,DAYTONA BEACH FL,14,3,2,2,21
Tropical Storm,Edouard,5,2002-09-02T21:00:00Z,BURAS LA,0,0,1,5,6
Tropical Storm,Edouard,5,2002-09-02T21:00:00Z,JACKSONVILLE FL,13,5,2,2,22
Tropical Storm,Edouard,5,2002-09-02T21:00:00Z,NEW ORLEANS LA,0,0,0,5,5
Tropical Storm,Edouard,5,2002-09-02T21:00:00Z,SAVANNAH GA,12,5,2,2,21
Tropical Storm,Edouard,5,2002-09-02T21:00:00Z,NEW IBERIA LA,0,0,0,3,3
Tropical Storm,Edouard,5,2002-09-02T21:00:00Z,CHARLESTON SC,11,4,2,2,19
Tropical Storm,Edouard,5,2002-09-02T21:00:00Z,GULF 29N 85W,0,4,5,5,14
Tropical Storm,Edouard,5,2002-09-02T21:00:00Z,MYRTLE BEACH SC,6,4,2,3,15
Tropical Storm,Edouard,5,2002-09-02T21:00:00Z,GULF 29N 87W,0,1,4,6,11
Tropical Storm,Edouard,5,2002-09-02T21:00:00Z,WILMINGTON NC,2,3,3,3,11
Tropical Storm,Edouard,5,2002-09-02T21:00:00Z,GULF 28N 89W,0,0,1,6,7
Tropical Storm,Edouard,5,2002-09-02T21:00:00Z,MOREHEAD CITY NC,0,2,3,3,8
Tropical Storm,Edouard,5,2002-09-02T21:00:00Z,GULF 28N 91W,0,0,0,4,4
Tropical Storm,Edouard,5,2002-09-02T21:00:00Z,CAPE HATTERAS NC,0,1,1,3,5
Tropical Storm,Edouard,5,2002-09-02T21:00:00Z,GULF 28N 93W,0,0,0,2,2
Tropical Storm,Edouard,5,2002-09-02T21:00:00Z,NORFOLK VA,0,0,0,2,2
Tropical Storm,Edouard,6,2002-09-03T03:00:00Z,30.8N  78.5W,99,0,0,0,99
Tropical Storm,Edouard,6,2002-09-03T03:00:00Z,KEY WEST FL,0,0,0,4,4
Tropical Storm,Edouard,6,2002-09-03T03:00:00Z,30.8N  79.2W,99,0,0,0,99
Tropical Storm,Edouard,6,2002-09-03T03:00:00Z,MARCO ISLAND FL,0,0,2,6,8
Tropical Storm,Edouard,6,2002-09-03T03:00:00Z,30.3N  80.0W,23,2,1,0,26
Tropical Storm,Edouard,6,2002-09-03T03:00:00Z,FT MYERS FL,0,1,3,6,10
Tropical Storm,Edouard,6,2002-09-03T03:00:00Z,MUHA 230N 824W,0,0,0,2,2
Tropical Storm,Edouard,6,2002-09-03T03:00:00Z,VENICE FL,0,2,4,6,12
Tropical Storm,Edouard,6,2002-09-03T03:00:00Z,MYAK 241N 776W,0,0,0,2,2
Tropical Storm,Edouard,6,2002-09-03T03:00:00Z,TAMPA FL,1,5,5,4,15
Tropical Storm,Edouard,6,2002-09-03T03:00:00Z,MYNN 251N 775W,0,0,0,3,3
Tropical Storm,Edouard,6,2002-09-03T03:00:00Z,CEDAR KEY FL,1,8,5,4,18
Tropical Storm,Edouard,6,2002-09-03T03:00:00Z,MYGF 266N 787W,0,1,1,5,7
Tropical Storm,Edouard,6,2002-09-03T03:00:00Z,ST MARKS FL,0,7,5,4,16
Tropical Storm,Edouard,6,2002-09-03T03:00:00Z,MARATHON FL,0,0,0,4,4
Tropical Storm,Edouard,6,2002-09-03T03:00:00Z,APALACHICOLA FL,0,4,6,4,14
Tropical Storm,Edouard,6,2002-09-03T03:00:00Z,MIAMI FL,0,0,1,5,6
Tropical Storm,Edouard,6,2002-09-03T03:00:00Z,PANAMA CITY FL,0,2,6,5,13
Tropical Storm,Edouard,6,2002-09-03T03:00:00Z,W PALM BEACH FL,1,1,1,6,9
Tropical Storm,Edouard,6,2002-09-03T03:00:00Z,PENSACOLA FL,0,0,3,6,9
Tropical Storm,Edouard,6,2002-09-03T03:00:00Z,FT PIERCE FL,4,2,3,4,13
Tropical Storm,Edouard,6,2002-09-03T03:00:00Z,MOBILE AL,0,0,1,5,6
Tropical Storm,Edouard,6,2002-09-03T03:00:00Z,COCOA BEACH FL,8,3,2,3,16
Tropical Storm,Edouard,6,2002-09-03T03:00:00Z,GULFPORT MS,0,0,1,4,5
Tropical Storm,Edouard,6,2002-09-03T03:00:00Z,DAYTONA BEACH FL,10,5,3,2,20
Tropical Storm,Edouard,6,2002-09-03T03:00:00Z,BURAS LA,0,0,1,4,5
Tropical Storm,Edouard,6,2002-09-03T03:00:00Z,JACKSONVILLE FL,10,7,2,2,21
Tropical Storm,Edouard,6,2002-09-03T03:00:00Z,NEW ORLEANS LA,0,0,0,4,4
Tropical Storm,Edouard,6,2002-09-03T03:00:00Z,SAVANNAH GA,8,7,2,2,19
Tropical Storm,Edouard,6,2002-09-03T03:00:00Z,NEW IBERIA LA,0,0,0,2,2
Tropical Storm,Edouard,6,2002-09-03T03:00:00Z,CHARLESTON SC,9,4,2,2,17
Tropical Storm,Edouard,6,2002-09-03T03:00:00Z,GULF 29N 85W,0,3,6,5,14
Tropical Storm,Edouard,6,2002-09-03T03:00:00Z,MYRTLE BEACH SC,5,4,2,2,13
Tropical Storm,Edouard,6,2002-09-03T03:00:00Z,GULF 29N 87W,0,0,4,7,11
Tropical Storm,Edouard,6,2002-09-03T03:00:00Z,WILMINGTON NC,2,3,2,3,10
Tropical Storm,Edouard,6,2002-09-03T03:00:00Z,GULF 28N 89W,0,0,1,6,7
Tropical Storm,Edouard,6,2002-09-03T03:00:00Z,MOREHEAD CITY NC,1,1,2,3,7
Tropical Storm,Edouard,6,2002-09-03T03:00:00Z,GULF 28N 91W,0,0,0,4,4
Tropical Storm,Edouard,6,2002-09-03T03:00:00Z,CAPE HATTERAS NC,0,0,1,3,4
Tropical Storm,Edouard,6,2002-09-03T03:00:00Z,GULF 28N 93W,0,0,0,2,2
Tropical Storm,Edouard,7,2002-09-03T09:00:00Z,30.2N  79.0W,99,0,0,0,99
Tropical Storm,Edouard,7,2002-09-03T09:00:00Z,MYRTLE BEACH SC,2,3,1,2,8
Tropical Storm,Edouard,7,2002-09-03T09:00:00Z,30.1N  79.6W,99,0,0,0,99
Tropical Storm,Edouard,7,2002-09-03T09:00:00Z,WILMINGTON NC,0,1,0,2,3
Tropical Storm,Edouard,7,2002-09-03T09:00:00Z,29.7N  80.5W,19,3,1,1,24
Tropical Storm,Edouard,7,2002-09-03T09:00:00Z,KEY WEST FL,0,0,1,5,6
Tropical Storm,Edouard,7,2002-09-03T09:00:00Z,MUCF 221N 805W,0,0,0,2,2
Tropical Storm,Edouard,7,2002-09-03T09:00:00Z,MARCO ISLAND FL,0,0,3,7,10
Tropical Storm,Edouard,7,2002-09-03T09:00:00Z,MUSN 216N 826W,0,0,0,2,2
Tropical Storm,Edouard,7,2002-09-03T09:00:00Z,FT MYERS FL,0,0,4,7,11
Tropical Storm,Edouard,7,2002-09-03T09:00:00Z,MUHA 230N 824W,0,0,0,3,3
Tropical Storm,Edouard,7,2002-09-03T09:00:00Z,VENICE FL,0,0,4,7,11
Tropical Storm,Edouard,7,2002-09-03T09:00:00Z,MYEG 235N 758W,0,0,0,2,2
Tropical Storm,Edouard,7,2002-09-03T09:00:00Z,TAMPA FL,0,1,6,6,13
Tropical Storm,Edouard,7,2002-09-03T09:00:00Z,MYAK 241N 776W,0,0,1,4,5
Tropical Storm,Edouard,7,2002-09-03T09:00:00Z,CEDAR KEY FL,0,3,6,6,15
Tropical Storm,Edouard,7,2002-09-03T09:00:00Z,MYNN 251N 775W,0,0,2,4,6
Tropical Storm,Edouard,7,2002-09-03T09:00:00Z,ST MARKS FL,0,1,7,6,14
Tropical Storm,Edouard,7,2002-09-03T09:00:00Z,MYGF 266N 787W,1,2,4,4,11
Tropical Storm,Edouard,7,2002-09-03T09:00:00Z,APALACHICOLA FL,0,0,4,8,12
Tropical Storm,Edouard,7,2002-09-03T09:00:00Z,MARATHON FL,0,0,1,6,7
Tropical Storm,Edouard,7,2002-09-03T09:00:00Z,PANAMA CITY FL,0,0,3,8,11
Tropical Storm,Edouard,7,2002-09-03T09:00:00Z,MIAMI FL,0,0,4,6,10
Tropical Storm,Edouard,7,2002-09-03T09:00:00Z,PENSACOLA FL,0,0,1,6,7
Tropical Storm,Edouard,7,2002-09-03T09:00:00Z,W PALM BEACH FL,0,2,5,5,12
Tropical Storm,Edouard,7,2002-09-03T09:00:00Z,MOBILE AL,0,0,0,5,5
Tropical Storm,Edouard,7,2002-09-03T09:00:00Z,FT PIERCE FL,1,5,4,4,14
Tropical Storm,Edouard,7,2002-09-03T09:00:00Z,GULFPORT MS,0,0,0,4,4
Tropical Storm,Edouard,7,2002-09-03T09:00:00Z,COCOA BEACH FL,4,5,4,3,16
Tropical Storm,Edouard,7,2002-09-03T09:00:00Z,BURAS LA,0,0,0,2,2
Tropical Storm,Edouard,7,2002-09-03T09:00:00Z,DAYTONA BEACH FL,7,6,3,3,19
Tropical Storm,Edouard,7,2002-09-03T09:00:00Z,NEW ORLEANS LA,0,0,0,2,2
Tropical Storm,Edouard,7,2002-09-03T09:00:00Z,JACKSONVILLE FL,8,7,3,2,20
Tropical Storm,Edouard,7,2002-09-03T09:00:00Z,GULF 29N 85W,0,0,3,8,11
Tropical Storm,Edouard,7,2002-09-03T09:00:00Z,SAVANNAH GA,14,4,2,1,21
Tropical Storm,Edouard,7,2002-09-03T09:00:00Z,GULF 29N 87W,0,0,0,7,7
Tropical Storm,Edouard,7,2002-09-03T09:00:00Z,CHARLESTON SC,12,4,1,1,18
Tropical Storm,Edouard,7,2002-09-03T09:00:00Z,GULF 28N 89W,0,0,0,2,2
Tropical Storm,Edouard,8,2002-09-03T15:00:00Z,30.0N  79.0W,99,0,0,0,99
Tropical Storm,Edouard,8,2002-09-03T15:00:00Z,CAPE HATTERAS NC,0,0,0,2,2
Tropical Storm,Edouard,8,2002-09-03T15:00:00Z,29.8N  80.0W,35,0,0,0,35
Tropical Storm,Edouard,8,2002-09-03T15:00:00Z,NORFOLK VA,0,0,0,2,2
Tropical Storm,Edouard,8,2002-09-03T15:00:00Z,29.2N  81.0W,14,4,2,2,22
Tropical Storm,Edouard,8,2002-09-03T15:00:00Z,KEY WEST FL,0,0,2,4,6
Tropical Storm,Edouard,8,2002-09-03T15:00:00Z,MUSN 216N 826W,0,0,0,2,2
Tropical Storm,Edouard,8,2002-09-03T15:00:00Z,MARCO ISLAND FL,0,1,5,5,11
Tropical Storm,Edouard,8,2002-09-03T15:00:00Z,MUHA 230N 824W,0,0,0,3,3
Tropical Storm,Edouard,8,2002-09-03T15:00:00Z,FT MYERS FL,0,2,6,5,13
Tropical Storm,Edouard,8,2002-09-03T15:00:00Z,MUAN 219N 850W,0,0,0,2,2
Tropical Storm,Edouard,8,2002-09-03T15:00:00Z,VENICE FL,0,3,6,5,14
Tropical Storm,Edouard,8,2002-09-03T15:00:00Z,MYNN 251N 775W,0,0,0,2,2
Tropical Storm,Edouard,8,2002-09-03T15:00:00Z,TAMPA FL,1,5,6,4,16
Tropical Storm,Edouard,8,2002-09-03T15:00:00Z,MYGF 266N 787W,0,2,2,4,8
Tropical Storm,Edouard,8,2002-09-03T15:00:00Z,CEDAR KEY FL,1,6,6,4,17
Tropical Storm,Edouard,8,2002-09-03T15:00:00Z,MARATHON FL,0,0,2,4,6
Tropical Storm,Edouard,8,2002-09-03T15:00:00Z,ST MARKS FL,0,2,7,6,15
Tropical Storm,Edouard,8,2002-09-03T15:00:00Z,MIAMI FL,0,1,3,4,8
Tropical Storm,Edouard,8,2002-09-03T15:00:00Z,APALACHICOLA FL,0,0,5,8,13
Tropical Storm,Edouard,8,2002-09-03T15:00:00Z,W PALM BEACH FL,1,3,4,3,11
Tropical Storm,Edouard,8,2002-09-03T15:00:00Z,PANAMA CITY FL,0,0,3,8,11
Tropical Storm,Edouard,8,2002-09-03T15:00:00Z,FT PIERCE FL,4,5,3,3,15
Tropical Storm,Edouard,8,2002-09-03T15:00:00Z,PENSACOLA FL,0,0,0,7,7
Tropical Storm,Edouard,8,2002-09-03T15:00:00Z,COCOA BEACH FL,8,5,3,2,18
Tropical Storm,Edouard,8,2002-09-03T15:00:00Z,MOBILE AL,0,0,0,5,5
Tropical Storm,Edouard,8,2002-09-03T15:00:00Z,DAYTONA BEACH FL,13,4,3,1,21
Tropical Storm,Edouard,8,2002-09-03T15:00:00Z,GULFPORT MS,0,0,0,4,4
Tropical Storm,Edouard,8,2002-09-03T15:00:00Z,JACKSONVILLE FL,11,6,3,2,22
Tropical Storm,Edouard,8,2002-09-03T15:00:00Z,BURAS LA,0,0,0,3,3
Tropical Storm,Edouard,8,2002-09-03T15:00:00Z,SAVANNAH GA,9,7,3,2,21
Tropical Storm,Edouard,8,2002-09-03T15:00:00Z,NEW ORLEANS LA,0,0,0,2,2
Tropical Storm,Edouard,8,2002-09-03T15:00:00Z,CHARLESTON SC,9,6,3,1,19
Tropical Storm,Edouard,8,2002-09-03T15:00:00Z,GULF 29N 85W,0,0,5,8,13
Tropical Storm,Edouard,8,2002-09-03T15:00:00Z,MYRTLE BEACH SC,3,7,2,2,14
Tropical Storm,Edouard,8,2002-09-03T15:00:00Z,GULF 29N 87W,0,0,1,7,8
Tropical Storm,Edouard,8,2002-09-03T15:00:00Z,WILMINGTON NC,0,4,2,3,9
Tropical Storm,Edouard,8,2002-09-03T15:00:00Z,GULF 28N 89W,0,0,0,4,4
Tropical Storm,Edouard,8,2002-09-03T15:00:00Z,MOREHEAD CITY NC,0,1,1,3,5
Tropical Storm,Edouard,9,2002-09-03T21:00:00Z,29.3N  81.2W,47,0,0,0,47
Tropical Storm,Edouard,9,2002-09-03T21:00:00Z,FT MYERS FL,3,7,2,3,15
Tropical Storm,Edouard,9,2002-09-03T21:00:00Z,28.8N  82.4W,25,2,1,0,28
Tropical Storm,Edouard,9,2002-09-03T21:00:00Z,VENICE FL,4,10,2,2,18
Tropical Storm,Edouard,9,2002-09-03T21:00:00Z,28.5N  83.5W,7,12,2,2,23
Tropical Storm,Edouard,9,2002-09-03T21:00:00Z,TAMPA FL,13,7,1,2,23
Tropical Storm,Edouard,9,2002-09-03T21:00:00Z,MUHA 230N 824W,0,0,0,2,2
Tropical Storm,Edouard,9,2002-09-03T21:00:00Z,CEDAR KEY FL,18,6,1,1,26
Tropical Storm,Edouard,9,2002-09-03T21:00:00Z,MYGF 266N 787W,0,1,0,2,3
Tropical Storm,Edouard,9,2002-09-03T21:00:00Z,ST MARKS FL,4,12,3,2,21
Tropical Storm,Edouard,9,2002-09-03T21:00:00Z,MARATHON FL,0,1,1,2,4
Tropical Storm,Edouard,9,2002-09-03T21:00:00Z,APALACHICOLA FL,1,9,5,4,19
Tropical Storm,Edouard,9,2002-09-03T21:00:00Z,MIAMI FL,0,2,1,3,6
Tropical Storm,Edouard,9,2002-09-03T21:00:00Z,PANAMA CITY FL,0,6,6,6,18
Tropical Storm,Edouard,9,2002-09-03T21:00:00Z,W PALM BEACH FL,3,3,1,2,9
Tropical Storm,Edouard,9,2002-09-03T21:00:00Z,PENSACOLA FL,0,0,4,9,13
Tropical Storm,Edouard,9,2002-09-03T21:00:00Z,FT PIERCE FL,13,2,0,1,16
Tropical Storm,Edouard,9,2002-09-03T21:00:00Z,MOBILE AL,0,0,1,9,10
Tropical Storm,Edouard,9,2002-09-03T21:00:00Z,COCOA BEACH FL,25,1,0,0,26
Tropical Storm,Edouard,9,2002-09-03T21:00:00Z,GULFPORT MS,0,0,0,8,8
Tropical Storm,Edouard,9,2002-09-03T21:00:00Z,DAYTONA BEACH FL,46,0,0,0,46
Tropical Storm,Edouard,9,2002-09-03T21:00:00Z,BURAS LA,0,0,0,7,7
Tropical Storm,Edouard,9,2002-09-03T21:00:00Z,JACKSONVILLE FL,41,0,1,0,42
Tropical Storm,Edouard,9,2002-09-03T21:00:00Z,NEW ORLEANS LA,0,0,0,5,5
Tropical Storm,Edouard,9,2002-09-03T21:00:00Z,SAVANNAH GA,17,1,1,1,20
Tropical Storm,Edouard,9,2002-09-03T21:00:00Z,NEW IBERIA LA,0,0,0,2,2
Tropical Storm,Edouard,9,2002-09-03T21:00:00Z,CHARLESTON SC,2,3,2,3,10
Tropical Storm,Edouard,9,2002-09-03T21:00:00Z,GULF 29N 85W,0,10,5,4,19
Tropical Storm,Edouard,9,2002-09-03T21:00:00Z,MYRTLE BEACH SC,0,0,1,3,4
Tropical Storm,Edouard,9,2002-09-03T21:00:00Z,GULF 29N 87W,0,1,5,8,14
Tropical Storm,Edouard,9,2002-09-03T21:00:00Z,WILMINGTON NC,0,0,0,2,2
Tropical Storm,Edouard,9,2002-09-03T21:00:00Z,GULF 28N 89W,0,0,1,7,8
Tropical Storm,Edouard,9,2002-09-03T21:00:00Z,KEY WEST FL,0,1,1,3,5
Tropical Storm,Edouard,9,2002-09-03T21:00:00Z,GULF 28N 91W,0,0,0,4,4
Tropical Storm,Edouard,9,2002-09-03T21:00:00Z,MARCO ISLAND FL,1,5,2,3,11
Tropical Storm,Edouard,10,2002-09-04T03:00:00Z,28.9N  81.3W,45,0,0,0,45
Tropical Storm,Edouard,10,2002-09-04T03:00:00Z,FT MYERS FL,5,6,2,2,15
Tropical Storm,Edouard,10,2002-09-04T03:00:00Z,28.6N  82.3W,28,1,1,0,30
Tropical Storm,Edouard,10,2002-09-04T03:00:00Z,VENICE FL,7,8,2,1,18
Tropical Storm,Edouard,10,2002-09-04T03:00:00Z,28.5N  83.4W,11,8,2,2,23
Tropical Storm,Edouard,10,2002-09-04T03:00:00Z,TAMPA FL,18,4,1,1,24
Tropical Storm,Edouard,10,2002-09-04T03:00:00Z,MYGF 266N 787W,1,0,1,1,3
Tropical Storm,Edouard,10,2002-09-04T03:00:00Z,CEDAR KEY FL,21,4,1,1,27
Tropical Storm,Edouard,10,2002-09-04T03:00:00Z,MARATHON FL,0,1,1,1,3
Tropical Storm,Edouard,10,2002-09-04T03:00:00Z,ST MARKS FL,4,10,3,4,21
Tropical Storm,Edouard,10,2002-09-04T03:00:00Z,MIAMI FL,1,2,1,2,6
Tropical Storm,Edouard,10,2002-09-04T03:00:00Z,APALACHICOLA FL,1,8,5,5,19
Tropical Storm,Edouard,10,2002-09-04T03:00:00Z,W PALM BEACH FL,6,2,1,1,10
Tropical Storm,Edouard,10,2002-09-04T03:00:00Z,PANAMA CITY FL,0,5,6,6,17
Tropical Storm,Edouard,10,2002-09-04T03:00:00Z,FT PIERCE FL,18,1,0,1,20
Tropical Storm,Edouard,10,2002-09-04T03:00:00Z,PENSACOLA FL,0,0,3,10,13
Tropical Storm,Edouard,10,2002-09-04T03:00:00Z,COCOA BEACH FL,33,0,0,0,33
Tropical Storm,Edouard,10,2002-09-04T03:00:00Z,MOBILE AL,0,0,1,9,10
Tropical Storm,Edouard,10,2002-09-04T03:00:00Z,DAYTONA BEACH FL,54,0,0,0,54
Tropical Storm,Edouard,10,2002-09-04T03:00:00Z,GULFPORT MS,0,0,0,9,9
Tropical Storm,Edouard,10,2002-09-04T03:00:00Z,JACKSONVILLE FL,38,1,0,0,39
Tropical Storm,Edouard,10,2002-09-04T03:00:00Z,BURAS LA,0,0,0,8,8
Tropical Storm,Edouard,10,2002-09-04T03:00:00Z,SAVANNAH GA,12,3,2,1,18
Tropical Storm,Edouard,10,2002-09-04T03:00:00Z,NEW ORLEANS LA,0,0,0,6,6
Tropical Storm,Edouard,10,2002-09-04T03:00:00Z,CHARLESTON SC,1,3,3,3,10
Tropical Storm,Edouard,10,2002-09-04T03:00:00Z,NEW IBERIA LA,0,0,0,3,3
Tropical Storm,Edouard,10,2002-09-04T03:00:00Z,MYRTLE BEACH SC,0,0,2,3,5
Tropical Storm,Edouard,10,2002-09-04T03:00:00Z,GULF 29N 85W,0,9,5,5,19
Tropical Storm,Edouard,10,2002-09-04T03:00:00Z,WILMINGTON NC,0,0,0,2,2
Tropical Storm,Edouard,10,2002-09-04T03:00:00Z,GULF 29N 87W,0,1,4,9,14
Tropical Storm,Edouard,10,2002-09-04T03:00:00Z,KEY WEST FL,0,1,1,2,4
Tropical Storm,Edouard,10,2002-09-04T03:00:00Z,GULF 28N 89W,0,0,1,8,9
Tropical Storm,Edouard,10,2002-09-04T03:00:00Z,MARCO ISLAND FL,1,5,3,2,11
Tropical Storm,Edouard,10,2002-09-04T03:00:00Z,GULF 28N 91W,0,0,0,5,5
Tropical Storm,Edouard,11,2002-09-04T09:00:00Z,29.1N  81.6W,46,0,0,0,46
Tropical Storm,Edouard,11,2002-09-04T09:00:00Z,VENICE FL,8,6,1,2,17
Tropical Storm,Edouard,11,2002-09-04T09:00:00Z,28.9N  82.7W,26,2,0,1,29
Tropical Storm,Edouard,11,2002-09-04T09:00:00Z,TAMPA FL,19,2,1,1,23
Tropical Storm,Edouard,11,2002-09-04T09:00:00Z,28.8N  83.7W,13,6,2,2,23
Tropical Storm,Edouard,11,2002-09-04T09:00:00Z,CEDAR KEY FL,24,1,1,1,27
Tropical Storm,Edouard,11,2002-09-04T09:00:00Z,MYGF 266N 787W,0,1,0,1,2
Tropical Storm,Edouard,11,2002-09-04T09:00:00Z,ST MARKS FL,8,8,3,3,22
Tropical Storm,Edouard,11,2002-09-04T09:00:00Z,MARATHON FL,0,0,1,1,2
Tropical Storm,Edouard,11,2002-09-04T09:00:00Z,APALACHICOLA FL,2,9,5,4,20
Tropical Storm,Edouard,11,2002-09-04T09:00:00Z,MIAMI FL,1,0,1,2,4
Tropical Storm,Edouard,11,2002-09-04T09:00:00Z,PANAMA CITY FL,0,7,6,5,18
Tropical Storm,Edouard,11,2002-09-04T09:00:00Z,W PALM BEACH FL,4,2,0,2,8
Tropical Storm,Edouard,11,2002-09-04T09:00:00Z,PENSACOLA FL,0,1,4,9,14
Tropical Storm,Edouard,11,2002-09-04T09:00:00Z,FT PIERCE FL,15,1,0,1,17
Tropical Storm,Edouard,11,2002-09-04T09:00:00Z,MOBILE AL,0,0,2,9,11
Tropical Storm,Edouard,11,2002-09-04T09:00:00Z,COCOA BEACH FL,32,0,0,0,32
Tropical Storm,Edouard,11,2002-09-04T09:00:00Z,GULFPORT MS,0,0,1,8,9
Tropical Storm,Edouard,11,2002-09-04T09:00:00Z,DAYTONA BEACH FL,60,0,0,0,60
Tropical Storm,Edouard,11,2002-09-04T09:00:00Z,BURAS LA,0,0,0,9,9
Tropical Storm,Edouard,11,2002-09-04T09:00:00Z,JACKSONVILLE FL,50,0,0,0,50
Tropical Storm,Edouard,11,2002-09-04T09:00:00Z,NEW ORLEANS LA,0,0,0,7,7
Tropical Storm,Edouard,11,2002-09-04T09:00:00Z,SAVANNAH GA,17,1,1,2,21
Tropical Storm,Edouard,11,2002-09-04T09:00:00Z,NEW IBERIA LA,0,0,0,3,3
Tropical Storm,Edouard,11,2002-09-04T09:00:00Z,CHARLESTON SC,2,4,2,3,11
Tropical Storm,Edouard,11,2002-09-04T09:00:00Z,GULF 29N 85W,2,9,5,4,20
Tropical Storm,Edouard,11,2002-09-04T09:00:00Z,MYRTLE BEACH SC,0,1,1,3,5
Tropical Storm,Edouard,11,2002-09-04T09:00:00Z,GULF 29N 87W,0,1,6,8,15
Tropical Storm,Edouard,11,2002-09-04T09:00:00Z,WILMINGTON NC,0,0,1,1,2
Tropical Storm,Edouard,11,2002-09-04T09:00:00Z,GULF 28N 89W,0,0,1,9,10
Tropical Storm,Edouard,11,2002-09-04T09:00:00Z,KEY WEST FL,0,0,1,2,3
Tropical Storm,Edouard,11,2002-09-04T09:00:00Z,GULF 28N 91W,0,0,0,5,5
Tropical Storm,Edouard,11,2002-09-04T09:00:00Z,MARCO ISLAND FL,2,3,1,3,9
Tropical Storm,Edouard,11,2002-09-04T09:00:00Z,GULF 28N 93W,0,0,0,2,2
Tropical Storm,Edouard,11,2002-09-04T09:00:00Z,FT MYERS FL,5,4,2,2,13
Tropical Storm,Edouard,12,2002-09-04T15:00:00Z,29.4N  81.1W,59,0,0,0,59
Tropical Storm,Edouard,12,2002-09-04T15:00:00Z,TAMPA FL,14,4,2,1,21
Tropical Storm,Edouard,12,2002-09-04T15:00:00Z,29.0N  82.0W,31,1,0,1,33
Tropical Storm,Edouard,12,2002-09-04T15:00:00Z,CEDAR KEY FL,18,4,1,1,24
Tropical Storm,Edouard,12,2002-09-04T15:00:00Z,28.8N  83.2W,14,5,2,1,22
Tropical Storm,Edouard,12,2002-09-04T15:00:00Z,ST MARKS FL,4,9,4,2,19
Tropical Storm,Edouard,12,2002-09-04T15:00:00Z,MYGF 266N 787W,0,1,1,1,3
Tropical Storm,Edouard,12,2002-09-04T15:00:00Z,APALACHICOLA FL,1,8,5,4,18
Tropical Storm,Edouard,12,2002-09-04T15:00:00Z,MARATHON FL,0,0,1,1,2
Tropical Storm,Edouard,12,2002-09-04T15:00:00Z,PANAMA CITY FL,0,5,6,5,16
Tropical Storm,Edouard,12,2002-09-04T15:00:00Z,MIAMI FL,0,1,2,1,4
Tropical Storm,Edouard,12,2002-09-04T15:00:00Z,PENSACOLA FL,0,0,5,8,13
Tropical Storm,Edouard,12,2002-09-04T15:00:00Z,W PALM BEACH FL,2,2,2,2,8
Tropical Storm,Edouard,12,2002-09-04T15:00:00Z,MOBILE AL,0,0,2,8,10
Tropical Storm,Edouard,12,2002-09-04T15:00:00Z,FT PIERCE FL,9,3,1,1,14
Tropical Storm,Edouard,12,2002-09-04T15:00:00Z,GULFPORT MS,0,0,1,8,9
Tropical Storm,Edouard,12,2002-09-04T15:00:00Z,COCOA BEACH FL,21,1,1,0,23
Tropical Storm,Edouard,12,2002-09-04T15:00:00Z,BURAS LA,0,0,1,8,9
Tropical Storm,Edouard,12,2002-09-04T15:00:00Z,DAYTONA BEACH FL,51,0,0,0,51
Tropical Storm,Edouard,12,2002-09-04T15:00:00Z,NEW ORLEANS LA,0,0,0,7,7
Tropical Storm,Edouard,12,2002-09-04T15:00:00Z,JACKSONVILLE FL,47,0,0,0,47
Tropical Storm,Edouard,12,2002-09-04T15:00:00Z,NEW IBERIA LA,0,0,0,5,5
Tropical Storm,Edouard,12,2002-09-04T15:00:00Z,SAVANNAH GA,13,3,2,1,19
Tropical Storm,Edouard,12,2002-09-04T15:00:00Z,PORT ARTHUR TX,0,0,0,2,2
Tropical Storm,Edouard,12,2002-09-04T15:00:00Z,CHARLESTON SC,3,4,3,3,13
Tropical Storm,Edouard,12,2002-09-04T15:00:00Z,GALVESTON TX,0,0,0,2,2
Tropical Storm,Edouard,12,2002-09-04T15:00:00Z,MYRTLE BEACH SC,0,2,2,4,8
Tropical Storm,Edouard,12,2002-09-04T15:00:00Z,FREEPORT TX,0,0,0,2,2
Tropical Storm,Edouard,12,2002-09-04T15:00:00Z,WILMINGTON NC,0,0,2,3,5
Tropical Storm,Edouard,12,2002-09-04T15:00:00Z,GULF 29N 85W,1,8,5,4,18
Tropical Storm,Edouard,12,2002-09-04T15:00:00Z,MOREHEAD CITY NC,0,0,1,2,3
Tropical Storm,Edouard,12,2002-09-04T15:00:00Z,GULF 29N 87W,0,1,6,7,14
Tropical Storm,Edouard,12,2002-09-04T15:00:00Z,CAPE HATTERAS NC,0,0,0,2,2
Tropical Storm,Edouard,12,2002-09-04T15:00:00Z,GULF 28N 89W,0,0,2,8,10
Tropical Storm,Edouard,12,2002-09-04T15:00:00Z,KEY WEST FL,0,0,1,2,3
Tropical Storm,Edouard,12,2002-09-04T15:00:00Z,GULF 28N 91W,0,0,0,7,7
Tropical Storm,Edouard,12,2002-09-04T15:00:00Z,MARCO ISLAND FL,1,3,2,2,8
Tropical Storm,Edouard,12,2002-09-04T15:00:00Z,GULF 28N 93W,0,0,0,4,4
Tropical Storm,Edouard,12,2002-09-04T15:00:00Z,FT MYERS FL,2,6,2,2,12
Tropical Storm,Edouard,12,2002-09-04T15:00:00Z,GULF 28N 95W,0,0,0,2,2
Tropical Storm,Edouard,12,2002-09-04T15:00:00Z,VENICE FL,5,6,3,2,16
Tropical Storm,Edouard,13,2002-09-04T21:00:00Z,28.9N  82.3W,51,0,0,0,51
Tropical Storm,Edouard,13,2002-09-04T21:00:00Z,CEDAR KEY FL,42,0,0,0,42
Tropical Storm,Edouard,13,2002-09-04T21:00:00Z,28.7N  83.3W,31,1,0,0,32
Tropical Storm,Edouard,13,2002-09-04T21:00:00Z,ST MARKS FL,19,3,1,1,24
Tropical Storm,Edouard,13,2002-09-04T21:00:00Z,28.8N  84.5W,14,5,2,2,23
Tropical Storm,Edouard,13,2002-09-04T21:00:00Z,APALACHICOLA FL,8,8,3,2,21
Tropical Storm,Edouard,13,2002-09-04T21:00:00Z,MIAMI FL,0,1,0,1,2
Tropical Storm,Edouard,13,2002-09-04T21:00:00Z,PANAMA CITY FL,2,9,5,3,19
Tropical Storm,Edouard,13,2002-09-04T21:00:00Z,W PALM BEACH FL,1,1,0,1,3
Tropical Storm,Edouard,13,2002-09-04T21:00:00Z,PENSACOLA FL,0,1,7,8,16
Tropical Storm,Edouard,13,2002-09-04T21:00:00Z,FT PIERCE FL,4,2,1,0,7
Tropical Storm,Edouard,13,2002-09-04T21:00:00Z,MOBILE AL,0,0,3,10,13
Tropical Storm,Edouard,13,2002-09-04T21:00:00Z,COCOA BEACH FL,15,1,0,1,17
Tropical Storm,Edouard,13,2002-09-04T21:00:00Z,GULFPORT MS,0,0,1,10,11
Tropical Storm,Edouard,13,2002-09-04T21:00:00Z,DAYTONA BEACH FL,99,0,0,0,99
Tropical Storm,Edouard,13,2002-09-04T21:00:00Z,BURAS LA,0,0,1,9,10
Tropical Storm,Edouard,13,2002-09-04T21:00:00Z,JACKSONVILLE FL,64,0,0,0,64
Tropical Storm,Edouard,13,2002-09-04T21:00:00Z,NEW ORLEANS LA,0,0,0,9,9
Tropical Storm,Edouard,13,2002-09-04T21:00:00Z,SAVANNAH GA,6,4,2,2,14
Tropical Storm,Edouard,13,2002-09-04T21:00:00Z,NEW IBERIA LA,0,0,0,5,5
Tropical Storm,Edouard,13,2002-09-04T21:00:00Z,CHARLESTON SC,0,2,2,3,7
Tropical Storm,Edouard,13,2002-09-04T21:00:00Z,PORT ARTHUR TX,0,0,0,2,2
Tropical Storm,Edouard,13,2002-09-04T21:00:00Z,MYRTLE BEACH SC,0,0,1,2,3
Tropical Storm,Edouard,13,2002-09-04T21:00:00Z,GULF 29N 85W,8,8,3,2,21
Tropical Storm,Edouard,13,2002-09-04T21:00:00Z,KEY WEST FL,0,0,1,1,2
Tropical Storm,Edouard,13,2002-09-04T21:00:00Z,GULF 29N 87W,0,3,7,6,16
Tropical Storm,Edouard,13,2002-09-04T21:00:00Z,MARCO ISLAND FL,2,3,0,2,7
Tropical Storm,Edouard,13,2002-09-04T21:00:00Z,GULF 28N 89W,0,0,2,9,11
Tropical Storm,Edouard,13,2002-09-04T21:00:00Z,FT MYERS FL,6,4,1,1,12
Tropical Storm,Edouard,13,2002-09-04T21:00:00Z,GULF 28N 91W,0,0,0,6,6
Tropical Storm,Edouard,13,2002-09-04T21:00:00Z,VENICE FL,13,3,1,1,18
Tropical Storm,Edouard,13,2002-09-04T21:00:00Z,GULF 28N 93W,0,0,0,3,3
Tropical Storm,Edouard,13,2002-09-04T21:00:00Z,TAMPA FL,27,1,0,1,29
Tropical Depression,Edouard,14,2002-09-05T03:00:00Z,28.7N  83.0W,43,0,0,0,43
Tropical Depression,Edouard,14,2002-09-05T03:00:00Z,ST MARKS FL,23,2,1,0,26
Tropical Depression,Edouard,14,2002-09-05T03:00:00Z,28.7N  84.0W,28,1,0,1,30
Tropical Depression,Edouard,14,2002-09-05T03:00:00Z,APALACHICOLA FL,15,5,2,1,23
Tropical Depression,Edouard,14,2002-09-05T03:00:00Z,28.9N  85.0W,15,5,2,1,23
Tropical Depression,Edouard,14,2002-09-05T03:00:00Z,PANAMA CITY FL,7,8,3,3,21
Tropical Depression,Edouard,14,2002-09-05T03:00:00Z,W PALM BEACH FL,0,1,0,1,2
Tropical Depression,Edouard,14,2002-09-05T03:00:00Z,PENSACOLA FL,0,4,6,7,17
Tropical Depression,Edouard,14,2002-09-05T03:00:00Z,FT PIERCE FL,3,1,1,1,6
Tropical Depression,Edouard,14,2002-09-05T03:00:00Z,MOBILE AL,0,1,4,10,15
Tropical Depression,Edouard,14,2002-09-05T03:00:00Z,COCOA BEACH FL,16,0,0,1,17
Tropical Depression,Edouard,14,2002-09-05T03:00:00Z,GULFPORT MS,0,0,3,10,13
Tropical Depression,Edouard,14,2002-09-05T03:00:00Z,DAYTONA BEACH FL,99,0,0,0,99
Tropical Depression,Edouard,14,2002-09-05T03:00:00Z,BURAS LA,0,0,2,10,12
Tropical Depression,Edouard,14,2002-09-05T03:00:00Z,JACKSONVILLE FL,53,0,0,0,53
Tropical Depression,Edouard,14,2002-09-05T03:00:00Z,NEW ORLEANS LA,0,0,1,9,10
Tropical Depression,Edouard,14,2002-09-05T03:00:00Z,SAVANNAH GA,3,4,2,3,12
Tropical Depression,Edouard,14,2002-09-05T03:00:00Z,NEW IBERIA LA,0,0,0,6,6
Tropical Depression,Edouard,14,2002-09-05T03:00:00Z,CHARLESTON SC,0,1,1,3,5
Tropical Depression,Edouard,14,2002-09-05T03:00:00Z,PORT ARTHUR TX,0,0,0,2,2
Tropical Depression,Edouard,14,2002-09-05T03:00:00Z,MYRTLE BEACH SC,0,0,0,2,2
Tropical Depression,Edouard,14,2002-09-05T03:00:00Z,GULF 29N 85W,15,5,2,1,23
Tropical Depression,Edouard,14,2002-09-05T03:00:00Z,MARCO ISLAND FL,2,1,1,1,5
Tropical Depression,Edouard,14,2002-09-05T03:00:00Z,GULF 29N 87W,0,6,6,6,18
Tropical Depression,Edouard,14,2002-09-05T03:00:00Z,FT MYERS FL,6,2,1,1,10
Tropical Depression,Edouard,14,2002-09-05T03:00:00Z,GULF 28N 89W,0,0,3,9,12
Tropical Depression,Edouard,14,2002-09-05T03:00:00Z,VENICE FL,14,2,0,1,17
Tropical Depression,Edouard,14,2002-09-05T03:00:00Z,GULF 28N 91W,0,0,0,7,7
Tropical Depression,Edouard,14,2002-09-05T03:00:00Z,TAMPA FL,31,0,0,0,31
Tropical Depression,Edouard,14,2002-09-05T03:00:00Z,GULF 28N 93W,0,0,0,3,3
Tropical Depression,Edouard,14,2002-09-05T03:00:00Z,CEDAR KEY FL,49,0,0,0,49
Tropical Depression,Edouard,15,2002-09-05T09:00:00Z,28.7N  83.6W,49,0,0,0,49
Tropical Depression,Edouard,15,2002-09-05T09:00:00Z,PANAMA CITY FL,14,6,2,1,23
Tropical Depression,Edouard,15,2002-09-05T09:00:00Z,28.8N  84.8W,26,1,1,0,28
Tropical Depression,Edouard,15,2002-09-05T09:00:00Z,PENSACOLA FL,1,7,6,5,19
Tropical Depression,Edouard,15,2002-09-05T09:00:00Z,29.2N  85.9W,12,7,2,1,22
Tropical Depression,Edouard,15,2002-09-05T09:00:00Z,MOBILE AL,0,2,7,8,17
Tropical Depression,Edouard,15,2002-09-05T09:00:00Z,FT PIERCE FL,2,0,0,1,3
Tropical Depression,Edouard,15,2002-09-05T09:00:00Z,GULFPORT MS,0,1,5,9,15
Tropical Depression,Edouard,15,2002-09-05T09:00:00Z,COCOA BEACH FL,9,1,0,0,10
Tropical Depression,Edouard,15,2002-09-05T09:00:00Z,BURAS LA,0,0,5,9,14
Tropical Depression,Edouard,15,2002-09-05T09:00:00Z,DAYTONA BEACH FL,99,0,0,0,99
Tropical Depression,Edouard,15,2002-09-05T09:00:00Z,NEW ORLEANS LA,0,0,2,10,12
Tropical Depression,Edouard,15,2002-09-05T09:00:00Z,JACKSONVILLE FL,53,1,0,0,54
Tropical Depression,Edouard,15,2002-09-05T09:00:00Z,NEW IBERIA LA,0,0,0,9,9
Tropical Depression,Edouard,15,2002-09-05T09:00:00Z,SAVANNAH GA,1,3,2,3,9
Tropical Depression,Edouard,15,2002-09-05T09:00:00Z,PORT ARTHUR TX,0,0,0,4,4
Tropical Depression,Edouard,15,2002-09-05T09:00:00Z,CHARLESTON SC,0,0,1,2,3
Tropical Depression,Edouard,15,2002-09-05T09:00:00Z,GALVESTON TX,0,0,0,3,3
Tropical Depression,Edouard,15,2002-09-05T09:00:00Z,MARCO ISLAND FL,2,1,0,0,3
Tropical Depression,Edouard,15,2002-09-05T09:00:00Z,FREEPORT TX,0,0,0,2,2
Tropical Depression,Edouard,15,2002-09-05T09:00:00Z,FT MYERS FL,7,1,1,0,9
Tropical Depression,Edouard,15,2002-09-05T09:00:00Z,GULF 29N 85W,24,2,0,1,27
Tropical Depression,Edouard,15,2002-09-05T09:00:00Z,VENICE FL,18,1,0,0,19
Tropical Depression,Edouard,15,2002-09-05T09:00:00Z,GULF 29N 87W,2,10,4,3,19
Tropical Depression,Edouard,15,2002-09-05T09:00:00Z,TAMPA FL,50,0,0,0,50
Tropical Depression,Edouard,15,2002-09-05T09:00:00Z,GULF 28N 89W,0,1,6,6,13
Tropical Depression,Edouard,15,2002-09-05T09:00:00Z,CEDAR KEY FL,99,0,0,0,99
Tropical Depression,Edouard,15,2002-09-05T09:00:00Z,GULF 28N 91W,0,0,1,8,9
Tropical Depression,Edouard,15,2002-09-05T09:00:00Z,ST MARKS FL,34,1,0,0,35
Tropical Depression,Edouard,15,2002-09-05T09:00:00Z,GULF 28N 93W,0,0,0,5,5
Tropical Depression,Edouard,15,2002-09-05T09:00:00Z,APALACHICOLA FL,23,2,1,1,27
Tropical Depression,Edouard,15,2002-09-05T09:00:00Z,GULF 28N 95W,0,0,0,2,2
Tropical Depression,Edouard,16,2002-09-05T15:00:00Z,28.5N  85.3W,42,0,0,0,42
Tropical Depression,Edouard,16,2002-09-05T15:00:00Z,NEW ORLEANS LA,0,2,8,7,17
Tropical Depression,Edouard,16,2002-09-05T15:00:00Z,28.6N  86.4W,27,1,0,0,28
Tropical Depression,Edouard,16,2002-09-05T15:00:00Z,NEW IBERIA LA,0,0,4,10,14
Tropical Depression,Edouard,16,2002-09-05T15:00:00Z,29.0N  88.0W,6,10,3,2,21
Tropical Depression,Edouard,16,2002-09-05T15:00:00Z,PORT ARTHUR TX,0,0,0,9,9
Tropical Depression,Edouard,16,2002-09-05T15:00:00Z,JACKSONVILLE FL,4,1,0,1,6
Tropical Depression,Edouard,16,2002-09-05T15:00:00Z,GALVESTON TX,0,0,0,7,7
Tropical Depression,Edouard,16,2002-09-05T15:00:00Z,SAVANNAH GA,0,0,1,1,2
Tropical Depression,Edouard,16,2002-09-05T15:00:00Z,FREEPORT TX,0,0,0,6,6
Tropical Depression,Edouard,16,2002-09-05T15:00:00Z,VENICE FL,3,1,0,0,4
Tropical Depression,Edouard,16,2002-09-05T15:00:00Z,PORT O CONNOR TX,0,0,0,4,4
Tropical Depression,Edouard,16,2002-09-05T15:00:00Z,TAMPA FL,99,0,0,0,99
Tropical Depression,Edouard,16,2002-09-05T15:00:00Z,CORPUSCHRISTI TX,0,0,0,2,2
Tropical Depression,Edouard,16,2002-09-05T15:00:00Z,CEDAR KEY FL,99,0,0,0,99
Tropical Depression,Edouard,16,2002-09-05T15:00:00Z,GULF 29N 85W,50,0,0,0,50
Tropical Depression,Edouard,16,2002-09-05T15:00:00Z,ST MARKS FL,35,0,0,0,35
Tropical Depression,Edouard,16,2002-09-05T15:00:00Z,GULF 29N 87W,19,4,1,1,25
Tropical Depression,Edouard,16,2002-09-05T15:00:00Z,APALACHICOLA FL,41,0,0,0,41
Tropical Depression,Edouard,16,2002-09-05T15:00:00Z,GULF 28N 89W,1,8,6,2,17
Tropical Depression,Edouard,16,2002-09-05T15:00:00Z,PANAMA CITY FL,30,1,0,0,31
Tropical Depression,Edouard,16,2002-09-05T15:00:00Z,GULF 28N 91W,0,1,6,7,14
Tropical Depression,Edouard,16,2002-09-05T15:00:00Z,PENSACOLA FL,8,9,3,1,21
Tropical Depression,Edouard,16,2002-09-05T15:00:00Z,GULF 28N 93W,0,0,1,9,10
Tropical Depression,Edouard,16,2002-09-05T15:00:00Z,MOBILE AL,1,9,7,3,20
Tropical Depression,Edouard,16,2002-09-05T15:00:00Z,GULF 28N 95W,0,0,0,6,6
Tropical Depression,Edouard,16,2002-09-05T15:00:00Z,GULFPORT MS,0,6,9,4,19
Tropical Depression,Edouard,16,2002-09-05T15:00:00Z,GULF 27N 96W,0,0,0,3,3
Tropical Depression,Edouard,16,2002-09-05T15:00:00Z,BURAS LA,0,5,9,4,18
Tropical Depression,Edouard,17,2002-09-05T21:00:00Z,28.7N  86.5W,50,0,0,0,50
Tropical Depression,Edouard,17,2002-09-05T21:00:00Z,BURAS LA,10,12,2,1,25
Tropical Depression,Edouard,17,2002-09-05T21:00:00Z,29.0N  88.0W,26,2,0,1,29
Tropical Depression,Edouard,17,2002-09-05T21:00:00Z,NEW ORLEANS LA,3,15,4,1,23
Tropical Depression,Edouard,17,2002-09-05T21:00:00Z,30.0N  89.5W,8,14,2,1,25
Tropical Depression,Edouard,17,2002-09-05T21:00:00Z,NEW IBERIA LA,0,10,8,2,20
Tropical Depression,Edouard,17,2002-09-05T21:00:00Z,DAYTONA BEACH FL,0,1,0,1,2
Tropical Depression,Edouard,17,2002-09-05T21:00:00Z,PORT ARTHUR TX,0,2,8,5,15
Tropical Depression,Edouard,17,2002-09-05T21:00:00Z,JACKSONVILLE FL,1,1,0,2,4
Tropical Depression,Edouard,17,2002-09-05T21:00:00Z,GALVESTON TX,0,1,5,6,12
Tropical Depression,Edouard,17,2002-09-05T21:00:00Z,SAVANNAH GA,0,0,0,2,2
Tropical Depression,Edouard,17,2002-09-05T21:00:00Z,FREEPORT TX,0,0,4,6,10
Tropical Depression,Edouard,17,2002-09-05T21:00:00Z,FT MYERS FL,0,1,0,1,2
Tropical Depression,Edouard,17,2002-09-05T21:00:00Z,PORT O CONNOR TX,0,0,1,5,6
Tropical Depression,Edouard,17,2002-09-05T21:00:00Z,VENICE FL,3,1,0,1,5
Tropical Depression,Edouard,17,2002-09-05T21:00:00Z,CORPUSCHRISTI TX,0,0,0,4,4
Tropical Depression,Edouard,17,2002-09-05T21:00:00Z,TAMPA FL,21,0,0,0,21
Tropical Depression,Edouard,17,2002-09-05T21:00:00Z,GULF 29N 85W,80,0,0,0,80
Tropical Depression,Edouard,17,2002-09-05T21:00:00Z,CEDAR KEY FL,99,0,0,0,99
Tropical Depression,Edouard,17,2002-09-05T21:00:00Z,GULF 29N 87W,40,0,0,0,40
Tropical Depression,Edouard,17,2002-09-05T21:00:00Z,ST MARKS FL,30,0,0,0,30
Tropical Depression,Edouard,17,2002-09-05T21:00:00Z,GULF 28N 89W,15,6,1,1,23
Tropical Depression,Edouard,17,2002-09-05T21:00:00Z,APALACHICOLA FL,52,0,0,0,52
Tropical Depression,Edouard,17,2002-09-05T21:00:00Z,GULF 28N 91W,2,10,3,2,17
Tropical Depression,Edouard,17,2002-09-05T21:00:00Z,PANAMA CITY FL,33,0,1,0,34
Tropical Depression,Edouard,17,2002-09-05T21:00:00Z,GULF 28N 93W,0,4,5,4,13
Tropical Depression,Edouard,17,2002-09-05T21:00:00Z,PENSACOLA FL,18,4,1,1,24
Tropical Depression,Edouard,17,2002-09-05T21:00:00Z,GULF 28N 95W,0,0,3,5,8
Tropical Depression,Edouard,17,2002-09-05T21:00:00Z,MOBILE AL,11,9,3,1,24
Tropical Depression,Edouard,17,2002-09-05T21:00:00Z,GULF 27N 96W,0,0,1,3,4
Tropical Depression,Edouard,17,2002-09-05T21:00:00Z,GULFPORT MS,8,13,2,2,25
Tropical Depression,Edouard,18,2002-09-06T03:00:00Z,28.5N  87.0W,42,0,0,0,42
Tropical Depression,Edouard,18,2002-09-06T03:00:00Z,BURAS LA,15,10,1,1,27
Tropical Depression,Edouard,18,2002-09-06T03:00:00Z,29.0N  88.5W,26,3,1,0,30
Tropical Depression,Edouard,18,2002-09-06T03:00:00Z,NEW ORLEANS LA,6,15,2,1,24
Tropical Depression,Edouard,18,2002-09-06T03:00:00Z,30.0N  89.5W,12,12,1,1,26
Tropical Depression,Edouard,18,2002-09-06T03:00:00Z,NEW IBERIA LA,1,12,4,3,20
Tropical Depression,Edouard,18,2002-09-06T03:00:00Z,DAYTONA BEACH FL,0,0,1,1,2
Tropical Depression,Edouard,18,2002-09-06T03:00:00Z,PORT ARTHUR TX,0,3,6,5,14
Tropical Depression,Edouard,18,2002-09-06T03:00:00Z,JACKSONVILLE FL,0,0,1,3,4
Tropical Depression,Edouard,18,2002-09-06T03:00:00Z,GALVESTON TX,0,1,5,5,11
Tropical Depression,Edouard,18,2002-09-06T03:00:00Z,SAVANNAH GA,0,0,0,3,3
Tropical Depression,Edouard,18,2002-09-06T03:00:00Z,FREEPORT TX,0,0,3,6,9
Tropical Depression,Edouard,18,2002-09-06T03:00:00Z,VENICE FL,1,0,1,0,2
Tropical Depression,Edouard,18,2002-09-06T03:00:00Z,PORT O CONNOR TX,0,0,1,5,6
Tropical Depression,Edouard,18,2002-09-06T03:00:00Z,TAMPA FL,3,1,1,1,6
Tropical Depression,Edouard,18,2002-09-06T03:00:00Z,CORPUSCHRISTI TX,0,0,0,3,3
Tropical Depression,Edouard,18,2002-09-06T03:00:00Z,CEDAR KEY FL,64,0,0,0,64
Tropical Depression,Edouard,18,2002-09-06T03:00:00Z,GULF 29N 85W,99,0,0,0,99
Tropical Depression,Edouard,18,2002-09-06T03:00:00Z,ST MARKS FL,24,0,1,0,25
Tropical Depression,Edouard,18,2002-09-06T03:00:00Z,GULF 29N 87W,41,0,0,0,41
Tropical Depression,Edouard,18,2002-09-06T03:00:00Z,APALACHICOLA FL,48,0,0,0,48
Tropical Depression,Edouard,18,2002-09-06T03:00:00Z,GULF 28N 89W,20,4,0,1,25
Tropical Depression,Edouard,18,2002-09-06T03:00:00Z,PANAMA CITY FL,33,0,1,0,34
Tropical Depression,Edouard,18,2002-09-06T03:00:00Z,GULF 28N 91W,3,11,2,2,18
Tropical Depression,Edouard,18,2002-09-06T03:00:00Z,PENSACOLA FL,19,3,1,1,24
Tropical Depression,Edouard,18,2002-09-06T03:00:00Z,GULF 28N 93W,0,4,4,4,12
Tropical Depression,Edouard,18,2002-09-06T03:00:00Z,MOBILE AL,14,7,2,1,24
Tropical Depression,Edouard,18,2002-09-06T03:00:00Z,GULF 28N 95W,0,0,3,4,7
Tropical Depression,Edouard,18,2002-09-06T03:00:00Z,GULFPORT MS,12,10,2,1,25
Tropical Depression,Edouard,18,2002-09-06T03:00:00Z,GULF 27N 96W,0,0,0,3,3
Tropical Depression,Edouard,19,2002-09-06T09:00:00Z,28.7N  87.9W,43,0,0,0,43
Tropical Depression,Edouard,19,2002-09-06T09:00:00Z,NEW ORLEANS LA,14,11,1,0,26
Tropical Depression,Edouard,19,2002-09-06T09:00:00Z,29.6N  89.1W,25,4,0,0,29
Tropical Depression,Edouard,19,2002-09-06T09:00:00Z,NEW IBERIA LA,4,13,3,0,20
Tropical Depression,Edouard,19,2002-09-06T09:00:00Z,30.7N  90.0W,10,13,2,0,25
Tropical Depression,Edouard,19,2002-09-06T09:00:00Z,PORT ARTHUR TX,0,6,5,0,11
Tropical Depression,Edouard,19,2002-09-06T09:00:00Z,TAMPA FL,1,0,1,0,2
Tropical Depression,Edouard,19,2002-09-06T09:00:00Z,GALVESTON TX,0,2,5,0,7
Tropical Depression,Edouard,19,2002-09-06T09:00:00Z,CEDAR KEY FL,2,1,1,0,4
Tropical Depression,Edouard,19,2002-09-06T09:00:00Z,FREEPORT TX,0,1,3,0,4
Tropical Depression,Edouard,19,2002-09-06T09:00:00Z,ST MARKS FL,6,3,1,0,10
Tropical Depression,Edouard,19,2002-09-06T09:00:00Z,GULF 29N 85W,99,0,0,0,99
Tropical Depression,Edouard,19,2002-09-06T09:00:00Z,APALACHICOLA FL,46,0,0,0,46
Tropical Depression,Edouard,19,2002-09-06T09:00:00Z,GULF 29N 87W,53,0,0,0,53
Tropical Depression,Edouard,19,2002-09-06T09:00:00Z,PANAMA CITY FL,31,0,0,0,31
Tropical Depression,Edouard,19,2002-09-06T09:00:00Z,GULF 28N 89W,27,1,0,0,28
Tropical Depression,Edouard,19,2002-09-06T09:00:00Z,PENSACOLA FL,20,2,1,0,23
Tropical Depression,Edouard,19,2002-09-06T09:00:00Z,GULF 28N 91W,10,6,1,0,17
Tropical Depression,Edouard,19,2002-09-06T09:00:00Z,MOBILE AL,16,7,2,0,25
Tropical Depression,Edouard,19,2002-09-06T09:00:00Z,GULF 28N 93W,1,5,3,0,9
Tropical Depression,Edouard,19,2002-09-06T09:00:00Z,GULFPORT MS,17,9,1,0,27
Tropical Depression,Edouard,19,2002-09-06T09:00:00Z,GULF 28N 95W,0,1,1,0,2
Tropical Depression,Edouard,19,2002-09-06T09:00:00Z,BURAS LA,23,5,0,0,28
Tropical Depression,Six,1,2002-09-05T21:00:00Z,28.9N  94.3W,99,0,0,0,99
Tropical Depression,Six,1,2002-09-05T21:00:00Z,FREEPORT TX,36,0,0,1,37
Tropical Depression,Six,1,2002-09-05T21:00:00Z,29.4N  94.8W,46,1,0,0,47
Tropical Depression,Six,1,2002-09-05T21:00:00Z,PORT O CONNOR TX,13,5,2,1,21
Tropical Depression,Six,1,2002-09-05T21:00:00Z,30.0N  95.5W,28,2,0,1,31
Tropical Depression,Six,1,2002-09-05T21:00:00Z,CORPUSCHRISTI TX,2,5,4,4,15
Tropical Depression,Six,1,2002-09-05T21:00:00Z,MMSO 238N 982W,0,0,0,2,2
Tropical Depression,Six,1,2002-09-05T21:00:00Z,BROWNSVILLE TX,0,2,3,4,9
Tropical Depression,Six,1,2002-09-05T21:00:00Z,MOBILE AL,0,0,0,3,3
Tropical Depression,Six,1,2002-09-05T21:00:00Z,GULF 28N 89W,0,0,0,3,3
Tropical Depression,Six,1,2002-09-05T21:00:00Z,GULFPORT MS,0,0,0,4,4
Tropical Depression,Six,1,2002-09-05T21:00:00Z,GULF 28N 91W,2,1,2,3,8
Tropical Depression,Six,1,2002-09-05T21:00:00Z,BURAS LA,0,0,1,4,5
Tropical Depression,Six,1,2002-09-05T21:00:00Z,GULF 28N 93W,99,0,0,0,99
Tropical Depression,Six,1,2002-09-05T21:00:00Z,NEW ORLEANS LA,0,1,1,5,7
Tropical Depression,Six,1,2002-09-05T21:00:00Z,GULF 28N 95W,34,1,0,0,35
Tropical Depression,Six,1,2002-09-05T21:00:00Z,NEW IBERIA LA,9,3,2,2,16
Tropical Depression,Six,1,2002-09-05T21:00:00Z,GULF 27N 96W,9,5,2,1,17
Tropical Depression,Six,1,2002-09-05T21:00:00Z,PORT ARTHUR TX,41,0,1,0,42
Tropical Depression,Six,1,2002-09-05T21:00:00Z,GULF 25N 96W,0,3,1,4,8
Tropical Depression,Six,1,2002-09-05T21:00:00Z,GALVESTON TX,49,0,0,0,49
Tropical Storm,Fay,2,2002-09-06T03:00:00Z,28.8N  94.2W,51,0,0,0,51
Tropical Storm,Fay,2,2002-09-06T03:00:00Z,GALVESTON TX,40,0,0,0,40
Tropical Storm,Fay,2,2002-09-06T03:00:00Z,29.5N  95.0W,35,0,1,0,36
Tropical Storm,Fay,2,2002-09-06T03:00:00Z,FREEPORT TX,32,1,0,0,33
Tropical Storm,Fay,2,2002-09-06T03:00:00Z,30.0N  95.5W,25,3,1,0,29
Tropical Storm,Fay,2,2002-09-06T03:00:00Z,PORT O CONNOR TX,17,3,1,1,22
Tropical Storm,Fay,2,2002-09-06T03:00:00Z,MMSO 238N 982W,0,0,0,2,2
Tropical Storm,Fay,2,2002-09-06T03:00:00Z,CORPUSCHRISTI TX,4,6,2,3,15
Tropical Storm,Fay,2,2002-09-06T03:00:00Z,PENSACOLA FL,0,0,1,2,3
Tropical Storm,Fay,2,2002-09-06T03:00:00Z,BROWNSVILLE TX,0,0,1,5,6
Tropical Storm,Fay,2,2002-09-06T03:00:00Z,MOBILE AL,0,1,2,2,5
Tropical Storm,Fay,2,2002-09-06T03:00:00Z,GULF 28N 89W,0,1,0,2,3
Tropical Storm,Fay,2,2002-09-06T03:00:00Z,GULFPORT MS,0,3,3,2,8
Tropical Storm,Fay,2,2002-09-06T03:00:00Z,GULF 28N 91W,10,2,0,1,13
Tropical Storm,Fay,2,2002-09-06T03:00:00Z,BURAS LA,1,4,2,2,9
Tropical Storm,Fay,2,2002-09-06T03:00:00Z,GULF 28N 93W,99,0,0,0,99
Tropical Storm,Fay,2,2002-09-06T03:00:00Z,NEW ORLEANS LA,3,6,2,2,13
Tropical Storm,Fay,2,2002-09-06T03:00:00Z,GULF 28N 95W,33,0,0,0,33
Tropical Storm,Fay,2,2002-09-06T03:00:00Z,NEW IBERIA LA,18,2,2,0,22
Tropical Storm,Fay,2,2002-09-06T03:00:00Z,GULF 27N 96W,7,2,2,2,13
Tropical Storm,Fay,2,2002-09-06T03:00:00Z,PORT ARTHUR TX,34,0,1,0,35
Tropical Storm,Fay,2,2002-09-06T03:00:00Z,GULF 25N 96W,0,0,0,3,3
Tropical Storm,Fay,3,2002-09-06T09:00:00Z,28.7N  95.4W,57,0,0,0,57
Tropical Storm,Fay,3,2002-09-06T09:00:00Z,FREEPORT TX,53,0,0,0,53
Tropical Storm,Fay,3,2002-09-06T09:00:00Z,29.3N  96.2W,37,1,0,0,38
Tropical Storm,Fay,3,2002-09-06T09:00:00Z,PORT O CONNOR TX,34,0,0,1,35
Tropical Storm,Fay,3,2002-09-06T09:00:00Z,29.9N  97.2W,24,3,1,1,29
Tropical Storm,Fay,3,2002-09-06T09:00:00Z,CORPUSCHRISTI TX,12,3,2,2,19
Tropical Storm,Fay,3,2002-09-06T09:00:00Z,MMSO 238N 982W,0,0,0,2,2
Tropical Storm,Fay,3,2002-09-06T09:00:00Z,BROWNSVILLE TX,1,1,2,4,8
Tropical Storm,Fay,3,2002-09-06T09:00:00Z,GULFPORT MS,0,0,0,2,2
Tropical Storm,Fay,3,2002-09-06T09:00:00Z,GULF 28N 89W,0,0,0,2,2
Tropical Storm,Fay,3,2002-09-06T09:00:00Z,BURAS LA,0,0,0,3,3
Tropical Storm,Fay,3,2002-09-06T09:00:00Z,GULF 28N 91W,1,1,2,2,6
Tropical Storm,Fay,3,2002-09-06T09:00:00Z,NEW ORLEANS LA,0,0,1,3,4
Tropical Storm,Fay,3,2002-09-06T09:00:00Z,GULF 28N 93W,73,0,0,0,73
Tropical Storm,Fay,3,2002-09-06T09:00:00Z,NEW IBERIA LA,2,2,2,3,9
Tropical Storm,Fay,3,2002-09-06T09:00:00Z,GULF 28N 95W,99,0,0,0,99
Tropical Storm,Fay,3,2002-09-06T09:00:00Z,PORT ARTHUR TX,22,1,1,1,25
Tropical Storm,Fay,3,2002-09-06T09:00:00Z,GULF 27N 96W,21,1,1,0,23
Tropical Storm,Fay,3,2002-09-06T09:00:00Z,GALVESTON TX,47,0,0,0,47
Tropical Storm,Fay,3,2002-09-06T09:00:00Z,GULF 25N 96W,0,1,2,3,6
Tropical Storm,Fay,4,2002-09-06T15:00:00Z,28.7N  96.0W,67,0,0,0,67
Tropical Storm,Fay,4,2002-09-06T15:00:00Z,FREEPORT TX,70,0,0,0,70
Tropical Storm,Fay,4,2002-09-06T15:00:00Z,29.3N  97.0W,34,0,1,0,35
Tropical Storm,Fay,4,2002-09-06T15:00:00Z,PORT O CONNOR TX,52,0,0,0,52
Tropical Storm,Fay,4,2002-09-06T15:00:00Z,29.7N  98.0W,20,5,1,1,27
Tropical Storm,Fay,4,2002-09-06T15:00:00Z,CORPUSCHRISTI TX,16,3,1,2,22
Tropical Storm,Fay,4,2002-09-06T15:00:00Z,MMSO 238N 982W,0,0,0,3,3
Tropical Storm,Fay,4,2002-09-06T15:00:00Z,BROWNSVILLE TX,1,2,3,4,10
Tropical Storm,Fay,4,2002-09-06T15:00:00Z,BURAS LA,0,0,0,2,2
Tropical Storm,Fay,4,2002-09-06T15:00:00Z,GULF 28N 91W,0,1,1,2,4
Tropical Storm,Fay,4,2002-09-06T15:00:00Z,NEW ORLEANS LA,0,0,0,2,2
Tropical Storm,Fay,4,2002-09-06T15:00:00Z,GULF 28N 93W,10,3,1,1,15
Tropical Storm,Fay,4,2002-09-06T15:00:00Z,NEW IBERIA LA,1,1,2,3,7
Tropical Storm,Fay,4,2002-09-06T15:00:00Z,GULF 28N 95W,99,0,0,0,99
Tropical Storm,Fay,4,2002-09-06T15:00:00Z,PORT ARTHUR TX,13,3,1,1,18
Tropical Storm,Fay,4,2002-09-06T15:00:00Z,GULF 27N 96W,19,1,1,1,22
Tropical Storm,Fay,4,2002-09-06T15:00:00Z,GALVESTON TX,50,0,0,0,50
Tropical Storm,Fay,4,2002-09-06T15:00:00Z,GULF 25N 96W,0,1,2,3,6
Tropical Storm,Fay,5,2002-09-06T21:00:00Z,28.6N  96.5W,46,0,0,0,46
Tropical Storm,Fay,5,2002-09-06T21:00:00Z,PORT O CONNOR TX,50,0,0,0,50
Tropical Storm,Fay,5,2002-09-06T21:00:00Z,29.0N  97.6W,28,1,1,0,30
Tropical Storm,Fay,5,2002-09-06T21:00:00Z,CORPUSCHRISTI TX,27,1,1,0,29
Tropical Storm,Fay,5,2002-09-06T21:00:00Z,29.4N  98.6W,18,6,2,1,27
Tropical Storm,Fay,5,2002-09-06T21:00:00Z,BROWNSVILLE TX,7,1,2,3,13
Tropical Storm,Fay,5,2002-09-06T21:00:00Z,MMSO 238N 982W,0,0,0,3,3
Tropical Storm,Fay,5,2002-09-06T21:00:00Z,GULF 28N 91W,0,1,1,1,3
Tropical Storm,Fay,5,2002-09-06T21:00:00Z,NEW ORLEANS LA,0,0,0,2,2
Tropical Storm,Fay,5,2002-09-06T21:00:00Z,GULF 28N 93W,11,1,1,1,14
Tropical Storm,Fay,5,2002-09-06T21:00:00Z,NEW IBERIA LA,1,1,1,3,6
Tropical Storm,Fay,5,2002-09-06T21:00:00Z,GULF 28N 95W,99,0,0,0,99
Tropical Storm,Fay,5,2002-09-06T21:00:00Z,PORT ARTHUR TX,12,2,1,1,16
Tropical Storm,Fay,5,2002-09-06T21:00:00Z,GULF 27N 96W,45,0,0,0,45
Tropical Storm,Fay,5,2002-09-06T21:00:00Z,GALVESTON TX,37,0,0,0,37
Tropical Storm,Fay,5,2002-09-06T21:00:00Z,GULF 25N 96W,2,1,1,3,7
Tropical Storm,Fay,5,2002-09-06T21:00:00Z,FREEPORT TX,52,0,0,0,52
Tropical Storm,Fay,6,2002-09-07T03:00:00Z,28.5N  96.5W,57,0,0,0,57
Tropical Storm,Fay,6,2002-09-07T03:00:00Z,PORT O CONNOR TX,61,0,0,0,61
Tropical Storm,Fay,6,2002-09-07T03:00:00Z,29.0N  97.5W,37,0,0,1,38
Tropical Storm,Fay,6,2002-09-07T03:00:00Z,CORPUSCHRISTI TX,31,1,0,0,32
Tropical Storm,Fay,6,2002-09-07T03:00:00Z,29.5N  99.0W,17,9,1,1,28
Tropical Storm,Fay,6,2002-09-07T03:00:00Z,BROWNSVILLE TX,2,3,2,4,11
Tropical Storm,Fay,6,2002-09-07T03:00:00Z,MMSO 238N 982W,0,0,0,3,3
Tropical Storm,Fay,6,2002-09-07T03:00:00Z,GULF 28N 91W,0,0,1,1,2
Tropical Storm,Fay,6,2002-09-07T03:00:00Z,NEW IBERIA LA,0,1,0,2,3
Tropical Storm,Fay,6,2002-09-07T03:00:00Z,GULF 28N 93W,9,2,0,1,12
Tropical Storm,Fay,6,2002-09-07T03:00:00Z,PORT ARTHUR TX,6,3,2,1,12
Tropical Storm,Fay,6,2002-09-07T03:00:00Z,GULF 28N 95W,99,0,0,0,99
Tropical Storm,Fay,6,2002-09-07T03:00:00Z,GALVESTON TX,24,0,1,0,25
Tropical Storm,Fay,6,2002-09-07T03:00:00Z,GULF 27N 96W,24,1,0,0,25
Tropical Storm,Fay,6,2002-09-07T03:00:00Z,FREEPORT TX,42,0,0,0,42
Tropical Storm,Fay,6,2002-09-07T03:00:00Z,GULF 25N 96W,0,1,1,3,5
Tropical Storm,Fay,7,2002-09-07T09:00:00Z,28.6N  97.1W,51,0,0,0,51
Tropical Storm,Fay,7,2002-09-07T09:00:00Z,FREEPORT TX,99,0,0,0,99
Tropical Storm,Fay,7,2002-09-07T09:00:00Z,28.9N  98.0W,32,1,0,0,33
Tropical Storm,Fay,7,2002-09-07T09:00:00Z,PORT O CONNOR TX,99,0,0,0,99
Tropical Storm,Fay,7,2002-09-07T09:00:00Z,29.0N  99.0W,21,3,1,1,26
Tropical Storm,Fay,7,2002-09-07T09:00:00Z,CORPUSCHRISTI TX,39,0,0,0,39
Tropical Storm,Fay,7,2002-09-07T09:00:00Z,MMSO 238N 982W,0,0,0,4,4
Tropical Storm,Fay,7,2002-09-07T09:00:00Z,BROWNSVILLE TX,7,2,2,2,13
Tropical Storm,Fay,7,2002-09-07T09:00:00Z,MMTM 222N 979W,0,0,0,2,2
Tropical Storm,Fay,7,2002-09-07T09:00:00Z,GULF 28N 91W,0,0,1,2,3
Tropical Storm,Fay,7,2002-09-07T09:00:00Z,NEW ORLEANS LA,0,0,0,2,2
Tropical Storm,Fay,7,2002-09-07T09:00:00Z,GULF 28N 93W,4,2,1,3,10
Tropical Storm,Fay,7,2002-09-07T09:00:00Z,NEW IBERIA LA,0,1,1,2,4
Tropical Storm,Fay,7,2002-09-07T09:00:00Z,GULF 28N 95W,99,0,0,0,99
Tropical Storm,Fay,7,2002-09-07T09:00:00Z,PORT ARTHUR TX,6,3,2,2,13
Tropical Storm,Fay,7,2002-09-07T09:00:00Z,GULF 27N 96W,45,0,0,0,45
Tropical Storm,Fay,7,2002-09-07T09:00:00Z,GALVESTON TX,33,0,0,1,34
Tropical Storm,Fay,7,2002-09-07T09:00:00Z,GULF 25N 96W,1,1,1,4,7
Tropical Depression,Seven,1,2002-09-07T15:00:00Z,26.0N  51.0W,40,1,0,0,41
Tropical Depression,Seven,1,2002-09-07T15:00:00Z,28.0N  54.0W,1,15,4,2,22
Tropical Depression,Seven,1,2002-09-07T15:00:00Z,27.0N  52.5W,16,8,1,1,26
Tropical Depression,Seven,1,2002-09-07T15:00:00Z,BERMUDA,0,0,0,2,2
Tropical Depression,Seven,2,2002-09-07T21:00:00Z,25.3N  51.3W,38,0,0,0,38
Tropical Depression,Seven,2,2002-09-07T21:00:00Z,26.5N  54.5W,2,15,3,2,22
Tropical Depression,Seven,2,2002-09-07T21:00:00Z,25.8N  53.0W,18,5,1,1,25
Tropical Depression,Seven,2,2002-09-07T21:00:00Z,BERMUDA,0,0,0,2,2
Tropical Depression,Seven,3,2002-09-08T03:00:00Z,24.9N  52.0W,42,0,0,0,42
Tropical Depression,Seven,3,2002-09-08T03:00:00Z,26.3N  55.2W,4,14,3,2,23
Tropical Depression,Seven,3,2002-09-08T03:00:00Z,25.6N  53.7W,21,4,1,0,26
Tropical Depression,Seven,3,2002-09-08T03:00:00Z,BERMUDA,0,0,0,2,2
Tropical Depression,Seven,4,2002-09-08T09:00:00Z,25.4N  53.3W,41,0,0,0,41
Tropical Depression,Seven,4,2002-09-08T09:00:00Z,26.2N  55.4W,15,5,2,2,24
Tropical Depression,Seven,4,2002-09-08T09:00:00Z,25.7N  54.4W,26,1,1,0,28
Subtropical Depression,Eight,1,2002-09-08T15:00:00Z,31.7N  72.7W,40,1,0,0,41
Subtropical Depression,Eight,1,2002-09-08T15:00:00Z,MOREHEAD CITY NC,0,10,4,2,16
Subtropical Depression,Eight,1,2002-09-08T15:00:00Z,32.5N  74.0W,26,1,0,1,28
Subtropical Depression,Eight,1,2002-09-08T15:00:00Z,CAPE HATTERAS NC,1,8,4,3,16
Subtropical Depression,Eight,1,2002-09-08T15:00:00Z,33.0N  75.5W,8,10,1,2,21
Subtropical Depression,Eight,1,2002-09-08T15:00:00Z,NORFOLK VA,0,3,4,5,12
Subtropical Depression,Eight,1,2002-09-08T15:00:00Z,BERMUDA,0,0,0,4,4
Subtropical Depression,Eight,1,2002-09-08T15:00:00Z,OCEAN CITY MD,0,1,1,6,8
Subtropical Depression,Eight,1,2002-09-08T15:00:00Z,DAYTONA BEACH FL,0,0,1,1,2
Subtropical Depression,Eight,1,2002-09-08T15:00:00Z,ATLANTIC CITY NJ,0,0,1,5,6
Subtropical Depression,Eight,1,2002-09-08T15:00:00Z,JACKSONVILLE FL,0,0,2,1,3
Subtropical Depression,Eight,1,2002-09-08T15:00:00Z,NEW YORK CITY NY,0,0,0,4,4
Subtropical Depression,Eight,1,2002-09-08T15:00:00Z,SAVANNAH GA,0,1,3,3,7
Subtropical Depression,Eight,1,2002-09-08T15:00:00Z,MONTAUK POINT NY,0,0,0,3,3
Subtropical Depression,Eight,1,2002-09-08T15:00:00Z,CHARLESTON SC,0,2,6,3,11
Subtropical Depression,Eight,1,2002-09-08T15:00:00Z,PROVIDENCE RI,0,0,0,2,2
Subtropical Depression,Eight,1,2002-09-08T15:00:00Z,MYRTLE BEACH SC,0,5,6,3,14
Subtropical Depression,Eight,1,2002-09-08T15:00:00Z,NANTUCKET MA,0,0,0,2,2
Subtropical Depression,Eight,1,2002-09-08T15:00:00Z,WILMINGTON NC,0,7,6,2,15
Subtropical Depression,Eight,1,2002-09-08T15:00:00Z,HYANNIS MA,0,0,0,2,2
Tropical Storm,Gustav,2,2002-09-08T21:00:00Z,33.2N  74.2W,44,0,0,0,44
Tropical Storm,Gustav,2,2002-09-08T21:00:00Z,OCEAN CITY MD,0,0,3,9,12
Tropical Storm,Gustav,2,2002-09-08T21:00:00Z,33.7N  75.7W,28,2,0,0,30
Tropical Storm,Gustav,2,2002-09-08T21:00:00Z,ATLANTIC CITY NJ,0,0,1,10,11
Tropical Storm,Gustav,2,2002-09-08T21:00:00Z,34.8N  75.4W,15,6,1,1,23
Tropical Storm,Gustav,2,2002-09-08T21:00:00Z,NEW YORK CITY NY,0,0,0,9,9
Tropical Storm,Gustav,2,2002-09-08T21:00:00Z,BERMUDA,0,0,0,6,6
Tropical Storm,Gustav,2,2002-09-08T21:00:00Z,MONTAUK POINT NY,0,0,0,9,9
Tropical Storm,Gustav,2,2002-09-08T21:00:00Z,JACKSONVILLE FL,0,0,1,1,2
Tropical Storm,Gustav,2,2002-09-08T21:00:00Z,PROVIDENCE RI,0,0,0,7,7
Tropical Storm,Gustav,2,2002-09-08T21:00:00Z,SAVANNAH GA,0,2,3,1,6
Tropical Storm,Gustav,2,2002-09-08T21:00:00Z,NANTUCKET MA,0,0,0,8,8
Tropical Storm,Gustav,2,2002-09-08T21:00:00Z,CHARLESTON SC,0,7,4,1,12
Tropical Storm,Gustav,2,2002-09-08T21:00:00Z,HYANNIS MA,0,0,0,7,7
Tropical Storm,Gustav,2,2002-09-08T21:00:00Z,MYRTLE BEACH SC,1,12,3,1,17
Tropical Storm,Gustav,2,2002-09-08T21:00:00Z,BOSTON MA,0,0,0,6,6
Tropical Storm,Gustav,2,2002-09-08T21:00:00Z,WILMINGTON NC,3,14,2,1,20
Tropical Storm,Gustav,2,2002-09-08T21:00:00Z,PORTLAND ME,0,0,0,4,4
Tropical Storm,Gustav,2,2002-09-08T21:00:00Z,MOREHEAD CITY NC,8,11,2,1,22
Tropical Storm,Gustav,2,2002-09-08T21:00:00Z,BAR HARBOR ME,0,0,0,2,2
Tropical Storm,Gustav,2,2002-09-08T21:00:00Z,CAPE HATTERAS NC,7,9,2,2,20
Tropical Storm,Gustav,2,2002-09-08T21:00:00Z,YARMOUTH NS,0,0,0,2,2
Tropical Storm,Gustav,2,2002-09-08T21:00:00Z,NORFOLK VA,0,4,5,5,14
Tropical Storm,Gustav,3,2002-09-09T03:00:00Z,33.0N  75.7W,66,0,0,0,66
Tropical Storm,Gustav,3,2002-09-09T03:00:00Z,OCEAN CITY MD,0,1,5,7,13
Tropical Storm,Gustav,3,2002-09-09T03:00:00Z,34.4N  76.0W,32,2,0,0,34
Tropical Storm,Gustav,3,2002-09-09T03:00:00Z,ATLANTIC CITY NJ,0,0,2,8,10
Tropical Storm,Gustav,3,2002-09-09T03:00:00Z,35.7N  74.9W,4,12,3,1,20
Tropical Storm,Gustav,3,2002-09-09T03:00:00Z,NEW YORK CITY NY,0,0,0,8,8
Tropical Storm,Gustav,3,2002-09-09T03:00:00Z,BERMUDA,0,0,0,2,2
Tropical Storm,Gustav,3,2002-09-09T03:00:00Z,MONTAUK POINT NY,0,0,0,7,7
Tropical Storm,Gustav,3,2002-09-09T03:00:00Z,SAVANNAH GA,0,1,2,1,4
Tropical Storm,Gustav,3,2002-09-09T03:00:00Z,PROVIDENCE RI,0,0,0,6,6
Tropical Storm,Gustav,3,2002-09-09T03:00:00Z,CHARLESTON SC,0,8,2,1,11
Tropical Storm,Gustav,3,2002-09-09T03:00:00Z,NANTUCKET MA,0,0,0,7,7
Tropical Storm,Gustav,3,2002-09-09T03:00:00Z,MYRTLE BEACH SC,2,15,2,0,19
Tropical Storm,Gustav,3,2002-09-09T03:00:00Z,HYANNIS MA,0,0,0,6,6
Tropical Storm,Gustav,3,2002-09-09T03:00:00Z,WILMINGTON NC,9,15,1,0,25
Tropical Storm,Gustav,3,2002-09-09T03:00:00Z,BOSTON MA,0,0,0,5,5
Tropical Storm,Gustav,3,2002-09-09T03:00:00Z,MOREHEAD CITY NC,18,10,0,0,28
Tropical Storm,Gustav,3,2002-09-09T03:00:00Z,PORTLAND ME,0,0,0,2,2
Tropical Storm,Gustav,3,2002-09-09T03:00:00Z,CAPE HATTERAS NC,10,12,1,1,24
Tropical Storm,Gustav,3,2002-09-09T03:00:00Z,BAR HARBOR ME,0,0,0,2,2
Tropical Storm,Gustav,3,2002-09-09T03:00:00Z,NORFOLK VA,0,7,6,3,16
Tropical Storm,Gustav,3,2002-09-09T03:00:00Z,YARMOUTH NS,0,0,0,2,2
Tropical Storm,Gustav,4,2002-09-09T09:00:00Z,33.8N  75.8W,45,0,0,0,45
Tropical Storm,Gustav,4,2002-09-09T09:00:00Z,PROVIDENCE RI,0,0,0,10,10
Tropical Storm,Gustav,4,2002-09-09T09:00:00Z,35.1N  75.4W,20,3,1,0,24
Tropical Storm,Gustav,4,2002-09-09T09:00:00Z,NANTUCKET MA,0,0,0,12,12
Tropical Storm,Gustav,4,2002-09-09T09:00:00Z,36.5N  73.0W,0,8,8,2,18
Tropical Storm,Gustav,4,2002-09-09T09:00:00Z,HYANNIS MA,0,0,0,11,11
Tropical Storm,Gustav,4,2002-09-09T09:00:00Z,CHARLESTON SC,2,3,1,0,6
Tropical Storm,Gustav,4,2002-09-09T09:00:00Z,BOSTON MA,0,0,0,9,9
Tropical Storm,Gustav,4,2002-09-09T09:00:00Z,MYRTLE BEACH SC,12,4,0,0,16
Tropical Storm,Gustav,4,2002-09-09T09:00:00Z,PORTLAND ME,0,0,0,6,6
Tropical Storm,Gustav,4,2002-09-09T09:00:00Z,WILMINGTON NC,23,1,0,1,25
Tropical Storm,Gustav,4,2002-09-09T09:00:00Z,BAR HARBOR ME,0,0,0,5,5
Tropical Storm,Gustav,4,2002-09-09T09:00:00Z,MOREHEAD CITY NC,28,0,1,0,29
Tropical Storm,Gustav,4,2002-09-09T09:00:00Z,EASTPORT ME,0,0,0,4,4
Tropical Storm,Gustav,4,2002-09-09T09:00:00Z,CAPE HATTERAS NC,17,5,1,0,23
Tropical Storm,Gustav,4,2002-09-09T09:00:00Z,ST JOHN NB,0,0,0,3,3
Tropical Storm,Gustav,4,2002-09-09T09:00:00Z,NORFOLK VA,0,11,5,1,17
Tropical Storm,Gustav,4,2002-09-09T09:00:00Z,MONCTON NB,0,0,0,2,2
Tropical Storm,Gustav,4,2002-09-09T09:00:00Z,OCEAN CITY MD,0,2,9,4,15
Tropical Storm,Gustav,4,2002-09-09T09:00:00Z,YARMOUTH NS,0,0,0,7,7
Tropical Storm,Gustav,4,2002-09-09T09:00:00Z,ATLANTIC CITY NJ,0,0,5,8,13
Tropical Storm,Gustav,4,2002-09-09T09:00:00Z,HALIFAX NS,0,0,0,4,4
Tropical Storm,Gustav,4,2002-09-09T09:00:00Z,NEW YORK CITY NY,0,0,1,10,11
Tropical Storm,Gustav,4,2002-09-09T09:00:00Z,SABLE ISLAND NS,0,0,0,3,3
Tropical Storm,Gustav,4,2002-09-09T09:00:00Z,MONTAUK POINT NY,0,0,0,11,11
Tropical Storm,Gustav,4,2002-09-09T09:00:00Z,EDDY POINT NS,0,0,0,2,2
Tropical Storm,Gustav,5,2002-09-09T15:00:00Z,34.1N  75.6W,37,0,0,0,37
Tropical Storm,Gustav,5,2002-09-09T15:00:00Z,PROVIDENCE RI,0,0,1,7,8
Tropical Storm,Gustav,5,2002-09-09T15:00:00Z,35.3N  74.7W,17,4,1,0,22
Tropical Storm,Gustav,5,2002-09-09T15:00:00Z,NANTUCKET MA,0,0,1,7,8
Tropical Storm,Gustav,5,2002-09-09T15:00:00Z,36.6N  72.0W,1,7,6,1,15
Tropical Storm,Gustav,5,2002-09-09T15:00:00Z,HYANNIS MA,0,0,0,8,8
Tropical Storm,Gustav,5,2002-09-09T15:00:00Z,BERMUDA,0,0,0,3,3
Tropical Storm,Gustav,5,2002-09-09T15:00:00Z,BOSTON MA,0,0,0,7,7
Tropical Storm,Gustav,5,2002-09-09T15:00:00Z,SAVANNAH GA,0,1,1,0,2
Tropical Storm,Gustav,5,2002-09-09T15:00:00Z,PORTLAND ME,0,0,0,6,6
Tropical Storm,Gustav,5,2002-09-09T15:00:00Z,CHARLESTON SC,3,4,0,1,8
Tropical Storm,Gustav,5,2002-09-09T15:00:00Z,BAR HARBOR ME,0,0,0,5,5
Tropical Storm,Gustav,5,2002-09-09T15:00:00Z,MYRTLE BEACH SC,11,3,1,0,15
Tropical Storm,Gustav,5,2002-09-09T15:00:00Z,EASTPORT ME,0,0,0,5,5
Tropical Storm,Gustav,5,2002-09-09T15:00:00Z,WILMINGTON NC,17,2,1,0,20
Tropical Storm,Gustav,5,2002-09-09T15:00:00Z,ST JOHN NB,0,0,0,4,4
Tropical Storm,Gustav,5,2002-09-09T15:00:00Z,MOREHEAD CITY NC,22,1,1,0,24
Tropical Storm,Gustav,5,2002-09-09T15:00:00Z,MONCTON NB,0,0,0,3,3
Tropical Storm,Gustav,5,2002-09-09T15:00:00Z,CAPE HATTERAS NC,17,4,1,0,22
Tropical Storm,Gustav,5,2002-09-09T15:00:00Z,YARMOUTH NS,0,0,0,6,6
Tropical Storm,Gustav,5,2002-09-09T15:00:00Z,NORFOLK VA,1,9,4,1,15
Tropical Storm,Gustav,5,2002-09-09T15:00:00Z,HALIFAX NS,0,0,0,5,5
Tropical Storm,Gustav,5,2002-09-09T15:00:00Z,OCEAN CITY MD,0,2,8,2,12
Tropical Storm,Gustav,5,2002-09-09T15:00:00Z,SABLE ISLAND NS,0,0,0,5,5
Tropical Storm,Gustav,5,2002-09-09T15:00:00Z,ATLANTIC CITY NJ,0,0,5,5,10
Tropical Storm,Gustav,5,2002-09-09T15:00:00Z,SYDNEY NS,0,0,0,3,3
Tropical Storm,Gustav,5,2002-09-09T15:00:00Z,NEW YORK CITY NY,0,0,2,6,8
Tropical Storm,Gustav,5,2002-09-09T15:00:00Z,EDDY POINT NS,0,0,0,3,3
Tropical Storm,Gustav,5,2002-09-09T15:00:00Z,MONTAUK POINT NY,0,0,1,7,8
Tropical Storm,Gustav,5,2002-09-09T15:00:00Z,ILE ST PIERRE,0,0,0,2,2
Tropical Storm,Gustav,6,2002-09-09T21:00:00Z,34.4N  75.7W,35,0,0,0,35
Tropical Storm,Gustav,6,2002-09-09T21:00:00Z,HYANNIS MA,0,0,1,7,8
Tropical Storm,Gustav,6,2002-09-09T21:00:00Z,35.5N  74.5W,15,5,1,0,21
Tropical Storm,Gustav,6,2002-09-09T21:00:00Z,BOSTON MA,0,0,0,7,7
Tropical Storm,Gustav,6,2002-09-09T21:00:00Z,37.0N  71.0W,0,4,9,2,15
Tropical Storm,Gustav,6,2002-09-09T21:00:00Z,PORTLAND ME,0,0,0,6,6
Tropical Storm,Gustav,6,2002-09-09T21:00:00Z,BERMUDA,0,0,1,1,2
Tropical Storm,Gustav,6,2002-09-09T21:00:00Z,BAR HARBOR ME,0,0,0,6,6
Tropical Storm,Gustav,6,2002-09-09T21:00:00Z,CHARLESTON SC,4,3,1,0,8
Tropical Storm,Gustav,6,2002-09-09T21:00:00Z,EASTPORT ME,0,0,0,5,5
Tropical Storm,Gustav,6,2002-09-09T21:00:00Z,MYRTLE BEACH SC,13,2,1,0,16
Tropical Storm,Gustav,6,2002-09-09T21:00:00Z,ST JOHN NB,0,0,0,5,5
Tropical Storm,Gustav,6,2002-09-09T21:00:00Z,WILMINGTON NC,20,2,0,0,22
Tropical Storm,Gustav,6,2002-09-09T21:00:00Z,MONCTON NB,0,0,0,4,4
Tropical Storm,Gustav,6,2002-09-09T21:00:00Z,MOREHEAD CITY NC,26,1,0,0,27
Tropical Storm,Gustav,6,2002-09-09T21:00:00Z,YARMOUTH NS,0,0,0,7,7
Tropical Storm,Gustav,6,2002-09-09T21:00:00Z,CAPE HATTERAS NC,20,3,0,0,23
Tropical Storm,Gustav,6,2002-09-09T21:00:00Z,HALIFAX NS,0,0,0,6,6
Tropical Storm,Gustav,6,2002-09-09T21:00:00Z,NORFOLK VA,2,10,3,1,16
Tropical Storm,Gustav,6,2002-09-09T21:00:00Z,SABLE ISLAND NS,0,0,0,6,6
Tropical Storm,Gustav,6,2002-09-09T21:00:00Z,OCEAN CITY MD,0,3,8,2,13
Tropical Storm,Gustav,6,2002-09-09T21:00:00Z,SYDNEY NS,0,0,0,4,4
Tropical Storm,Gustav,6,2002-09-09T21:00:00Z,ATLANTIC CITY NJ,0,0,6,4,10
Tropical Storm,Gustav,6,2002-09-09T21:00:00Z,EDDY POINT NS,0,0,0,5,5
Tropical Storm,Gustav,6,2002-09-09T21:00:00Z,NEW YORK CITY NY,0,0,3,6,9
Tropical Storm,Gustav,6,2002-09-09T21:00:00Z,PTX BASQUES NFLD,0,0,0,2,2
Tropical Storm,Gustav,6,2002-09-09T21:00:00Z,MONTAUK POINT NY,0,0,1,8,9
Tropical Storm,Gustav,6,2002-09-09T21:00:00Z,BURGEO NFLD,0,0,0,2,2
Tropical Storm,Gustav,6,2002-09-09T21:00:00Z,PROVIDENCE RI,0,0,1,7,8
Tropical Storm,Gustav,6,2002-09-09T21:00:00Z,ILE ST PIERRE,0,0,0,2,2
Tropical Storm,Gustav,6,2002-09-09T21:00:00Z,NANTUCKET MA,0,0,1,8,9
Tropical Storm,Gustav,6,2002-09-09T21:00:00Z,CAPE RACE NFLD,0,0,0,2,2
Tropical Storm,Gustav,7,2002-09-10T03:00:00Z,35.5N  74.8W,31,5,0,0,36
Tropical Storm,Gustav,7,2002-09-10T03:00:00Z,PORTLAND ME,0,0,3,4,7
Tropical Storm,Gustav,7,2002-09-10T03:00:00Z,37.5N  71.0W,0,20,7,0,27
Tropical Storm,Gustav,7,2002-09-10T03:00:00Z,BAR HARBOR ME,0,0,2,6,8
Tropical Storm,Gustav,7,2002-09-10T03:00:00Z,40.5N  64.5W,0,0,11,4,15
Tropical Storm,Gustav,7,2002-09-10T03:00:00Z,EASTPORT ME,0,0,1,7,8
Tropical Storm,Gustav,7,2002-09-10T03:00:00Z,MYRTLE BEACH SC,24,0,0,0,24
Tropical Storm,Gustav,7,2002-09-10T03:00:00Z,ST JOHN NB,0,0,1,7,8
Tropical Storm,Gustav,7,2002-09-10T03:00:00Z,WILMINGTON NC,41,0,0,0,41
Tropical Storm,Gustav,7,2002-09-10T03:00:00Z,MONCTON NB,0,0,0,8,8
Tropical Storm,Gustav,7,2002-09-10T03:00:00Z,MOREHEAD CITY NC,46,0,0,0,46
Tropical Storm,Gustav,7,2002-09-10T03:00:00Z,YARMOUTH NS,0,0,3,7,10
Tropical Storm,Gustav,7,2002-09-10T03:00:00Z,CAPE HATTERAS NC,37,2,0,0,39
Tropical Storm,Gustav,7,2002-09-10T03:00:00Z,HALIFAX NS,0,0,1,9,10
Tropical Storm,Gustav,7,2002-09-10T03:00:00Z,NORFOLK VA,12,13,1,0,26
Tropical Storm,Gustav,7,2002-09-10T03:00:00Z,SABLE ISLAND NS,0,0,1,9,10
Tropical Storm,Gustav,7,2002-09-10T03:00:00Z,OCEAN CITY MD,1,16,3,1,21
Tropical Storm,Gustav,7,2002-09-10T03:00:00Z,SYDNEY NS,0,0,0,9,9
Tropical Storm,Gustav,7,2002-09-10T03:00:00Z,ATLANTIC CITY NJ,0,6,7,0,13
Tropical Storm,Gustav,7,2002-09-10T03:00:00Z,EDDY POINT NS,0,0,0,9,9
Tropical Storm,Gustav,7,2002-09-10T03:00:00Z,NEW YORK CITY NY,0,2,7,0,9
Tropical Storm,Gustav,7,2002-09-10T03:00:00Z,PTX BASQUES NFLD,0,0,0,8,8
Tropical Storm,Gustav,7,2002-09-10T03:00:00Z,MONTAUK POINT NY,0,1,9,1,11
Tropical Storm,Gustav,7,2002-09-10T03:00:00Z,BURGEO NFLD,0,0,0,8,8
Tropical Storm,Gustav,7,2002-09-10T03:00:00Z,PROVIDENCE RI,0,0,8,2,10
Tropical Storm,Gustav,7,2002-09-10T03:00:00Z,ILE ST PIERRE,0,0,0,8,8
Tropical Storm,Gustav,7,2002-09-10T03:00:00Z,NANTUCKET MA,0,0,11,2,13
Tropical Storm,Gustav,7,2002-09-10T03:00:00Z,CAPE RACE NFLD,0,0,0,8,8
Tropical Storm,Gustav,7,2002-09-10T03:00:00Z,HYANNIS MA,0,0,9,3,12
Tropical Storm,Gustav,7,2002-09-10T03:00:00Z,HIBERNIA OILFLD,0,0,0,6,6
Tropical Storm,Gustav,7,2002-09-10T03:00:00Z,BOSTON MA,0,0,6,3,9
Tropical Storm,Gustav,8,2002-09-10T09:00:00Z,37.0N  72.0W,40,2,0,0,42
Tropical Storm,Gustav,8,2002-09-10T09:00:00Z,PORTLAND ME,0,3,2,0,5
Tropical Storm,Gustav,8,2002-09-10T09:00:00Z,39.0N  67.5W,0,17,4,0,21
Tropical Storm,Gustav,8,2002-09-10T09:00:00Z,BAR HARBOR ME,0,2,4,0,6
Tropical Storm,Gustav,8,2002-09-10T09:00:00Z,43.5N  60.0W,0,0,7,3,10
Tropical Storm,Gustav,8,2002-09-10T09:00:00Z,EASTPORT ME,0,1,6,0,7
Tropical Storm,Gustav,8,2002-09-10T09:00:00Z,BERMUDA,0,0,2,0,2
Tropical Storm,Gustav,8,2002-09-10T09:00:00Z,ST JOHN NB,0,1,6,1,8
Tropical Storm,Gustav,8,2002-09-10T09:00:00Z,WILMINGTON NC,13,0,0,0,13
Tropical Storm,Gustav,8,2002-09-10T09:00:00Z,MONCTON NB,0,0,7,0,7
Tropical Storm,Gustav,8,2002-09-10T09:00:00Z,MOREHEAD CITY NC,59,0,0,0,59
Tropical Storm,Gustav,8,2002-09-10T09:00:00Z,YARMOUTH NS,0,2,8,1,11
Tropical Storm,Gustav,8,2002-09-10T09:00:00Z,CAPE HATTERAS NC,64,0,0,0,64
Tropical Storm,Gustav,8,2002-09-10T09:00:00Z,HALIFAX NS,0,0,9,1,10
Tropical Storm,Gustav,8,2002-09-10T09:00:00Z,NORFOLK VA,15,1,0,0,16
Tropical Storm,Gustav,8,2002-09-10T09:00:00Z,SABLE ISLAND NS,0,0,7,3,10
Tropical Storm,Gustav,8,2002-09-10T09:00:00Z,OCEAN CITY MD,5,4,0,0,9
Tropical Storm,Gustav,8,2002-09-10T09:00:00Z,SYDNEY NS,0,0,6,4,10
Tropical Storm,Gustav,8,2002-09-10T09:00:00Z,ATLANTIC CITY NJ,1,4,0,0,5
Tropical Storm,Gustav,8,2002-09-10T09:00:00Z,EDDY POINT NS,0,0,8,2,10
Tropical Storm,Gustav,8,2002-09-10T09:00:00Z,NEW YORK CITY NY,0,4,0,0,4
Tropical Storm,Gustav,8,2002-09-10T09:00:00Z,PTX BASQUES NFLD,0,0,4,5,9
Tropical Storm,Gustav,8,2002-09-10T09:00:00Z,MONTAUK POINT NY,0,9,0,0,9
Tropical Storm,Gustav,8,2002-09-10T09:00:00Z,BURGEO NFLD,0,0,2,7,9
Tropical Storm,Gustav,8,2002-09-10T09:00:00Z,PROVIDENCE RI,0,7,1,0,8
Tropical Storm,Gustav,8,2002-09-10T09:00:00Z,ILE ST PIERRE,0,0,1,8,9
Tropical Storm,Gustav,8,2002-09-10T09:00:00Z,NANTUCKET MA,0,12,2,0,14
Tropical Storm,Gustav,8,2002-09-10T09:00:00Z,CAPE RACE NFLD,0,0,0,8,8
Tropical Storm,Gustav,8,2002-09-10T09:00:00Z,HYANNIS MA,0,10,2,0,12
Tropical Storm,Gustav,8,2002-09-10T09:00:00Z,HIBERNIA OILFLD,0,0,0,7,7
Tropical Storm,Gustav,8,2002-09-10T09:00:00Z,BOSTON MA,0,6,1,0,7
Tropical Storm,Gustav,9,2002-09-10T15:00:00Z,37.4N  70.8W,40,8,0,0,48
Tropical Storm,Gustav,9,2002-09-10T15:00:00Z,BAR HARBOR ME,0,3,1,0,4
Tropical Storm,Gustav,9,2002-09-10T15:00:00Z,41.0N  64.4W,0,15,5,0,20
Tropical Storm,Gustav,9,2002-09-10T15:00:00Z,EASTPORT ME,0,4,2,0,6
Tropical Storm,Gustav,9,2002-09-10T15:00:00Z,46.2N  55.9W,0,0,7,4,11
Tropical Storm,Gustav,9,2002-09-10T15:00:00Z,ST JOHN NB,0,4,3,0,7
Tropical Storm,Gustav,9,2002-09-10T15:00:00Z,WILMINGTON NC,2,0,0,0,2
Tropical Storm,Gustav,9,2002-09-10T15:00:00Z,MONCTON NB,0,2,5,0,7
Tropical Storm,Gustav,9,2002-09-10T15:00:00Z,MOREHEAD CITY NC,50,0,0,0,50
Tropical Storm,Gustav,9,2002-09-10T15:00:00Z,YARMOUTH NS,0,8,4,0,12
Tropical Storm,Gustav,9,2002-09-10T15:00:00Z,CAPE HATTERAS NC,69,0,0,0,69
Tropical Storm,Gustav,9,2002-09-10T15:00:00Z,HALIFAX NS,0,4,9,0,13
Tropical Storm,Gustav,9,2002-09-10T15:00:00Z,NORFOLK VA,10,0,0,0,10
Tropical Storm,Gustav,9,2002-09-10T15:00:00Z,SABLE ISLAND NS,0,1,11,1,13
Tropical Storm,Gustav,9,2002-09-10T15:00:00Z,OCEAN CITY MD,4,0,0,0,4
Tropical Storm,Gustav,9,2002-09-10T15:00:00Z,SYDNEY NS,0,0,10,1,11
Tropical Storm,Gustav,9,2002-09-10T15:00:00Z,MONTAUK POINT NY,0,4,0,0,4
Tropical Storm,Gustav,9,2002-09-10T15:00:00Z,EDDY POINT NS,0,1,11,0,12
Tropical Storm,Gustav,9,2002-09-10T15:00:00Z,PROVIDENCE RI,0,4,0,0,4
Tropical Storm,Gustav,9,2002-09-10T15:00:00Z,PTX BASQUES NFLD,0,0,9,1,10
Tropical Storm,Gustav,9,2002-09-10T15:00:00Z,NANTUCKET MA,0,10,0,0,10
Tropical Storm,Gustav,9,2002-09-10T15:00:00Z,BURGEO NFLD,0,0,8,2,10
Tropical Storm,Gustav,9,2002-09-10T15:00:00Z,HYANNIS MA,0,7,0,0,7
Tropical Storm,Gustav,9,2002-09-10T15:00:00Z,ILE ST PIERRE,0,0,8,3,11
Tropical Storm,Gustav,9,2002-09-10T15:00:00Z,BOSTON MA,0,3,0,0,3
Tropical Storm,Gustav,9,2002-09-10T15:00:00Z,CAPE RACE NFLD,0,0,3,7,10
Tropical Storm,Gustav,9,2002-09-10T15:00:00Z,PORTLAND ME,0,2,0,0,2
Tropical Storm,Gustav,9,2002-09-10T15:00:00Z,HIBERNIA OILFLD,0,0,0,7,7
Tropical Storm,Gustav,10,2002-09-10T21:00:00Z,39.9N  68.0W,18,8,0,0,26
Tropical Storm,Gustav,10,2002-09-10T21:00:00Z,BAR HARBOR ME,1,6,0,0,7
Tropical Storm,Gustav,10,2002-09-10T21:00:00Z,44.7N  60.5W,0,11,6,0,17
Tropical Storm,Gustav,10,2002-09-10T21:00:00Z,EASTPORT ME,0,8,1,0,9
Tropical Storm,Gustav,10,2002-09-10T21:00:00Z,50.0N  52.5W,0,0,8,4,12
Tropical Storm,Gustav,10,2002-09-10T21:00:00Z,ST JOHN NB,0,10,0,0,10
Tropical Storm,Gustav,10,2002-09-10T21:00:00Z,MOREHEAD CITY NC,10,0,0,0,10
Tropical Storm,Gustav,10,2002-09-10T21:00:00Z,MONCTON NB,0,9,1,0,10
Tropical Storm,Gustav,10,2002-09-10T21:00:00Z,CAPE HATTERAS NC,99,0,0,0,99
Tropical Storm,Gustav,10,2002-09-10T21:00:00Z,YARMOUTH NS,1,14,0,0,15
Tropical Storm,Gustav,10,2002-09-10T21:00:00Z,NORFOLK VA,20,0,0,0,20
Tropical Storm,Gustav,10,2002-09-10T21:00:00Z,HALIFAX NS,0,15,2,0,17
Tropical Storm,Gustav,10,2002-09-10T21:00:00Z,OCEAN CITY MD,15,0,0,0,15
Tropical Storm,Gustav,10,2002-09-10T21:00:00Z,SABLE ISLAND NS,0,10,5,1,16
Tropical Storm,Gustav,10,2002-09-10T21:00:00Z,ATLANTIC CITY NJ,7,0,0,0,7
Tropical Storm,Gustav,10,2002-09-10T21:00:00Z,SYDNEY NS,0,9,7,1,17
Tropical Storm,Gustav,10,2002-09-10T21:00:00Z,NEW YORK CITY NY,4,0,0,0,4
Tropical Storm,Gustav,10,2002-09-10T21:00:00Z,EDDY POINT NS,0,12,5,0,17
Tropical Storm,Gustav,10,2002-09-10T21:00:00Z,MONTAUK POINT NY,9,1,0,0,10
Tropical Storm,Gustav,10,2002-09-10T21:00:00Z,PTX BASQUES NFLD,0,6,9,0,15
Tropical Storm,Gustav,10,2002-09-10T21:00:00Z,PROVIDENCE RI,7,1,0,0,8
Tropical Storm,Gustav,10,2002-09-10T21:00:00Z,BURGEO NFLD,0,3,11,0,14
Tropical Storm,Gustav,10,2002-09-10T21:00:00Z,NANTUCKET MA,13,4,0,0,17
Tropical Storm,Gustav,10,2002-09-10T21:00:00Z,ILE ST PIERRE,0,2,10,1,13
Tropical Storm,Gustav,10,2002-09-10T21:00:00Z,HYANNIS MA,10,3,0,0,13
Tropical Storm,Gustav,10,2002-09-10T21:00:00Z,CAPE RACE NFLD,0,0,7,3,10
Tropical Storm,Gustav,10,2002-09-10T21:00:00Z,BOSTON MA,5,2,0,0,7
Tropical Storm,Gustav,10,2002-09-10T21:00:00Z,HIBERNIA OILFLD,0,0,1,5,6
Tropical Storm,Gustav,10,2002-09-10T21:00:00Z,PORTLAND ME,2,2,0,0,4
Tropical Storm,Gustav,11,2002-09-11T03:00:00Z,40.5N  66.5W,25,8,0,0,33
Tropical Storm,Gustav,11,2002-09-11T03:00:00Z,MONCTON NB,0,8,2,1,11
Tropical Storm,Gustav,11,2002-09-11T03:00:00Z,44.0N  60.0W,0,13,8,0,21
Tropical Storm,Gustav,11,2002-09-11T03:00:00Z,YARMOUTH NS,3,14,1,0,18
Tropical Storm,Gustav,11,2002-09-11T03:00:00Z,51.0N  53.0W,0,0,8,4,12
Tropical Storm,Gustav,11,2002-09-11T03:00:00Z,HALIFAX NS,0,18,3,0,21
Tropical Storm,Gustav,11,2002-09-11T03:00:00Z,CAPE HATTERAS NC,99,0,0,0,99
Tropical Storm,Gustav,11,2002-09-11T03:00:00Z,SABLE ISLAND NS,0,13,8,0,21
Tropical Storm,Gustav,11,2002-09-11T03:00:00Z,MONTAUK POINT NY,2,0,0,0,2
Tropical Storm,Gustav,11,2002-09-11T03:00:00Z,SYDNEY NS,0,8,11,0,19
Tropical Storm,Gustav,11,2002-09-11T03:00:00Z,PROVIDENCE RI,2,0,0,0,2
Tropical Storm,Gustav,11,2002-09-11T03:00:00Z,EDDY POINT NS,0,13,7,0,20
Tropical Storm,Gustav,11,2002-09-11T03:00:00Z,NANTUCKET MA,11,1,0,0,12
Tropical Storm,Gustav,11,2002-09-11T03:00:00Z,PTX BASQUES NFLD,0,4,12,0,16
Tropical Storm,Gustav,11,2002-09-11T03:00:00Z,HYANNIS MA,6,1,0,0,7
Tropical Storm,Gustav,11,2002-09-11T03:00:00Z,BURGEO NFLD,0,3,12,1,16
Tropical Storm,Gustav,11,2002-09-11T03:00:00Z,BOSTON MA,1,1,0,0,2
Tropical Storm,Gustav,11,2002-09-11T03:00:00Z,ILE ST PIERRE,0,2,11,1,14
Tropical Storm,Gustav,11,2002-09-11T03:00:00Z,BAR HARBOR ME,1,3,0,0,4
Tropical Storm,Gustav,11,2002-09-11T03:00:00Z,CAPE RACE NFLD,0,0,7,2,9
Tropical Storm,Gustav,11,2002-09-11T03:00:00Z,EASTPORT ME,1,6,0,1,8
Tropical Storm,Gustav,11,2002-09-11T03:00:00Z,HIBERNIA OILFLD,0,0,1,4,5
Tropical Storm,Gustav,11,2002-09-11T03:00:00Z,ST JOHN NB,0,8,2,0,10
Tropical Storm,Gustav,12,2002-09-11T09:00:00Z,44.5N  61.2W,19,8,0,0,27
Tropical Storm,Gustav,12,2002-09-11T09:00:00Z,SABLE ISLAND NS,12,11,0,0,23
Tropical Storm,Gustav,12,2002-09-11T09:00:00Z,49.3N  56.0W,0,15,2,1,18
Tropical Storm,Gustav,12,2002-09-11T09:00:00Z,SYDNEY NS,8,17,0,0,25
Tropical Storm,Gustav,12,2002-09-11T09:00:00Z,52.5N  52.5W,0,3,8,3,14
Tropical Storm,Gustav,12,2002-09-11T09:00:00Z,EDDY POINT NS,15,11,0,0,26
Tropical Storm,Gustav,12,2002-09-11T09:00:00Z,NANTUCKET MA,2,0,0,0,2
Tropical Storm,Gustav,12,2002-09-11T09:00:00Z,PTX BASQUES NFLD,3,19,0,0,22
Tropical Storm,Gustav,12,2002-09-11T09:00:00Z,EASTPORT ME,2,1,0,0,3
Tropical Storm,Gustav,12,2002-09-11T09:00:00Z,BURGEO NFLD,1,19,1,0,21
Tropical Storm,Gustav,12,2002-09-11T09:00:00Z,ST JOHN NB,5,1,0,0,6
Tropical Storm,Gustav,12,2002-09-11T09:00:00Z,ILE ST PIERRE,0,16,1,0,17
Tropical Storm,Gustav,12,2002-09-11T09:00:00Z,MONCTON NB,6,3,1,0,10
Tropical Storm,Gustav,12,2002-09-11T09:00:00Z,CAPE RACE NFLD,0,6,4,1,11
Tropical Storm,Gustav,12,2002-09-11T09:00:00Z,YARMOUTH NS,11,1,0,0,12
Tropical Storm,Gustav,12,2002-09-11T09:00:00Z,HIBERNIA OILFLD,0,0,3,2,5
Tropical Storm,Gustav,12,2002-09-11T09:00:00Z,HALIFAX NS,21,3,0,1,25
Hurricane,Gustav,13,2002-09-11T15:00:00Z,47.2N  59.5W,22,8,0,0,30
Hurricane,Gustav,13,2002-09-11T15:00:00Z,SABLE ISLAND NS,22,2,0,0,24
Hurricane,Gustav,13,2002-09-11T15:00:00Z,51.5N  54.6W,0,14,3,1,18
Hurricane,Gustav,13,2002-09-11T15:00:00Z,SYDNEY NS,29,3,0,0,32
Hurricane,Gustav,13,2002-09-11T15:00:00Z,54.7N  52.5W,0,4,7,3,14
Hurricane,Gustav,13,2002-09-11T15:00:00Z,EDDY POINT NS,36,1,0,0,37
Hurricane,Gustav,13,2002-09-11T15:00:00Z,NANTUCKET MA,1,0,0,1,2
Hurricane,Gustav,13,2002-09-11T15:00:00Z,PTX BASQUES NFLD,18,11,0,0,29
Hurricane,Gustav,13,2002-09-11T15:00:00Z,EASTPORT ME,4,0,0,1,5
Hurricane,Gustav,13,2002-09-11T15:00:00Z,BURGEO NFLD,9,15,0,0,24
Hurricane,Gustav,13,2002-09-11T15:00:00Z,ST JOHN NB,10,0,0,1,11
Hurricane,Gustav,13,2002-09-11T15:00:00Z,ILE ST PIERRE,4,13,0,0,17
Hurricane,Gustav,13,2002-09-11T15:00:00Z,MONCTON NB,16,0,1,0,17
Hurricane,Gustav,13,2002-09-11T15:00:00Z,CAPE RACE NFLD,0,6,1,1,8
Hurricane,Gustav,13,2002-09-11T15:00:00Z,YARMOUTH NS,23,0,0,0,23
Hurricane,Gustav,13,2002-09-11T15:00:00Z,HIBERNIA OILFLD,0,1,1,1,3
Hurricane,Gustav,13,2002-09-11T15:00:00Z,HALIFAX NS,41,0,0,0,41
Hurricane,Gustav,14,2002-09-11T21:00:00Z,49.2N  56.7W,20,5,0,0,25
Hurricane,Gustav,14,2002-09-11T21:00:00Z,SYDNEY NS,39,0,0,0,39
Hurricane,Gustav,14,2002-09-11T21:00:00Z,53.0N  53.0W,0,16,2,0,18
Hurricane,Gustav,14,2002-09-11T21:00:00Z,EDDY POINT NS,45,0,0,0,45
Hurricane,Gustav,14,2002-09-11T21:00:00Z,57.0N  51.0W,0,3,9,2,14
Hurricane,Gustav,14,2002-09-11T21:00:00Z,PTX BASQUES NFLD,32,1,0,0,33
Hurricane,Gustav,14,2002-09-11T21:00:00Z,ST JOHN NB,2,0,0,0,2
Hurricane,Gustav,14,2002-09-11T21:00:00Z,BURGEO NFLD,27,1,0,0,28
Hurricane,Gustav,14,2002-09-11T21:00:00Z,MONCTON NB,5,0,0,1,6
Hurricane,Gustav,14,2002-09-11T21:00:00Z,ILE ST PIERRE,18,2,0,1,21
Hurricane,Gustav,14,2002-09-11T21:00:00Z,YARMOUTH NS,8,0,0,0,8
Hurricane,Gustav,14,2002-09-11T21:00:00Z,CAPE RACE NFLD,3,6,0,0,9
Hurricane,Gustav,14,2002-09-11T21:00:00Z,HALIFAX NS,43,0,0,0,43
Hurricane,Gustav,14,2002-09-11T21:00:00Z,HIBERNIA OILFLD,0,1,1,1,3
Hurricane,Gustav,14,2002-09-11T21:00:00Z,SABLE ISLAND NS,25,0,1,0,26
Hurricane,Gustav,15,2002-09-12T03:00:00Z,52.0N  52.5W,30,0,0,0,30
Hurricane,Gustav,15,2002-09-12T03:00:00Z,EDDY POINT NS,99,0,0,0,99
Hurricane,Gustav,15,2002-09-12T03:00:00Z,56.0N  51.0W,4,12,1,0,17
Hurricane,Gustav,15,2002-09-12T03:00:00Z,PTX BASQUES NFLD,38,0,0,0,38
Hurricane,Gustav,15,2002-09-12T03:00:00Z,60.0N  51.0W,0,6,4,0,10
Hurricane,Gustav,15,2002-09-12T03:00:00Z,BURGEO NFLD,45,0,0,0,45
Hurricane,Gustav,15,2002-09-12T03:00:00Z,HALIFAX NS,3,0,0,0,3
Hurricane,Gustav,15,2002-09-12T03:00:00Z,ILE ST PIERRE,25,0,0,0,25
Hurricane,Gustav,15,2002-09-12T03:00:00Z,SABLE ISLAND NS,27,0,0,0,27
Hurricane,Gustav,15,2002-09-12T03:00:00Z,CAPE RACE NFLD,5,0,1,0,6
Hurricane,Gustav,15,2002-09-12T03:00:00Z,SYDNEY NS,43,0,0,0,43
Hurricane,Gustav,15,2002-09-12T03:00:00Z,HIBERNIA OILFLD,1,0,1,0,2
Hurricane,Gustav,16,2002-09-12T09:00:00Z,57.5N  52.5W,31,0,0,0,31
Hurricane,Gustav,16,2002-09-12T09:00:00Z,EDDY POINT NS,4,0,0,0,4
Hurricane,Gustav,16,2002-09-12T09:00:00Z,60.5N  53.0W,10,7,1,0,18
Hurricane,Gustav,16,2002-09-12T09:00:00Z,PTX BASQUES NFLD,99,0,0,0,99
Hurricane,Gustav,16,2002-09-12T09:00:00Z,63.0N  54.5W,0,9,3,0,12
Hurricane,Gustav,16,2002-09-12T09:00:00Z,BURGEO NFLD,99,0,0,0,99
Hurricane,Gustav,16,2002-09-12T09:00:00Z,SYDNEY NS,99,0,0,0,99
Hurricane,Gustav,16,2002-09-12T09:00:00Z,ILE ST PIERRE,6,0,0,0,6
Tropical Depression,Nine,1,2002-09-12T03:00:00Z,27.5N  85.9W,51,0,0,0,51
Tropical Depression,Nine,1,2002-09-12T03:00:00Z,MARCO ISLAND FL,0,2,3,3,8
Tropical Depression,Nine,1,2002-09-12T03:00:00Z,28.2N  85.6W,33,0,1,0,34
Tropical Depression,Nine,1,2002-09-12T03:00:00Z,FT MYERS FL,1,2,3,4,10
Tropical Depression,Nine,1,2002-09-12T03:00:00Z,29.0N  85.3W,21,2,0,1,24
Tropical Depression,Nine,1,2002-09-12T03:00:00Z,VENICE FL,3,3,3,3,12
Tropical Depression,Nine,1,2002-09-12T03:00:00Z,MUSN 216N 826W,0,0,1,1,2
Tropical Depression,Nine,1,2002-09-12T03:00:00Z,TAMPA FL,3,4,3,3,13
Tropical Depression,Nine,1,2002-09-12T03:00:00Z,MUHA 230N 824W,0,1,1,2,4
Tropical Depression,Nine,1,2002-09-12T03:00:00Z,CEDAR KEY FL,5,4,3,3,15
Tropical Depression,Nine,1,2002-09-12T03:00:00Z,MUAN 219N 850W,0,1,1,2,4
Tropical Depression,Nine,1,2002-09-12T03:00:00Z,ST MARKS FL,8,4,3,3,18
Tropical Depression,Nine,1,2002-09-12T03:00:00Z,MYGF 266N 787W,0,0,0,3,3
Tropical Depression,Nine,1,2002-09-12T03:00:00Z,APALACHICOLA FL,14,3,2,2,21
Tropical Depression,Nine,1,2002-09-12T03:00:00Z,MARATHON FL,0,1,1,3,5
Tropical Depression,Nine,1,2002-09-12T03:00:00Z,PANAMA CITY FL,13,4,2,1,20
Tropical Depression,Nine,1,2002-09-12T03:00:00Z,MIAMI FL,0,0,1,4,5
Tropical Depression,Nine,1,2002-09-12T03:00:00Z,PENSACOLA FL,6,6,3,3,18
Tropical Depression,Nine,1,2002-09-12T03:00:00Z,W PALM BEACH FL,0,0,1,4,5
Tropical Depression,Nine,1,2002-09-12T03:00:00Z,MOBILE AL,2,6,4,3,15
Tropical Depression,Nine,1,2002-09-12T03:00:00Z,FT PIERCE FL,0,0,2,4,6
Tropical Depression,Nine,1,2002-09-12T03:00:00Z,GULFPORT MS,1,5,3,4,13
Tropical Depression,Nine,1,2002-09-12T03:00:00Z,COCOA BEACH FL,0,1,1,5,7
Tropical Depression,Nine,1,2002-09-12T03:00:00Z,BURAS LA,1,4,3,3,11
Tropical Depression,Nine,1,2002-09-12T03:00:00Z,DAYTONA BEACH FL,0,1,3,5,9
Tropical Depression,Nine,1,2002-09-12T03:00:00Z,NEW ORLEANS LA,0,2,3,4,9
Tropical Depression,Nine,1,2002-09-12T03:00:00Z,JACKSONVILLE FL,0,2,2,6,10
Tropical Depression,Nine,1,2002-09-12T03:00:00Z,NEW IBERIA LA,0,0,1,3,4
Tropical Depression,Nine,1,2002-09-12T03:00:00Z,SAVANNAH GA,0,0,2,6,8
Tropical Depression,Nine,1,2002-09-12T03:00:00Z,GULF 29N 85W,19,2,1,1,23
Tropical Depression,Nine,1,2002-09-12T03:00:00Z,CHARLESTON SC,0,0,0,5,5
Tropical Depression,Nine,1,2002-09-12T03:00:00Z,GULF 29N 87W,17,2,2,1,22
Tropical Depression,Nine,1,2002-09-12T03:00:00Z,MYRTLE BEACH SC,0,0,0,3,3
Tropical Depression,Nine,1,2002-09-12T03:00:00Z,GULF 28N 89W,4,4,3,2,13
Tropical Depression,Nine,1,2002-09-12T03:00:00Z,WILMINGTON NC,0,0,0,2,2
Tropical Depression,Nine,1,2002-09-12T03:00:00Z,GULF 28N 91W,0,1,2,2,5
Tropical Depression,Nine,1,2002-09-12T03:00:00Z,KEY WEST FL,0,1,2,3,6
Tropical Depression,Nine,2,2002-09-12T09:00:00Z,28.1N  85.7W,48,0,0,0,48
Tropical Depression,Nine,2,2002-09-12T09:00:00Z,MARCO ISLAND FL,0,1,2,3,6
Tropical Depression,Nine,2,2002-09-12T09:00:00Z,28.9N  85.6W,30,1,0,0,31
Tropical Depression,Nine,2,2002-09-12T09:00:00Z,FT MYERS FL,0,2,2,4,8
Tropical Depression,Nine,2,2002-09-12T09:00:00Z,30.0N  85.5W,18,2,2,1,23
Tropical Depression,Nine,2,2002-09-12T09:00:00Z,VENICE FL,2,4,2,3,11
Tropical Depression,Nine,2,2002-09-12T09:00:00Z,MUHA 230N 824W,0,0,1,1,2
Tropical Depression,Nine,2,2002-09-12T09:00:00Z,TAMPA FL,4,3,2,3,12
Tropical Depression,Nine,2,2002-09-12T09:00:00Z,MUAN 219N 850W,0,0,1,1,2
Tropical Depression,Nine,2,2002-09-12T09:00:00Z,CEDAR KEY FL,7,4,2,2,15
Tropical Depression,Nine,2,2002-09-12T09:00:00Z,MYGF 266N 787W,0,0,0,2,2
Tropical Depression,Nine,2,2002-09-12T09:00:00Z,ST MARKS FL,12,4,2,1,19
Tropical Depression,Nine,2,2002-09-12T09:00:00Z,MARATHON FL,0,0,1,2,3
Tropical Depression,Nine,2,2002-09-12T09:00:00Z,APALACHICOLA FL,19,2,1,1,23
Tropical Depression,Nine,2,2002-09-12T09:00:00Z,MIAMI FL,0,0,1,3,4
Tropical Depression,Nine,2,2002-09-12T09:00:00Z,PANAMA CITY FL,18,2,2,1,23
Tropical Depression,Nine,2,2002-09-12T09:00:00Z,W PALM BEACH FL,0,0,1,3,4
Tropical Depression,Nine,2,2002-09-12T09:00:00Z,PENSACOLA FL,8,6,3,1,18
Tropical Depression,Nine,2,2002-09-12T09:00:00Z,FT PIERCE FL,0,0,1,4,5
Tropical Depression,Nine,2,2002-09-12T09:00:00Z,MOBILE AL,2,7,4,2,15
Tropical Depression,Nine,2,2002-09-12T09:00:00Z,COCOA BEACH FL,0,1,1,5,7
Tropical Depression,Nine,2,2002-09-12T09:00:00Z,GULFPORT MS,1,5,4,3,13
Tropical Depression,Nine,2,2002-09-12T09:00:00Z,DAYTONA BEACH FL,0,2,2,5,9
Tropical Depression,Nine,2,2002-09-12T09:00:00Z,BURAS LA,0,5,4,1,10
Tropical Depression,Nine,2,2002-09-12T09:00:00Z,JACKSONVILLE FL,1,2,2,6,11
Tropical Depression,Nine,2,2002-09-12T09:00:00Z,NEW ORLEANS LA,0,2,4,2,8
Tropical Depression,Nine,2,2002-09-12T09:00:00Z,SAVANNAH GA,0,1,2,6,9
Tropical Depression,Nine,2,2002-09-12T09:00:00Z,NEW IBERIA LA,0,0,2,1,3
Tropical Depression,Nine,2,2002-09-12T09:00:00Z,CHARLESTON SC,0,0,1,6,7
Tropical Depression,Nine,2,2002-09-12T09:00:00Z,GULF 29N 85W,26,1,0,0,27
Tropical Depression,Nine,2,2002-09-12T09:00:00Z,MYRTLE BEACH SC,0,0,0,5,5
Tropical Depression,Nine,2,2002-09-12T09:00:00Z,GULF 29N 87W,18,3,1,0,22
Tropical Depression,Nine,2,2002-09-12T09:00:00Z,WILMINGTON NC,0,0,0,3,3
Tropical Depression,Nine,2,2002-09-12T09:00:00Z,GULF 28N 89W,3,5,2,2,12
Tropical Depression,Nine,2,2002-09-12T09:00:00Z,MOREHEAD CITY NC,0,0,0,2,2
Tropical Depression,Nine,2,2002-09-12T09:00:00Z,GULF 28N 91W,0,1,2,1,4
Tropical Depression,Nine,2,2002-09-12T09:00:00Z,KEY WEST FL,0,0,1,3,4
Tropical Depression,Nine,3,2002-09-12T15:00:00Z,29.0N  86.7W,46,0,0,0,46
Tropical Depression,Nine,3,2002-09-12T15:00:00Z,MARCO ISLAND FL,0,1,1,1,3
Tropical Depression,Nine,3,2002-09-12T15:00:00Z,30.5N  86.5W,24,1,0,1,26
Tropical Depression,Nine,3,2002-09-12T15:00:00Z,FT MYERS FL,0,1,3,1,5
Tropical Depression,Nine,3,2002-09-12T15:00:00Z,32.5N  85.0W,4,6,4,3,17
Tropical Depression,Nine,3,2002-09-12T15:00:00Z,VENICE FL,1,3,2,1,7
Tropical Depression,Nine,3,2002-09-12T15:00:00Z,MYGF 266N 787W,0,0,1,1,2
Tropical Depression,Nine,3,2002-09-12T15:00:00Z,TAMPA FL,1,4,3,1,9
Tropical Depression,Nine,3,2002-09-12T15:00:00Z,MIAMI FL,0,0,1,1,2
Tropical Depression,Nine,3,2002-09-12T15:00:00Z,CEDAR KEY FL,3,5,3,2,13
Tropical Depression,Nine,3,2002-09-12T15:00:00Z,W PALM BEACH FL,0,0,1,2,3
Tropical Depression,Nine,3,2002-09-12T15:00:00Z,ST MARKS FL,10,3,3,1,17
Tropical Depression,Nine,3,2002-09-12T15:00:00Z,FT PIERCE FL,0,0,2,3,5
Tropical Depression,Nine,3,2002-09-12T15:00:00Z,APALACHICOLA FL,18,2,1,0,21
Tropical Depression,Nine,3,2002-09-12T15:00:00Z,COCOA BEACH FL,0,1,2,3,6
Tropical Depression,Nine,3,2002-09-12T15:00:00Z,PANAMA CITY FL,22,2,0,0,24
Tropical Depression,Nine,3,2002-09-12T15:00:00Z,DAYTONA BEACH FL,0,1,4,4,9
Tropical Depression,Nine,3,2002-09-12T15:00:00Z,PENSACOLA FL,23,1,1,0,25
Tropical Depression,Nine,3,2002-09-12T15:00:00Z,JACKSONVILLE FL,0,2,5,4,11
Tropical Depression,Nine,3,2002-09-12T15:00:00Z,MOBILE AL,16,3,1,0,20
Tropical Depression,Nine,3,2002-09-12T15:00:00Z,SAVANNAH GA,0,0,4,7,11
Tropical Depression,Nine,3,2002-09-12T15:00:00Z,GULFPORT MS,11,4,1,0,16
Tropical Depression,Nine,3,2002-09-12T15:00:00Z,CHARLESTON SC,0,0,1,9,10
Tropical Depression,Nine,3,2002-09-12T15:00:00Z,BURAS LA,8,4,0,1,13
Tropical Depression,Nine,3,2002-09-12T15:00:00Z,MYRTLE BEACH SC,0,0,0,9,9
Tropical Depression,Nine,3,2002-09-12T15:00:00Z,NEW ORLEANS LA,3,5,1,1,10
Tropical Depression,Nine,3,2002-09-12T15:00:00Z,WILMINGTON NC,0,0,0,8,8
Tropical Depression,Nine,3,2002-09-12T15:00:00Z,NEW IBERIA LA,0,2,1,0,3
Tropical Depression,Nine,3,2002-09-12T15:00:00Z,MOREHEAD CITY NC,0,0,0,6,6
Tropical Depression,Nine,3,2002-09-12T15:00:00Z,GULF 29N 85W,22,1,0,0,23
Tropical Depression,Nine,3,2002-09-12T15:00:00Z,CAPE HATTERAS NC,0,0,0,4,4
Tropical Depression,Nine,3,2002-09-12T15:00:00Z,GULF 29N 87W,44,0,0,0,44
Tropical Depression,Nine,3,2002-09-12T15:00:00Z,NORFOLK VA,0,0,0,4,4
Tropical Depression,Nine,3,2002-09-12T15:00:00Z,GULF 28N 89W,11,2,0,1,14
Tropical Depression,Nine,3,2002-09-12T15:00:00Z,OCEAN CITY MD,0,0,0,2,2
Tropical Depression,Nine,3,2002-09-12T15:00:00Z,GULF 28N 91W,0,2,0,0,2
Tropical Depression,Nine,4,2002-09-12T21:00:00Z,29.0N  87.0W,48,0,0,0,48
Tropical Depression,Nine,4,2002-09-12T21:00:00Z,NEW YORK CITY NY,0,0,0,2,2
Tropical Depression,Nine,4,2002-09-12T21:00:00Z,30.5N  86.5W,29,3,0,0,32
Tropical Depression,Nine,4,2002-09-12T21:00:00Z,VENICE FL,0,0,1,2,3
Tropical Depression,Nine,4,2002-09-12T21:00:00Z,32.5N  85.5W,3,15,6,1,25
Tropical Depression,Nine,4,2002-09-12T21:00:00Z,TAMPA FL,0,0,2,3,5
Tropical Depression,Nine,4,2002-09-12T21:00:00Z,FT PIERCE FL,0,0,0,2,2
Tropical Depression,Nine,4,2002-09-12T21:00:00Z,CEDAR KEY FL,0,3,4,2,9
Tropical Depression,Nine,4,2002-09-12T21:00:00Z,COCOA BEACH FL,0,0,0,3,3
Tropical Depression,Nine,4,2002-09-12T21:00:00Z,ST MARKS FL,4,9,4,1,18
Tropical Depression,Nine,4,2002-09-12T21:00:00Z,DAYTONA BEACH FL,0,0,1,5,6
Tropical Depression,Nine,4,2002-09-12T21:00:00Z,APALACHICOLA FL,15,5,2,0,22
Tropical Depression,Nine,4,2002-09-12T21:00:00Z,JACKSONVILLE FL,0,0,3,7,10
Tropical Depression,Nine,4,2002-09-12T21:00:00Z,PANAMA CITY FL,23,4,0,1,28
Tropical Depression,Nine,4,2002-09-12T21:00:00Z,SAVANNAH GA,0,0,3,9,12
Tropical Depression,Nine,4,2002-09-12T21:00:00Z,PENSACOLA FL,30,3,0,0,33
Tropical Depression,Nine,4,2002-09-12T21:00:00Z,CHARLESTON SC,0,0,1,10,11
Tropical Depression,Nine,4,2002-09-12T21:00:00Z,MOBILE AL,19,6,0,1,26
Tropical Depression,Nine,4,2002-09-12T21:00:00Z,MYRTLE BEACH SC,0,0,0,10,10
Tropical Depression,Nine,4,2002-09-12T21:00:00Z,GULFPORT MS,12,6,1,0,19
Tropical Depression,Nine,4,2002-09-12T21:00:00Z,WILMINGTON NC,0,0,0,9,9
Tropical Depression,Nine,4,2002-09-12T21:00:00Z,BURAS LA,12,3,1,0,16
Tropical Depression,Nine,4,2002-09-12T21:00:00Z,MOREHEAD CITY NC,0,0,0,8,8
Tropical Depression,Nine,4,2002-09-12T21:00:00Z,NEW ORLEANS LA,2,5,2,1,10
Tropical Depression,Nine,4,2002-09-12T21:00:00Z,CAPE HATTERAS NC,0,0,0,6,6
Tropical Depression,Nine,4,2002-09-12T21:00:00Z,GULF 29N 85W,16,4,1,0,21
Tropical Depression,Nine,4,2002-09-12T21:00:00Z,NORFOLK VA,0,0,0,7,7
Tropical Depression,Nine,4,2002-09-12T21:00:00Z,GULF 29N 87W,48,0,0,0,48
Tropical Depression,Nine,4,2002-09-12T21:00:00Z,OCEAN CITY MD,0,0,0,5,5
Tropical Depression,Nine,4,2002-09-12T21:00:00Z,GULF 28N 89W,33,0,0,0,33
Tropical Depression,Nine,4,2002-09-12T21:00:00Z,ATLANTIC CITY NJ,0,0,0,4,4
Tropical Depression,Nine,4,2002-09-12T21:00:00Z,GULF 28N 91W,1,1,0,0,2
Tropical Depression,Nine,5,2002-09-13T03:00:00Z,29.0N  88.0W,35,0,0,0,35
Tropical Depression,Nine,5,2002-09-13T03:00:00Z,MARCO ISLAND FL,0,0,1,1,2
Tropical Depression,Nine,5,2002-09-13T03:00:00Z,30.9N  86.9W,11,10,1,0,22
Tropical Depression,Nine,5,2002-09-13T03:00:00Z,FT MYERS FL,0,0,2,1,3
Tropical Depression,Nine,5,2002-09-13T03:00:00Z,32.8N  84.8W,0,4,11,2,17
Tropical Depression,Nine,5,2002-09-13T03:00:00Z,VENICE FL,0,1,2,1,4
Tropical Depression,Nine,5,2002-09-13T03:00:00Z,MYGF 266N 787W,0,0,0,2,2
Tropical Depression,Nine,5,2002-09-13T03:00:00Z,TAMPA FL,0,1,4,2,7
Tropical Depression,Nine,5,2002-09-13T03:00:00Z,W PALM BEACH FL,0,0,1,1,2
Tropical Depression,Nine,5,2002-09-13T03:00:00Z,CEDAR KEY FL,0,3,5,2,10
Tropical Depression,Nine,5,2002-09-13T03:00:00Z,FT PIERCE FL,0,0,1,3,4
Tropical Depression,Nine,5,2002-09-13T03:00:00Z,ST MARKS FL,0,8,6,1,15
Tropical Depression,Nine,5,2002-09-13T03:00:00Z,COCOA BEACH FL,0,0,2,3,5
Tropical Depression,Nine,5,2002-09-13T03:00:00Z,APALACHICOLA FL,3,10,2,1,16
Tropical Depression,Nine,5,2002-09-13T03:00:00Z,DAYTONA BEACH FL,0,0,4,4,8
Tropical Depression,Nine,5,2002-09-13T03:00:00Z,PANAMA CITY FL,5,11,2,0,18
Tropical Depression,Nine,5,2002-09-13T03:00:00Z,JACKSONVILLE FL,0,0,6,5,11
Tropical Depression,Nine,5,2002-09-13T03:00:00Z,PENSACOLA FL,17,6,1,0,24
Tropical Depression,Nine,5,2002-09-13T03:00:00Z,SAVANNAH GA,0,0,4,8,12
Tropical Depression,Nine,5,2002-09-13T03:00:00Z,MOBILE AL,21,3,1,0,25
Tropical Depression,Nine,5,2002-09-13T03:00:00Z,CHARLESTON SC,0,0,1,10,11
Tropical Depression,Nine,5,2002-09-13T03:00:00Z,GULFPORT MS,23,1,0,0,24
Tropical Depression,Nine,5,2002-09-13T03:00:00Z,MYRTLE BEACH SC,0,0,0,10,10
Tropical Depression,Nine,5,2002-09-13T03:00:00Z,BURAS LA,23,1,0,0,24
Tropical Depression,Nine,5,2002-09-13T03:00:00Z,WILMINGTON NC,0,0,0,9,9
Tropical Depression,Nine,5,2002-09-13T03:00:00Z,NEW ORLEANS LA,15,2,0,0,17
Tropical Depression,Nine,5,2002-09-13T03:00:00Z,MOREHEAD CITY NC,0,0,0,8,8
Tropical Depression,Nine,5,2002-09-13T03:00:00Z,NEW IBERIA LA,2,2,1,0,5
Tropical Depression,Nine,5,2002-09-13T03:00:00Z,CAPE HATTERAS NC,0,0,0,6,6
Tropical Depression,Nine,5,2002-09-13T03:00:00Z,GULF 29N 85W,4,9,2,0,15
Tropical Depression,Nine,5,2002-09-13T03:00:00Z,NORFOLK VA,0,0,0,7,7
Tropical Depression,Nine,5,2002-09-13T03:00:00Z,GULF 29N 87W,25,1,0,0,26
Tropical Depression,Nine,5,2002-09-13T03:00:00Z,OCEAN CITY MD,0,0,0,4,4
Tropical Depression,Nine,5,2002-09-13T03:00:00Z,GULF 28N 89W,37,0,0,0,37
Tropical Depression,Nine,5,2002-09-13T03:00:00Z,ATLANTIC CITY NJ,0,0,0,3,3
Tropical Depression,Nine,5,2002-09-13T03:00:00Z,GULF 28N 91W,3,2,0,0,5
Tropical Depression,Nine,5,2002-09-13T03:00:00Z,NEW YORK CITY NY,0,0,0,2,2
Tropical Storm,Hanna,6,2002-09-13T09:00:00Z,29.6N  88.3W,45,0,0,0,45
Tropical Storm,Hanna,6,2002-09-13T09:00:00Z,HYANNIS MA,0,0,0,4,4
Tropical Storm,Hanna,6,2002-09-13T09:00:00Z,32.0N  85.8W,1,31,1,1,34
Tropical Storm,Hanna,6,2002-09-13T09:00:00Z,BOSTON MA,0,0,0,4,4
Tropical Storm,Hanna,6,2002-09-13T09:00:00Z,34.5N  83.0W,0,1,21,1,23
Tropical Storm,Hanna,6,2002-09-13T09:00:00Z,PORTLAND ME,0,0,0,2,2
Tropical Storm,Hanna,6,2002-09-13T09:00:00Z,DAYTONA BEACH FL,0,0,3,1,4
Tropical Storm,Hanna,6,2002-09-13T09:00:00Z,TAMPA FL,0,1,1,0,2
Tropical Storm,Hanna,6,2002-09-13T09:00:00Z,JACKSONVILLE FL,0,1,8,2,11
Tropical Storm,Hanna,6,2002-09-13T09:00:00Z,CEDAR KEY FL,0,5,3,1,9
Tropical Storm,Hanna,6,2002-09-13T09:00:00Z,SAVANNAH GA,0,0,12,3,15
Tropical Storm,Hanna,6,2002-09-13T09:00:00Z,ST MARKS FL,0,17,3,1,21
Tropical Storm,Hanna,6,2002-09-13T09:00:00Z,CHARLESTON SC,0,0,7,7,14
Tropical Storm,Hanna,6,2002-09-13T09:00:00Z,APALACHICOLA FL,2,21,1,0,24
Tropical Storm,Hanna,6,2002-09-13T09:00:00Z,MYRTLE BEACH SC,0,0,3,11,14
Tropical Storm,Hanna,6,2002-09-13T09:00:00Z,PANAMA CITY FL,5,25,0,0,30
Tropical Storm,Hanna,6,2002-09-13T09:00:00Z,WILMINGTON NC,0,0,1,13,14
Tropical Storm,Hanna,6,2002-09-13T09:00:00Z,PENSACOLA FL,25,15,0,1,41
Tropical Storm,Hanna,6,2002-09-13T09:00:00Z,MOREHEAD CITY NC,0,0,0,13,13
Tropical Storm,Hanna,6,2002-09-13T09:00:00Z,MOBILE AL,35,7,0,0,42
Tropical Storm,Hanna,6,2002-09-13T09:00:00Z,CAPE HATTERAS NC,0,0,0,13,13
Tropical Storm,Hanna,6,2002-09-13T09:00:00Z,GULFPORT MS,39,2,0,0,41
Tropical Storm,Hanna,6,2002-09-13T09:00:00Z,NORFOLK VA,0,0,0,14,14
Tropical Storm,Hanna,6,2002-09-13T09:00:00Z,BURAS LA,51,0,0,0,51
Tropical Storm,Hanna,6,2002-09-13T09:00:00Z,OCEAN CITY MD,0,0,0,13,13
Tropical Storm,Hanna,6,2002-09-13T09:00:00Z,NEW ORLEANS LA,29,0,1,0,30
Tropical Storm,Hanna,6,2002-09-13T09:00:00Z,ATLANTIC CITY NJ,0,0,0,12,12
Tropical Storm,Hanna,6,2002-09-13T09:00:00Z,NEW IBERIA LA,4,1,0,0,5
Tropical Storm,Hanna,6,2002-09-13T09:00:00Z,NEW YORK CITY NY,0,0,0,9,9
Tropical Storm,Hanna,6,2002-09-13T09:00:00Z,GULF 29N 85W,2,17,1,0,20
Tropical Storm,Hanna,6,2002-09-13T09:00:00Z,MONTAUK POINT NY,0,0,0,7,7
Tropical Storm,Hanna,6,2002-09-13T09:00:00Z,GULF 29N 87W,29,7,0,0,36
Tropical Storm,Hanna,6,2002-09-13T09:00:00Z,PROVIDENCE RI,0,0,0,5,5
Tropical Storm,Hanna,6,2002-09-13T09:00:00Z,GULF 28N 89W,89,0,0,0,89
Tropical Storm,Hanna,6,2002-09-13T09:00:00Z,NANTUCKET MA,0,0,0,4,4
Tropical Storm,Hanna,6,2002-09-13T09:00:00Z,GULF 28N 91W,20,0,0,0,20
Tropical Storm,Hanna,7,2002-09-13T15:00:00Z,31.0N  88.0W,45,2,0,0,47
Tropical Storm,Hanna,7,2002-09-13T15:00:00Z,BAR HARBOR ME,0,0,0,6,6
Tropical Storm,Hanna,7,2002-09-13T15:00:00Z,34.0N  84.0W,0,22,3,0,25
Tropical Storm,Hanna,7,2002-09-13T15:00:00Z,EASTPORT ME,0,0,0,5,5
Tropical Storm,Hanna,7,2002-09-13T15:00:00Z,36.5N  79.0W,0,0,14,3,17
Tropical Storm,Hanna,7,2002-09-13T15:00:00Z,ST JOHN NB,0,0,0,3,3
Tropical Storm,Hanna,7,2002-09-13T15:00:00Z,DAYTONA BEACH FL,0,1,1,0,2
Tropical Storm,Hanna,7,2002-09-13T15:00:00Z,MONCTON NB,0,0,0,2,2
Tropical Storm,Hanna,7,2002-09-13T15:00:00Z,JACKSONVILLE FL,0,3,4,0,7
Tropical Storm,Hanna,7,2002-09-13T15:00:00Z,YARMOUTH NS,0,0,0,5,5
Tropical Storm,Hanna,7,2002-09-13T15:00:00Z,SAVANNAH GA,0,6,7,0,13
Tropical Storm,Hanna,7,2002-09-13T15:00:00Z,HALIFAX NS,0,0,0,2,2
Tropical Storm,Hanna,7,2002-09-13T15:00:00Z,CHARLESTON SC,0,3,10,1,14
Tropical Storm,Hanna,7,2002-09-13T15:00:00Z,CEDAR KEY FL,0,2,1,0,3
Tropical Storm,Hanna,7,2002-09-13T15:00:00Z,MYRTLE BEACH SC,0,1,12,1,14
Tropical Storm,Hanna,7,2002-09-13T15:00:00Z,ST MARKS FL,1,11,1,0,13
Tropical Storm,Hanna,7,2002-09-13T15:00:00Z,WILMINGTON NC,0,0,11,3,14
Tropical Storm,Hanna,7,2002-09-13T15:00:00Z,APALACHICOLA FL,3,10,0,0,13
Tropical Storm,Hanna,7,2002-09-13T15:00:00Z,MOREHEAD CITY NC,0,0,9,4,13
Tropical Storm,Hanna,7,2002-09-13T15:00:00Z,PANAMA CITY FL,10,12,0,0,22
Tropical Storm,Hanna,7,2002-09-13T15:00:00Z,CAPE HATTERAS NC,0,0,6,6,12
Tropical Storm,Hanna,7,2002-09-13T15:00:00Z,PENSACOLA FL,38,3,0,0,41
Tropical Storm,Hanna,7,2002-09-13T15:00:00Z,NORFOLK VA,0,0,7,7,14
Tropical Storm,Hanna,7,2002-09-13T15:00:00Z,MOBILE AL,48,1,0,0,49
Tropical Storm,Hanna,7,2002-09-13T15:00:00Z,OCEAN CITY MD,0,0,3,11,14
Tropical Storm,Hanna,7,2002-09-13T15:00:00Z,GULFPORT MS,51,0,0,0,51
Tropical Storm,Hanna,7,2002-09-13T15:00:00Z,ATLANTIC CITY NJ,0,0,1,12,13
Tropical Storm,Hanna,7,2002-09-13T15:00:00Z,BURAS LA,62,0,0,0,62
Tropical Storm,Hanna,7,2002-09-13T15:00:00Z,NEW YORK CITY NY,0,0,0,12,12
Tropical Storm,Hanna,7,2002-09-13T15:00:00Z,NEW ORLEANS LA,43,0,0,0,43
Tropical Storm,Hanna,7,2002-09-13T15:00:00Z,MONTAUK POINT NY,0,0,0,11,11
Tropical Storm,Hanna,7,2002-09-13T15:00:00Z,NEW IBERIA LA,7,1,0,0,8
Tropical Storm,Hanna,7,2002-09-13T15:00:00Z,PROVIDENCE RI,0,0,0,10,10
Tropical Storm,Hanna,7,2002-09-13T15:00:00Z,GULF 29N 85W,2,4,1,0,7
Tropical Storm,Hanna,7,2002-09-13T15:00:00Z,NANTUCKET MA,0,0,0,10,10
Tropical Storm,Hanna,7,2002-09-13T15:00:00Z,GULF 29N 87W,26,2,0,0,28
Tropical Storm,Hanna,7,2002-09-13T15:00:00Z,HYANNIS MA,0,0,0,10,10
Tropical Storm,Hanna,7,2002-09-13T15:00:00Z,GULF 28N 89W,99,0,0,0,99
Tropical Storm,Hanna,7,2002-09-13T15:00:00Z,BOSTON MA,0,0,0,10,10
Tropical Storm,Hanna,7,2002-09-13T15:00:00Z,GULF 28N 91W,30,0,0,0,30
Tropical Storm,Hanna,7,2002-09-13T15:00:00Z,PORTLAND ME,0,0,0,8,8
Tropical Storm,Hanna,8,2002-09-13T21:00:00Z,32.0N  87.5W,47,1,0,0,48
Tropical Storm,Hanna,8,2002-09-13T21:00:00Z,EASTPORT ME,0,0,0,7,7
Tropical Storm,Hanna,8,2002-09-13T21:00:00Z,35.0N  83.5W,0,22,2,0,24
Tropical Storm,Hanna,8,2002-09-13T21:00:00Z,ST JOHN NB,0,0,0,6,6
Tropical Storm,Hanna,8,2002-09-13T21:00:00Z,37.5N  78.5W,0,1,13,2,16
Tropical Storm,Hanna,8,2002-09-13T21:00:00Z,MONCTON NB,0,0,0,5,5
Tropical Storm,Hanna,8,2002-09-13T21:00:00Z,DAYTONA BEACH FL,0,1,1,0,2
Tropical Storm,Hanna,8,2002-09-13T21:00:00Z,YARMOUTH NS,0,0,0,7,7
Tropical Storm,Hanna,8,2002-09-13T21:00:00Z,JACKSONVILLE FL,0,3,3,0,6
Tropical Storm,Hanna,8,2002-09-13T21:00:00Z,HALIFAX NS,0,0,0,5,5
Tropical Storm,Hanna,8,2002-09-13T21:00:00Z,SAVANNAH GA,0,6,6,0,12
Tropical Storm,Hanna,8,2002-09-13T21:00:00Z,SABLE ISLAND NS,0,0,0,2,2
Tropical Storm,Hanna,8,2002-09-13T21:00:00Z,CHARLESTON SC,0,3,9,0,12
Tropical Storm,Hanna,8,2002-09-13T21:00:00Z,SYDNEY NS,0,0,0,2,2
Tropical Storm,Hanna,8,2002-09-13T21:00:00Z,MYRTLE BEACH SC,0,2,10,1,13
Tropical Storm,Hanna,8,2002-09-13T21:00:00Z,EDDY POINT NS,0,0,0,3,3
Tropical Storm,Hanna,8,2002-09-13T21:00:00Z,WILMINGTON NC,0,1,10,2,13
Tropical Storm,Hanna,8,2002-09-13T21:00:00Z,CEDAR KEY FL,0,1,1,0,2
Tropical Storm,Hanna,8,2002-09-13T21:00:00Z,MOREHEAD CITY NC,0,0,9,3,12
Tropical Storm,Hanna,8,2002-09-13T21:00:00Z,ST MARKS FL,1,7,1,0,9
Tropical Storm,Hanna,8,2002-09-13T21:00:00Z,CAPE HATTERAS NC,0,0,7,4,11
Tropical Storm,Hanna,8,2002-09-13T21:00:00Z,APALACHICOLA FL,2,6,0,0,8
Tropical Storm,Hanna,8,2002-09-13T21:00:00Z,NORFOLK VA,0,0,9,5,14
Tropical Storm,Hanna,8,2002-09-13T21:00:00Z,PANAMA CITY FL,9,8,0,0,17
Tropical Storm,Hanna,8,2002-09-13T21:00:00Z,OCEAN CITY MD,0,0,5,8,13
Tropical Storm,Hanna,8,2002-09-13T21:00:00Z,PENSACOLA FL,51,0,0,0,51
Tropical Storm,Hanna,8,2002-09-13T21:00:00Z,ATLANTIC CITY NJ,0,0,3,9,12
Tropical Storm,Hanna,8,2002-09-13T21:00:00Z,MOBILE AL,65,0,0,0,65
Tropical Storm,Hanna,8,2002-09-13T21:00:00Z,NEW YORK CITY NY,0,0,1,11,12
Tropical Storm,Hanna,8,2002-09-13T21:00:00Z,GULFPORT MS,70,0,0,0,70
Tropical Storm,Hanna,8,2002-09-13T21:00:00Z,MONTAUK POINT NY,0,0,0,11,11
Tropical Storm,Hanna,8,2002-09-13T21:00:00Z,BURAS LA,82,0,0,0,82
Tropical Storm,Hanna,8,2002-09-13T21:00:00Z,PROVIDENCE RI,0,0,0,10,10
Tropical Storm,Hanna,8,2002-09-13T21:00:00Z,NEW ORLEANS LA,56,0,0,0,56
Tropical Storm,Hanna,8,2002-09-13T21:00:00Z,NANTUCKET MA,0,0,0,10,10
Tropical Storm,Hanna,8,2002-09-13T21:00:00Z,NEW IBERIA LA,7,0,0,0,7
Tropical Storm,Hanna,8,2002-09-13T21:00:00Z,HYANNIS MA,0,0,0,10,10
Tropical Storm,Hanna,8,2002-09-13T21:00:00Z,GULF 29N 85W,1,2,1,0,4
Tropical Storm,Hanna,8,2002-09-13T21:00:00Z,BOSTON MA,0,0,0,10,10
Tropical Storm,Hanna,8,2002-09-13T21:00:00Z,GULF 29N 87W,30,1,0,0,31
Tropical Storm,Hanna,8,2002-09-13T21:00:00Z,PORTLAND ME,0,0,0,9,9
Tropical Storm,Hanna,8,2002-09-13T21:00:00Z,GULF 28N 89W,99,0,0,0,99
Tropical Storm,Hanna,8,2002-09-13T21:00:00Z,BAR HARBOR ME,0,0,0,8,8
Tropical Storm,Hanna,8,2002-09-13T21:00:00Z,GULF 28N 91W,28,0,0,0,28
Tropical Storm,Hanna,9,2002-09-14T03:00:00Z,33.0N  85.7W,31,2,0,0,33
Tropical Storm,Hanna,9,2002-09-14T03:00:00Z,ST JOHN NB,0,0,0,9,9
Tropical Storm,Hanna,9,2002-09-14T03:00:00Z,35.7N  81.6W,0,17,1,0,18
Tropical Storm,Hanna,9,2002-09-14T03:00:00Z,MONCTON NB,0,0,0,8,8
Tropical Storm,Hanna,9,2002-09-14T03:00:00Z,38.6N  76.6W,0,0,12,1,13
Tropical Storm,Hanna,9,2002-09-14T03:00:00Z,YARMOUTH NS,0,0,0,9,9
Tropical Storm,Hanna,9,2002-09-14T03:00:00Z,DAYTONA BEACH FL,0,2,0,0,2
Tropical Storm,Hanna,9,2002-09-14T03:00:00Z,HALIFAX NS,0,0,0,8,8
Tropical Storm,Hanna,9,2002-09-14T03:00:00Z,JACKSONVILLE FL,2,6,0,0,8
Tropical Storm,Hanna,9,2002-09-14T03:00:00Z,SABLE ISLAND NS,0,0,0,5,5
Tropical Storm,Hanna,9,2002-09-14T03:00:00Z,SAVANNAH GA,1,13,0,0,14
Tropical Storm,Hanna,9,2002-09-14T03:00:00Z,SYDNEY NS,0,0,0,5,5
Tropical Storm,Hanna,9,2002-09-14T03:00:00Z,CHARLESTON SC,0,12,2,0,14
Tropical Storm,Hanna,9,2002-09-14T03:00:00Z,EDDY POINT NS,0,0,0,6,6
Tropical Storm,Hanna,9,2002-09-14T03:00:00Z,MYRTLE BEACH SC,0,9,5,0,14
Tropical Storm,Hanna,9,2002-09-14T03:00:00Z,PTX BASQUES NFLD,0,0,0,3,3
Tropical Storm,Hanna,9,2002-09-14T03:00:00Z,WILMINGTON NC,0,6,7,0,13
Tropical Storm,Hanna,9,2002-09-14T03:00:00Z,BURGEO NFLD,0,0,0,2,2
Tropical Storm,Hanna,9,2002-09-14T03:00:00Z,MOREHEAD CITY NC,0,2,10,0,12
Tropical Storm,Hanna,9,2002-09-14T03:00:00Z,ILE ST PIERRE,0,0,0,2,2
Tropical Storm,Hanna,9,2002-09-14T03:00:00Z,CAPE HATTERAS NC,0,1,10,0,11
Tropical Storm,Hanna,9,2002-09-14T03:00:00Z,CEDAR KEY FL,2,2,0,0,4
Tropical Storm,Hanna,9,2002-09-14T03:00:00Z,NORFOLK VA,0,1,11,1,13
Tropical Storm,Hanna,9,2002-09-14T03:00:00Z,ST MARKS FL,16,2,0,0,18
Tropical Storm,Hanna,9,2002-09-14T03:00:00Z,OCEAN CITY MD,0,0,10,3,13
Tropical Storm,Hanna,9,2002-09-14T03:00:00Z,APALACHICOLA FL,20,0,0,0,20
Tropical Storm,Hanna,9,2002-09-14T03:00:00Z,ATLANTIC CITY NJ,0,0,7,5,12
Tropical Storm,Hanna,9,2002-09-14T03:00:00Z,PANAMA CITY FL,36,0,0,0,36
Tropical Storm,Hanna,9,2002-09-14T03:00:00Z,NEW YORK CITY NY,0,0,4,7,11
Tropical Storm,Hanna,9,2002-09-14T03:00:00Z,PENSACOLA FL,64,0,0,0,64
Tropical Storm,Hanna,9,2002-09-14T03:00:00Z,MONTAUK POINT NY,0,0,2,9,11
Tropical Storm,Hanna,9,2002-09-14T03:00:00Z,MOBILE AL,60,0,0,0,60
Tropical Storm,Hanna,9,2002-09-14T03:00:00Z,PROVIDENCE RI,0,0,1,10,11
Tropical Storm,Hanna,9,2002-09-14T03:00:00Z,GULFPORT MS,51,0,0,0,51
Tropical Storm,Hanna,9,2002-09-14T03:00:00Z,NANTUCKET MA,0,0,1,10,11
Tropical Storm,Hanna,9,2002-09-14T03:00:00Z,BURAS LA,66,0,0,0,66
Tropical Storm,Hanna,9,2002-09-14T03:00:00Z,HYANNIS MA,0,0,0,11,11
Tropical Storm,Hanna,9,2002-09-14T03:00:00Z,NEW ORLEANS LA,10,0,0,0,10
Tropical Storm,Hanna,9,2002-09-14T03:00:00Z,BOSTON MA,0,0,1,9,10
Tropical Storm,Hanna,9,2002-09-14T03:00:00Z,GULF 29N 85W,9,0,0,0,9
Tropical Storm,Hanna,9,2002-09-14T03:00:00Z,PORTLAND ME,0,0,0,10,10
Tropical Storm,Hanna,9,2002-09-14T03:00:00Z,GULF 29N 87W,61,0,0,0,61
Tropical Storm,Hanna,9,2002-09-14T03:00:00Z,BAR HARBOR ME,0,0,0,10,10
Tropical Storm,Hanna,9,2002-09-14T03:00:00Z,GULF 28N 89W,99,0,0,0,99
Tropical Storm,Hanna,9,2002-09-14T03:00:00Z,EASTPORT ME,0,0,0,9,9
Tropical Storm,Hanna,10,2002-09-14T09:00:00Z,33.5N  85.0W,32,1,0,0,33
Tropical Storm,Hanna,10,2002-09-14T09:00:00Z,NANTUCKET MA,0,0,2,0,2
Tropical Storm,Hanna,10,2002-09-14T09:00:00Z,36.0N  80.5W,0,19,2,0,21
Tropical Storm,Hanna,10,2002-09-14T09:00:00Z,HYANNIS MA,0,0,2,0,2
Tropical Storm,Hanna,10,2002-09-14T09:00:00Z,38.5N  74.5W,0,0,12,0,12
Tropical Storm,Hanna,10,2002-09-14T09:00:00Z,BOSTON MA,0,0,2,0,2
Tropical Storm,Hanna,10,2002-09-14T09:00:00Z,JACKSONVILLE FL,3,3,0,0,6
Tropical Storm,Hanna,10,2002-09-14T09:00:00Z,CEDAR KEY FL,1,1,0,0,2
Tropical Storm,Hanna,10,2002-09-14T09:00:00Z,SAVANNAH GA,3,11,0,0,14
Tropical Storm,Hanna,10,2002-09-14T09:00:00Z,ST MARKS FL,11,1,0,0,12
Tropical Storm,Hanna,10,2002-09-14T09:00:00Z,CHARLESTON SC,1,12,1,0,14
Tropical Storm,Hanna,10,2002-09-14T09:00:00Z,APALACHICOLA FL,9,1,0,0,10
Tropical Storm,Hanna,10,2002-09-14T09:00:00Z,MYRTLE BEACH SC,0,11,3,0,14
Tropical Storm,Hanna,10,2002-09-14T09:00:00Z,PANAMA CITY FL,23,0,0,0,23
Tropical Storm,Hanna,10,2002-09-14T09:00:00Z,WILMINGTON NC,0,8,6,0,14
Tropical Storm,Hanna,10,2002-09-14T09:00:00Z,PENSACOLA FL,72,0,0,0,72
Tropical Storm,Hanna,10,2002-09-14T09:00:00Z,MOREHEAD CITY NC,0,4,9,0,13
Tropical Storm,Hanna,10,2002-09-14T09:00:00Z,MOBILE AL,79,0,0,0,79
Tropical Storm,Hanna,10,2002-09-14T09:00:00Z,CAPE HATTERAS NC,0,2,10,0,12
Tropical Storm,Hanna,10,2002-09-14T09:00:00Z,GULFPORT MS,74,0,0,0,74
Tropical Storm,Hanna,10,2002-09-14T09:00:00Z,NORFOLK VA,0,2,13,0,15
Tropical Storm,Hanna,10,2002-09-14T09:00:00Z,BURAS LA,99,0,0,0,99
Tropical Storm,Hanna,10,2002-09-14T09:00:00Z,OCEAN CITY MD,0,1,13,0,14
Tropical Storm,Hanna,10,2002-09-14T09:00:00Z,NEW ORLEANS LA,2,0,0,0,2
Tropical Storm,Hanna,10,2002-09-14T09:00:00Z,ATLANTIC CITY NJ,0,0,12,0,12
Tropical Storm,Hanna,10,2002-09-14T09:00:00Z,GULF 29N 85W,2,1,0,0,3
Tropical Storm,Hanna,10,2002-09-14T09:00:00Z,NEW YORK CITY NY,0,0,9,0,9
Tropical Storm,Hanna,10,2002-09-14T09:00:00Z,GULF 29N 87W,25,0,0,0,25
Tropical Storm,Hanna,10,2002-09-14T09:00:00Z,MONTAUK POINT NY,0,0,5,0,5
Tropical Storm,Hanna,10,2002-09-14T09:00:00Z,GULF 28N 89W,99,0,0,0,99
Tropical Storm,Hanna,10,2002-09-14T09:00:00Z,PROVIDENCE RI,0,0,3,0,3
Tropical Storm,Hanna,11,2002-09-14T15:00:00Z,34.5N  84.0W,35,0,0,0,35
Tropical Storm,Hanna,11,2002-09-14T15:00:00Z,MONTAUK POINT NY,0,0,8,0,8
Tropical Storm,Hanna,11,2002-09-14T15:00:00Z,36.9N  80.0W,1,18,1,0,20
Tropical Storm,Hanna,11,2002-09-14T15:00:00Z,PROVIDENCE RI,0,0,7,0,7
Tropical Storm,Hanna,11,2002-09-14T15:00:00Z,40.0N  74.4W,0,1,12,0,13
Tropical Storm,Hanna,11,2002-09-14T15:00:00Z,NANTUCKET MA,0,0,5,0,5
Tropical Storm,Hanna,11,2002-09-14T15:00:00Z,JACKSONVILLE FL,2,2,0,0,4
Tropical Storm,Hanna,11,2002-09-14T15:00:00Z,HYANNIS MA,0,0,5,0,5
Tropical Storm,Hanna,11,2002-09-14T15:00:00Z,SAVANNAH GA,7,6,1,0,14
Tropical Storm,Hanna,11,2002-09-14T15:00:00Z,BOSTON MA,0,0,5,0,5
Tropical Storm,Hanna,11,2002-09-14T15:00:00Z,CHARLESTON SC,4,9,1,0,14
Tropical Storm,Hanna,11,2002-09-14T15:00:00Z,PORTLAND ME,0,0,3,0,3
Tropical Storm,Hanna,11,2002-09-14T15:00:00Z,MYRTLE BEACH SC,1,12,1,0,14
Tropical Storm,Hanna,11,2002-09-14T15:00:00Z,ST MARKS FL,5,0,0,0,5
Tropical Storm,Hanna,11,2002-09-14T15:00:00Z,WILMINGTON NC,0,11,3,0,14
Tropical Storm,Hanna,11,2002-09-14T15:00:00Z,APALACHICOLA FL,2,1,0,0,3
Tropical Storm,Hanna,11,2002-09-14T15:00:00Z,MOREHEAD CITY NC,0,7,6,0,13
Tropical Storm,Hanna,11,2002-09-14T15:00:00Z,PANAMA CITY FL,10,1,0,0,11
Tropical Storm,Hanna,11,2002-09-14T15:00:00Z,CAPE HATTERAS NC,0,4,8,0,12
Tropical Storm,Hanna,11,2002-09-14T15:00:00Z,PENSACOLA FL,83,0,0,0,83
Tropical Storm,Hanna,11,2002-09-14T15:00:00Z,NORFOLK VA,0,7,9,0,16
Tropical Storm,Hanna,11,2002-09-14T15:00:00Z,MOBILE AL,99,0,0,0,99
Tropical Storm,Hanna,11,2002-09-14T15:00:00Z,OCEAN CITY MD,0,3,12,0,15
Tropical Storm,Hanna,11,2002-09-14T15:00:00Z,GULFPORT MS,99,0,0,0,99
Tropical Storm,Hanna,11,2002-09-14T15:00:00Z,ATLANTIC CITY NJ,0,2,12,0,14
Tropical Storm,Hanna,11,2002-09-14T15:00:00Z,BURAS LA,99,0,0,0,99
Tropical Storm,Hanna,11,2002-09-14T15:00:00Z,NEW YORK CITY NY,0,1,11,0,12
Tropical Depression,Ten,1,2002-09-14T21:00:00Z,12.0N  67.5W,50,1,0,0,51
Tropical Depression,Ten,1,2002-09-14T21:00:00Z,MKJP 179N 768W,0,0,2,16,18
Tropical Depression,Ten,1,2002-09-14T21:00:00Z,13.5N  70.5W,1,33,1,0,35
Tropical Depression,Ten,1,2002-09-14T21:00:00Z,MKJS 185N 779W,0,0,0,16,16
Tropical Depression,Ten,1,2002-09-14T21:00:00Z,15.5N  73.0W,0,4,22,1,27
Tropical Depression,Ten,1,2002-09-14T21:00:00Z,MWCG 193N 814W,0,0,0,5,5
Tropical Depression,Ten,1,2002-09-14T21:00:00Z,SKPG 125N 717W,0,20,4,0,24
Tropical Depression,Ten,1,2002-09-14T21:00:00Z,MUGM 200N 751W,0,0,2,16,18
Tropical Depression,Ten,1,2002-09-14T21:00:00Z,TNCC 122N 690W,21,18,0,0,39
Tropical Depression,Ten,1,2002-09-14T21:00:00Z,MUCM 214N 779W,0,0,0,12,12
Tropical Depression,Ten,1,2002-09-14T21:00:00Z,SVMG 110N 640W,87,0,0,0,87
Tropical Depression,Ten,1,2002-09-14T21:00:00Z,MUCF 221N 805W,0,0,0,5,5
Tropical Depression,Ten,1,2002-09-14T21:00:00Z,TTPP 106N 614W,99,0,0,0,99
Tropical Depression,Ten,1,2002-09-14T21:00:00Z,MUSN 216N 826W,0,0,0,2,2
Tropical Depression,Ten,1,2002-09-14T21:00:00Z,TTPT 112N 608W,91,0,0,0,91
Tropical Depression,Ten,1,2002-09-14T21:00:00Z,MDPP 198N 707W,0,0,4,6,10
Tropical Depression,Ten,1,2002-09-14T21:00:00Z,TGPY 120N 618W,31,0,0,0,31
Tropical Depression,Ten,1,2002-09-14T21:00:00Z,MBJT 215N 712W,0,0,1,5,6
Tropical Depression,Ten,1,2002-09-14T21:00:00Z,MDSD 185N 697W,0,1,7,2,10
Tropical Depression,Ten,1,2002-09-14T21:00:00Z,MYMM 224N 730W,0,0,0,7,7
Tropical Depression,Ten,1,2002-09-14T21:00:00Z,MDCB 176N 714W,0,2,17,2,21
Tropical Depression,Ten,1,2002-09-14T21:00:00Z,MYSM 241N 745W,0,0,0,3,3
Tropical Depression,Ten,1,2002-09-14T21:00:00Z,MTPP 186N 724W,0,0,13,6,19
Tropical Depression,Ten,1,2002-09-14T21:00:00Z,MYEG 235N 758W,0,0,0,5,5
Tropical Depression,Ten,1,2002-09-14T21:00:00Z,MTCA 183N 738W,0,0,12,9,21
Tropical Depression,Ten,1,2002-09-14T21:00:00Z,MYAK 241N 776W,0,0,0,3,3
Tropical Depression,Ten,2,2002-09-15T03:00:00Z,12.5N  69.4W,50,1,0,0,51
Tropical Depression,Ten,2,2002-09-15T03:00:00Z,MUGM 200N 751W,0,0,8,11,19
Tropical Depression,Ten,2,2002-09-15T03:00:00Z,14.3N  72.2W,1,33,1,0,35
Tropical Depression,Ten,2,2002-09-15T03:00:00Z,MUCM 214N 779W,0,0,0,15,15
Tropical Depression,Ten,2,2002-09-15T03:00:00Z,16.5N  74.5W,0,4,22,1,27
Tropical Depression,Ten,2,2002-09-15T03:00:00Z,MUCF 221N 805W,0,0,0,9,9
Tropical Depression,Ten,2,2002-09-15T03:00:00Z,SKPG 125N 717W,6,24,0,1,31
Tropical Depression,Ten,2,2002-09-15T03:00:00Z,MUSN 216N 826W,0,0,0,4,4
Tropical Depression,Ten,2,2002-09-15T03:00:00Z,TNCC 122N 690W,54,0,0,0,54
Tropical Depression,Ten,2,2002-09-15T03:00:00Z,MUHA 230N 824W,0,0,0,3,3
Tropical Depression,Ten,2,2002-09-15T03:00:00Z,SVMG 110N 640W,99,0,0,0,99
Tropical Depression,Ten,2,2002-09-15T03:00:00Z,MDPP 198N 707W,0,0,4,3,7
Tropical Depression,Ten,2,2002-09-15T03:00:00Z,TTPP 106N 614W,18,0,0,0,18
Tropical Depression,Ten,2,2002-09-15T03:00:00Z,MBJT 215N 712W,0,0,1,3,4
Tropical Depression,Ten,2,2002-09-15T03:00:00Z,TGPY 120N 618W,17,0,0,0,17
Tropical Depression,Ten,2,2002-09-15T03:00:00Z,MYMM 224N 730W,0,0,1,6,7
Tropical Depression,Ten,2,2002-09-15T03:00:00Z,MDSD 185N 697W,0,2,3,1,6
Tropical Depression,Ten,2,2002-09-15T03:00:00Z,MYSM 241N 745W,0,0,0,3,3
Tropical Depression,Ten,2,2002-09-15T03:00:00Z,MDCB 176N 714W,0,10,10,0,20
Tropical Depression,Ten,2,2002-09-15T03:00:00Z,MYEG 235N 758W,0,0,0,7,7
Tropical Depression,Ten,2,2002-09-15T03:00:00Z,MTPP 186N 724W,0,2,15,2,19
Tropical Depression,Ten,2,2002-09-15T03:00:00Z,MYAK 241N 776W,0,0,0,5,5
Tropical Depression,Ten,2,2002-09-15T03:00:00Z,MTCA 183N 738W,0,1,20,2,23
Tropical Depression,Ten,2,2002-09-15T03:00:00Z,MYNN 251N 775W,0,0,0,2,2
Tropical Depression,Ten,2,2002-09-15T03:00:00Z,MKJP 179N 768W,0,0,11,10,21
Tropical Depression,Ten,2,2002-09-15T03:00:00Z,MARATHON FL,0,0,0,2,2
Tropical Depression,Ten,2,2002-09-15T03:00:00Z,MKJS 185N 779W,0,0,4,14,18
Tropical Depression,Ten,2,2002-09-15T03:00:00Z,KEY WEST FL,0,0,0,2,2
Tropical Depression,Ten,2,2002-09-15T03:00:00Z,MWCG 193N 814W,0,0,0,8,8
Tropical Depression,Ten,3,2002-09-15T09:00:00Z,13.4N  71.5W,48,2,0,0,50
Tropical Depression,Ten,3,2002-09-15T09:00:00Z,MUSN 216N 826W,0,0,0,13,13
Tropical Depression,Ten,3,2002-09-15T09:00:00Z,15.2N  74.6W,0,34,1,0,35
Tropical Depression,Ten,3,2002-09-15T09:00:00Z,MUHA 230N 824W,0,0,0,12,12
Tropical Depression,Ten,3,2002-09-15T09:00:00Z,16.9N  77.1W,0,6,20,1,27
Tropical Depression,Ten,3,2002-09-15T09:00:00Z,MUAN 219N 850W,0,0,0,6,6
Tropical Depression,Ten,3,2002-09-15T09:00:00Z,SKPG 125N 717W,39,1,0,0,40
Tropical Depression,Ten,3,2002-09-15T09:00:00Z,MYEG 235N 758W,0,0,0,5,5
Tropical Depression,Ten,3,2002-09-15T09:00:00Z,TNCC 122N 690W,64,0,0,0,64
Tropical Depression,Ten,3,2002-09-15T09:00:00Z,MYAK 241N 776W,0,0,0,7,7
Tropical Depression,Ten,3,2002-09-15T09:00:00Z,SVMG 110N 640W,99,0,0,0,99
Tropical Depression,Ten,3,2002-09-15T09:00:00Z,MYNN 251N 775W,0,0,0,4,4
Tropical Depression,Ten,3,2002-09-15T09:00:00Z,MDCB 176N 714W,0,8,1,1,10
Tropical Depression,Ten,3,2002-09-15T09:00:00Z,MYGF 266N 787W,0,0,0,2,2
Tropical Depression,Ten,3,2002-09-15T09:00:00Z,MTPP 186N 724W,0,5,4,0,9
Tropical Depression,Ten,3,2002-09-15T09:00:00Z,MARATHON FL,0,0,0,8,8
Tropical Depression,Ten,3,2002-09-15T09:00:00Z,MTCA 183N 738W,0,11,7,1,19
Tropical Depression,Ten,3,2002-09-15T09:00:00Z,MIAMI FL,0,0,0,4,4
Tropical Depression,Ten,3,2002-09-15T09:00:00Z,MKJP 179N 768W,0,4,21,1,26
Tropical Depression,Ten,3,2002-09-15T09:00:00Z,W PALM BEACH FL,0,0,0,2,2
Tropical Depression,Ten,3,2002-09-15T09:00:00Z,MKJS 185N 779W,0,0,21,3,24
Tropical Depression,Ten,3,2002-09-15T09:00:00Z,KEY WEST FL,0,0,0,8,8
Tropical Depression,Ten,3,2002-09-15T09:00:00Z,MWCG 193N 814W,0,0,2,15,17
Tropical Depression,Ten,3,2002-09-15T09:00:00Z,MARCO ISLAND FL,0,0,0,4,4
Tropical Depression,Ten,3,2002-09-15T09:00:00Z,MUGM 200N 751W,0,1,11,3,15
Tropical Depression,Ten,3,2002-09-15T09:00:00Z,FT MYERS FL,0,0,0,3,3
Tropical Depression,Ten,3,2002-09-15T09:00:00Z,MUCM 214N 779W,0,0,5,11,16
Tropical Depression,Ten,3,2002-09-15T09:00:00Z,VENICE FL,0,0,0,2,2
Tropical Depression,Ten,3,2002-09-15T09:00:00Z,MUCF 221N 805W,0,0,1,15,16
Tropical Depression,Ten,4,2002-09-15T15:00:00Z,14.5N  73.7W,49,1,0,0,50
Tropical Depression,Ten,4,2002-09-15T15:00:00Z,MUAN 219N 850W,0,0,0,8,8
Tropical Depression,Ten,4,2002-09-15T15:00:00Z,16.2N  76.5W,1,35,0,0,36
Tropical Depression,Ten,4,2002-09-15T15:00:00Z,MMCZ 205N 869W,0,0,0,3,3
Tropical Depression,Ten,4,2002-09-15T15:00:00Z,17.5N  78.5W,0,15,12,1,28
Tropical Depression,Ten,4,2002-09-15T15:00:00Z,MHNJ 165N 859W,0,0,0,2,2
Tropical Depression,Ten,4,2002-09-15T15:00:00Z,SKPG 125N 717W,45,0,0,0,45
Tropical Depression,Ten,4,2002-09-15T15:00:00Z,MNPC 141N 834W,0,0,0,2,2
Tropical Depression,Ten,4,2002-09-15T15:00:00Z,TNCC 122N 690W,77,0,0,0,77
Tropical Depression,Ten,4,2002-09-15T15:00:00Z,MYEG 235N 758W,0,0,0,3,3
Tropical Depression,Ten,4,2002-09-15T15:00:00Z,MDCB 176N 714W,2,1,0,0,3
Tropical Depression,Ten,4,2002-09-15T15:00:00Z,MYAK 241N 776W,0,0,0,6,6
Tropical Depression,Ten,4,2002-09-15T15:00:00Z,MTPP 186N 724W,0,3,0,1,4
Tropical Depression,Ten,4,2002-09-15T15:00:00Z,MYNN 251N 775W,0,0,0,3,3
Tropical Depression,Ten,4,2002-09-15T15:00:00Z,MTCA 183N 738W,0,13,1,0,14
Tropical Depression,Ten,4,2002-09-15T15:00:00Z,MYGF 266N 787W,0,0,0,2,2
Tropical Depression,Ten,4,2002-09-15T15:00:00Z,MKJP 179N 768W,0,25,4,1,30
Tropical Depression,Ten,4,2002-09-15T15:00:00Z,MARATHON FL,0,0,0,8,8
Tropical Depression,Ten,4,2002-09-15T15:00:00Z,MKJS 185N 779W,0,12,14,1,27
Tropical Depression,Ten,4,2002-09-15T15:00:00Z,MIAMI FL,0,0,0,5,5
Tropical Depression,Ten,4,2002-09-15T15:00:00Z,MWCG 193N 814W,0,0,10,10,20
Tropical Depression,Ten,4,2002-09-15T15:00:00Z,W PALM BEACH FL,0,0,0,3,3
Tropical Depression,Ten,4,2002-09-15T15:00:00Z,MUGM 200N 751W,0,3,6,3,12
Tropical Depression,Ten,4,2002-09-15T15:00:00Z,KEY WEST FL,0,0,0,9,9
Tropical Depression,Ten,4,2002-09-15T15:00:00Z,MUCM 214N 779W,0,0,8,8,16
Tropical Depression,Ten,4,2002-09-15T15:00:00Z,MARCO ISLAND FL,0,0,0,5,5
Tropical Depression,Ten,4,2002-09-15T15:00:00Z,MUCF 221N 805W,0,0,3,13,16
Tropical Depression,Ten,4,2002-09-15T15:00:00Z,FT MYERS FL,0,0,0,3,3
Tropical Depression,Ten,4,2002-09-15T15:00:00Z,MUSN 216N 826W,0,0,1,14,15
Tropical Depression,Ten,4,2002-09-15T15:00:00Z,VENICE FL,0,0,0,2,2
Tropical Depression,Ten,4,2002-09-15T15:00:00Z,MUHA 230N 824W,0,0,0,13,13
Tropical Depression,Ten,6,2002-09-17T15:00:00Z,17.0N  80.0W,45,0,0,0,45
Tropical Depression,Ten,6,2002-09-17T15:00:00Z,MNPC 141N 834W,0,1,1,1,3
Tropical Depression,Ten,6,2002-09-17T15:00:00Z,18.0N  81.5W,19,13,0,0,32
Tropical Depression,Ten,6,2002-09-17T15:00:00Z,MMMD 210N 897W,0,0,0,7,7
Tropical Depression,Ten,6,2002-09-17T15:00:00Z,19.0N  83.0W,0,21,5,1,27
Tropical Depression,Ten,6,2002-09-17T15:00:00Z,MARATHON FL,0,0,1,7,8
Tropical Depression,Ten,6,2002-09-17T15:00:00Z,MKJP 179N 768W,15,0,0,0,15
Tropical Depression,Ten,6,2002-09-17T15:00:00Z,MIAMI FL,0,0,0,3,3
Tropical Depression,Ten,6,2002-09-17T15:00:00Z,MKJS 185N 779W,19,0,0,0,19
Tropical Depression,Ten,6,2002-09-17T15:00:00Z,W PALM BEACH FL,0,0,0,2,2
Tropical Depression,Ten,6,2002-09-17T15:00:00Z,MWCG 193N 814W,5,23,1,0,29
Tropical Depression,Ten,6,2002-09-17T15:00:00Z,KEY WEST FL,0,0,2,8,10
Tropical Depression,Ten,6,2002-09-17T15:00:00Z,MUCM 214N 779W,0,1,1,2,4
Tropical Depression,Ten,6,2002-09-17T15:00:00Z,MARCO ISLAND FL,0,0,0,6,6
Tropical Depression,Ten,6,2002-09-17T15:00:00Z,MUCF 221N 805W,0,4,6,4,14
Tropical Depression,Ten,6,2002-09-17T15:00:00Z,FT MYERS FL,0,0,0,5,5
Tropical Depression,Ten,6,2002-09-17T15:00:00Z,MUSN 216N 826W,0,5,13,3,21
Tropical Depression,Ten,6,2002-09-17T15:00:00Z,VENICE FL,0,0,0,4,4
Tropical Depression,Ten,6,2002-09-17T15:00:00Z,MUHA 230N 824W,0,1,8,8,17
Tropical Depression,Ten,6,2002-09-17T15:00:00Z,TAMPA FL,0,0,0,2,2
Tropical Depression,Ten,6,2002-09-17T15:00:00Z,MUAN 219N 850W,0,0,12,9,21
Tropical Depression,Ten,6,2002-09-17T15:00:00Z,GULF 29N 85W,0,0,0,2,2
Tropical Depression,Ten,6,2002-09-17T15:00:00Z,MMCZ 205N 869W,0,0,5,11,16
Tropical Depression,Ten,6,2002-09-17T15:00:00Z,GULF 29N 87W,0,0,0,3,3
Tropical Depression,Ten,6,2002-09-17T15:00:00Z,MZBZ 175N 883W,0,0,1,3,4
Tropical Depression,Ten,6,2002-09-17T15:00:00Z,GULF 28N 89W,0,0,0,3,3
Tropical Depression,Ten,6,2002-09-17T15:00:00Z,MHNJ 165N 859W,0,0,5,4,9
Tropical Depression,Ten,7,2002-09-17T21:00:00Z,17.6N  80.0W,45,0,0,0,45
Tropical Depression,Ten,7,2002-09-17T21:00:00Z,DAYTONA BEACH FL,0,0,0,2,2
Tropical Depression,Ten,7,2002-09-17T21:00:00Z,18.7N  81.4W,20,11,0,1,32
Tropical Depression,Ten,7,2002-09-17T21:00:00Z,KEY WEST FL,0,0,5,10,15
Tropical Depression,Ten,7,2002-09-17T21:00:00Z,20.0N  83.0W,0,20,7,1,28
Tropical Depression,Ten,7,2002-09-17T21:00:00Z,MARCO ISLAND FL,0,0,1,10,11
Tropical Depression,Ten,7,2002-09-17T21:00:00Z,MKJP 179N 768W,21,0,1,0,22
Tropical Depression,Ten,7,2002-09-17T21:00:00Z,FT MYERS FL,0,0,0,10,10
Tropical Depression,Ten,7,2002-09-17T21:00:00Z,MKJS 185N 779W,28,0,0,0,28
Tropical Depression,Ten,7,2002-09-17T21:00:00Z,VENICE FL,0,0,0,10,10
Tropical Depression,Ten,7,2002-09-17T21:00:00Z,MWCG 193N 814W,12,18,1,0,31
Tropical Depression,Ten,7,2002-09-17T21:00:00Z,TAMPA FL,0,0,0,7,7
Tropical Depression,Ten,7,2002-09-17T21:00:00Z,MUCM 214N 779W,0,4,2,2,8
Tropical Depression,Ten,7,2002-09-17T21:00:00Z,CEDAR KEY FL,0,0,0,5,5
Tropical Depression,Ten,7,2002-09-17T21:00:00Z,MUCF 221N 805W,0,8,8,3,19
Tropical Depression,Ten,7,2002-09-17T21:00:00Z,ST MARKS FL,0,0,0,3,3
Tropical Depression,Ten,7,2002-09-17T21:00:00Z,MUSN 216N 826W,0,11,13,2,26
Tropical Depression,Ten,7,2002-09-17T21:00:00Z,APALACHICOLA FL,0,0,0,5,5
Tropical Depression,Ten,7,2002-09-17T21:00:00Z,MUHA 230N 824W,0,2,14,5,21
Tropical Depression,Ten,7,2002-09-17T21:00:00Z,PANAMA CITY FL,0,0,0,5,5
Tropical Depression,Ten,7,2002-09-17T21:00:00Z,MUAN 219N 850W,0,1,16,5,22
Tropical Depression,Ten,7,2002-09-17T21:00:00Z,PENSACOLA FL,0,0,0,3,3
Tropical Depression,Ten,7,2002-09-17T21:00:00Z,MMCZ 205N 869W,0,0,6,6,12
Tropical Depression,Ten,7,2002-09-17T21:00:00Z,MOBILE AL,0,0,0,3,3
Tropical Depression,Ten,7,2002-09-17T21:00:00Z,MHNJ 165N 859W,0,0,1,1,2
Tropical Depression,Ten,7,2002-09-17T21:00:00Z,GULFPORT MS,0,0,0,2,2
Tropical Depression,Ten,7,2002-09-17T21:00:00Z,MYAK 241N 776W,0,0,0,2,2
Tropical Depression,Ten,7,2002-09-17T21:00:00Z,BURAS LA,0,0,0,3,3
Tropical Depression,Ten,7,2002-09-17T21:00:00Z,MMMD 210N 897W,0,0,0,2,2
Tropical Depression,Ten,7,2002-09-17T21:00:00Z,NEW ORLEANS LA,0,0,0,2,2
Tropical Depression,Ten,7,2002-09-17T21:00:00Z,MARATHON FL,0,0,3,10,13
Tropical Depression,Ten,7,2002-09-17T21:00:00Z,GULF 29N 85W,0,0,0,8,8
Tropical Depression,Ten,7,2002-09-17T21:00:00Z,MIAMI FL,0,0,0,7,7
Tropical Depression,Ten,7,2002-09-17T21:00:00Z,GULF 29N 87W,0,0,0,8,8
Tropical Depression,Ten,7,2002-09-17T21:00:00Z,W PALM BEACH FL,0,0,0,4,4
Tropical Depression,Ten,7,2002-09-17T21:00:00Z,GULF 28N 89W,0,0,0,7,7
Tropical Depression,Ten,7,2002-09-17T21:00:00Z,FT PIERCE FL,0,0,0,3,3
Tropical Depression,Ten,7,2002-09-17T21:00:00Z,GULF 28N 91W,0,0,0,2,2
Tropical Depression,Ten,7,2002-09-17T21:00:00Z,COCOA BEACH FL,0,0,0,2,2
Tropical Depression,Ten,8,2002-09-18T03:00:00Z,18.9N  80.0W,55,0,0,0,55
Tropical Depression,Ten,8,2002-09-18T03:00:00Z,FT PIERCE FL,0,0,0,5,5
Tropical Depression,Ten,8,2002-09-18T03:00:00Z,20.0N  81.0W,30,10,0,0,40
Tropical Depression,Ten,8,2002-09-18T03:00:00Z,COCOA BEACH FL,0,0,0,4,4
Tropical Depression,Ten,8,2002-09-18T03:00:00Z,21.5N  82.5W,0,23,10,1,34
Tropical Depression,Ten,8,2002-09-18T03:00:00Z,DAYTONA BEACH FL,0,0,0,3,3
Tropical Depression,Ten,8,2002-09-18T03:00:00Z,MKJP 179N 768W,48,0,0,0,48
Tropical Depression,Ten,8,2002-09-18T03:00:00Z,JACKSONVILLE FL,0,0,0,2,2
Tropical Depression,Ten,8,2002-09-18T03:00:00Z,MKJS 185N 779W,56,0,0,0,56
Tropical Depression,Ten,8,2002-09-18T03:00:00Z,KEY WEST FL,0,1,14,4,19
Tropical Depression,Ten,8,2002-09-18T03:00:00Z,MWCG 193N 814W,31,6,0,0,37
Tropical Depression,Ten,8,2002-09-18T03:00:00Z,MARCO ISLAND FL,0,0,4,10,14
Tropical Depression,Ten,8,2002-09-18T03:00:00Z,MUCM 214N 779W,4,4,1,1,10
Tropical Depression,Ten,8,2002-09-18T03:00:00Z,FT MYERS FL,0,0,2,10,12
Tropical Depression,Ten,8,2002-09-18T03:00:00Z,MUCF 221N 805W,1,21,4,1,27
Tropical Depression,Ten,8,2002-09-18T03:00:00Z,VENICE FL,0,0,1,11,12
Tropical Depression,Ten,8,2002-09-18T03:00:00Z,MUSN 216N 826W,0,21,12,0,33
Tropical Depression,Ten,8,2002-09-18T03:00:00Z,TAMPA FL,0,0,0,9,9
Tropical Depression,Ten,8,2002-09-18T03:00:00Z,MUHA 230N 824W,0,8,19,2,29
Tropical Depression,Ten,8,2002-09-18T03:00:00Z,CEDAR KEY FL,0,0,0,6,6
Tropical Depression,Ten,8,2002-09-18T03:00:00Z,MUAN 219N 850W,0,1,16,5,22
Tropical Depression,Ten,8,2002-09-18T03:00:00Z,ST MARKS FL,0,0,0,4,4
Tropical Depression,Ten,8,2002-09-18T03:00:00Z,MMCZ 205N 869W,0,0,3,8,11
Tropical Depression,Ten,8,2002-09-18T03:00:00Z,APALACHICOLA FL,0,0,0,5,5
Tropical Depression,Ten,8,2002-09-18T03:00:00Z,MHNJ 165N 859W,0,0,0,2,2
Tropical Depression,Ten,8,2002-09-18T03:00:00Z,PANAMA CITY FL,0,0,0,5,5
Tropical Depression,Ten,8,2002-09-18T03:00:00Z,MYAK 241N 776W,0,0,1,1,2
Tropical Depression,Ten,8,2002-09-18T03:00:00Z,PENSACOLA FL,0,0,0,3,3
Tropical Depression,Ten,8,2002-09-18T03:00:00Z,MYNN 251N 775W,0,0,0,2,2
Tropical Depression,Ten,8,2002-09-18T03:00:00Z,MOBILE AL,0,0,0,2,2
Tropical Depression,Ten,8,2002-09-18T03:00:00Z,MYGF 266N 787W,0,0,0,3,3
Tropical Depression,Ten,8,2002-09-18T03:00:00Z,BURAS LA,0,0,0,2,2
Tropical Depression,Ten,8,2002-09-18T03:00:00Z,MMMD 210N 897W,0,0,0,3,3
Tropical Depression,Ten,8,2002-09-18T03:00:00Z,GULF 29N 85W,0,0,0,7,7
Tropical Depression,Ten,8,2002-09-18T03:00:00Z,MARATHON FL,0,1,10,5,16
Tropical Depression,Ten,8,2002-09-18T03:00:00Z,GULF 29N 87W,0,0,0,6,6
Tropical Depression,Ten,8,2002-09-18T03:00:00Z,MIAMI FL,0,0,3,7,10
Tropical Depression,Ten,8,2002-09-18T03:00:00Z,GULF 28N 89W,0,0,0,4,4
Tropical Depression,Ten,8,2002-09-18T03:00:00Z,W PALM BEACH FL,0,0,1,5,6
Tropical Storm,Isidore,9,2002-09-18T09:00:00Z,19.2N  80.3W,52,0,0,0,52
Tropical Storm,Isidore,9,2002-09-18T09:00:00Z,W PALM BEACH FL,0,0,1,4,5
Tropical Storm,Isidore,9,2002-09-18T09:00:00Z,20.5N  81.7W,21,15,0,0,36
Tropical Storm,Isidore,9,2002-09-18T09:00:00Z,FT PIERCE FL,0,0,0,4,4
Tropical Storm,Isidore,9,2002-09-18T09:00:00Z,21.6N  82.9W,1,26,2,0,29
Tropical Storm,Isidore,9,2002-09-18T09:00:00Z,COCOA BEACH FL,0,0,0,3,3
Tropical Storm,Isidore,9,2002-09-18T09:00:00Z,MKJP 179N 768W,29,0,0,0,29
Tropical Storm,Isidore,9,2002-09-18T09:00:00Z,DAYTONA BEACH FL,0,0,0,2,2
Tropical Storm,Isidore,9,2002-09-18T09:00:00Z,MKJS 185N 779W,57,0,0,1,58
Tropical Storm,Isidore,9,2002-09-18T09:00:00Z,KEY WEST FL,0,3,10,4,17
Tropical Storm,Isidore,9,2002-09-18T09:00:00Z,MWCG 193N 814W,37,1,0,0,38
Tropical Storm,Isidore,9,2002-09-18T09:00:00Z,MARCO ISLAND FL,0,0,4,8,12
Tropical Storm,Isidore,9,2002-09-18T09:00:00Z,MUCM 214N 779W,3,4,0,1,8
Tropical Storm,Isidore,9,2002-09-18T09:00:00Z,FT MYERS FL,0,0,2,8,10
Tropical Storm,Isidore,9,2002-09-18T09:00:00Z,MUCF 221N 805W,4,18,1,1,24
Tropical Storm,Isidore,9,2002-09-18T09:00:00Z,VENICE FL,0,0,1,9,10
Tropical Storm,Isidore,9,2002-09-18T09:00:00Z,MUSN 216N 826W,2,26,2,0,30
Tropical Storm,Isidore,9,2002-09-18T09:00:00Z,TAMPA FL,0,0,0,7,7
Tropical Storm,Isidore,9,2002-09-18T09:00:00Z,MUHA 230N 824W,0,16,7,2,25
Tropical Storm,Isidore,9,2002-09-18T09:00:00Z,CEDAR KEY FL,0,0,0,4,4
Tropical Storm,Isidore,9,2002-09-18T09:00:00Z,MUAN 219N 850W,0,7,11,4,22
Tropical Storm,Isidore,9,2002-09-18T09:00:00Z,ST MARKS FL,0,0,0,3,3
Tropical Storm,Isidore,9,2002-09-18T09:00:00Z,MMCZ 205N 869W,0,0,5,7,12
Tropical Storm,Isidore,9,2002-09-18T09:00:00Z,APALACHICOLA FL,0,0,0,4,4
Tropical Storm,Isidore,9,2002-09-18T09:00:00Z,MYAK 241N 776W,0,0,1,1,2
Tropical Storm,Isidore,9,2002-09-18T09:00:00Z,PANAMA CITY FL,0,0,0,3,3
Tropical Storm,Isidore,9,2002-09-18T09:00:00Z,MYGF 266N 787W,0,0,0,2,2
Tropical Storm,Isidore,9,2002-09-18T09:00:00Z,PENSACOLA FL,0,0,0,2,2
Tropical Storm,Isidore,9,2002-09-18T09:00:00Z,MMMD 210N 897W,0,0,0,4,4
Tropical Storm,Isidore,9,2002-09-18T09:00:00Z,GULF 29N 85W,0,0,0,6,6
Tropical Storm,Isidore,9,2002-09-18T09:00:00Z,MARATHON FL,0,2,7,5,14
Tropical Storm,Isidore,9,2002-09-18T09:00:00Z,GULF 29N 87W,0,0,0,5,5
Tropical Storm,Isidore,9,2002-09-18T09:00:00Z,MIAMI FL,0,0,2,6,8
Tropical Storm,Isidore,9,2002-09-18T09:00:00Z,GULF 28N 89W,0,0,0,4,4
Tropical Storm,Isidore,10,2002-09-18T15:00:00Z,19.9N  80.8W,54,0,0,0,54
Tropical Storm,Isidore,10,2002-09-18T15:00:00Z,DAYTONA BEACH FL,0,0,0,4,4
Tropical Storm,Isidore,10,2002-09-18T15:00:00Z,21.1N  82.1W,25,12,0,1,38
Tropical Storm,Isidore,10,2002-09-18T15:00:00Z,JACKSONVILLE FL,0,0,0,3,3
Tropical Storm,Isidore,10,2002-09-18T15:00:00Z,22.5N  83.5W,0,24,7,0,31
Tropical Storm,Isidore,10,2002-09-18T15:00:00Z,KEY WEST FL,0,8,11,3,22
Tropical Storm,Isidore,10,2002-09-18T15:00:00Z,MKJP 179N 768W,2,0,0,0,2
Tropical Storm,Isidore,10,2002-09-18T15:00:00Z,MARCO ISLAND FL,0,1,8,6,15
Tropical Storm,Isidore,10,2002-09-18T15:00:00Z,MKJS 185N 779W,99,0,0,0,99
Tropical Storm,Isidore,10,2002-09-18T15:00:00Z,FT MYERS FL,0,0,6,7,13
Tropical Storm,Isidore,10,2002-09-18T15:00:00Z,MWCG 193N 814W,42,0,0,0,42
Tropical Storm,Isidore,10,2002-09-18T15:00:00Z,VENICE FL,0,0,4,9,13
Tropical Storm,Isidore,10,2002-09-18T15:00:00Z,MUCM 214N 779W,4,2,0,1,7
Tropical Storm,Isidore,10,2002-09-18T15:00:00Z,TAMPA FL,0,0,1,9,10
Tropical Storm,Isidore,10,2002-09-18T15:00:00Z,MUCF 221N 805W,18,9,1,0,28
Tropical Storm,Isidore,10,2002-09-18T15:00:00Z,CEDAR KEY FL,0,0,0,8,8
Tropical Storm,Isidore,10,2002-09-18T15:00:00Z,MUSN 216N 826W,10,24,0,1,35
Tropical Storm,Isidore,10,2002-09-18T15:00:00Z,ST MARKS FL,0,0,0,6,6
Tropical Storm,Isidore,10,2002-09-18T15:00:00Z,MUHA 230N 824W,1,25,4,1,31
Tropical Storm,Isidore,10,2002-09-18T15:00:00Z,APALACHICOLA FL,0,0,0,7,7
Tropical Storm,Isidore,10,2002-09-18T15:00:00Z,MUAN 219N 850W,0,9,12,3,24
Tropical Storm,Isidore,10,2002-09-18T15:00:00Z,PANAMA CITY FL,0,0,0,6,6
Tropical Storm,Isidore,10,2002-09-18T15:00:00Z,MMCZ 205N 869W,0,0,3,8,11
Tropical Storm,Isidore,10,2002-09-18T15:00:00Z,PENSACOLA FL,0,0,0,4,4
Tropical Storm,Isidore,10,2002-09-18T15:00:00Z,MYGF 266N 787W,0,0,0,2,2
Tropical Storm,Isidore,10,2002-09-18T15:00:00Z,MOBILE AL,0,0,0,2,2
Tropical Storm,Isidore,10,2002-09-18T15:00:00Z,MMMD 210N 897W,0,0,0,3,3
Tropical Storm,Isidore,10,2002-09-18T15:00:00Z,GULFPORT MS,0,0,0,2,2
Tropical Storm,Isidore,10,2002-09-18T15:00:00Z,MARATHON FL,0,5,9,3,17
Tropical Storm,Isidore,10,2002-09-18T15:00:00Z,BURAS LA,0,0,0,3,3
Tropical Storm,Isidore,10,2002-09-18T15:00:00Z,MIAMI FL,0,0,4,5,9
Tropical Storm,Isidore,10,2002-09-18T15:00:00Z,GULF 29N 85W,0,0,0,10,10
Tropical Storm,Isidore,10,2002-09-18T15:00:00Z,W PALM BEACH FL,0,0,1,6,7
Tropical Storm,Isidore,10,2002-09-18T15:00:00Z,GULF 29N 87W,0,0,0,8,8
Tropical Storm,Isidore,10,2002-09-18T15:00:00Z,FT PIERCE FL,0,0,1,5,6
Tropical Storm,Isidore,10,2002-09-18T15:00:00Z,GULF 28N 89W,0,0,0,6,6
Tropical Storm,Isidore,10,2002-09-18T15:00:00Z,COCOA BEACH FL,0,0,0,5,5
Tropical Storm,Isidore,10,2002-09-18T15:00:00Z,GULF 28N 91W,0,0,0,2,2
Tropical Storm,Isidore,11,2002-09-18T21:00:00Z,21.3N  81.1W,57,0,0,0,57
Tropical Storm,Isidore,11,2002-09-18T21:00:00Z,JACKSONVILLE FL,0,0,0,2,2
Tropical Storm,Isidore,11,2002-09-18T21:00:00Z,22.4N  82.7W,24,14,0,0,38
Tropical Storm,Isidore,11,2002-09-18T21:00:00Z,KEY WEST FL,2,16,2,2,22
Tropical Storm,Isidore,11,2002-09-18T21:00:00Z,23.3N  84.0W,1,24,2,1,28
Tropical Storm,Isidore,11,2002-09-18T21:00:00Z,MARCO ISLAND FL,0,4,6,4,14
Tropical Storm,Isidore,11,2002-09-18T21:00:00Z,MKJS 185N 779W,99,0,0,0,99
Tropical Storm,Isidore,11,2002-09-18T21:00:00Z,FT MYERS FL,0,2,6,4,12
Tropical Storm,Isidore,11,2002-09-18T21:00:00Z,MWCG 193N 814W,27,0,0,0,27
Tropical Storm,Isidore,11,2002-09-18T21:00:00Z,VENICE FL,0,1,6,5,12
Tropical Storm,Isidore,11,2002-09-18T21:00:00Z,MUCM 214N 779W,15,0,0,0,15
Tropical Storm,Isidore,11,2002-09-18T21:00:00Z,TAMPA FL,0,0,3,6,9
Tropical Storm,Isidore,11,2002-09-18T21:00:00Z,MUCF 221N 805W,45,0,0,0,45
Tropical Storm,Isidore,11,2002-09-18T21:00:00Z,CEDAR KEY FL,0,0,1,6,7
Tropical Storm,Isidore,11,2002-09-18T21:00:00Z,MUSN 216N 826W,34,5,0,0,39
Tropical Storm,Isidore,11,2002-09-18T21:00:00Z,ST MARKS FL,0,0,0,5,5
Tropical Storm,Isidore,11,2002-09-18T21:00:00Z,MUHA 230N 824W,18,17,0,0,35
Tropical Storm,Isidore,11,2002-09-18T21:00:00Z,APALACHICOLA FL,0,0,1,6,7
Tropical Storm,Isidore,11,2002-09-18T21:00:00Z,MUAN 219N 850W,0,15,4,2,21
Tropical Storm,Isidore,11,2002-09-18T21:00:00Z,PANAMA CITY FL,0,0,0,6,6
Tropical Storm,Isidore,11,2002-09-18T21:00:00Z,MMCZ 205N 869W,0,0,4,6,10
Tropical Storm,Isidore,11,2002-09-18T21:00:00Z,PENSACOLA FL,0,0,0,5,5
Tropical Storm,Isidore,11,2002-09-18T21:00:00Z,MYAK 241N 776W,0,0,0,2,2
Tropical Storm,Isidore,11,2002-09-18T21:00:00Z,MOBILE AL,0,0,0,4,4
Tropical Storm,Isidore,11,2002-09-18T21:00:00Z,MYGF 266N 787W,0,0,0,2,2
Tropical Storm,Isidore,11,2002-09-18T21:00:00Z,GULFPORT MS,0,0,0,4,4
Tropical Storm,Isidore,11,2002-09-18T21:00:00Z,MMMD 210N 897W,0,0,0,5,5
Tropical Storm,Isidore,11,2002-09-18T21:00:00Z,BURAS LA,0,0,0,5,5
Tropical Storm,Isidore,11,2002-09-18T21:00:00Z,MARATHON FL,1,12,2,2,17
Tropical Storm,Isidore,11,2002-09-18T21:00:00Z,NEW ORLEANS LA,0,0,0,3,3
Tropical Storm,Isidore,11,2002-09-18T21:00:00Z,MIAMI FL,0,2,3,4,9
Tropical Storm,Isidore,11,2002-09-18T21:00:00Z,NEW IBERIA LA,0,0,0,2,2
Tropical Storm,Isidore,11,2002-09-18T21:00:00Z,W PALM BEACH FL,0,0,2,4,6
Tropical Storm,Isidore,11,2002-09-18T21:00:00Z,GULF 29N 85W,0,0,1,8,9
Tropical Storm,Isidore,11,2002-09-18T21:00:00Z,FT PIERCE FL,0,0,1,4,5
Tropical Storm,Isidore,11,2002-09-18T21:00:00Z,GULF 29N 87W,0,0,1,8,9
Tropical Storm,Isidore,11,2002-09-18T21:00:00Z,COCOA BEACH FL,0,0,1,3,4
Tropical Storm,Isidore,11,2002-09-18T21:00:00Z,GULF 28N 89W,0,0,0,9,9
Tropical Storm,Isidore,11,2002-09-18T21:00:00Z,DAYTONA BEACH FL,0,0,0,3,3
Tropical Storm,Isidore,11,2002-09-18T21:00:00Z,GULF 28N 91W,0,0,0,5,5
Tropical Storm,Isidore,12,2002-09-19T03:00:00Z,22.0N  82.0W,44,0,0,0,44
Tropical Storm,Isidore,12,2002-09-19T03:00:00Z,JACKSONVILLE FL,0,0,0,2,2
Tropical Storm,Isidore,12,2002-09-19T03:00:00Z,23.0N  83.5W,21,6,1,0,28
Tropical Storm,Isidore,12,2002-09-19T03:00:00Z,KEY WEST FL,9,11,1,2,23
Tropical Storm,Isidore,12,2002-09-19T03:00:00Z,23.5N  84.5W,6,16,1,1,24
Tropical Storm,Isidore,12,2002-09-19T03:00:00Z,MARCO ISLAND FL,0,7,4,4,15
Tropical Storm,Isidore,12,2002-09-19T03:00:00Z,MWCG 193N 814W,10,0,1,0,11
Tropical Storm,Isidore,12,2002-09-19T03:00:00Z,FT MYERS FL,0,3,5,5,13
Tropical Storm,Isidore,12,2002-09-19T03:00:00Z,MUCM 214N 779W,10,1,0,0,11
Tropical Storm,Isidore,12,2002-09-19T03:00:00Z,VENICE FL,0,2,5,6,13
Tropical Storm,Isidore,12,2002-09-19T03:00:00Z,MUCF 221N 805W,50,0,0,0,50
Tropical Storm,Isidore,12,2002-09-19T03:00:00Z,TAMPA FL,0,0,3,6,9
Tropical Storm,Isidore,12,2002-09-19T03:00:00Z,MUSN 216N 826W,34,0,0,1,35
Tropical Storm,Isidore,12,2002-09-19T03:00:00Z,CEDAR KEY FL,0,0,1,5,6
Tropical Storm,Isidore,12,2002-09-19T03:00:00Z,MUHA 230N 824W,33,1,0,0,34
Tropical Storm,Isidore,12,2002-09-19T03:00:00Z,ST MARKS FL,0,0,0,4,4
Tropical Storm,Isidore,12,2002-09-19T03:00:00Z,MUAN 219N 850W,5,9,1,2,17
Tropical Storm,Isidore,12,2002-09-19T03:00:00Z,APALACHICOLA FL,0,0,0,6,6
Tropical Storm,Isidore,12,2002-09-19T03:00:00Z,MMCZ 205N 869W,0,1,1,4,6
Tropical Storm,Isidore,12,2002-09-19T03:00:00Z,PANAMA CITY FL,0,0,0,5,5
Tropical Storm,Isidore,12,2002-09-19T03:00:00Z,MYAK 241N 776W,0,1,1,2,4
Tropical Storm,Isidore,12,2002-09-19T03:00:00Z,PENSACOLA FL,0,0,0,4,4
Tropical Storm,Isidore,12,2002-09-19T03:00:00Z,MYNN 251N 775W,0,1,1,1,3
Tropical Storm,Isidore,12,2002-09-19T03:00:00Z,MOBILE AL,0,0,0,3,3
Tropical Storm,Isidore,12,2002-09-19T03:00:00Z,MYGF 266N 787W,0,0,2,3,5
Tropical Storm,Isidore,12,2002-09-19T03:00:00Z,GULFPORT MS,0,0,0,3,3
Tropical Storm,Isidore,12,2002-09-19T03:00:00Z,MMMD 210N 897W,0,0,0,4,4
Tropical Storm,Isidore,12,2002-09-19T03:00:00Z,BURAS LA,0,0,0,5,5
Tropical Storm,Isidore,12,2002-09-19T03:00:00Z,MARATHON FL,6,10,2,1,19
Tropical Storm,Isidore,12,2002-09-19T03:00:00Z,NEW ORLEANS LA,0,0,0,3,3
Tropical Storm,Isidore,12,2002-09-19T03:00:00Z,MIAMI FL,0,5,3,4,12
Tropical Storm,Isidore,12,2002-09-19T03:00:00Z,GULF 29N 85W,0,0,1,7,8
Tropical Storm,Isidore,12,2002-09-19T03:00:00Z,W PALM BEACH FL,0,1,3,4,8
Tropical Storm,Isidore,12,2002-09-19T03:00:00Z,GULF 29N 87W,0,0,1,7,8
Tropical Storm,Isidore,12,2002-09-19T03:00:00Z,FT PIERCE FL,0,0,2,5,7
Tropical Storm,Isidore,12,2002-09-19T03:00:00Z,GULF 28N 89W,0,0,1,8,9
Tropical Storm,Isidore,12,2002-09-19T03:00:00Z,COCOA BEACH FL,0,0,1,4,5
Tropical Storm,Isidore,12,2002-09-19T03:00:00Z,GULF 28N 91W,0,0,0,5,5
Tropical Storm,Isidore,12,2002-09-19T03:00:00Z,DAYTONA BEACH FL,0,0,0,4,4
Tropical Storm,Isidore,12,2002-09-19T03:00:00Z,GULF 28N 93W,0,0,0,2,2
Tropical Storm,Isidore,13,2002-09-19T09:00:00Z,22.2N  83.1W,50,0,0,0,50
Tropical Storm,Isidore,13,2002-09-19T09:00:00Z,KEY WEST FL,13,6,1,1,21
Tropical Storm,Isidore,13,2002-09-19T09:00:00Z,23.1N  84.4W,27,5,0,0,32
Tropical Storm,Isidore,13,2002-09-19T09:00:00Z,MARCO ISLAND FL,0,6,4,4,14
Tropical Storm,Isidore,13,2002-09-19T09:00:00Z,23.5N  85.0W,11,15,1,1,28
Tropical Storm,Isidore,13,2002-09-19T09:00:00Z,FT MYERS FL,0,3,4,5,12
Tropical Storm,Isidore,13,2002-09-19T09:00:00Z,MWCG 193N 814W,99,0,0,0,99
Tropical Storm,Isidore,13,2002-09-19T09:00:00Z,VENICE FL,0,2,4,6,12
Tropical Storm,Isidore,13,2002-09-19T09:00:00Z,MUCF 221N 805W,41,0,0,0,41
Tropical Storm,Isidore,13,2002-09-19T09:00:00Z,TAMPA FL,0,0,2,7,9
Tropical Storm,Isidore,13,2002-09-19T09:00:00Z,MUSN 216N 826W,62,0,0,0,62
Tropical Storm,Isidore,13,2002-09-19T09:00:00Z,CEDAR KEY FL,0,0,0,6,6
Tropical Storm,Isidore,13,2002-09-19T09:00:00Z,MUHA 230N 824W,43,1,0,0,44
Tropical Storm,Isidore,13,2002-09-19T09:00:00Z,ST MARKS FL,0,0,0,4,4
Tropical Storm,Isidore,13,2002-09-19T09:00:00Z,MUAN 219N 850W,22,2,1,0,25
Tropical Storm,Isidore,13,2002-09-19T09:00:00Z,APALACHICOLA FL,0,0,0,6,6
Tropical Storm,Isidore,13,2002-09-19T09:00:00Z,MMCZ 205N 869W,0,2,1,4,7
Tropical Storm,Isidore,13,2002-09-19T09:00:00Z,PANAMA CITY FL,0,0,0,5,5
Tropical Storm,Isidore,13,2002-09-19T09:00:00Z,MYAK 241N 776W,0,0,1,1,2
Tropical Storm,Isidore,13,2002-09-19T09:00:00Z,PENSACOLA FL,0,0,0,4,4
Tropical Storm,Isidore,13,2002-09-19T09:00:00Z,MYNN 251N 775W,0,0,1,1,2
Tropical Storm,Isidore,13,2002-09-19T09:00:00Z,MOBILE AL,0,0,0,3,3
Tropical Storm,Isidore,13,2002-09-19T09:00:00Z,MYGF 266N 787W,0,0,1,3,4
Tropical Storm,Isidore,13,2002-09-19T09:00:00Z,GULFPORT MS,0,0,0,3,3
Tropical Storm,Isidore,13,2002-09-19T09:00:00Z,MMMD 210N 897W,0,0,1,3,4
Tropical Storm,Isidore,13,2002-09-19T09:00:00Z,BURAS LA,0,0,0,4,4
Tropical Storm,Isidore,13,2002-09-19T09:00:00Z,MARATHON FL,7,6,2,2,17
Tropical Storm,Isidore,13,2002-09-19T09:00:00Z,NEW ORLEANS LA,0,0,0,3,3
Tropical Storm,Isidore,13,2002-09-19T09:00:00Z,MIAMI FL,0,3,3,4,10
Tropical Storm,Isidore,13,2002-09-19T09:00:00Z,GULF 29N 85W,0,0,1,7,8
Tropical Storm,Isidore,13,2002-09-19T09:00:00Z,W PALM BEACH FL,0,1,2,4,7
Tropical Storm,Isidore,13,2002-09-19T09:00:00Z,GULF 29N 87W,0,0,1,7,8
Tropical Storm,Isidore,13,2002-09-19T09:00:00Z,FT PIERCE FL,0,0,1,5,6
Tropical Storm,Isidore,13,2002-09-19T09:00:00Z,GULF 28N 89W,0,0,1,8,9
Tropical Storm,Isidore,13,2002-09-19T09:00:00Z,COCOA BEACH FL,0,0,1,4,5
Tropical Storm,Isidore,13,2002-09-19T09:00:00Z,GULF 28N 91W,0,0,0,5,5
Tropical Storm,Isidore,13,2002-09-19T09:00:00Z,DAYTONA BEACH FL,0,0,0,3,3
Tropical Storm,Isidore,13,2002-09-19T09:00:00Z,GULF 28N 93W,0,0,0,2,2
Tropical Storm,Isidore,13,2002-09-19T09:00:00Z,JACKSONVILLE FL,0,0,0,2,2
Tropical Storm,Isidore,14,2002-09-19T15:00:00Z,22.0N  83.6W,50,0,0,0,50
Tropical Storm,Isidore,14,2002-09-19T15:00:00Z,KEY WEST FL,10,6,2,2,20
Tropical Storm,Isidore,14,2002-09-19T15:00:00Z,23.0N  84.5W,31,3,0,0,34
Tropical Storm,Isidore,14,2002-09-19T15:00:00Z,MARCO ISLAND FL,0,5,4,5,14
Tropical Storm,Isidore,14,2002-09-19T15:00:00Z,23.5N  85.0W,15,12,1,0,28
Tropical Storm,Isidore,14,2002-09-19T15:00:00Z,FT MYERS FL,0,2,5,6,13
Tropical Storm,Isidore,14,2002-09-19T15:00:00Z,MWCG 193N 814W,99,0,0,0,99
Tropical Storm,Isidore,14,2002-09-19T15:00:00Z,VENICE FL,0,1,5,7,13
Tropical Storm,Isidore,14,2002-09-19T15:00:00Z,MUCM 214N 779W,0,0,0,2,2
Tropical Storm,Isidore,14,2002-09-19T15:00:00Z,TAMPA FL,0,0,2,7,9
Tropical Storm,Isidore,14,2002-09-19T15:00:00Z,MUCF 221N 805W,34,0,0,0,34
Tropical Storm,Isidore,14,2002-09-19T15:00:00Z,CEDAR KEY FL,0,0,1,6,7
Tropical Storm,Isidore,14,2002-09-19T15:00:00Z,MUSN 216N 826W,67,0,0,0,67
Tropical Storm,Isidore,14,2002-09-19T15:00:00Z,ST MARKS FL,0,0,0,5,5
Tropical Storm,Isidore,14,2002-09-19T15:00:00Z,MUHA 230N 824W,41,0,0,0,41
Tropical Storm,Isidore,14,2002-09-19T15:00:00Z,APALACHICOLA FL,0,0,0,7,7
Tropical Storm,Isidore,14,2002-09-19T15:00:00Z,MUAN 219N 850W,28,1,0,1,30
Tropical Storm,Isidore,14,2002-09-19T15:00:00Z,PANAMA CITY FL,0,0,0,7,7
Tropical Storm,Isidore,14,2002-09-19T15:00:00Z,MMCZ 205N 869W,1,3,2,3,9
Tropical Storm,Isidore,14,2002-09-19T15:00:00Z,PENSACOLA FL,0,0,0,6,6
Tropical Storm,Isidore,14,2002-09-19T15:00:00Z,MYAK 241N 776W,0,0,0,3,3
Tropical Storm,Isidore,14,2002-09-19T15:00:00Z,MOBILE AL,0,0,0,5,5
Tropical Storm,Isidore,14,2002-09-19T15:00:00Z,MYNN 251N 775W,0,0,0,2,2
Tropical Storm,Isidore,14,2002-09-19T15:00:00Z,GULFPORT MS,0,0,0,6,6
Tropical Storm,Isidore,14,2002-09-19T15:00:00Z,MYGF 266N 787W,0,0,1,2,3
Tropical Storm,Isidore,14,2002-09-19T15:00:00Z,BURAS LA,0,0,0,7,7
Tropical Storm,Isidore,14,2002-09-19T15:00:00Z,MMMD 210N 897W,0,0,1,2,3
Tropical Storm,Isidore,14,2002-09-19T15:00:00Z,NEW ORLEANS LA,0,0,0,5,5
Tropical Storm,Isidore,14,2002-09-19T15:00:00Z,MARATHON FL,4,6,3,3,16
Tropical Storm,Isidore,14,2002-09-19T15:00:00Z,NEW IBERIA LA,0,0,0,3,3
Tropical Storm,Isidore,14,2002-09-19T15:00:00Z,MIAMI FL,0,2,3,5,10
Tropical Storm,Isidore,14,2002-09-19T15:00:00Z,GULF 29N 85W,0,0,1,9,10
Tropical Storm,Isidore,14,2002-09-19T15:00:00Z,W PALM BEACH FL,0,0,2,5,7
Tropical Storm,Isidore,14,2002-09-19T15:00:00Z,GULF 29N 87W,0,0,1,9,10
Tropical Storm,Isidore,14,2002-09-19T15:00:00Z,FT PIERCE FL,0,0,1,5,6
Tropical Storm,Isidore,14,2002-09-19T15:00:00Z,GULF 28N 89W,0,0,1,10,11
Tropical Storm,Isidore,14,2002-09-19T15:00:00Z,COCOA BEACH FL,0,0,1,4,5
Tropical Storm,Isidore,14,2002-09-19T15:00:00Z,GULF 28N 91W,0,0,0,7,7
Tropical Storm,Isidore,14,2002-09-19T15:00:00Z,DAYTONA BEACH FL,0,0,0,3,3
Tropical Storm,Isidore,14,2002-09-19T15:00:00Z,GULF 28N 93W,0,0,0,3,3
Tropical Storm,Isidore,14,2002-09-19T15:00:00Z,JACKSONVILLE FL,0,0,0,2,2
Hurricane,Isidore,15,2002-09-19T21:00:00Z,22.4N  84.2W,50,0,0,0,50
Hurricane,Isidore,15,2002-09-19T21:00:00Z,FT MYERS FL,0,3,4,4,11
Hurricane,Isidore,15,2002-09-19T21:00:00Z,23.2N  85.0W,35,0,1,0,36
Hurricane,Isidore,15,2002-09-19T21:00:00Z,VENICE FL,0,2,4,5,11
Hurricane,Isidore,15,2002-09-19T21:00:00Z,23.5N  85.5W,23,5,1,1,30
Hurricane,Isidore,15,2002-09-19T21:00:00Z,TAMPA FL,0,0,2,6,8
Hurricane,Isidore,15,2002-09-19T21:00:00Z,MUCF 221N 805W,8,0,1,1,10
Hurricane,Isidore,15,2002-09-19T21:00:00Z,CEDAR KEY FL,0,0,0,5,5
Hurricane,Isidore,15,2002-09-19T21:00:00Z,MUSN 216N 826W,85,0,0,0,85
Hurricane,Isidore,15,2002-09-19T21:00:00Z,ST MARKS FL,0,0,0,3,3
Hurricane,Isidore,15,2002-09-19T21:00:00Z,MUHA 230N 824W,39,0,0,0,39
Hurricane,Isidore,15,2002-09-19T21:00:00Z,APALACHICOLA FL,0,0,0,5,5
Hurricane,Isidore,15,2002-09-19T21:00:00Z,MUAN 219N 850W,36,0,0,1,37
Hurricane,Isidore,15,2002-09-19T21:00:00Z,PANAMA CITY FL,0,0,0,4,4
Hurricane,Isidore,15,2002-09-19T21:00:00Z,MMCZ 205N 869W,2,2,1,3,8
Hurricane,Isidore,15,2002-09-19T21:00:00Z,PENSACOLA FL,0,0,0,3,3
Hurricane,Isidore,15,2002-09-19T21:00:00Z,MYGF 266N 787W,0,0,0,2,2
Hurricane,Isidore,15,2002-09-19T21:00:00Z,MOBILE AL,0,0,0,2,2
Hurricane,Isidore,15,2002-09-19T21:00:00Z,MMMD 210N 897W,0,0,1,4,5
Hurricane,Isidore,15,2002-09-19T21:00:00Z,GULFPORT MS,0,0,0,3,3
Hurricane,Isidore,15,2002-09-19T21:00:00Z,MARATHON FL,3,4,3,3,13
Hurricane,Isidore,15,2002-09-19T21:00:00Z,BURAS LA,0,0,0,4,4
Hurricane,Isidore,15,2002-09-19T21:00:00Z,MIAMI FL,0,1,3,4,8
Hurricane,Isidore,15,2002-09-19T21:00:00Z,NEW ORLEANS LA,0,0,0,3,3
Hurricane,Isidore,15,2002-09-19T21:00:00Z,W PALM BEACH FL,0,0,2,3,5
Hurricane,Isidore,15,2002-09-19T21:00:00Z,GULF 29N 85W,0,0,1,6,7
Hurricane,Isidore,15,2002-09-19T21:00:00Z,FT PIERCE FL,0,0,1,3,4
Hurricane,Isidore,15,2002-09-19T21:00:00Z,GULF 29N 87W,0,0,0,7,7
Hurricane,Isidore,15,2002-09-19T21:00:00Z,COCOA BEACH FL,0,0,0,3,3
Hurricane,Isidore,15,2002-09-19T21:00:00Z,GULF 28N 89W,0,0,1,8,9
Hurricane,Isidore,15,2002-09-19T21:00:00Z,DAYTONA BEACH FL,0,0,0,2,2
Hurricane,Isidore,15,2002-09-19T21:00:00Z,GULF 28N 91W,0,0,0,6,6
Hurricane,Isidore,15,2002-09-19T21:00:00Z,KEY WEST FL,10,4,2,2,18
Hurricane,Isidore,15,2002-09-19T21:00:00Z,GULF 28N 93W,0,0,0,2,2
Hurricane,Isidore,15,2002-09-19T21:00:00Z,MARCO ISLAND FL,1,4,4,4,13
Hurricane,Isidore,16,2002-09-20T03:00:00Z,22.5N  84.5W,53,0,0,0,53
Hurricane,Isidore,16,2002-09-20T03:00:00Z,TAMPA FL,0,0,1,5,6
Hurricane,Isidore,16,2002-09-20T03:00:00Z,23.0N  85.5W,34,1,0,0,35
Hurricane,Isidore,16,2002-09-20T03:00:00Z,CEDAR KEY FL,0,0,0,4,4
Hurricane,Isidore,16,2002-09-20T03:00:00Z,23.5N  86.5W,14,8,2,1,25
Hurricane,Isidore,16,2002-09-20T03:00:00Z,ST MARKS FL,0,0,0,3,3
Hurricane,Isidore,16,2002-09-20T03:00:00Z,MWCG 193N 814W,0,0,0,3,3
Hurricane,Isidore,16,2002-09-20T03:00:00Z,APALACHICOLA FL,0,0,0,5,5
Hurricane,Isidore,16,2002-09-20T03:00:00Z,MUCF 221N 805W,1,1,2,3,7
Hurricane,Isidore,16,2002-09-20T03:00:00Z,PANAMA CITY FL,0,0,0,5,5
Hurricane,Isidore,16,2002-09-20T03:00:00Z,MUSN 216N 826W,99,0,0,0,99
Hurricane,Isidore,16,2002-09-20T03:00:00Z,PENSACOLA FL,0,0,0,5,5
Hurricane,Isidore,16,2002-09-20T03:00:00Z,MUHA 230N 824W,38,0,0,0,38
Hurricane,Isidore,16,2002-09-20T03:00:00Z,MOBILE AL,0,0,0,4,4
Hurricane,Isidore,16,2002-09-20T03:00:00Z,MUAN 219N 850W,39,0,0,0,39
Hurricane,Isidore,16,2002-09-20T03:00:00Z,GULFPORT MS,0,0,0,5,5
Hurricane,Isidore,16,2002-09-20T03:00:00Z,MMCZ 205N 869W,2,2,1,5,10
Hurricane,Isidore,16,2002-09-20T03:00:00Z,BURAS LA,0,0,0,7,7
Hurricane,Isidore,16,2002-09-20T03:00:00Z,MMMD 210N 897W,0,0,2,4,6
Hurricane,Isidore,16,2002-09-20T03:00:00Z,NEW ORLEANS LA,0,0,0,6,6
Hurricane,Isidore,16,2002-09-20T03:00:00Z,MARATHON FL,1,4,2,4,11
Hurricane,Isidore,16,2002-09-20T03:00:00Z,NEW IBERIA LA,0,0,0,4,4
Hurricane,Isidore,16,2002-09-20T03:00:00Z,MIAMI FL,0,1,1,4,6
Hurricane,Isidore,16,2002-09-20T03:00:00Z,PORT ARTHUR TX,0,0,0,2,2
Hurricane,Isidore,16,2002-09-20T03:00:00Z,W PALM BEACH FL,0,0,1,3,4
Hurricane,Isidore,16,2002-09-20T03:00:00Z,GALVESTON TX,0,0,0,2,2
Hurricane,Isidore,16,2002-09-20T03:00:00Z,FT PIERCE FL,0,0,0,3,3
Hurricane,Isidore,16,2002-09-20T03:00:00Z,GULF 29N 85W,0,0,1,6,7
Hurricane,Isidore,16,2002-09-20T03:00:00Z,COCOA BEACH FL,0,0,0,2,2
Hurricane,Isidore,16,2002-09-20T03:00:00Z,GULF 29N 87W,0,0,1,8,9
Hurricane,Isidore,16,2002-09-20T03:00:00Z,KEY WEST FL,7,4,1,3,15
Hurricane,Isidore,16,2002-09-20T03:00:00Z,GULF 28N 89W,0,0,2,10,12
Hurricane,Isidore,16,2002-09-20T03:00:00Z,MARCO ISLAND FL,0,3,2,5,10
Hurricane,Isidore,16,2002-09-20T03:00:00Z,GULF 28N 91W,0,0,1,8,9
Hurricane,Isidore,16,2002-09-20T03:00:00Z,FT MYERS FL,0,1,3,5,9
Hurricane,Isidore,16,2002-09-20T03:00:00Z,GULF 28N 93W,0,0,0,5,5
Hurricane,Isidore,16,2002-09-20T03:00:00Z,VENICE FL,0,1,2,6,9
Hurricane,Isidore,16,2002-09-20T03:00:00Z,GULF 28N 95W,0,0,0,2,2
Hurricane,Isidore,17,2002-09-20T09:00:00Z,22.7N  85.2W,43,0,0,0,43
Hurricane,Isidore,17,2002-09-20T09:00:00Z,TAMPA FL,0,0,0,4,4
Hurricane,Isidore,17,2002-09-20T09:00:00Z,23.0N  86.0W,32,0,1,0,33
Hurricane,Isidore,17,2002-09-20T09:00:00Z,CEDAR KEY FL,0,0,0,4,4
Hurricane,Isidore,17,2002-09-20T09:00:00Z,23.2N  86.8W,23,2,2,1,28
Hurricane,Isidore,17,2002-09-20T09:00:00Z,ST MARKS FL,0,0,0,3,3
Hurricane,Isidore,17,2002-09-20T09:00:00Z,MWCG 193N 814W,0,0,1,1,2
Hurricane,Isidore,17,2002-09-20T09:00:00Z,APALACHICOLA FL,0,0,0,5,5
Hurricane,Isidore,17,2002-09-20T09:00:00Z,MUCF 221N 805W,0,1,1,2,4
Hurricane,Isidore,17,2002-09-20T09:00:00Z,PANAMA CITY FL,0,0,0,5,5
Hurricane,Isidore,17,2002-09-20T09:00:00Z,MUSN 216N 826W,99,0,0,0,99
Hurricane,Isidore,17,2002-09-20T09:00:00Z,PENSACOLA FL,0,0,0,4,4
Hurricane,Isidore,17,2002-09-20T09:00:00Z,MUHA 230N 824W,24,1,0,0,25
Hurricane,Isidore,17,2002-09-20T09:00:00Z,MOBILE AL,0,0,0,4,4
Hurricane,Isidore,17,2002-09-20T09:00:00Z,MUAN 219N 850W,48,0,0,0,48
Hurricane,Isidore,17,2002-09-20T09:00:00Z,GULFPORT MS,0,0,0,5,5
Hurricane,Isidore,17,2002-09-20T09:00:00Z,MMCZ 205N 869W,2,3,4,5,14
Hurricane,Isidore,17,2002-09-20T09:00:00Z,BURAS LA,0,0,1,6,7
Hurricane,Isidore,17,2002-09-20T09:00:00Z,MZBZ 175N 883W,0,0,0,3,3
Hurricane,Isidore,17,2002-09-20T09:00:00Z,NEW ORLEANS LA,0,0,0,5,5
Hurricane,Isidore,17,2002-09-20T09:00:00Z,MMFR 185N 926W,0,0,0,2,2
Hurricane,Isidore,17,2002-09-20T09:00:00Z,NEW IBERIA LA,0,0,0,4,4
Hurricane,Isidore,17,2002-09-20T09:00:00Z,MMMD 210N 897W,0,1,4,7,12
Hurricane,Isidore,17,2002-09-20T09:00:00Z,PORT ARTHUR TX,0,0,0,2,2
Hurricane,Isidore,17,2002-09-20T09:00:00Z,MARATHON FL,0,1,1,3,5
Hurricane,Isidore,17,2002-09-20T09:00:00Z,GALVESTON TX,0,0,0,2,2
Hurricane,Isidore,17,2002-09-20T09:00:00Z,MIAMI FL,0,0,0,3,3
Hurricane,Isidore,17,2002-09-20T09:00:00Z,GULF 29N 85W,0,0,1,5,6
Hurricane,Isidore,17,2002-09-20T09:00:00Z,W PALM BEACH FL,0,0,0,2,2
Hurricane,Isidore,17,2002-09-20T09:00:00Z,GULF 29N 87W,0,0,2,6,8
Hurricane,Isidore,17,2002-09-20T09:00:00Z,FT PIERCE FL,0,0,0,2,2
Hurricane,Isidore,17,2002-09-20T09:00:00Z,GULF 28N 89W,0,0,5,7,12
Hurricane,Isidore,17,2002-09-20T09:00:00Z,COCOA BEACH FL,0,0,0,2,2
Hurricane,Isidore,17,2002-09-20T09:00:00Z,GULF 28N 91W,0,0,3,7,10
Hurricane,Isidore,17,2002-09-20T09:00:00Z,DAYTONA BEACH FL,0,0,0,2,2
Hurricane,Isidore,17,2002-09-20T09:00:00Z,GULF 28N 93W,0,0,1,5,6
Hurricane,Isidore,17,2002-09-20T09:00:00Z,KEY WEST FL,1,2,2,3,8
Hurricane,Isidore,17,2002-09-20T09:00:00Z,GULF 28N 95W,0,0,0,3,3
Hurricane,Isidore,17,2002-09-20T09:00:00Z,MARCO ISLAND FL,0,0,1,4,5
Hurricane,Isidore,17,2002-09-20T09:00:00Z,GULF 27N 96W,0,0,0,2,2
Hurricane,Isidore,17,2002-09-20T09:00:00Z,FT MYERS FL,0,0,1,4,5
Hurricane,Isidore,17,2002-09-20T09:00:00Z,GULF 25N 96W,0,0,0,2,2
Hurricane,Isidore,17,2002-09-20T09:00:00Z,VENICE FL,0,0,1,5,6
Hurricane,Isidore,18,2002-09-20T15:00:00Z,22.5N  85.5W,51,0,0,0,51
Hurricane,Isidore,18,2002-09-20T15:00:00Z,FT MYERS FL,0,0,0,3,3
Hurricane,Isidore,18,2002-09-20T15:00:00Z,22.8N  86.4W,30,1,0,1,32
Hurricane,Isidore,18,2002-09-20T15:00:00Z,VENICE FL,0,0,0,3,3
Hurricane,Isidore,18,2002-09-20T15:00:00Z,23.0N  87.5W,16,6,2,1,25
Hurricane,Isidore,18,2002-09-20T15:00:00Z,TAMPA FL,0,0,0,2,2
Hurricane,Isidore,18,2002-09-20T15:00:00Z,MUCF 221N 805W,0,0,1,2,3
Hurricane,Isidore,18,2002-09-20T15:00:00Z,APALACHICOLA FL,0,0,0,2,2
Hurricane,Isidore,18,2002-09-20T15:00:00Z,MUSN 216N 826W,99,0,0,0,99
Hurricane,Isidore,18,2002-09-20T15:00:00Z,PANAMA CITY FL,0,0,0,2,2
Hurricane,Isidore,18,2002-09-20T15:00:00Z,MUHA 230N 824W,19,0,1,0,20
Hurricane,Isidore,18,2002-09-20T15:00:00Z,GULFPORT MS,0,0,0,2,2
Hurricane,Isidore,18,2002-09-20T15:00:00Z,MUAN 219N 850W,66,0,0,0,66
Hurricane,Isidore,18,2002-09-20T15:00:00Z,BURAS LA,0,0,0,3,3
Hurricane,Isidore,18,2002-09-20T15:00:00Z,MMCZ 205N 869W,9,3,1,3,16
Hurricane,Isidore,18,2002-09-20T15:00:00Z,NEW ORLEANS LA,0,0,0,2,2
Hurricane,Isidore,18,2002-09-20T15:00:00Z,MZBZ 175N 883W,0,0,0,3,3
Hurricane,Isidore,18,2002-09-20T15:00:00Z,NEW IBERIA LA,0,0,0,2,2
Hurricane,Isidore,18,2002-09-20T15:00:00Z,MMSO 238N 982W,0,0,0,2,2
Hurricane,Isidore,18,2002-09-20T15:00:00Z,BROWNSVILLE TX,0,0,0,2,2
Hurricane,Isidore,18,2002-09-20T15:00:00Z,MMTM 222N 979W,0,0,0,2,2
Hurricane,Isidore,18,2002-09-20T15:00:00Z,GULF 29N 85W,0,0,0,3,3
Hurricane,Isidore,18,2002-09-20T15:00:00Z,MMTX 210N 974W,0,0,0,2,2
Hurricane,Isidore,18,2002-09-20T15:00:00Z,GULF 29N 87W,0,0,0,4,4
Hurricane,Isidore,18,2002-09-20T15:00:00Z,MMVR 192N 961W,0,0,0,2,2
Hurricane,Isidore,18,2002-09-20T15:00:00Z,GULF 28N 89W,0,0,1,6,7
Hurricane,Isidore,18,2002-09-20T15:00:00Z,MMFR 185N 926W,0,0,0,4,4
Hurricane,Isidore,18,2002-09-20T15:00:00Z,GULF 28N 91W,0,0,1,5,6
Hurricane,Isidore,18,2002-09-20T15:00:00Z,MMMD 210N 897W,0,4,4,6,14
Hurricane,Isidore,18,2002-09-20T15:00:00Z,GULF 28N 93W,0,0,0,5,5
Hurricane,Isidore,18,2002-09-20T15:00:00Z,MARATHON FL,0,1,0,3,4
Hurricane,Isidore,18,2002-09-20T15:00:00Z,GULF 28N 95W,0,0,0,3,3
Hurricane,Isidore,18,2002-09-20T15:00:00Z,MIAMI FL,0,0,0,2,2
Hurricane,Isidore,18,2002-09-20T15:00:00Z,GULF 27N 96W,0,0,0,3,3
Hurricane,Isidore,18,2002-09-20T15:00:00Z,KEY WEST FL,1,1,2,2,6
Hurricane,Isidore,18,2002-09-20T15:00:00Z,GULF 25N 96W,0,0,0,4,4
Hurricane,Isidore,18,2002-09-20T15:00:00Z,MARCO ISLAND FL,0,0,1,3,4
Hurricane,Isidore,19,2002-09-20T21:00:00Z,22.8N  86.4W,42,0,0,0,42
Hurricane,Isidore,19,2002-09-20T21:00:00Z,PENSACOLA FL,0,0,0,2,2
Hurricane,Isidore,19,2002-09-20T21:00:00Z,22.9N  87.5W,27,1,1,1,30
Hurricane,Isidore,19,2002-09-20T21:00:00Z,MOBILE AL,0,0,0,3,3
Hurricane,Isidore,19,2002-09-20T21:00:00Z,22.8N  88.5W,17,5,1,2,25
Hurricane,Isidore,19,2002-09-20T21:00:00Z,GULFPORT MS,0,0,0,3,3
Hurricane,Isidore,19,2002-09-20T21:00:00Z,MUSN 216N 826W,4,0,1,1,6
Hurricane,Isidore,19,2002-09-20T21:00:00Z,BURAS LA,0,0,1,5,6
Hurricane,Isidore,19,2002-09-20T21:00:00Z,MUHA 230N 824W,3,1,1,1,6
Hurricane,Isidore,19,2002-09-20T21:00:00Z,NEW ORLEANS LA,0,0,0,4,4
Hurricane,Isidore,19,2002-09-20T21:00:00Z,MUAN 219N 850W,99,0,0,0,99
Hurricane,Isidore,19,2002-09-20T21:00:00Z,NEW IBERIA LA,0,0,0,4,4
Hurricane,Isidore,19,2002-09-20T21:00:00Z,MMCZ 205N 869W,9,2,3,2,16
Hurricane,Isidore,19,2002-09-20T21:00:00Z,PORT ARTHUR TX,0,0,0,3,3
Hurricane,Isidore,19,2002-09-20T21:00:00Z,MZBZ 175N 883W,0,0,1,5,6
Hurricane,Isidore,19,2002-09-20T21:00:00Z,GALVESTON TX,0,0,0,3,3
Hurricane,Isidore,19,2002-09-20T21:00:00Z,MGPB 157N 886W,0,0,0,2,2
Hurricane,Isidore,19,2002-09-20T21:00:00Z,FREEPORT TX,0,0,0,3,3
Hurricane,Isidore,19,2002-09-20T21:00:00Z,MHNJ 165N 859W,0,0,0,2,2
Hurricane,Isidore,19,2002-09-20T21:00:00Z,PORT O CONNOR TX,0,0,0,3,3
Hurricane,Isidore,19,2002-09-20T21:00:00Z,MMSO 238N 982W,0,0,0,3,3
Hurricane,Isidore,19,2002-09-20T21:00:00Z,CORPUSCHRISTI TX,0,0,0,2,2
Hurricane,Isidore,19,2002-09-20T21:00:00Z,MMTM 222N 979W,0,0,0,3,3
Hurricane,Isidore,19,2002-09-20T21:00:00Z,BROWNSVILLE TX,0,0,0,3,3
Hurricane,Isidore,19,2002-09-20T21:00:00Z,MMTX 210N 974W,0,0,0,3,3
Hurricane,Isidore,19,2002-09-20T21:00:00Z,GULF 29N 85W,0,0,0,3,3
Hurricane,Isidore,19,2002-09-20T21:00:00Z,MMVR 192N 961W,0,0,0,4,4
Hurricane,Isidore,19,2002-09-20T21:00:00Z,GULF 29N 87W,0,0,1,4,5
Hurricane,Isidore,19,2002-09-20T21:00:00Z,MMFR 185N 926W,0,0,1,6,7
Hurricane,Isidore,19,2002-09-20T21:00:00Z,GULF 28N 89W,0,0,4,6,10
Hurricane,Isidore,19,2002-09-20T21:00:00Z,MMMD 210N 897W,2,6,5,4,17
Hurricane,Isidore,19,2002-09-20T21:00:00Z,GULF 28N 91W,0,0,3,7,10
Hurricane,Isidore,19,2002-09-20T21:00:00Z,KEY WEST FL,0,1,0,2,3
Hurricane,Isidore,19,2002-09-20T21:00:00Z,GULF 28N 93W,0,0,1,7,8
Hurricane,Isidore,19,2002-09-20T21:00:00Z,MARCO ISLAND FL,0,0,0,2,2
Hurricane,Isidore,19,2002-09-20T21:00:00Z,GULF 28N 95W,0,0,0,5,5
Hurricane,Isidore,19,2002-09-20T21:00:00Z,VENICE FL,0,0,0,2,2
Hurricane,Isidore,19,2002-09-20T21:00:00Z,GULF 27N 96W,0,0,0,5,5
Hurricane,Isidore,19,2002-09-20T21:00:00Z,APALACHICOLA FL,0,0,0,2,2
Hurricane,Isidore,19,2002-09-20T21:00:00Z,GULF 25N 96W,0,0,0,7,7
Hurricane,Isidore,19,2002-09-20T21:00:00Z,PANAMA CITY FL,0,0,0,2,2
Hurricane,Isidore,20,2002-09-21T03:00:00Z,23.0N  87.0W,41,0,0,0,41
Hurricane,Isidore,20,2002-09-21T03:00:00Z,BURAS LA,0,0,0,5,5
Hurricane,Isidore,20,2002-09-21T03:00:00Z,22.5N  88.0W,26,2,0,1,29
Hurricane,Isidore,20,2002-09-21T03:00:00Z,NEW ORLEANS LA,0,0,0,4,4
Hurricane,Isidore,20,2002-09-21T03:00:00Z,22.5N  89.0W,17,6,2,1,26
Hurricane,Isidore,20,2002-09-21T03:00:00Z,NEW IBERIA LA,0,0,0,3,3
Hurricane,Isidore,20,2002-09-21T03:00:00Z,MUSN 216N 826W,0,1,1,1,3
Hurricane,Isidore,20,2002-09-21T03:00:00Z,PORT ARTHUR TX,0,0,0,2,2
Hurricane,Isidore,20,2002-09-21T03:00:00Z,MUHA 230N 824W,2,1,0,2,5
Hurricane,Isidore,20,2002-09-21T03:00:00Z,GALVESTON TX,0,0,0,3,3
Hurricane,Isidore,20,2002-09-21T03:00:00Z,MUAN 219N 850W,99,0,0,0,99
Hurricane,Isidore,20,2002-09-21T03:00:00Z,FREEPORT TX,0,0,0,3,3
Hurricane,Isidore,20,2002-09-21T03:00:00Z,MMCZ 205N 869W,1,7,4,3,15
Hurricane,Isidore,20,2002-09-21T03:00:00Z,PORT O CONNOR TX,0,0,0,3,3
Hurricane,Isidore,20,2002-09-21T03:00:00Z,MZBZ 175N 883W,0,0,1,4,5
Hurricane,Isidore,20,2002-09-21T03:00:00Z,CORPUSCHRISTI TX,0,0,0,2,2
Hurricane,Isidore,20,2002-09-21T03:00:00Z,MMSO 238N 982W,0,0,0,3,3
Hurricane,Isidore,20,2002-09-21T03:00:00Z,BROWNSVILLE TX,0,0,0,3,3
Hurricane,Isidore,20,2002-09-21T03:00:00Z,MMTM 222N 979W,0,0,0,3,3
Hurricane,Isidore,20,2002-09-21T03:00:00Z,GULF 29N 85W,0,0,0,2,2
Hurricane,Isidore,20,2002-09-21T03:00:00Z,MMTX 210N 974W,0,0,0,3,3
Hurricane,Isidore,20,2002-09-21T03:00:00Z,GULF 29N 87W,0,0,0,4,4
Hurricane,Isidore,20,2002-09-21T03:00:00Z,MMVR 192N 961W,0,0,0,3,3
Hurricane,Isidore,20,2002-09-21T03:00:00Z,GULF 28N 89W,0,0,2,7,9
Hurricane,Isidore,20,2002-09-21T03:00:00Z,MMFR 185N 926W,0,0,0,6,6
Hurricane,Isidore,20,2002-09-21T03:00:00Z,GULF 28N 91W,0,0,3,6,9
Hurricane,Isidore,20,2002-09-21T03:00:00Z,MMMD 210N 897W,1,8,5,4,18
Hurricane,Isidore,20,2002-09-21T03:00:00Z,GULF 28N 93W,0,0,2,6,8
Hurricane,Isidore,20,2002-09-21T03:00:00Z,KEY WEST FL,0,0,0,2,2
Hurricane,Isidore,20,2002-09-21T03:00:00Z,GULF 28N 95W,0,0,0,5,5
Hurricane,Isidore,20,2002-09-21T03:00:00Z,PENSACOLA FL,0,0,0,2,2
Hurricane,Isidore,20,2002-09-21T03:00:00Z,GULF 27N 96W,0,0,0,5,5
Hurricane,Isidore,20,2002-09-21T03:00:00Z,MOBILE AL,0,0,0,2,2
Hurricane,Isidore,20,2002-09-21T03:00:00Z,GULF 25N 96W,0,0,1,6,7
Hurricane,Isidore,20,2002-09-21T03:00:00Z,GULFPORT MS,0,0,0,3,3
Hurricane,Isidore,21,2002-09-21T09:00:00Z,22.3N  88.0W,46,0,0,0,46
Hurricane,Isidore,21,2002-09-21T09:00:00Z,BURAS LA,0,0,0,2,2
Hurricane,Isidore,21,2002-09-21T09:00:00Z,22.2N  89.1W,32,1,0,1,34
Hurricane,Isidore,21,2002-09-21T09:00:00Z,GALVESTON TX,0,0,0,2,2
Hurricane,Isidore,21,2002-09-21T09:00:00Z,21.8N  90.3W,16,6,2,1,25
Hurricane,Isidore,21,2002-09-21T09:00:00Z,FREEPORT TX,0,0,0,2,2
Hurricane,Isidore,21,2002-09-21T09:00:00Z,MUAN 219N 850W,99,0,0,0,99
Hurricane,Isidore,21,2002-09-21T09:00:00Z,PORT O CONNOR TX,0,0,0,2,2
Hurricane,Isidore,21,2002-09-21T09:00:00Z,MMCZ 205N 869W,12,2,1,1,16
Hurricane,Isidore,21,2002-09-21T09:00:00Z,CORPUSCHRISTI TX,0,0,0,2,2
Hurricane,Isidore,21,2002-09-21T09:00:00Z,MZBZ 175N 883W,0,0,0,4,4
Hurricane,Isidore,21,2002-09-21T09:00:00Z,BROWNSVILLE TX,0,0,0,4,4
Hurricane,Isidore,21,2002-09-21T09:00:00Z,MGPB 157N 886W,0,0,0,2,2
Hurricane,Isidore,21,2002-09-21T09:00:00Z,GULF 28N 89W,0,0,0,4,4
Hurricane,Isidore,21,2002-09-21T09:00:00Z,MMSO 238N 982W,0,0,0,5,5
Hurricane,Isidore,21,2002-09-21T09:00:00Z,GULF 28N 91W,0,0,0,4,4
Hurricane,Isidore,21,2002-09-21T09:00:00Z,MMTM 222N 979W,0,0,0,7,7
Hurricane,Isidore,21,2002-09-21T09:00:00Z,GULF 28N 93W,0,0,0,4,4
Hurricane,Isidore,21,2002-09-21T09:00:00Z,MMTX 210N 974W,0,0,1,6,7
Hurricane,Isidore,21,2002-09-21T09:00:00Z,GULF 28N 95W,0,0,0,3,3
Hurricane,Isidore,21,2002-09-21T09:00:00Z,MMVR 192N 961W,0,0,1,6,7
Hurricane,Isidore,21,2002-09-21T09:00:00Z,GULF 27N 96W,0,0,0,4,4
Hurricane,Isidore,21,2002-09-21T09:00:00Z,MMFR 185N 926W,0,0,2,7,9
Hurricane,Isidore,21,2002-09-21T09:00:00Z,GULF 25N 96W,0,0,1,7,8
Hurricane,Isidore,21,2002-09-21T09:00:00Z,MMMD 210N 897W,17,3,2,1,23
Hurricane,Isidore,22,2002-09-21T15:00:00Z,21.9N  88.0W,51,0,0,0,51
Hurricane,Isidore,22,2002-09-21T15:00:00Z,NEW IBERIA LA,0,0,0,2,2
Hurricane,Isidore,22,2002-09-21T15:00:00Z,21.9N  89.2W,28,1,0,1,30
Hurricane,Isidore,22,2002-09-21T15:00:00Z,PORT ARTHUR TX,0,0,0,2,2
Hurricane,Isidore,22,2002-09-21T15:00:00Z,22.0N  90.5W,7,15,2,1,25
Hurricane,Isidore,22,2002-09-21T15:00:00Z,GALVESTON TX,0,0,0,3,3
Hurricane,Isidore,22,2002-09-21T15:00:00Z,MUAN 219N 850W,99,0,0,0,99
Hurricane,Isidore,22,2002-09-21T15:00:00Z,FREEPORT TX,0,0,0,3,3
Hurricane,Isidore,22,2002-09-21T15:00:00Z,MMCZ 205N 869W,28,0,0,0,28
Hurricane,Isidore,22,2002-09-21T15:00:00Z,PORT O CONNOR TX,0,0,0,3,3
Hurricane,Isidore,22,2002-09-21T15:00:00Z,MZBZ 175N 883W,0,0,0,2,2
Hurricane,Isidore,22,2002-09-21T15:00:00Z,CORPUSCHRISTI TX,0,0,0,3,3
Hurricane,Isidore,22,2002-09-21T15:00:00Z,MMSO 238N 982W,0,0,0,7,7
Hurricane,Isidore,22,2002-09-21T15:00:00Z,BROWNSVILLE TX,0,0,0,6,6
Hurricane,Isidore,22,2002-09-21T15:00:00Z,MMTM 222N 979W,0,0,0,8,8
Hurricane,Isidore,22,2002-09-21T15:00:00Z,GULF 29N 87W,0,0,0,2,2
Hurricane,Isidore,22,2002-09-21T15:00:00Z,MMTX 210N 974W,0,0,1,7,8
Hurricane,Isidore,22,2002-09-21T15:00:00Z,GULF 28N 89W,0,0,0,5,5
Hurricane,Isidore,22,2002-09-21T15:00:00Z,MMVR 192N 961W,0,0,1,7,8
Hurricane,Isidore,22,2002-09-21T15:00:00Z,GULF 28N 91W,0,0,0,6,6
Hurricane,Isidore,22,2002-09-21T15:00:00Z,MMFR 185N 926W,0,1,3,5,9
Hurricane,Isidore,22,2002-09-21T15:00:00Z,GULF 28N 93W,0,0,0,6,6
Hurricane,Isidore,22,2002-09-21T15:00:00Z,MMMD 210N 897W,20,3,1,1,25
Hurricane,Isidore,22,2002-09-21T15:00:00Z,GULF 28N 95W,0,0,0,5,5
Hurricane,Isidore,22,2002-09-21T15:00:00Z,BURAS LA,0,0,0,3,3
Hurricane,Isidore,22,2002-09-21T15:00:00Z,GULF 27N 96W,0,0,0,6,6
Hurricane,Isidore,22,2002-09-21T15:00:00Z,NEW ORLEANS LA,0,0,0,2,2
Hurricane,Isidore,22,2002-09-21T15:00:00Z,GULF 25N 96W,0,0,1,8,9
Hurricane,Isidore,23,2002-09-21T21:00:00Z,21.9N  88.0W,51,0,0,0,51
Hurricane,Isidore,23,2002-09-21T21:00:00Z,NEW IBERIA LA,0,0,0,2,2
Hurricane,Isidore,23,2002-09-21T21:00:00Z,21.9N  89.2W,27,2,0,1,30
Hurricane,Isidore,23,2002-09-21T21:00:00Z,PORT ARTHUR TX,0,0,0,2,2
Hurricane,Isidore,23,2002-09-21T21:00:00Z,22.0N  90.3W,12,11,2,1,26
Hurricane,Isidore,23,2002-09-21T21:00:00Z,GALVESTON TX,0,0,0,3,3
Hurricane,Isidore,23,2002-09-21T21:00:00Z,MUAN 219N 850W,99,0,0,0,99
Hurricane,Isidore,23,2002-09-21T21:00:00Z,FREEPORT TX,0,0,0,3,3
Hurricane,Isidore,23,2002-09-21T21:00:00Z,MMCZ 205N 869W,27,0,1,0,28
Hurricane,Isidore,23,2002-09-21T21:00:00Z,PORT O CONNOR TX,0,0,0,3,3
Hurricane,Isidore,23,2002-09-21T21:00:00Z,MZBZ 175N 883W,0,0,1,3,4
Hurricane,Isidore,23,2002-09-21T21:00:00Z,CORPUSCHRISTI TX,0,0,0,3,3
Hurricane,Isidore,23,2002-09-21T21:00:00Z,MMSO 238N 982W,0,0,0,7,7
Hurricane,Isidore,23,2002-09-21T21:00:00Z,BROWNSVILLE TX,0,0,0,6,6
Hurricane,Isidore,23,2002-09-21T21:00:00Z,MMTM 222N 979W,0,0,0,8,8
Hurricane,Isidore,23,2002-09-21T21:00:00Z,GULF 29N 87W,0,0,0,2,2
Hurricane,Isidore,23,2002-09-21T21:00:00Z,MMTX 210N 974W,0,0,1,7,8
Hurricane,Isidore,23,2002-09-21T21:00:00Z,GULF 28N 89W,0,0,0,5,5
Hurricane,Isidore,23,2002-09-21T21:00:00Z,MMVR 192N 961W,0,0,1,7,8
Hurricane,Isidore,23,2002-09-21T21:00:00Z,GULF 28N 91W,0,0,0,6,6
Hurricane,Isidore,23,2002-09-21T21:00:00Z,MMFR 185N 926W,0,1,3,6,10
Hurricane,Isidore,23,2002-09-21T21:00:00Z,GULF 28N 93W,0,0,0,6,6
Hurricane,Isidore,23,2002-09-21T21:00:00Z,MMMD 210N 897W,20,3,1,1,25
Hurricane,Isidore,23,2002-09-21T21:00:00Z,GULF 28N 95W,0,0,0,5,5
Hurricane,Isidore,23,2002-09-21T21:00:00Z,BURAS LA,0,0,0,2,2
Hurricane,Isidore,23,2002-09-21T21:00:00Z,GULF 27N 96W,0,0,0,6,6
Hurricane,Isidore,23,2002-09-21T21:00:00Z,NEW ORLEANS LA,0,0,0,2,2
Hurricane,Isidore,23,2002-09-21T21:00:00Z,GULF 25N 96W,0,0,1,9,10
Hurricane,Isidore,24,2002-09-22T03:00:00Z,22.0N  89.0W,47,0,0,0,47
Hurricane,Isidore,24,2002-09-22T03:00:00Z,NEW IBERIA LA,0,0,0,2,2
Hurricane,Isidore,24,2002-09-22T03:00:00Z,21.8N  90.5W,25,3,1,0,29
Hurricane,Isidore,24,2002-09-22T03:00:00Z,PORT ARTHUR TX,0,0,0,2,2
Hurricane,Isidore,24,2002-09-22T03:00:00Z,22.0N  91.5W,7,17,2,1,27
Hurricane,Isidore,24,2002-09-22T03:00:00Z,GALVESTON TX,0,0,0,3,3
Hurricane,Isidore,24,2002-09-22T03:00:00Z,MUAN 219N 850W,4,0,1,1,6
Hurricane,Isidore,24,2002-09-22T03:00:00Z,FREEPORT TX,0,0,0,3,3
Hurricane,Isidore,24,2002-09-22T03:00:00Z,MMCZ 205N 869W,11,0,0,1,12
Hurricane,Isidore,24,2002-09-22T03:00:00Z,PORT O CONNOR TX,0,0,0,4,4
Hurricane,Isidore,24,2002-09-22T03:00:00Z,MZBZ 175N 883W,0,0,0,2,2
Hurricane,Isidore,24,2002-09-22T03:00:00Z,CORPUSCHRISTI TX,0,0,0,4,4
Hurricane,Isidore,24,2002-09-22T03:00:00Z,MMSO 238N 982W,0,0,1,7,8
Hurricane,Isidore,24,2002-09-22T03:00:00Z,BROWNSVILLE TX,0,0,0,7,7
Hurricane,Isidore,24,2002-09-22T03:00:00Z,MMTM 222N 979W,0,0,2,8,10
Hurricane,Isidore,24,2002-09-22T03:00:00Z,GULF 29N 87W,0,0,0,2,2
Hurricane,Isidore,24,2002-09-22T03:00:00Z,MMTX 210N 974W,0,0,3,7,10
Hurricane,Isidore,24,2002-09-22T03:00:00Z,GULF 28N 89W,0,0,0,5,5
Hurricane,Isidore,24,2002-09-22T03:00:00Z,MMVR 192N 961W,0,0,3,6,9
Hurricane,Isidore,24,2002-09-22T03:00:00Z,GULF 28N 91W,0,0,0,6,6
Hurricane,Isidore,24,2002-09-22T03:00:00Z,MMFR 185N 926W,0,3,3,4,10
Hurricane,Isidore,24,2002-09-22T03:00:00Z,GULF 28N 93W,0,0,0,7,7
Hurricane,Isidore,24,2002-09-22T03:00:00Z,MMMD 210N 897W,27,1,0,0,28
Hurricane,Isidore,24,2002-09-22T03:00:00Z,GULF 28N 95W,0,0,0,6,6
Hurricane,Isidore,24,2002-09-22T03:00:00Z,BURAS LA,0,0,0,3,3
Hurricane,Isidore,24,2002-09-22T03:00:00Z,GULF 27N 96W,0,0,0,7,7
Hurricane,Isidore,24,2002-09-22T03:00:00Z,NEW ORLEANS LA,0,0,0,2,2
Hurricane,Isidore,24,2002-09-22T03:00:00Z,GULF 25N 96W,0,0,2,9,11
Hurricane,Isidore,25,2002-09-22T09:00:00Z,21.5N  90.1W,48,0,0,0,48
Hurricane,Isidore,25,2002-09-22T09:00:00Z,BURAS LA,0,0,0,2,2
Hurricane,Isidore,25,2002-09-22T09:00:00Z,21.2N  90.8W,36,0,0,0,36
Hurricane,Isidore,25,2002-09-22T09:00:00Z,GALVESTON TX,0,0,0,2,2
Hurricane,Isidore,25,2002-09-22T09:00:00Z,21.2N  91.4W,27,1,1,1,30
Hurricane,Isidore,25,2002-09-22T09:00:00Z,FREEPORT TX,0,0,0,2,2
Hurricane,Isidore,25,2002-09-22T09:00:00Z,MUAN 219N 850W,0,0,1,2,3
Hurricane,Isidore,25,2002-09-22T09:00:00Z,PORT O CONNOR TX,0,0,0,2,2
Hurricane,Isidore,25,2002-09-22T09:00:00Z,MMCZ 205N 869W,4,0,1,4,9
Hurricane,Isidore,25,2002-09-22T09:00:00Z,CORPUSCHRISTI TX,0,0,0,2,2
Hurricane,Isidore,25,2002-09-22T09:00:00Z,MZBZ 175N 883W,0,0,1,3,4
Hurricane,Isidore,25,2002-09-22T09:00:00Z,BROWNSVILLE TX,0,0,0,5,5
Hurricane,Isidore,25,2002-09-22T09:00:00Z,MMSO 238N 982W,0,0,0,7,7
Hurricane,Isidore,25,2002-09-22T09:00:00Z,GULF 28N 89W,0,0,0,3,3
Hurricane,Isidore,25,2002-09-22T09:00:00Z,MMTM 222N 979W,0,0,1,8,9
Hurricane,Isidore,25,2002-09-22T09:00:00Z,GULF 28N 91W,0,0,0,4,4
Hurricane,Isidore,25,2002-09-22T09:00:00Z,MMTX 210N 974W,0,0,3,7,10
Hurricane,Isidore,25,2002-09-22T09:00:00Z,GULF 28N 93W,0,0,0,4,4
Hurricane,Isidore,25,2002-09-22T09:00:00Z,MMVR 192N 961W,0,1,4,6,11
Hurricane,Isidore,25,2002-09-22T09:00:00Z,GULF 28N 95W,0,0,0,4,4
Hurricane,Isidore,25,2002-09-22T09:00:00Z,MMFR 185N 926W,2,5,3,4,14
Hurricane,Isidore,25,2002-09-22T09:00:00Z,GULF 27N 96W,0,0,0,5,5
Hurricane,Isidore,25,2002-09-22T09:00:00Z,MMMD 210N 897W,42,0,0,1,43
Hurricane,Isidore,25,2002-09-22T09:00:00Z,GULF 25N 96W,0,0,1,8,9
Hurricane,Isidore,26,2002-09-22T15:00:00Z,21.3N  90.5W,53,0,0,0,53
Hurricane,Isidore,26,2002-09-22T15:00:00Z,NEW IBERIA LA,0,0,0,2,2
Hurricane,Isidore,26,2002-09-22T15:00:00Z,21.3N  91.2W,39,0,0,0,39
Hurricane,Isidore,26,2002-09-22T15:00:00Z,PORT ARTHUR TX,0,0,0,2,2
Hurricane,Isidore,26,2002-09-22T15:00:00Z,21.5N  92.0W,22,3,1,1,27
Hurricane,Isidore,26,2002-09-22T15:00:00Z,GALVESTON TX,0,0,0,2,2
Hurricane,Isidore,26,2002-09-22T15:00:00Z,MUAN 219N 850W,0,0,0,2,2
Hurricane,Isidore,26,2002-09-22T15:00:00Z,FREEPORT TX,0,0,0,3,3
Hurricane,Isidore,26,2002-09-22T15:00:00Z,MMCZ 205N 869W,0,0,1,4,5
Hurricane,Isidore,26,2002-09-22T15:00:00Z,PORT O CONNOR TX,0,0,0,3,3
Hurricane,Isidore,26,2002-09-22T15:00:00Z,MZBZ 175N 883W,0,0,0,2,2
Hurricane,Isidore,26,2002-09-22T15:00:00Z,CORPUSCHRISTI TX,0,0,0,3,3
Hurricane,Isidore,26,2002-09-22T15:00:00Z,MMSO 238N 982W,0,0,0,8,8
Hurricane,Isidore,26,2002-09-22T15:00:00Z,BROWNSVILLE TX,0,0,0,6,6
Hurricane,Isidore,26,2002-09-22T15:00:00Z,MMTM 222N 979W,0,0,2,8,10
Hurricane,Isidore,26,2002-09-22T15:00:00Z,GULF 28N 89W,0,0,0,4,4
Hurricane,Isidore,26,2002-09-22T15:00:00Z,MMTX 210N 974W,0,0,3,8,11
Hurricane,Isidore,26,2002-09-22T15:00:00Z,GULF 28N 91W,0,0,0,5,5
Hurricane,Isidore,26,2002-09-22T15:00:00Z,MMVR 192N 961W,0,1,4,6,11
Hurricane,Isidore,26,2002-09-22T15:00:00Z,GULF 28N 93W,0,0,0,5,5
Hurricane,Isidore,26,2002-09-22T15:00:00Z,MMFR 185N 926W,3,5,3,3,14
Hurricane,Isidore,26,2002-09-22T15:00:00Z,GULF 28N 95W,0,0,0,5,5
Hurricane,Isidore,26,2002-09-22T15:00:00Z,MMMD 210N 897W,55,0,0,0,55
Hurricane,Isidore,26,2002-09-22T15:00:00Z,GULF 27N 96W,0,0,0,6,6
Hurricane,Isidore,26,2002-09-22T15:00:00Z,BURAS LA,0,0,0,2,2
Hurricane,Isidore,26,2002-09-22T15:00:00Z,GULF 25N 96W,0,0,1,9,10
Hurricane,Isidore,26,2002-09-22T15:00:00Z,NEW ORLEANS LA,0,0,0,2,2
Hurricane,Isidore,27,2002-09-22T21:00:00Z,21.4N  91.3W,50,0,0,0,50
Hurricane,Isidore,27,2002-09-22T21:00:00Z,NEW ORLEANS LA,0,0,0,4,4
Hurricane,Isidore,27,2002-09-22T21:00:00Z,21.5N  92.0W,35,1,0,0,36
Hurricane,Isidore,27,2002-09-22T21:00:00Z,NEW IBERIA LA,0,0,0,5,5
Hurricane,Isidore,27,2002-09-22T21:00:00Z,22.3N  92.7W,17,5,2,1,25
Hurricane,Isidore,27,2002-09-22T21:00:00Z,PORT ARTHUR TX,0,0,0,5,5
Hurricane,Isidore,27,2002-09-22T21:00:00Z,MUAN 219N 850W,0,0,0,2,2
Hurricane,Isidore,27,2002-09-22T21:00:00Z,GALVESTON TX,0,0,0,6,6
Hurricane,Isidore,27,2002-09-22T21:00:00Z,MMCZ 205N 869W,0,0,1,2,3
Hurricane,Isidore,27,2002-09-22T21:00:00Z,FREEPORT TX,0,0,0,7,7
Hurricane,Isidore,27,2002-09-22T21:00:00Z,MMSO 238N 982W,0,0,2,8,10
Hurricane,Isidore,27,2002-09-22T21:00:00Z,PORT O CONNOR TX,0,0,0,7,7
Hurricane,Isidore,27,2002-09-22T21:00:00Z,MMTM 222N 979W,0,0,4,7,11
Hurricane,Isidore,27,2002-09-22T21:00:00Z,CORPUSCHRISTI TX,0,0,0,7,7
Hurricane,Isidore,27,2002-09-22T21:00:00Z,MMTX 210N 974W,0,0,5,6,11
Hurricane,Isidore,27,2002-09-22T21:00:00Z,BROWNSVILLE TX,0,0,1,9,10
Hurricane,Isidore,27,2002-09-22T21:00:00Z,MMVR 192N 961W,0,2,4,4,10
Hurricane,Isidore,27,2002-09-22T21:00:00Z,GULF 29N 87W,0,0,0,3,3
Hurricane,Isidore,27,2002-09-22T21:00:00Z,MMFR 185N 926W,4,4,2,1,11
Hurricane,Isidore,27,2002-09-22T21:00:00Z,GULF 28N 89W,0,0,0,6,6
Hurricane,Isidore,27,2002-09-22T21:00:00Z,MMMD 210N 897W,99,0,0,0,99
Hurricane,Isidore,27,2002-09-22T21:00:00Z,GULF 28N 91W,0,0,1,7,8
Hurricane,Isidore,27,2002-09-22T21:00:00Z,PENSACOLA FL,0,0,0,2,2
Hurricane,Isidore,27,2002-09-22T21:00:00Z,GULF 28N 93W,0,0,1,8,9
Hurricane,Isidore,27,2002-09-22T21:00:00Z,MOBILE AL,0,0,0,2,2
Hurricane,Isidore,27,2002-09-22T21:00:00Z,GULF 28N 95W,0,0,0,9,9
Hurricane,Isidore,27,2002-09-22T21:00:00Z,GULFPORT MS,0,0,0,3,3
Hurricane,Isidore,27,2002-09-22T21:00:00Z,GULF 27N 96W,0,0,1,9,10
Hurricane,Isidore,27,2002-09-22T21:00:00Z,BURAS LA,0,0,0,5,5
Hurricane,Isidore,27,2002-09-22T21:00:00Z,GULF 25N 96W,0,0,5,9,14
Hurricane,Isidore,28,2002-09-23T03:00:00Z,21.0N  91.0W,63,0,0,0,63
Hurricane,Isidore,28,2002-09-23T03:00:00Z,NEW IBERIA LA,0,0,0,5,5
Hurricane,Isidore,28,2002-09-23T03:00:00Z,21.8N  92.0W,23,4,1,1,29
Hurricane,Isidore,28,2002-09-23T03:00:00Z,PORT ARTHUR TX,0,0,0,6,6
Hurricane,Isidore,28,2002-09-23T03:00:00Z,22.8N  92.5W,7,14,2,2,25
Hurricane,Isidore,28,2002-09-23T03:00:00Z,GALVESTON TX,0,0,0,7,7
Hurricane,Isidore,28,2002-09-23T03:00:00Z,MMCZ 205N 869W,0,0,0,3,3
Hurricane,Isidore,28,2002-09-23T03:00:00Z,FREEPORT TX,0,0,0,7,7
Hurricane,Isidore,28,2002-09-23T03:00:00Z,MMSO 238N 982W,0,0,2,8,10
Hurricane,Isidore,28,2002-09-23T03:00:00Z,PORT O CONNOR TX,0,0,0,7,7
Hurricane,Isidore,28,2002-09-23T03:00:00Z,MMTM 222N 979W,0,0,3,7,10
Hurricane,Isidore,28,2002-09-23T03:00:00Z,CORPUSCHRISTI TX,0,0,0,7,7
Hurricane,Isidore,28,2002-09-23T03:00:00Z,MMTX 210N 974W,0,0,4,6,10
Hurricane,Isidore,28,2002-09-23T03:00:00Z,BROWNSVILLE TX,0,0,1,9,10
Hurricane,Isidore,28,2002-09-23T03:00:00Z,MMVR 192N 961W,0,1,4,3,8
Hurricane,Isidore,28,2002-09-23T03:00:00Z,GULF 29N 87W,0,0,0,3,3
Hurricane,Isidore,28,2002-09-23T03:00:00Z,MMFR 185N 926W,7,3,1,1,12
Hurricane,Isidore,28,2002-09-23T03:00:00Z,GULF 28N 89W,0,0,1,6,7
Hurricane,Isidore,28,2002-09-23T03:00:00Z,MMMD 210N 897W,99,0,0,0,99
Hurricane,Isidore,28,2002-09-23T03:00:00Z,GULF 28N 91W,0,0,1,9,10
Hurricane,Isidore,28,2002-09-23T03:00:00Z,PENSACOLA FL,0,0,0,2,2
Hurricane,Isidore,28,2002-09-23T03:00:00Z,GULF 28N 93W,0,0,1,9,10
Hurricane,Isidore,28,2002-09-23T03:00:00Z,MOBILE AL,0,0,0,2,2
Hurricane,Isidore,28,2002-09-23T03:00:00Z,GULF 28N 95W,0,0,1,9,10
Hurricane,Isidore,28,2002-09-23T03:00:00Z,GULFPORT MS,0,0,0,3,3
Hurricane,Isidore,28,2002-09-23T03:00:00Z,GULF 27N 96W,0,0,1,10,11
Hurricane,Isidore,28,2002-09-23T03:00:00Z,BURAS LA,0,0,0,5,5
Hurricane,Isidore,28,2002-09-23T03:00:00Z,GULF 25N 96W,0,0,5,9,14
Hurricane,Isidore,28,2002-09-23T03:00:00Z,NEW ORLEANS LA,0,0,0,5,5
Hurricane,Isidore,29,2002-09-23T09:00:00Z,21.2N  91.7W,45,0,0,0,45
Hurricane,Isidore,29,2002-09-23T09:00:00Z,NEW IBERIA LA,0,0,0,7,7
Hurricane,Isidore,29,2002-09-23T09:00:00Z,22.2N  92.2W,28,1,1,0,30
Hurricane,Isidore,29,2002-09-23T09:00:00Z,PORT ARTHUR TX,0,0,0,7,7
Hurricane,Isidore,29,2002-09-23T09:00:00Z,23.1N  92.6W,11,11,1,2,25
Hurricane,Isidore,29,2002-09-23T09:00:00Z,GALVESTON TX,0,0,0,8,8
Hurricane,Isidore,29,2002-09-23T09:00:00Z,MMSO 238N 982W,0,0,2,8,10
Hurricane,Isidore,29,2002-09-23T09:00:00Z,FREEPORT TX,0,0,0,9,9
Hurricane,Isidore,29,2002-09-23T09:00:00Z,MMTM 222N 979W,0,0,3,7,10
Hurricane,Isidore,29,2002-09-23T09:00:00Z,PORT O CONNOR TX,0,0,0,9,9
Hurricane,Isidore,29,2002-09-23T09:00:00Z,MMTX 210N 974W,0,0,4,5,9
Hurricane,Isidore,29,2002-09-23T09:00:00Z,CORPUSCHRISTI TX,0,0,0,8,8
Hurricane,Isidore,29,2002-09-23T09:00:00Z,MMVR 192N 961W,0,2,2,3,7
Hurricane,Isidore,29,2002-09-23T09:00:00Z,BROWNSVILLE TX,0,0,1,10,11
Hurricane,Isidore,29,2002-09-23T09:00:00Z,MMFR 185N 926W,11,1,0,0,12
Hurricane,Isidore,29,2002-09-23T09:00:00Z,GULF 29N 87W,0,0,0,3,3
Hurricane,Isidore,29,2002-09-23T09:00:00Z,MMMD 210N 897W,99,0,0,0,99
Hurricane,Isidore,29,2002-09-23T09:00:00Z,GULF 28N 89W,0,0,1,7,8
Hurricane,Isidore,29,2002-09-23T09:00:00Z,PENSACOLA FL,0,0,0,2,2
Hurricane,Isidore,29,2002-09-23T09:00:00Z,GULF 28N 91W,0,0,2,9,11
Hurricane,Isidore,29,2002-09-23T09:00:00Z,MOBILE AL,0,0,0,3,3
Hurricane,Isidore,29,2002-09-23T09:00:00Z,GULF 28N 93W,0,0,2,10,12
Hurricane,Isidore,29,2002-09-23T09:00:00Z,GULFPORT MS,0,0,0,4,4
Hurricane,Isidore,29,2002-09-23T09:00:00Z,GULF 28N 95W,0,0,1,10,11
Hurricane,Isidore,29,2002-09-23T09:00:00Z,BURAS LA,0,0,0,6,6
Hurricane,Isidore,29,2002-09-23T09:00:00Z,GULF 27N 96W,0,0,1,11,12
Hurricane,Isidore,29,2002-09-23T09:00:00Z,NEW ORLEANS LA,0,0,0,6,6
Hurricane,Isidore,29,2002-09-23T09:00:00Z,GULF 25N 96W,0,0,6,8,14
Tropical Storm,Isidore,30,2002-09-23T15:00:00Z,21.1N  90.7W,48,0,0,0,48
Tropical Storm,Isidore,30,2002-09-23T15:00:00Z,NEW IBERIA LA,0,0,0,8,8
Tropical Storm,Isidore,30,2002-09-23T15:00:00Z,22.0N  91.4W,26,3,1,0,30
Tropical Storm,Isidore,30,2002-09-23T15:00:00Z,PORT ARTHUR TX,0,0,0,8,8
Tropical Storm,Isidore,30,2002-09-23T15:00:00Z,23.0N  92.0W,9,14,2,1,26
Tropical Storm,Isidore,30,2002-09-23T15:00:00Z,GALVESTON TX,0,0,1,8,9
Tropical Storm,Isidore,30,2002-09-23T15:00:00Z,MMCZ 205N 869W,1,2,1,1,5
Tropical Storm,Isidore,30,2002-09-23T15:00:00Z,FREEPORT TX,0,0,1,8,9
Tropical Storm,Isidore,30,2002-09-23T15:00:00Z,MMSO 238N 982W,0,0,1,7,8
Tropical Storm,Isidore,30,2002-09-23T15:00:00Z,PORT O CONNOR TX,0,0,1,8,9
Tropical Storm,Isidore,30,2002-09-23T15:00:00Z,MMTM 222N 979W,0,0,1,6,7
Tropical Storm,Isidore,30,2002-09-23T15:00:00Z,CORPUSCHRISTI TX,0,0,1,7,8
Tropical Storm,Isidore,30,2002-09-23T15:00:00Z,MMTX 210N 974W,0,0,1,5,6
Tropical Storm,Isidore,30,2002-09-23T15:00:00Z,BROWNSVILLE TX,0,0,2,8,10
Tropical Storm,Isidore,30,2002-09-23T15:00:00Z,MMVR 192N 961W,0,0,1,3,4
Tropical Storm,Isidore,30,2002-09-23T15:00:00Z,GULF 29N 85W,0,0,0,2,2
Tropical Storm,Isidore,30,2002-09-23T15:00:00Z,MMFR 185N 926W,4,3,1,1,9
Tropical Storm,Isidore,30,2002-09-23T15:00:00Z,GULF 29N 87W,0,0,0,4,4
Tropical Storm,Isidore,30,2002-09-23T15:00:00Z,MMMD 210N 897W,99,0,0,0,99
Tropical Storm,Isidore,30,2002-09-23T15:00:00Z,GULF 28N 89W,0,0,1,8,9
Tropical Storm,Isidore,30,2002-09-23T15:00:00Z,PANAMA CITY FL,0,0,0,2,2
Tropical Storm,Isidore,30,2002-09-23T15:00:00Z,GULF 28N 91W,0,0,3,9,12
Tropical Storm,Isidore,30,2002-09-23T15:00:00Z,PENSACOLA FL,0,0,0,3,3
Tropical Storm,Isidore,30,2002-09-23T15:00:00Z,GULF 28N 93W,0,0,4,9,13
Tropical Storm,Isidore,30,2002-09-23T15:00:00Z,MOBILE AL,0,0,0,4,4
Tropical Storm,Isidore,30,2002-09-23T15:00:00Z,GULF 28N 95W,0,0,2,10,12
Tropical Storm,Isidore,30,2002-09-23T15:00:00Z,GULFPORT MS,0,0,0,5,5
Tropical Storm,Isidore,30,2002-09-23T15:00:00Z,GULF 27N 96W,0,0,3,9,12
Tropical Storm,Isidore,30,2002-09-23T15:00:00Z,BURAS LA,0,0,0,7,7
Tropical Storm,Isidore,30,2002-09-23T15:00:00Z,GULF 25N 96W,0,1,6,7,14
Tropical Storm,Isidore,30,2002-09-23T15:00:00Z,NEW ORLEANS LA,0,0,0,7,7
Tropical Storm,Isidore,31,2002-09-23T21:00:00Z,22.3N  90.8W,40,0,0,0,40
Tropical Storm,Isidore,31,2002-09-23T21:00:00Z,NEW IBERIA LA,0,0,4,9,13
Tropical Storm,Isidore,31,2002-09-23T21:00:00Z,23.6N  91.3W,22,7,1,0,30
Tropical Storm,Isidore,31,2002-09-23T21:00:00Z,PORT ARTHUR TX,0,0,4,9,13
Tropical Storm,Isidore,31,2002-09-23T21:00:00Z,25.1N  91.8W,3,19,2,1,25
Tropical Storm,Isidore,31,2002-09-23T21:00:00Z,GALVESTON TX,0,0,5,9,14
Tropical Storm,Isidore,31,2002-09-23T21:00:00Z,MMCZ 205N 869W,2,1,1,1,5
Tropical Storm,Isidore,31,2002-09-23T21:00:00Z,FREEPORT TX,0,0,5,8,13
Tropical Storm,Isidore,31,2002-09-23T21:00:00Z,MMSO 238N 982W,0,0,0,4,4
Tropical Storm,Isidore,31,2002-09-23T21:00:00Z,PORT O CONNOR TX,0,0,4,8,12
Tropical Storm,Isidore,31,2002-09-23T21:00:00Z,MMTM 222N 979W,0,0,0,2,2
Tropical Storm,Isidore,31,2002-09-23T21:00:00Z,CORPUSCHRISTI TX,0,0,2,7,9
Tropical Storm,Isidore,31,2002-09-23T21:00:00Z,MMMD 210N 897W,99,0,0,0,99
Tropical Storm,Isidore,31,2002-09-23T21:00:00Z,BROWNSVILLE TX,0,0,2,6,8
Tropical Storm,Isidore,31,2002-09-23T21:00:00Z,ST MARKS FL,0,0,0,2,2
Tropical Storm,Isidore,31,2002-09-23T21:00:00Z,GULF 29N 85W,0,0,0,3,3
Tropical Storm,Isidore,31,2002-09-23T21:00:00Z,APALACHICOLA FL,0,0,0,3,3
Tropical Storm,Isidore,31,2002-09-23T21:00:00Z,GULF 29N 87W,0,0,0,7,7
Tropical Storm,Isidore,31,2002-09-23T21:00:00Z,PANAMA CITY FL,0,0,0,3,3
Tropical Storm,Isidore,31,2002-09-23T21:00:00Z,GULF 28N 89W,0,0,6,6,12
Tropical Storm,Isidore,31,2002-09-23T21:00:00Z,PENSACOLA FL,0,0,0,5,5
Tropical Storm,Isidore,31,2002-09-23T21:00:00Z,GULF 28N 91W,0,2,10,5,17
Tropical Storm,Isidore,31,2002-09-23T21:00:00Z,MOBILE AL,0,0,0,7,7
Tropical Storm,Isidore,31,2002-09-23T21:00:00Z,GULF 28N 93W,0,2,11,5,18
Tropical Storm,Isidore,31,2002-09-23T21:00:00Z,GULFPORT MS,0,0,1,8,9
Tropical Storm,Isidore,31,2002-09-23T21:00:00Z,GULF 28N 95W,0,1,8,6,15
Tropical Storm,Isidore,31,2002-09-23T21:00:00Z,BURAS LA,0,0,3,8,11
Tropical Storm,Isidore,31,2002-09-23T21:00:00Z,GULF 27N 96W,0,0,7,6,13
Tropical Storm,Isidore,31,2002-09-23T21:00:00Z,NEW ORLEANS LA,0,0,2,9,11
Tropical Storm,Isidore,31,2002-09-23T21:00:00Z,GULF 25N 96W,0,1,5,5,11
Tropical Storm,Isidore,32,2002-09-24T03:00:00Z,23.5N  90.7W,51,0,0,0,51
Tropical Storm,Isidore,32,2002-09-24T03:00:00Z,PORT ARTHUR TX,0,2,12,4,18
Tropical Storm,Isidore,32,2002-09-24T03:00:00Z,25.4N  91.2W,21,12,1,0,34
Tropical Storm,Isidore,32,2002-09-24T03:00:00Z,GALVESTON TX,0,2,10,4,16
Tropical Storm,Isidore,32,2002-09-24T03:00:00Z,27.5N  91.5W,1,21,4,1,27
Tropical Storm,Isidore,32,2002-09-24T03:00:00Z,FREEPORT TX,0,1,8,5,14
Tropical Storm,Isidore,32,2002-09-24T03:00:00Z,MMMD 210N 897W,99,0,0,0,99
Tropical Storm,Isidore,32,2002-09-24T03:00:00Z,PORT O CONNOR TX,0,0,4,6,10
Tropical Storm,Isidore,32,2002-09-24T03:00:00Z,CEDAR KEY FL,0,0,0,2,2
Tropical Storm,Isidore,32,2002-09-24T03:00:00Z,CORPUSCHRISTI TX,0,0,1,4,5
Tropical Storm,Isidore,32,2002-09-24T03:00:00Z,ST MARKS FL,0,0,0,4,4
Tropical Storm,Isidore,32,2002-09-24T03:00:00Z,BROWNSVILLE TX,0,0,1,2,3
Tropical Storm,Isidore,32,2002-09-24T03:00:00Z,APALACHICOLA FL,0,0,0,5,5
Tropical Storm,Isidore,32,2002-09-24T03:00:00Z,GULF 29N 85W,0,0,0,5,5
Tropical Storm,Isidore,32,2002-09-24T03:00:00Z,PANAMA CITY FL,0,0,0,7,7
Tropical Storm,Isidore,32,2002-09-24T03:00:00Z,GULF 29N 87W,0,0,2,8,10
Tropical Storm,Isidore,32,2002-09-24T03:00:00Z,PENSACOLA FL,0,0,1,10,11
Tropical Storm,Isidore,32,2002-09-24T03:00:00Z,GULF 28N 89W,0,5,9,3,17
Tropical Storm,Isidore,32,2002-09-24T03:00:00Z,MOBILE AL,0,0,3,10,13
Tropical Storm,Isidore,32,2002-09-24T03:00:00Z,GULF 28N 91W,0,17,7,1,25
Tropical Storm,Isidore,32,2002-09-24T03:00:00Z,GULFPORT MS,0,0,7,8,15
Tropical Storm,Isidore,32,2002-09-24T03:00:00Z,GULF 28N 93W,0,15,7,2,24
Tropical Storm,Isidore,32,2002-09-24T03:00:00Z,BURAS LA,0,2,11,5,18
Tropical Storm,Isidore,32,2002-09-24T03:00:00Z,GULF 28N 95W,0,3,9,3,15
Tropical Storm,Isidore,32,2002-09-24T03:00:00Z,NEW ORLEANS LA,0,2,12,5,19
Tropical Storm,Isidore,32,2002-09-24T03:00:00Z,GULF 27N 96W,0,1,5,3,9
Tropical Storm,Isidore,32,2002-09-24T03:00:00Z,NEW IBERIA LA,0,3,14,4,21
Tropical Storm,Isidore,32,2002-09-24T03:00:00Z,GULF 25N 96W,0,0,3,2,5
Tropical Storm,Isidore,33,2002-09-24T09:00:00Z,24.0N  91.0W,42,0,0,0,42
Tropical Storm,Isidore,33,2002-09-24T09:00:00Z,PORT ARTHUR TX,0,3,13,3,19
Tropical Storm,Isidore,33,2002-09-24T09:00:00Z,26.2N  91.5W,10,19,1,0,30
Tropical Storm,Isidore,33,2002-09-24T09:00:00Z,GALVESTON TX,0,3,11,3,17
Tropical Storm,Isidore,33,2002-09-24T09:00:00Z,28.5N  91.5W,0,15,8,1,24
Tropical Storm,Isidore,33,2002-09-24T09:00:00Z,FREEPORT TX,0,2,10,3,15
Tropical Storm,Isidore,33,2002-09-24T09:00:00Z,MMMD 210N 897W,99,0,0,0,99
Tropical Storm,Isidore,33,2002-09-24T09:00:00Z,PORT O CONNOR TX,0,1,6,4,11
Tropical Storm,Isidore,33,2002-09-24T09:00:00Z,CEDAR KEY FL,0,0,0,2,2
Tropical Storm,Isidore,33,2002-09-24T09:00:00Z,CORPUSCHRISTI TX,0,0,2,4,6
Tropical Storm,Isidore,33,2002-09-24T09:00:00Z,ST MARKS FL,0,0,0,4,4
Tropical Storm,Isidore,33,2002-09-24T09:00:00Z,BROWNSVILLE TX,0,0,2,1,3
Tropical Storm,Isidore,33,2002-09-24T09:00:00Z,APALACHICOLA FL,0,0,0,5,5
Tropical Storm,Isidore,33,2002-09-24T09:00:00Z,GULF 29N 85W,0,0,0,5,5
Tropical Storm,Isidore,33,2002-09-24T09:00:00Z,PANAMA CITY FL,0,0,0,7,7
Tropical Storm,Isidore,33,2002-09-24T09:00:00Z,GULF 29N 87W,0,0,3,7,10
Tropical Storm,Isidore,33,2002-09-24T09:00:00Z,PENSACOLA FL,0,0,2,9,11
Tropical Storm,Isidore,33,2002-09-24T09:00:00Z,GULF 28N 89W,0,7,7,3,17
Tropical Storm,Isidore,33,2002-09-24T09:00:00Z,MOBILE AL,0,0,5,9,14
Tropical Storm,Isidore,33,2002-09-24T09:00:00Z,GULF 28N 91W,0,18,5,1,24
Tropical Storm,Isidore,33,2002-09-24T09:00:00Z,GULFPORT MS,0,0,9,7,16
Tropical Storm,Isidore,33,2002-09-24T09:00:00Z,GULF 28N 93W,0,18,6,1,25
Tropical Storm,Isidore,33,2002-09-24T09:00:00Z,BURAS LA,0,3,11,4,18
Tropical Storm,Isidore,33,2002-09-24T09:00:00Z,GULF 28N 95W,0,6,9,2,17
Tropical Storm,Isidore,33,2002-09-24T09:00:00Z,NEW ORLEANS LA,0,2,13,4,19
Tropical Storm,Isidore,33,2002-09-24T09:00:00Z,GULF 27N 96W,0,3,6,2,11
Tropical Storm,Isidore,33,2002-09-24T09:00:00Z,NEW IBERIA LA,0,4,15,2,21
Tropical Storm,Isidore,33,2002-09-24T09:00:00Z,GULF 25N 96W,0,3,2,2,7
Tropical Storm,Isidore,34,2002-09-24T15:00:00Z,25.1N  91.0W,42,0,1,0,43
Tropical Storm,Isidore,34,2002-09-24T15:00:00Z,BURAS LA,0,8,10,2,20
Tropical Storm,Isidore,34,2002-09-24T15:00:00Z,27.3N  91.2W,5,23,1,0,29
Tropical Storm,Isidore,34,2002-09-24T15:00:00Z,NEW ORLEANS LA,0,7,13,1,21
Tropical Storm,Isidore,34,2002-09-24T15:00:00Z,29.8N  91.0W,0,12,10,1,23
Tropical Storm,Isidore,34,2002-09-24T15:00:00Z,NEW IBERIA LA,0,12,10,1,23
Tropical Storm,Isidore,34,2002-09-24T15:00:00Z,MMMD 210N 897W,99,0,0,0,99
Tropical Storm,Isidore,34,2002-09-24T15:00:00Z,PORT ARTHUR TX,0,8,9,1,18
Tropical Storm,Isidore,34,2002-09-24T15:00:00Z,JACKSONVILLE FL,0,0,0,3,3
Tropical Storm,Isidore,34,2002-09-24T15:00:00Z,GALVESTON TX,0,6,7,2,15
Tropical Storm,Isidore,34,2002-09-24T15:00:00Z,SAVANNAH GA,0,0,0,3,3
Tropical Storm,Isidore,34,2002-09-24T15:00:00Z,FREEPORT TX,0,4,6,1,11
Tropical Storm,Isidore,34,2002-09-24T15:00:00Z,CHARLESTON SC,0,0,0,2,2
Tropical Storm,Isidore,34,2002-09-24T15:00:00Z,PORT O CONNOR TX,0,1,3,1,5
Tropical Storm,Isidore,34,2002-09-24T15:00:00Z,TAMPA FL,0,0,0,2,2
Tropical Storm,Isidore,34,2002-09-24T15:00:00Z,GULF 29N 85W,0,0,1,5,6
Tropical Storm,Isidore,34,2002-09-24T15:00:00Z,CEDAR KEY FL,0,0,0,3,3
Tropical Storm,Isidore,34,2002-09-24T15:00:00Z,GULF 29N 87W,0,1,5,5,11
Tropical Storm,Isidore,34,2002-09-24T15:00:00Z,ST MARKS FL,0,0,0,6,6
Tropical Storm,Isidore,34,2002-09-24T15:00:00Z,GULF 28N 89W,0,13,5,1,19
Tropical Storm,Isidore,34,2002-09-24T15:00:00Z,APALACHICOLA FL,0,0,1,6,7
Tropical Storm,Isidore,34,2002-09-24T15:00:00Z,GULF 28N 91W,1,24,1,1,27
Tropical Storm,Isidore,34,2002-09-24T15:00:00Z,PANAMA CITY FL,0,0,1,8,9
Tropical Storm,Isidore,34,2002-09-24T15:00:00Z,GULF 28N 93W,1,21,1,1,24
Tropical Storm,Isidore,34,2002-09-24T15:00:00Z,PENSACOLA FL,0,0,5,8,13
Tropical Storm,Isidore,34,2002-09-24T15:00:00Z,GULF 28N 95W,0,7,4,1,12
Tropical Storm,Isidore,34,2002-09-24T15:00:00Z,MOBILE AL,0,1,9,5,15
Tropical Storm,Isidore,34,2002-09-24T15:00:00Z,GULF 27N 96W,0,2,2,1,5
Tropical Storm,Isidore,34,2002-09-24T15:00:00Z,GULFPORT MS,0,2,12,4,18
Tropical Storm,Isidore,35,2002-09-24T21:00:00Z,25.6N  90.4W,51,0,0,0,51
Tropical Storm,Isidore,35,2002-09-24T21:00:00Z,MOBILE AL,0,3,14,3,20
Tropical Storm,Isidore,35,2002-09-24T21:00:00Z,27.9N  90.5W,16,19,0,1,36
Tropical Storm,Isidore,35,2002-09-24T21:00:00Z,GULFPORT MS,0,8,14,1,23
Tropical Storm,Isidore,35,2002-09-24T21:00:00Z,30.6N  90.1W,0,12,13,1,26
Tropical Storm,Isidore,35,2002-09-24T21:00:00Z,BURAS LA,1,21,6,0,28
Tropical Storm,Isidore,35,2002-09-24T21:00:00Z,DAYTONA BEACH FL,0,0,0,2,2
Tropical Storm,Isidore,35,2002-09-24T21:00:00Z,NEW ORLEANS LA,0,19,9,0,28
Tropical Storm,Isidore,35,2002-09-24T21:00:00Z,JACKSONVILLE FL,0,0,0,4,4
Tropical Storm,Isidore,35,2002-09-24T21:00:00Z,NEW IBERIA LA,0,18,8,1,27
Tropical Storm,Isidore,35,2002-09-24T21:00:00Z,SAVANNAH GA,0,0,0,5,5
Tropical Storm,Isidore,35,2002-09-24T21:00:00Z,PORT ARTHUR TX,0,4,9,1,14
Tropical Storm,Isidore,35,2002-09-24T21:00:00Z,CHARLESTON SC,0,0,0,4,4
Tropical Storm,Isidore,35,2002-09-24T21:00:00Z,GALVESTON TX,0,2,4,1,7
Tropical Storm,Isidore,35,2002-09-24T21:00:00Z,MYRTLE BEACH SC,0,0,0,3,3
Tropical Storm,Isidore,35,2002-09-24T21:00:00Z,FREEPORT TX,0,0,3,0,3
Tropical Storm,Isidore,35,2002-09-24T21:00:00Z,WILMINGTON NC,0,0,0,2,2
Tropical Storm,Isidore,35,2002-09-24T21:00:00Z,GULF 29N 85W,0,0,1,6,7
Tropical Storm,Isidore,35,2002-09-24T21:00:00Z,TAMPA FL,0,0,0,2,2
Tropical Storm,Isidore,35,2002-09-24T21:00:00Z,GULF 29N 87W,0,2,8,3,13
Tropical Storm,Isidore,35,2002-09-24T21:00:00Z,CEDAR KEY FL,0,0,0,4,4
Tropical Storm,Isidore,35,2002-09-24T21:00:00Z,GULF 28N 89W,8,18,1,0,27
Tropical Storm,Isidore,35,2002-09-24T21:00:00Z,ST MARKS FL,0,0,0,8,8
Tropical Storm,Isidore,35,2002-09-24T21:00:00Z,GULF 28N 91W,13,21,1,0,35
Tropical Storm,Isidore,35,2002-09-24T21:00:00Z,APALACHICOLA FL,0,0,1,7,8
Tropical Storm,Isidore,35,2002-09-24T21:00:00Z,GULF 28N 93W,2,16,2,0,20
Tropical Storm,Isidore,35,2002-09-24T21:00:00Z,PANAMA CITY FL,0,0,3,7,10
Tropical Storm,Isidore,35,2002-09-24T21:00:00Z,GULF 28N 95W,0,1,2,0,3
Tropical Storm,Isidore,35,2002-09-24T21:00:00Z,PENSACOLA FL,0,1,9,6,16
Tropical Storm,Isidore,36,2002-09-25T03:00:00Z,27.2N  90.2W,34,0,0,0,34
Tropical Storm,Isidore,36,2002-09-25T03:00:00Z,CEDAR KEY FL,0,0,2,1,3
Tropical Storm,Isidore,36,2002-09-25T03:00:00Z,29.7N  90.2W,9,13,1,0,23
Tropical Storm,Isidore,36,2002-09-25T03:00:00Z,ST MARKS FL,0,1,4,2,7
Tropical Storm,Isidore,36,2002-09-25T03:00:00Z,33.0N  89.0W,0,3,13,3,19
Tropical Storm,Isidore,36,2002-09-25T03:00:00Z,APALACHICOLA FL,0,2,6,1,9
Tropical Storm,Isidore,36,2002-09-25T03:00:00Z,JACKSONVILLE FL,0,0,1,2,3
Tropical Storm,Isidore,36,2002-09-25T03:00:00Z,PANAMA CITY FL,0,3,7,2,12
Tropical Storm,Isidore,36,2002-09-25T03:00:00Z,SAVANNAH GA,0,0,1,4,5
Tropical Storm,Isidore,36,2002-09-25T03:00:00Z,PENSACOLA FL,0,9,7,0,16
Tropical Storm,Isidore,36,2002-09-25T03:00:00Z,CHARLESTON SC,0,0,0,5,5
Tropical Storm,Isidore,36,2002-09-25T03:00:00Z,MOBILE AL,1,12,5,1,19
Tropical Storm,Isidore,36,2002-09-25T03:00:00Z,MYRTLE BEACH SC,0,0,0,5,5
Tropical Storm,Isidore,36,2002-09-25T03:00:00Z,GULFPORT MS,3,14,3,0,20
Tropical Storm,Isidore,36,2002-09-25T03:00:00Z,WILMINGTON NC,0,0,0,5,5
Tropical Storm,Isidore,36,2002-09-25T03:00:00Z,BURAS LA,12,10,1,0,23
Tropical Storm,Isidore,36,2002-09-25T03:00:00Z,MOREHEAD CITY NC,0,0,0,4,4
Tropical Storm,Isidore,36,2002-09-25T03:00:00Z,NEW ORLEANS LA,7,14,1,0,22
Tropical Storm,Isidore,36,2002-09-25T03:00:00Z,CAPE HATTERAS NC,0,0,0,4,4
Tropical Storm,Isidore,36,2002-09-25T03:00:00Z,NEW IBERIA LA,4,15,1,0,20
Tropical Storm,Isidore,36,2002-09-25T03:00:00Z,NORFOLK VA,0,0,0,6,6
Tropical Storm,Isidore,36,2002-09-25T03:00:00Z,PORT ARTHUR TX,1,8,2,1,12
Tropical Storm,Isidore,36,2002-09-25T03:00:00Z,OCEAN CITY MD,0,0,0,6,6
Tropical Storm,Isidore,36,2002-09-25T03:00:00Z,GALVESTON TX,0,5,2,0,7
Tropical Storm,Isidore,36,2002-09-25T03:00:00Z,ATLANTIC CITY NJ,0,0,0,6,6
Tropical Storm,Isidore,36,2002-09-25T03:00:00Z,FREEPORT TX,0,2,1,0,3
Tropical Storm,Isidore,36,2002-09-25T03:00:00Z,NEW YORK CITY NY,0,0,0,5,5
Tropical Storm,Isidore,36,2002-09-25T03:00:00Z,GULF 29N 85W,0,3,4,1,8
Tropical Storm,Isidore,36,2002-09-25T03:00:00Z,MONTAUK POINT NY,0,0,0,3,3
Tropical Storm,Isidore,36,2002-09-25T03:00:00Z,GULF 29N 87W,3,10,2,0,15
Tropical Storm,Isidore,36,2002-09-25T03:00:00Z,PROVIDENCE RI,0,0,0,3,3
Tropical Storm,Isidore,36,2002-09-25T03:00:00Z,GULF 28N 89W,25,1,1,0,27
Tropical Storm,Isidore,36,2002-09-25T03:00:00Z,NANTUCKET MA,0,0,0,2,2
Tropical Storm,Isidore,36,2002-09-25T03:00:00Z,GULF 28N 91W,24,2,1,0,27
Tropical Storm,Isidore,36,2002-09-25T03:00:00Z,HYANNIS MA,0,0,0,2,2
Tropical Storm,Isidore,36,2002-09-25T03:00:00Z,GULF 28N 93W,7,7,0,0,14
Tropical Storm,Isidore,36,2002-09-25T03:00:00Z,BOSTON MA,0,0,0,2,2
Tropical Storm,Isidore,36,2002-09-25T03:00:00Z,GULF 28N 95W,0,2,1,0,3
Tropical Storm,Isidore,37,2002-09-25T09:00:00Z,28.5N  90.5W,47,0,0,0,47
Tropical Storm,Isidore,37,2002-09-25T09:00:00Z,ST JOHN NB,0,0,0,2,2
Tropical Storm,Isidore,37,2002-09-25T09:00:00Z,31.0N  90.5W,8,16,1,0,25
Tropical Storm,Isidore,37,2002-09-25T09:00:00Z,YARMOUTH NS,0,0,0,2,2
Tropical Storm,Isidore,37,2002-09-25T09:00:00Z,34.5N  88.5W,0,1,14,5,20
Tropical Storm,Isidore,37,2002-09-25T09:00:00Z,ST MARKS FL,0,0,3,2,5
Tropical Storm,Isidore,37,2002-09-25T09:00:00Z,JACKSONVILLE FL,0,0,1,1,2
Tropical Storm,Isidore,37,2002-09-25T09:00:00Z,APALACHICOLA FL,0,1,3,2,6
Tropical Storm,Isidore,37,2002-09-25T09:00:00Z,SAVANNAH GA,0,0,1,3,4
Tropical Storm,Isidore,37,2002-09-25T09:00:00Z,PANAMA CITY FL,0,2,5,1,8
Tropical Storm,Isidore,37,2002-09-25T09:00:00Z,CHARLESTON SC,0,0,0,4,4
Tropical Storm,Isidore,37,2002-09-25T09:00:00Z,PENSACOLA FL,1,8,6,1,16
Tropical Storm,Isidore,37,2002-09-25T09:00:00Z,MYRTLE BEACH SC,0,0,0,4,4
Tropical Storm,Isidore,37,2002-09-25T09:00:00Z,MOBILE AL,3,13,4,0,20
Tropical Storm,Isidore,37,2002-09-25T09:00:00Z,WILMINGTON NC,0,0,0,4,4
Tropical Storm,Isidore,37,2002-09-25T09:00:00Z,GULFPORT MS,11,11,1,0,23
Tropical Storm,Isidore,37,2002-09-25T09:00:00Z,MOREHEAD CITY NC,0,0,0,3,3
Tropical Storm,Isidore,37,2002-09-25T09:00:00Z,BURAS LA,31,2,0,0,33
Tropical Storm,Isidore,37,2002-09-25T09:00:00Z,CAPE HATTERAS NC,0,0,0,3,3
Tropical Storm,Isidore,37,2002-09-25T09:00:00Z,NEW ORLEANS LA,25,6,0,0,31
Tropical Storm,Isidore,37,2002-09-25T09:00:00Z,NORFOLK VA,0,0,0,5,5
Tropical Storm,Isidore,37,2002-09-25T09:00:00Z,NEW IBERIA LA,18,11,0,0,29
Tropical Storm,Isidore,37,2002-09-25T09:00:00Z,OCEAN CITY MD,0,0,0,6,6
Tropical Storm,Isidore,37,2002-09-25T09:00:00Z,PORT ARTHUR TX,1,17,1,0,19
Tropical Storm,Isidore,37,2002-09-25T09:00:00Z,ATLANTIC CITY NJ,0,0,0,6,6
Tropical Storm,Isidore,37,2002-09-25T09:00:00Z,GALVESTON TX,0,12,1,0,13
Tropical Storm,Isidore,37,2002-09-25T09:00:00Z,NEW YORK CITY NY,0,0,0,6,6
Tropical Storm,Isidore,37,2002-09-25T09:00:00Z,FREEPORT TX,0,7,2,0,9
Tropical Storm,Isidore,37,2002-09-25T09:00:00Z,MONTAUK POINT NY,0,0,0,6,6
Tropical Storm,Isidore,37,2002-09-25T09:00:00Z,PORT O CONNOR TX,0,2,1,0,3
Tropical Storm,Isidore,37,2002-09-25T09:00:00Z,PROVIDENCE RI,0,0,0,6,6
Tropical Storm,Isidore,37,2002-09-25T09:00:00Z,GULF 29N 85W,0,1,2,1,4
Tropical Storm,Isidore,37,2002-09-25T09:00:00Z,NANTUCKET MA,0,0,0,5,5
Tropical Storm,Isidore,37,2002-09-25T09:00:00Z,GULF 29N 87W,1,7,4,0,12
Tropical Storm,Isidore,37,2002-09-25T09:00:00Z,HYANNIS MA,0,0,0,5,5
Tropical Storm,Isidore,37,2002-09-25T09:00:00Z,GULF 28N 89W,40,0,0,0,40
Tropical Storm,Isidore,37,2002-09-25T09:00:00Z,BOSTON MA,0,0,0,5,5
Tropical Storm,Isidore,37,2002-09-25T09:00:00Z,GULF 28N 91W,49,0,0,0,49
Tropical Storm,Isidore,37,2002-09-25T09:00:00Z,PORTLAND ME,0,0,0,5,5
Tropical Storm,Isidore,37,2002-09-25T09:00:00Z,GULF 28N 93W,16,6,0,0,22
Tropical Storm,Isidore,37,2002-09-25T09:00:00Z,BAR HARBOR ME,0,0,0,4,4
Tropical Storm,Isidore,37,2002-09-25T09:00:00Z,GULF 28N 95W,0,7,1,0,8
Tropical Storm,Isidore,37,2002-09-25T09:00:00Z,EASTPORT ME,0,0,0,3,3
Tropical Storm,Isidore,38,2002-09-25T15:00:00Z,30.0N  90.2W,43,0,0,0,43
Tropical Storm,Isidore,38,2002-09-25T15:00:00Z,YARMOUTH NS,0,0,0,6,6
Tropical Storm,Isidore,38,2002-09-25T15:00:00Z,33.0N  89.3W,3,21,3,0,27
Tropical Storm,Isidore,38,2002-09-25T15:00:00Z,HALIFAX NS,0,0,0,5,5
Tropical Storm,Isidore,38,2002-09-25T15:00:00Z,37.3N  85.3W,0,0,13,5,18
Tropical Storm,Isidore,38,2002-09-25T15:00:00Z,SABLE ISLAND NS,0,0,0,3,3
Tropical Storm,Isidore,38,2002-09-25T15:00:00Z,SAVANNAH GA,0,0,2,1,3
Tropical Storm,Isidore,38,2002-09-25T15:00:00Z,SYDNEY NS,0,0,0,3,3
Tropical Storm,Isidore,38,2002-09-25T15:00:00Z,CHARLESTON SC,0,0,2,1,3
Tropical Storm,Isidore,38,2002-09-25T15:00:00Z,EDDY POINT NS,0,0,0,3,3
Tropical Storm,Isidore,38,2002-09-25T15:00:00Z,MYRTLE BEACH SC,0,0,1,2,3
Tropical Storm,Isidore,38,2002-09-25T15:00:00Z,PTX BASQUES NFLD,0,0,0,2,2
Tropical Storm,Isidore,38,2002-09-25T15:00:00Z,WILMINGTON NC,0,0,1,2,3
Tropical Storm,Isidore,38,2002-09-25T15:00:00Z,ST MARKS FL,0,1,2,0,3
Tropical Storm,Isidore,38,2002-09-25T15:00:00Z,MOREHEAD CITY NC,0,0,0,3,3
Tropical Storm,Isidore,38,2002-09-25T15:00:00Z,APALACHICOLA FL,0,2,1,0,3
Tropical Storm,Isidore,38,2002-09-25T15:00:00Z,CAPE HATTERAS NC,0,0,0,3,3
Tropical Storm,Isidore,38,2002-09-25T15:00:00Z,PANAMA CITY FL,0,4,2,0,6
Tropical Storm,Isidore,38,2002-09-25T15:00:00Z,NORFOLK VA,0,0,0,6,6
Tropical Storm,Isidore,38,2002-09-25T15:00:00Z,PENSACOLA FL,8,10,1,0,19
Tropical Storm,Isidore,38,2002-09-25T15:00:00Z,OCEAN CITY MD,0,0,0,7,7
Tropical Storm,Isidore,38,2002-09-25T15:00:00Z,MOBILE AL,20,7,0,0,27
Tropical Storm,Isidore,38,2002-09-25T15:00:00Z,ATLANTIC CITY NJ,0,0,0,8,8
Tropical Storm,Isidore,38,2002-09-25T15:00:00Z,GULFPORT MS,32,2,0,0,34
Tropical Storm,Isidore,38,2002-09-25T15:00:00Z,NEW YORK CITY NY,0,0,0,8,8
Tropical Storm,Isidore,38,2002-09-25T15:00:00Z,BURAS LA,45,0,0,0,45
Tropical Storm,Isidore,38,2002-09-25T15:00:00Z,MONTAUK POINT NY,0,0,0,7,7
Tropical Storm,Isidore,38,2002-09-25T15:00:00Z,NEW ORLEANS LA,43,0,0,0,43
Tropical Storm,Isidore,38,2002-09-25T15:00:00Z,PROVIDENCE RI,0,0,0,8,8
Tropical Storm,Isidore,38,2002-09-25T15:00:00Z,NEW IBERIA LA,34,0,0,0,34
Tropical Storm,Isidore,38,2002-09-25T15:00:00Z,NANTUCKET MA,0,0,0,7,7
Tropical Storm,Isidore,38,2002-09-25T15:00:00Z,PORT ARTHUR TX,6,6,0,0,12
Tropical Storm,Isidore,38,2002-09-25T15:00:00Z,HYANNIS MA,0,0,0,7,7
Tropical Storm,Isidore,38,2002-09-25T15:00:00Z,GALVESTON TX,1,2,0,0,3
Tropical Storm,Isidore,38,2002-09-25T15:00:00Z,BOSTON MA,0,0,0,8,8
Tropical Storm,Isidore,38,2002-09-25T15:00:00Z,GULF 29N 85W,0,1,1,0,2
Tropical Storm,Isidore,38,2002-09-25T15:00:00Z,PORTLAND ME,0,0,0,8,8
Tropical Storm,Isidore,38,2002-09-25T15:00:00Z,GULF 29N 87W,5,5,1,0,11
Tropical Storm,Isidore,38,2002-09-25T15:00:00Z,BAR HARBOR ME,0,0,0,7,7
Tropical Storm,Isidore,38,2002-09-25T15:00:00Z,GULF 28N 89W,43,0,0,0,43
Tropical Storm,Isidore,38,2002-09-25T15:00:00Z,EASTPORT ME,0,0,0,7,7
Tropical Storm,Isidore,38,2002-09-25T15:00:00Z,GULF 28N 91W,62,0,0,0,62
Tropical Storm,Isidore,38,2002-09-25T15:00:00Z,ST JOHN NB,0,0,0,6,6
Tropical Storm,Isidore,38,2002-09-25T15:00:00Z,GULF 28N 93W,18,0,0,0,18
Tropical Storm,Isidore,38,2002-09-25T15:00:00Z,MONCTON NB,0,0,0,5,5
Tropical Storm,Isidore,39,2002-09-25T21:00:00Z,30.5N  90.2W,49,4,0,0,53
Tropical Storm,Isidore,39,2002-09-25T21:00:00Z,YARMOUTH NS,0,0,0,7,7
Tropical Storm,Isidore,39,2002-09-25T21:00:00Z,35.2N  87.9W,0,21,7,0,28
Tropical Storm,Isidore,39,2002-09-25T21:00:00Z,HALIFAX NS,0,0,0,6,6
Tropical Storm,Isidore,39,2002-09-25T21:00:00Z,39.3N  82.2W,0,0,12,6,18
Tropical Storm,Isidore,39,2002-09-25T21:00:00Z,SABLE ISLAND NS,0,0,0,4,4
Tropical Storm,Isidore,39,2002-09-25T21:00:00Z,MYRTLE BEACH SC,0,0,2,0,2
Tropical Storm,Isidore,39,2002-09-25T21:00:00Z,SYDNEY NS,0,0,0,6,6
Tropical Storm,Isidore,39,2002-09-25T21:00:00Z,WILMINGTON NC,0,0,2,0,2
Tropical Storm,Isidore,39,2002-09-25T21:00:00Z,EDDY POINT NS,0,0,0,6,6
Tropical Storm,Isidore,39,2002-09-25T21:00:00Z,MOREHEAD CITY NC,0,0,1,1,2
Tropical Storm,Isidore,39,2002-09-25T21:00:00Z,PTX BASQUES NFLD,0,0,0,6,6
Tropical Storm,Isidore,39,2002-09-25T21:00:00Z,CAPE HATTERAS NC,0,0,1,1,2
Tropical Storm,Isidore,39,2002-09-25T21:00:00Z,BURGEO NFLD,0,0,0,5,5
Tropical Storm,Isidore,39,2002-09-25T21:00:00Z,NORFOLK VA,0,0,2,3,5
Tropical Storm,Isidore,39,2002-09-25T21:00:00Z,ILE ST PIERRE,0,0,0,4,4
Tropical Storm,Isidore,39,2002-09-25T21:00:00Z,OCEAN CITY MD,0,0,1,6,7
Tropical Storm,Isidore,39,2002-09-25T21:00:00Z,CAPE RACE NFLD,0,0,0,2,2
Tropical Storm,Isidore,39,2002-09-25T21:00:00Z,ATLANTIC CITY NJ,0,0,0,9,9
Tropical Storm,Isidore,39,2002-09-25T21:00:00Z,PANAMA CITY FL,0,2,0,0,2
Tropical Storm,Isidore,39,2002-09-25T21:00:00Z,NEW YORK CITY NY,0,0,0,9,9
Tropical Storm,Isidore,39,2002-09-25T21:00:00Z,PENSACOLA FL,5,12,1,0,18
Tropical Storm,Isidore,39,2002-09-25T21:00:00Z,MONTAUK POINT NY,0,0,0,8,8
Tropical Storm,Isidore,39,2002-09-25T21:00:00Z,MOBILE AL,24,13,0,0,37
Tropical Storm,Isidore,39,2002-09-25T21:00:00Z,PROVIDENCE RI,0,0,0,8,8
Tropical Storm,Isidore,39,2002-09-25T21:00:00Z,GULFPORT MS,40,6,0,0,46
Tropical Storm,Isidore,39,2002-09-25T21:00:00Z,NANTUCKET MA,0,0,0,7,7
Tropical Storm,Isidore,39,2002-09-25T21:00:00Z,BURAS LA,54,0,0,0,54
Tropical Storm,Isidore,39,2002-09-25T21:00:00Z,HYANNIS MA,0,0,0,7,7
Tropical Storm,Isidore,39,2002-09-25T21:00:00Z,NEW ORLEANS LA,55,1,0,0,56
Tropical Storm,Isidore,39,2002-09-25T21:00:00Z,BOSTON MA,0,0,0,9,9
Tropical Storm,Isidore,39,2002-09-25T21:00:00Z,NEW IBERIA LA,40,3,0,0,43
Tropical Storm,Isidore,39,2002-09-25T21:00:00Z,PORTLAND ME,0,0,0,9,9
Tropical Storm,Isidore,39,2002-09-25T21:00:00Z,PORT ARTHUR TX,3,2,0,0,5
Tropical Storm,Isidore,39,2002-09-25T21:00:00Z,BAR HARBOR ME,0,0,0,8,8
Tropical Storm,Isidore,39,2002-09-25T21:00:00Z,GULF 29N 87W,2,2,0,0,4
Tropical Storm,Isidore,39,2002-09-25T21:00:00Z,EASTPORT ME,0,0,0,8,8
Tropical Storm,Isidore,39,2002-09-25T21:00:00Z,GULF 28N 89W,36,1,0,0,37
Tropical Storm,Isidore,39,2002-09-25T21:00:00Z,ST JOHN NB,0,0,0,7,7
Tropical Storm,Isidore,39,2002-09-25T21:00:00Z,GULF 28N 91W,82,0,0,0,82
Tropical Storm,Isidore,39,2002-09-25T21:00:00Z,MONCTON NB,0,0,0,7,7
Tropical Storm,Isidore,39,2002-09-25T21:00:00Z,GULF 28N 93W,15,0,0,0,15
Tropical Storm,Isidore,40,2002-09-26T03:00:00Z,33.2N  88.8W,35,2,0,0,37
Tropical Storm,Isidore,40,2002-09-26T03:00:00Z,YARMOUTH NS,0,0,0,7,7
Tropical Storm,Isidore,40,2002-09-26T03:00:00Z,37.0N  86.0W,0,18,5,0,23
Tropical Storm,Isidore,40,2002-09-26T03:00:00Z,HALIFAX NS,0,0,0,6,6
Tropical Storm,Isidore,40,2002-09-26T03:00:00Z,41.5N  78.0W,0,0,8,4,12
Tropical Storm,Isidore,40,2002-09-26T03:00:00Z,SABLE ISLAND NS,0,0,0,4,4
Tropical Storm,Isidore,40,2002-09-26T03:00:00Z,SAVANNAH GA,0,1,1,0,2
Tropical Storm,Isidore,40,2002-09-26T03:00:00Z,SYDNEY NS,0,0,0,6,6
Tropical Storm,Isidore,40,2002-09-26T03:00:00Z,CHARLESTON SC,0,0,2,0,2
Tropical Storm,Isidore,40,2002-09-26T03:00:00Z,EDDY POINT NS,0,0,0,6,6
Tropical Storm,Isidore,40,2002-09-26T03:00:00Z,MYRTLE BEACH SC,0,0,2,0,2
Tropical Storm,Isidore,40,2002-09-26T03:00:00Z,PTX BASQUES NFLD,0,0,0,6,6
Tropical Storm,Isidore,40,2002-09-26T03:00:00Z,WILMINGTON NC,0,0,2,0,2
Tropical Storm,Isidore,40,2002-09-26T03:00:00Z,BURGEO NFLD,0,0,0,6,6
Tropical Storm,Isidore,40,2002-09-26T03:00:00Z,MOREHEAD CITY NC,0,0,2,0,2
Tropical Storm,Isidore,40,2002-09-26T03:00:00Z,ILE ST PIERRE,0,0,0,5,5
Tropical Storm,Isidore,40,2002-09-26T03:00:00Z,CAPE HATTERAS NC,0,0,2,0,2
Tropical Storm,Isidore,40,2002-09-26T03:00:00Z,CAPE RACE NFLD,0,0,0,3,3
Tropical Storm,Isidore,40,2002-09-26T03:00:00Z,NORFOLK VA,0,0,4,1,5
Tropical Storm,Isidore,40,2002-09-26T03:00:00Z,HIBERNIA OILFLD,0,0,0,2,2
Tropical Storm,Isidore,40,2002-09-26T03:00:00Z,OCEAN CITY MD,0,0,4,3,7
Tropical Storm,Isidore,40,2002-09-26T03:00:00Z,ST MARKS FL,0,2,0,0,2
Tropical Storm,Isidore,40,2002-09-26T03:00:00Z,ATLANTIC CITY NJ,0,0,4,4,8
Tropical Storm,Isidore,40,2002-09-26T03:00:00Z,APALACHICOLA FL,1,1,0,0,2
Tropical Storm,Isidore,40,2002-09-26T03:00:00Z,NEW YORK CITY NY,0,0,2,6,8
Tropical Storm,Isidore,40,2002-09-26T03:00:00Z,PANAMA CITY FL,3,2,0,0,5
Tropical Storm,Isidore,40,2002-09-26T03:00:00Z,MONTAUK POINT NY,0,0,1,6,7
Tropical Storm,Isidore,40,2002-09-26T03:00:00Z,PENSACOLA FL,27,1,0,0,28
Tropical Storm,Isidore,40,2002-09-26T03:00:00Z,PROVIDENCE RI,0,0,0,7,7
Tropical Storm,Isidore,40,2002-09-26T03:00:00Z,MOBILE AL,50,0,0,0,50
Tropical Storm,Isidore,40,2002-09-26T03:00:00Z,NANTUCKET MA,0,0,0,6,6
Tropical Storm,Isidore,40,2002-09-26T03:00:00Z,GULFPORT MS,63,0,0,0,63
Tropical Storm,Isidore,40,2002-09-26T03:00:00Z,HYANNIS MA,0,0,0,7,7
Tropical Storm,Isidore,40,2002-09-26T03:00:00Z,BURAS LA,79,0,0,0,79
Tropical Storm,Isidore,40,2002-09-26T03:00:00Z,BOSTON MA,0,0,0,8,8
Tropical Storm,Isidore,40,2002-09-26T03:00:00Z,NEW ORLEANS LA,66,0,0,0,66
Tropical Storm,Isidore,40,2002-09-26T03:00:00Z,PORTLAND ME,0,0,0,8,8
Tropical Storm,Isidore,40,2002-09-26T03:00:00Z,NEW IBERIA LA,10,0,0,0,10
Tropical Storm,Isidore,40,2002-09-26T03:00:00Z,BAR HARBOR ME,0,0,0,8,8
Tropical Storm,Isidore,40,2002-09-26T03:00:00Z,GULF 29N 87W,7,0,0,0,7
Tropical Storm,Isidore,40,2002-09-26T03:00:00Z,EASTPORT ME,0,0,0,8,8
Tropical Storm,Isidore,40,2002-09-26T03:00:00Z,GULF 28N 89W,80,0,0,0,80
Tropical Storm,Isidore,40,2002-09-26T03:00:00Z,ST JOHN NB,0,0,0,7,7
Tropical Storm,Isidore,40,2002-09-26T03:00:00Z,GULF 28N 91W,99,0,0,0,99
Tropical Storm,Isidore,40,2002-09-26T03:00:00Z,MONCTON NB,0,0,0,8,8
Tropical Storm,Isidore,41,2002-09-26T09:00:00Z,35.5N  87.5W,31,2,0,0,33
Tropical Storm,Isidore,41,2002-09-26T09:00:00Z,HYANNIS MA,0,0,2,0,2
Tropical Storm,Isidore,41,2002-09-26T09:00:00Z,39.0N  84.0W,0,19,3,0,22
Tropical Storm,Isidore,41,2002-09-26T09:00:00Z,BOSTON MA,0,0,2,0,2
Tropical Storm,Isidore,41,2002-09-26T09:00:00Z,44.0N  76.5W,0,0,10,0,10
Tropical Storm,Isidore,41,2002-09-26T09:00:00Z,PORTLAND ME,0,0,2,0,2
Tropical Storm,Isidore,41,2002-09-26T09:00:00Z,NORFOLK VA,0,0,3,0,3
Tropical Storm,Isidore,41,2002-09-26T09:00:00Z,PENSACOLA FL,3,0,0,0,3
Tropical Storm,Isidore,41,2002-09-26T09:00:00Z,OCEAN CITY MD,0,0,4,0,4
Tropical Storm,Isidore,41,2002-09-26T09:00:00Z,MOBILE AL,36,0,0,0,36
Tropical Storm,Isidore,41,2002-09-26T09:00:00Z,ATLANTIC CITY NJ,0,0,5,0,5
Tropical Storm,Isidore,41,2002-09-26T09:00:00Z,GULFPORT MS,83,0,0,0,83
Tropical Storm,Isidore,41,2002-09-26T09:00:00Z,NEW YORK CITY NY,0,0,5,0,5
Tropical Storm,Isidore,41,2002-09-26T09:00:00Z,BURAS LA,99,0,0,0,99
Tropical Storm,Isidore,41,2002-09-26T09:00:00Z,MONTAUK POINT NY,0,0,3,0,3
Tropical Storm,Isidore,41,2002-09-26T09:00:00Z,NEW ORLEANS LA,99,0,0,0,99
Tropical Storm,Isidore,41,2002-09-26T09:00:00Z,PROVIDENCE RI,0,0,3,0,3
Tropical Storm,Isidore,41,2002-09-26T09:00:00Z,GULF 28N 89W,2,0,0,0,2
Tropical Storm,Isidore,41,2002-09-26T09:00:00Z,NANTUCKET MA,0,0,2,0,2
Tropical Storm,Isidore,41,2002-09-26T09:00:00Z,GULF 28N 91W,4,0,0,0,4
Tropical Storm,Isidore,42,2002-09-26T15:00:00Z,35.6N  86.6W,37,3,0,0,40
Tropical Storm,Isidore,42,2002-09-26T15:00:00Z,BOSTON MA,0,0,8,0,8
Tropical Storm,Isidore,42,2002-09-26T15:00:00Z,40.0N  80.6W,0,15,5,0,20
Tropical Storm,Isidore,42,2002-09-26T15:00:00Z,PORTLAND ME,0,0,8,0,8
Tropical Storm,Isidore,42,2002-09-26T15:00:00Z,45.0N  70.0W,0,0,8,0,8
Tropical Storm,Isidore,42,2002-09-26T15:00:00Z,BAR HARBOR ME,0,0,6,0,6
Tropical Storm,Isidore,42,2002-09-26T15:00:00Z,NORFOLK VA,0,2,2,0,4
Tropical Storm,Isidore,42,2002-09-26T15:00:00Z,EASTPORT ME,0,0,4,0,4
Tropical Storm,Isidore,42,2002-09-26T15:00:00Z,OCEAN CITY MD,0,1,5,0,6
Tropical Storm,Isidore,42,2002-09-26T15:00:00Z,ST JOHN NB,0,0,3,0,3
Tropical Storm,Isidore,42,2002-09-26T15:00:00Z,ATLANTIC CITY NJ,0,1,7,0,8
Tropical Storm,Isidore,42,2002-09-26T15:00:00Z,YARMOUTH NS,0,0,3,0,3
Tropical Storm,Isidore,42,2002-09-26T15:00:00Z,NEW YORK CITY NY,0,0,9,0,9
Tropical Storm,Isidore,42,2002-09-26T15:00:00Z,PENSACOLA FL,5,0,0,0,5
Tropical Storm,Isidore,42,2002-09-26T15:00:00Z,MONTAUK POINT NY,0,0,8,0,8
Tropical Storm,Isidore,42,2002-09-26T15:00:00Z,MOBILE AL,74,0,0,0,74
Tropical Storm,Isidore,42,2002-09-26T15:00:00Z,PROVIDENCE RI,0,0,8,0,8
Tropical Storm,Isidore,42,2002-09-26T15:00:00Z,GULFPORT MS,99,0,0,0,99
Tropical Storm,Isidore,42,2002-09-26T15:00:00Z,NANTUCKET MA,0,0,6,0,6
Tropical Storm,Isidore,42,2002-09-26T15:00:00Z,BURAS LA,99,0,0,0,99
Tropical Storm,Isidore,42,2002-09-26T15:00:00Z,HYANNIS MA,0,0,7,0,7
Tropical Storm,Isidore,42,2002-09-26T15:00:00Z,NEW ORLEANS LA,99,0,0,0,99
Tropical Depression,Isidore,43,2002-09-26T21:00:00Z,40.4N  83.3W,25,2,0,0,27
Tropical Depression,Isidore,43,2002-09-26T21:00:00Z,BAR HARBOR ME,0,2,9,0,11
Tropical Depression,Isidore,43,2002-09-26T21:00:00Z,44.3N  73.4W,0,12,2,0,14
Tropical Depression,Isidore,43,2002-09-26T21:00:00Z,EASTPORT ME,0,1,10,0,11
Tropical Depression,Isidore,43,2002-09-26T21:00:00Z,48.0N  62.0W,0,0,8,0,8
Tropical Depression,Isidore,43,2002-09-26T21:00:00Z,ST JOHN NB,0,0,10,0,10
Tropical Depression,Isidore,43,2002-09-26T21:00:00Z,OCEAN CITY MD,0,2,0,0,2
Tropical Depression,Isidore,43,2002-09-26T21:00:00Z,MONCTON NB,0,0,10,0,10
Tropical Depression,Isidore,43,2002-09-26T21:00:00Z,ATLANTIC CITY NJ,0,5,0,0,5
Tropical Depression,Isidore,43,2002-09-26T21:00:00Z,YARMOUTH NS,0,0,9,0,9
Tropical Depression,Isidore,43,2002-09-26T21:00:00Z,NEW YORK CITY NY,0,7,0,0,7
Tropical Depression,Isidore,43,2002-09-26T21:00:00Z,HALIFAX NS,0,0,8,0,8
Tropical Depression,Isidore,43,2002-09-26T21:00:00Z,MONTAUK POINT NY,0,6,1,0,7
Tropical Depression,Isidore,43,2002-09-26T21:00:00Z,SABLE ISLAND NS,0,0,4,0,4
Tropical Depression,Isidore,43,2002-09-26T21:00:00Z,PROVIDENCE RI,0,7,1,0,8
Tropical Depression,Isidore,43,2002-09-26T21:00:00Z,SYDNEY NS,0,0,6,0,6
Tropical Depression,Isidore,43,2002-09-26T21:00:00Z,NANTUCKET MA,0,4,2,0,6
Tropical Depression,Isidore,43,2002-09-26T21:00:00Z,EDDY POINT NS,0,0,7,0,7
Tropical Depression,Isidore,43,2002-09-26T21:00:00Z,HYANNIS MA,0,5,2,0,7
Tropical Depression,Isidore,43,2002-09-26T21:00:00Z,PTX BASQUES NFLD,0,0,5,0,5
Tropical Depression,Isidore,43,2002-09-26T21:00:00Z,BOSTON MA,0,7,3,0,10
Tropical Depression,Isidore,43,2002-09-26T21:00:00Z,BURGEO NFLD,0,0,3,0,3
Tropical Depression,Isidore,43,2002-09-26T21:00:00Z,PORTLAND ME,0,6,6,0,12
Tropical Depression,Isidore,43,2002-09-26T21:00:00Z,ILE ST PIERRE,0,0,2,0,2
Tropical Depression,Eleven,1,2002-09-17T21:00:00Z,37.0N  50.5W,20,2,0,0,22
Tropical Depression,Eleven,1,2002-09-17T21:00:00Z,CAPE RACE NFLD,0,1,1,1,3
Tropical Depression,Eleven,1,2002-09-17T21:00:00Z,39.0N  47.5W,2,12,2,0,16
Tropical Depression,Eleven,1,2002-09-17T21:00:00Z,HIBERNIA OILFLD,0,0,4,3,7
Tropical Depression,Eleven,1,2002-09-17T21:00:00Z,42.0N  43.0W,0,1,9,2,12
Tropical Depression,Eleven,2,2002-09-18T03:00:00Z,37.2N  48.2W,18,1,0,0,19
Tropical Depression,Eleven,2,2002-09-18T03:00:00Z,44.2N  39.2W,0,2,7,0,9
Tropical Depression,Eleven,2,2002-09-18T03:00:00Z,40.1N  44.3W,1,10,2,0,13
Tropical Depression,Eleven,2,2002-09-18T03:00:00Z,HIBERNIA OILFLD,0,1,2,0,3
Tropical Storm,Josephine,3,2002-09-18T09:00:00Z,39.9N  46.5W,22,2,0,0,24
Tropical Storm,Josephine,3,2002-09-18T09:00:00Z,43.2N  41.5W,0,13,0,0,13
Tropical Storm,Josephine,4,2002-09-18T15:00:00Z,41.0N  45.0W,25,2,0,0,27
Tropical Storm,Josephine,4,2002-09-18T15:00:00Z,45.0N  39.0W,1,17,0,0,18
Tropical Storm,Josephine,5,2002-09-18T21:00:00Z,44.0N  43.0W,28,3,0,0,31
Tropical Storm,Josephine,5,2002-09-18T21:00:00Z,HIBERNIA OILFLD,1,1,0,0,2
Tropical Storm,Josephine,5,2002-09-18T21:00:00Z,49.0N  38.0W,0,14,0,0,14
Tropical Storm,Josephine,6,2002-09-19T03:00:00Z,46.3N  40.6W,31,0,0,0,31
Tropical Storm,Josephine,7,2002-09-19T09:00:00Z,48.7N  38.2W,31,0,0,0,31
Tropical Storm,Josephine,8,2002-09-19T15:00:00Z,53.5N  35.5W,25,0,0,0,25
Subtropical Depression,Twelve,1,2002-09-20T21:00:00Z,31.0N  50.9W,27,1,0,0,28
Subtropical Depression,Twelve,1,2002-09-20T21:00:00Z,33.5N  50.5W,8,7,2,2,19
Subtropical Depression,Twelve,1,2002-09-20T21:00:00Z,32.6N  50.5W,14,4,2,1,21
Subtropical Depression,Twelve,2,2002-09-21T03:00:00Z,32.8N  50.7W,30,1,0,0,31
Subtropical Depression,Twelve,2,2002-09-21T03:00:00Z,34.0N  51.2W,16,3,2,0,21
Subtropical Depression,Twelve,2,2002-09-21T03:00:00Z,34.0N  50.5W,16,3,2,0,21
Subtropical Depression,Twelve,2,2002-09-21T03:00:00Z,SABLE ISLAND NS,0,0,0,2,2
Tropical Storm,Kyle,3,2002-09-21T09:00:00Z,32.7N  51.3W,34,0,0,1,35
Tropical Storm,Kyle,3,2002-09-21T09:00:00Z,BERMUDA,0,0,1,1,2
Tropical Storm,Kyle,3,2002-09-21T09:00:00Z,33.0N  51.5W,29,1,0,0,30
Tropical Storm,Kyle,3,2002-09-21T09:00:00Z,SABLE ISLAND NS,0,0,0,2,2
Tropical Storm,Kyle,3,2002-09-21T09:00:00Z,32.7N  52.2W,31,1,0,0,32
Tropical Storm,Kyle,4,2002-09-21T15:00:00Z,32.7N  51.0W,46,0,0,0,46
Tropical Storm,Kyle,4,2002-09-21T15:00:00Z,32.1N  51.9W,99,0,0,0,99
Tropical Storm,Kyle,4,2002-09-21T15:00:00Z,32.5N  51.0W,56,0,0,0,56
Tropical Storm,Kyle,5,2002-09-21T21:00:00Z,32.8N  50.5W,99,0,0,0,99
Tropical Storm,Kyle,5,2002-09-21T21:00:00Z,32.0N  51.5W,99,0,0,0,99
Tropical Storm,Kyle,5,2002-09-21T21:00:00Z,32.4N  50.6W,99,0,0,0,99
Tropical Storm,Kyle,6,2002-09-22T03:00:00Z,32.3N  50.9W,99,0,0,0,99
Tropical Storm,Kyle,6,2002-09-22T03:00:00Z,31.6N  52.3W,99,0,0,0,99
Tropical Storm,Kyle,6,2002-09-22T03:00:00Z,32.0N  51.4W,99,0,0,0,99
Tropical Storm,Kyle,7,2002-09-22T09:00:00Z,31.9N  51.8W,99,0,0,0,99
Tropical Storm,Kyle,7,2002-09-22T09:00:00Z,31.0N  53.0W,24,1,1,1,27
Tropical Storm,Kyle,7,2002-09-22T09:00:00Z,31.7N  52.1W,99,0,0,0,99
Tropical Storm,Kyle,8,2002-09-22T15:00:00Z,33.0N  50.5W,99,0,0,0,99
Tropical Storm,Kyle,8,2002-09-22T15:00:00Z,31.5N  53.0W,15,3,1,2,21
Tropical Storm,Kyle,8,2002-09-22T15:00:00Z,32.5N  52.0W,31,1,0,0,32
Tropical Storm,Kyle,8,2002-09-22T15:00:00Z,BERMUDA,0,0,0,3,3
Tropical Storm,Kyle,9,2002-09-22T21:00:00Z,33.0N  50.0W,99,0,0,0,99
Tropical Storm,Kyle,9,2002-09-22T21:00:00Z,32.0N  53.0W,14,6,1,1,22
Tropical Storm,Kyle,9,2002-09-22T21:00:00Z,32.5N  52.0W,20,3,1,0,24
Tropical Storm,Kyle,10,2002-09-23T03:00:00Z,31.9N  50.7W,40,0,0,0,40
Tropical Storm,Kyle,10,2002-09-23T03:00:00Z,30.5N  53.0W,15,4,1,2,22
Tropical Storm,Kyle,10,2002-09-23T03:00:00Z,31.0N  52.0W,20,2,1,1,24
Tropical Storm,Kyle,11,2002-09-23T09:00:00Z,31.7N  51.2W,40,0,0,0,40
Tropical Storm,Kyle,11,2002-09-23T09:00:00Z,30.0N  54.0W,12,5,2,1,20
Tropical Storm,Kyle,11,2002-09-23T09:00:00Z,30.8N  52.6W,20,2,1,1,24
Tropical Storm,Kyle,12,2002-09-23T15:00:00Z,31.0N  50.9W,45,0,0,0,45
Tropical Storm,Kyle,12,2002-09-23T15:00:00Z,29.0N  53.0W,12,4,3,1,20
Tropical Storm,Kyle,12,2002-09-23T15:00:00Z,30.0N  52.0W,21,2,1,0,24
Tropical Storm,Kyle,13,2002-09-23T21:00:00Z,29.6N  52.4W,32,0,0,1,33
Tropical Storm,Kyle,13,2002-09-23T21:00:00Z,28.1N  54.8W,14,4,2,1,21
Tropical Storm,Kyle,13,2002-09-23T21:00:00Z,28.9N  53.3W,23,1,1,0,25
Tropical Storm,Kyle,14,2002-09-24T03:00:00Z,29.8N  52.6W,32,1,0,0,33
Tropical Storm,Kyle,14,2002-09-24T03:00:00Z,28.0N  56.1W,8,9,2,2,21
Tropical Storm,Kyle,14,2002-09-24T03:00:00Z,28.7N  54.3W,18,3,1,1,23
Tropical Storm,Kyle,14,2002-09-24T03:00:00Z,BERMUDA,0,0,0,2,2
Tropical Storm,Kyle,15,2002-09-24T09:00:00Z,29.1N  53.3W,31,1,0,0,32
Tropical Storm,Kyle,15,2002-09-24T09:00:00Z,27.8N  56.5W,12,7,1,1,21
Tropical Storm,Kyle,15,2002-09-24T09:00:00Z,28.2N  55.1W,20,2,1,1,24
Tropical Storm,Kyle,15,2002-09-24T09:00:00Z,BERMUDA,0,0,0,2,2
Tropical Storm,Kyle,16,2002-09-24T15:00:00Z,28.6N  53.8W,41,0,0,0,41
Tropical Storm,Kyle,16,2002-09-24T15:00:00Z,27.5N  56.6W,9,12,2,1,24
Tropical Storm,Kyle,16,2002-09-24T15:00:00Z,27.9N  55.4W,23,3,1,1,28
Tropical Storm,Kyle,17,2002-09-24T21:00:00Z,28.7N  54.0W,44,0,0,0,44
Tropical Storm,Kyle,17,2002-09-24T21:00:00Z,28.0N  56.0W,16,5,1,2,24
Tropical Storm,Kyle,17,2002-09-24T21:00:00Z,28.3N  55.1W,27,1,0,1,29
Tropical Storm,Kyle,18,2002-09-25T03:00:00Z,29.0N  54.8W,39,0,0,1,40
Tropical Storm,Kyle,18,2002-09-25T03:00:00Z,27.9N  57.3W,9,9,2,2,22
Tropical Storm,Kyle,18,2002-09-25T03:00:00Z,28.5N  56.0W,24,1,1,1,27
Tropical Storm,Kyle,18,2002-09-25T03:00:00Z,BERMUDA,0,0,0,2,2
Tropical Storm,Kyle,19,2002-09-25T09:00:00Z,28.5N  57.7W,45,0,0,0,45
Tropical Storm,Kyle,19,2002-09-25T09:00:00Z,27.7N  59.0W,22,4,1,1,28
Tropical Storm,Kyle,19,2002-09-25T09:00:00Z,28.0N  58.6W,30,1,1,0,32
Tropical Storm,Kyle,19,2002-09-25T09:00:00Z,BERMUDA,0,0,0,4,4
Tropical Storm,Kyle,20,2002-09-25T15:00:00Z,28.0N  57.7W,45,0,0,0,45
Tropical Storm,Kyle,20,2002-09-25T15:00:00Z,27.3N  58.7W,26,1,1,1,29
Tropical Storm,Kyle,20,2002-09-25T15:00:00Z,27.7N  58.3W,35,0,1,0,36
Tropical Storm,Kyle,20,2002-09-25T15:00:00Z,BERMUDA,0,0,0,2,2
Hurricane,Kyle,21,2002-09-25T21:00:00Z,28.0N  58.0W,50,0,0,0,50
Hurricane,Kyle,21,2002-09-25T21:00:00Z,27.2N  58.7W,26,2,1,0,29
Hurricane,Kyle,21,2002-09-25T21:00:00Z,27.5N  58.4W,35,0,0,1,36
Hurricane,Kyle,21,2002-09-25T21:00:00Z,BERMUDA,0,0,0,2,2
Hurricane,Kyle,22,2002-09-26T03:00:00Z,27.8N  59.7W,44,0,0,0,44
Hurricane,Kyle,22,2002-09-26T03:00:00Z,27.0N  61.0W,20,5,1,1,27
Hurricane,Kyle,22,2002-09-26T03:00:00Z,27.4N  60.9W,26,2,1,0,29
Hurricane,Kyle,22,2002-09-26T03:00:00Z,BERMUDA,0,0,1,3,4
Hurricane,Kyle,23,2002-09-26T09:00:00Z,27.3N  60.9W,50,0,0,0,50
Hurricane,Kyle,23,2002-09-26T09:00:00Z,26.5N  61.4W,30,1,0,1,32
Hurricane,Kyle,23,2002-09-26T09:00:00Z,26.9N  61.5W,36,0,1,0,37
Hurricane,Kyle,23,2002-09-26T09:00:00Z,BERMUDA,0,0,0,2,2
Hurricane,Kyle,24,2002-09-26T15:00:00Z,27.0N  60.5W,57,0,0,0,57
Hurricane,Kyle,24,2002-09-26T15:00:00Z,26.5N  61.0W,36,1,0,0,37
Hurricane,Kyle,24,2002-09-26T15:00:00Z,26.7N  61.0W,41,0,0,0,41
Hurricane,Kyle,24,2002-09-26T15:00:00Z,BERMUDA,0,0,0,2,2
Hurricane,Kyle,25,2002-09-26T21:00:00Z,27.0N  61.0W,53,0,0,0,53
Hurricane,Kyle,25,2002-09-26T21:00:00Z,26.5N  61.5W,34,1,0,1,36
Hurricane,Kyle,25,2002-09-26T21:00:00Z,26.5N  61.5W,34,1,0,1,36
Hurricane,Kyle,25,2002-09-26T21:00:00Z,BERMUDA,0,0,1,3,4
Hurricane,Kyle,26,2002-09-27T03:00:00Z,26.9N  61.1W,61,0,0,0,61
Hurricane,Kyle,26,2002-09-27T03:00:00Z,26.6N  62.0W,33,1,0,0,34
Hurricane,Kyle,26,2002-09-27T03:00:00Z,26.8N  61.5W,48,0,0,0,48
Hurricane,Kyle,26,2002-09-27T03:00:00Z,BERMUDA,0,0,1,4,5
Hurricane,Kyle,27,2002-09-27T09:00:00Z,26.5N  61.3W,60,0,0,0,60
Hurricane,Kyle,27,2002-09-27T09:00:00Z,26.1N  62.1W,32,1,0,1,34
Hurricane,Kyle,27,2002-09-27T09:00:00Z,26.3N  61.8W,42,1,0,0,43
Hurricane,Kyle,27,2002-09-27T09:00:00Z,BERMUDA,0,0,1,3,4
Hurricane,Kyle,28,2002-09-27T15:00:00Z,26.6N  61.7W,56,0,0,0,56
Hurricane,Kyle,28,2002-09-27T15:00:00Z,26.5N  62.5W,36,0,1,0,37
Hurricane,Kyle,28,2002-09-27T15:00:00Z,26.5N  62.3W,40,0,0,0,40
Hurricane,Kyle,28,2002-09-27T15:00:00Z,BERMUDA,0,0,1,4,5
Hurricane,Kyle,29,2002-09-27T21:00:00Z,26.7N  61.8W,99,0,0,0,99
Hurricane,Kyle,29,2002-09-27T21:00:00Z,26.7N  62.5W,36,0,0,0,36
Hurricane,Kyle,29,2002-09-27T21:00:00Z,26.7N  62.2W,44,0,0,0,44
Hurricane,Kyle,29,2002-09-27T21:00:00Z,BERMUDA,0,0,1,4,5
Hurricane,Kyle,30,2002-09-28T03:00:00Z,26.4N  62.5W,55,0,0,0,55
Hurricane,Kyle,30,2002-09-28T03:00:00Z,MBJT 215N 712W,0,0,0,2,2
Hurricane,Kyle,30,2002-09-28T03:00:00Z,26.4N  63.0W,38,0,0,0,38
Hurricane,Kyle,30,2002-09-28T03:00:00Z,MYMM 224N 730W,0,0,0,2,2
Hurricane,Kyle,30,2002-09-28T03:00:00Z,26.4N  63.5W,29,1,1,0,31
Hurricane,Kyle,30,2002-09-28T03:00:00Z,BERMUDA,0,0,2,3,5
Hurricane,Kyle,31,2002-09-28T09:00:00Z,26.1N  63.8W,82,0,0,0,82
Hurricane,Kyle,31,2002-09-28T09:00:00Z,MYMM 224N 730W,0,0,0,6,6
Hurricane,Kyle,31,2002-09-28T09:00:00Z,26.0N  64.6W,51,0,0,0,51
Hurricane,Kyle,31,2002-09-28T09:00:00Z,MYSM 241N 745W,0,0,0,5,5
Hurricane,Kyle,31,2002-09-28T09:00:00Z,26.0N  65.5W,28,4,1,0,33
Hurricane,Kyle,31,2002-09-28T09:00:00Z,MYEG 235N 758W,0,0,0,3,3
Hurricane,Kyle,31,2002-09-28T09:00:00Z,MUGM 200N 751W,0,0,0,2,2
Hurricane,Kyle,31,2002-09-28T09:00:00Z,MYAK 241N 776W,0,0,0,2,2
Hurricane,Kyle,31,2002-09-28T09:00:00Z,MDPP 198N 707W,0,0,0,3,3
Hurricane,Kyle,31,2002-09-28T09:00:00Z,MYNN 251N 775W,0,0,0,2,2
Hurricane,Kyle,31,2002-09-28T09:00:00Z,MBJT 215N 712W,0,0,1,5,6
Hurricane,Kyle,31,2002-09-28T09:00:00Z,BERMUDA,0,0,0,3,3
Tropical Storm,Kyle,32,2002-09-28T15:00:00Z,26.2N  64.8W,84,0,0,0,84
Tropical Storm,Kyle,32,2002-09-28T15:00:00Z,MBJT 215N 712W,0,0,1,5,6
Tropical Storm,Kyle,32,2002-09-28T15:00:00Z,26.1N  65.4W,62,0,0,0,62
Tropical Storm,Kyle,32,2002-09-28T15:00:00Z,MYMM 224N 730W,0,0,1,5,6
Tropical Storm,Kyle,32,2002-09-28T15:00:00Z,26.1N  66.0W,44,0,0,0,44
Tropical Storm,Kyle,32,2002-09-28T15:00:00Z,MYSM 241N 745W,0,0,0,4,4
Tropical Storm,Kyle,32,2002-09-28T15:00:00Z,MDSD 185N 697W,0,0,0,2,2
Tropical Storm,Kyle,32,2002-09-28T15:00:00Z,MYEG 235N 758W,0,0,0,3,3
Tropical Storm,Kyle,32,2002-09-28T15:00:00Z,MDPP 198N 707W,0,0,0,3,3
Tropical Storm,Kyle,32,2002-09-28T15:00:00Z,BERMUDA,0,0,0,3,3
Tropical Storm,Kyle,33,2002-09-28T21:00:00Z,27.0N  65.0W,61,0,0,0,61
Tropical Storm,Kyle,33,2002-09-28T21:00:00Z,MYSM 241N 745W,0,0,0,4,4
Tropical Storm,Kyle,33,2002-09-28T21:00:00Z,27.0N  65.5W,50,0,0,0,50
Tropical Storm,Kyle,33,2002-09-28T21:00:00Z,MYEG 235N 758W,0,0,0,2,2
Tropical Storm,Kyle,33,2002-09-28T21:00:00Z,27.0N  66.0W,41,0,0,0,41
Tropical Storm,Kyle,33,2002-09-28T21:00:00Z,MYNN 251N 775W,0,0,0,2,2
Tropical Storm,Kyle,33,2002-09-28T21:00:00Z,MBJT 215N 712W,0,0,0,3,3
Tropical Storm,Kyle,33,2002-09-28T21:00:00Z,BERMUDA,0,0,1,4,5
Tropical Storm,Kyle,33,2002-09-28T21:00:00Z,MYMM 224N 730W,0,0,0,3,3
Tropical Storm,Kyle,34,2002-09-29T03:00:00Z,28.2N  65.0W,76,0,0,0,76
Tropical Storm,Kyle,34,2002-09-29T03:00:00Z,MYMM 224N 730W,0,0,0,2,2
Tropical Storm,Kyle,34,2002-09-29T03:00:00Z,27.9N  65.3W,74,0,0,0,74
Tropical Storm,Kyle,34,2002-09-29T03:00:00Z,MYSM 241N 745W,0,0,0,3,3
Tropical Storm,Kyle,34,2002-09-29T03:00:00Z,27.5N  65.7W,59,0,0,0,59
Tropical Storm,Kyle,34,2002-09-29T03:00:00Z,BERMUDA,0,1,1,2,4
Tropical Storm,Kyle,34,2002-09-29T03:00:00Z,MBJT 215N 712W,0,0,0,3,3
Tropical Storm,Kyle,35,2002-09-29T09:00:00Z,27.5N  65.5W,99,0,0,0,99
Tropical Storm,Kyle,35,2002-09-29T09:00:00Z,MYSM 241N 745W,0,0,0,4,4
Tropical Storm,Kyle,35,2002-09-29T09:00:00Z,27.3N  65.8W,76,0,0,0,76
Tropical Storm,Kyle,35,2002-09-29T09:00:00Z,MYEG 235N 758W,0,0,0,2,2
Tropical Storm,Kyle,35,2002-09-29T09:00:00Z,27.0N  66.0W,60,0,0,0,60
Tropical Storm,Kyle,35,2002-09-29T09:00:00Z,MYNN 251N 775W,0,0,0,2,2
Tropical Storm,Kyle,35,2002-09-29T09:00:00Z,MBJT 215N 712W,0,0,0,3,3
Tropical Storm,Kyle,35,2002-09-29T09:00:00Z,BERMUDA,0,0,1,2,3
Tropical Storm,Kyle,35,2002-09-29T09:00:00Z,MYMM 224N 730W,0,0,0,3,3
Tropical Storm,Kyle,36,2002-09-29T15:00:00Z,27.6N  65.6W,99,0,0,0,99
Tropical Storm,Kyle,36,2002-09-29T15:00:00Z,MYSM 241N 745W,0,0,0,5,5
Tropical Storm,Kyle,36,2002-09-29T15:00:00Z,27.5N  66.0W,76,0,0,0,76
Tropical Storm,Kyle,36,2002-09-29T15:00:00Z,MYEG 235N 758W,0,0,0,3,3
Tropical Storm,Kyle,36,2002-09-29T15:00:00Z,27.0N  66.5W,42,0,0,0,42
Tropical Storm,Kyle,36,2002-09-29T15:00:00Z,MYAK 241N 776W,0,0,0,2,2
Tropical Storm,Kyle,36,2002-09-29T15:00:00Z,MDPP 198N 707W,0,0,0,2,2
Tropical Storm,Kyle,36,2002-09-29T15:00:00Z,MYNN 251N 775W,0,0,0,2,2
Tropical Storm,Kyle,36,2002-09-29T15:00:00Z,MBJT 215N 712W,0,0,1,4,5
Tropical Storm,Kyle,36,2002-09-29T15:00:00Z,BERMUDA,0,0,2,3,5
Tropical Storm,Kyle,36,2002-09-29T15:00:00Z,MYMM 224N 730W,0,0,1,5,6
Tropical Storm,Kyle,37,2002-09-29T21:00:00Z,29.0N  65.0W,99,0,0,0,99
Tropical Storm,Kyle,37,2002-09-29T21:00:00Z,29.5N  64.0W,74,0,0,0,74
Tropical Storm,Kyle,37,2002-09-29T21:00:00Z,29.0N  65.0W,99,0,0,0,99
Tropical Storm,Kyle,37,2002-09-29T21:00:00Z,BERMUDA,1,2,3,5,11
Tropical Storm,Kyle,38,2002-09-30T03:00:00Z,29.5N  64.1W,99,0,0,0,99
Tropical Storm,Kyle,38,2002-09-30T03:00:00Z,29.5N  62.1W,10,4,2,2,18
Tropical Storm,Kyle,38,2002-09-30T03:00:00Z,29.5N  63.4W,51,0,0,0,51
Tropical Storm,Kyle,38,2002-09-30T03:00:00Z,BERMUDA,1,6,3,3,13
Tropical Storm,Kyle,39,2002-09-30T09:00:00Z,29.5N  63.5W,99,0,0,0,99
Tropical Storm,Kyle,39,2002-09-30T09:00:00Z,29.2N  61.9W,8,6,2,3,19
Tropical Storm,Kyle,39,2002-09-30T09:00:00Z,29.4N  62.9W,41,0,0,0,41
Tropical Storm,Kyle,39,2002-09-30T09:00:00Z,BERMUDA,4,4,2,2,12
Tropical Storm,Kyle,40,2002-09-30T15:00:00Z,30.0N  63.5W,99,0,0,0,99
Tropical Storm,Kyle,40,2002-09-30T15:00:00Z,30.0N  60.0W,0,7,7,3,17
Tropical Storm,Kyle,40,2002-09-30T15:00:00Z,30.0N  62.0W,10,8,2,1,21
Tropical Storm,Kyle,40,2002-09-30T15:00:00Z,BERMUDA,9,2,1,1,13
Tropical Depression,Kyle,41,2002-09-30T21:00:00Z,27.3N  67.2W,99,0,0,0,99
Tropical Depression,Kyle,41,2002-09-30T21:00:00Z,MDPP 198N 707W,0,0,0,4,4
Tropical Depression,Kyle,41,2002-09-30T21:00:00Z,27.0N  67.5W,99,0,0,0,99
Tropical Depression,Kyle,41,2002-09-30T21:00:00Z,MBJT 215N 712W,0,0,1,6,7
Tropical Depression,Kyle,41,2002-09-30T21:00:00Z,27.0N  67.5W,99,0,0,0,99
Tropical Depression,Kyle,41,2002-09-30T21:00:00Z,MYMM 224N 730W,0,0,1,4,5
Tropical Depression,Kyle,41,2002-09-30T21:00:00Z,TISX 177N 648W,0,0,0,2,2
Tropical Depression,Kyle,41,2002-09-30T21:00:00Z,MYSM 241N 745W,0,0,1,4,5
Tropical Depression,Kyle,41,2002-09-30T21:00:00Z,TIST 183N 650W,0,0,0,3,3
Tropical Depression,Kyle,41,2002-09-30T21:00:00Z,MYEG 235N 758W,0,0,0,2,2
Tropical Depression,Kyle,41,2002-09-30T21:00:00Z,TJPS 180N 666W,0,0,0,3,3
Tropical Depression,Kyle,41,2002-09-30T21:00:00Z,BERMUDA,0,0,0,3,3
Tropical Depression,Kyle,41,2002-09-30T21:00:00Z,MDSD 185N 697W,0,0,0,3,3
Tropical Depression,Kyle,41,2002-09-30T21:00:00Z,ST CROIX VI,0,0,0,2,2
Tropical Depression,Kyle,41,2002-09-30T21:00:00Z,MDCB 176N 714W,0,0,0,2,2
Tropical Depression,Kyle,41,2002-09-30T21:00:00Z,ST THOMAS VI,0,0,0,3,3
Tropical Depression,Kyle,41,2002-09-30T21:00:00Z,MTPP 186N 724W,0,0,0,2,2
Tropical Depression,Kyle,41,2002-09-30T21:00:00Z,SAN JUAN PR,0,0,0,3,3
Tropical Depression,Kyle,41,2002-09-30T21:00:00Z,TJSJ 184N 661W,0,0,0,3,3
Tropical Depression,Kyle,41,2002-09-30T21:00:00Z,PONCE PR,0,0,0,3,3
Tropical Depression,Kyle,42,2002-10-01T03:00:00Z,27.1N  67.4W,99,0,0,0,99
Tropical Depression,Kyle,42,2002-10-01T03:00:00Z,MUGM 200N 751W,0,0,0,2,2
Tropical Depression,Kyle,42,2002-10-01T03:00:00Z,27.0N  67.6W,99,0,0,0,99
Tropical Depression,Kyle,42,2002-10-01T03:00:00Z,MDPP 198N 707W,0,0,0,5,5
Tropical Depression,Kyle,42,2002-10-01T03:00:00Z,27.0N  67.7W,99,0,0,0,99
Tropical Depression,Kyle,42,2002-10-01T03:00:00Z,MBJT 215N 712W,0,0,1,7,8
Tropical Depression,Kyle,42,2002-10-01T03:00:00Z,MDSD 185N 697W,0,0,0,3,3
Tropical Depression,Kyle,42,2002-10-01T03:00:00Z,MYMM 224N 730W,0,0,1,6,7
Tropical Depression,Kyle,42,2002-10-01T03:00:00Z,MDCB 176N 714W,0,0,0,2,2
Tropical Depression,Kyle,42,2002-10-01T03:00:00Z,MYSM 241N 745W,0,0,0,5,5
Tropical Depression,Kyle,42,2002-10-01T03:00:00Z,MTPP 186N 724W,0,0,0,3,3
Tropical Depression,Kyle,42,2002-10-01T03:00:00Z,MYEG 235N 758W,0,0,0,3,3
Tropical Depression,Kyle,42,2002-10-01T03:00:00Z,MTCA 183N 738W,0,0,0,2,2
Tropical Depression,Kyle,42,2002-10-01T03:00:00Z,BERMUDA,0,0,1,5,6
Tropical Depression,Kyle,43,2002-10-01T09:00:00Z,29.0N  66.0W,99,0,0,0,99
Tropical Depression,Kyle,43,2002-10-01T09:00:00Z,MYSM 241N 745W,0,0,0,4,4
Tropical Depression,Kyle,43,2002-10-01T09:00:00Z,29.0N  66.0W,99,0,0,0,99
Tropical Depression,Kyle,43,2002-10-01T09:00:00Z,MYEG 235N 758W,0,0,0,2,2
Tropical Depression,Kyle,43,2002-10-01T09:00:00Z,29.0N  66.0W,99,0,0,0,99
Tropical Depression,Kyle,43,2002-10-01T09:00:00Z,MYNN 251N 775W,0,0,0,2,2
Tropical Depression,Kyle,43,2002-10-01T09:00:00Z,MBJT 215N 712W,0,0,0,2,2
Tropical Depression,Kyle,43,2002-10-01T09:00:00Z,BERMUDA,0,3,3,4,10
Tropical Depression,Kyle,43,2002-10-01T09:00:00Z,MYMM 224N 730W,0,0,0,3,3
Tropical Storm,Kyle,44,2002-10-01T15:00:00Z,28.0N  67.3W,99,0,0,0,99
Tropical Storm,Kyle,44,2002-10-01T15:00:00Z,TJSJ 184N 661W,0,0,0,2,2
Tropical Storm,Kyle,44,2002-10-01T15:00:00Z,27.8N  67.3W,99,0,0,0,99
Tropical Storm,Kyle,44,2002-10-01T15:00:00Z,MDPP 198N 707W,0,0,1,5,6
Tropical Storm,Kyle,44,2002-10-01T15:00:00Z,27.0N  67.5W,41,1,0,0,42
Tropical Storm,Kyle,44,2002-10-01T15:00:00Z,MBJT 215N 712W,0,0,2,6,8
Tropical Storm,Kyle,44,2002-10-01T15:00:00Z,TJPS 180N 666W,0,0,0,2,2
Tropical Storm,Kyle,44,2002-10-01T15:00:00Z,MYMM 224N 730W,0,0,1,6,7
Tropical Storm,Kyle,44,2002-10-01T15:00:00Z,MDSD 185N 697W,0,0,0,4,4
Tropical Storm,Kyle,44,2002-10-01T15:00:00Z,MYSM 241N 745W,0,0,0,5,5
Tropical Storm,Kyle,44,2002-10-01T15:00:00Z,MDCB 176N 714W,0,0,0,2,2
Tropical Storm,Kyle,44,2002-10-01T15:00:00Z,MYEG 235N 758W,0,0,0,3,3
Tropical Storm,Kyle,44,2002-10-01T15:00:00Z,MTPP 186N 724W,0,0,0,3,3
Tropical Storm,Kyle,44,2002-10-01T15:00:00Z,BERMUDA,0,0,1,4,5
Tropical Storm,Kyle,44,2002-10-01T15:00:00Z,MTCA 183N 738W,0,0,0,2,2
Tropical Storm,Kyle,44,2002-10-01T15:00:00Z,SAN JUAN PR,0,0,0,2,2
Tropical Storm,Kyle,44,2002-10-01T15:00:00Z,MUGM 200N 751W,0,0,0,2,2
Tropical Storm,Kyle,44,2002-10-01T15:00:00Z,PONCE PR,0,0,0,2,2
Tropical Storm,Kyle,45,2002-10-01T21:00:00Z,28.5N  67.5W,99,0,0,0,99
Tropical Storm,Kyle,45,2002-10-01T21:00:00Z,MBJT 215N 712W,0,0,1,6,7
Tropical Storm,Kyle,45,2002-10-01T21:00:00Z,27.8N  67.7W,99,0,0,0,99
Tropical Storm,Kyle,45,2002-10-01T21:00:00Z,MYMM 224N 730W,0,0,1,4,5
Tropical Storm,Kyle,45,2002-10-01T21:00:00Z,27.2N  68.0W,26,1,1,0,28
Tropical Storm,Kyle,45,2002-10-01T21:00:00Z,MYSM 241N 745W,0,0,1,4,5
Tropical Storm,Kyle,45,2002-10-01T21:00:00Z,TISX 177N 648W,0,0,0,2,2
Tropical Storm,Kyle,45,2002-10-01T21:00:00Z,MYEG 235N 758W,0,0,0,2,2
Tropical Storm,Kyle,45,2002-10-01T21:00:00Z,TIST 183N 650W,0,0,0,2,2
Tropical Storm,Kyle,45,2002-10-01T21:00:00Z,BERMUDA,0,0,0,3,3
Tropical Storm,Kyle,45,2002-10-01T21:00:00Z,TJPS 180N 666W,0,0,0,3,3
Tropical Storm,Kyle,45,2002-10-01T21:00:00Z,ST CROIX VI,0,0,0,2,2
Tropical Storm,Kyle,45,2002-10-01T21:00:00Z,MDSD 185N 697W,0,0,0,3,3
Tropical Storm,Kyle,45,2002-10-01T21:00:00Z,ST THOMAS VI,0,0,0,2,2
Tropical Storm,Kyle,45,2002-10-01T21:00:00Z,MTPP 186N 724W,0,0,0,2,2
Tropical Storm,Kyle,45,2002-10-01T21:00:00Z,SAN JUAN PR,0,0,0,3,3
Tropical Storm,Kyle,45,2002-10-01T21:00:00Z,TJSJ 184N 661W,0,0,0,3,3
Tropical Storm,Kyle,45,2002-10-01T21:00:00Z,PONCE PR,0,0,0,3,3
Tropical Storm,Kyle,45,2002-10-01T21:00:00Z,MDPP 198N 707W,0,0,0,4,4
Tropical Storm,Kyle,46,2002-10-02T03:00:00Z,28.1N  67.9W,99,0,0,0,99
Tropical Storm,Kyle,46,2002-10-02T03:00:00Z,MYMM 224N 730W,0,0,0,4,4
Tropical Storm,Kyle,46,2002-10-02T03:00:00Z,28.0N  68.1W,99,0,0,0,99
Tropical Storm,Kyle,46,2002-10-02T03:00:00Z,MYSM 241N 745W,0,0,1,3,4
Tropical Storm,Kyle,46,2002-10-02T03:00:00Z,27.9N  68.5W,99,0,0,0,99
Tropical Storm,Kyle,46,2002-10-02T03:00:00Z,MYEG 235N 758W,0,0,0,2,2
Tropical Storm,Kyle,46,2002-10-02T03:00:00Z,MDPP 198N 707W,0,0,0,2,2
Tropical Storm,Kyle,46,2002-10-02T03:00:00Z,BERMUDA,0,0,0,2,2
Tropical Storm,Kyle,46,2002-10-02T03:00:00Z,MBJT 215N 712W,0,0,0,4,4
Tropical Storm,Kyle,46,2002-10-02T03:00:00Z,CAPE HATTERAS NC,0,0,0,2,2
Tropical Storm,Kyle,47,2002-10-02T09:00:00Z,28.5N  67.5W,99,0,0,0,99
Tropical Storm,Kyle,47,2002-10-02T09:00:00Z,MYEG 235N 758W,0,0,0,3,3
Tropical Storm,Kyle,47,2002-10-02T09:00:00Z,28.5N  67.5W,99,0,0,0,99
Tropical Storm,Kyle,47,2002-10-02T09:00:00Z,MYAK 241N 776W,0,0,0,2,2
Tropical Storm,Kyle,47,2002-10-02T09:00:00Z,28.5N  67.5W,99,0,0,0,99
Tropical Storm,Kyle,47,2002-10-02T09:00:00Z,MYNN 251N 775W,0,0,0,3,3
Tropical Storm,Kyle,47,2002-10-02T09:00:00Z,MBJT 215N 712W,0,0,0,3,3
Tropical Storm,Kyle,47,2002-10-02T09:00:00Z,MYGF 266N 787W,0,0,0,2,2
Tropical Storm,Kyle,47,2002-10-02T09:00:00Z,MYMM 224N 730W,0,0,1,3,4
Tropical Storm,Kyle,47,2002-10-02T09:00:00Z,BERMUDA,0,1,2,5,8
Tropical Storm,Kyle,47,2002-10-02T09:00:00Z,MYSM 241N 745W,0,0,1,5,6
Tropical Storm,Kyle,48,2002-10-02T15:00:00Z,28.8N  66.5W,99,0,0,0,99
Tropical Storm,Kyle,48,2002-10-02T15:00:00Z,MYEG 235N 758W,0,0,0,4,4
Tropical Storm,Kyle,48,2002-10-02T15:00:00Z,28.5N  67.0W,99,0,0,0,99
Tropical Storm,Kyle,48,2002-10-02T15:00:00Z,MYAK 241N 776W,0,0,0,3,3
Tropical Storm,Kyle,48,2002-10-02T15:00:00Z,28.3N  67.5W,99,0,0,0,99
Tropical Storm,Kyle,48,2002-10-02T15:00:00Z,MYNN 251N 775W,0,0,0,3,3
Tropical Storm,Kyle,48,2002-10-02T15:00:00Z,MBJT 215N 712W,0,0,1,3,4
Tropical Storm,Kyle,48,2002-10-02T15:00:00Z,MYGF 266N 787W,0,0,0,2,2
Tropical Storm,Kyle,48,2002-10-02T15:00:00Z,MYMM 224N 730W,0,0,1,4,5
Tropical Storm,Kyle,48,2002-10-02T15:00:00Z,BERMUDA,0,3,2,4,9
Tropical Storm,Kyle,48,2002-10-02T15:00:00Z,MYSM 241N 745W,0,0,1,6,7
Tropical Storm,Kyle,49,2002-10-02T21:00:00Z,28.7N  66.7W,99,0,0,0,99
Tropical Storm,Kyle,49,2002-10-02T21:00:00Z,MYGF 266N 787W,0,0,0,4,4
Tropical Storm,Kyle,49,2002-10-02T21:00:00Z,28.5N  67.0W,99,0,0,0,99
Tropical Storm,Kyle,49,2002-10-02T21:00:00Z,BERMUDA,0,2,3,3,8
Tropical Storm,Kyle,49,2002-10-02T21:00:00Z,28.5N  68.0W,68,0,0,0,68
Tropical Storm,Kyle,49,2002-10-02T21:00:00Z,MIAMI FL,0,0,0,2,2
Tropical Storm,Kyle,49,2002-10-02T21:00:00Z,MBJT 215N 712W,0,0,0,3,3
Tropical Storm,Kyle,49,2002-10-02T21:00:00Z,W PALM BEACH FL,0,0,0,3,3
Tropical Storm,Kyle,49,2002-10-02T21:00:00Z,MYMM 224N 730W,0,0,1,3,4
Tropical Storm,Kyle,49,2002-10-02T21:00:00Z,FT PIERCE FL,0,0,0,3,3
Tropical Storm,Kyle,49,2002-10-02T21:00:00Z,MYSM 241N 745W,0,0,1,6,7
Tropical Storm,Kyle,49,2002-10-02T21:00:00Z,COCOA BEACH FL,0,0,0,3,3
Tropical Storm,Kyle,49,2002-10-02T21:00:00Z,MYEG 235N 758W,0,0,0,4,4
Tropical Storm,Kyle,49,2002-10-02T21:00:00Z,DAYTONA BEACH FL,0,0,0,2,2
Tropical Storm,Kyle,49,2002-10-02T21:00:00Z,MYAK 241N 776W,0,0,0,4,4
Tropical Storm,Kyle,49,2002-10-02T21:00:00Z,MARCO ISLAND FL,0,0,0,2,2
Tropical Storm,Kyle,49,2002-10-02T21:00:00Z,MYNN 251N 775W,0,0,0,5,5
Tropical Storm,Kyle,49,2002-10-02T21:00:00Z,FT MYERS FL,0,0,0,2,2
Tropical Storm,Kyle,50,2002-10-03T03:00:00Z,29.0N  67.0W,99,0,0,0,99
Tropical Storm,Kyle,50,2002-10-03T03:00:00Z,MYNN 251N 775W,0,0,0,3,3
Tropical Storm,Kyle,50,2002-10-03T03:00:00Z,28.8N  67.7W,99,0,0,0,99
Tropical Storm,Kyle,50,2002-10-03T03:00:00Z,MYGF 266N 787W,0,0,0,2,2
Tropical Storm,Kyle,50,2002-10-03T03:00:00Z,28.7N  68.7W,27,1,1,0,29
Tropical Storm,Kyle,50,2002-10-03T03:00:00Z,BERMUDA,0,0,1,2,3
Tropical Storm,Kyle,50,2002-10-03T03:00:00Z,MDPP 198N 707W,0,0,0,3,3
Tropical Storm,Kyle,50,2002-10-03T03:00:00Z,MYRTLE BEACH SC,0,0,0,2,2
Tropical Storm,Kyle,50,2002-10-03T03:00:00Z,MBJT 215N 712W,0,0,0,5,5
Tropical Storm,Kyle,50,2002-10-03T03:00:00Z,WILMINGTON NC,0,0,0,2,2
Tropical Storm,Kyle,50,2002-10-03T03:00:00Z,MYMM 224N 730W,0,0,0,5,5
Tropical Storm,Kyle,50,2002-10-03T03:00:00Z,MOREHEAD CITY NC,0,0,0,3,3
Tropical Storm,Kyle,50,2002-10-03T03:00:00Z,MYSM 241N 745W,0,0,0,6,6
Tropical Storm,Kyle,50,2002-10-03T03:00:00Z,CAPE HATTERAS NC,0,0,0,4,4
Tropical Storm,Kyle,50,2002-10-03T03:00:00Z,MYEG 235N 758W,0,0,0,4,4
Tropical Storm,Kyle,50,2002-10-03T03:00:00Z,NORFOLK VA,0,0,0,2,2
Tropical Storm,Kyle,50,2002-10-03T03:00:00Z,MYAK 241N 776W,0,0,0,2,2
Tropical Storm,Kyle,51,2002-10-03T09:00:00Z,29.5N  68.1W,60,0,0,0,60
Tropical Storm,Kyle,51,2002-10-03T09:00:00Z,JACKSONVILLE FL,0,0,0,2,2
Tropical Storm,Kyle,51,2002-10-03T09:00:00Z,29.9N  69.2W,36,1,0,0,37
Tropical Storm,Kyle,51,2002-10-03T09:00:00Z,SAVANNAH GA,0,0,0,3,3
Tropical Storm,Kyle,51,2002-10-03T09:00:00Z,30.7N  70.4W,11,9,2,1,23
Tropical Storm,Kyle,51,2002-10-03T09:00:00Z,CHARLESTON SC,0,0,0,4,4
Tropical Storm,Kyle,51,2002-10-03T09:00:00Z,MYGF 266N 787W,0,0,0,2,2
Tropical Storm,Kyle,51,2002-10-03T09:00:00Z,MYRTLE BEACH SC,0,0,0,4,4
Tropical Storm,Kyle,51,2002-10-03T09:00:00Z,BERMUDA,0,1,2,5,8
Tropical Storm,Kyle,51,2002-10-03T09:00:00Z,WILMINGTON NC,0,0,0,5,5
Tropical Storm,Kyle,51,2002-10-03T09:00:00Z,FT PIERCE FL,0,0,0,2,2
Tropical Storm,Kyle,51,2002-10-03T09:00:00Z,MOREHEAD CITY NC,0,0,0,5,5
Tropical Storm,Kyle,51,2002-10-03T09:00:00Z,COCOA BEACH FL,0,0,0,2,2
Tropical Storm,Kyle,51,2002-10-03T09:00:00Z,CAPE HATTERAS NC,0,0,0,5,5
Tropical Storm,Kyle,51,2002-10-03T09:00:00Z,DAYTONA BEACH FL,0,0,0,2,2
Tropical Storm,Kyle,51,2002-10-03T09:00:00Z,NORFOLK VA,0,0,0,2,2
Tropical Storm,Kyle,52,2002-10-03T15:00:00Z,29.8N  69.2W,67,0,0,0,67
Tropical Storm,Kyle,52,2002-10-03T15:00:00Z,CHARLESTON SC,0,0,0,5,5
Tropical Storm,Kyle,52,2002-10-03T15:00:00Z,30.4N  70.3W,40,0,0,0,40
Tropical Storm,Kyle,52,2002-10-03T15:00:00Z,MYRTLE BEACH SC,0,0,0,6,6
Tropical Storm,Kyle,52,2002-10-03T15:00:00Z,31.5N  71.0W,16,6,2,0,24
Tropical Storm,Kyle,52,2002-10-03T15:00:00Z,WILMINGTON NC,0,0,0,6,6
Tropical Storm,Kyle,52,2002-10-03T15:00:00Z,BERMUDA,0,0,3,5,8
Tropical Storm,Kyle,52,2002-10-03T15:00:00Z,MOREHEAD CITY NC,0,0,1,6,7
Tropical Storm,Kyle,52,2002-10-03T15:00:00Z,COCOA BEACH FL,0,0,0,2,2
Tropical Storm,Kyle,52,2002-10-03T15:00:00Z,CAPE HATTERAS NC,0,0,1,6,7
Tropical Storm,Kyle,52,2002-10-03T15:00:00Z,DAYTONA BEACH FL,0,0,0,2,2
Tropical Storm,Kyle,52,2002-10-03T15:00:00Z,NORFOLK VA,0,0,0,4,4
Tropical Storm,Kyle,52,2002-10-03T15:00:00Z,JACKSONVILLE FL,0,0,0,2,2
Tropical Storm,Kyle,52,2002-10-03T15:00:00Z,OCEAN CITY MD,0,0,0,2,2
Tropical Storm,Kyle,52,2002-10-03T15:00:00Z,SAVANNAH GA,0,0,0,3,3
Tropical Storm,Kyle,53,2002-10-03T21:00:00Z,30.3N  69.9W,65,0,0,0,65
Tropical Storm,Kyle,53,2002-10-03T21:00:00Z,MYRTLE BEACH SC,0,0,1,5,6
Tropical Storm,Kyle,53,2002-10-03T21:00:00Z,31.3N  71.0W,36,0,0,0,36
Tropical Storm,Kyle,53,2002-10-03T21:00:00Z,WILMINGTON NC,0,0,2,6,8
Tropical Storm,Kyle,53,2002-10-03T21:00:00Z,33.0N  71.5W,5,12,2,2,21
Tropical Storm,Kyle,53,2002-10-03T21:00:00Z,MOREHEAD CITY NC,0,0,3,6,9
Tropical Storm,Kyle,53,2002-10-03T21:00:00Z,BERMUDA,0,0,2,5,7
Tropical Storm,Kyle,53,2002-10-03T21:00:00Z,CAPE HATTERAS NC,0,0,3,7,10
Tropical Storm,Kyle,53,2002-10-03T21:00:00Z,JACKSONVILLE FL,0,0,0,2,2
Tropical Storm,Kyle,53,2002-10-03T21:00:00Z,NORFOLK VA,0,0,0,6,6
Tropical Storm,Kyle,53,2002-10-03T21:00:00Z,SAVANNAH GA,0,0,0,3,3
Tropical Storm,Kyle,53,2002-10-03T21:00:00Z,OCEAN CITY MD,0,0,0,4,4
Tropical Storm,Kyle,53,2002-10-03T21:00:00Z,CHARLESTON SC,0,0,1,4,5
Tropical Storm,Kyle,53,2002-10-03T21:00:00Z,ATLANTIC CITY NJ,0,0,0,2,2
Tropical Storm,Kyle,54,2002-10-04T03:00:00Z,30.5N  70.2W,71,0,0,0,71
Tropical Storm,Kyle,54,2002-10-04T03:00:00Z,MOREHEAD CITY NC,0,0,3,7,10
Tropical Storm,Kyle,54,2002-10-04T03:00:00Z,32.0N  71.0W,29,2,1,0,32
Tropical Storm,Kyle,54,2002-10-04T03:00:00Z,CAPE HATTERAS NC,0,0,4,7,11
Tropical Storm,Kyle,54,2002-10-04T03:00:00Z,33.5N  71.1W,4,14,2,1,21
Tropical Storm,Kyle,54,2002-10-04T03:00:00Z,NORFOLK VA,0,0,1,6,7
Tropical Storm,Kyle,54,2002-10-04T03:00:00Z,BERMUDA,0,0,2,5,7
Tropical Storm,Kyle,54,2002-10-04T03:00:00Z,OCEAN CITY MD,0,0,0,6,6
Tropical Storm,Kyle,54,2002-10-04T03:00:00Z,SAVANNAH GA,0,0,0,2,2
Tropical Storm,Kyle,54,2002-10-04T03:00:00Z,ATLANTIC CITY NJ,0,0,0,4,4
Tropical Storm,Kyle,54,2002-10-04T03:00:00Z,CHARLESTON SC,0,0,1,3,4
Tropical Storm,Kyle,54,2002-10-04T03:00:00Z,NEW YORK CITY NY,0,0,0,2,2
Tropical Storm,Kyle,54,2002-10-04T03:00:00Z,MYRTLE BEACH SC,0,0,1,5,6
Tropical Storm,Kyle,54,2002-10-04T03:00:00Z,MONTAUK POINT NY,0,0,0,2,2
Tropical Storm,Kyle,54,2002-10-04T03:00:00Z,WILMINGTON NC,0,0,2,6,8
Tropical Storm,Kyle,54,2002-10-04T03:00:00Z,NANTUCKET MA,0,0,0,2,2
Tropical Storm,Kyle,55,2002-10-04T09:00:00Z,31.1N  70.5W,53,0,0,0,53
Tropical Storm,Kyle,55,2002-10-04T09:00:00Z,MYRTLE BEACH SC,0,0,1,4,5
Tropical Storm,Kyle,55,2002-10-04T09:00:00Z,31.8N  70.6W,39,0,0,0,39
Tropical Storm,Kyle,55,2002-10-04T09:00:00Z,WILMINGTON NC,0,0,1,5,6
Tropical Storm,Kyle,55,2002-10-04T09:00:00Z,32.5N  70.6W,25,1,1,1,28
Tropical Storm,Kyle,55,2002-10-04T09:00:00Z,MOREHEAD CITY NC,0,0,1,6,7
Tropical Storm,Kyle,55,2002-10-04T09:00:00Z,BERMUDA,0,1,3,5,9
Tropical Storm,Kyle,55,2002-10-04T09:00:00Z,CAPE HATTERAS NC,0,0,1,6,7
Tropical Storm,Kyle,55,2002-10-04T09:00:00Z,SAVANNAH GA,0,0,0,2,2
Tropical Storm,Kyle,55,2002-10-04T09:00:00Z,NORFOLK VA,0,0,0,4,4
Tropical Storm,Kyle,55,2002-10-04T09:00:00Z,CHARLESTON SC,0,0,0,4,4
Tropical Storm,Kyle,55,2002-10-04T09:00:00Z,OCEAN CITY MD,0,0,0,3,3
Tropical Storm,Kyle,56,2002-10-04T15:00:00Z,31.5N  71.5W,51,0,0,0,51
Tropical Storm,Kyle,56,2002-10-04T15:00:00Z,WILMINGTON NC,0,0,2,7,9
Tropical Storm,Kyle,56,2002-10-04T15:00:00Z,32.5N  71.5W,34,0,0,0,34
Tropical Storm,Kyle,56,2002-10-04T15:00:00Z,MOREHEAD CITY NC,0,0,4,7,11
Tropical Storm,Kyle,56,2002-10-04T15:00:00Z,33.5N  71.5W,16,4,1,2,23
Tropical Storm,Kyle,56,2002-10-04T15:00:00Z,CAPE HATTERAS NC,0,0,4,7,11
Tropical Storm,Kyle,56,2002-10-04T15:00:00Z,BERMUDA,0,0,1,5,6
Tropical Storm,Kyle,56,2002-10-04T15:00:00Z,NORFOLK VA,0,0,1,7,8
Tropical Storm,Kyle,56,2002-10-04T15:00:00Z,JACKSONVILLE FL,0,0,0,2,2
Tropical Storm,Kyle,56,2002-10-04T15:00:00Z,OCEAN CITY MD,0,0,0,6,6
Tropical Storm,Kyle,56,2002-10-04T15:00:00Z,SAVANNAH GA,0,0,0,3,3
Tropical Storm,Kyle,56,2002-10-04T15:00:00Z,ATLANTIC CITY NJ,0,0,0,4,4
Tropical Storm,Kyle,56,2002-10-04T15:00:00Z,CHARLESTON SC,0,0,1,5,6
Tropical Storm,Kyle,56,2002-10-04T15:00:00Z,NEW YORK CITY NY,0,0,0,2,2
Tropical Storm,Kyle,56,2002-10-04T15:00:00Z,MYRTLE BEACH SC,0,0,1,7,8
Tropical Storm,Kyle,56,2002-10-04T15:00:00Z,MONTAUK POINT NY,0,0,0,2,2
Tropical Storm,Kyle,57,2002-10-04T21:00:00Z,32.5N  71.5W,42,0,1,0,43
Tropical Storm,Kyle,57,2002-10-04T21:00:00Z,NORFOLK VA,0,1,4,6,11
Tropical Storm,Kyle,57,2002-10-04T21:00:00Z,33.5N  72.0W,24,1,1,0,26
Tropical Storm,Kyle,57,2002-10-04T21:00:00Z,OCEAN CITY MD,0,0,2,7,9
Tropical Storm,Kyle,57,2002-10-04T21:00:00Z,34.5N  72.0W,8,7,3,2,20
Tropical Storm,Kyle,57,2002-10-04T21:00:00Z,ATLANTIC CITY NJ,0,0,1,6,7
Tropical Storm,Kyle,57,2002-10-04T21:00:00Z,BERMUDA,0,0,2,4,6
Tropical Storm,Kyle,57,2002-10-04T21:00:00Z,NEW YORK CITY NY,0,0,0,5,5
Tropical Storm,Kyle,57,2002-10-04T21:00:00Z,SAVANNAH GA,0,0,0,2,2
Tropical Storm,Kyle,57,2002-10-04T21:00:00Z,MONTAUK POINT NY,0,0,0,3,3
Tropical Storm,Kyle,57,2002-10-04T21:00:00Z,CHARLESTON SC,0,0,2,3,5
Tropical Storm,Kyle,57,2002-10-04T21:00:00Z,PROVIDENCE RI,0,0,0,2,2
Tropical Storm,Kyle,57,2002-10-04T21:00:00Z,MYRTLE BEACH SC,0,1,3,4,8
Tropical Storm,Kyle,57,2002-10-04T21:00:00Z,NANTUCKET MA,0,0,0,2,2
Tropical Storm,Kyle,57,2002-10-04T21:00:00Z,WILMINGTON NC,0,2,5,4,11
Tropical Storm,Kyle,57,2002-10-04T21:00:00Z,HYANNIS MA,0,0,0,2,2
Tropical Storm,Kyle,57,2002-10-04T21:00:00Z,MOREHEAD CITY NC,0,4,6,3,13
Tropical Storm,Kyle,57,2002-10-04T21:00:00Z,BOSTON MA,0,0,0,2,2
Tropical Storm,Kyle,57,2002-10-04T21:00:00Z,CAPE HATTERAS NC,0,5,6,4,15
Tropical Storm,Kyle,58,2002-10-05T03:00:00Z,33.4N  71.7W,40,0,0,0,40
Tropical Storm,Kyle,58,2002-10-05T03:00:00Z,NORFOLK VA,0,2,6,4,12
Tropical Storm,Kyle,58,2002-10-05T03:00:00Z,34.5N  71.7W,16,4,1,2,23
Tropical Storm,Kyle,58,2002-10-05T03:00:00Z,OCEAN CITY MD,0,1,3,7,11
Tropical Storm,Kyle,58,2002-10-05T03:00:00Z,35.0N  71.5W,9,7,3,1,20
Tropical Storm,Kyle,58,2002-10-05T03:00:00Z,ATLANTIC CITY NJ,0,0,2,6,8
Tropical Storm,Kyle,58,2002-10-05T03:00:00Z,BERMUDA,0,0,2,4,6
Tropical Storm,Kyle,58,2002-10-05T03:00:00Z,NEW YORK CITY NY,0,0,1,5,6
Tropical Storm,Kyle,58,2002-10-05T03:00:00Z,CHARLESTON SC,0,0,1,2,3
Tropical Storm,Kyle,58,2002-10-05T03:00:00Z,MONTAUK POINT NY,0,0,0,4,4
Tropical Storm,Kyle,58,2002-10-05T03:00:00Z,MYRTLE BEACH SC,0,1,2,3,6
Tropical Storm,Kyle,58,2002-10-05T03:00:00Z,PROVIDENCE RI,0,0,0,3,3
Tropical Storm,Kyle,58,2002-10-05T03:00:00Z,WILMINGTON NC,0,3,3,4,10
Tropical Storm,Kyle,58,2002-10-05T03:00:00Z,NANTUCKET MA,0,0,0,3,3
Tropical Storm,Kyle,58,2002-10-05T03:00:00Z,MOREHEAD CITY NC,1,6,4,3,14
Tropical Storm,Kyle,58,2002-10-05T03:00:00Z,HYANNIS MA,0,0,0,2,2
Tropical Storm,Kyle,58,2002-10-05T03:00:00Z,CAPE HATTERAS NC,1,9,3,3,16
Tropical Storm,Kyle,58,2002-10-05T03:00:00Z,BOSTON MA,0,0,0,2,2
Tropical Depression,Kyle,59,2002-10-05T09:00:00Z,34.6N  71.5W,31,1,0,0,32
Tropical Depression,Kyle,59,2002-10-05T09:00:00Z,OCEAN CITY MD,2,5,2,4,13
Tropical Depression,Kyle,59,2002-10-05T09:00:00Z,35.0N  70.0W,10,5,3,2,20
Tropical Depression,Kyle,59,2002-10-05T09:00:00Z,ATLANTIC CITY NJ,1,2,3,4,10
Tropical Depression,Kyle,59,2002-10-05T09:00:00Z,35.0N  70.0W,10,5,3,2,20
Tropical Depression,Kyle,59,2002-10-05T09:00:00Z,NEW YORK CITY NY,0,1,2,5,8
Tropical Depression,Kyle,59,2002-10-05T09:00:00Z,BERMUDA,0,1,2,4,7
Tropical Depression,Kyle,59,2002-10-05T09:00:00Z,MONTAUK POINT NY,0,0,2,4,6
Tropical Depression,Kyle,59,2002-10-05T09:00:00Z,MYRTLE BEACH SC,0,0,0,2,2
Tropical Depression,Kyle,59,2002-10-05T09:00:00Z,PROVIDENCE RI,0,0,1,4,5
Tropical Depression,Kyle,59,2002-10-05T09:00:00Z,WILMINGTON NC,0,1,1,2,4
Tropical Depression,Kyle,59,2002-10-05T09:00:00Z,NANTUCKET MA,0,0,1,3,4
Tropical Depression,Kyle,59,2002-10-05T09:00:00Z,MOREHEAD CITY NC,2,2,2,3,9
Tropical Depression,Kyle,59,2002-10-05T09:00:00Z,HYANNIS MA,0,0,1,3,4
Tropical Depression,Kyle,59,2002-10-05T09:00:00Z,CAPE HATTERAS NC,8,2,2,2,14
Tropical Depression,Kyle,59,2002-10-05T09:00:00Z,BOSTON MA,0,0,0,3,3
Tropical Depression,Kyle,59,2002-10-05T09:00:00Z,NORFOLK VA,3,4,2,3,12
Tropical Depression,Kyle,60,2002-10-05T15:00:00Z,33.5N  70.5W,50,0,0,0,50
Tropical Depression,Kyle,60,2002-10-05T15:00:00Z,MONTAUK POINT NY,0,1,2,4,7
Tropical Depression,Kyle,60,2002-10-05T15:00:00Z,34.5N  70.0W,20,2,1,1,24
Tropical Depression,Kyle,60,2002-10-05T15:00:00Z,PROVIDENCE RI,0,0,2,5,7
Tropical Depression,Kyle,60,2002-10-05T15:00:00Z,35.0N  69.0W,9,4,3,2,18
Tropical Depression,Kyle,60,2002-10-05T15:00:00Z,NANTUCKET MA,0,1,2,5,8
Tropical Depression,Kyle,60,2002-10-05T15:00:00Z,BERMUDA,0,0,2,5,7
Tropical Depression,Kyle,60,2002-10-05T15:00:00Z,HYANNIS MA,0,0,2,5,7
Tropical Depression,Kyle,60,2002-10-05T15:00:00Z,WILMINGTON NC,0,0,1,1,2
Tropical Depression,Kyle,60,2002-10-05T15:00:00Z,BOSTON MA,0,0,2,4,6
Tropical Depression,Kyle,60,2002-10-05T15:00:00Z,MOREHEAD CITY NC,0,1,1,2,4
Tropical Depression,Kyle,60,2002-10-05T15:00:00Z,PORTLAND ME,0,0,1,3,4
Tropical Depression,Kyle,60,2002-10-05T15:00:00Z,CAPE HATTERAS NC,0,3,2,2,7
Tropical Depression,Kyle,60,2002-10-05T15:00:00Z,BAR HARBOR ME,0,0,0,3,3
Tropical Depression,Kyle,60,2002-10-05T15:00:00Z,NORFOLK VA,0,1,1,3,5
Tropical Depression,Kyle,60,2002-10-05T15:00:00Z,EASTPORT ME,0,0,0,2,2
Tropical Depression,Kyle,60,2002-10-05T15:00:00Z,OCEAN CITY MD,0,1,2,3,6
Tropical Depression,Kyle,60,2002-10-05T15:00:00Z,ST JOHN NB,0,0,0,2,2
Tropical Depression,Kyle,60,2002-10-05T15:00:00Z,ATLANTIC CITY NJ,0,1,2,3,6
Tropical Depression,Kyle,60,2002-10-05T15:00:00Z,YARMOUTH NS,0,0,0,3,3
Tropical Depression,Kyle,60,2002-10-05T15:00:00Z,NEW YORK CITY NY,0,1,1,4,6
Tropical Depression,Kyle,61,2002-10-05T21:00:00Z,35.0N  69.5W,38,0,0,0,38
Tropical Depression,Kyle,61,2002-10-05T21:00:00Z,MONTAUK POINT NY,0,2,3,4,9
Tropical Depression,Kyle,61,2002-10-05T21:00:00Z,35.5N  68.5W,20,1,1,1,23
Tropical Depression,Kyle,61,2002-10-05T21:00:00Z,PROVIDENCE RI,0,1,3,4,8
Tropical Depression,Kyle,61,2002-10-05T21:00:00Z,35.5N  67.5W,12,3,2,1,18
Tropical Depression,Kyle,61,2002-10-05T21:00:00Z,NANTUCKET MA,0,2,3,4,9
Tropical Depression,Kyle,61,2002-10-05T21:00:00Z,BERMUDA,1,3,3,3,10
Tropical Depression,Kyle,61,2002-10-05T21:00:00Z,HYANNIS MA,0,1,3,4,8
Tropical Depression,Kyle,61,2002-10-05T21:00:00Z,MOREHEAD CITY NC,0,1,1,1,3
Tropical Depression,Kyle,61,2002-10-05T21:00:00Z,BOSTON MA,0,1,2,4,7
Tropical Depression,Kyle,61,2002-10-05T21:00:00Z,CAPE HATTERAS NC,1,2,2,1,6
Tropical Depression,Kyle,61,2002-10-05T21:00:00Z,PORTLAND ME,0,0,1,4,5
Tropical Depression,Kyle,61,2002-10-05T21:00:00Z,NORFOLK VA,1,1,2,1,5
Tropical Depression,Kyle,61,2002-10-05T21:00:00Z,BAR HARBOR ME,0,0,1,3,4
Tropical Depression,Kyle,61,2002-10-05T21:00:00Z,OCEAN CITY MD,1,3,1,3,8
Tropical Depression,Kyle,61,2002-10-05T21:00:00Z,EASTPORT ME,0,0,0,3,3
Tropical Depression,Kyle,61,2002-10-05T21:00:00Z,ATLANTIC CITY NJ,0,3,2,2,7
Tropical Depression,Kyle,61,2002-10-05T21:00:00Z,ST JOHN NB,0,0,0,2,2
Tropical Depression,Kyle,61,2002-10-05T21:00:00Z,NEW YORK CITY NY,0,2,2,3,7
Tropical Depression,Kyle,61,2002-10-05T21:00:00Z,YARMOUTH NS,0,0,0,3,3
Tropical Depression,Kyle,62,2002-10-06T03:00:00Z,33.8N  68.5W,43,0,0,0,43
Tropical Depression,Kyle,62,2002-10-06T03:00:00Z,34.0N  66.5W,10,5,2,2,19
Tropical Depression,Kyle,62,2002-10-06T03:00:00Z,34.0N  67.5W,20,2,1,0,23
Tropical Depression,Kyle,62,2002-10-06T03:00:00Z,BERMUDA,0,4,4,5,13
Tropical Depression,Kyle,63,2002-10-06T09:00:00Z,34.0N  68.5W,99,0,0,0,99
Tropical Depression,Kyle,63,2002-10-06T09:00:00Z,OCEAN CITY MD,0,0,0,3,3
Tropical Depression,Kyle,63,2002-10-06T09:00:00Z,34.0N  68.0W,41,0,0,0,41
Tropical Depression,Kyle,63,2002-10-06T09:00:00Z,ATLANTIC CITY NJ,0,0,0,2,2
Tropical Depression,Kyle,63,2002-10-06T09:00:00Z,34.0N  68.0W,41,0,0,0,41
Tropical Depression,Kyle,63,2002-10-06T09:00:00Z,NEW YORK CITY NY,0,0,0,2,2
Tropical Depression,Kyle,63,2002-10-06T09:00:00Z,MYSM 241N 745W,0,0,0,2,2
Tropical Depression,Kyle,63,2002-10-06T09:00:00Z,MONTAUK POINT NY,0,0,0,3,3
Tropical Depression,Kyle,63,2002-10-06T09:00:00Z,BERMUDA,0,3,4,4,11
Tropical Depression,Kyle,63,2002-10-06T09:00:00Z,PROVIDENCE RI,0,0,0,2,2
Tropical Depression,Kyle,63,2002-10-06T09:00:00Z,WILMINGTON NC,0,0,0,2,2
Tropical Depression,Kyle,63,2002-10-06T09:00:00Z,NANTUCKET MA,0,0,0,4,4
Tropical Depression,Kyle,63,2002-10-06T09:00:00Z,MOREHEAD CITY NC,0,0,0,3,3
Tropical Depression,Kyle,63,2002-10-06T09:00:00Z,HYANNIS MA,0,0,0,3,3
Tropical Depression,Kyle,63,2002-10-06T09:00:00Z,CAPE HATTERAS NC,0,0,1,3,4
Tropical Depression,Kyle,63,2002-10-06T09:00:00Z,BOSTON MA,0,0,0,2,2
Tropical Depression,Kyle,63,2002-10-06T09:00:00Z,NORFOLK VA,0,0,0,2,2
Tropical Depression,Kyle,63,2002-10-06T09:00:00Z,YARMOUTH NS,0,0,0,2,2
Tropical Storm,Kyle,64,2002-10-06T15:00:00Z,34.0N  69.0W,99,0,0,0,99
Tropical Storm,Kyle,64,2002-10-06T15:00:00Z,NEW YORK CITY NY,0,0,0,3,3
Tropical Storm,Kyle,64,2002-10-06T15:00:00Z,34.0N  68.5W,99,0,0,0,99
Tropical Storm,Kyle,64,2002-10-06T15:00:00Z,MONTAUK POINT NY,0,0,0,4,4
Tropical Storm,Kyle,64,2002-10-06T15:00:00Z,34.0N  68.5W,99,0,0,0,99
Tropical Storm,Kyle,64,2002-10-06T15:00:00Z,PROVIDENCE RI,0,0,0,3,3
Tropical Storm,Kyle,64,2002-10-06T15:00:00Z,BERMUDA,0,1,3,4,8
Tropical Storm,Kyle,64,2002-10-06T15:00:00Z,NANTUCKET MA,0,0,0,4,4
Tropical Storm,Kyle,64,2002-10-06T15:00:00Z,MOREHEAD CITY NC,0,0,0,2,2
Tropical Storm,Kyle,64,2002-10-06T15:00:00Z,HYANNIS MA,0,0,0,4,4
Tropical Storm,Kyle,64,2002-10-06T15:00:00Z,CAPE HATTERAS NC,0,0,1,3,4
Tropical Storm,Kyle,64,2002-10-06T15:00:00Z,BOSTON MA,0,0,0,3,3
Tropical Storm,Kyle,64,2002-10-06T15:00:00Z,NORFOLK VA,0,0,0,2,2
Tropical Storm,Kyle,64,2002-10-06T15:00:00Z,PORTLAND ME,0,0,0,2,2
Tropical Storm,Kyle,64,2002-10-06T15:00:00Z,OCEAN CITY MD,0,0,1,2,3
Tropical Storm,Kyle,64,2002-10-06T15:00:00Z,YARMOUTH NS,0,0,0,2,2
Tropical Storm,Kyle,64,2002-10-06T15:00:00Z,ATLANTIC CITY NJ,0,0,0,3,3
Tropical Storm,Kyle,65,2002-10-06T21:00:00Z,32.6N  69.6W,99,0,0,0,99
Tropical Storm,Kyle,65,2002-10-06T21:00:00Z,OCEAN CITY MD,0,0,1,4,5
Tropical Storm,Kyle,65,2002-10-06T21:00:00Z,32.5N  69.5W,99,0,0,0,99
Tropical Storm,Kyle,65,2002-10-06T21:00:00Z,ATLANTIC CITY NJ,0,0,1,3,4
Tropical Storm,Kyle,65,2002-10-06T21:00:00Z,32.5N  69.5W,99,0,0,0,99
Tropical Storm,Kyle,65,2002-10-06T21:00:00Z,NEW YORK CITY NY,0,0,0,3,3
Tropical Storm,Kyle,65,2002-10-06T21:00:00Z,MBJT 215N 712W,0,0,0,2,2
Tropical Storm,Kyle,65,2002-10-06T21:00:00Z,MONTAUK POINT NY,0,0,0,3,3
Tropical Storm,Kyle,65,2002-10-06T21:00:00Z,BERMUDA,0,0,2,5,7
Tropical Storm,Kyle,65,2002-10-06T21:00:00Z,PROVIDENCE RI,0,0,0,2,2
Tropical Storm,Kyle,65,2002-10-06T21:00:00Z,WILMINGTON NC,0,0,1,2,3
Tropical Storm,Kyle,65,2002-10-06T21:00:00Z,NANTUCKET MA,0,0,0,2,2
Tropical Storm,Kyle,65,2002-10-06T21:00:00Z,MOREHEAD CITY NC,0,0,2,3,5
Tropical Storm,Kyle,65,2002-10-06T21:00:00Z,HYANNIS MA,0,0,0,2,2
Tropical Storm,Kyle,65,2002-10-06T21:00:00Z,CAPE HATTERAS NC,0,1,3,4,8
Tropical Storm,Kyle,65,2002-10-06T21:00:00Z,BOSTON MA,0,0,0,2,2
Tropical Storm,Kyle,65,2002-10-06T21:00:00Z,NORFOLK VA,0,0,2,3,5
Tropical Storm,Kyle,66,2002-10-07T03:00:00Z,32.3N  69.1W,99,0,0,0,99
Tropical Storm,Kyle,66,2002-10-07T03:00:00Z,COCOA BEACH FL,0,0,0,2,2
Tropical Storm,Kyle,66,2002-10-07T03:00:00Z,31.7N  68.4W,47,0,0,0,47
Tropical Storm,Kyle,66,2002-10-07T03:00:00Z,DAYTONA BEACH FL,0,0,0,2,2
Tropical Storm,Kyle,66,2002-10-07T03:00:00Z,30.8N  68.0W,7,9,2,2,20
Tropical Storm,Kyle,66,2002-10-07T03:00:00Z,JACKSONVILLE FL,0,0,0,2,2
Tropical Storm,Kyle,66,2002-10-07T03:00:00Z,MYSM 241N 745W,0,0,0,3,3
Tropical Storm,Kyle,66,2002-10-07T03:00:00Z,CHARLESTON SC,0,0,0,2,2
Tropical Storm,Kyle,66,2002-10-07T03:00:00Z,MYNN 251N 775W,0,0,0,2,2
Tropical Storm,Kyle,66,2002-10-07T03:00:00Z,MYRTLE BEACH SC,0,0,0,2,2
Tropical Storm,Kyle,66,2002-10-07T03:00:00Z,MYGF 266N 787W,0,0,0,2,2
Tropical Storm,Kyle,66,2002-10-07T03:00:00Z,WILMINGTON NC,0,0,0,2,2
Tropical Storm,Kyle,66,2002-10-07T03:00:00Z,BERMUDA,0,5,4,2,11
Tropical Storm,Kyle,66,2002-10-07T03:00:00Z,MOREHEAD CITY NC,0,0,0,2,2
Tropical Storm,Kyle,66,2002-10-07T03:00:00Z,W PALM BEACH FL,0,0,0,2,2
Tropical Storm,Kyle,66,2002-10-07T03:00:00Z,CAPE HATTERAS NC,0,0,0,2,2
Tropical Storm,Kyle,66,2002-10-07T03:00:00Z,FT PIERCE FL,0,0,0,2,2
Tropical Storm,Kyle,67,2002-10-07T09:00:00Z,32.0N  71.1W,99,0,0,0,99
Tropical Storm,Kyle,67,2002-10-07T09:00:00Z,MIAMI FL,0,0,0,2,2
Tropical Storm,Kyle,67,2002-10-07T09:00:00Z,31.3N  71.2W,34,1,0,0,35
Tropical Storm,Kyle,67,2002-10-07T09:00:00Z,W PALM BEACH FL,0,0,0,3,3
Tropical Storm,Kyle,67,2002-10-07T09:00:00Z,30.3N  71.4W,20,2,2,0,24
Tropical Storm,Kyle,67,2002-10-07T09:00:00Z,FT PIERCE FL,0,0,0,3,3
Tropical Storm,Kyle,67,2002-10-07T09:00:00Z,MUGM 200N 751W,0,0,0,2,2
Tropical Storm,Kyle,67,2002-10-07T09:00:00Z,COCOA BEACH FL,0,0,0,3,3
Tropical Storm,Kyle,67,2002-10-07T09:00:00Z,MUCM 214N 779W,0,0,0,2,2
Tropical Storm,Kyle,67,2002-10-07T09:00:00Z,DAYTONA BEACH FL,0,0,0,2,2
Tropical Storm,Kyle,67,2002-10-07T09:00:00Z,MBJT 215N 712W,0,0,0,3,3
Tropical Storm,Kyle,67,2002-10-07T09:00:00Z,CHARLESTON SC,0,0,0,2,2
Tropical Storm,Kyle,67,2002-10-07T09:00:00Z,MYMM 224N 730W,0,0,0,5,5
Tropical Storm,Kyle,67,2002-10-07T09:00:00Z,MYRTLE BEACH SC,0,0,1,3,4
Tropical Storm,Kyle,67,2002-10-07T09:00:00Z,MYSM 241N 745W,0,0,1,7,8
Tropical Storm,Kyle,67,2002-10-07T09:00:00Z,WILMINGTON NC,0,1,1,3,5
Tropical Storm,Kyle,67,2002-10-07T09:00:00Z,MYEG 235N 758W,0,0,0,6,6
Tropical Storm,Kyle,67,2002-10-07T09:00:00Z,MOREHEAD CITY NC,1,1,2,3,7
Tropical Storm,Kyle,67,2002-10-07T09:00:00Z,MYAK 241N 776W,0,0,0,5,5
Tropical Storm,Kyle,67,2002-10-07T09:00:00Z,CAPE HATTERAS NC,1,2,1,3,7
Tropical Storm,Kyle,67,2002-10-07T09:00:00Z,MYNN 251N 775W,0,0,0,6,6
Tropical Storm,Kyle,67,2002-10-07T09:00:00Z,NORFOLK VA,0,0,1,2,3
Tropical Storm,Kyle,67,2002-10-07T09:00:00Z,MYGF 266N 787W,0,0,0,5,5
Tropical Storm,Kyle,67,2002-10-07T09:00:00Z,OCEAN CITY MD,0,0,0,2,2
Tropical Storm,Kyle,67,2002-10-07T09:00:00Z,BERMUDA,0,0,0,2,2
Tropical Storm,Kyle,68,2002-10-07T15:00:00Z,31.3N  70.9W,50,0,0,0,50
Tropical Storm,Kyle,68,2002-10-07T15:00:00Z,MYNN 251N 775W,0,0,1,5,6
Tropical Storm,Kyle,68,2002-10-07T15:00:00Z,30.4N  71.0W,27,1,1,0,29
Tropical Storm,Kyle,68,2002-10-07T15:00:00Z,MYGF 266N 787W,0,0,0,5,5
Tropical Storm,Kyle,68,2002-10-07T15:00:00Z,29.5N  71.2W,17,4,1,1,23
Tropical Storm,Kyle,68,2002-10-07T15:00:00Z,MIAMI FL,0,0,0,2,2
Tropical Storm,Kyle,68,2002-10-07T15:00:00Z,MDSD 185N 697W,0,0,0,2,2
Tropical Storm,Kyle,68,2002-10-07T15:00:00Z,W PALM BEACH FL,0,0,0,3,3
Tropical Storm,Kyle,68,2002-10-07T15:00:00Z,MTPP 186N 724W,0,0,0,2,2
Tropical Storm,Kyle,68,2002-10-07T15:00:00Z,FT PIERCE FL,0,0,0,3,3
Tropical Storm,Kyle,68,2002-10-07T15:00:00Z,MTCA 183N 738W,0,0,0,2,2
Tropical Storm,Kyle,68,2002-10-07T15:00:00Z,COCOA BEACH FL,0,0,0,2,2
Tropical Storm,Kyle,68,2002-10-07T15:00:00Z,MUGM 200N 751W,0,0,0,3,3
Tropical Storm,Kyle,68,2002-10-07T15:00:00Z,DAYTONA BEACH FL,0,0,0,2,2
Tropical Storm,Kyle,68,2002-10-07T15:00:00Z,MUCM 214N 779W,0,0,0,2,2
Tropical Storm,Kyle,68,2002-10-07T15:00:00Z,CHARLESTON SC,0,0,0,2,2
Tropical Storm,Kyle,68,2002-10-07T15:00:00Z,MDPP 198N 707W,0,0,0,3,3
Tropical Storm,Kyle,68,2002-10-07T15:00:00Z,MYRTLE BEACH SC,0,0,1,2,3
Tropical Storm,Kyle,68,2002-10-07T15:00:00Z,MBJT 215N 712W,0,0,0,6,6
Tropical Storm,Kyle,68,2002-10-07T15:00:00Z,WILMINGTON NC,0,0,1,3,4
Tropical Storm,Kyle,68,2002-10-07T15:00:00Z,MYMM 224N 730W,0,0,1,7,8
Tropical Storm,Kyle,68,2002-10-07T15:00:00Z,MOREHEAD CITY NC,0,0,1,4,5
Tropical Storm,Kyle,68,2002-10-07T15:00:00Z,MYSM 241N 745W,0,0,2,8,10
Tropical Storm,Kyle,68,2002-10-07T15:00:00Z,CAPE HATTERAS NC,0,0,1,4,5
Tropical Storm,Kyle,68,2002-10-07T15:00:00Z,MYEG 235N 758W,0,0,0,7,7
Tropical Storm,Kyle,68,2002-10-07T15:00:00Z,NORFOLK VA,0,0,0,2,2
Tropical Storm,Kyle,68,2002-10-07T15:00:00Z,MYAK 241N 776W,0,0,0,5,5
Tropical Storm,Kyle,69,2002-10-07T21:00:00Z,31.2N  71.0W,48,0,0,0,48
Tropical Storm,Kyle,69,2002-10-07T21:00:00Z,MARATHON FL,0,0,0,2,2
Tropical Storm,Kyle,69,2002-10-07T21:00:00Z,30.3N  71.2W,29,1,0,0,30
Tropical Storm,Kyle,69,2002-10-07T21:00:00Z,MIAMI FL,0,0,0,3,3
Tropical Storm,Kyle,69,2002-10-07T21:00:00Z,29.3N  71.5W,15,5,2,1,23
Tropical Storm,Kyle,69,2002-10-07T21:00:00Z,W PALM BEACH FL,0,0,0,4,4
Tropical Storm,Kyle,69,2002-10-07T21:00:00Z,MTPP 186N 724W,0,0,0,2,2
Tropical Storm,Kyle,69,2002-10-07T21:00:00Z,FT PIERCE FL,0,0,0,4,4
Tropical Storm,Kyle,69,2002-10-07T21:00:00Z,MTCA 183N 738W,0,0,0,2,2
Tropical Storm,Kyle,69,2002-10-07T21:00:00Z,COCOA BEACH FL,0,0,0,3,3
Tropical Storm,Kyle,69,2002-10-07T21:00:00Z,MUGM 200N 751W,0,0,0,3,3
Tropical Storm,Kyle,69,2002-10-07T21:00:00Z,DAYTONA BEACH FL,0,0,0,3,3
Tropical Storm,Kyle,69,2002-10-07T21:00:00Z,MUCM 214N 779W,0,0,0,3,3
Tropical Storm,Kyle,69,2002-10-07T21:00:00Z,JACKSONVILLE FL,0,0,0,2,2
Tropical Storm,Kyle,69,2002-10-07T21:00:00Z,MDPP 198N 707W,0,0,0,3,3
Tropical Storm,Kyle,69,2002-10-07T21:00:00Z,SAVANNAH GA,0,0,0,2,2
Tropical Storm,Kyle,69,2002-10-07T21:00:00Z,MBJT 215N 712W,0,0,0,5,5
Tropical Storm,Kyle,69,2002-10-07T21:00:00Z,CHARLESTON SC,0,0,0,3,3
Tropical Storm,Kyle,69,2002-10-07T21:00:00Z,MYMM 224N 730W,0,0,1,6,7
Tropical Storm,Kyle,69,2002-10-07T21:00:00Z,MYRTLE BEACH SC,0,0,1,3,4
Tropical Storm,Kyle,69,2002-10-07T21:00:00Z,MYSM 241N 745W,0,0,2,8,10
Tropical Storm,Kyle,69,2002-10-07T21:00:00Z,WILMINGTON NC,0,0,1,4,5
Tropical Storm,Kyle,69,2002-10-07T21:00:00Z,MYEG 235N 758W,0,0,1,7,8
Tropical Storm,Kyle,69,2002-10-07T21:00:00Z,MOREHEAD CITY NC,0,0,1,4,5
Tropical Storm,Kyle,69,2002-10-07T21:00:00Z,MYAK 241N 776W,0,0,0,6,6
Tropical Storm,Kyle,69,2002-10-07T21:00:00Z,CAPE HATTERAS NC,0,0,1,4,5
Tropical Storm,Kyle,69,2002-10-07T21:00:00Z,MYNN 251N 775W,0,0,1,6,7
Tropical Storm,Kyle,69,2002-10-07T21:00:00Z,NORFOLK VA,0,0,0,2,2
Tropical Storm,Kyle,69,2002-10-07T21:00:00Z,MYGF 266N 787W,0,0,1,5,6
Tropical Storm,Kyle,69,2002-10-07T21:00:00Z,MARCO ISLAND FL,0,0,0,2,2
Tropical Storm,Kyle,70,2002-10-08T03:00:00Z,31.0N  71.2W,48,0,0,0,48
Tropical Storm,Kyle,70,2002-10-08T03:00:00Z,W PALM BEACH FL,0,0,0,5,5
Tropical Storm,Kyle,70,2002-10-08T03:00:00Z,30.0N  71.5W,30,1,0,1,32
Tropical Storm,Kyle,70,2002-10-08T03:00:00Z,FT PIERCE FL,0,0,0,5,5
Tropical Storm,Kyle,70,2002-10-08T03:00:00Z,29.0N  72.0W,10,12,1,1,24
Tropical Storm,Kyle,70,2002-10-08T03:00:00Z,COCOA BEACH FL,0,0,0,4,4
Tropical Storm,Kyle,70,2002-10-08T03:00:00Z,MTPP 186N 724W,0,0,0,2,2
Tropical Storm,Kyle,70,2002-10-08T03:00:00Z,DAYTONA BEACH FL,0,0,0,4,4
Tropical Storm,Kyle,70,2002-10-08T03:00:00Z,MTCA 183N 738W,0,0,0,2,2
Tropical Storm,Kyle,70,2002-10-08T03:00:00Z,JACKSONVILLE FL,0,0,0,3,3
Tropical Storm,Kyle,70,2002-10-08T03:00:00Z,MUGM 200N 751W,0,0,0,3,3
Tropical Storm,Kyle,70,2002-10-08T03:00:00Z,SAVANNAH GA,0,0,0,3,3
Tropical Storm,Kyle,70,2002-10-08T03:00:00Z,MUCM 214N 779W,0,0,0,3,3
Tropical Storm,Kyle,70,2002-10-08T03:00:00Z,CHARLESTON SC,0,0,0,4,4
Tropical Storm,Kyle,70,2002-10-08T03:00:00Z,MUCF 221N 805W,0,0,0,2,2
Tropical Storm,Kyle,70,2002-10-08T03:00:00Z,MYRTLE BEACH SC,0,0,1,4,5
Tropical Storm,Kyle,70,2002-10-08T03:00:00Z,MDPP 198N 707W,0,0,0,2,2
Tropical Storm,Kyle,70,2002-10-08T03:00:00Z,WILMINGTON NC,0,0,1,4,5
Tropical Storm,Kyle,70,2002-10-08T03:00:00Z,MBJT 215N 712W,0,0,0,5,5
Tropical Storm,Kyle,70,2002-10-08T03:00:00Z,MOREHEAD CITY NC,0,0,1,4,5
Tropical Storm,Kyle,70,2002-10-08T03:00:00Z,MYMM 224N 730W,0,0,1,6,7
Tropical Storm,Kyle,70,2002-10-08T03:00:00Z,CAPE HATTERAS NC,0,0,1,4,5
Tropical Storm,Kyle,70,2002-10-08T03:00:00Z,MYSM 241N 745W,0,0,2,8,10
Tropical Storm,Kyle,70,2002-10-08T03:00:00Z,NORFOLK VA,0,0,0,2,2
Tropical Storm,Kyle,70,2002-10-08T03:00:00Z,MYEG 235N 758W,0,0,1,7,8
Tropical Storm,Kyle,70,2002-10-08T03:00:00Z,KEY WEST FL,0,0,0,2,2
Tropical Storm,Kyle,70,2002-10-08T03:00:00Z,MYAK 241N 776W,0,0,0,7,7
Tropical Storm,Kyle,70,2002-10-08T03:00:00Z,MARCO ISLAND FL,0,0,0,2,2
Tropical Storm,Kyle,70,2002-10-08T03:00:00Z,MYNN 251N 775W,0,0,1,7,8
Tropical Storm,Kyle,70,2002-10-08T03:00:00Z,FT MYERS FL,0,0,0,2,2
Tropical Storm,Kyle,70,2002-10-08T03:00:00Z,MYGF 266N 787W,0,0,1,6,7
Tropical Storm,Kyle,70,2002-10-08T03:00:00Z,VENICE FL,0,0,0,2,2
Tropical Storm,Kyle,70,2002-10-08T03:00:00Z,MARATHON FL,0,0,0,2,2
Tropical Storm,Kyle,70,2002-10-08T03:00:00Z,TAMPA FL,0,0,0,2,2
Tropical Storm,Kyle,70,2002-10-08T03:00:00Z,MIAMI FL,0,0,0,4,4
Tropical Storm,Kyle,71,2002-10-08T09:00:00Z,30.3N  71.8W,54,0,0,0,54
Tropical Storm,Kyle,71,2002-10-08T09:00:00Z,MIAMI FL,0,0,0,3,3
Tropical Storm,Kyle,71,2002-10-08T09:00:00Z,29.5N  72.2W,35,0,0,0,35
Tropical Storm,Kyle,71,2002-10-08T09:00:00Z,W PALM BEACH FL,0,0,0,4,4
Tropical Storm,Kyle,71,2002-10-08T09:00:00Z,28.9N  73.0W,21,5,0,1,27
Tropical Storm,Kyle,71,2002-10-08T09:00:00Z,FT PIERCE FL,0,0,0,4,4
Tropical Storm,Kyle,71,2002-10-08T09:00:00Z,MUGM 200N 751W,0,0,0,3,3
Tropical Storm,Kyle,71,2002-10-08T09:00:00Z,COCOA BEACH FL,0,0,0,4,4
Tropical Storm,Kyle,71,2002-10-08T09:00:00Z,MUCM 214N 779W,0,0,0,2,2
Tropical Storm,Kyle,71,2002-10-08T09:00:00Z,DAYTONA BEACH FL,0,0,0,3,3
Tropical Storm,Kyle,71,2002-10-08T09:00:00Z,MDPP 198N 707W,0,0,0,2,2
Tropical Storm,Kyle,71,2002-10-08T09:00:00Z,JACKSONVILLE FL,0,0,0,2,2
Tropical Storm,Kyle,71,2002-10-08T09:00:00Z,MBJT 215N 712W,0,0,0,4,4
Tropical Storm,Kyle,71,2002-10-08T09:00:00Z,SAVANNAH GA,0,0,0,3,3
Tropical Storm,Kyle,71,2002-10-08T09:00:00Z,MYMM 224N 730W,0,0,1,5,6
Tropical Storm,Kyle,71,2002-10-08T09:00:00Z,CHARLESTON SC,0,0,0,4,4
Tropical Storm,Kyle,71,2002-10-08T09:00:00Z,MYSM 241N 745W,0,0,2,7,9
Tropical Storm,Kyle,71,2002-10-08T09:00:00Z,MYRTLE BEACH SC,0,0,1,4,5
Tropical Storm,Kyle,71,2002-10-08T09:00:00Z,MYEG 235N 758W,0,0,1,6,7
Tropical Storm,Kyle,71,2002-10-08T09:00:00Z,WILMINGTON NC,0,0,1,5,6
Tropical Storm,Kyle,71,2002-10-08T09:00:00Z,MYAK 241N 776W,0,0,0,6,6
Tropical Storm,Kyle,71,2002-10-08T09:00:00Z,MOREHEAD CITY NC,0,0,2,4,6
Tropical Storm,Kyle,71,2002-10-08T09:00:00Z,MYNN 251N 775W,0,0,1,6,7
Tropical Storm,Kyle,71,2002-10-08T09:00:00Z,CAPE HATTERAS NC,0,0,1,4,5
Tropical Storm,Kyle,71,2002-10-08T09:00:00Z,MYGF 266N 787W,0,0,1,5,6
Tropical Storm,Kyle,71,2002-10-08T09:00:00Z,NORFOLK VA,0,0,0,3,3
Tropical Storm,Kyle,71,2002-10-08T09:00:00Z,MARATHON FL,0,0,0,2,2
Tropical Storm,Kyle,72,2002-10-08T15:00:00Z,29.3N  72.4W,53,0,0,0,53
Tropical Storm,Kyle,72,2002-10-08T15:00:00Z,FT PIERCE FL,0,0,2,7,9
Tropical Storm,Kyle,72,2002-10-08T15:00:00Z,28.6N  73.5W,33,2,0,0,35
Tropical Storm,Kyle,72,2002-10-08T15:00:00Z,COCOA BEACH FL,0,0,2,7,9
Tropical Storm,Kyle,72,2002-10-08T15:00:00Z,28.1N  74.8W,9,13,2,1,25
Tropical Storm,Kyle,72,2002-10-08T15:00:00Z,DAYTONA BEACH FL,0,0,1,6,7
Tropical Storm,Kyle,72,2002-10-08T15:00:00Z,MKJS 185N 779W,0,0,0,2,2
Tropical Storm,Kyle,72,2002-10-08T15:00:00Z,JACKSONVILLE FL,0,0,0,6,6
Tropical Storm,Kyle,72,2002-10-08T15:00:00Z,MUGM 200N 751W,0,0,0,3,3
Tropical Storm,Kyle,72,2002-10-08T15:00:00Z,SAVANNAH GA,0,0,0,6,6
Tropical Storm,Kyle,72,2002-10-08T15:00:00Z,MUCM 214N 779W,0,0,0,5,5
Tropical Storm,Kyle,72,2002-10-08T15:00:00Z,CHARLESTON SC,0,0,1,6,7
Tropical Storm,Kyle,72,2002-10-08T15:00:00Z,MUCF 221N 805W,0,0,0,3,3
Tropical Storm,Kyle,72,2002-10-08T15:00:00Z,MYRTLE BEACH SC,0,0,1,6,7
Tropical Storm,Kyle,72,2002-10-08T15:00:00Z,MUHA 230N 824W,0,0,0,2,2
Tropical Storm,Kyle,72,2002-10-08T15:00:00Z,WILMINGTON NC,0,0,1,5,6
Tropical Storm,Kyle,72,2002-10-08T15:00:00Z,MBJT 215N 712W,0,0,0,2,2
Tropical Storm,Kyle,72,2002-10-08T15:00:00Z,MOREHEAD CITY NC,0,0,1,5,6
Tropical Storm,Kyle,72,2002-10-08T15:00:00Z,MYMM 224N 730W,0,0,1,5,6
Tropical Storm,Kyle,72,2002-10-08T15:00:00Z,CAPE HATTERAS NC,0,0,1,3,4
Tropical Storm,Kyle,72,2002-10-08T15:00:00Z,MYSM 241N 745W,0,1,6,4,11
Tropical Storm,Kyle,72,2002-10-08T15:00:00Z,NORFOLK VA,0,0,0,2,2
Tropical Storm,Kyle,72,2002-10-08T15:00:00Z,MYEG 235N 758W,0,0,4,6,10
Tropical Storm,Kyle,72,2002-10-08T15:00:00Z,KEY WEST FL,0,0,0,4,4
Tropical Storm,Kyle,72,2002-10-08T15:00:00Z,MYAK 241N 776W,0,0,3,7,10
Tropical Storm,Kyle,72,2002-10-08T15:00:00Z,MARCO ISLAND FL,0,0,0,5,5
Tropical Storm,Kyle,72,2002-10-08T15:00:00Z,MYNN 251N 775W,0,0,6,6,12
Tropical Storm,Kyle,72,2002-10-08T15:00:00Z,FT MYERS FL,0,0,0,5,5
Tropical Storm,Kyle,72,2002-10-08T15:00:00Z,MYGF 266N 787W,0,0,5,7,12
Tropical Storm,Kyle,72,2002-10-08T15:00:00Z,VENICE FL,0,0,0,4,4
Tropical Storm,Kyle,72,2002-10-08T15:00:00Z,MARATHON FL,0,0,0,5,5
Tropical Storm,Kyle,72,2002-10-08T15:00:00Z,TAMPA FL,0,0,0,4,4
Tropical Storm,Kyle,72,2002-10-08T15:00:00Z,MIAMI FL,0,0,1,7,8
Tropical Storm,Kyle,72,2002-10-08T15:00:00Z,CEDAR KEY FL,0,0,0,4,4
Tropical Storm,Kyle,72,2002-10-08T15:00:00Z,W PALM BEACH FL,0,0,2,7,9
Tropical Storm,Kyle,72,2002-10-08T15:00:00Z,ST MARKS FL,0,0,0,2,2
Tropical Depression,Kyle,73,2002-10-08T21:00:00Z,28.6N  74.4W,66,0,0,0,66
Tropical Depression,Kyle,73,2002-10-08T21:00:00Z,JACKSONVILLE FL,0,0,4,7,11
Tropical Depression,Kyle,73,2002-10-08T21:00:00Z,28.0N  76.0W,35,5,0,0,40
Tropical Depression,Kyle,73,2002-10-08T21:00:00Z,SAVANNAH GA,0,0,2,7,9
Tropical Depression,Kyle,73,2002-10-08T21:00:00Z,27.7N  77.7W,4,20,1,1,26
Tropical Depression,Kyle,73,2002-10-08T21:00:00Z,CHARLESTON SC,0,0,2,7,9
Tropical Depression,Kyle,73,2002-10-08T21:00:00Z,MWCG 193N 814W,0,0,0,2,2
Tropical Depression,Kyle,73,2002-10-08T21:00:00Z,MYRTLE BEACH SC,0,0,1,6,7
Tropical Depression,Kyle,73,2002-10-08T21:00:00Z,MUCM 214N 779W,0,0,1,3,4
Tropical Depression,Kyle,73,2002-10-08T21:00:00Z,WILMINGTON NC,0,0,1,4,5
Tropical Depression,Kyle,73,2002-10-08T21:00:00Z,MUCF 221N 805W,0,0,1,6,7
Tropical Depression,Kyle,73,2002-10-08T21:00:00Z,MOREHEAD CITY NC,0,0,0,4,4
Tropical Depression,Kyle,73,2002-10-08T21:00:00Z,MUSN 216N 826W,0,0,0,5,5
Tropical Depression,Kyle,73,2002-10-08T21:00:00Z,CAPE HATTERAS NC,0,0,0,2,2
Tropical Depression,Kyle,73,2002-10-08T21:00:00Z,MUHA 230N 824W,0,0,1,6,7
Tropical Depression,Kyle,73,2002-10-08T21:00:00Z,KEY WEST FL,0,0,3,8,11
Tropical Depression,Kyle,73,2002-10-08T21:00:00Z,MUAN 219N 850W,0,0,0,3,3
Tropical Depression,Kyle,73,2002-10-08T21:00:00Z,MARCO ISLAND FL,0,0,6,7,13
Tropical Depression,Kyle,73,2002-10-08T21:00:00Z,MYSM 241N 745W,0,1,1,2,4
Tropical Depression,Kyle,73,2002-10-08T21:00:00Z,FT MYERS FL,0,0,5,8,13
Tropical Depression,Kyle,73,2002-10-08T21:00:00Z,MYEG 235N 758W,0,1,2,3,6
Tropical Depression,Kyle,73,2002-10-08T21:00:00Z,VENICE FL,0,0,4,8,12
Tropical Depression,Kyle,73,2002-10-08T21:00:00Z,MYAK 241N 776W,0,2,6,3,11
Tropical Depression,Kyle,73,2002-10-08T21:00:00Z,TAMPA FL,0,0,4,8,12
Tropical Depression,Kyle,73,2002-10-08T21:00:00Z,MYNN 251N 775W,0,7,6,2,15
Tropical Depression,Kyle,73,2002-10-08T21:00:00Z,CEDAR KEY FL,0,0,2,8,10
Tropical Depression,Kyle,73,2002-10-08T21:00:00Z,MYGF 266N 787W,0,12,6,2,20
Tropical Depression,Kyle,73,2002-10-08T21:00:00Z,ST MARKS FL,0,0,0,7,7
Tropical Depression,Kyle,73,2002-10-08T21:00:00Z,MARATHON FL,0,0,5,7,12
Tropical Depression,Kyle,73,2002-10-08T21:00:00Z,APALACHICOLA FL,0,0,0,6,6
Tropical Depression,Kyle,73,2002-10-08T21:00:00Z,MIAMI FL,0,1,9,5,15
Tropical Depression,Kyle,73,2002-10-08T21:00:00Z,PANAMA CITY FL,0,0,0,4,4
Tropical Depression,Kyle,73,2002-10-08T21:00:00Z,W PALM BEACH FL,0,4,9,4,17
Tropical Depression,Kyle,73,2002-10-08T21:00:00Z,PENSACOLA FL,0,0,0,2,2
Tropical Depression,Kyle,73,2002-10-08T21:00:00Z,FT PIERCE FL,0,4,9,4,17
Tropical Depression,Kyle,73,2002-10-08T21:00:00Z,GULF 29N 85W,0,0,0,6,6
Tropical Depression,Kyle,73,2002-10-08T21:00:00Z,COCOA BEACH FL,0,3,8,5,16
Tropical Depression,Kyle,73,2002-10-08T21:00:00Z,GULF 29N 87W,0,0,0,3,3
Tropical Depression,Kyle,73,2002-10-08T21:00:00Z,DAYTONA BEACH FL,0,1,7,6,14
Tropical Depression,Kyle,74,2002-10-09T03:00:00Z,27.8N  76.0W,43,0,0,0,43
Tropical Depression,Kyle,74,2002-10-09T03:00:00Z,WILMINGTON NC,0,0,1,6,7
Tropical Depression,Kyle,74,2002-10-09T03:00:00Z,27.5N  78.0W,10,17,1,0,28
Tropical Depression,Kyle,74,2002-10-09T03:00:00Z,MOREHEAD CITY NC,0,0,0,5,5
Tropical Depression,Kyle,74,2002-10-09T03:00:00Z,27.5N  80.0W,0,14,7,2,23
Tropical Depression,Kyle,74,2002-10-09T03:00:00Z,CAPE HATTERAS NC,0,0,0,3,3
Tropical Depression,Kyle,74,2002-10-09T03:00:00Z,MUCF 221N 805W,0,0,0,2,2
Tropical Depression,Kyle,74,2002-10-09T03:00:00Z,KEY WEST FL,0,0,4,6,10
Tropical Depression,Kyle,74,2002-10-09T03:00:00Z,MUSN 216N 826W,0,0,0,2,2
Tropical Depression,Kyle,74,2002-10-09T03:00:00Z,MARCO ISLAND FL,0,1,9,6,16
Tropical Depression,Kyle,74,2002-10-09T03:00:00Z,MUHA 230N 824W,0,0,1,4,5
Tropical Depression,Kyle,74,2002-10-09T03:00:00Z,FT MYERS FL,0,1,10,6,17
Tropical Depression,Kyle,74,2002-10-09T03:00:00Z,MUAN 219N 850W,0,0,0,2,2
Tropical Depression,Kyle,74,2002-10-09T03:00:00Z,VENICE FL,0,0,9,8,17
Tropical Depression,Kyle,74,2002-10-09T03:00:00Z,MYAK 241N 776W,0,2,3,1,6
Tropical Depression,Kyle,74,2002-10-09T03:00:00Z,TAMPA FL,0,1,9,7,17
Tropical Depression,Kyle,74,2002-10-09T03:00:00Z,MYNN 251N 775W,0,8,3,1,12
Tropical Depression,Kyle,74,2002-10-09T03:00:00Z,CEDAR KEY FL,0,0,7,9,16
Tropical Depression,Kyle,74,2002-10-09T03:00:00Z,MYGF 266N 787W,1,17,3,1,22
Tropical Depression,Kyle,74,2002-10-09T03:00:00Z,ST MARKS FL,0,0,2,10,12
Tropical Depression,Kyle,74,2002-10-09T03:00:00Z,MARATHON FL,0,0,7,4,11
Tropical Depression,Kyle,74,2002-10-09T03:00:00Z,APALACHICOLA FL,0,0,1,10,11
Tropical Depression,Kyle,74,2002-10-09T03:00:00Z,MIAMI FL,0,4,10,3,17
Tropical Depression,Kyle,74,2002-10-09T03:00:00Z,PANAMA CITY FL,0,0,0,9,9
Tropical Depression,Kyle,74,2002-10-09T03:00:00Z,W PALM BEACH FL,0,9,9,2,20
Tropical Depression,Kyle,74,2002-10-09T03:00:00Z,PENSACOLA FL,0,0,0,5,5
Tropical Depression,Kyle,74,2002-10-09T03:00:00Z,FT PIERCE FL,0,11,9,2,22
Tropical Depression,Kyle,74,2002-10-09T03:00:00Z,MOBILE AL,0,0,0,3,3
Tropical Depression,Kyle,74,2002-10-09T03:00:00Z,COCOA BEACH FL,0,10,10,2,22
Tropical Depression,Kyle,74,2002-10-09T03:00:00Z,GULFPORT MS,0,0,0,2,2
Tropical Depression,Kyle,74,2002-10-09T03:00:00Z,DAYTONA BEACH FL,0,5,11,5,21
Tropical Depression,Kyle,74,2002-10-09T03:00:00Z,BURAS LA,0,0,0,2,2
Tropical Depression,Kyle,74,2002-10-09T03:00:00Z,JACKSONVILLE FL,0,1,9,7,17
Tropical Depression,Kyle,74,2002-10-09T03:00:00Z,GULF 29N 85W,0,0,1,11,12
Tropical Depression,Kyle,74,2002-10-09T03:00:00Z,SAVANNAH GA,0,0,5,8,13
Tropical Depression,Kyle,74,2002-10-09T03:00:00Z,GULF 29N 87W,0,0,0,7,7
Tropical Depression,Kyle,74,2002-10-09T03:00:00Z,CHARLESTON SC,0,0,4,8,12
Tropical Depression,Kyle,74,2002-10-09T03:00:00Z,GULF 28N 89W,0,0,0,3,3
Tropical Depression,Kyle,74,2002-10-09T03:00:00Z,MYRTLE BEACH SC,0,0,2,7,9
Tropical Depression,Kyle,75,2002-10-09T09:00:00Z,27.4N  77.1W,42,0,0,0,42
Tropical Depression,Kyle,75,2002-10-09T09:00:00Z,CAPE HATTERAS NC,0,0,0,3,3
Tropical Depression,Kyle,75,2002-10-09T09:00:00Z,27.4N  79.1W,11,15,0,1,27
Tropical Depression,Kyle,75,2002-10-09T09:00:00Z,KEY WEST FL,0,1,5,3,9
Tropical Depression,Kyle,75,2002-10-09T09:00:00Z,27.8N  81.1W,0,12,7,2,21
Tropical Depression,Kyle,75,2002-10-09T09:00:00Z,MARCO ISLAND FL,0,4,9,3,16
Tropical Depression,Kyle,75,2002-10-09T09:00:00Z,MUHA 230N 824W,0,0,1,3,4
Tropical Depression,Kyle,75,2002-10-09T09:00:00Z,FT MYERS FL,0,4,10,3,17
Tropical Depression,Kyle,75,2002-10-09T09:00:00Z,MYAK 241N 776W,0,3,1,1,5
Tropical Depression,Kyle,75,2002-10-09T09:00:00Z,VENICE FL,0,2,11,4,17
Tropical Depression,Kyle,75,2002-10-09T09:00:00Z,MYNN 251N 775W,3,7,1,0,11
Tropical Depression,Kyle,75,2002-10-09T09:00:00Z,TAMPA FL,0,3,11,4,18
Tropical Depression,Kyle,75,2002-10-09T09:00:00Z,MYGF 266N 787W,10,13,0,1,24
Tropical Depression,Kyle,75,2002-10-09T09:00:00Z,CEDAR KEY FL,0,1,10,6,17
Tropical Depression,Kyle,75,2002-10-09T09:00:00Z,MARATHON FL,0,2,6,3,11
Tropical Depression,Kyle,75,2002-10-09T09:00:00Z,ST MARKS FL,0,0,4,10,14
Tropical Depression,Kyle,75,2002-10-09T09:00:00Z,MIAMI FL,0,10,4,2,16
Tropical Depression,Kyle,75,2002-10-09T09:00:00Z,APALACHICOLA FL,0,0,2,11,13
Tropical Depression,Kyle,75,2002-10-09T09:00:00Z,W PALM BEACH FL,1,16,2,1,20
Tropical Depression,Kyle,75,2002-10-09T09:00:00Z,PANAMA CITY FL,0,0,1,10,11
Tropical Depression,Kyle,75,2002-10-09T09:00:00Z,FT PIERCE FL,1,17,3,1,22
Tropical Depression,Kyle,75,2002-10-09T09:00:00Z,PENSACOLA FL,0,0,0,7,7
Tropical Depression,Kyle,75,2002-10-09T09:00:00Z,COCOA BEACH FL,1,15,5,2,23
Tropical Depression,Kyle,75,2002-10-09T09:00:00Z,MOBILE AL,0,0,0,5,5
Tropical Depression,Kyle,75,2002-10-09T09:00:00Z,DAYTONA BEACH FL,0,10,8,3,21
Tropical Depression,Kyle,75,2002-10-09T09:00:00Z,GULFPORT MS,0,0,0,4,4
Tropical Depression,Kyle,75,2002-10-09T09:00:00Z,JACKSONVILLE FL,0,3,9,6,18
Tropical Depression,Kyle,75,2002-10-09T09:00:00Z,BURAS LA,0,0,0,4,4
Tropical Depression,Kyle,75,2002-10-09T09:00:00Z,SAVANNAH GA,0,1,6,8,15
Tropical Depression,Kyle,75,2002-10-09T09:00:00Z,NEW ORLEANS LA,0,0,0,2,2
Tropical Depression,Kyle,75,2002-10-09T09:00:00Z,CHARLESTON SC,0,1,5,7,13
Tropical Depression,Kyle,75,2002-10-09T09:00:00Z,GULF 29N 85W,0,0,3,10,13
Tropical Depression,Kyle,75,2002-10-09T09:00:00Z,MYRTLE BEACH SC,0,0,3,7,10
Tropical Depression,Kyle,75,2002-10-09T09:00:00Z,GULF 29N 87W,0,0,0,9,9
Tropical Depression,Kyle,75,2002-10-09T09:00:00Z,WILMINGTON NC,0,0,1,6,7
Tropical Depression,Kyle,75,2002-10-09T09:00:00Z,GULF 28N 89W,0,0,0,5,5
Tropical Depression,Kyle,75,2002-10-09T09:00:00Z,MOREHEAD CITY NC,0,0,1,4,5
Tropical Depression,Kyle,75,2002-10-09T09:00:00Z,GULF 28N 91W,0,0,0,2,2
Tropical Depression,Kyle,76,2002-10-09T15:00:00Z,27.7N  77.9W,45,0,0,0,45
Tropical Depression,Kyle,76,2002-10-09T15:00:00Z,KEY WEST FL,0,1,2,2,5
Tropical Depression,Kyle,76,2002-10-09T15:00:00Z,28.0N  79.9W,15,16,0,0,31
Tropical Depression,Kyle,76,2002-10-09T15:00:00Z,MARCO ISLAND FL,0,7,4,2,13
Tropical Depression,Kyle,76,2002-10-09T15:00:00Z,28.8N  81.3W,1,19,3,1,24
Tropical Depression,Kyle,76,2002-10-09T15:00:00Z,FT MYERS FL,0,9,5,2,16
Tropical Depression,Kyle,76,2002-10-09T15:00:00Z,MYNN 251N 775W,3,2,1,0,6
Tropical Depression,Kyle,76,2002-10-09T15:00:00Z,VENICE FL,0,7,7,3,17
Tropical Depression,Kyle,76,2002-10-09T15:00:00Z,MYGF 266N 787W,20,5,0,0,25
Tropical Depression,Kyle,76,2002-10-09T15:00:00Z,TAMPA FL,0,9,8,2,19
Tropical Depression,Kyle,76,2002-10-09T15:00:00Z,MARATHON FL,0,2,2,2,6
Tropical Depression,Kyle,76,2002-10-09T15:00:00Z,CEDAR KEY FL,0,5,10,4,19
Tropical Depression,Kyle,76,2002-10-09T15:00:00Z,MIAMI FL,1,10,2,1,14
Tropical Depression,Kyle,76,2002-10-09T15:00:00Z,ST MARKS FL,0,0,8,8,16
Tropical Depression,Kyle,76,2002-10-09T15:00:00Z,W PALM BEACH FL,4,16,1,1,22
Tropical Depression,Kyle,76,2002-10-09T15:00:00Z,APALACHICOLA FL,0,0,5,10,15
Tropical Depression,Kyle,76,2002-10-09T15:00:00Z,FT PIERCE FL,6,19,1,0,26
Tropical Depression,Kyle,76,2002-10-09T15:00:00Z,PANAMA CITY FL,0,0,3,10,13
Tropical Depression,Kyle,76,2002-10-09T15:00:00Z,COCOA BEACH FL,4,22,1,0,27
Tropical Depression,Kyle,76,2002-10-09T15:00:00Z,PENSACOLA FL,0,0,0,9,9
Tropical Depression,Kyle,76,2002-10-09T15:00:00Z,DAYTONA BEACH FL,1,19,3,2,25
Tropical Depression,Kyle,76,2002-10-09T15:00:00Z,MOBILE AL,0,0,0,7,7
Tropical Depression,Kyle,76,2002-10-09T15:00:00Z,JACKSONVILLE FL,0,9,8,4,21
Tropical Depression,Kyle,76,2002-10-09T15:00:00Z,GULFPORT MS,0,0,0,5,5
Tropical Depression,Kyle,76,2002-10-09T15:00:00Z,SAVANNAH GA,0,2,8,7,17
Tropical Depression,Kyle,76,2002-10-09T15:00:00Z,BURAS LA,0,0,0,4,4
Tropical Depression,Kyle,76,2002-10-09T15:00:00Z,CHARLESTON SC,0,1,6,8,15
Tropical Depression,Kyle,76,2002-10-09T15:00:00Z,NEW ORLEANS LA,0,0,0,3,3
Tropical Depression,Kyle,76,2002-10-09T15:00:00Z,MYRTLE BEACH SC,0,0,4,7,11
Tropical Depression,Kyle,76,2002-10-09T15:00:00Z,GULF 29N 85W,0,0,6,9,15
Tropical Depression,Kyle,76,2002-10-09T15:00:00Z,WILMINGTON NC,0,0,1,7,8
Tropical Depression,Kyle,76,2002-10-09T15:00:00Z,GULF 29N 87W,0,0,1,9,10
Tropical Depression,Kyle,76,2002-10-09T15:00:00Z,MOREHEAD CITY NC,0,0,0,6,6
Tropical Depression,Kyle,76,2002-10-09T15:00:00Z,GULF 28N 89W,0,0,0,5,5
Tropical Depression,Kyle,76,2002-10-09T15:00:00Z,CAPE HATTERAS NC,0,0,0,3,3
Tropical Depression,Kyle,76,2002-10-09T15:00:00Z,GULF 28N 91W,0,0,0,2,2
Tropical Depression,Kyle,76,2002-10-09T15:00:00Z,NORFOLK VA,0,0,0,2,2
Tropical Depression,Kyle,77,2002-10-09T21:00:00Z,28.0N  78.6W,41,0,0,0,41
Tropical Depression,Kyle,77,2002-10-09T21:00:00Z,NORFOLK VA,0,0,0,3,3
Tropical Depression,Kyle,77,2002-10-09T21:00:00Z,28.3N  80.4W,17,9,0,1,27
Tropical Depression,Kyle,77,2002-10-09T21:00:00Z,KEY WEST FL,0,1,2,1,4
Tropical Depression,Kyle,77,2002-10-09T21:00:00Z,29.5N  81.5W,2,16,3,1,22
Tropical Depression,Kyle,77,2002-10-09T21:00:00Z,MARCO ISLAND FL,1,7,2,1,11
Tropical Depression,Kyle,77,2002-10-09T21:00:00Z,MYNN 251N 775W,1,1,0,0,2
Tropical Depression,Kyle,77,2002-10-09T21:00:00Z,FT MYERS FL,1,10,2,1,14
Tropical Depression,Kyle,77,2002-10-09T21:00:00Z,MYGF 266N 787W,20,0,0,1,21
Tropical Depression,Kyle,77,2002-10-09T21:00:00Z,VENICE FL,0,10,3,2,15
Tropical Depression,Kyle,77,2002-10-09T21:00:00Z,MARATHON FL,0,2,2,0,4
Tropical Depression,Kyle,77,2002-10-09T21:00:00Z,TAMPA FL,0,12,4,2,18
Tropical Depression,Kyle,77,2002-10-09T21:00:00Z,MIAMI FL,3,7,1,0,11
Tropical Depression,Kyle,77,2002-10-09T21:00:00Z,CEDAR KEY FL,0,8,7,3,18
Tropical Depression,Kyle,77,2002-10-09T21:00:00Z,W PALM BEACH FL,11,7,0,1,19
Tropical Depression,Kyle,77,2002-10-09T21:00:00Z,ST MARKS FL,0,1,8,6,15
Tropical Depression,Kyle,77,2002-10-09T21:00:00Z,FT PIERCE FL,15,8,0,1,24
Tropical Depression,Kyle,77,2002-10-09T21:00:00Z,APALACHICOLA FL,0,0,6,7,13
Tropical Depression,Kyle,77,2002-10-09T21:00:00Z,COCOA BEACH FL,14,10,1,1,26
Tropical Depression,Kyle,77,2002-10-09T21:00:00Z,PANAMA CITY FL,0,0,3,8,11
Tropical Depression,Kyle,77,2002-10-09T21:00:00Z,DAYTONA BEACH FL,6,15,2,1,24
Tropical Depression,Kyle,77,2002-10-09T21:00:00Z,PENSACOLA FL,0,0,0,7,7
Tropical Depression,Kyle,77,2002-10-09T21:00:00Z,JACKSONVILLE FL,1,12,6,2,21
Tropical Depression,Kyle,77,2002-10-09T21:00:00Z,MOBILE AL,0,0,0,5,5
Tropical Depression,Kyle,77,2002-10-09T21:00:00Z,SAVANNAH GA,0,5,9,5,19
Tropical Depression,Kyle,77,2002-10-09T21:00:00Z,GULFPORT MS,0,0,0,3,3
Tropical Depression,Kyle,77,2002-10-09T21:00:00Z,CHARLESTON SC,0,4,8,5,17
Tropical Depression,Kyle,77,2002-10-09T21:00:00Z,BURAS LA,0,0,0,2,2
Tropical Depression,Kyle,77,2002-10-09T21:00:00Z,MYRTLE BEACH SC,0,1,6,6,13
Tropical Depression,Kyle,77,2002-10-09T21:00:00Z,GULF 29N 85W,0,0,6,6,12
Tropical Depression,Kyle,77,2002-10-09T21:00:00Z,WILMINGTON NC,0,0,3,7,10
Tropical Depression,Kyle,77,2002-10-09T21:00:00Z,GULF 29N 87W,0,0,1,6,7
Tropical Depression,Kyle,77,2002-10-09T21:00:00Z,MOREHEAD CITY NC,0,0,1,6,7
Tropical Depression,Kyle,77,2002-10-09T21:00:00Z,GULF 28N 89W,0,0,0,2,2
Tropical Depression,Kyle,77,2002-10-09T21:00:00Z,CAPE HATTERAS NC,0,0,0,4,4
Tropical Depression,Kyle,78,2002-10-10T03:00:00Z,28.6N  79.5W,44,0,0,0,44
Tropical Depression,Kyle,78,2002-10-10T03:00:00Z,NORFOLK VA,0,0,1,8,9
Tropical Depression,Kyle,78,2002-10-10T03:00:00Z,29.4N  80.9W,22,4,1,0,27
Tropical Depression,Kyle,78,2002-10-10T03:00:00Z,OCEAN CITY MD,0,0,0,5,5
Tropical Depression,Kyle,78,2002-10-10T03:00:00Z,31.0N  81.0W,8,12,2,1,23
Tropical Depression,Kyle,78,2002-10-10T03:00:00Z,ATLANTIC CITY NJ,0,0,0,3,3
Tropical Depression,Kyle,78,2002-10-10T03:00:00Z,MYGF 266N 787W,19,0,1,0,20
Tropical Depression,Kyle,78,2002-10-10T03:00:00Z,MARCO ISLAND FL,1,4,1,0,6
Tropical Depression,Kyle,78,2002-10-10T03:00:00Z,MIAMI FL,3,2,1,0,6
Tropical Depression,Kyle,78,2002-10-10T03:00:00Z,FT MYERS FL,2,7,1,0,10
Tropical Depression,Kyle,78,2002-10-10T03:00:00Z,W PALM BEACH FL,13,1,1,0,15
Tropical Depression,Kyle,78,2002-10-10T03:00:00Z,VENICE FL,2,8,1,0,11
Tropical Depression,Kyle,78,2002-10-10T03:00:00Z,FT PIERCE FL,22,1,0,0,23
Tropical Depression,Kyle,78,2002-10-10T03:00:00Z,TAMPA FL,3,11,1,1,16
Tropical Depression,Kyle,78,2002-10-10T03:00:00Z,COCOA BEACH FL,25,1,1,0,27
Tropical Depression,Kyle,78,2002-10-10T03:00:00Z,CEDAR KEY FL,1,12,3,1,17
Tropical Depression,Kyle,78,2002-10-10T03:00:00Z,DAYTONA BEACH FL,20,5,1,0,26
Tropical Depression,Kyle,78,2002-10-10T03:00:00Z,ST MARKS FL,0,5,6,3,14
Tropical Depression,Kyle,78,2002-10-10T03:00:00Z,JACKSONVILLE FL,5,14,2,1,22
Tropical Depression,Kyle,78,2002-10-10T03:00:00Z,APALACHICOLA FL,0,2,5,3,10
Tropical Depression,Kyle,78,2002-10-10T03:00:00Z,SAVANNAH GA,1,11,6,3,21
Tropical Depression,Kyle,78,2002-10-10T03:00:00Z,PANAMA CITY FL,0,1,3,4,8
Tropical Depression,Kyle,78,2002-10-10T03:00:00Z,CHARLESTON SC,1,8,7,4,20
Tropical Depression,Kyle,78,2002-10-10T03:00:00Z,PENSACOLA FL,0,0,1,3,4
Tropical Depression,Kyle,78,2002-10-10T03:00:00Z,MYRTLE BEACH SC,0,4,8,6,18
Tropical Depression,Kyle,78,2002-10-10T03:00:00Z,MOBILE AL,0,0,0,2,2
Tropical Depression,Kyle,78,2002-10-10T03:00:00Z,WILMINGTON NC,0,1,7,7,15
Tropical Depression,Kyle,78,2002-10-10T03:00:00Z,GULF 29N 85W,0,2,5,2,9
Tropical Depression,Kyle,78,2002-10-10T03:00:00Z,MOREHEAD CITY NC,0,0,4,8,12
Tropical Depression,Kyle,78,2002-10-10T03:00:00Z,GULF 29N 87W,0,0,1,2,3
Tropical Depression,Kyle,78,2002-10-10T03:00:00Z,CAPE HATTERAS NC,0,0,1,9,10
Tropical Depression,Kyle,79,2002-10-10T09:00:00Z,29.1N  80.5W,45,0,0,0,45
Tropical Depression,Kyle,79,2002-10-10T09:00:00Z,NORFOLK VA,0,0,1,9,10
Tropical Depression,Kyle,79,2002-10-10T09:00:00Z,30.3N  81.1W,27,2,1,0,30
Tropical Depression,Kyle,79,2002-10-10T09:00:00Z,OCEAN CITY MD,0,0,0,7,7
Tropical Depression,Kyle,79,2002-10-10T09:00:00Z,31.8N  80.9W,8,13,2,1,24
Tropical Depression,Kyle,79,2002-10-10T09:00:00Z,ATLANTIC CITY NJ,0,0,0,4,4
Tropical Depression,Kyle,79,2002-10-10T09:00:00Z,MYGF 266N 787W,14,0,0,0,14
Tropical Depression,Kyle,79,2002-10-10T09:00:00Z,NEW YORK CITY NY,0,0,0,2,2
Tropical Depression,Kyle,79,2002-10-10T09:00:00Z,MIAMI FL,2,0,0,0,2
Tropical Depression,Kyle,79,2002-10-10T09:00:00Z,MARCO ISLAND FL,1,2,0,0,3
Tropical Depression,Kyle,79,2002-10-10T09:00:00Z,W PALM BEACH FL,14,0,0,0,14
Tropical Depression,Kyle,79,2002-10-10T09:00:00Z,FT MYERS FL,4,2,1,0,7
Tropical Depression,Kyle,79,2002-10-10T09:00:00Z,FT PIERCE FL,29,0,0,0,29
Tropical Depression,Kyle,79,2002-10-10T09:00:00Z,VENICE FL,5,3,1,0,9
Tropical Depression,Kyle,79,2002-10-10T09:00:00Z,COCOA BEACH FL,37,1,0,0,38
Tropical Depression,Kyle,79,2002-10-10T09:00:00Z,TAMPA FL,12,3,1,0,16
Tropical Depression,Kyle,79,2002-10-10T09:00:00Z,DAYTONA BEACH FL,36,0,0,0,36
Tropical Depression,Kyle,79,2002-10-10T09:00:00Z,CEDAR KEY FL,9,7,1,0,17
Tropical Depression,Kyle,79,2002-10-10T09:00:00Z,JACKSONVILLE FL,18,6,1,1,26
Tropical Depression,Kyle,79,2002-10-10T09:00:00Z,ST MARKS FL,1,7,3,2,13
Tropical Depression,Kyle,79,2002-10-10T09:00:00Z,SAVANNAH GA,4,14,3,1,22
Tropical Depression,Kyle,79,2002-10-10T09:00:00Z,APALACHICOLA FL,0,3,4,2,9
Tropical Depression,Kyle,79,2002-10-10T09:00:00Z,CHARLESTON SC,1,13,4,2,20
Tropical Depression,Kyle,79,2002-10-10T09:00:00Z,PANAMA CITY FL,0,1,4,2,7
Tropical Depression,Kyle,79,2002-10-10T09:00:00Z,MYRTLE BEACH SC,0,7,7,4,18
Tropical Depression,Kyle,79,2002-10-10T09:00:00Z,PENSACOLA FL,0,0,1,3,4
Tropical Depression,Kyle,79,2002-10-10T09:00:00Z,WILMINGTON NC,0,2,8,6,16
Tropical Depression,Kyle,79,2002-10-10T09:00:00Z,MOBILE AL,0,0,0,3,3
Tropical Depression,Kyle,79,2002-10-10T09:00:00Z,MOREHEAD CITY NC,0,1,5,7,13
Tropical Depression,Kyle,79,2002-10-10T09:00:00Z,GULF 29N 85W,0,3,3,2,8
Tropical Depression,Kyle,79,2002-10-10T09:00:00Z,CAPE HATTERAS NC,0,0,3,7,10
Tropical Depression,Kyle,79,2002-10-10T09:00:00Z,GULF 29N 87W,0,0,1,2,3
Tropical Depression,Kyle,80,2002-10-10T15:00:00Z,30.3N  81.2W,47,0,0,0,47
Tropical Depression,Kyle,80,2002-10-10T15:00:00Z,OCEAN CITY MD,0,0,1,9,10
Tropical Depression,Kyle,80,2002-10-10T15:00:00Z,31.8N  81.1W,24,4,0,0,28
Tropical Depression,Kyle,80,2002-10-10T15:00:00Z,ATLANTIC CITY NJ,0,0,0,8,8
Tropical Depression,Kyle,80,2002-10-10T15:00:00Z,33.5N  80.0W,1,15,3,2,21
Tropical Depression,Kyle,80,2002-10-10T15:00:00Z,NEW YORK CITY NY,0,0,0,5,5
Tropical Depression,Kyle,80,2002-10-10T15:00:00Z,W PALM BEACH FL,3,0,0,0,3
Tropical Depression,Kyle,80,2002-10-10T15:00:00Z,MONTAUK POINT NY,0,0,0,3,3
Tropical Depression,Kyle,80,2002-10-10T15:00:00Z,FT PIERCE FL,32,0,0,0,32
Tropical Depression,Kyle,80,2002-10-10T15:00:00Z,PROVIDENCE RI,0,0,0,2,2
Tropical Depression,Kyle,80,2002-10-10T15:00:00Z,COCOA BEACH FL,50,0,0,0,50
Tropical Depression,Kyle,80,2002-10-10T15:00:00Z,NANTUCKET MA,0,0,0,2,2
Tropical Depression,Kyle,80,2002-10-10T15:00:00Z,DAYTONA BEACH FL,53,0,0,0,53
Tropical Depression,Kyle,80,2002-10-10T15:00:00Z,HYANNIS MA,0,0,0,2,2
Tropical Depression,Kyle,80,2002-10-10T15:00:00Z,JACKSONVILLE FL,40,0,1,0,41
Tropical Depression,Kyle,80,2002-10-10T15:00:00Z,TAMPA FL,9,0,0,1,10
Tropical Depression,Kyle,80,2002-10-10T15:00:00Z,SAVANNAH GA,18,7,1,0,26
Tropical Depression,Kyle,80,2002-10-10T15:00:00Z,CEDAR KEY FL,17,0,0,1,18
Tropical Depression,Kyle,80,2002-10-10T15:00:00Z,CHARLESTON SC,5,14,2,1,22
Tropical Depression,Kyle,80,2002-10-10T15:00:00Z,ST MARKS FL,8,5,1,0,14
Tropical Depression,Kyle,80,2002-10-10T15:00:00Z,MYRTLE BEACH SC,0,12,6,1,19
Tropical Depression,Kyle,80,2002-10-10T15:00:00Z,APALACHICOLA FL,2,4,1,1,8
Tropical Depression,Kyle,80,2002-10-10T15:00:00Z,WILMINGTON NC,0,6,9,3,18
Tropical Depression,Kyle,80,2002-10-10T15:00:00Z,PANAMA CITY FL,1,4,1,0,6
Tropical Depression,Kyle,80,2002-10-10T15:00:00Z,MOREHEAD CITY NC,0,2,9,4,15
Tropical Depression,Kyle,80,2002-10-10T15:00:00Z,PENSACOLA FL,0,1,1,1,3
Tropical Depression,Kyle,80,2002-10-10T15:00:00Z,CAPE HATTERAS NC,0,0,7,7,14
Tropical Depression,Kyle,80,2002-10-10T15:00:00Z,GULF 29N 85W,1,2,1,1,5
Tropical Depression,Kyle,80,2002-10-10T15:00:00Z,NORFOLK VA,0,0,4,9,13
Tropical Depression,Kyle,81,2002-10-10T21:00:00Z,32.3N  80.8W,31,1,0,0,32
Tropical Depression,Kyle,81,2002-10-10T21:00:00Z,CAPE HATTERAS NC,0,1,10,5,16
Tropical Depression,Kyle,81,2002-10-10T21:00:00Z,34.0N  79.2W,2,18,2,1,23
Tropical Depression,Kyle,81,2002-10-10T21:00:00Z,NORFOLK VA,0,0,5,9,14
Tropical Depression,Kyle,81,2002-10-10T21:00:00Z,35.3N  77.0W,0,3,12,3,18
Tropical Depression,Kyle,81,2002-10-10T21:00:00Z,OCEAN CITY MD,0,0,1,10,11
Tropical Depression,Kyle,81,2002-10-10T21:00:00Z,BERMUDA,0,0,0,2,2
Tropical Depression,Kyle,81,2002-10-10T21:00:00Z,ATLANTIC CITY NJ,0,0,0,8,8
Tropical Depression,Kyle,81,2002-10-10T21:00:00Z,FT PIERCE FL,53,0,0,0,53
Tropical Depression,Kyle,81,2002-10-10T21:00:00Z,NEW YORK CITY NY,0,0,0,6,6
Tropical Depression,Kyle,81,2002-10-10T21:00:00Z,COCOA BEACH FL,88,0,0,0,88
Tropical Depression,Kyle,81,2002-10-10T21:00:00Z,MONTAUK POINT NY,0,0,0,4,4
Tropical Depression,Kyle,81,2002-10-10T21:00:00Z,DAYTONA BEACH FL,99,0,0,0,99
Tropical Depression,Kyle,81,2002-10-10T21:00:00Z,PROVIDENCE RI,0,0,0,3,3
Tropical Depression,Kyle,81,2002-10-10T21:00:00Z,JACKSONVILLE FL,52,0,0,0,52
Tropical Depression,Kyle,81,2002-10-10T21:00:00Z,NANTUCKET MA,0,0,0,2,2
Tropical Depression,Kyle,81,2002-10-10T21:00:00Z,SAVANNAH GA,34,0,0,0,34
Tropical Depression,Kyle,81,2002-10-10T21:00:00Z,HYANNIS MA,0,0,0,2,2
Tropical Depression,Kyle,81,2002-10-10T21:00:00Z,CHARLESTON SC,18,9,1,0,28
Tropical Depression,Kyle,81,2002-10-10T21:00:00Z,BOSTON MA,0,0,0,2,2
Tropical Depression,Kyle,81,2002-10-10T21:00:00Z,MYRTLE BEACH SC,3,18,1,1,23
Tropical Depression,Kyle,81,2002-10-10T21:00:00Z,CEDAR KEY FL,4,0,0,0,4
Tropical Depression,Kyle,81,2002-10-10T21:00:00Z,WILMINGTON NC,0,12,7,1,20
Tropical Depression,Kyle,81,2002-10-10T21:00:00Z,ST MARKS FL,4,0,0,0,4
Tropical Depression,Kyle,81,2002-10-10T21:00:00Z,MOREHEAD CITY NC,0,4,12,2,18
Tropical Depression,Kyle,82,2002-10-11T03:00:00Z,34.0N  79.0W,21,3,0,0,24
Tropical Depression,Kyle,82,2002-10-11T03:00:00Z,NORFOLK VA,0,12,6,0,18
Tropical Depression,Kyle,82,2002-10-11T03:00:00Z,35.5N  76.0W,0,17,3,0,20
Tropical Depression,Kyle,82,2002-10-11T03:00:00Z,OCEAN CITY MD,0,3,13,0,16
Tropical Depression,Kyle,82,2002-10-11T03:00:00Z,39.0N  71.5W,0,0,13,0,13
Tropical Depression,Kyle,82,2002-10-11T03:00:00Z,ATLANTIC CITY NJ,0,1,12,0,13
Tropical Depression,Kyle,82,2002-10-11T03:00:00Z,DAYTONA BEACH FL,99,0,0,0,99
Tropical Depression,Kyle,82,2002-10-11T03:00:00Z,NEW YORK CITY NY,0,0,11,0,11
Tropical Depression,Kyle,82,2002-10-11T03:00:00Z,JACKSONVILLE FL,69,0,0,0,69
Tropical Depression,Kyle,82,2002-10-11T03:00:00Z,MONTAUK POINT NY,0,0,8,0,8
Tropical Depression,Kyle,82,2002-10-11T03:00:00Z,SAVANNAH GA,59,0,0,0,59
Tropical Depression,Kyle,82,2002-10-11T03:00:00Z,PROVIDENCE RI,0,0,6,0,6
Tropical Depression,Kyle,82,2002-10-11T03:00:00Z,CHARLESTON SC,41,0,0,0,41
Tropical Depression,Kyle,82,2002-10-11T03:00:00Z,NANTUCKET MA,0,0,5,0,5
Tropical Depression,Kyle,82,2002-10-11T03:00:00Z,MYRTLE BEACH SC,23,2,0,0,25
Tropical Depression,Kyle,82,2002-10-11T03:00:00Z,HYANNIS MA,0,0,4,0,4
Tropical Depression,Kyle,82,2002-10-11T03:00:00Z,WILMINGTON NC,11,10,0,0,21
Tropical Depression,Kyle,82,2002-10-11T03:00:00Z,BOSTON MA,0,0,4,0,4
Tropical Depression,Kyle,82,2002-10-11T03:00:00Z,MOREHEAD CITY NC,3,17,1,0,21
Tropical Depression,Kyle,82,2002-10-11T03:00:00Z,PORTLAND ME,0,0,2,0,2
Tropical Depression,Kyle,82,2002-10-11T03:00:00Z,CAPE HATTERAS NC,0,17,3,0,20
Tropical Storm,Kyle,83,2002-10-11T09:00:00Z,35.0N  78.0W,26,8,0,0,34
Tropical Storm,Kyle,83,2002-10-11T09:00:00Z,NORFOLK VA,1,22,0,0,23
Tropical Storm,Kyle,83,2002-10-11T09:00:00Z,37.2N  74.0W,0,17,3,0,20
Tropical Storm,Kyle,83,2002-10-11T09:00:00Z,OCEAN CITY MD,0,13,4,0,17
Tropical Storm,Kyle,83,2002-10-11T09:00:00Z,38.5N  70.5W,0,1,11,0,12
Tropical Storm,Kyle,83,2002-10-11T09:00:00Z,ATLANTIC CITY NJ,0,5,8,0,13
Tropical Storm,Kyle,83,2002-10-11T09:00:00Z,JACKSONVILLE FL,99,0,0,0,99
Tropical Storm,Kyle,83,2002-10-11T09:00:00Z,NEW YORK CITY NY,0,1,9,0,10
Tropical Storm,Kyle,83,2002-10-11T09:00:00Z,SAVANNAH GA,99,0,0,0,99
Tropical Storm,Kyle,83,2002-10-11T09:00:00Z,MONTAUK POINT NY,0,0,8,0,8
Tropical Storm,Kyle,83,2002-10-11T09:00:00Z,CHARLESTON SC,66,0,0,0,66
Tropical Storm,Kyle,83,2002-10-11T09:00:00Z,PROVIDENCE RI,0,0,5,0,5
Tropical Storm,Kyle,83,2002-10-11T09:00:00Z,MYRTLE BEACH SC,49,0,0,0,49
Tropical Storm,Kyle,83,2002-10-11T09:00:00Z,NANTUCKET MA,0,0,5,0,5
Tropical Storm,Kyle,83,2002-10-11T09:00:00Z,WILMINGTON NC,34,4,0,0,38
Tropical Storm,Kyle,83,2002-10-11T09:00:00Z,HYANNIS MA,0,0,4,0,4
Tropical Storm,Kyle,83,2002-10-11T09:00:00Z,MOREHEAD CITY NC,16,16,0,0,32
Tropical Storm,Kyle,83,2002-10-11T09:00:00Z,BOSTON MA,0,0,3,0,3
Tropical Storm,Kyle,83,2002-10-11T09:00:00Z,CAPE HATTERAS NC,3,24,0,0,27
Tropical Storm,Kyle,84,2002-10-11T15:00:00Z,36.0N  76.0W,26,4,0,0,30
Tropical Storm,Kyle,84,2002-10-11T15:00:00Z,NANTUCKET MA,0,3,11,0,14
Tropical Storm,Kyle,84,2002-10-11T15:00:00Z,38.0N  72.0W,1,18,3,0,22
Tropical Storm,Kyle,84,2002-10-11T15:00:00Z,HYANNIS MA,0,3,9,1,13
Tropical Storm,Kyle,84,2002-10-11T15:00:00Z,39.5N  67.0W,0,1,12,2,15
Tropical Storm,Kyle,84,2002-10-11T15:00:00Z,BOSTON MA,0,2,8,0,10
Tropical Storm,Kyle,84,2002-10-11T15:00:00Z,BERMUDA,0,0,1,3,4
Tropical Storm,Kyle,84,2002-10-11T15:00:00Z,PORTLAND ME,0,0,6,2,8
Tropical Storm,Kyle,84,2002-10-11T15:00:00Z,JACKSONVILLE FL,5,0,0,0,5
Tropical Storm,Kyle,84,2002-10-11T15:00:00Z,BAR HARBOR ME,0,0,4,4,8
Tropical Storm,Kyle,84,2002-10-11T15:00:00Z,SAVANNAH GA,99,0,0,0,99
Tropical Storm,Kyle,84,2002-10-11T15:00:00Z,EASTPORT ME,0,0,3,5,8
Tropical Storm,Kyle,84,2002-10-11T15:00:00Z,CHARLESTON SC,99,0,0,0,99
Tropical Storm,Kyle,84,2002-10-11T15:00:00Z,ST JOHN NB,0,0,2,6,8
Tropical Storm,Kyle,84,2002-10-11T15:00:00Z,MYRTLE BEACH SC,64,0,0,0,64
Tropical Storm,Kyle,84,2002-10-11T15:00:00Z,MONCTON NB,0,0,1,6,7
Tropical Storm,Kyle,84,2002-10-11T15:00:00Z,WILMINGTON NC,48,0,0,0,48
Tropical Storm,Kyle,84,2002-10-11T15:00:00Z,YARMOUTH NS,0,0,4,6,10
Tropical Storm,Kyle,84,2002-10-11T15:00:00Z,MOREHEAD CITY NC,34,1,0,0,35
Tropical Storm,Kyle,84,2002-10-11T15:00:00Z,HALIFAX NS,0,0,1,8,9
Tropical Storm,Kyle,84,2002-10-11T15:00:00Z,CAPE HATTERAS NC,26,3,1,0,30
Tropical Storm,Kyle,84,2002-10-11T15:00:00Z,SABLE ISLAND NS,0,0,0,8,8
Tropical Storm,Kyle,84,2002-10-11T15:00:00Z,NORFOLK VA,21,6,0,0,27
Tropical Storm,Kyle,84,2002-10-11T15:00:00Z,SYDNEY NS,0,0,0,6,6
Tropical Storm,Kyle,84,2002-10-11T15:00:00Z,OCEAN CITY MD,7,14,0,1,22
Tropical Storm,Kyle,84,2002-10-11T15:00:00Z,EDDY POINT NS,0,0,0,7,7
Tropical Storm,Kyle,84,2002-10-11T15:00:00Z,ATLANTIC CITY NJ,2,13,2,0,17
Tropical Storm,Kyle,84,2002-10-11T15:00:00Z,PTX BASQUES NFLD,0,0,0,5,5
Tropical Storm,Kyle,84,2002-10-11T15:00:00Z,NEW YORK CITY NY,0,10,3,0,13
Tropical Storm,Kyle,84,2002-10-11T15:00:00Z,BURGEO NFLD,0,0,0,4,4
Tropical Storm,Kyle,84,2002-10-11T15:00:00Z,MONTAUK POINT NY,0,6,8,0,14
Tropical Storm,Kyle,84,2002-10-11T15:00:00Z,ILE ST PIERRE,0,0,0,4,4
Tropical Storm,Kyle,84,2002-10-11T15:00:00Z,PROVIDENCE RI,0,4,8,0,12
Tropical Storm,Kyle,84,2002-10-11T15:00:00Z,CAPE RACE NFLD,0,0,0,2,2
Tropical Storm,Kyle,85,2002-10-11T21:00:00Z,38.0N  72.0W,21,4,0,0,25
Tropical Storm,Kyle,85,2002-10-11T21:00:00Z,BOSTON MA,1,10,1,0,12
Tropical Storm,Kyle,85,2002-10-11T21:00:00Z,39.0N  67.5W,0,14,2,1,17
Tropical Storm,Kyle,85,2002-10-11T21:00:00Z,PORTLAND ME,0,6,2,1,9
Tropical Storm,Kyle,85,2002-10-11T21:00:00Z,40.0N  63.0W,0,1,9,3,13
Tropical Storm,Kyle,85,2002-10-11T21:00:00Z,BAR HARBOR ME,0,3,4,2,9
Tropical Storm,Kyle,85,2002-10-11T21:00:00Z,BERMUDA,0,0,2,3,5
Tropical Storm,Kyle,85,2002-10-11T21:00:00Z,EASTPORT ME,0,1,5,2,8
Tropical Storm,Kyle,85,2002-10-11T21:00:00Z,CHARLESTON SC,99,0,0,0,99
Tropical Storm,Kyle,85,2002-10-11T21:00:00Z,ST JOHN NB,0,1,5,2,8
Tropical Storm,Kyle,85,2002-10-11T21:00:00Z,MYRTLE BEACH SC,99,0,0,0,99
Tropical Storm,Kyle,85,2002-10-11T21:00:00Z,MONCTON NB,0,0,4,3,7
Tropical Storm,Kyle,85,2002-10-11T21:00:00Z,WILMINGTON NC,99,0,0,0,99
Tropical Storm,Kyle,85,2002-10-11T21:00:00Z,YARMOUTH NS,0,2,7,2,11
Tropical Storm,Kyle,85,2002-10-11T21:00:00Z,MOREHEAD CITY NC,65,0,0,0,65
Tropical Storm,Kyle,85,2002-10-11T21:00:00Z,HALIFAX NS,0,0,6,3,9
Tropical Storm,Kyle,85,2002-10-11T21:00:00Z,CAPE HATTERAS NC,49,0,0,0,49
Tropical Storm,Kyle,85,2002-10-11T21:00:00Z,SABLE ISLAND NS,0,0,3,6,9
Tropical Storm,Kyle,85,2002-10-11T21:00:00Z,NORFOLK VA,33,0,1,0,34
Tropical Storm,Kyle,85,2002-10-11T21:00:00Z,SYDNEY NS,0,0,2,6,8
Tropical Storm,Kyle,85,2002-10-11T21:00:00Z,OCEAN CITY MD,23,0,1,0,24
Tropical Storm,Kyle,85,2002-10-11T21:00:00Z,EDDY POINT NS,0,0,3,5,8
Tropical Storm,Kyle,85,2002-10-11T21:00:00Z,ATLANTIC CITY NJ,14,2,0,1,17
Tropical Storm,Kyle,85,2002-10-11T21:00:00Z,PTX BASQUES NFLD,0,0,1,5,6
Tropical Storm,Kyle,85,2002-10-11T21:00:00Z,NEW YORK CITY NY,9,5,0,0,14
Tropical Storm,Kyle,85,2002-10-11T21:00:00Z,BURGEO NFLD,0,0,0,6,6
Tropical Storm,Kyle,85,2002-10-11T21:00:00Z,MONTAUK POINT NY,6,9,1,0,16
Tropical Storm,Kyle,85,2002-10-11T21:00:00Z,ILE ST PIERRE,0,0,0,6,6
Tropical Storm,Kyle,85,2002-10-11T21:00:00Z,PROVIDENCE RI,3,10,1,0,14
Tropical Storm,Kyle,85,2002-10-11T21:00:00Z,CAPE RACE NFLD,0,0,0,5,5
Tropical Storm,Kyle,85,2002-10-11T21:00:00Z,NANTUCKET MA,2,13,1,0,16
Tropical Storm,Kyle,85,2002-10-11T21:00:00Z,HIBERNIA OILFLD,0,0,0,2,2
Tropical Storm,Kyle,85,2002-10-11T21:00:00Z,HYANNIS MA,2,12,1,0,15
Tropical Depression,Kyle,86,2002-10-12T00:00:00Z,38.0N  72.0W,21,4,0,0,25
Tropical Depression,Kyle,86,2002-10-12T00:00:00Z,BOSTON MA,1,10,1,0,12
Tropical Depression,Kyle,86,2002-10-12T00:00:00Z,39.0N  67.5W,0,14,2,1,17
Tropical Depression,Kyle,86,2002-10-12T00:00:00Z,PORTLAND ME,0,6,2,1,9
Tropical Depression,Kyle,86,2002-10-12T00:00:00Z,40.0N  63.0W,0,1,9,3,13
Tropical Depression,Kyle,86,2002-10-12T00:00:00Z,BAR HARBOR ME,0,3,4,2,9
Tropical Depression,Kyle,86,2002-10-12T00:00:00Z,BERMUDA,0,0,2,3,5
Tropical Depression,Kyle,86,2002-10-12T00:00:00Z,EASTPORT ME,0,1,5,2,8
Tropical Depression,Kyle,86,2002-10-12T00:00:00Z,CHARLESTON SC,99,0,0,0,99
Tropical Depression,Kyle,86,2002-10-12T00:00:00Z,ST JOHN NB,0,1,5,2,8
Tropical Depression,Kyle,86,2002-10-12T00:00:00Z,MYRTLE BEACH SC,99,0,0,0,99
Tropical Depression,Kyle,86,2002-10-12T00:00:00Z,MONCTON NB,0,0,4,3,7
Tropical Depression,Kyle,86,2002-10-12T00:00:00Z,WILMINGTON NC,99,0,0,0,99
Tropical Depression,Kyle,86,2002-10-12T00:00:00Z,YARMOUTH NS,0,2,7,2,11
Tropical Depression,Kyle,86,2002-10-12T00:00:00Z,MOREHEAD CITY NC,65,0,0,0,65
Tropical Depression,Kyle,86,2002-10-12T00:00:00Z,HALIFAX NS,0,0,6,3,9
Tropical Depression,Kyle,86,2002-10-12T00:00:00Z,CAPE HATTERAS NC,49,0,0,0,49
Tropical Depression,Kyle,86,2002-10-12T00:00:00Z,SABLE ISLAND NS,0,0,3,6,9
Tropical Depression,Kyle,86,2002-10-12T00:00:00Z,NORFOLK VA,33,0,1,0,34
Tropical Depression,Kyle,86,2002-10-12T00:00:00Z,SYDNEY NS,0,0,2,6,8
Tropical Depression,Kyle,86,2002-10-12T00:00:00Z,OCEAN CITY MD,23,0,1,0,24
Tropical Depression,Kyle,86,2002-10-12T00:00:00Z,EDDY POINT NS,0,0,3,5,8
Tropical Depression,Kyle,86,2002-10-12T00:00:00Z,ATLANTIC CITY NJ,14,2,0,1,17
Tropical Depression,Kyle,86,2002-10-12T00:00:00Z,PTX BASQUES NFLD,0,0,1,5,6
Tropical Depression,Kyle,86,2002-10-12T00:00:00Z,NEW YORK CITY NY,9,5,0,0,14
Tropical Depression,Kyle,86,2002-10-12T00:00:00Z,BURGEO NFLD,0,0,0,6,6
Tropical Depression,Kyle,86,2002-10-12T00:00:00Z,MONTAUK POINT NY,6,9,1,0,16
Tropical Depression,Kyle,86,2002-10-12T00:00:00Z,ILE ST PIERRE,0,0,0,6,6
Tropical Depression,Kyle,86,2002-10-12T00:00:00Z,PROVIDENCE RI,3,10,1,0,14
Tropical Depression,Kyle,86,2002-10-12T00:00:00Z,CAPE RACE NFLD,0,0,0,5,5
Tropical Depression,Kyle,86,2002-10-12T00:00:00Z,NANTUCKET MA,2,13,1,0,16
Tropical Depression,Kyle,86,2002-10-12T00:00:00Z,HIBERNIA OILFLD,0,0,0,2,2
Tropical Depression,Kyle,86,2002-10-12T00:00:00Z,HYANNIS MA,2,12,1,0,15
Tropical Depression,Kyle,87,2002-10-12T03:00:00Z,38.5N  70.5W,24,0,0,0,24
Tropical Depression,Kyle,87,2002-10-12T03:00:00Z,ATLANTIC CITY NJ,4,0,0,0,4
Tropical Depression,Kyle,87,2002-10-12T03:00:00Z,MYRTLE BEACH SC,99,0,0,0,99
Tropical Depression,Kyle,87,2002-10-12T03:00:00Z,NEW YORK CITY NY,4,0,0,0,4
Tropical Depression,Kyle,87,2002-10-12T03:00:00Z,WILMINGTON NC,99,0,0,0,99
Tropical Depression,Kyle,87,2002-10-12T03:00:00Z,MONTAUK POINT NY,8,0,0,0,8
Tropical Depression,Kyle,87,2002-10-12T03:00:00Z,MOREHEAD CITY NC,99,0,0,0,99
Tropical Depression,Kyle,87,2002-10-12T03:00:00Z,PROVIDENCE RI,6,0,0,0,6
Tropical Depression,Kyle,87,2002-10-12T03:00:00Z,CAPE HATTERAS NC,71,0,0,0,71
Tropical Depression,Kyle,87,2002-10-12T03:00:00Z,NANTUCKET MA,6,0,0,0,6
Tropical Depression,Kyle,87,2002-10-12T03:00:00Z,NORFOLK VA,8,0,0,0,8
Tropical Depression,Kyle,87,2002-10-12T03:00:00Z,HYANNIS MA,5,0,0,0,5
Tropical Depression,Kyle,87,2002-10-12T03:00:00Z,OCEAN CITY MD,7,0,0,0,7
Tropical Depression,Kyle,87,2002-10-12T03:00:00Z,BOSTON MA,3,0,0,0,3
Tropical Storm,Kyle,88,2002-10-12T09:00:00Z,38.2N  68.0W,24,0,0,0,24
Tropical Storm,Kyle,88,2002-10-12T09:00:00Z,MONTAUK POINT NY,3,0,0,0,3
Tropical Storm,Kyle,88,2002-10-12T09:00:00Z,MOREHEAD CITY NC,99,0,0,0,99
Tropical Storm,Kyle,88,2002-10-12T09:00:00Z,PROVIDENCE RI,2,0,0,0,2
Tropical Storm,Kyle,88,2002-10-12T09:00:00Z,CAPE HATTERAS NC,99,0,0,0,99
Tropical Storm,Kyle,88,2002-10-12T09:00:00Z,NANTUCKET MA,7,0,0,0,7
Tropical Storm,Kyle,88,2002-10-12T09:00:00Z,NORFOLK VA,2,0,0,0,2
Tropical Storm,Kyle,88,2002-10-12T09:00:00Z,HYANNIS MA,4,0,0,0,4
Tropical Storm,Kyle,89,2002-10-12T15:00:00Z,40.0N  65.0W,19,4,0,0,23
Tropical Storm,Kyle,89,2002-10-12T15:00:00Z,EASTPORT ME,1,2,0,0,3
Tropical Storm,Kyle,89,2002-10-12T15:00:00Z,40.0N  60.0W,0,14,0,0,14
Tropical Storm,Kyle,89,2002-10-12T15:00:00Z,ST JOHN NB,1,2,0,0,3
Tropical Storm,Kyle,89,2002-10-12T15:00:00Z,MONTAUK POINT NY,5,0,0,0,5
Tropical Storm,Kyle,89,2002-10-12T15:00:00Z,MONCTON NB,0,2,0,0,2
Tropical Storm,Kyle,89,2002-10-12T15:00:00Z,PROVIDENCE RI,4,0,0,0,4
Tropical Storm,Kyle,89,2002-10-12T15:00:00Z,YARMOUTH NS,4,5,0,0,9
Tropical Storm,Kyle,89,2002-10-12T15:00:00Z,NANTUCKET MA,17,0,0,0,17
Tropical Storm,Kyle,89,2002-10-12T15:00:00Z,HALIFAX NS,1,6,0,0,7
Tropical Storm,Kyle,89,2002-10-12T15:00:00Z,HYANNIS MA,10,1,0,0,11
Tropical Storm,Kyle,89,2002-10-12T15:00:00Z,SABLE ISLAND NS,0,7,0,0,7
Tropical Storm,Kyle,89,2002-10-12T15:00:00Z,BOSTON MA,2,0,0,0,2
Tropical Storm,Kyle,89,2002-10-12T15:00:00Z,SYDNEY NS,0,2,0,0,2
Tropical Storm,Kyle,89,2002-10-12T15:00:00Z,BAR HARBOR ME,1,1,0,0,2
Tropical Storm,Kyle,89,2002-10-12T15:00:00Z,EDDY POINT NS,0,4,0,0,4
Tropical Depression,Thirteen,1,2002-09-21T21:00:00Z,11.0N  51.0W,48,0,0,0,48
Tropical Depression,Thirteen,1,2002-09-21T21:00:00Z,TFFR 163N 615W,0,0,4,13,17
Tropical Depression,Thirteen,1,2002-09-21T21:00:00Z,11.5N  53.5W,13,20,0,0,33
Tropical Depression,Thirteen,1,2002-09-21T21:00:00Z,TAPA 171N 618W,0,0,3,13,16
Tropical Depression,Thirteen,1,2002-09-21T21:00:00Z,12.5N  56.5W,0,14,13,0,27
Tropical Depression,Thirteen,1,2002-09-21T21:00:00Z,TKPK 173N 627W,0,0,1,13,14
Tropical Depression,Thirteen,1,2002-09-21T21:00:00Z,SVMG 110N 640W,0,0,0,6,6
Tropical Depression,Thirteen,1,2002-09-21T21:00:00Z,TNCM 181N 631W,0,0,1,12,13
Tropical Depression,Thirteen,1,2002-09-21T21:00:00Z,TTPP 106N 614W,0,0,1,10,11
Tropical Depression,Thirteen,1,2002-09-21T21:00:00Z,TISX 177N 648W,0,0,0,11,11
Tropical Depression,Thirteen,1,2002-09-21T21:00:00Z,TTPT 112N 608W,0,0,3,11,14
Tropical Depression,Thirteen,1,2002-09-21T21:00:00Z,TIST 183N 650W,0,0,0,10,10
Tropical Depression,Thirteen,1,2002-09-21T21:00:00Z,TGPY 120N 618W,0,0,2,11,13
Tropical Depression,Thirteen,1,2002-09-21T21:00:00Z,TJPS 180N 666W,0,0,0,7,7
Tropical Depression,Thirteen,1,2002-09-21T21:00:00Z,TBPB 131N 595W,0,0,14,6,20
Tropical Depression,Thirteen,1,2002-09-21T21:00:00Z,MDSD 185N 697W,0,0,0,2,2
Tropical Depression,Thirteen,1,2002-09-21T21:00:00Z,TVSV 131N 612W,0,0,5,12,17
Tropical Depression,Thirteen,1,2002-09-21T21:00:00Z,TJSJ 184N 661W,0,0,0,8,8
Tropical Depression,Thirteen,1,2002-09-21T21:00:00Z,TLPL 138N 610W,0,0,7,11,18
Tropical Depression,Thirteen,1,2002-09-21T21:00:00Z,ST CROIX VI,0,0,0,11,11
Tropical Depression,Thirteen,1,2002-09-21T21:00:00Z,TFFF 146N 610W,0,0,7,11,18
Tropical Depression,Thirteen,1,2002-09-21T21:00:00Z,ST THOMAS VI,0,0,0,10,10
Tropical Depression,Thirteen,1,2002-09-21T21:00:00Z,TDPR 153N 614W,0,0,5,13,18
Tropical Depression,Thirteen,1,2002-09-21T21:00:00Z,SAN JUAN PR,0,0,0,8,8
Tropical Depression,Thirteen,1,2002-09-21T21:00:00Z,SVBS 157N 636W,0,0,1,12,13
Tropical Depression,Thirteen,1,2002-09-21T21:00:00Z,PONCE PR,0,0,0,7,7
Tropical Depression,Thirteen,2,2002-09-22T03:00:00Z,11.3N  52.0W,48,2,0,0,50
Tropical Depression,Thirteen,2,2002-09-22T03:00:00Z,TFFR 163N 615W,0,0,3,19,22
Tropical Depression,Thirteen,2,2002-09-22T03:00:00Z,12.4N  55.0W,1,34,1,0,36
Tropical Depression,Thirteen,2,2002-09-22T03:00:00Z,TAPA 171N 618W,0,0,1,20,21
Tropical Depression,Thirteen,2,2002-09-22T03:00:00Z,13.9N  58.0W,0,3,25,0,28
Tropical Depression,Thirteen,2,2002-09-22T03:00:00Z,TKPK 173N 627W,0,0,0,19,19
Tropical Depression,Thirteen,2,2002-09-22T03:00:00Z,TTPP 106N 614W,0,0,1,3,4
Tropical Depression,Thirteen,2,2002-09-22T03:00:00Z,TNCM 181N 631W,0,0,0,18,18
Tropical Depression,Thirteen,2,2002-09-22T03:00:00Z,TTPT 112N 608W,0,0,2,5,7
Tropical Depression,Thirteen,2,2002-09-22T03:00:00Z,TISX 177N 648W,0,0,0,15,15
Tropical Depression,Thirteen,2,2002-09-22T03:00:00Z,TGPY 120N 618W,0,0,1,8,9
Tropical Depression,Thirteen,2,2002-09-22T03:00:00Z,TIST 183N 650W,0,0,0,14,14
Tropical Depression,Thirteen,2,2002-09-22T03:00:00Z,TBPB 131N 595W,0,0,16,5,21
Tropical Depression,Thirteen,2,2002-09-22T03:00:00Z,TJPS 180N 666W,0,0,0,9,9
Tropical Depression,Thirteen,2,2002-09-22T03:00:00Z,TVSV 131N 612W,0,0,5,11,16
Tropical Depression,Thirteen,2,2002-09-22T03:00:00Z,TJSJ 184N 661W,0,0,0,11,11
Tropical Depression,Thirteen,2,2002-09-22T03:00:00Z,TLPL 138N 610W,0,0,7,12,19
Tropical Depression,Thirteen,2,2002-09-22T03:00:00Z,ST CROIX VI,0,0,0,15,15
Tropical Depression,Thirteen,2,2002-09-22T03:00:00Z,TFFF 146N 610W,0,0,8,13,21
Tropical Depression,Thirteen,2,2002-09-22T03:00:00Z,ST THOMAS VI,0,0,0,14,14
Tropical Depression,Thirteen,2,2002-09-22T03:00:00Z,TDPR 153N 614W,0,0,5,17,22
Tropical Depression,Thirteen,2,2002-09-22T03:00:00Z,SAN JUAN PR,0,0,0,11,11
Tropical Depression,Thirteen,2,2002-09-22T03:00:00Z,SVBS 157N 636W,0,0,0,17,17
Tropical Depression,Thirteen,2,2002-09-22T03:00:00Z,PONCE PR,0,0,0,9,9
Tropical Depression,Thirteen,3,2002-09-22T09:00:00Z,12.4N  54.1W,49,1,0,0,50
Tropical Depression,Thirteen,3,2002-09-22T09:00:00Z,TAPA 171N 618W,0,0,14,9,23
Tropical Depression,Thirteen,3,2002-09-22T09:00:00Z,13.6N  57.2W,0,35,0,0,35
Tropical Depression,Thirteen,3,2002-09-22T09:00:00Z,TKPK 173N 627W,0,0,8,14,22
Tropical Depression,Thirteen,3,2002-09-22T09:00:00Z,15.0N  60.0W,0,4,23,1,28
Tropical Depression,Thirteen,3,2002-09-22T09:00:00Z,TNCM 181N 631W,0,0,4,17,21
Tropical Depression,Thirteen,3,2002-09-22T09:00:00Z,SVMG 110N 640W,0,0,0,3,3
Tropical Depression,Thirteen,3,2002-09-22T09:00:00Z,TISX 177N 648W,0,0,1,17,18
Tropical Depression,Thirteen,3,2002-09-22T09:00:00Z,TTPP 106N 614W,0,0,2,3,5
Tropical Depression,Thirteen,3,2002-09-22T09:00:00Z,TIST 183N 650W,0,0,0,18,18
Tropical Depression,Thirteen,3,2002-09-22T09:00:00Z,TTPT 112N 608W,0,1,5,3,9
Tropical Depression,Thirteen,3,2002-09-22T09:00:00Z,TJPS 180N 666W,0,0,0,14,14
Tropical Depression,Thirteen,3,2002-09-22T09:00:00Z,TGPY 120N 618W,0,0,6,5,11
Tropical Depression,Thirteen,3,2002-09-22T09:00:00Z,MDSD 185N 697W,0,0,0,4,4
Tropical Depression,Thirteen,3,2002-09-22T09:00:00Z,TBPB 131N 595W,0,10,13,1,24
Tropical Depression,Thirteen,3,2002-09-22T09:00:00Z,TJSJ 184N 661W,0,0,0,15,15
Tropical Depression,Thirteen,3,2002-09-22T09:00:00Z,TVSV 131N 612W,0,1,13,4,18
Tropical Depression,Thirteen,3,2002-09-22T09:00:00Z,MDPP 198N 707W,0,0,0,2,2
Tropical Depression,Thirteen,3,2002-09-22T09:00:00Z,TLPL 138N 610W,0,1,18,2,21
Tropical Depression,Thirteen,3,2002-09-22T09:00:00Z,ST CROIX VI,0,0,1,17,18
Tropical Depression,Thirteen,3,2002-09-22T09:00:00Z,TFFF 146N 610W,0,1,20,3,24
Tropical Depression,Thirteen,3,2002-09-22T09:00:00Z,ST THOMAS VI,0,0,0,18,18
Tropical Depression,Thirteen,3,2002-09-22T09:00:00Z,TDPR 153N 614W,0,0,20,4,24
Tropical Depression,Thirteen,3,2002-09-22T09:00:00Z,SAN JUAN PR,0,0,0,15,15
Tropical Depression,Thirteen,3,2002-09-22T09:00:00Z,SVBS 157N 636W,0,0,4,15,19
Tropical Depression,Thirteen,3,2002-09-22T09:00:00Z,PONCE PR,0,0,0,14,14
Tropical Depression,Thirteen,3,2002-09-22T09:00:00Z,TFFR 163N 615W,0,0,18,6,24
Tropical Depression,Thirteen,4,2002-09-22T15:00:00Z,13.5N  58.0W,51,1,0,0,52
Tropical Depression,Thirteen,4,2002-09-22T15:00:00Z,TNCM 181N 631W,0,1,18,2,21
Tropical Depression,Thirteen,4,2002-09-22T15:00:00Z,14.5N  61.0W,1,33,0,0,34
Tropical Depression,Thirteen,4,2002-09-22T15:00:00Z,TISX 177N 648W,0,0,16,6,22
Tropical Depression,Thirteen,4,2002-09-22T15:00:00Z,16.0N  63.5W,0,6,20,0,26
Tropical Depression,Thirteen,4,2002-09-22T15:00:00Z,TIST 183N 650W,0,0,12,9,21
Tropical Depression,Thirteen,4,2002-09-22T15:00:00Z,SVMG 110N 640W,0,0,1,1,2
Tropical Depression,Thirteen,4,2002-09-22T15:00:00Z,TJPS 180N 666W,0,0,5,15,20
Tropical Depression,Thirteen,4,2002-09-22T15:00:00Z,TTPP 106N 614W,0,1,1,0,2
Tropical Depression,Thirteen,4,2002-09-22T15:00:00Z,MDSD 185N 697W,0,0,0,13,13
Tropical Depression,Thirteen,4,2002-09-22T15:00:00Z,TTPT 112N 608W,0,5,1,0,6
Tropical Depression,Thirteen,4,2002-09-22T15:00:00Z,MDCB 176N 714W,0,0,0,8,8
Tropical Depression,Thirteen,4,2002-09-22T15:00:00Z,TGPY 120N 618W,0,10,1,1,12
Tropical Depression,Thirteen,4,2002-09-22T15:00:00Z,MTPP 186N 724W,0,0,0,5,5
Tropical Depression,Thirteen,4,2002-09-22T15:00:00Z,TBPB 131N 595W,20,16,0,0,36
Tropical Depression,Thirteen,4,2002-09-22T15:00:00Z,MTCA 183N 738W,0,0,0,2,2
Tropical Depression,Thirteen,4,2002-09-22T15:00:00Z,TVSV 131N 612W,1,23,1,0,25
Tropical Depression,Thirteen,4,2002-09-22T15:00:00Z,TJSJ 184N 661W,0,0,6,14,20
Tropical Depression,Thirteen,4,2002-09-22T15:00:00Z,TLPL 138N 610W,1,30,0,0,31
Tropical Depression,Thirteen,4,2002-09-22T15:00:00Z,MDPP 198N 707W,0,0,0,9,9
Tropical Depression,Thirteen,4,2002-09-22T15:00:00Z,TFFF 146N 610W,1,33,0,0,34
Tropical Depression,Thirteen,4,2002-09-22T15:00:00Z,MBJT 215N 712W,0,0,0,4,4
Tropical Depression,Thirteen,4,2002-09-22T15:00:00Z,TDPR 153N 614W,0,30,2,0,32
Tropical Depression,Thirteen,4,2002-09-22T15:00:00Z,ST CROIX VI,0,0,16,6,22
Tropical Depression,Thirteen,4,2002-09-22T15:00:00Z,SVBS 157N 636W,0,6,19,1,26
Tropical Depression,Thirteen,4,2002-09-22T15:00:00Z,ST THOMAS VI,0,0,12,9,21
Tropical Depression,Thirteen,4,2002-09-22T15:00:00Z,TFFR 163N 615W,0,22,7,0,29
Tropical Depression,Thirteen,4,2002-09-22T15:00:00Z,SAN JUAN PR,0,0,6,14,20
Tropical Depression,Thirteen,4,2002-09-22T15:00:00Z,TAPA 171N 618W,0,11,14,1,26
Tropical Depression,Thirteen,4,2002-09-22T15:00:00Z,PONCE PR,0,0,5,15,20
Tropical Depression,Thirteen,4,2002-09-22T15:00:00Z,TKPK 173N 627W,0,4,20,1,25
Tropical Depression,Thirteen,5,2002-09-22T21:00:00Z,13.5N  60.0W,48,1,0,0,49
Tropical Depression,Thirteen,5,2002-09-22T21:00:00Z,TNCM 181N 631W,0,7,10,1,18
Tropical Depression,Thirteen,5,2002-09-22T21:00:00Z,14.5N  63.0W,1,32,1,0,34
Tropical Depression,Thirteen,5,2002-09-22T21:00:00Z,TISX 177N 648W,0,4,17,2,23
Tropical Depression,Thirteen,5,2002-09-22T21:00:00Z,15.5N  66.0W,0,4,21,1,26
Tropical Depression,Thirteen,5,2002-09-22T21:00:00Z,TIST 183N 650W,0,1,16,2,19
Tropical Depression,Thirteen,5,2002-09-22T21:00:00Z,SKPG 125N 717W,0,0,0,2,2
Tropical Depression,Thirteen,5,2002-09-22T21:00:00Z,TJPS 180N 666W,0,0,16,5,21
Tropical Depression,Thirteen,5,2002-09-22T21:00:00Z,TNCC 122N 690W,0,0,2,3,5
Tropical Depression,Thirteen,5,2002-09-22T21:00:00Z,MDSD 185N 697W,0,0,2,16,18
Tropical Depression,Thirteen,5,2002-09-22T21:00:00Z,SVMG 110N 640W,0,3,1,0,4
Tropical Depression,Thirteen,5,2002-09-22T21:00:00Z,MDCB 176N 714W,0,0,0,15,15
Tropical Depression,Thirteen,5,2002-09-22T21:00:00Z,TTPP 106N 614W,1,2,0,0,3
Tropical Depression,Thirteen,5,2002-09-22T21:00:00Z,MTPP 186N 724W,0,0,0,13,13
Tropical Depression,Thirteen,5,2002-09-22T21:00:00Z,TTPT 112N 608W,7,3,0,0,10
Tropical Depression,Thirteen,5,2002-09-22T21:00:00Z,MTCA 183N 738W,0,0,0,9,9
Tropical Depression,Thirteen,5,2002-09-22T21:00:00Z,TGPY 120N 618W,7,12,0,1,20
Tropical Depression,Thirteen,5,2002-09-22T21:00:00Z,MUGM 200N 751W,0,0,0,4,4
Tropical Depression,Thirteen,5,2002-09-22T21:00:00Z,TBPB 131N 595W,51,0,0,0,51
Tropical Depression,Thirteen,5,2002-09-22T21:00:00Z,TJSJ 184N 661W,0,0,15,5,20
Tropical Depression,Thirteen,5,2002-09-22T21:00:00Z,TVSV 131N 612W,27,10,0,0,37
Tropical Depression,Thirteen,5,2002-09-22T21:00:00Z,MDPP 198N 707W,0,0,0,14,14
Tropical Depression,Thirteen,5,2002-09-22T21:00:00Z,TLPL 138N 610W,33,9,0,0,42
Tropical Depression,Thirteen,5,2002-09-22T21:00:00Z,MBJT 215N 712W,0,0,0,8,8
Tropical Depression,Thirteen,5,2002-09-22T21:00:00Z,TFFF 146N 610W,29,13,0,0,42
Tropical Depression,Thirteen,5,2002-09-22T21:00:00Z,MYMM 224N 730W,0,0,0,3,3
Tropical Depression,Thirteen,5,2002-09-22T21:00:00Z,TDPR 153N 614W,12,25,0,0,37
Tropical Depression,Thirteen,5,2002-09-22T21:00:00Z,ST CROIX VI,0,4,17,2,23
Tropical Depression,Thirteen,5,2002-09-22T21:00:00Z,SVBS 157N 636W,0,27,5,0,32
Tropical Depression,Thirteen,5,2002-09-22T21:00:00Z,ST THOMAS VI,0,1,16,2,19
Tropical Depression,Thirteen,5,2002-09-22T21:00:00Z,TFFR 163N 615W,3,26,0,0,29
Tropical Depression,Thirteen,5,2002-09-22T21:00:00Z,SAN JUAN PR,0,0,15,5,20
Tropical Depression,Thirteen,5,2002-09-22T21:00:00Z,TAPA 171N 618W,0,20,2,0,22
Tropical Depression,Thirteen,5,2002-09-22T21:00:00Z,PONCE PR,0,0,16,5,21
Tropical Depression,Thirteen,5,2002-09-22T21:00:00Z,TKPK 173N 627W,0,17,6,0,23
Tropical Depression,Thirteen,6,2002-09-23T03:00:00Z,13.4N  62.4W,50,1,0,0,51
Tropical Depression,Thirteen,6,2002-09-23T03:00:00Z,TISX 177N 648W,0,8,5,2,15
Tropical Depression,Thirteen,6,2002-09-23T03:00:00Z,14.1N  65.4W,2,32,0,0,34
Tropical Depression,Thirteen,6,2002-09-23T03:00:00Z,TIST 183N 650W,0,3,7,2,12
Tropical Depression,Thirteen,6,2002-09-23T03:00:00Z,15.0N  67.7W,0,13,13,1,27
Tropical Depression,Thirteen,6,2002-09-23T03:00:00Z,TJPS 180N 666W,0,3,11,3,17
Tropical Depression,Thirteen,6,2002-09-23T03:00:00Z,SKPG 125N 717W,0,0,1,6,7
Tropical Depression,Thirteen,6,2002-09-23T03:00:00Z,MDSD 185N 697W,0,0,6,11,17
Tropical Depression,Thirteen,6,2002-09-23T03:00:00Z,TNCC 122N 690W,0,1,7,3,11
Tropical Depression,Thirteen,6,2002-09-23T03:00:00Z,MDCB 176N 714W,0,0,3,15,18
Tropical Depression,Thirteen,6,2002-09-23T03:00:00Z,SVMG 110N 640W,2,6,0,0,8
Tropical Depression,Thirteen,6,2002-09-23T03:00:00Z,MTPP 186N 724W,0,0,0,14,14
Tropical Depression,Thirteen,6,2002-09-23T03:00:00Z,TTPP 106N 614W,3,0,0,0,3
Tropical Depression,Thirteen,6,2002-09-23T03:00:00Z,MTCA 183N 738W,0,0,0,11,11
Tropical Depression,Thirteen,6,2002-09-23T03:00:00Z,TTPT 112N 608W,13,0,0,0,13
Tropical Depression,Thirteen,6,2002-09-23T03:00:00Z,MKJP 179N 768W,0,0,0,4,4
Tropical Depression,Thirteen,6,2002-09-23T03:00:00Z,TGPY 120N 618W,34,0,0,0,34
Tropical Depression,Thirteen,6,2002-09-23T03:00:00Z,MKJS 185N 779W,0,0,0,2,2
Tropical Depression,Thirteen,6,2002-09-23T03:00:00Z,TBPB 131N 595W,78,0,0,0,78
Tropical Depression,Thirteen,6,2002-09-23T03:00:00Z,MUGM 200N 751W,0,0,0,5,5
Tropical Depression,Thirteen,6,2002-09-23T03:00:00Z,TVSV 131N 612W,61,0,0,0,61
Tropical Depression,Thirteen,6,2002-09-23T03:00:00Z,TJSJ 184N 661W,0,2,9,3,14
Tropical Depression,Thirteen,6,2002-09-23T03:00:00Z,TLPL 138N 610W,62,0,0,0,62
Tropical Depression,Thirteen,6,2002-09-23T03:00:00Z,MDPP 198N 707W,0,0,1,11,12
Tropical Depression,Thirteen,6,2002-09-23T03:00:00Z,TFFF 146N 610W,50,0,0,0,50
Tropical Depression,Thirteen,6,2002-09-23T03:00:00Z,MBJT 215N 712W,0,0,0,5,5
Tropical Depression,Thirteen,6,2002-09-23T03:00:00Z,TDPR 153N 614W,33,2,0,0,35
Tropical Depression,Thirteen,6,2002-09-23T03:00:00Z,MYMM 224N 730W,0,0,0,2,2
Tropical Depression,Thirteen,6,2002-09-23T03:00:00Z,SVBS 157N 636W,11,21,0,0,32
Tropical Depression,Thirteen,6,2002-09-23T03:00:00Z,ST CROIX VI,0,8,5,2,15
Tropical Depression,Thirteen,6,2002-09-23T03:00:00Z,TFFR 163N 615W,10,5,0,0,15
Tropical Depression,Thirteen,6,2002-09-23T03:00:00Z,ST THOMAS VI,0,3,7,2,12
Tropical Depression,Thirteen,6,2002-09-23T03:00:00Z,TAPA 171N 618W,2,4,1,0,7
Tropical Depression,Thirteen,6,2002-09-23T03:00:00Z,SAN JUAN PR,0,2,9,3,14
Tropical Depression,Thirteen,6,2002-09-23T03:00:00Z,TKPK 173N 627W,1,7,1,0,9
Tropical Depression,Thirteen,6,2002-09-23T03:00:00Z,PONCE PR,0,3,11,3,17
Tropical Depression,Thirteen,6,2002-09-23T03:00:00Z,TNCM 181N 631W,0,3,2,1,6
Tropical Depression,Thirteen,7,2002-09-23T09:00:00Z,14.0N  64.6W,49,0,0,1,50
Tropical Depression,Thirteen,7,2002-09-23T09:00:00Z,TIST 183N 650W,0,7,2,1,10
Tropical Depression,Thirteen,7,2002-09-23T09:00:00Z,14.8N  67.2W,3,29,0,0,32
Tropical Depression,Thirteen,7,2002-09-23T09:00:00Z,TJPS 180N 666W,0,11,5,1,17
Tropical Depression,Thirteen,7,2002-09-23T09:00:00Z,15.6N  69.3W,0,13,11,1,25
Tropical Depression,Thirteen,7,2002-09-23T09:00:00Z,MDSD 185N 697W,0,1,11,7,19
Tropical Depression,Thirteen,7,2002-09-23T09:00:00Z,SKPG 125N 717W,0,0,4,3,7
Tropical Depression,Thirteen,7,2002-09-23T09:00:00Z,MDCB 176N 714W,0,0,11,9,20
Tropical Depression,Thirteen,7,2002-09-23T09:00:00Z,TNCC 122N 690W,0,5,3,1,9
Tropical Depression,Thirteen,7,2002-09-23T09:00:00Z,MTPP 186N 724W,0,0,3,15,18
Tropical Depression,Thirteen,7,2002-09-23T09:00:00Z,SVMG 110N 640W,2,0,0,0,2
Tropical Depression,Thirteen,7,2002-09-23T09:00:00Z,MTCA 183N 738W,0,0,1,15,16
Tropical Depression,Thirteen,7,2002-09-23T09:00:00Z,TTPT 112N 608W,2,0,0,0,2
Tropical Depression,Thirteen,7,2002-09-23T09:00:00Z,MKJP 179N 768W,0,0,0,9,9
Tropical Depression,Thirteen,7,2002-09-23T09:00:00Z,TGPY 120N 618W,24,0,0,0,24
Tropical Depression,Thirteen,7,2002-09-23T09:00:00Z,MKJS 185N 779W,0,0,0,6,6
Tropical Depression,Thirteen,7,2002-09-23T09:00:00Z,TBPB 131N 595W,96,0,0,0,96
Tropical Depression,Thirteen,7,2002-09-23T09:00:00Z,MUGM 200N 751W,0,0,0,11,11
Tropical Depression,Thirteen,7,2002-09-23T09:00:00Z,TVSV 131N 612W,82,0,0,0,82
Tropical Depression,Thirteen,7,2002-09-23T09:00:00Z,MUCM 214N 779W,0,0,0,3,3
Tropical Depression,Thirteen,7,2002-09-23T09:00:00Z,TLPL 138N 610W,87,0,0,0,87
Tropical Depression,Thirteen,7,2002-09-23T09:00:00Z,TJSJ 184N 661W,0,8,4,1,13
Tropical Depression,Thirteen,7,2002-09-23T09:00:00Z,TFFF 146N 610W,69,0,0,0,69
Tropical Depression,Thirteen,7,2002-09-23T09:00:00Z,MDPP 198N 707W,0,0,3,11,14
Tropical Depression,Thirteen,7,2002-09-23T09:00:00Z,TDPR 153N 614W,39,0,0,0,39
Tropical Depression,Thirteen,7,2002-09-23T09:00:00Z,MBJT 215N 712W,0,0,0,7,7
Tropical Depression,Thirteen,7,2002-09-23T09:00:00Z,SVBS 157N 636W,39,1,0,0,40
Tropical Depression,Thirteen,7,2002-09-23T09:00:00Z,MYMM 224N 730W,0,0,0,4,4
Tropical Depression,Thirteen,7,2002-09-23T09:00:00Z,TFFR 163N 615W,7,0,0,0,7
Tropical Depression,Thirteen,7,2002-09-23T09:00:00Z,ST CROIX VI,2,11,1,0,14
Tropical Depression,Thirteen,7,2002-09-23T09:00:00Z,TAPA 171N 618W,2,0,0,0,2
Tropical Depression,Thirteen,7,2002-09-23T09:00:00Z,ST THOMAS VI,0,7,2,1,10
Tropical Depression,Thirteen,7,2002-09-23T09:00:00Z,TKPK 173N 627W,3,2,0,0,5
Tropical Depression,Thirteen,7,2002-09-23T09:00:00Z,SAN JUAN PR,0,8,4,1,13
Tropical Depression,Thirteen,7,2002-09-23T09:00:00Z,TNCM 181N 631W,1,1,1,0,3
Tropical Depression,Thirteen,7,2002-09-23T09:00:00Z,PONCE PR,0,11,5,1,17
Tropical Depression,Thirteen,7,2002-09-23T09:00:00Z,TISX 177N 648W,2,11,1,0,14
Tropical Depression,Thirteen,8,2002-09-23T15:00:00Z,14.3N  64.8W,48,0,0,0,48
Tropical Depression,Thirteen,8,2002-09-23T15:00:00Z,MDSD 185N 697W,0,2,17,4,23
Tropical Depression,Thirteen,8,2002-09-23T15:00:00Z,15.3N  67.4W,2,32,0,0,34
Tropical Depression,Thirteen,8,2002-09-23T15:00:00Z,MDCB 176N 714W,0,0,15,8,23
Tropical Depression,Thirteen,8,2002-09-23T15:00:00Z,16.2N  69.4W,0,14,11,1,26
Tropical Depression,Thirteen,8,2002-09-23T15:00:00Z,MTPP 186N 724W,0,0,6,14,20
Tropical Depression,Thirteen,8,2002-09-23T15:00:00Z,SKPG 125N 717W,0,0,2,3,5
Tropical Depression,Thirteen,8,2002-09-23T15:00:00Z,MTCA 183N 738W,0,0,1,17,18
Tropical Depression,Thirteen,8,2002-09-23T15:00:00Z,TNCC 122N 690W,0,2,3,1,6
Tropical Depression,Thirteen,8,2002-09-23T15:00:00Z,MKJP 179N 768W,0,0,0,8,8
Tropical Depression,Thirteen,8,2002-09-23T15:00:00Z,TGPY 120N 618W,14,0,0,0,14
Tropical Depression,Thirteen,8,2002-09-23T15:00:00Z,MKJS 185N 779W,0,0,0,5,5
Tropical Depression,Thirteen,8,2002-09-23T15:00:00Z,TBPB 131N 595W,99,0,0,0,99
Tropical Depression,Thirteen,8,2002-09-23T15:00:00Z,MUGM 200N 751W,0,0,0,14,14
Tropical Depression,Thirteen,8,2002-09-23T15:00:00Z,TVSV 131N 612W,83,0,0,0,83
Tropical Depression,Thirteen,8,2002-09-23T15:00:00Z,MUCM 214N 779W,0,0,0,5,5
Tropical Depression,Thirteen,8,2002-09-23T15:00:00Z,TLPL 138N 610W,89,0,0,0,89
Tropical Depression,Thirteen,8,2002-09-23T15:00:00Z,TJSJ 184N 661W,0,13,3,1,17
Tropical Depression,Thirteen,8,2002-09-23T15:00:00Z,TFFF 146N 610W,79,0,0,0,79
Tropical Depression,Thirteen,8,2002-09-23T15:00:00Z,MDPP 198N 707W,0,0,8,11,19
Tropical Depression,Thirteen,8,2002-09-23T15:00:00Z,TDPR 153N 614W,52,0,0,0,52
Tropical Depression,Thirteen,8,2002-09-23T15:00:00Z,MBJT 215N 712W,0,0,1,11,12
Tropical Depression,Thirteen,8,2002-09-23T15:00:00Z,SVBS 157N 636W,45,0,0,0,45
Tropical Depression,Thirteen,8,2002-09-23T15:00:00Z,MYMM 224N 730W,0,0,0,9,9
Tropical Depression,Thirteen,8,2002-09-23T15:00:00Z,TFFR 163N 615W,12,0,0,0,12
Tropical Depression,Thirteen,8,2002-09-23T15:00:00Z,MYSM 241N 745W,0,0,0,3,3
Tropical Depression,Thirteen,8,2002-09-23T15:00:00Z,TAPA 171N 618W,3,0,1,0,4
Tropical Depression,Thirteen,8,2002-09-23T15:00:00Z,MYEG 235N 758W,0,0,0,4,4
Tropical Depression,Thirteen,8,2002-09-23T15:00:00Z,TKPK 173N 627W,6,2,0,0,8
Tropical Depression,Thirteen,8,2002-09-23T15:00:00Z,ST CROIX VI,3,14,0,1,18
Tropical Depression,Thirteen,8,2002-09-23T15:00:00Z,TNCM 181N 631W,1,2,1,0,4
Tropical Depression,Thirteen,8,2002-09-23T15:00:00Z,ST THOMAS VI,1,10,2,0,13
Tropical Depression,Thirteen,8,2002-09-23T15:00:00Z,TISX 177N 648W,3,14,0,1,18
Tropical Depression,Thirteen,8,2002-09-23T15:00:00Z,SAN JUAN PR,0,13,3,1,17
Tropical Depression,Thirteen,8,2002-09-23T15:00:00Z,TIST 183N 650W,1,10,2,0,13
Tropical Depression,Thirteen,8,2002-09-23T15:00:00Z,PONCE PR,0,18,3,1,22
Tropical Depression,Thirteen,8,2002-09-23T15:00:00Z,TJPS 180N 666W,0,18,3,1,22
Tropical Storm,Lili,10,2002-09-23T21:00:00Z,14.2N  66.2W,51,0,0,0,51
Tropical Storm,Lili,10,2002-09-23T21:00:00Z,MTCA 183N 738W,0,0,5,15,20
Tropical Storm,Lili,10,2002-09-23T21:00:00Z,15.2N  68.5W,7,27,0,0,34
Tropical Storm,Lili,10,2002-09-23T21:00:00Z,MKJP 179N 768W,0,0,0,12,12
Tropical Storm,Lili,10,2002-09-23T21:00:00Z,16.2N  70.4W,0,17,8,1,26
Tropical Storm,Lili,10,2002-09-23T21:00:00Z,MKJS 185N 779W,0,0,0,9,9
Tropical Storm,Lili,10,2002-09-23T21:00:00Z,SKPG 125N 717W,0,1,3,2,6
Tropical Storm,Lili,10,2002-09-23T21:00:00Z,MUGM 200N 751W,0,0,0,17,17
Tropical Storm,Lili,10,2002-09-23T21:00:00Z,TNCC 122N 690W,1,6,1,1,9
Tropical Storm,Lili,10,2002-09-23T21:00:00Z,MUCM 214N 779W,0,0,0,9,9
Tropical Storm,Lili,10,2002-09-23T21:00:00Z,TTPT 112N 608W,2,0,0,0,2
Tropical Storm,Lili,10,2002-09-23T21:00:00Z,MUCF 221N 805W,0,0,0,2,2
Tropical Storm,Lili,10,2002-09-23T21:00:00Z,TGPY 120N 618W,99,0,0,0,99
Tropical Storm,Lili,10,2002-09-23T21:00:00Z,TJSJ 184N 661W,1,6,2,1,10
Tropical Storm,Lili,10,2002-09-23T21:00:00Z,TBPB 131N 595W,58,0,0,0,58
Tropical Storm,Lili,10,2002-09-23T21:00:00Z,MDPP 198N 707W,0,0,9,8,17
Tropical Storm,Lili,10,2002-09-23T21:00:00Z,TVSV 131N 612W,99,0,0,0,99
Tropical Storm,Lili,10,2002-09-23T21:00:00Z,MBJT 215N 712W,0,0,1,10,11
Tropical Storm,Lili,10,2002-09-23T21:00:00Z,TLPL 138N 610W,94,0,0,0,94
Tropical Storm,Lili,10,2002-09-23T21:00:00Z,MYMM 224N 730W,0,0,0,10,10
Tropical Storm,Lili,10,2002-09-23T21:00:00Z,TFFF 146N 610W,22,0,0,0,22
Tropical Storm,Lili,10,2002-09-23T21:00:00Z,MYSM 241N 745W,0,0,0,5,5
Tropical Storm,Lili,10,2002-09-23T21:00:00Z,TDPR 153N 614W,3,0,0,0,3
Tropical Storm,Lili,10,2002-09-23T21:00:00Z,MYEG 235N 758W,0,0,0,7,7
Tropical Storm,Lili,10,2002-09-23T21:00:00Z,SVBS 157N 636W,28,0,0,0,28
Tropical Storm,Lili,10,2002-09-23T21:00:00Z,MYAK 241N 776W,0,0,0,3,3
Tropical Storm,Lili,10,2002-09-23T21:00:00Z,TISX 177N 648W,2,4,0,1,7
Tropical Storm,Lili,10,2002-09-23T21:00:00Z,MYNN 251N 775W,0,0,0,2,2
Tropical Storm,Lili,10,2002-09-23T21:00:00Z,TIST 183N 650W,0,3,1,1,5
Tropical Storm,Lili,10,2002-09-23T21:00:00Z,ST CROIX VI,2,4,0,1,7
Tropical Storm,Lili,10,2002-09-23T21:00:00Z,TJPS 180N 666W,1,12,2,0,15
Tropical Storm,Lili,10,2002-09-23T21:00:00Z,ST THOMAS VI,0,3,1,1,5
Tropical Storm,Lili,10,2002-09-23T21:00:00Z,MDSD 185N 697W,0,5,14,2,21
Tropical Storm,Lili,10,2002-09-23T21:00:00Z,SAN JUAN PR,1,6,2,1,10
Tropical Storm,Lili,10,2002-09-23T21:00:00Z,MDCB 176N 714W,0,3,17,4,24
Tropical Storm,Lili,10,2002-09-23T21:00:00Z,PONCE PR,1,12,2,0,15
Tropical Storm,Lili,10,2002-09-23T21:00:00Z,MTPP 186N 724W,0,0,11,10,21
Tropical Storm,Lili,11,2002-09-24T03:00:00Z,15.0N  67.1W,48,0,0,0,48
Tropical Storm,Lili,11,2002-09-24T03:00:00Z,MKJP 179N 768W,0,0,0,8,8
Tropical Storm,Lili,11,2002-09-24T03:00:00Z,16.1N  69.0W,7,25,0,0,32
Tropical Storm,Lili,11,2002-09-24T03:00:00Z,MKJS 185N 779W,0,0,0,5,5
Tropical Storm,Lili,11,2002-09-24T03:00:00Z,17.0N  70.5W,0,19,5,2,26
Tropical Storm,Lili,11,2002-09-24T03:00:00Z,MUGM 200N 751W,0,0,1,13,14
Tropical Storm,Lili,11,2002-09-24T03:00:00Z,SKPG 125N 717W,0,1,3,2,6
Tropical Storm,Lili,11,2002-09-24T03:00:00Z,MUCM 214N 779W,0,0,0,5,5
Tropical Storm,Lili,11,2002-09-24T03:00:00Z,TNCC 122N 690W,4,5,0,0,9
Tropical Storm,Lili,11,2002-09-24T03:00:00Z,TJSJ 184N 661W,10,7,0,1,18
Tropical Storm,Lili,11,2002-09-24T03:00:00Z,TGPY 120N 618W,99,0,0,0,99
Tropical Storm,Lili,11,2002-09-24T03:00:00Z,MDPP 198N 707W,0,3,12,5,20
Tropical Storm,Lili,11,2002-09-24T03:00:00Z,TVSV 131N 612W,99,0,0,0,99
Tropical Storm,Lili,11,2002-09-24T03:00:00Z,MBJT 215N 712W,0,0,6,10,16
Tropical Storm,Lili,11,2002-09-24T03:00:00Z,TLPL 138N 610W,34,0,0,0,34
Tropical Storm,Lili,11,2002-09-24T03:00:00Z,MYMM 224N 730W,0,0,1,12,13
Tropical Storm,Lili,11,2002-09-24T03:00:00Z,TFFF 146N 610W,3,0,0,0,3
Tropical Storm,Lili,11,2002-09-24T03:00:00Z,MYSM 241N 745W,0,0,0,7,7
Tropical Storm,Lili,11,2002-09-24T03:00:00Z,SVBS 157N 636W,44,0,0,0,44
Tropical Storm,Lili,11,2002-09-24T03:00:00Z,MYEG 235N 758W,0,0,0,7,7
Tropical Storm,Lili,11,2002-09-24T03:00:00Z,TISX 177N 648W,13,2,0,0,15
Tropical Storm,Lili,11,2002-09-24T03:00:00Z,MYAK 241N 776W,0,0,0,3,3
Tropical Storm,Lili,11,2002-09-24T03:00:00Z,TIST 183N 650W,8,2,1,0,11
Tropical Storm,Lili,11,2002-09-24T03:00:00Z,MYNN 251N 775W,0,0,0,2,2
Tropical Storm,Lili,11,2002-09-24T03:00:00Z,TJPS 180N 666W,15,8,0,0,23
Tropical Storm,Lili,11,2002-09-24T03:00:00Z,ST CROIX VI,13,2,0,0,15
Tropical Storm,Lili,11,2002-09-24T03:00:00Z,MDSD 185N 697W,0,17,6,1,24
Tropical Storm,Lili,11,2002-09-24T03:00:00Z,ST THOMAS VI,8,2,1,0,11
Tropical Storm,Lili,11,2002-09-24T03:00:00Z,MDCB 176N 714W,0,8,12,3,23
Tropical Storm,Lili,11,2002-09-24T03:00:00Z,SAN JUAN PR,10,7,0,1,18
Tropical Storm,Lili,11,2002-09-24T03:00:00Z,MTPP 186N 724W,0,1,13,7,21
Tropical Storm,Lili,11,2002-09-24T03:00:00Z,PONCE PR,15,8,0,0,23
Tropical Storm,Lili,11,2002-09-24T03:00:00Z,MTCA 183N 738W,0,0,7,10,17
Tropical Storm,Lili,9,2002-09-23T16:30:00Z,13.9N  64.9W,47,0,0,1,48
Tropical Storm,Lili,9,2002-09-23T16:30:00Z,MDSD 185N 697W,0,1,15,5,21
Tropical Storm,Lili,9,2002-09-23T16:30:00Z,14.9N  67.4W,3,29,0,0,32
Tropical Storm,Lili,9,2002-09-23T16:30:00Z,MDCB 176N 714W,0,0,14,8,22
Tropical Storm,Lili,9,2002-09-23T16:30:00Z,15.9N  69.5W,0,12,12,1,25
Tropical Storm,Lili,9,2002-09-23T16:30:00Z,MTPP 186N 724W,0,0,5,15,20
Tropical Storm,Lili,9,2002-09-23T16:30:00Z,SKPG 125N 717W,0,0,3,4,7
Tropical Storm,Lili,9,2002-09-23T16:30:00Z,MTCA 183N 738W,0,0,2,16,18
Tropical Storm,Lili,9,2002-09-23T16:30:00Z,TNCC 122N 690W,0,5,4,1,10
Tropical Storm,Lili,9,2002-09-23T16:30:00Z,MKJP 179N 768W,0,0,0,9,9
Tropical Storm,Lili,9,2002-09-23T16:30:00Z,SVMG 110N 640W,2,0,0,0,2
Tropical Storm,Lili,9,2002-09-23T16:30:00Z,MKJS 185N 779W,0,0,0,6,6
Tropical Storm,Lili,9,2002-09-23T16:30:00Z,TTPT 112N 608W,3,0,0,0,3
Tropical Storm,Lili,9,2002-09-23T16:30:00Z,MUGM 200N 751W,0,0,0,14,14
Tropical Storm,Lili,9,2002-09-23T16:30:00Z,TGPY 120N 618W,33,0,0,0,33
Tropical Storm,Lili,9,2002-09-23T16:30:00Z,MUCM 214N 779W,0,0,0,5,5
Tropical Storm,Lili,9,2002-09-23T16:30:00Z,TBPB 131N 595W,99,0,0,0,99
Tropical Storm,Lili,9,2002-09-23T16:30:00Z,TJSJ 184N 661W,0,9,4,1,14
Tropical Storm,Lili,9,2002-09-23T16:30:00Z,TVSV 131N 612W,86,0,0,0,86
Tropical Storm,Lili,9,2002-09-23T16:30:00Z,MDPP 198N 707W,0,0,6,11,17
Tropical Storm,Lili,9,2002-09-23T16:30:00Z,TLPL 138N 610W,84,0,0,0,84
Tropical Storm,Lili,9,2002-09-23T16:30:00Z,MBJT 215N 712W,0,0,1,11,12
Tropical Storm,Lili,9,2002-09-23T16:30:00Z,TFFF 146N 610W,51,0,0,0,51
Tropical Storm,Lili,9,2002-09-23T16:30:00Z,MYMM 224N 730W,0,0,0,9,9
Tropical Storm,Lili,9,2002-09-23T16:30:00Z,TDPR 153N 614W,21,0,0,0,21
Tropical Storm,Lili,9,2002-09-23T16:30:00Z,MYSM 241N 745W,0,0,0,4,4
Tropical Storm,Lili,9,2002-09-23T16:30:00Z,SVBS 157N 636W,33,0,0,1,34
Tropical Storm,Lili,9,2002-09-23T16:30:00Z,MYEG 235N 758W,0,0,0,5,5
Tropical Storm,Lili,9,2002-09-23T16:30:00Z,TFFR 163N 615W,2,1,0,0,3
Tropical Storm,Lili,9,2002-09-23T16:30:00Z,MYAK 241N 776W,0,0,0,2,2
Tropical Storm,Lili,9,2002-09-23T16:30:00Z,TKPK 173N 627W,2,1,0,0,3
Tropical Storm,Lili,9,2002-09-23T16:30:00Z,ST CROIX VI,1,10,2,0,13
Tropical Storm,Lili,9,2002-09-23T16:30:00Z,TNCM 181N 631W,0,1,1,0,2
Tropical Storm,Lili,9,2002-09-23T16:30:00Z,ST THOMAS VI,0,7,2,1,10
Tropical Storm,Lili,9,2002-09-23T16:30:00Z,TISX 177N 648W,1,10,2,0,13
Tropical Storm,Lili,9,2002-09-23T16:30:00Z,SAN JUAN PR,0,9,4,1,14
Tropical Storm,Lili,9,2002-09-23T16:30:00Z,TIST 183N 650W,0,7,2,1,10
Tropical Storm,Lili,9,2002-09-23T16:30:00Z,PONCE PR,0,13,4,1,18
Tropical Storm,Lili,9,2002-09-23T16:30:00Z,TJPS 180N 666W,0,13,4,1,18
Tropical Storm,Lili,12,2002-09-24T09:00:00Z,14.7N  69.2W,47,0,0,0,47
Tropical Storm,Lili,12,2002-09-24T09:00:00Z,MUCM 214N 779W,0,0,0,10,10
Tropical Storm,Lili,12,2002-09-24T09:00:00Z,16.1N  70.7W,13,20,0,0,33
Tropical Storm,Lili,12,2002-09-24T09:00:00Z,MUCF 221N 805W,0,0,0,2,2
Tropical Storm,Lili,12,2002-09-24T09:00:00Z,17.5N  72.0W,0,19,7,1,27
Tropical Storm,Lili,12,2002-09-24T09:00:00Z,TJSJ 184N 661W,1,0,1,0,2
Tropical Storm,Lili,12,2002-09-24T09:00:00Z,SKPG 125N 717W,2,6,1,0,9
Tropical Storm,Lili,12,2002-09-24T09:00:00Z,MDPP 198N 707W,0,8,10,3,21
Tropical Storm,Lili,12,2002-09-24T09:00:00Z,TNCC 122N 690W,15,1,0,0,16
Tropical Storm,Lili,12,2002-09-24T09:00:00Z,MBJT 215N 712W,0,1,8,7,16
Tropical Storm,Lili,12,2002-09-24T09:00:00Z,TJPS 180N 666W,3,2,1,0,6
Tropical Storm,Lili,12,2002-09-24T09:00:00Z,MYMM 224N 730W,0,0,4,12,16
Tropical Storm,Lili,12,2002-09-24T09:00:00Z,MDSD 185N 697W,2,18,2,1,23
Tropical Storm,Lili,12,2002-09-24T09:00:00Z,MYSM 241N 745W,0,0,0,11,11
Tropical Storm,Lili,12,2002-09-24T09:00:00Z,MDCB 176N 714W,0,23,4,1,28
Tropical Storm,Lili,12,2002-09-24T09:00:00Z,MYEG 235N 758W,0,0,0,13,13
Tropical Storm,Lili,12,2002-09-24T09:00:00Z,MTPP 186N 724W,0,9,13,3,25
Tropical Storm,Lili,12,2002-09-24T09:00:00Z,MYAK 241N 776W,0,0,0,8,8
Tropical Storm,Lili,12,2002-09-24T09:00:00Z,MTCA 183N 738W,0,2,15,5,22
Tropical Storm,Lili,12,2002-09-24T09:00:00Z,MYNN 251N 775W,0,0,0,6,6
Tropical Storm,Lili,12,2002-09-24T09:00:00Z,MKJP 179N 768W,0,0,1,10,11
Tropical Storm,Lili,12,2002-09-24T09:00:00Z,MYGF 266N 787W,0,0,0,2,2
Tropical Storm,Lili,12,2002-09-24T09:00:00Z,MKJS 185N 779W,0,0,0,7,7
Tropical Storm,Lili,12,2002-09-24T09:00:00Z,SAN JUAN PR,1,0,1,0,2
Tropical Storm,Lili,12,2002-09-24T09:00:00Z,MUGM 200N 751W,0,0,6,13,19
Tropical Storm,Lili,12,2002-09-24T09:00:00Z,PONCE PR,3,2,1,0,6
Tropical Storm,Lili,13,2002-09-24T15:00:00Z,15.0N  69.7W,46,0,0,0,46
Tropical Storm,Lili,13,2002-09-24T15:00:00Z,MUCF 221N 805W,0,0,0,5,5
Tropical Storm,Lili,13,2002-09-24T15:00:00Z,16.3N  71.2W,18,15,0,0,33
Tropical Storm,Lili,13,2002-09-24T15:00:00Z,MDPP 198N 707W,0,6,12,1,19
Tropical Storm,Lili,13,2002-09-24T15:00:00Z,18.0N  72.8W,0,17,12,0,29
Tropical Storm,Lili,13,2002-09-24T15:00:00Z,MBJT 215N 712W,0,0,9,6,15
Tropical Storm,Lili,13,2002-09-24T15:00:00Z,SKPG 125N 717W,2,1,0,1,4
Tropical Storm,Lili,13,2002-09-24T15:00:00Z,MYMM 224N 730W,0,0,5,11,16
Tropical Storm,Lili,13,2002-09-24T15:00:00Z,TNCC 122N 690W,2,0,0,0,2
Tropical Storm,Lili,13,2002-09-24T15:00:00Z,MYSM 241N 745W,0,0,0,12,12
Tropical Storm,Lili,13,2002-09-24T15:00:00Z,TJPS 180N 666W,1,0,0,1,2
Tropical Storm,Lili,13,2002-09-24T15:00:00Z,MYEG 235N 758W,0,0,0,14,14
Tropical Storm,Lili,13,2002-09-24T15:00:00Z,MDSD 185N 697W,1,16,2,1,20
Tropical Storm,Lili,13,2002-09-24T15:00:00Z,MYAK 241N 776W,0,0,0,11,11
Tropical Storm,Lili,13,2002-09-24T15:00:00Z,MDCB 176N 714W,2,26,2,0,30
Tropical Storm,Lili,13,2002-09-24T15:00:00Z,MYNN 251N 775W,0,0,0,8,8
Tropical Storm,Lili,13,2002-09-24T15:00:00Z,MTPP 186N 724W,0,15,13,1,29
Tropical Storm,Lili,13,2002-09-24T15:00:00Z,MYGF 266N 787W,0,0,0,4,4
Tropical Storm,Lili,13,2002-09-24T15:00:00Z,MTCA 183N 738W,0,6,18,2,26
Tropical Storm,Lili,13,2002-09-24T15:00:00Z,PONCE PR,1,0,0,1,2
Tropical Storm,Lili,13,2002-09-24T15:00:00Z,MKJP 179N 768W,0,0,5,8,13
Tropical Storm,Lili,13,2002-09-24T15:00:00Z,MARATHON FL,0,0,0,3,3
Tropical Storm,Lili,13,2002-09-24T15:00:00Z,MKJS 185N 779W,0,0,1,10,11
Tropical Storm,Lili,13,2002-09-24T15:00:00Z,MIAMI FL,0,0,0,3,3
Tropical Storm,Lili,13,2002-09-24T15:00:00Z,MWCG 193N 814W,0,0,0,2,2
Tropical Storm,Lili,13,2002-09-24T15:00:00Z,W PALM BEACH FL,0,0,0,2,2
Tropical Storm,Lili,13,2002-09-24T15:00:00Z,MUGM 200N 751W,0,0,13,8,21
Tropical Storm,Lili,13,2002-09-24T15:00:00Z,KEY WEST FL,0,0,0,2,2
Tropical Storm,Lili,13,2002-09-24T15:00:00Z,MUCM 214N 779W,0,0,0,13,13
Tropical Storm,Lili,14,2002-09-24T21:00:00Z,15.2N  70.7W,47,0,0,0,47
Tropical Storm,Lili,14,2002-09-24T21:00:00Z,MUCF 221N 805W,0,0,0,5,5
Tropical Storm,Lili,14,2002-09-24T21:00:00Z,16.6N  72.8W,7,28,0,0,35
Tropical Storm,Lili,14,2002-09-24T21:00:00Z,MDPP 198N 707W,0,5,6,3,14
Tropical Storm,Lili,14,2002-09-24T21:00:00Z,18.2N  73.8W,0,21,6,1,28
Tropical Storm,Lili,14,2002-09-24T21:00:00Z,MBJT 215N 712W,0,0,6,6,12
Tropical Storm,Lili,14,2002-09-24T21:00:00Z,SKPG 125N 717W,2,0,0,1,3
Tropical Storm,Lili,14,2002-09-24T21:00:00Z,MYMM 224N 730W,0,0,4,11,15
Tropical Storm,Lili,14,2002-09-24T21:00:00Z,MDSD 185N 697W,3,8,2,1,14
Tropical Storm,Lili,14,2002-09-24T21:00:00Z,MYSM 241N 745W,0,0,0,13,13
Tropical Storm,Lili,14,2002-09-24T21:00:00Z,MDCB 176N 714W,8,22,1,0,31
Tropical Storm,Lili,14,2002-09-24T21:00:00Z,MYEG 235N 758W,0,0,1,14,15
Tropical Storm,Lili,14,2002-09-24T21:00:00Z,MTPP 186N 724W,0,21,4,1,26
Tropical Storm,Lili,14,2002-09-24T21:00:00Z,MYAK 241N 776W,0,0,0,11,11
Tropical Storm,Lili,14,2002-09-24T21:00:00Z,MTCA 183N 738W,0,20,7,1,28
Tropical Storm,Lili,14,2002-09-24T21:00:00Z,MYNN 251N 775W,0,0,0,9,9
Tropical Storm,Lili,14,2002-09-24T21:00:00Z,MKJP 179N 768W,0,1,11,4,16
Tropical Storm,Lili,14,2002-09-24T21:00:00Z,MYGF 266N 787W,0,0,0,4,4
Tropical Storm,Lili,14,2002-09-24T21:00:00Z,MKJS 185N 779W,0,0,5,8,13
Tropical Storm,Lili,14,2002-09-24T21:00:00Z,MARATHON FL,0,0,0,3,3
Tropical Storm,Lili,14,2002-09-24T21:00:00Z,MWCG 193N 814W,0,0,0,2,2
Tropical Storm,Lili,14,2002-09-24T21:00:00Z,MIAMI FL,0,0,0,3,3
Tropical Storm,Lili,14,2002-09-24T21:00:00Z,MUGM 200N 751W,0,1,16,5,22
Tropical Storm,Lili,14,2002-09-24T21:00:00Z,W PALM BEACH FL,0,0,0,2,2
Tropical Storm,Lili,14,2002-09-24T21:00:00Z,MUCM 214N 779W,0,0,1,13,14
Tropical Storm,Lili,14,2002-09-24T21:00:00Z,KEY WEST FL,0,0,0,2,2
Tropical Storm,Lili,15,2002-09-25T03:00:00Z,15.7N  71.4W,47,0,0,0,47
Tropical Storm,Lili,15,2002-09-25T03:00:00Z,MYMM 224N 730W,0,0,10,8,18
Tropical Storm,Lili,15,2002-09-25T03:00:00Z,17.2N  73.0W,11,23,1,0,35
Tropical Storm,Lili,15,2002-09-25T03:00:00Z,MYSM 241N 745W,0,0,2,13,15
Tropical Storm,Lili,15,2002-09-25T03:00:00Z,18.7N  73.7W,0,25,3,1,29
Tropical Storm,Lili,15,2002-09-25T03:00:00Z,MYEG 235N 758W,0,0,2,15,17
Tropical Storm,Lili,15,2002-09-25T03:00:00Z,MDSD 185N 697W,3,7,1,1,12
Tropical Storm,Lili,15,2002-09-25T03:00:00Z,MYAK 241N 776W,0,0,0,13,13
Tropical Storm,Lili,15,2002-09-25T03:00:00Z,MDCB 176N 714W,19,12,0,0,31
Tropical Storm,Lili,15,2002-09-25T03:00:00Z,MYNN 251N 775W,0,0,0,11,11
Tropical Storm,Lili,15,2002-09-25T03:00:00Z,MTPP 186N 724W,1,26,1,0,28
Tropical Storm,Lili,15,2002-09-25T03:00:00Z,MYGF 266N 787W,0,0,0,6,6
Tropical Storm,Lili,15,2002-09-25T03:00:00Z,MTCA 183N 738W,0,27,2,1,30
Tropical Storm,Lili,15,2002-09-25T03:00:00Z,MARATHON FL,0,0,0,3,3
Tropical Storm,Lili,15,2002-09-25T03:00:00Z,MKJP 179N 768W,0,2,9,4,15
Tropical Storm,Lili,15,2002-09-25T03:00:00Z,MIAMI FL,0,0,0,4,4
Tropical Storm,Lili,15,2002-09-25T03:00:00Z,MKJS 185N 779W,0,0,5,6,11
Tropical Storm,Lili,15,2002-09-25T03:00:00Z,W PALM BEACH FL,0,0,0,4,4
Tropical Storm,Lili,15,2002-09-25T03:00:00Z,MUGM 200N 751W,0,5,15,3,23
Tropical Storm,Lili,15,2002-09-25T03:00:00Z,FT PIERCE FL,0,0,0,2,2
Tropical Storm,Lili,15,2002-09-25T03:00:00Z,MUCM 214N 779W,0,0,2,12,14
Tropical Storm,Lili,15,2002-09-25T03:00:00Z,COCOA BEACH FL,0,0,0,2,2
Tropical Storm,Lili,15,2002-09-25T03:00:00Z,MUCF 221N 805W,0,0,0,5,5
Tropical Storm,Lili,15,2002-09-25T03:00:00Z,KEY WEST FL,0,0,0,2,2
Tropical Storm,Lili,15,2002-09-25T03:00:00Z,MDPP 198N 707W,0,8,4,3,15
Tropical Storm,Lili,15,2002-09-25T03:00:00Z,MARCO ISLAND FL,0,0,0,2,2
Tropical Storm,Lili,15,2002-09-25T03:00:00Z,MBJT 215N 712W,0,1,8,5,14
Tropical Storm,Lili,16,2002-09-25T09:00:00Z,16.2N  72.0W,45,0,0,0,45
Tropical Storm,Lili,16,2002-09-25T09:00:00Z,MYMM 224N 730W,0,2,10,6,18
Tropical Storm,Lili,16,2002-09-25T09:00:00Z,18.0N  73.7W,6,28,0,0,34
Tropical Storm,Lili,16,2002-09-25T09:00:00Z,MYSM 241N 745W,0,0,5,11,16
Tropical Storm,Lili,16,2002-09-25T09:00:00Z,19.5N  74.5W,0,23,4,1,28
Tropical Storm,Lili,16,2002-09-25T09:00:00Z,MYEG 235N 758W,0,0,6,12,18
Tropical Storm,Lili,16,2002-09-25T09:00:00Z,MDSD 185N 697W,7,3,0,1,11
Tropical Storm,Lili,16,2002-09-25T09:00:00Z,MYAK 241N 776W,0,0,1,14,15
Tropical Storm,Lili,16,2002-09-25T09:00:00Z,MDCB 176N 714W,31,2,1,0,34
Tropical Storm,Lili,16,2002-09-25T09:00:00Z,MYNN 251N 775W,0,0,0,13,13
Tropical Storm,Lili,16,2002-09-25T09:00:00Z,MTPP 186N 724W,9,22,0,0,31
Tropical Storm,Lili,16,2002-09-25T09:00:00Z,MYGF 266N 787W,0,0,0,8,8
Tropical Storm,Lili,16,2002-09-25T09:00:00Z,MTCA 183N 738W,3,29,1,0,33
Tropical Storm,Lili,16,2002-09-25T09:00:00Z,MARATHON FL,0,0,0,6,6
Tropical Storm,Lili,16,2002-09-25T09:00:00Z,MKJP 179N 768W,0,8,7,2,17
Tropical Storm,Lili,16,2002-09-25T09:00:00Z,MIAMI FL,0,0,0,7,7
Tropical Storm,Lili,16,2002-09-25T09:00:00Z,MKJS 185N 779W,0,1,8,4,13
Tropical Storm,Lili,16,2002-09-25T09:00:00Z,W PALM BEACH FL,0,0,0,6,6
Tropical Storm,Lili,16,2002-09-25T09:00:00Z,MWCG 193N 814W,0,0,0,2,2
Tropical Storm,Lili,16,2002-09-25T09:00:00Z,FT PIERCE FL,0,0,0,5,5
Tropical Storm,Lili,16,2002-09-25T09:00:00Z,MUGM 200N 751W,0,14,9,2,25
Tropical Storm,Lili,16,2002-09-25T09:00:00Z,COCOA BEACH FL,0,0,0,3,3
Tropical Storm,Lili,16,2002-09-25T09:00:00Z,MUCM 214N 779W,0,0,7,10,17
Tropical Storm,Lili,16,2002-09-25T09:00:00Z,DAYTONA BEACH FL,0,0,0,2,2
Tropical Storm,Lili,16,2002-09-25T09:00:00Z,MUCF 221N 805W,0,0,0,8,8
Tropical Storm,Lili,16,2002-09-25T09:00:00Z,KEY WEST FL,0,0,0,4,4
Tropical Storm,Lili,16,2002-09-25T09:00:00Z,MUSN 216N 826W,0,0,0,2,2
Tropical Storm,Lili,16,2002-09-25T09:00:00Z,MARCO ISLAND FL,0,0,0,4,4
Tropical Storm,Lili,16,2002-09-25T09:00:00Z,MUHA 230N 824W,0,0,0,3,3
Tropical Storm,Lili,16,2002-09-25T09:00:00Z,FT MYERS FL,0,0,0,3,3
Tropical Storm,Lili,16,2002-09-25T09:00:00Z,MDPP 198N 707W,2,8,2,1,13
Tropical Storm,Lili,16,2002-09-25T09:00:00Z,VENICE FL,0,0,0,2,2
Tropical Storm,Lili,16,2002-09-25T09:00:00Z,MBJT 215N 712W,0,3,6,3,12
Tropical Storm,Lili,17,2002-09-25T15:00:00Z,15.8N  72.5W,46,0,0,0,46
Tropical Storm,Lili,17,2002-09-25T15:00:00Z,MBJT 215N 712W,0,1,3,4,8
Tropical Storm,Lili,17,2002-09-25T15:00:00Z,17.1N  73.8W,17,15,1,0,33
Tropical Storm,Lili,17,2002-09-25T15:00:00Z,MYMM 224N 730W,0,0,6,7,13
Tropical Storm,Lili,17,2002-09-25T15:00:00Z,18.5N  74.9W,0,22,5,1,28
Tropical Storm,Lili,17,2002-09-25T15:00:00Z,MYSM 241N 745W,0,0,2,11,13
Tropical Storm,Lili,17,2002-09-25T15:00:00Z,SKPG 125N 717W,2,0,0,0,2
Tropical Storm,Lili,17,2002-09-25T15:00:00Z,MYEG 235N 758W,0,0,3,13,16
Tropical Storm,Lili,17,2002-09-25T15:00:00Z,MDSD 185N 697W,2,2,1,0,5
Tropical Storm,Lili,17,2002-09-25T15:00:00Z,MYAK 241N 776W,0,0,1,14,15
Tropical Storm,Lili,17,2002-09-25T15:00:00Z,MDCB 176N 714W,23,2,0,0,25
Tropical Storm,Lili,17,2002-09-25T15:00:00Z,MYNN 251N 775W,0,0,0,12,12
Tropical Storm,Lili,17,2002-09-25T15:00:00Z,MTPP 186N 724W,7,15,1,1,24
Tropical Storm,Lili,17,2002-09-25T15:00:00Z,MYGF 266N 787W,0,0,0,7,7
Tropical Storm,Lili,17,2002-09-25T15:00:00Z,MTCA 183N 738W,3,25,1,0,29
Tropical Storm,Lili,17,2002-09-25T15:00:00Z,MARATHON FL,0,0,0,7,7
Tropical Storm,Lili,17,2002-09-25T15:00:00Z,MKJP 179N 768W,0,8,10,2,20
Tropical Storm,Lili,17,2002-09-25T15:00:00Z,MIAMI FL,0,0,0,7,7
Tropical Storm,Lili,17,2002-09-25T15:00:00Z,MKJS 185N 779W,0,1,11,5,17
Tropical Storm,Lili,17,2002-09-25T15:00:00Z,W PALM BEACH FL,0,0,0,5,5
Tropical Storm,Lili,17,2002-09-25T15:00:00Z,MWCG 193N 814W,0,0,0,5,5
Tropical Storm,Lili,17,2002-09-25T15:00:00Z,FT PIERCE FL,0,0,0,4,4
Tropical Storm,Lili,17,2002-09-25T15:00:00Z,MUGM 200N 751W,0,9,13,3,25
Tropical Storm,Lili,17,2002-09-25T15:00:00Z,COCOA BEACH FL,0,0,0,2,2
Tropical Storm,Lili,17,2002-09-25T15:00:00Z,MUCM 214N 779W,0,0,7,11,18
Tropical Storm,Lili,17,2002-09-25T15:00:00Z,KEY WEST FL,0,0,0,5,5
Tropical Storm,Lili,17,2002-09-25T15:00:00Z,MUCF 221N 805W,0,0,0,10,10
Tropical Storm,Lili,17,2002-09-25T15:00:00Z,MARCO ISLAND FL,0,0,0,4,4
Tropical Storm,Lili,17,2002-09-25T15:00:00Z,MUSN 216N 826W,0,0,0,3,3
Tropical Storm,Lili,17,2002-09-25T15:00:00Z,FT MYERS FL,0,0,0,3,3
Tropical Storm,Lili,17,2002-09-25T15:00:00Z,MUHA 230N 824W,0,0,0,4,4
Tropical Storm,Lili,17,2002-09-25T15:00:00Z,VENICE FL,0,0,0,2,2
Tropical Storm,Lili,17,2002-09-25T15:00:00Z,MDPP 198N 707W,1,4,2,2,9
Tropical Storm,Lili,18,2002-09-25T21:00:00Z,16.0N  72.7W,48,0,0,1,49
Tropical Storm,Lili,18,2002-09-25T21:00:00Z,MYMM 224N 730W,0,1,9,6,16
Tropical Storm,Lili,18,2002-09-25T21:00:00Z,17.3N  74.0W,19,15,0,0,34
Tropical Storm,Lili,18,2002-09-25T21:00:00Z,MYSM 241N 745W,0,0,4,11,15
Tropical Storm,Lili,18,2002-09-25T21:00:00Z,19.0N  74.7W,0,23,5,1,29
Tropical Storm,Lili,18,2002-09-25T21:00:00Z,MYEG 235N 758W,0,0,7,11,18
Tropical Storm,Lili,18,2002-09-25T21:00:00Z,MDSD 185N 697W,1,1,2,2,6
Tropical Storm,Lili,18,2002-09-25T21:00:00Z,MYAK 241N 776W,0,0,2,13,15
Tropical Storm,Lili,18,2002-09-25T21:00:00Z,MDCB 176N 714W,23,2,0,0,25
Tropical Storm,Lili,18,2002-09-25T21:00:00Z,MYNN 251N 775W,0,0,1,12,13
Tropical Storm,Lili,18,2002-09-25T21:00:00Z,MTPP 186N 724W,8,14,2,0,24
Tropical Storm,Lili,18,2002-09-25T21:00:00Z,MYGF 266N 787W,0,0,0,9,9
Tropical Storm,Lili,18,2002-09-25T21:00:00Z,MTCA 183N 738W,6,24,1,0,31
Tropical Storm,Lili,18,2002-09-25T21:00:00Z,MARATHON FL,0,0,0,6,6
Tropical Storm,Lili,18,2002-09-25T21:00:00Z,MKJP 179N 768W,0,10,7,2,19
Tropical Storm,Lili,18,2002-09-25T21:00:00Z,MIAMI FL,0,0,0,7,7
Tropical Storm,Lili,18,2002-09-25T21:00:00Z,MKJS 185N 779W,0,2,8,5,15
Tropical Storm,Lili,18,2002-09-25T21:00:00Z,W PALM BEACH FL,0,0,0,6,6
Tropical Storm,Lili,18,2002-09-25T21:00:00Z,MWCG 193N 814W,0,0,0,2,2
Tropical Storm,Lili,18,2002-09-25T21:00:00Z,FT PIERCE FL,0,0,0,5,5
Tropical Storm,Lili,18,2002-09-25T21:00:00Z,MUGM 200N 751W,0,12,13,2,27
Tropical Storm,Lili,18,2002-09-25T21:00:00Z,COCOA BEACH FL,0,0,0,3,3
Tropical Storm,Lili,18,2002-09-25T21:00:00Z,MUCM 214N 779W,0,0,7,10,17
Tropical Storm,Lili,18,2002-09-25T21:00:00Z,DAYTONA BEACH FL,0,0,0,2,2
Tropical Storm,Lili,18,2002-09-25T21:00:00Z,MUCF 221N 805W,0,0,0,8,8
Tropical Storm,Lili,18,2002-09-25T21:00:00Z,KEY WEST FL,0,0,0,5,5
Tropical Storm,Lili,18,2002-09-25T21:00:00Z,MUSN 216N 826W,0,0,0,2,2
Tropical Storm,Lili,18,2002-09-25T21:00:00Z,MARCO ISLAND FL,0,0,0,4,4
Tropical Storm,Lili,18,2002-09-25T21:00:00Z,MUHA 230N 824W,0,0,0,3,3
Tropical Storm,Lili,18,2002-09-25T21:00:00Z,FT MYERS FL,0,0,0,3,3
Tropical Storm,Lili,18,2002-09-25T21:00:00Z,MDPP 198N 707W,0,4,3,4,11
Tropical Storm,Lili,18,2002-09-25T21:00:00Z,VENICE FL,0,0,0,2,2
Tropical Storm,Lili,18,2002-09-25T21:00:00Z,MBJT 215N 712W,0,1,5,5,11
Tropical Storm,Lili,18,2002-09-25T21:00:00Z,TAMPA FL,0,0,0,2,2
Tropical Storm,Lili,19,2002-09-26T03:00:00Z,15.3N  72.6W,44,0,0,0,44
Tropical Storm,Lili,19,2002-09-26T03:00:00Z,MDPP 198N 707W,0,1,2,1,4
Tropical Storm,Lili,19,2002-09-26T03:00:00Z,16.0N  74.0W,25,6,0,0,31
Tropical Storm,Lili,19,2002-09-26T03:00:00Z,MBJT 215N 712W,0,0,1,2,3
Tropical Storm,Lili,19,2002-09-26T03:00:00Z,17.1N  75.5W,1,20,4,1,26
Tropical Storm,Lili,19,2002-09-26T03:00:00Z,MYMM 224N 730W,0,0,1,5,6
Tropical Storm,Lili,19,2002-09-26T03:00:00Z,SKPG 125N 717W,0,1,0,1,2
Tropical Storm,Lili,19,2002-09-26T03:00:00Z,MYSM 241N 745W,0,0,0,5,5
Tropical Storm,Lili,19,2002-09-26T03:00:00Z,MDSD 185N 697W,1,1,1,1,4
Tropical Storm,Lili,19,2002-09-26T03:00:00Z,MYEG 235N 758W,0,0,1,8,9
Tropical Storm,Lili,19,2002-09-26T03:00:00Z,MDCB 176N 714W,13,4,1,0,18
Tropical Storm,Lili,19,2002-09-26T03:00:00Z,MYAK 241N 776W,0,0,0,10,10
Tropical Storm,Lili,19,2002-09-26T03:00:00Z,MTPP 186N 724W,2,11,3,1,17
Tropical Storm,Lili,19,2002-09-26T03:00:00Z,MYNN 251N 775W,0,0,0,7,7
Tropical Storm,Lili,19,2002-09-26T03:00:00Z,MTCA 183N 738W,1,18,3,2,24
Tropical Storm,Lili,19,2002-09-26T03:00:00Z,MYGF 266N 787W,0,0,0,4,4
Tropical Storm,Lili,19,2002-09-26T03:00:00Z,MKJP 179N 768W,0,7,13,3,23
Tropical Storm,Lili,19,2002-09-26T03:00:00Z,MARATHON FL,0,0,0,8,8
Tropical Storm,Lili,19,2002-09-26T03:00:00Z,MKJS 185N 779W,0,1,13,7,21
Tropical Storm,Lili,19,2002-09-26T03:00:00Z,MIAMI FL,0,0,0,6,6
Tropical Storm,Lili,19,2002-09-26T03:00:00Z,MWCG 193N 814W,0,0,0,11,11
Tropical Storm,Lili,19,2002-09-26T03:00:00Z,W PALM BEACH FL,0,0,0,4,4
Tropical Storm,Lili,19,2002-09-26T03:00:00Z,MUGM 200N 751W,0,3,13,4,20
Tropical Storm,Lili,19,2002-09-26T03:00:00Z,FT PIERCE FL,0,0,0,2,2
Tropical Storm,Lili,19,2002-09-26T03:00:00Z,MUCM 214N 779W,0,0,4,14,18
Tropical Storm,Lili,19,2002-09-26T03:00:00Z,KEY WEST FL,0,0,0,7,7
Tropical Storm,Lili,19,2002-09-26T03:00:00Z,MUCF 221N 805W,0,0,0,13,13
Tropical Storm,Lili,19,2002-09-26T03:00:00Z,MARCO ISLAND FL,0,0,0,4,4
Tropical Storm,Lili,19,2002-09-26T03:00:00Z,MUSN 216N 826W,0,0,0,8,8
Tropical Storm,Lili,19,2002-09-26T03:00:00Z,FT MYERS FL,0,0,0,3,3
Tropical Storm,Lili,19,2002-09-26T03:00:00Z,MUHA 230N 824W,0,0,0,8,8
Tropical Storm,Lili,19,2002-09-26T03:00:00Z,VENICE FL,0,0,0,2,2
Tropical Storm,Lili,19,2002-09-26T03:00:00Z,MUAN 219N 850W,0,0,0,2,2
Tropical Storm,Lili,20,2002-09-26T09:00:00Z,15.7N  73.2W,44,0,0,0,44
Tropical Storm,Lili,20,2002-09-26T09:00:00Z,MBJT 215N 712W,0,0,1,1,2
Tropical Storm,Lili,20,2002-09-26T09:00:00Z,16.6N  74.7W,22,9,1,0,32
Tropical Storm,Lili,20,2002-09-26T09:00:00Z,MYMM 224N 730W,0,0,2,4,6
Tropical Storm,Lili,20,2002-09-26T09:00:00Z,17.8N  76.1W,1,21,4,1,27
Tropical Storm,Lili,20,2002-09-26T09:00:00Z,MYSM 241N 745W,0,0,0,6,6
Tropical Storm,Lili,20,2002-09-26T09:00:00Z,MDSD 185N 697W,0,1,0,1,2
Tropical Storm,Lili,20,2002-09-26T09:00:00Z,MYEG 235N 758W,0,0,2,9,11
Tropical Storm,Lili,20,2002-09-26T09:00:00Z,MDCB 176N 714W,15,2,1,0,18
Tropical Storm,Lili,20,2002-09-26T09:00:00Z,MYAK 241N 776W,0,0,1,11,12
Tropical Storm,Lili,20,2002-09-26T09:00:00Z,MTPP 186N 724W,4,11,2,0,17
Tropical Storm,Lili,20,2002-09-26T09:00:00Z,MYNN 251N 775W,0,0,0,8,8
Tropical Storm,Lili,20,2002-09-26T09:00:00Z,MTCA 183N 738W,5,19,1,0,25
Tropical Storm,Lili,20,2002-09-26T09:00:00Z,MYGF 266N 787W,0,0,0,5,5
Tropical Storm,Lili,20,2002-09-26T09:00:00Z,MKJP 179N 768W,0,15,8,2,25
Tropical Storm,Lili,20,2002-09-26T09:00:00Z,MARATHON FL,0,0,0,10,10
Tropical Storm,Lili,20,2002-09-26T09:00:00Z,MKJS 185N 779W,0,4,14,4,22
Tropical Storm,Lili,20,2002-09-26T09:00:00Z,MIAMI FL,0,0,0,8,8
Tropical Storm,Lili,20,2002-09-26T09:00:00Z,MWCG 193N 814W,0,0,1,11,12
Tropical Storm,Lili,20,2002-09-26T09:00:00Z,W PALM BEACH FL,0,0,0,5,5
Tropical Storm,Lili,20,2002-09-26T09:00:00Z,MUGM 200N 751W,0,8,11,3,22
Tropical Storm,Lili,20,2002-09-26T09:00:00Z,FT PIERCE FL,0,0,0,3,3
Tropical Storm,Lili,20,2002-09-26T09:00:00Z,MUCM 214N 779W,0,0,9,10,19
Tropical Storm,Lili,20,2002-09-26T09:00:00Z,COCOA BEACH FL,0,0,0,2,2
Tropical Storm,Lili,20,2002-09-26T09:00:00Z,MUCF 221N 805W,0,0,1,14,15
Tropical Storm,Lili,20,2002-09-26T09:00:00Z,KEY WEST FL,0,0,0,9,9
Tropical Storm,Lili,20,2002-09-26T09:00:00Z,MUSN 216N 826W,0,0,0,10,10
Tropical Storm,Lili,20,2002-09-26T09:00:00Z,MARCO ISLAND FL,0,0,0,6,6
Tropical Storm,Lili,20,2002-09-26T09:00:00Z,MUHA 230N 824W,0,0,0,10,10
Tropical Storm,Lili,20,2002-09-26T09:00:00Z,FT MYERS FL,0,0,0,5,5
Tropical Storm,Lili,20,2002-09-26T09:00:00Z,MUAN 219N 850W,0,0,0,3,3
Tropical Storm,Lili,20,2002-09-26T09:00:00Z,VENICE FL,0,0,0,3,3
Tropical Storm,Lili,20,2002-09-26T09:00:00Z,MDPP 198N 707W,0,1,1,1,3
Tropical Storm,Lili,20,2002-09-26T09:00:00Z,TAMPA FL,0,0,0,2,2
Tropical Depression,Lili,21,2002-09-26T15:00:00Z,16.9N  75.4W,45,0,0,0,45
Tropical Depression,Lili,21,2002-09-26T15:00:00Z,MYEG 235N 758W,0,0,3,3,6
Tropical Depression,Lili,21,2002-09-26T15:00:00Z,18.0N  77.0W,18,15,0,0,33
Tropical Depression,Lili,21,2002-09-26T15:00:00Z,MYAK 241N 776W,0,0,4,5,9
Tropical Depression,Lili,21,2002-09-26T15:00:00Z,19.0N  78.5W,1,21,4,1,27
Tropical Depression,Lili,21,2002-09-26T15:00:00Z,MYNN 251N 775W,0,0,1,4,5
Tropical Depression,Lili,21,2002-09-26T15:00:00Z,MDCB 176N 714W,2,0,0,0,2
Tropical Depression,Lili,21,2002-09-26T15:00:00Z,MYGF 266N 787W,0,0,0,3,3
Tropical Depression,Lili,21,2002-09-26T15:00:00Z,MTPP 186N 724W,5,2,0,1,8
Tropical Depression,Lili,21,2002-09-26T15:00:00Z,MARATHON FL,0,0,1,12,13
Tropical Depression,Lili,21,2002-09-26T15:00:00Z,MTCA 183N 738W,24,0,1,0,25
Tropical Depression,Lili,21,2002-09-26T15:00:00Z,MIAMI FL,0,0,0,8,8
Tropical Depression,Lili,21,2002-09-26T15:00:00Z,MKJP 179N 768W,23,10,1,0,34
Tropical Depression,Lili,21,2002-09-26T15:00:00Z,W PALM BEACH FL,0,0,0,5,5
Tropical Depression,Lili,21,2002-09-26T15:00:00Z,MKJS 185N 779W,4,24,1,0,29
Tropical Depression,Lili,21,2002-09-26T15:00:00Z,FT PIERCE FL,0,0,0,3,3
Tropical Depression,Lili,21,2002-09-26T15:00:00Z,MWCG 193N 814W,0,1,10,8,19
Tropical Depression,Lili,21,2002-09-26T15:00:00Z,COCOA BEACH FL,0,0,0,2,2
Tropical Depression,Lili,21,2002-09-26T15:00:00Z,MUGM 200N 751W,5,13,1,1,20
Tropical Depression,Lili,21,2002-09-26T15:00:00Z,KEY WEST FL,0,0,1,12,13
Tropical Depression,Lili,21,2002-09-26T15:00:00Z,MUCM 214N 779W,0,9,10,2,21
Tropical Depression,Lili,21,2002-09-26T15:00:00Z,MARCO ISLAND FL,0,0,0,9,9
Tropical Depression,Lili,21,2002-09-26T15:00:00Z,MUCF 221N 805W,0,0,12,8,20
Tropical Depression,Lili,21,2002-09-26T15:00:00Z,FT MYERS FL,0,0,0,7,7
Tropical Depression,Lili,21,2002-09-26T15:00:00Z,MUSN 216N 826W,0,0,4,14,18
Tropical Depression,Lili,21,2002-09-26T15:00:00Z,VENICE FL,0,0,0,6,6
Tropical Depression,Lili,21,2002-09-26T15:00:00Z,MUHA 230N 824W,0,0,3,13,16
Tropical Depression,Lili,21,2002-09-26T15:00:00Z,TAMPA FL,0,0,0,3,3
Tropical Depression,Lili,21,2002-09-26T15:00:00Z,MUAN 219N 850W,0,0,0,12,12
Tropical Depression,Lili,21,2002-09-26T15:00:00Z,CEDAR KEY FL,0,0,0,2,2
Tropical Depression,Lili,21,2002-09-26T15:00:00Z,MMCZ 205N 869W,0,0,0,5,5
Tropical Depression,Lili,21,2002-09-26T15:00:00Z,GULF 29N 85W,0,0,0,2,2
Tropical Depression,Lili,21,2002-09-26T15:00:00Z,MHNJ 165N 859W,0,0,0,2,2
Tropical Depression,Lili,22,2002-09-27T03:00:00Z,17.0N  75.3W,55,0,0,0,55
Tropical Depression,Lili,22,2002-09-27T03:00:00Z,MYSM 241N 745W,0,0,0,3,3
Tropical Depression,Lili,22,2002-09-27T03:00:00Z,18.0N  76.3W,31,6,0,0,37
Tropical Depression,Lili,22,2002-09-27T03:00:00Z,MYEG 235N 758W,0,0,3,5,8
Tropical Depression,Lili,22,2002-09-27T03:00:00Z,18.9N  77.5W,3,25,2,1,31
Tropical Depression,Lili,22,2002-09-27T03:00:00Z,MYAK 241N 776W,0,0,2,9,11
Tropical Depression,Lili,22,2002-09-27T03:00:00Z,MTPP 186N 724W,4,1,0,1,6
Tropical Depression,Lili,22,2002-09-27T03:00:00Z,MYNN 251N 775W,0,0,0,8,8
Tropical Depression,Lili,22,2002-09-27T03:00:00Z,MTCA 183N 738W,25,0,0,0,25
Tropical Depression,Lili,22,2002-09-27T03:00:00Z,MYGF 266N 787W,0,0,0,5,5
Tropical Depression,Lili,22,2002-09-27T03:00:00Z,MKJP 179N 768W,24,10,1,0,35
Tropical Depression,Lili,22,2002-09-27T03:00:00Z,MARATHON FL,0,0,0,12,12
Tropical Depression,Lili,22,2002-09-27T03:00:00Z,MKJS 185N 779W,3,23,2,1,29
Tropical Depression,Lili,22,2002-09-27T03:00:00Z,MIAMI FL,0,0,0,9,9
Tropical Depression,Lili,22,2002-09-27T03:00:00Z,MWCG 193N 814W,0,0,7,10,17
Tropical Depression,Lili,22,2002-09-27T03:00:00Z,W PALM BEACH FL,0,0,0,6,6
Tropical Depression,Lili,22,2002-09-27T03:00:00Z,MUGM 200N 751W,4,14,2,1,21
Tropical Depression,Lili,22,2002-09-27T03:00:00Z,FT PIERCE FL,0,0,0,4,4
Tropical Depression,Lili,22,2002-09-27T03:00:00Z,MUCM 214N 779W,0,4,14,4,22
Tropical Depression,Lili,22,2002-09-27T03:00:00Z,COCOA BEACH FL,0,0,0,3,3
Tropical Depression,Lili,22,2002-09-27T03:00:00Z,MUCF 221N 805W,0,0,6,13,19
Tropical Depression,Lili,22,2002-09-27T03:00:00Z,KEY WEST FL,0,0,0,12,12
Tropical Depression,Lili,22,2002-09-27T03:00:00Z,MUSN 216N 826W,0,0,1,14,15
Tropical Depression,Lili,22,2002-09-27T03:00:00Z,MARCO ISLAND FL,0,0,0,9,9
Tropical Depression,Lili,22,2002-09-27T03:00:00Z,MUHA 230N 824W,0,0,0,14,14
Tropical Depression,Lili,22,2002-09-27T03:00:00Z,FT MYERS FL,0,0,0,7,7
Tropical Depression,Lili,22,2002-09-27T03:00:00Z,MUAN 219N 850W,0,0,0,7,7
Tropical Depression,Lili,22,2002-09-27T03:00:00Z,VENICE FL,0,0,0,5,5
Tropical Depression,Lili,22,2002-09-27T03:00:00Z,MYMM 224N 730W,0,0,1,1,2
Tropical Depression,Lili,22,2002-09-27T03:00:00Z,TAMPA FL,0,0,0,3,3
Tropical Depression,Lili,23,2002-09-27T09:00:00Z,17.5N  77.5W,51,0,0,0,51
Tropical Depression,Lili,23,2002-09-27T09:00:00Z,MYAK 241N 776W,0,0,5,6,11
Tropical Depression,Lili,23,2002-09-27T09:00:00Z,18.5N  78.5W,27,7,0,0,34
Tropical Depression,Lili,23,2002-09-27T09:00:00Z,MYNN 251N 775W,0,0,1,6,7
Tropical Depression,Lili,23,2002-09-27T09:00:00Z,19.5N  79.5W,3,22,2,1,28
Tropical Depression,Lili,23,2002-09-27T09:00:00Z,MYGF 266N 787W,0,0,0,5,5
Tropical Depression,Lili,23,2002-09-27T09:00:00Z,MTCA 183N 738W,1,0,0,3,4
Tropical Depression,Lili,23,2002-09-27T09:00:00Z,MARATHON FL,0,0,4,10,14
Tropical Depression,Lili,23,2002-09-27T09:00:00Z,MKJP 179N 768W,47,0,0,0,47
Tropical Depression,Lili,23,2002-09-27T09:00:00Z,MIAMI FL,0,0,1,9,10
Tropical Depression,Lili,23,2002-09-27T09:00:00Z,MKJS 185N 779W,34,2,0,0,36
Tropical Depression,Lili,23,2002-09-27T09:00:00Z,W PALM BEACH FL,0,0,0,7,7
Tropical Depression,Lili,23,2002-09-27T09:00:00Z,MWCG 193N 814W,0,8,9,4,21
Tropical Depression,Lili,23,2002-09-27T09:00:00Z,FT PIERCE FL,0,0,0,5,5
Tropical Depression,Lili,23,2002-09-27T09:00:00Z,MUGM 200N 751W,2,5,1,3,11
Tropical Depression,Lili,23,2002-09-27T09:00:00Z,COCOA BEACH FL,0,0,0,3,3
Tropical Depression,Lili,23,2002-09-27T09:00:00Z,MUCM 214N 779W,0,14,5,3,22
Tropical Depression,Lili,23,2002-09-27T09:00:00Z,KEY WEST FL,0,0,4,11,15
Tropical Depression,Lili,23,2002-09-27T09:00:00Z,MUCF 221N 805W,0,3,14,5,22
Tropical Depression,Lili,23,2002-09-27T09:00:00Z,MARCO ISLAND FL,0,0,1,9,10
Tropical Depression,Lili,23,2002-09-27T09:00:00Z,MUSN 216N 826W,0,0,9,9,18
Tropical Depression,Lili,23,2002-09-27T09:00:00Z,FT MYERS FL,0,0,0,8,8
Tropical Depression,Lili,23,2002-09-27T09:00:00Z,MUHA 230N 824W,0,0,7,10,17
Tropical Depression,Lili,23,2002-09-27T09:00:00Z,VENICE FL,0,0,0,6,6
Tropical Depression,Lili,23,2002-09-27T09:00:00Z,MUAN 219N 850W,0,0,1,8,9
Tropical Depression,Lili,23,2002-09-27T09:00:00Z,TAMPA FL,0,0,0,4,4
Tropical Depression,Lili,23,2002-09-27T09:00:00Z,MMCZ 205N 869W,0,0,0,2,2
Tropical Depression,Lili,23,2002-09-27T09:00:00Z,CEDAR KEY FL,0,0,0,2,2
Tropical Depression,Lili,23,2002-09-27T09:00:00Z,MYSM 241N 745W,0,0,0,2,2
Tropical Depression,Lili,23,2002-09-27T09:00:00Z,GULF 29N 85W,0,0,0,2,2
Tropical Depression,Lili,23,2002-09-27T09:00:00Z,MYEG 235N 758W,0,0,2,4,6
Tropical Storm,Lili,24,2002-09-27T15:00:00Z,17.9N  76.9W,55,0,0,0,55
Tropical Storm,Lili,24,2002-09-27T15:00:00Z,MYAK 241N 776W,0,0,4,7,11
Tropical Storm,Lili,24,2002-09-27T15:00:00Z,18.8N  77.9W,37,3,1,0,41
Tropical Storm,Lili,24,2002-09-27T15:00:00Z,MYNN 251N 775W,0,0,1,6,7
Tropical Storm,Lili,24,2002-09-27T15:00:00Z,19.5N  78.9W,9,23,0,1,33
Tropical Storm,Lili,24,2002-09-27T15:00:00Z,MYGF 266N 787W,0,0,0,5,5
Tropical Storm,Lili,24,2002-09-27T15:00:00Z,MTCA 183N 738W,14,0,1,0,15
Tropical Storm,Lili,24,2002-09-27T15:00:00Z,MARATHON FL,0,0,2,12,14
Tropical Storm,Lili,24,2002-09-27T15:00:00Z,MKJP 179N 768W,56,0,0,0,56
Tropical Storm,Lili,24,2002-09-27T15:00:00Z,MIAMI FL,0,0,1,9,10
Tropical Storm,Lili,24,2002-09-27T15:00:00Z,MKJS 185N 779W,40,2,0,0,42
Tropical Storm,Lili,24,2002-09-27T15:00:00Z,W PALM BEACH FL,0,0,0,7,7
Tropical Storm,Lili,24,2002-09-27T15:00:00Z,MWCG 193N 814W,0,6,10,5,21
Tropical Storm,Lili,24,2002-09-27T15:00:00Z,FT PIERCE FL,0,0,0,5,5
Tropical Storm,Lili,24,2002-09-27T15:00:00Z,MUGM 200N 751W,10,3,0,1,14
Tropical Storm,Lili,24,2002-09-27T15:00:00Z,COCOA BEACH FL,0,0,0,3,3
Tropical Storm,Lili,24,2002-09-27T15:00:00Z,MUCM 214N 779W,1,16,4,2,23
Tropical Storm,Lili,24,2002-09-27T15:00:00Z,DAYTONA BEACH FL,0,0,0,2,2
Tropical Storm,Lili,24,2002-09-27T15:00:00Z,MUCF 221N 805W,0,2,14,6,22
Tropical Storm,Lili,24,2002-09-27T15:00:00Z,KEY WEST FL,0,0,1,13,14
Tropical Storm,Lili,24,2002-09-27T15:00:00Z,MUSN 216N 826W,0,0,7,10,17
Tropical Storm,Lili,24,2002-09-27T15:00:00Z,MARCO ISLAND FL,0,0,0,9,9
Tropical Storm,Lili,24,2002-09-27T15:00:00Z,MUHA 230N 824W,0,0,4,12,16
Tropical Storm,Lili,24,2002-09-27T15:00:00Z,FT MYERS FL,0,0,0,7,7
Tropical Storm,Lili,24,2002-09-27T15:00:00Z,MUAN 219N 850W,0,0,0,8,8
Tropical Storm,Lili,24,2002-09-27T15:00:00Z,VENICE FL,0,0,0,6,6
Tropical Storm,Lili,24,2002-09-27T15:00:00Z,MMCZ 205N 869W,0,0,0,2,2
Tropical Storm,Lili,24,2002-09-27T15:00:00Z,TAMPA FL,0,0,0,4,4
Tropical Storm,Lili,24,2002-09-27T15:00:00Z,MYEG 235N 758W,0,0,2,4,6
Tropical Storm,Lili,24,2002-09-27T15:00:00Z,CEDAR KEY FL,0,0,0,2,2
Tropical Storm,Lili,25,2002-09-27T21:00:00Z,18.8N  76.8W,59,0,0,0,59
Tropical Storm,Lili,25,2002-09-27T21:00:00Z,MYAK 241N 776W,0,1,7,5,13
Tropical Storm,Lili,25,2002-09-27T21:00:00Z,19.6N  77.8W,34,3,0,0,37
Tropical Storm,Lili,25,2002-09-27T21:00:00Z,MYNN 251N 775W,0,0,3,6,9
Tropical Storm,Lili,25,2002-09-27T21:00:00Z,20.4N  79.1W,5,21,2,1,29
Tropical Storm,Lili,25,2002-09-27T21:00:00Z,MYGF 266N 787W,0,0,0,7,7
Tropical Storm,Lili,25,2002-09-27T21:00:00Z,MTCA 183N 738W,13,0,0,1,14
Tropical Storm,Lili,25,2002-09-27T21:00:00Z,MARATHON FL,0,0,5,11,16
Tropical Storm,Lili,25,2002-09-27T21:00:00Z,MKJP 179N 768W,59,0,0,0,59
Tropical Storm,Lili,25,2002-09-27T21:00:00Z,MIAMI FL,0,0,2,10,12
Tropical Storm,Lili,25,2002-09-27T21:00:00Z,MKJS 185N 779W,35,0,0,0,35
Tropical Storm,Lili,25,2002-09-27T21:00:00Z,W PALM BEACH FL,0,0,0,9,9
Tropical Storm,Lili,25,2002-09-27T21:00:00Z,MWCG 193N 814W,0,4,9,5,18
Tropical Storm,Lili,25,2002-09-27T21:00:00Z,FT PIERCE FL,0,0,0,7,7
Tropical Storm,Lili,25,2002-09-27T21:00:00Z,MUGM 200N 751W,21,1,0,0,22
Tropical Storm,Lili,25,2002-09-27T21:00:00Z,COCOA BEACH FL,0,0,0,5,5
Tropical Storm,Lili,25,2002-09-27T21:00:00Z,MUCM 214N 779W,6,18,2,1,27
Tropical Storm,Lili,25,2002-09-27T21:00:00Z,DAYTONA BEACH FL,0,0,0,3,3
Tropical Storm,Lili,25,2002-09-27T21:00:00Z,MUCF 221N 805W,0,6,14,3,23
Tropical Storm,Lili,25,2002-09-27T21:00:00Z,KEY WEST FL,0,0,4,12,16
Tropical Storm,Lili,25,2002-09-27T21:00:00Z,MUSN 216N 826W,0,0,9,9,18
Tropical Storm,Lili,25,2002-09-27T21:00:00Z,MARCO ISLAND FL,0,0,1,10,11
Tropical Storm,Lili,25,2002-09-27T21:00:00Z,MUHA 230N 824W,0,0,8,9,17
Tropical Storm,Lili,25,2002-09-27T21:00:00Z,FT MYERS FL,0,0,0,10,10
Tropical Storm,Lili,25,2002-09-27T21:00:00Z,MUAN 219N 850W,0,0,1,9,10
Tropical Storm,Lili,25,2002-09-27T21:00:00Z,VENICE FL,0,0,0,8,8
Tropical Storm,Lili,25,2002-09-27T21:00:00Z,MMCZ 205N 869W,0,0,0,3,3
Tropical Storm,Lili,25,2002-09-27T21:00:00Z,TAMPA FL,0,0,0,5,5
Tropical Storm,Lili,25,2002-09-27T21:00:00Z,MYSM 241N 745W,0,0,0,2,2
Tropical Storm,Lili,25,2002-09-27T21:00:00Z,CEDAR KEY FL,0,0,0,3,3
Tropical Storm,Lili,25,2002-09-27T21:00:00Z,MYEG 235N 758W,0,1,4,3,8
Tropical Storm,Lili,25,2002-09-27T21:00:00Z,GULF 29N 85W,0,0,0,2,2
Tropical Storm,Lili,26,2002-09-28T03:00:00Z,19.7N  76.1W,49,0,0,0,49
Tropical Storm,Lili,26,2002-09-28T03:00:00Z,MYAK 241N 776W,0,7,7,3,17
Tropical Storm,Lili,26,2002-09-28T03:00:00Z,20.6N  77.5W,26,7,0,1,34
Tropical Storm,Lili,26,2002-09-28T03:00:00Z,MYNN 251N 775W,0,2,6,4,12
Tropical Storm,Lili,26,2002-09-28T03:00:00Z,21.3N  79.0W,3,20,2,1,26
Tropical Storm,Lili,26,2002-09-28T03:00:00Z,MYGF 266N 787W,0,0,3,6,9
Tropical Storm,Lili,26,2002-09-28T03:00:00Z,MTPP 186N 724W,2,0,0,1,3
Tropical Storm,Lili,26,2002-09-28T03:00:00Z,MARATHON FL,0,0,9,7,16
Tropical Storm,Lili,26,2002-09-28T03:00:00Z,MTCA 183N 738W,55,0,0,0,55
Tropical Storm,Lili,26,2002-09-28T03:00:00Z,MIAMI FL,0,0,5,8,13
Tropical Storm,Lili,26,2002-09-28T03:00:00Z,MKJP 179N 768W,32,1,0,0,33
Tropical Storm,Lili,26,2002-09-28T03:00:00Z,W PALM BEACH FL,0,0,2,8,10
Tropical Storm,Lili,26,2002-09-28T03:00:00Z,MKJS 185N 779W,15,3,1,1,20
Tropical Storm,Lili,26,2002-09-28T03:00:00Z,FT PIERCE FL,0,0,1,7,8
Tropical Storm,Lili,26,2002-09-28T03:00:00Z,MWCG 193N 814W,0,1,7,6,14
Tropical Storm,Lili,26,2002-09-28T03:00:00Z,COCOA BEACH FL,0,0,0,6,6
Tropical Storm,Lili,26,2002-09-28T03:00:00Z,MUGM 200N 751W,40,0,0,0,40
Tropical Storm,Lili,26,2002-09-28T03:00:00Z,DAYTONA BEACH FL,0,0,0,3,3
Tropical Storm,Lili,26,2002-09-28T03:00:00Z,MUCM 214N 779W,12,17,1,0,30
Tropical Storm,Lili,26,2002-09-28T03:00:00Z,KEY WEST FL,0,0,7,9,16
Tropical Storm,Lili,26,2002-09-28T03:00:00Z,MUCF 221N 805W,0,7,12,3,22
Tropical Storm,Lili,26,2002-09-28T03:00:00Z,MARCO ISLAND FL,0,0,3,9,12
Tropical Storm,Lili,26,2002-09-28T03:00:00Z,MUSN 216N 826W,0,0,7,9,16
Tropical Storm,Lili,26,2002-09-28T03:00:00Z,FT MYERS FL,0,0,1,9,10
Tropical Storm,Lili,26,2002-09-28T03:00:00Z,MUHA 230N 824W,0,0,8,8,16
Tropical Storm,Lili,26,2002-09-28T03:00:00Z,VENICE FL,0,0,1,8,9
Tropical Storm,Lili,26,2002-09-28T03:00:00Z,MUAN 219N 850W,0,0,0,9,9
Tropical Storm,Lili,26,2002-09-28T03:00:00Z,TAMPA FL,0,0,0,6,6
Tropical Storm,Lili,26,2002-09-28T03:00:00Z,MMCZ 205N 869W,0,0,0,3,3
Tropical Storm,Lili,26,2002-09-28T03:00:00Z,CEDAR KEY FL,0,0,0,4,4
Tropical Storm,Lili,26,2002-09-28T03:00:00Z,MYMM 224N 730W,0,1,0,1,2
Tropical Storm,Lili,26,2002-09-28T03:00:00Z,ST MARKS FL,0,0,0,2,2
Tropical Storm,Lili,26,2002-09-28T03:00:00Z,MYSM 241N 745W,0,1,1,2,4
Tropical Storm,Lili,26,2002-09-28T03:00:00Z,APALACHICOLA FL,0,0,0,2,2
Tropical Storm,Lili,26,2002-09-28T03:00:00Z,MYEG 235N 758W,0,8,3,2,13
Tropical Storm,Lili,26,2002-09-28T03:00:00Z,GULF 29N 85W,0,0,0,3,3
Tropical Storm,Lili,27,2002-09-28T09:00:00Z,19.5N  77.0W,59,0,0,0,59
Tropical Storm,Lili,27,2002-09-28T09:00:00Z,MYGF 266N 787W,0,0,2,5,7
Tropical Storm,Lili,27,2002-09-28T09:00:00Z,20.5N  78.0W,31,5,0,0,36
Tropical Storm,Lili,27,2002-09-28T09:00:00Z,MARATHON FL,0,0,8,8,16
Tropical Storm,Lili,27,2002-09-28T09:00:00Z,21.0N  79.1W,9,17,1,1,28
Tropical Storm,Lili,27,2002-09-28T09:00:00Z,MIAMI FL,0,0,5,7,12
Tropical Storm,Lili,27,2002-09-28T09:00:00Z,MTCA 183N 738W,8,0,0,1,9
Tropical Storm,Lili,27,2002-09-28T09:00:00Z,W PALM BEACH FL,0,0,2,7,9
Tropical Storm,Lili,27,2002-09-28T09:00:00Z,MKJP 179N 768W,52,0,0,0,52
Tropical Storm,Lili,27,2002-09-28T09:00:00Z,FT PIERCE FL,0,0,1,6,7
Tropical Storm,Lili,27,2002-09-28T09:00:00Z,MKJS 185N 779W,33,0,0,1,34
Tropical Storm,Lili,27,2002-09-28T09:00:00Z,COCOA BEACH FL,0,0,0,5,5
Tropical Storm,Lili,27,2002-09-28T09:00:00Z,MWCG 193N 814W,0,3,6,6,15
Tropical Storm,Lili,27,2002-09-28T09:00:00Z,DAYTONA BEACH FL,0,0,0,3,3
Tropical Storm,Lili,27,2002-09-28T09:00:00Z,MUGM 200N 751W,30,0,0,0,30
Tropical Storm,Lili,27,2002-09-28T09:00:00Z,KEY WEST FL,0,0,7,9,16
Tropical Storm,Lili,27,2002-09-28T09:00:00Z,MUCM 214N 779W,16,14,1,0,31
Tropical Storm,Lili,27,2002-09-28T09:00:00Z,MARCO ISLAND FL,0,0,2,10,12
Tropical Storm,Lili,27,2002-09-28T09:00:00Z,MUCF 221N 805W,0,11,7,4,22
Tropical Storm,Lili,27,2002-09-28T09:00:00Z,FT MYERS FL,0,0,1,9,10
Tropical Storm,Lili,27,2002-09-28T09:00:00Z,MUSN 216N 826W,0,1,7,9,17
Tropical Storm,Lili,27,2002-09-28T09:00:00Z,VENICE FL,0,0,0,9,9
Tropical Storm,Lili,27,2002-09-28T09:00:00Z,MUHA 230N 824W,0,0,8,9,17
Tropical Storm,Lili,27,2002-09-28T09:00:00Z,TAMPA FL,0,0,0,6,6
Tropical Storm,Lili,27,2002-09-28T09:00:00Z,MUAN 219N 850W,0,0,0,11,11
Tropical Storm,Lili,27,2002-09-28T09:00:00Z,CEDAR KEY FL,0,0,0,4,4
Tropical Storm,Lili,27,2002-09-28T09:00:00Z,MMCZ 205N 869W,0,0,0,5,5
Tropical Storm,Lili,27,2002-09-28T09:00:00Z,ST MARKS FL,0,0,0,2,2
Tropical Storm,Lili,27,2002-09-28T09:00:00Z,MYSM 241N 745W,0,0,1,2,3
Tropical Storm,Lili,27,2002-09-28T09:00:00Z,APALACHICOLA FL,0,0,0,2,2
Tropical Storm,Lili,27,2002-09-28T09:00:00Z,MYEG 235N 758W,0,3,4,3,10
Tropical Storm,Lili,27,2002-09-28T09:00:00Z,GULF 29N 85W,0,0,0,3,3
Tropical Storm,Lili,27,2002-09-28T09:00:00Z,MYAK 241N 776W,0,5,6,4,15
Tropical Storm,Lili,27,2002-09-28T09:00:00Z,GULF 29N 87W,0,0,0,2,2
Tropical Storm,Lili,27,2002-09-28T09:00:00Z,MYNN 251N 775W,0,1,5,4,10
Tropical Storm,Lili,28,2002-09-28T15:00:00Z,19.9N  77.3W,57,0,0,0,57
Tropical Storm,Lili,28,2002-09-28T15:00:00Z,MARATHON FL,0,1,10,6,17
Tropical Storm,Lili,28,2002-09-28T15:00:00Z,20.7N  78.3W,37,3,0,0,40
Tropical Storm,Lili,28,2002-09-28T15:00:00Z,MIAMI FL,0,0,6,7,13
Tropical Storm,Lili,28,2002-09-28T15:00:00Z,21.3N  79.7W,7,17,1,1,26
Tropical Storm,Lili,28,2002-09-28T15:00:00Z,W PALM BEACH FL,0,0,2,8,10
Tropical Storm,Lili,28,2002-09-28T15:00:00Z,MTCA 183N 738W,10,0,0,1,11
Tropical Storm,Lili,28,2002-09-28T15:00:00Z,FT PIERCE FL,0,0,1,7,8
Tropical Storm,Lili,28,2002-09-28T15:00:00Z,MKJP 179N 768W,45,0,0,0,45
Tropical Storm,Lili,28,2002-09-28T15:00:00Z,COCOA BEACH FL,0,0,0,6,6
Tropical Storm,Lili,28,2002-09-28T15:00:00Z,MKJS 185N 779W,37,0,0,0,37
Tropical Storm,Lili,28,2002-09-28T15:00:00Z,DAYTONA BEACH FL,0,0,0,4,4
Tropical Storm,Lili,28,2002-09-28T15:00:00Z,MWCG 193N 814W,0,4,6,5,15
Tropical Storm,Lili,28,2002-09-28T15:00:00Z,JACKSONVILLE FL,0,0,0,2,2
Tropical Storm,Lili,28,2002-09-28T15:00:00Z,MUGM 200N 751W,36,0,0,0,36
Tropical Storm,Lili,28,2002-09-28T15:00:00Z,KEY WEST FL,0,1,9,8,18
Tropical Storm,Lili,28,2002-09-28T15:00:00Z,MUCM 214N 779W,28,5,1,0,34
Tropical Storm,Lili,28,2002-09-28T15:00:00Z,MARCO ISLAND FL,0,0,4,10,14
Tropical Storm,Lili,28,2002-09-28T15:00:00Z,MUCF 221N 805W,0,15,7,2,24
Tropical Storm,Lili,28,2002-09-28T15:00:00Z,FT MYERS FL,0,0,2,10,12
Tropical Storm,Lili,28,2002-09-28T15:00:00Z,MUSN 216N 826W,0,1,10,7,18
Tropical Storm,Lili,28,2002-09-28T15:00:00Z,VENICE FL,0,0,1,9,10
Tropical Storm,Lili,28,2002-09-28T15:00:00Z,MUHA 230N 824W,0,1,11,7,19
Tropical Storm,Lili,28,2002-09-28T15:00:00Z,TAMPA FL,0,0,0,8,8
Tropical Storm,Lili,28,2002-09-28T15:00:00Z,MUAN 219N 850W,0,0,1,11,12
Tropical Storm,Lili,28,2002-09-28T15:00:00Z,CEDAR KEY FL,0,0,0,5,5
Tropical Storm,Lili,28,2002-09-28T15:00:00Z,MMCZ 205N 869W,0,0,0,5,5
Tropical Storm,Lili,28,2002-09-28T15:00:00Z,ST MARKS FL,0,0,0,3,3
Tropical Storm,Lili,28,2002-09-28T15:00:00Z,MYSM 241N 745W,0,0,1,1,2
Tropical Storm,Lili,28,2002-09-28T15:00:00Z,APALACHICOLA FL,0,0,0,3,3
Tropical Storm,Lili,28,2002-09-28T15:00:00Z,MYEG 235N 758W,0,3,3,2,8
Tropical Storm,Lili,28,2002-09-28T15:00:00Z,PANAMA CITY FL,0,0,0,2,2
Tropical Storm,Lili,28,2002-09-28T15:00:00Z,MYAK 241N 776W,0,6,5,3,14
Tropical Storm,Lili,28,2002-09-28T15:00:00Z,GULF 29N 85W,0,0,0,5,5
Tropical Storm,Lili,28,2002-09-28T15:00:00Z,MYNN 251N 775W,0,1,5,4,10
Tropical Storm,Lili,28,2002-09-28T15:00:00Z,GULF 29N 87W,0,0,0,3,3
Tropical Storm,Lili,28,2002-09-28T15:00:00Z,MYGF 266N 787W,0,0,2,6,8
Tropical Storm,Lili,28,2002-09-28T15:00:00Z,GULF 28N 89W,0,0,0,2,2
Tropical Storm,Lili,29,2002-09-28T21:00:00Z,20.2N  77.7W,53,0,0,0,53
Tropical Storm,Lili,29,2002-09-28T21:00:00Z,MIAMI FL,0,1,7,6,14
Tropical Storm,Lili,29,2002-09-28T21:00:00Z,21.0N  79.0W,31,6,0,0,37
Tropical Storm,Lili,29,2002-09-28T21:00:00Z,W PALM BEACH FL,0,0,3,7,10
Tropical Storm,Lili,29,2002-09-28T21:00:00Z,21.5N  80.5W,4,21,3,0,28
Tropical Storm,Lili,29,2002-09-28T21:00:00Z,FT PIERCE FL,0,0,1,6,7
Tropical Storm,Lili,29,2002-09-28T21:00:00Z,MKJP 179N 768W,40,0,0,0,40
Tropical Storm,Lili,29,2002-09-28T21:00:00Z,COCOA BEACH FL,0,0,0,5,5
Tropical Storm,Lili,29,2002-09-28T21:00:00Z,MKJS 185N 779W,29,0,0,0,29
Tropical Storm,Lili,29,2002-09-28T21:00:00Z,DAYTONA BEACH FL,0,0,0,4,4
Tropical Storm,Lili,29,2002-09-28T21:00:00Z,MWCG 193N 814W,1,7,5,3,16
Tropical Storm,Lili,29,2002-09-28T21:00:00Z,JACKSONVILLE FL,0,0,0,2,2
Tropical Storm,Lili,29,2002-09-28T21:00:00Z,MUGM 200N 751W,54,0,0,0,54
Tropical Storm,Lili,29,2002-09-28T21:00:00Z,KEY WEST FL,0,2,13,5,20
Tropical Storm,Lili,29,2002-09-28T21:00:00Z,MUCM 214N 779W,36,1,1,0,38
Tropical Storm,Lili,29,2002-09-28T21:00:00Z,MARCO ISLAND FL,0,0,6,9,15
Tropical Storm,Lili,29,2002-09-28T21:00:00Z,MUCF 221N 805W,2,22,3,1,28
Tropical Storm,Lili,29,2002-09-28T21:00:00Z,FT MYERS FL,0,0,3,10,13
Tropical Storm,Lili,29,2002-09-28T21:00:00Z,MUSN 216N 826W,0,5,12,4,21
Tropical Storm,Lili,29,2002-09-28T21:00:00Z,VENICE FL,0,0,1,10,11
Tropical Storm,Lili,29,2002-09-28T21:00:00Z,MUHA 230N 824W,0,4,14,4,22
Tropical Storm,Lili,29,2002-09-28T21:00:00Z,TAMPA FL,0,0,0,8,8
Tropical Storm,Lili,29,2002-09-28T21:00:00Z,MUAN 219N 850W,0,0,3,12,15
Tropical Storm,Lili,29,2002-09-28T21:00:00Z,CEDAR KEY FL,0,0,0,5,5
Tropical Storm,Lili,29,2002-09-28T21:00:00Z,MMCZ 205N 869W,0,0,0,7,7
Tropical Storm,Lili,29,2002-09-28T21:00:00Z,ST MARKS FL,0,0,0,3,3
Tropical Storm,Lili,29,2002-09-28T21:00:00Z,MYEG 235N 758W,1,2,2,1,6
Tropical Storm,Lili,29,2002-09-28T21:00:00Z,APALACHICOLA FL,0,0,0,4,4
Tropical Storm,Lili,29,2002-09-28T21:00:00Z,MYAK 241N 776W,0,8,4,1,13
Tropical Storm,Lili,29,2002-09-28T21:00:00Z,PANAMA CITY FL,0,0,0,3,3
Tropical Storm,Lili,29,2002-09-28T21:00:00Z,MYNN 251N 775W,0,2,3,3,8
Tropical Storm,Lili,29,2002-09-28T21:00:00Z,GULF 29N 85W,0,0,0,5,5
Tropical Storm,Lili,29,2002-09-28T21:00:00Z,MYGF 266N 787W,0,0,2,5,7
Tropical Storm,Lili,29,2002-09-28T21:00:00Z,GULF 29N 87W,0,0,0,3,3
Tropical Storm,Lili,29,2002-09-28T21:00:00Z,MMMD 210N 897W,0,0,0,2,2
Tropical Storm,Lili,29,2002-09-28T21:00:00Z,GULF 28N 89W,0,0,0,2,2
Tropical Storm,Lili,29,2002-09-28T21:00:00Z,MARATHON FL,0,3,12,4,19
Tropical Storm,Lili,30,2002-09-29T03:00:00Z,20.6N  78.2W,54,0,0,0,54
Tropical Storm,Lili,30,2002-09-29T03:00:00Z,FT PIERCE FL,0,0,2,6,8
Tropical Storm,Lili,30,2002-09-29T03:00:00Z,21.6N  79.7W,27,9,0,0,36
Tropical Storm,Lili,30,2002-09-29T03:00:00Z,COCOA BEACH FL,0,0,1,5,6
Tropical Storm,Lili,30,2002-09-29T03:00:00Z,22.4N  81.4W,1,23,3,1,28
Tropical Storm,Lili,30,2002-09-29T03:00:00Z,DAYTONA BEACH FL,0,0,0,4,4
Tropical Storm,Lili,30,2002-09-29T03:00:00Z,MKJP 179N 768W,19,0,1,0,20
Tropical Storm,Lili,30,2002-09-29T03:00:00Z,JACKSONVILLE FL,0,0,0,2,2
Tropical Storm,Lili,30,2002-09-29T03:00:00Z,MKJS 185N 779W,31,0,0,1,32
Tropical Storm,Lili,30,2002-09-29T03:00:00Z,KEY WEST FL,0,9,11,3,23
Tropical Storm,Lili,30,2002-09-29T03:00:00Z,MWCG 193N 814W,1,8,2,2,13
Tropical Storm,Lili,30,2002-09-29T03:00:00Z,MARCO ISLAND FL,0,1,10,6,17
Tropical Storm,Lili,30,2002-09-29T03:00:00Z,MUGM 200N 751W,44,0,0,0,44
Tropical Storm,Lili,30,2002-09-29T03:00:00Z,FT MYERS FL,0,0,8,7,15
Tropical Storm,Lili,30,2002-09-29T03:00:00Z,MUCM 214N 779W,46,0,0,0,46
Tropical Storm,Lili,30,2002-09-29T03:00:00Z,VENICE FL,0,0,4,9,13
Tropical Storm,Lili,30,2002-09-29T03:00:00Z,MUCF 221N 805W,9,22,1,0,32
Tropical Storm,Lili,30,2002-09-29T03:00:00Z,TAMPA FL,0,0,1,9,10
Tropical Storm,Lili,30,2002-09-29T03:00:00Z,MUSN 216N 826W,0,11,8,3,22
Tropical Storm,Lili,30,2002-09-29T03:00:00Z,CEDAR KEY FL,0,0,0,7,7
Tropical Storm,Lili,30,2002-09-29T03:00:00Z,MUHA 230N 824W,0,13,10,2,25
Tropical Storm,Lili,30,2002-09-29T03:00:00Z,ST MARKS FL,0,0,0,4,4
Tropical Storm,Lili,30,2002-09-29T03:00:00Z,MUAN 219N 850W,0,0,7,9,16
Tropical Storm,Lili,30,2002-09-29T03:00:00Z,APALACHICOLA FL,0,0,0,6,6
Tropical Storm,Lili,30,2002-09-29T03:00:00Z,MMCZ 205N 869W,0,0,0,7,7
Tropical Storm,Lili,30,2002-09-29T03:00:00Z,PANAMA CITY FL,0,0,0,5,5
Tropical Storm,Lili,30,2002-09-29T03:00:00Z,MYEG 235N 758W,1,2,1,0,4
Tropical Storm,Lili,30,2002-09-29T03:00:00Z,PENSACOLA FL,0,0,0,3,3
Tropical Storm,Lili,30,2002-09-29T03:00:00Z,MYAK 241N 776W,2,9,2,1,14
Tropical Storm,Lili,30,2002-09-29T03:00:00Z,MOBILE AL,0,0,0,2,2
Tropical Storm,Lili,30,2002-09-29T03:00:00Z,MYNN 251N 775W,0,3,3,2,8
Tropical Storm,Lili,30,2002-09-29T03:00:00Z,BURAS LA,0,0,0,2,2
Tropical Storm,Lili,30,2002-09-29T03:00:00Z,MYGF 266N 787W,0,0,3,4,7
Tropical Storm,Lili,30,2002-09-29T03:00:00Z,GULF 29N 85W,0,0,0,8,8
Tropical Storm,Lili,30,2002-09-29T03:00:00Z,MMMD 210N 897W,0,0,0,3,3
Tropical Storm,Lili,30,2002-09-29T03:00:00Z,GULF 29N 87W,0,0,0,6,6
Tropical Storm,Lili,30,2002-09-29T03:00:00Z,MARATHON FL,0,10,10,2,22
Tropical Storm,Lili,30,2002-09-29T03:00:00Z,GULF 28N 89W,0,0,0,5,5
Tropical Storm,Lili,30,2002-09-29T03:00:00Z,MIAMI FL,0,3,9,3,15
Tropical Storm,Lili,30,2002-09-29T03:00:00Z,GULF 28N 91W,0,0,0,2,2
Tropical Storm,Lili,30,2002-09-29T03:00:00Z,W PALM BEACH FL,0,1,5,5,11
Tropical Storm,Lili,31,2002-09-29T09:00:00Z,20.6N  79.3W,54,0,0,0,54
Tropical Storm,Lili,31,2002-09-29T09:00:00Z,DAYTONA BEACH FL,0,0,0,3,3
Tropical Storm,Lili,31,2002-09-29T09:00:00Z,21.6N  80.7W,27,10,1,0,38
Tropical Storm,Lili,31,2002-09-29T09:00:00Z,JACKSONVILLE FL,0,0,0,2,2
Tropical Storm,Lili,31,2002-09-29T09:00:00Z,22.4N  82.3W,1,25,3,1,30
Tropical Storm,Lili,31,2002-09-29T09:00:00Z,KEY WEST FL,0,13,8,2,23
Tropical Storm,Lili,31,2002-09-29T09:00:00Z,MKJP 179N 768W,99,0,0,0,99
Tropical Storm,Lili,31,2002-09-29T09:00:00Z,MARCO ISLAND FL,0,1,9,5,15
Tropical Storm,Lili,31,2002-09-29T09:00:00Z,MKJS 185N 779W,99,0,0,0,99
Tropical Storm,Lili,31,2002-09-29T09:00:00Z,FT MYERS FL,0,0,6,7,13
Tropical Storm,Lili,31,2002-09-29T09:00:00Z,MWCG 193N 814W,7,6,1,1,15
Tropical Storm,Lili,31,2002-09-29T09:00:00Z,VENICE FL,0,0,4,9,13
Tropical Storm,Lili,31,2002-09-29T09:00:00Z,MUCM 214N 779W,40,0,0,0,40
Tropical Storm,Lili,31,2002-09-29T09:00:00Z,TAMPA FL,0,0,1,8,9
Tropical Storm,Lili,31,2002-09-29T09:00:00Z,MUCF 221N 805W,23,14,0,0,37
Tropical Storm,Lili,31,2002-09-29T09:00:00Z,CEDAR KEY FL,0,0,0,7,7
Tropical Storm,Lili,31,2002-09-29T09:00:00Z,MUSN 216N 826W,1,20,3,1,25
Tropical Storm,Lili,31,2002-09-29T09:00:00Z,ST MARKS FL,0,0,0,5,5
Tropical Storm,Lili,31,2002-09-29T09:00:00Z,MUHA 230N 824W,0,23,5,1,29
Tropical Storm,Lili,31,2002-09-29T09:00:00Z,APALACHICOLA FL,0,0,0,7,7
Tropical Storm,Lili,31,2002-09-29T09:00:00Z,MUAN 219N 850W,0,2,10,6,18
Tropical Storm,Lili,31,2002-09-29T09:00:00Z,PANAMA CITY FL,0,0,0,7,7
Tropical Storm,Lili,31,2002-09-29T09:00:00Z,MMCZ 205N 869W,0,0,1,8,9
Tropical Storm,Lili,31,2002-09-29T09:00:00Z,PENSACOLA FL,0,0,0,5,5
Tropical Storm,Lili,31,2002-09-29T09:00:00Z,MYAK 241N 776W,0,3,1,1,5
Tropical Storm,Lili,31,2002-09-29T09:00:00Z,MOBILE AL,0,0,0,4,4
Tropical Storm,Lili,31,2002-09-29T09:00:00Z,MYNN 251N 775W,0,0,1,1,2
Tropical Storm,Lili,31,2002-09-29T09:00:00Z,GULFPORT MS,0,0,0,4,4
Tropical Storm,Lili,31,2002-09-29T09:00:00Z,MYGF 266N 787W,0,0,1,2,3
Tropical Storm,Lili,31,2002-09-29T09:00:00Z,BURAS LA,0,0,0,5,5
Tropical Storm,Lili,31,2002-09-29T09:00:00Z,MMMD 210N 897W,0,0,0,4,4
Tropical Storm,Lili,31,2002-09-29T09:00:00Z,NEW ORLEANS LA,0,0,0,3,3
Tropical Storm,Lili,31,2002-09-29T09:00:00Z,MARATHON FL,0,11,7,2,20
Tropical Storm,Lili,31,2002-09-29T09:00:00Z,GULF 29N 85W,0,0,0,9,9
Tropical Storm,Lili,31,2002-09-29T09:00:00Z,MIAMI FL,0,1,7,3,11
Tropical Storm,Lili,31,2002-09-29T09:00:00Z,GULF 29N 87W,0,0,0,9,9
Tropical Storm,Lili,31,2002-09-29T09:00:00Z,W PALM BEACH FL,0,0,2,5,7
Tropical Storm,Lili,31,2002-09-29T09:00:00Z,GULF 28N 89W,0,0,0,8,8
Tropical Storm,Lili,31,2002-09-29T09:00:00Z,FT PIERCE FL,0,0,1,4,5
Tropical Storm,Lili,31,2002-09-29T09:00:00Z,GULF 28N 91W,0,0,0,4,4
Tropical Storm,Lili,31,2002-09-29T09:00:00Z,COCOA BEACH FL,0,0,0,4,4
Tropical Storm,Lili,32,2002-09-29T15:00:00Z,20.2N  80.0W,50,0,0,0,50
Tropical Storm,Lili,32,2002-09-29T15:00:00Z,MARCO ISLAND FL,0,1,6,4,11
Tropical Storm,Lili,32,2002-09-29T15:00:00Z,21.2N  81.8W,19,16,0,1,36
Tropical Storm,Lili,32,2002-09-29T15:00:00Z,FT MYERS FL,0,0,4,5,9
Tropical Storm,Lili,32,2002-09-29T15:00:00Z,22.4N  83.8W,0,19,9,1,29
Tropical Storm,Lili,32,2002-09-29T15:00:00Z,VENICE FL,0,0,3,6,9
Tropical Storm,Lili,32,2002-09-29T15:00:00Z,MKJP 179N 768W,99,0,0,0,99
Tropical Storm,Lili,32,2002-09-29T15:00:00Z,TAMPA FL,0,0,1,5,6
Tropical Storm,Lili,32,2002-09-29T15:00:00Z,MKJS 185N 779W,99,0,0,0,99
Tropical Storm,Lili,32,2002-09-29T15:00:00Z,CEDAR KEY FL,0,0,0,4,4
Tropical Storm,Lili,32,2002-09-29T15:00:00Z,MWCG 193N 814W,26,2,0,0,28
Tropical Storm,Lili,32,2002-09-29T15:00:00Z,ST MARKS FL,0,0,0,3,3
Tropical Storm,Lili,32,2002-09-29T15:00:00Z,MUCM 214N 779W,25,0,0,0,25
Tropical Storm,Lili,32,2002-09-29T15:00:00Z,APALACHICOLA FL,0,0,0,6,6
Tropical Storm,Lili,32,2002-09-29T15:00:00Z,MUCF 221N 805W,24,8,0,0,32
Tropical Storm,Lili,32,2002-09-29T15:00:00Z,PANAMA CITY FL,0,0,0,6,6
Tropical Storm,Lili,32,2002-09-29T15:00:00Z,MUSN 216N 826W,4,27,1,0,32
Tropical Storm,Lili,32,2002-09-29T15:00:00Z,PENSACOLA FL,0,0,0,5,5
Tropical Storm,Lili,32,2002-09-29T15:00:00Z,MUHA 230N 824W,1,23,4,0,28
Tropical Storm,Lili,32,2002-09-29T15:00:00Z,MOBILE AL,0,0,0,5,5
Tropical Storm,Lili,32,2002-09-29T15:00:00Z,MUAN 219N 850W,0,8,14,2,24
Tropical Storm,Lili,32,2002-09-29T15:00:00Z,GULFPORT MS,0,0,0,5,5
Tropical Storm,Lili,32,2002-09-29T15:00:00Z,MMCZ 205N 869W,0,0,7,6,13
Tropical Storm,Lili,32,2002-09-29T15:00:00Z,BURAS LA,0,0,0,7,7
Tropical Storm,Lili,32,2002-09-29T15:00:00Z,MMMD 210N 897W,0,0,0,7,7
Tropical Storm,Lili,32,2002-09-29T15:00:00Z,NEW ORLEANS LA,0,0,0,5,5
Tropical Storm,Lili,32,2002-09-29T15:00:00Z,MARATHON FL,0,7,7,1,15
Tropical Storm,Lili,32,2002-09-29T15:00:00Z,NEW IBERIA LA,0,0,0,3,3
Tropical Storm,Lili,32,2002-09-29T15:00:00Z,MIAMI FL,0,1,3,2,6
Tropical Storm,Lili,32,2002-09-29T15:00:00Z,GULF 29N 85W,0,0,0,8,8
Tropical Storm,Lili,32,2002-09-29T15:00:00Z,W PALM BEACH FL,0,0,1,2,3
Tropical Storm,Lili,32,2002-09-29T15:00:00Z,GULF 29N 87W,0,0,0,10,10
Tropical Storm,Lili,32,2002-09-29T15:00:00Z,FT PIERCE FL,0,0,0,2,2
Tropical Storm,Lili,32,2002-09-29T15:00:00Z,GULF 28N 89W,0,0,0,12,12
Tropical Storm,Lili,32,2002-09-29T15:00:00Z,COCOA BEACH FL,0,0,0,2,2
Tropical Storm,Lili,32,2002-09-29T15:00:00Z,GULF 28N 91W,0,0,0,8,8
Tropical Storm,Lili,32,2002-09-29T15:00:00Z,KEY WEST FL,0,9,8,2,19
Tropical Storm,Lili,32,2002-09-29T15:00:00Z,GULF 28N 93W,0,0,0,4,4
Tropical Storm,Lili,33,2002-09-29T21:00:00Z,20.5N  80.6W,53,0,0,0,53
Tropical Storm,Lili,33,2002-09-29T21:00:00Z,CEDAR KEY FL,0,0,0,4,4
Tropical Storm,Lili,33,2002-09-29T21:00:00Z,21.7N  82.5W,16,24,0,0,40
Tropical Storm,Lili,33,2002-09-29T21:00:00Z,ST MARKS FL,0,0,0,4,4
Tropical Storm,Lili,33,2002-09-29T21:00:00Z,22.8N  84.7W,0,20,11,1,32
Tropical Storm,Lili,33,2002-09-29T21:00:00Z,APALACHICOLA FL,0,0,0,7,7
Tropical Storm,Lili,33,2002-09-29T21:00:00Z,MKJS 185N 779W,99,0,0,0,99
Tropical Storm,Lili,33,2002-09-29T21:00:00Z,PANAMA CITY FL,0,0,0,7,7
Tropical Storm,Lili,33,2002-09-29T21:00:00Z,MWCG 193N 814W,33,1,0,0,34
Tropical Storm,Lili,33,2002-09-29T21:00:00Z,PENSACOLA FL,0,0,0,8,8
Tropical Storm,Lili,33,2002-09-29T21:00:00Z,MUCM 214N 779W,23,0,0,0,23
Tropical Storm,Lili,33,2002-09-29T21:00:00Z,MOBILE AL,0,0,0,8,8
Tropical Storm,Lili,33,2002-09-29T21:00:00Z,MUCF 221N 805W,34,3,0,0,37
Tropical Storm,Lili,33,2002-09-29T21:00:00Z,GULFPORT MS,0,0,0,10,10
Tropical Storm,Lili,33,2002-09-29T21:00:00Z,MUSN 216N 826W,15,25,0,0,40
Tropical Storm,Lili,33,2002-09-29T21:00:00Z,BURAS LA,0,0,0,12,12
Tropical Storm,Lili,33,2002-09-29T21:00:00Z,MUHA 230N 824W,4,30,0,0,34
Tropical Storm,Lili,33,2002-09-29T21:00:00Z,NEW ORLEANS LA,0,0,0,10,10
Tropical Storm,Lili,33,2002-09-29T21:00:00Z,MUAN 219N 850W,0,18,10,1,29
Tropical Storm,Lili,33,2002-09-29T21:00:00Z,NEW IBERIA LA,0,0,0,8,8
Tropical Storm,Lili,33,2002-09-29T21:00:00Z,MMCZ 205N 869W,0,1,9,4,14
Tropical Storm,Lili,33,2002-09-29T21:00:00Z,PORT ARTHUR TX,0,0,0,3,3
Tropical Storm,Lili,33,2002-09-29T21:00:00Z,MMMD 210N 897W,0,0,1,7,8
Tropical Storm,Lili,33,2002-09-29T21:00:00Z,GALVESTON TX,0,0,0,3,3
Tropical Storm,Lili,33,2002-09-29T21:00:00Z,MARATHON FL,0,11,3,0,14
Tropical Storm,Lili,33,2002-09-29T21:00:00Z,FREEPORT TX,0,0,0,2,2
Tropical Storm,Lili,33,2002-09-29T21:00:00Z,MIAMI FL,0,1,2,1,4
Tropical Storm,Lili,33,2002-09-29T21:00:00Z,GULF 29N 85W,0,0,1,8,9
Tropical Storm,Lili,33,2002-09-29T21:00:00Z,KEY WEST FL,0,15,4,0,19
Tropical Storm,Lili,33,2002-09-29T21:00:00Z,GULF 29N 87W,0,0,0,13,13
Tropical Storm,Lili,33,2002-09-29T21:00:00Z,MARCO ISLAND FL,0,2,5,2,9
Tropical Storm,Lili,33,2002-09-29T21:00:00Z,GULF 28N 89W,0,0,0,16,16
Tropical Storm,Lili,33,2002-09-29T21:00:00Z,FT MYERS FL,0,1,4,2,7
Tropical Storm,Lili,33,2002-09-29T21:00:00Z,GULF 28N 91W,0,0,0,13,13
Tropical Storm,Lili,33,2002-09-29T21:00:00Z,VENICE FL,0,0,4,4,8
Tropical Storm,Lili,33,2002-09-29T21:00:00Z,GULF 28N 93W,0,0,0,8,8
Tropical Storm,Lili,33,2002-09-29T21:00:00Z,TAMPA FL,0,0,1,4,5
Tropical Storm,Lili,33,2002-09-29T21:00:00Z,GULF 28N 95W,0,0,0,3,3
Tropical Storm,Lili,34,2002-09-30T03:00:00Z,21.2N  81.6W,51,0,1,0,52
Tropical Storm,Lili,34,2002-09-30T03:00:00Z,APALACHICOLA FL,0,0,0,6,6
Tropical Storm,Lili,34,2002-09-30T03:00:00Z,22.4N  84.0W,7,32,0,0,39
Tropical Storm,Lili,34,2002-09-30T03:00:00Z,PANAMA CITY FL,0,0,0,7,7
Tropical Storm,Lili,34,2002-09-30T03:00:00Z,23.9N  86.3W,0,16,15,0,31
Tropical Storm,Lili,34,2002-09-30T03:00:00Z,PENSACOLA FL,0,0,0,10,10
Tropical Storm,Lili,34,2002-09-30T03:00:00Z,MKJS 185N 779W,99,0,0,0,99
Tropical Storm,Lili,34,2002-09-30T03:00:00Z,MOBILE AL,0,0,0,11,11
Tropical Storm,Lili,34,2002-09-30T03:00:00Z,MWCG 193N 814W,31,0,0,0,31
Tropical Storm,Lili,34,2002-09-30T03:00:00Z,GULFPORT MS,0,0,0,13,13
Tropical Storm,Lili,34,2002-09-30T03:00:00Z,MUCM 214N 779W,16,0,0,0,16
Tropical Storm,Lili,34,2002-09-30T03:00:00Z,BURAS LA,0,0,0,16,16
Tropical Storm,Lili,34,2002-09-30T03:00:00Z,MUCF 221N 805W,43,1,0,0,44
Tropical Storm,Lili,34,2002-09-30T03:00:00Z,NEW ORLEANS LA,0,0,0,14,14
Tropical Storm,Lili,34,2002-09-30T03:00:00Z,MUSN 216N 826W,40,5,0,0,45
Tropical Storm,Lili,34,2002-09-30T03:00:00Z,NEW IBERIA LA,0,0,0,13,13
Tropical Storm,Lili,34,2002-09-30T03:00:00Z,MUHA 230N 824W,20,18,0,0,38
Tropical Storm,Lili,34,2002-09-30T03:00:00Z,PORT ARTHUR TX,0,0,0,8,8
Tropical Storm,Lili,34,2002-09-30T03:00:00Z,MUAN 219N 850W,1,30,1,0,32
Tropical Storm,Lili,34,2002-09-30T03:00:00Z,GALVESTON TX,0,0,0,7,7
Tropical Storm,Lili,34,2002-09-30T03:00:00Z,MMCZ 205N 869W,0,4,5,1,10
Tropical Storm,Lili,34,2002-09-30T03:00:00Z,FREEPORT TX,0,0,0,5,5
Tropical Storm,Lili,34,2002-09-30T03:00:00Z,MMMD 210N 897W,0,0,2,5,7
Tropical Storm,Lili,34,2002-09-30T03:00:00Z,PORT O CONNOR TX,0,0,0,3,3
Tropical Storm,Lili,34,2002-09-30T03:00:00Z,MARATHON FL,1,7,2,0,10
Tropical Storm,Lili,34,2002-09-30T03:00:00Z,GULF 29N 85W,0,0,1,7,8
Tropical Storm,Lili,34,2002-09-30T03:00:00Z,KEY WEST FL,1,15,1,0,17
Tropical Storm,Lili,34,2002-09-30T03:00:00Z,GULF 29N 87W,0,0,2,12,14
Tropical Storm,Lili,34,2002-09-30T03:00:00Z,MARCO ISLAND FL,0,2,2,1,5
Tropical Storm,Lili,34,2002-09-30T03:00:00Z,GULF 28N 89W,0,0,3,16,19
Tropical Storm,Lili,34,2002-09-30T03:00:00Z,FT MYERS FL,0,1,1,2,4
Tropical Storm,Lili,34,2002-09-30T03:00:00Z,GULF 28N 91W,0,0,1,16,17
Tropical Storm,Lili,34,2002-09-30T03:00:00Z,VENICE FL,0,0,3,2,5
Tropical Storm,Lili,34,2002-09-30T03:00:00Z,GULF 28N 93W,0,0,0,13,13
Tropical Storm,Lili,34,2002-09-30T03:00:00Z,TAMPA FL,0,0,1,2,3
Tropical Storm,Lili,34,2002-09-30T03:00:00Z,GULF 28N 95W,0,0,0,7,7
Tropical Storm,Lili,34,2002-09-30T03:00:00Z,CEDAR KEY FL,0,0,0,2,2
Tropical Storm,Lili,34,2002-09-30T03:00:00Z,GULF 27N 96W,0,0,0,3,3
Tropical Storm,Lili,34,2002-09-30T03:00:00Z,ST MARKS FL,0,0,0,3,3
Tropical Storm,Lili,34,2002-09-30T03:00:00Z,GULF 25N 96W,0,0,0,2,2
Tropical Storm,Lili,35,2002-09-30T09:00:00Z,21.3N  82.3W,51,0,0,0,51
Tropical Storm,Lili,35,2002-09-30T09:00:00Z,PENSACOLA FL,0,0,0,10,10
Tropical Storm,Lili,35,2002-09-30T09:00:00Z,22.5N  84.5W,9,30,0,0,39
Tropical Storm,Lili,35,2002-09-30T09:00:00Z,MOBILE AL,0,0,0,12,12
Tropical Storm,Lili,35,2002-09-30T09:00:00Z,24.0N  87.0W,0,13,19,0,32
Tropical Storm,Lili,35,2002-09-30T09:00:00Z,GULFPORT MS,0,0,0,15,15
Tropical Storm,Lili,35,2002-09-30T09:00:00Z,MKJS 185N 779W,99,0,0,0,99
Tropical Storm,Lili,35,2002-09-30T09:00:00Z,BURAS LA,0,0,1,17,18
Tropical Storm,Lili,35,2002-09-30T09:00:00Z,MWCG 193N 814W,32,0,0,0,32
Tropical Storm,Lili,35,2002-09-30T09:00:00Z,NEW ORLEANS LA,0,0,0,18,18
Tropical Storm,Lili,35,2002-09-30T09:00:00Z,MUCM 214N 779W,3,0,0,0,3
Tropical Storm,Lili,35,2002-09-30T09:00:00Z,NEW IBERIA LA,0,0,0,18,18
Tropical Storm,Lili,35,2002-09-30T09:00:00Z,MUCF 221N 805W,42,0,0,0,42
Tropical Storm,Lili,35,2002-09-30T09:00:00Z,PORT ARTHUR TX,0,0,0,14,14
Tropical Storm,Lili,35,2002-09-30T09:00:00Z,MUSN 216N 826W,48,0,0,0,48
Tropical Storm,Lili,35,2002-09-30T09:00:00Z,GALVESTON TX,0,0,0,12,12
Tropical Storm,Lili,35,2002-09-30T09:00:00Z,MUHA 230N 824W,28,8,0,0,36
Tropical Storm,Lili,35,2002-09-30T09:00:00Z,FREEPORT TX,0,0,0,10,10
Tropical Storm,Lili,35,2002-09-30T09:00:00Z,MUAN 219N 850W,7,27,1,0,35
Tropical Storm,Lili,35,2002-09-30T09:00:00Z,PORT O CONNOR TX,0,0,0,6,6
Tropical Storm,Lili,35,2002-09-30T09:00:00Z,MMCZ 205N 869W,0,7,6,1,14
Tropical Storm,Lili,35,2002-09-30T09:00:00Z,CORPUSCHRISTI TX,0,0,0,3,3
Tropical Storm,Lili,35,2002-09-30T09:00:00Z,MMMD 210N 897W,0,0,4,5,9
Tropical Storm,Lili,35,2002-09-30T09:00:00Z,BROWNSVILLE TX,0,0,0,2,2
Tropical Storm,Lili,35,2002-09-30T09:00:00Z,MARATHON FL,1,5,0,0,6
Tropical Storm,Lili,35,2002-09-30T09:00:00Z,GULF 29N 85W,0,0,2,4,6
Tropical Storm,Lili,35,2002-09-30T09:00:00Z,KEY WEST FL,2,11,1,0,14
Tropical Storm,Lili,35,2002-09-30T09:00:00Z,GULF 29N 87W,0,0,3,11,14
Tropical Storm,Lili,35,2002-09-30T09:00:00Z,MARCO ISLAND FL,0,2,1,0,3
Tropical Storm,Lili,35,2002-09-30T09:00:00Z,GULF 28N 89W,0,0,6,16,22
Tropical Storm,Lili,35,2002-09-30T09:00:00Z,FT MYERS FL,0,1,1,0,2
Tropical Storm,Lili,35,2002-09-30T09:00:00Z,GULF 28N 91W,0,0,1,20,21
Tropical Storm,Lili,35,2002-09-30T09:00:00Z,VENICE FL,0,0,2,0,2
Tropical Storm,Lili,35,2002-09-30T09:00:00Z,GULF 28N 93W,0,0,0,18,18
Tropical Storm,Lili,35,2002-09-30T09:00:00Z,ST MARKS FL,0,0,0,2,2
Tropical Storm,Lili,35,2002-09-30T09:00:00Z,GULF 28N 95W,0,0,0,11,11
Tropical Storm,Lili,35,2002-09-30T09:00:00Z,APALACHICOLA FL,0,0,1,4,5
Tropical Storm,Lili,35,2002-09-30T09:00:00Z,GULF 27N 96W,0,0,0,7,7
Tropical Storm,Lili,35,2002-09-30T09:00:00Z,PANAMA CITY FL,0,0,1,5,6
Tropical Storm,Lili,35,2002-09-30T09:00:00Z,GULF 25N 96W,0,0,0,4,4
Hurricane,Lili,36,2002-09-30T15:00:00Z,21.7N  83.5W,45,0,0,0,45
Hurricane,Lili,36,2002-09-30T15:00:00Z,APALACHICOLA FL,0,0,0,6,6
Hurricane,Lili,36,2002-09-30T15:00:00Z,23.0N  86.1W,2,28,0,0,30
Hurricane,Lili,36,2002-09-30T15:00:00Z,PANAMA CITY FL,0,0,0,7,7
Hurricane,Lili,36,2002-09-30T15:00:00Z,24.5N  88.5W,0,7,13,1,21
Hurricane,Lili,36,2002-09-30T15:00:00Z,PENSACOLA FL,0,0,0,8,8
Hurricane,Lili,36,2002-09-30T15:00:00Z,MWCG 193N 814W,39,0,0,0,39
Hurricane,Lili,36,2002-09-30T15:00:00Z,MOBILE AL,0,0,0,8,8
Hurricane,Lili,36,2002-09-30T15:00:00Z,MUCF 221N 805W,44,0,0,1,45
Hurricane,Lili,36,2002-09-30T15:00:00Z,GULFPORT MS,0,0,0,10,10
Hurricane,Lili,36,2002-09-30T15:00:00Z,MUSN 216N 826W,56,0,0,0,56
Hurricane,Lili,36,2002-09-30T15:00:00Z,BURAS LA,0,0,1,12,13
Hurricane,Lili,36,2002-09-30T15:00:00Z,MUHA 230N 824W,38,1,0,0,39
Hurricane,Lili,36,2002-09-30T15:00:00Z,NEW ORLEANS LA,0,0,0,12,12
Hurricane,Lili,36,2002-09-30T15:00:00Z,MUAN 219N 850W,24,9,0,0,33
Hurricane,Lili,36,2002-09-30T15:00:00Z,NEW IBERIA LA,0,0,0,13,13
Hurricane,Lili,36,2002-09-30T15:00:00Z,MMCZ 205N 869W,1,5,0,1,7
Hurricane,Lili,36,2002-09-30T15:00:00Z,PORT ARTHUR TX,0,0,0,12,12
Hurricane,Lili,36,2002-09-30T15:00:00Z,MMMD 210N 897W,0,1,1,1,3
Hurricane,Lili,36,2002-09-30T15:00:00Z,GALVESTON TX,0,0,0,12,12
Hurricane,Lili,36,2002-09-30T15:00:00Z,MARATHON FL,4,5,1,0,10
Hurricane,Lili,36,2002-09-30T15:00:00Z,FREEPORT TX,0,0,0,11,11
Hurricane,Lili,36,2002-09-30T15:00:00Z,MIAMI FL,0,1,1,1,3
Hurricane,Lili,36,2002-09-30T15:00:00Z,PORT O CONNOR TX,0,0,0,9,9
Hurricane,Lili,36,2002-09-30T15:00:00Z,W PALM BEACH FL,0,0,1,1,2
Hurricane,Lili,36,2002-09-30T15:00:00Z,CORPUSCHRISTI TX,0,0,0,7,7
Hurricane,Lili,36,2002-09-30T15:00:00Z,FT PIERCE FL,0,0,0,2,2
Hurricane,Lili,36,2002-09-30T15:00:00Z,BROWNSVILLE TX,0,0,0,4,4
Hurricane,Lili,36,2002-09-30T15:00:00Z,COCOA BEACH FL,0,0,0,2,2
Hurricane,Lili,36,2002-09-30T15:00:00Z,GULF 29N 85W,0,0,1,7,8
Hurricane,Lili,36,2002-09-30T15:00:00Z,KEY WEST FL,9,8,1,0,18
Hurricane,Lili,36,2002-09-30T15:00:00Z,GULF 29N 87W,0,0,2,10,12
Hurricane,Lili,36,2002-09-30T15:00:00Z,MARCO ISLAND FL,0,4,2,1,7
Hurricane,Lili,36,2002-09-30T15:00:00Z,GULF 28N 89W,0,0,5,11,16
Hurricane,Lili,36,2002-09-30T15:00:00Z,FT MYERS FL,0,2,2,2,6
Hurricane,Lili,36,2002-09-30T15:00:00Z,GULF 28N 91W,0,0,2,14,16
Hurricane,Lili,36,2002-09-30T15:00:00Z,VENICE FL,0,1,3,3,7
Hurricane,Lili,36,2002-09-30T15:00:00Z,GULF 28N 93W,0,0,1,13,14
Hurricane,Lili,36,2002-09-30T15:00:00Z,TAMPA FL,0,0,2,3,5
Hurricane,Lili,36,2002-09-30T15:00:00Z,GULF 28N 95W,0,0,0,11,11
Hurricane,Lili,36,2002-09-30T15:00:00Z,CEDAR KEY FL,0,0,1,3,4
Hurricane,Lili,36,2002-09-30T15:00:00Z,GULF 27N 96W,0,0,0,9,9
Hurricane,Lili,36,2002-09-30T15:00:00Z,ST MARKS FL,0,0,0,4,4
Hurricane,Lili,36,2002-09-30T15:00:00Z,GULF 25N 96W,0,0,0,5,5
Hurricane,Lili,37,2002-09-30T21:00:00Z,22.0N  84.0W,50,0,0,0,50
Hurricane,Lili,37,2002-09-30T21:00:00Z,PENSACOLA FL,0,0,0,6,6
Hurricane,Lili,37,2002-09-30T21:00:00Z,23.3N  86.4W,4,31,0,0,35
Hurricane,Lili,37,2002-09-30T21:00:00Z,MOBILE AL,0,0,0,7,7
Hurricane,Lili,37,2002-09-30T21:00:00Z,24.5N  89.0W,0,8,16,1,25
Hurricane,Lili,37,2002-09-30T21:00:00Z,GULFPORT MS,0,0,0,9,9
Hurricane,Lili,37,2002-09-30T21:00:00Z,MWCG 193N 814W,10,0,0,0,10
Hurricane,Lili,37,2002-09-30T21:00:00Z,BURAS LA,0,0,1,11,12
Hurricane,Lili,37,2002-09-30T21:00:00Z,MUCF 221N 805W,48,0,0,1,49
Hurricane,Lili,37,2002-09-30T21:00:00Z,NEW ORLEANS LA,0,0,0,11,11
Hurricane,Lili,37,2002-09-30T21:00:00Z,MUSN 216N 826W,65,0,0,0,65
Hurricane,Lili,37,2002-09-30T21:00:00Z,NEW IBERIA LA,0,0,0,12,12
Hurricane,Lili,37,2002-09-30T21:00:00Z,MUHA 230N 824W,46,0,0,0,46
Hurricane,Lili,37,2002-09-30T21:00:00Z,PORT ARTHUR TX,0,0,0,12,12
Hurricane,Lili,37,2002-09-30T21:00:00Z,MUAN 219N 850W,37,3,0,0,40
Hurricane,Lili,37,2002-09-30T21:00:00Z,GALVESTON TX,0,0,0,12,12
Hurricane,Lili,37,2002-09-30T21:00:00Z,MMCZ 205N 869W,2,5,0,1,8
Hurricane,Lili,37,2002-09-30T21:00:00Z,FREEPORT TX,0,0,0,12,12
Hurricane,Lili,37,2002-09-30T21:00:00Z,MMMD 210N 897W,0,1,1,1,3
Hurricane,Lili,37,2002-09-30T21:00:00Z,PORT O CONNOR TX,0,0,0,10,10
Hurricane,Lili,37,2002-09-30T21:00:00Z,MARATHON FL,3,2,0,0,5
Hurricane,Lili,37,2002-09-30T21:00:00Z,CORPUSCHRISTI TX,0,0,0,8,8
Hurricane,Lili,37,2002-09-30T21:00:00Z,KEY WEST FL,10,4,1,0,15
Hurricane,Lili,37,2002-09-30T21:00:00Z,BROWNSVILLE TX,0,0,0,6,6
Hurricane,Lili,37,2002-09-30T21:00:00Z,MARCO ISLAND FL,0,2,1,1,4
Hurricane,Lili,37,2002-09-30T21:00:00Z,GULF 29N 85W,0,0,1,5,6
Hurricane,Lili,37,2002-09-30T21:00:00Z,FT MYERS FL,0,1,1,1,3
Hurricane,Lili,37,2002-09-30T21:00:00Z,GULF 29N 87W,0,0,2,8,10
Hurricane,Lili,37,2002-09-30T21:00:00Z,VENICE FL,0,1,1,2,4
Hurricane,Lili,37,2002-09-30T21:00:00Z,GULF 28N 89W,0,0,6,10,16
Hurricane,Lili,37,2002-09-30T21:00:00Z,TAMPA FL,0,0,1,1,2
Hurricane,Lili,37,2002-09-30T21:00:00Z,GULF 28N 91W,0,0,3,14,17
Hurricane,Lili,37,2002-09-30T21:00:00Z,CEDAR KEY FL,0,0,0,2,2
Hurricane,Lili,37,2002-09-30T21:00:00Z,GULF 28N 93W,0,0,1,14,15
Hurricane,Lili,37,2002-09-30T21:00:00Z,ST MARKS FL,0,0,0,2,2
Hurricane,Lili,37,2002-09-30T21:00:00Z,GULF 28N 95W,0,0,0,13,13
Hurricane,Lili,37,2002-09-30T21:00:00Z,APALACHICOLA FL,0,0,0,4,4
Hurricane,Lili,37,2002-09-30T21:00:00Z,GULF 27N 96W,0,0,0,10,10
Hurricane,Lili,37,2002-09-30T21:00:00Z,PANAMA CITY FL,0,0,0,4,4
Hurricane,Lili,37,2002-09-30T21:00:00Z,GULF 25N 96W,0,0,0,7,7
Hurricane,Lili,38,2002-10-01T03:00:00Z,23.1N  85.8W,46,0,0,0,46
Hurricane,Lili,38,2002-10-01T03:00:00Z,GULFPORT MS,0,0,1,11,12
Hurricane,Lili,38,2002-10-01T03:00:00Z,24.5N  88.3W,4,23,1,0,28
Hurricane,Lili,38,2002-10-01T03:00:00Z,BURAS LA,0,0,5,10,15
Hurricane,Lili,38,2002-10-01T03:00:00Z,25.8N  90.8W,0,10,10,1,21
Hurricane,Lili,38,2002-10-01T03:00:00Z,NEW ORLEANS LA,0,0,2,12,14
Hurricane,Lili,38,2002-10-01T03:00:00Z,MUCF 221N 805W,31,0,0,0,31
Hurricane,Lili,38,2002-10-01T03:00:00Z,NEW IBERIA LA,0,0,2,13,15
Hurricane,Lili,38,2002-10-01T03:00:00Z,MUSN 216N 826W,82,0,0,0,82
Hurricane,Lili,38,2002-10-01T03:00:00Z,PORT ARTHUR TX,0,0,1,14,15
Hurricane,Lili,38,2002-10-01T03:00:00Z,MUHA 230N 824W,56,0,0,0,56
Hurricane,Lili,38,2002-10-01T03:00:00Z,GALVESTON TX,0,0,1,13,14
Hurricane,Lili,38,2002-10-01T03:00:00Z,MUAN 219N 850W,47,0,0,0,47
Hurricane,Lili,38,2002-10-01T03:00:00Z,FREEPORT TX,0,0,1,13,14
Hurricane,Lili,38,2002-10-01T03:00:00Z,MMCZ 205N 869W,2,0,0,0,2
Hurricane,Lili,38,2002-10-01T03:00:00Z,PORT O CONNOR TX,0,0,1,11,12
Hurricane,Lili,38,2002-10-01T03:00:00Z,KEY WEST FL,6,1,0,0,7
Hurricane,Lili,38,2002-10-01T03:00:00Z,CORPUSCHRISTI TX,0,0,1,7,8
Hurricane,Lili,38,2002-10-01T03:00:00Z,MARCO ISLAND FL,0,1,0,1,2
Hurricane,Lili,38,2002-10-01T03:00:00Z,BROWNSVILLE TX,0,0,1,4,5
Hurricane,Lili,38,2002-10-01T03:00:00Z,FT MYERS FL,0,1,0,1,2
Hurricane,Lili,38,2002-10-01T03:00:00Z,GULF 29N 85W,0,0,2,4,6
Hurricane,Lili,38,2002-10-01T03:00:00Z,VENICE FL,0,1,1,0,2
Hurricane,Lili,38,2002-10-01T03:00:00Z,GULF 29N 87W,0,0,5,6,11
Hurricane,Lili,38,2002-10-01T03:00:00Z,TAMPA FL,0,0,1,1,2
Hurricane,Lili,38,2002-10-01T03:00:00Z,GULF 28N 89W,0,2,12,4,18
Hurricane,Lili,38,2002-10-01T03:00:00Z,CEDAR KEY FL,0,0,0,2,2
Hurricane,Lili,38,2002-10-01T03:00:00Z,GULF 28N 91W,0,1,12,6,19
Hurricane,Lili,38,2002-10-01T03:00:00Z,ST MARKS FL,0,0,0,2,2
Hurricane,Lili,38,2002-10-01T03:00:00Z,GULF 28N 93W,0,0,9,8,17
Hurricane,Lili,38,2002-10-01T03:00:00Z,APALACHICOLA FL,0,0,1,3,4
Hurricane,Lili,38,2002-10-01T03:00:00Z,GULF 28N 95W,0,0,4,10,14
Hurricane,Lili,38,2002-10-01T03:00:00Z,PANAMA CITY FL,0,0,1,4,5
Hurricane,Lili,38,2002-10-01T03:00:00Z,GULF 27N 96W,0,0,3,8,11
Hurricane,Lili,38,2002-10-01T03:00:00Z,PENSACOLA FL,0,0,1,7,8
Hurricane,Lili,38,2002-10-01T03:00:00Z,GULF 25N 96W,0,0,2,4,6
Hurricane,Lili,38,2002-10-01T03:00:00Z,MOBILE AL,0,0,1,8,9
Hurricane,Lili,39,2002-10-01T09:00:00Z,23.4N  86.9W,45,0,0,0,45
Hurricane,Lili,39,2002-10-01T09:00:00Z,NEW IBERIA LA,0,0,5,12,17
Hurricane,Lili,39,2002-10-01T09:00:00Z,25.0N  89.5W,2,26,0,0,28
Hurricane,Lili,39,2002-10-01T09:00:00Z,PORT ARTHUR TX,0,0,3,13,16
Hurricane,Lili,39,2002-10-01T09:00:00Z,26.7N  91.7W,0,8,12,1,21
Hurricane,Lili,39,2002-10-01T09:00:00Z,GALVESTON TX,0,0,4,11,15
Hurricane,Lili,39,2002-10-01T09:00:00Z,MUCF 221N 805W,2,0,0,0,2
Hurricane,Lili,39,2002-10-01T09:00:00Z,FREEPORT TX,0,0,3,11,14
Hurricane,Lili,39,2002-10-01T09:00:00Z,MUSN 216N 826W,99,0,0,0,99
Hurricane,Lili,39,2002-10-01T09:00:00Z,PORT O CONNOR TX,0,0,2,9,11
Hurricane,Lili,39,2002-10-01T09:00:00Z,MUHA 230N 824W,48,0,0,0,48
Hurricane,Lili,39,2002-10-01T09:00:00Z,CORPUSCHRISTI TX,0,0,1,7,8
Hurricane,Lili,39,2002-10-01T09:00:00Z,MUAN 219N 850W,61,0,0,0,61
Hurricane,Lili,39,2002-10-01T09:00:00Z,BROWNSVILLE TX,0,0,1,3,4
Hurricane,Lili,39,2002-10-01T09:00:00Z,MMCZ 205N 869W,2,0,0,0,2
Hurricane,Lili,39,2002-10-01T09:00:00Z,GULF 29N 85W,0,1,2,2,5
Hurricane,Lili,39,2002-10-01T09:00:00Z,ST MARKS FL,0,0,1,2,3
Hurricane,Lili,39,2002-10-01T09:00:00Z,GULF 29N 87W,0,1,7,4,12
Hurricane,Lili,39,2002-10-01T09:00:00Z,APALACHICOLA FL,0,0,2,3,5
Hurricane,Lili,39,2002-10-01T09:00:00Z,GULF 28N 89W,0,7,11,1,19
Hurricane,Lili,39,2002-10-01T09:00:00Z,PANAMA CITY FL,0,0,2,4,6
Hurricane,Lili,39,2002-10-01T09:00:00Z,GULF 28N 91W,0,3,15,2,20
Hurricane,Lili,39,2002-10-01T09:00:00Z,PENSACOLA FL,0,0,2,8,10
Hurricane,Lili,39,2002-10-01T09:00:00Z,GULF 28N 93W,0,1,13,4,18
Hurricane,Lili,39,2002-10-01T09:00:00Z,MOBILE AL,0,0,3,9,12
Hurricane,Lili,39,2002-10-01T09:00:00Z,GULF 28N 95W,0,0,7,7,14
Hurricane,Lili,39,2002-10-01T09:00:00Z,GULFPORT MS,0,0,4,10,14
Hurricane,Lili,39,2002-10-01T09:00:00Z,GULF 27N 96W,0,0,5,5,10
Hurricane,Lili,39,2002-10-01T09:00:00Z,BURAS LA,0,0,11,5,16
Hurricane,Lili,39,2002-10-01T09:00:00Z,GULF 25N 96W,0,0,2,2,4
Hurricane,Lili,39,2002-10-01T09:00:00Z,NEW ORLEANS LA,0,0,7,9,16
Hurricane,Lili,40,2002-10-01T15:00:00Z,24.3N  88.2W,43,1,0,0,44
Hurricane,Lili,40,2002-10-01T15:00:00Z,PORT ARTHUR TX,0,0,12,6,18
Hurricane,Lili,40,2002-10-01T15:00:00Z,26.0N  90.5W,3,27,0,0,30
Hurricane,Lili,40,2002-10-01T15:00:00Z,GALVESTON TX,0,0,13,5,18
Hurricane,Lili,40,2002-10-01T15:00:00Z,28.1N  92.2W,0,10,13,0,23
Hurricane,Lili,40,2002-10-01T15:00:00Z,FREEPORT TX,0,0,12,5,17
Hurricane,Lili,40,2002-10-01T15:00:00Z,MUSN 216N 826W,99,0,0,0,99
Hurricane,Lili,40,2002-10-01T15:00:00Z,PORT O CONNOR TX,0,0,9,5,14
Hurricane,Lili,40,2002-10-01T15:00:00Z,MUHA 230N 824W,45,0,0,0,45
Hurricane,Lili,40,2002-10-01T15:00:00Z,CORPUSCHRISTI TX,0,0,5,5,10
Hurricane,Lili,40,2002-10-01T15:00:00Z,MUAN 219N 850W,76,0,0,0,76
Hurricane,Lili,40,2002-10-01T15:00:00Z,BROWNSVILLE TX,0,0,2,3,5
Hurricane,Lili,40,2002-10-01T15:00:00Z,ST MARKS FL,0,0,0,2,2
Hurricane,Lili,40,2002-10-01T15:00:00Z,GULF 29N 85W,0,0,1,2,3
Hurricane,Lili,40,2002-10-01T15:00:00Z,APALACHICOLA FL,0,0,0,3,3
Hurricane,Lili,40,2002-10-01T15:00:00Z,GULF 29N 87W,0,1,4,3,8
Hurricane,Lili,40,2002-10-01T15:00:00Z,PANAMA CITY FL,0,0,1,3,4
Hurricane,Lili,40,2002-10-01T15:00:00Z,GULF 28N 89W,0,11,7,1,19
Hurricane,Lili,40,2002-10-01T15:00:00Z,PENSACOLA FL,0,0,2,6,8
Hurricane,Lili,40,2002-10-01T15:00:00Z,GULF 28N 91W,0,13,10,1,24
Hurricane,Lili,40,2002-10-01T15:00:00Z,MOBILE AL,0,0,3,7,10
Hurricane,Lili,40,2002-10-01T15:00:00Z,GULF 28N 93W,0,8,14,1,23
Hurricane,Lili,40,2002-10-01T15:00:00Z,GULFPORT MS,0,0,6,7,13
Hurricane,Lili,40,2002-10-01T15:00:00Z,GULF 28N 95W,0,2,13,2,17
Hurricane,Lili,40,2002-10-01T15:00:00Z,BURAS LA,0,2,10,4,16
Hurricane,Lili,40,2002-10-01T15:00:00Z,GULF 27N 96W,0,1,9,2,12
Hurricane,Lili,40,2002-10-01T15:00:00Z,NEW ORLEANS LA,0,1,10,5,16
Hurricane,Lili,40,2002-10-01T15:00:00Z,GULF 25N 96W,0,1,2,2,5
Hurricane,Lili,40,2002-10-01T15:00:00Z,NEW IBERIA LA,0,1,13,4,18
Hurricane,Lili,41,2002-10-01T21:00:00Z,25.6N  89.5W,41,1,0,0,42
Hurricane,Lili,41,2002-10-01T21:00:00Z,GALVESTON TX,0,5,13,2,20
Hurricane,Lili,41,2002-10-01T21:00:00Z,27.4N  91.5W,3,26,0,0,29
Hurricane,Lili,41,2002-10-01T21:00:00Z,FREEPORT TX,0,4,12,2,18
Hurricane,Lili,41,2002-10-01T21:00:00Z,29.5N  93.0W,0,10,12,1,23
Hurricane,Lili,41,2002-10-01T21:00:00Z,PORT O CONNOR TX,0,2,9,2,13
Hurricane,Lili,41,2002-10-01T21:00:00Z,MUAN 219N 850W,99,0,0,0,99
Hurricane,Lili,41,2002-10-01T21:00:00Z,CORPUSCHRISTI TX,0,0,5,3,8
Hurricane,Lili,41,2002-10-01T21:00:00Z,ST MARKS FL,0,0,0,2,2
Hurricane,Lili,41,2002-10-01T21:00:00Z,BROWNSVILLE TX,0,0,2,1,3
Hurricane,Lili,41,2002-10-01T21:00:00Z,APALACHICOLA FL,0,0,0,2,2
Hurricane,Lili,41,2002-10-01T21:00:00Z,GULF 29N 85W,0,0,1,1,2
Hurricane,Lili,41,2002-10-01T21:00:00Z,PANAMA CITY FL,0,0,1,3,4
Hurricane,Lili,41,2002-10-01T21:00:00Z,GULF 29N 87W,0,3,2,3,8
Hurricane,Lili,41,2002-10-01T21:00:00Z,PENSACOLA FL,0,0,3,5,8
Hurricane,Lili,41,2002-10-01T21:00:00Z,GULF 28N 89W,5,15,1,0,21
Hurricane,Lili,41,2002-10-01T21:00:00Z,MOBILE AL,0,1,5,5,11
Hurricane,Lili,41,2002-10-01T21:00:00Z,GULF 28N 91W,2,24,1,0,27
Hurricane,Lili,41,2002-10-01T21:00:00Z,GULFPORT MS,0,2,8,3,13
Hurricane,Lili,41,2002-10-01T21:00:00Z,GULF 28N 93W,0,21,4,0,25
Hurricane,Lili,41,2002-10-01T21:00:00Z,BURAS LA,0,10,6,1,17
Hurricane,Lili,41,2002-10-01T21:00:00Z,GULF 28N 95W,0,8,9,1,18
Hurricane,Lili,41,2002-10-01T21:00:00Z,NEW ORLEANS LA,0,7,9,2,18
Hurricane,Lili,41,2002-10-01T21:00:00Z,GULF 27N 96W,0,3,7,1,11
Hurricane,Lili,41,2002-10-01T21:00:00Z,NEW IBERIA LA,0,8,12,1,21
Hurricane,Lili,41,2002-10-01T21:00:00Z,GULF 25N 96W,0,1,1,1,3
Hurricane,Lili,41,2002-10-01T21:00:00Z,PORT ARTHUR TX,0,4,15,2,21
Hurricane,Lili,42,2002-10-02T03:00:00Z,26.1N  90.7W,41,0,0,1,42
Hurricane,Lili,42,2002-10-02T03:00:00Z,PORT ARTHUR TX,0,10,12,1,23
Hurricane,Lili,42,2002-10-02T03:00:00Z,28.0N  92.2W,5,23,1,0,29
Hurricane,Lili,42,2002-10-02T03:00:00Z,GALVESTON TX,0,12,9,0,21
Hurricane,Lili,42,2002-10-02T03:00:00Z,30.5N  92.7W,0,7,14,1,22
Hurricane,Lili,42,2002-10-02T03:00:00Z,FREEPORT TX,0,10,8,0,18
Hurricane,Lili,42,2002-10-02T03:00:00Z,MUAN 219N 850W,4,0,0,0,4
Hurricane,Lili,42,2002-10-02T03:00:00Z,PORT O CONNOR TX,0,6,6,1,13
Hurricane,Lili,42,2002-10-02T03:00:00Z,ST MARKS FL,0,0,0,2,2
Hurricane,Lili,42,2002-10-02T03:00:00Z,CORPUSCHRISTI TX,0,2,3,1,6
Hurricane,Lili,42,2002-10-02T03:00:00Z,APALACHICOLA FL,0,0,0,3,3
Hurricane,Lili,42,2002-10-02T03:00:00Z,GULF 29N 85W,0,0,0,2,2
Hurricane,Lili,42,2002-10-02T03:00:00Z,PANAMA CITY FL,0,0,1,3,4
Hurricane,Lili,42,2002-10-02T03:00:00Z,GULF 29N 87W,0,1,3,3,7
Hurricane,Lili,42,2002-10-02T03:00:00Z,PENSACOLA FL,0,0,3,6,9
Hurricane,Lili,42,2002-10-02T03:00:00Z,GULF 28N 89W,8,9,1,0,18
Hurricane,Lili,42,2002-10-02T03:00:00Z,MOBILE AL,0,1,6,5,12
Hurricane,Lili,42,2002-10-02T03:00:00Z,GULF 28N 91W,9,18,1,0,28
Hurricane,Lili,42,2002-10-02T03:00:00Z,GULFPORT MS,0,2,9,3,14
Hurricane,Lili,42,2002-10-02T03:00:00Z,GULF 28N 93W,2,25,0,1,28
Hurricane,Lili,42,2002-10-02T03:00:00Z,BURAS LA,0,10,6,1,17
Hurricane,Lili,42,2002-10-02T03:00:00Z,GULF 28N 95W,0,15,3,1,19
Hurricane,Lili,42,2002-10-02T03:00:00Z,NEW ORLEANS LA,0,8,10,1,19
Hurricane,Lili,42,2002-10-02T03:00:00Z,GULF 27N 96W,0,7,2,1,10
Hurricane,Lili,42,2002-10-02T03:00:00Z,NEW IBERIA LA,0,12,10,1,23
Hurricane,Lili,43,2002-10-02T09:00:00Z,27.0N  91.5W,40,0,0,0,40
Hurricane,Lili,43,2002-10-02T09:00:00Z,PORT ARTHUR TX,0,22,2,1,25
Hurricane,Lili,43,2002-10-02T09:00:00Z,29.2N  92.5W,2,27,0,1,30
Hurricane,Lili,43,2002-10-02T09:00:00Z,GALVESTON TX,0,19,2,0,21
Hurricane,Lili,43,2002-10-02T09:00:00Z,31.5N  92.0W,0,11,11,1,23
Hurricane,Lili,43,2002-10-02T09:00:00Z,FREEPORT TX,0,15,2,0,17
Hurricane,Lili,43,2002-10-02T09:00:00Z,SAVANNAH GA,0,0,0,2,2
Hurricane,Lili,43,2002-10-02T09:00:00Z,PORT O CONNOR TX,0,7,2,1,10
Hurricane,Lili,43,2002-10-02T09:00:00Z,ST MARKS FL,0,0,0,3,3
Hurricane,Lili,43,2002-10-02T09:00:00Z,CORPUSCHRISTI TX,0,1,1,0,2
Hurricane,Lili,43,2002-10-02T09:00:00Z,APALACHICOLA FL,0,0,0,3,3
Hurricane,Lili,43,2002-10-02T09:00:00Z,GULF 29N 85W,0,0,0,2,2
Hurricane,Lili,43,2002-10-02T09:00:00Z,PANAMA CITY FL,0,0,1,4,5
Hurricane,Lili,43,2002-10-02T09:00:00Z,GULF 29N 87W,0,1,3,3,7
Hurricane,Lili,43,2002-10-02T09:00:00Z,PENSACOLA FL,0,1,4,6,11
Hurricane,Lili,43,2002-10-02T09:00:00Z,GULF 28N 89W,13,5,0,1,19
Hurricane,Lili,43,2002-10-02T09:00:00Z,MOBILE AL,0,2,8,4,14
Hurricane,Lili,43,2002-10-02T09:00:00Z,GULF 28N 91W,26,6,0,0,32
Hurricane,Lili,43,2002-10-02T09:00:00Z,GULFPORT MS,0,7,7,2,16
Hurricane,Lili,43,2002-10-02T09:00:00Z,GULF 28N 93W,16,15,0,0,31
Hurricane,Lili,43,2002-10-02T09:00:00Z,BURAS LA,2,13,3,0,18
Hurricane,Lili,43,2002-10-02T09:00:00Z,GULF 28N 95W,2,15,0,1,18
Hurricane,Lili,43,2002-10-02T09:00:00Z,NEW ORLEANS LA,0,17,3,1,21
Hurricane,Lili,43,2002-10-02T09:00:00Z,GULF 27N 96W,1,4,1,1,7
Hurricane,Lili,43,2002-10-02T09:00:00Z,NEW IBERIA LA,0,24,2,0,26
Hurricane,Lili,44,2002-10-02T15:00:00Z,28.1N  92.1W,37,1,0,0,38
Hurricane,Lili,44,2002-10-02T15:00:00Z,MOBILE AL,0,4,9,2,15
Hurricane,Lili,44,2002-10-02T15:00:00Z,30.4N  92.5W,9,20,1,0,30
Hurricane,Lili,44,2002-10-02T15:00:00Z,GULFPORT MS,1,9,7,1,18
Hurricane,Lili,44,2002-10-02T15:00:00Z,33.5N  91.0W,0,4,19,2,25
Hurricane,Lili,44,2002-10-02T15:00:00Z,BURAS LA,8,9,2,1,20
Hurricane,Lili,44,2002-10-02T15:00:00Z,SAVANNAH GA,0,0,0,3,3
Hurricane,Lili,44,2002-10-02T15:00:00Z,NEW ORLEANS LA,7,13,3,0,23
Hurricane,Lili,44,2002-10-02T15:00:00Z,CHARLESTON SC,0,0,0,3,3
Hurricane,Lili,44,2002-10-02T15:00:00Z,NEW IBERIA LA,14,15,0,0,29
Hurricane,Lili,44,2002-10-02T15:00:00Z,MYRTLE BEACH SC,0,0,0,3,3
Hurricane,Lili,44,2002-10-02T15:00:00Z,PORT ARTHUR TX,10,17,0,0,27
Hurricane,Lili,44,2002-10-02T15:00:00Z,WILMINGTON NC,0,0,0,2,2
Hurricane,Lili,44,2002-10-02T15:00:00Z,GALVESTON TX,10,12,0,0,22
Hurricane,Lili,44,2002-10-02T15:00:00Z,MOREHEAD CITY NC,0,0,0,2,2
Hurricane,Lili,44,2002-10-02T15:00:00Z,FREEPORT TX,6,11,0,0,17
Hurricane,Lili,44,2002-10-02T15:00:00Z,NORFOLK VA,0,0,0,3,3
Hurricane,Lili,44,2002-10-02T15:00:00Z,PORT O CONNOR TX,2,5,1,0,8
Hurricane,Lili,44,2002-10-02T15:00:00Z,OCEAN CITY MD,0,0,0,2,2
Hurricane,Lili,44,2002-10-02T15:00:00Z,GULF 29N 85W,0,0,0,2,2
Hurricane,Lili,44,2002-10-02T15:00:00Z,ATLANTIC CITY NJ,0,0,0,2,2
Hurricane,Lili,44,2002-10-02T15:00:00Z,GULF 29N 87W,0,1,3,1,5
Hurricane,Lili,44,2002-10-02T15:00:00Z,NEW YORK CITY NY,0,0,0,2,2
Hurricane,Lili,44,2002-10-02T15:00:00Z,GULF 28N 89W,15,2,0,0,17
Hurricane,Lili,44,2002-10-02T15:00:00Z,ST MARKS FL,0,0,0,2,2
Hurricane,Lili,44,2002-10-02T15:00:00Z,GULF 28N 91W,38,0,0,0,38
Hurricane,Lili,44,2002-10-02T15:00:00Z,APALACHICOLA FL,0,0,1,2,3
Hurricane,Lili,44,2002-10-02T15:00:00Z,GULF 28N 93W,33,1,0,0,34
Hurricane,Lili,44,2002-10-02T15:00:00Z,PANAMA CITY FL,0,0,1,3,4
Hurricane,Lili,44,2002-10-02T15:00:00Z,GULF 28N 95W,11,6,0,0,17
Hurricane,Lili,44,2002-10-02T15:00:00Z,PENSACOLA FL,0,1,5,4,10
Hurricane,Lili,44,2002-10-02T15:00:00Z,GULF 27N 96W,2,2,1,0,5
Hurricane,Lili,45,2002-10-02T18:00:00Z,28.1N  92.1W,37,1,0,0,38
Hurricane,Lili,45,2002-10-02T18:00:00Z,MOBILE AL,0,4,9,2,15
Hurricane,Lili,45,2002-10-02T18:00:00Z,30.4N  92.5W,9,20,1,0,30
Hurricane,Lili,45,2002-10-02T18:00:00Z,GULFPORT MS,1,9,7,1,18
Hurricane,Lili,45,2002-10-02T18:00:00Z,33.5N  91.0W,0,4,19,2,25
Hurricane,Lili,45,2002-10-02T18:00:00Z,BURAS LA,8,9,2,1,20
Hurricane,Lili,45,2002-10-02T18:00:00Z,SAVANNAH GA,0,0,0,3,3
Hurricane,Lili,45,2002-10-02T18:00:00Z,NEW ORLEANS LA,7,13,3,0,23
Hurricane,Lili,45,2002-10-02T18:00:00Z,CHARLESTON SC,0,0,0,3,3
Hurricane,Lili,45,2002-10-02T18:00:00Z,NEW IBERIA LA,14,15,0,0,29
Hurricane,Lili,45,2002-10-02T18:00:00Z,MYRTLE BEACH SC,0,0,0,3,3
Hurricane,Lili,45,2002-10-02T18:00:00Z,PORT ARTHUR TX,10,17,0,0,27
Hurricane,Lili,45,2002-10-02T18:00:00Z,WILMINGTON NC,0,0,0,2,2
Hurricane,Lili,45,2002-10-02T18:00:00Z,GALVESTON TX,10,12,0,0,22
Hurricane,Lili,45,2002-10-02T18:00:00Z,MOREHEAD CITY NC,0,0,0,2,2
Hurricane,Lili,45,2002-10-02T18:00:00Z,FREEPORT TX,6,11,0,0,17
Hurricane,Lili,45,2002-10-02T18:00:00Z,NORFOLK VA,0,0,0,3,3
Hurricane,Lili,45,2002-10-02T18:00:00Z,PORT O CONNOR TX,2,5,1,0,8
Hurricane,Lili,45,2002-10-02T18:00:00Z,OCEAN CITY MD,0,0,0,2,2
Hurricane,Lili,45,2002-10-02T18:00:00Z,GULF 29N 85W,0,0,0,2,2
Hurricane,Lili,45,2002-10-02T18:00:00Z,ATLANTIC CITY NJ,0,0,0,2,2
Hurricane,Lili,45,2002-10-02T18:00:00Z,GULF 29N 87W,0,1,3,1,5
Hurricane,Lili,45,2002-10-02T18:00:00Z,NEW YORK CITY NY,0,0,0,2,2
Hurricane,Lili,45,2002-10-02T18:00:00Z,GULF 28N 89W,15,2,0,0,17
Hurricane,Lili,45,2002-10-02T18:00:00Z,ST MARKS FL,0,0,0,2,2
Hurricane,Lili,45,2002-10-02T18:00:00Z,GULF 28N 91W,38,0,0,0,38
Hurricane,Lili,45,2002-10-02T18:00:00Z,APALACHICOLA FL,0,0,1,2,3
Hurricane,Lili,45,2002-10-02T18:00:00Z,GULF 28N 93W,33,1,0,0,34
Hurricane,Lili,45,2002-10-02T18:00:00Z,PANAMA CITY FL,0,0,1,3,4
Hurricane,Lili,45,2002-10-02T18:00:00Z,GULF 28N 95W,11,6,0,0,17
Hurricane,Lili,45,2002-10-02T18:00:00Z,PENSACOLA FL,0,1,5,4,10
Hurricane,Lili,45,2002-10-02T18:00:00Z,GULF 27N 96W,2,2,1,0,5
Hurricane,Lili,46,2002-10-02T21:00:00Z,29.8N  92.3W,40,0,0,0,40
Hurricane,Lili,46,2002-10-02T21:00:00Z,YARMOUTH NS,0,0,0,2,2
Hurricane,Lili,46,2002-10-02T21:00:00Z,32.2N  91.9W,8,21,4,0,33
Hurricane,Lili,46,2002-10-02T21:00:00Z,PENSACOLA FL,0,2,4,0,6
Hurricane,Lili,46,2002-10-02T21:00:00Z,36.1N  89.0W,0,0,20,5,25
Hurricane,Lili,46,2002-10-02T21:00:00Z,MOBILE AL,0,7,7,0,14
Hurricane,Lili,46,2002-10-02T21:00:00Z,NORFOLK VA,0,0,0,4,4
Hurricane,Lili,46,2002-10-02T21:00:00Z,GULFPORT MS,3,11,5,0,19
Hurricane,Lili,46,2002-10-02T21:00:00Z,OCEAN CITY MD,0,0,0,5,5
Hurricane,Lili,46,2002-10-02T21:00:00Z,BURAS LA,13,6,1,0,20
Hurricane,Lili,46,2002-10-02T21:00:00Z,ATLANTIC CITY NJ,0,0,0,6,6
Hurricane,Lili,46,2002-10-02T21:00:00Z,NEW ORLEANS LA,17,7,1,0,25
Hurricane,Lili,46,2002-10-02T21:00:00Z,NEW YORK CITY NY,0,0,0,7,7
Hurricane,Lili,46,2002-10-02T21:00:00Z,NEW IBERIA LA,36,1,0,0,37
Hurricane,Lili,46,2002-10-02T21:00:00Z,MONTAUK POINT NY,0,0,0,5,5
Hurricane,Lili,46,2002-10-02T21:00:00Z,PORT ARTHUR TX,29,2,0,0,31
Hurricane,Lili,46,2002-10-02T21:00:00Z,PROVIDENCE RI,0,0,0,5,5
Hurricane,Lili,46,2002-10-02T21:00:00Z,GALVESTON TX,17,2,0,0,19
Hurricane,Lili,46,2002-10-02T21:00:00Z,NANTUCKET MA,0,0,0,4,4
Hurricane,Lili,46,2002-10-02T21:00:00Z,FREEPORT TX,7,2,0,0,9
Hurricane,Lili,46,2002-10-02T21:00:00Z,HYANNIS MA,0,0,0,4,4
Hurricane,Lili,46,2002-10-02T21:00:00Z,GULF 29N 87W,0,1,2,0,3
Hurricane,Lili,46,2002-10-02T21:00:00Z,BOSTON MA,0,0,0,5,5
Hurricane,Lili,46,2002-10-02T21:00:00Z,GULF 28N 89W,11,3,0,0,14
Hurricane,Lili,46,2002-10-02T21:00:00Z,PORTLAND ME,0,0,0,5,5
Hurricane,Lili,46,2002-10-02T21:00:00Z,GULF 28N 91W,60,0,0,0,60
Hurricane,Lili,46,2002-10-02T21:00:00Z,BAR HARBOR ME,0,0,0,3,3
Hurricane,Lili,46,2002-10-02T21:00:00Z,GULF 28N 93W,43,0,0,0,43
Hurricane,Lili,46,2002-10-02T21:00:00Z,EASTPORT ME,0,0,0,2,2
Hurricane,Lili,46,2002-10-02T21:00:00Z,GULF 28N 95W,6,1,0,0,7
Hurricane,Lili,46,2002-10-02T21:00:00Z,ST JOHN NB,0,0,0,2,2
Hurricane,Lili,47,2002-10-03T03:00:00Z,31.8N  91.5W,48,3,0,0,51
Hurricane,Lili,47,2002-10-03T03:00:00Z,ST JOHN NB,0,0,0,3,3
Hurricane,Lili,47,2002-10-03T03:00:00Z,35.2N  89.5W,1,36,4,0,41
Hurricane,Lili,47,2002-10-03T03:00:00Z,MONCTON NB,0,0,0,2,2
Hurricane,Lili,47,2002-10-03T03:00:00Z,39.7N  84.8W,0,0,20,4,24
Hurricane,Lili,47,2002-10-03T03:00:00Z,YARMOUTH NS,0,0,0,3,3
Hurricane,Lili,47,2002-10-03T03:00:00Z,NORFOLK VA,0,0,0,2,2
Hurricane,Lili,47,2002-10-03T03:00:00Z,HALIFAX NS,0,0,0,2,2
Hurricane,Lili,47,2002-10-03T03:00:00Z,OCEAN CITY MD,0,0,0,4,4
Hurricane,Lili,47,2002-10-03T03:00:00Z,PENSACOLA FL,0,2,0,0,2
Hurricane,Lili,47,2002-10-03T03:00:00Z,ATLANTIC CITY NJ,0,0,0,7,7
Hurricane,Lili,47,2002-10-03T03:00:00Z,MOBILE AL,3,8,0,0,11
Hurricane,Lili,47,2002-10-03T03:00:00Z,NEW YORK CITY NY,0,0,0,8,8
Hurricane,Lili,47,2002-10-03T03:00:00Z,GULFPORT MS,14,8,0,0,22
Hurricane,Lili,47,2002-10-03T03:00:00Z,MONTAUK POINT NY,0,0,0,7,7
Hurricane,Lili,47,2002-10-03T03:00:00Z,BURAS LA,27,1,0,0,28
Hurricane,Lili,47,2002-10-03T03:00:00Z,PROVIDENCE RI,0,0,0,7,7
Hurricane,Lili,47,2002-10-03T03:00:00Z,NEW ORLEANS LA,47,0,0,0,47
Hurricane,Lili,47,2002-10-03T03:00:00Z,NANTUCKET MA,0,0,0,5,5
Hurricane,Lili,47,2002-10-03T03:00:00Z,NEW IBERIA LA,68,0,0,0,68
Hurricane,Lili,47,2002-10-03T03:00:00Z,HYANNIS MA,0,0,0,6,6
Hurricane,Lili,47,2002-10-03T03:00:00Z,PORT ARTHUR TX,16,0,0,0,16
Hurricane,Lili,47,2002-10-03T03:00:00Z,BOSTON MA,0,0,0,7,7
Hurricane,Lili,47,2002-10-03T03:00:00Z,GULF 28N 89W,6,1,0,0,7
Hurricane,Lili,47,2002-10-03T03:00:00Z,PORTLAND ME,0,0,0,7,7
Hurricane,Lili,47,2002-10-03T03:00:00Z,GULF 28N 91W,99,0,0,0,99
Hurricane,Lili,47,2002-10-03T03:00:00Z,BAR HARBOR ME,0,0,0,5,5
Hurricane,Lili,47,2002-10-03T03:00:00Z,GULF 28N 93W,27,0,0,0,27
Hurricane,Lili,47,2002-10-03T03:00:00Z,EASTPORT ME,0,0,0,4,4
Hurricane,Lili,48,2002-10-03T09:00:00Z,33.4N  91.0W,42,2,0,0,44
Hurricane,Lili,48,2002-10-03T09:00:00Z,NEW ORLEANS LA,31,0,0,0,31
Hurricane,Lili,48,2002-10-03T09:00:00Z,37.5N  87.5W,0,19,0,0,19
Hurricane,Lili,48,2002-10-03T09:00:00Z,NEW IBERIA LA,83,0,0,0,83
Hurricane,Lili,48,2002-10-03T09:00:00Z,,99,0,0,0,99
Hurricane,Lili,48,2002-10-03T09:00:00Z,PORT ARTHUR TX,21,0,0,0,21
Hurricane,Lili,48,2002-10-03T09:00:00Z,MOBILE AL,2,1,0,0,3
Hurricane,Lili,48,2002-10-03T09:00:00Z,GULF 28N 91W,99,0,0,0,99
Hurricane,Lili,48,2002-10-03T09:00:00Z,GULFPORT MS,5,0,0,0,5
Hurricane,Lili,48,2002-10-03T09:00:00Z,GULF 28N 93W,6,0,0,0,6
Hurricane,Lili,48,2002-10-03T09:00:00Z,BURAS LA,3,0,0,0,3
Hurricane,Lili,49,2002-10-03T15:00:00Z,35.0N  90.5W,39,4,0,0,43
Hurricane,Lili,49,2002-10-03T15:00:00Z,NEW ORLEANS LA,22,0,0,0,22
Hurricane,Lili,49,2002-10-03T15:00:00Z,40.0N  85.0W,0,15,0,0,15
Hurricane,Lili,49,2002-10-03T15:00:00Z,NEW IBERIA LA,99,0,0,0,99
Hurricane,Lili,49,2002-10-03T15:00:00Z,,99,0,0,0,99
Hurricane,Lili,49,2002-10-03T15:00:00Z,PORT ARTHUR TX,16,0,0,0,16
Tropical Storm,Lili,50,2002-10-03T21:00:00Z,37.5N  87.5W,36,5,0,0,41
Tropical Storm,Lili,50,2002-10-03T21:00:00Z,,99,0,0,0,99
Tropical Storm,Lili,50,2002-10-03T21:00:00Z,41.5N  81.0W,0,20,0,0,20
Tropical Storm,Lili,50,2002-10-03T21:00:00Z,NEW IBERIA LA,99,0,0,0,99
Tropical Storm,Lili,51,2002-10-04T03:00:00Z,39.7N  84.1W,28,4,0,0,32
Tropical Storm,Lili,51,2002-10-04T03:00:00Z,MONTAUK POINT NY,0,4,0,0,4
Tropical Storm,Lili,51,2002-10-04T03:00:00Z,43.5N  75.7W,0,14,0,0,14
Tropical Storm,Lili,51,2002-10-04T03:00:00Z,PROVIDENCE RI,0,3,0,0,3
Tropical Storm,Lili,51,2002-10-04T03:00:00Z,,99,0,0,0,99
Tropical Storm,Lili,51,2002-10-04T03:00:00Z,HYANNIS MA,0,2,0,0,2
Tropical Storm,Lili,51,2002-10-04T03:00:00Z,OCEAN CITY MD,0,3,0,0,3
Tropical Storm,Lili,51,2002-10-04T03:00:00Z,BOSTON MA,0,3,0,0,3
Tropical Storm,Lili,51,2002-10-04T03:00:00Z,ATLANTIC CITY NJ,0,6,0,0,6
Tropical Storm,Lili,51,2002-10-04T03:00:00Z,PORTLAND ME,0,2,0,0,2
Tropical Storm,Lili,51,2002-10-04T03:00:00Z,NEW YORK CITY NY,0,7,0,0,7
Tropical Depression,Fourteen,1,2002-10-14T15:00:00Z,21.7N  82.3W,43,0,0,0,43
Tropical Depression,Fourteen,1,2002-10-14T15:00:00Z,DAYTONA BEACH FL,0,0,9,4,13
Tropical Depression,Fourteen,1,2002-10-14T15:00:00Z,23.9N  80.6W,5,21,1,0,27
Tropical Depression,Fourteen,1,2002-10-14T15:00:00Z,JACKSONVILLE FL,0,0,4,6,10
Tropical Depression,Fourteen,1,2002-10-14T15:00:00Z,26.8N  77.5W,0,2,16,2,20
Tropical Depression,Fourteen,1,2002-10-14T15:00:00Z,SAVANNAH GA,0,0,1,7,8
Tropical Depression,Fourteen,1,2002-10-14T15:00:00Z,MWCG 193N 814W,36,0,0,0,36
Tropical Depression,Fourteen,1,2002-10-14T15:00:00Z,CHARLESTON SC,0,0,1,8,9
Tropical Depression,Fourteen,1,2002-10-14T15:00:00Z,MUCM 214N 779W,0,7,3,0,10
Tropical Depression,Fourteen,1,2002-10-14T15:00:00Z,MYRTLE BEACH SC,0,0,0,10,10
Tropical Depression,Fourteen,1,2002-10-14T15:00:00Z,MUCF 221N 805W,21,7,0,0,28
Tropical Depression,Fourteen,1,2002-10-14T15:00:00Z,WILMINGTON NC,0,0,0,10,10
Tropical Depression,Fourteen,1,2002-10-14T15:00:00Z,MUSN 216N 826W,44,0,0,0,44
Tropical Depression,Fourteen,1,2002-10-14T15:00:00Z,MOREHEAD CITY NC,0,0,0,10,10
Tropical Depression,Fourteen,1,2002-10-14T15:00:00Z,MUHA 230N 824W,25,7,0,0,32
Tropical Depression,Fourteen,1,2002-10-14T15:00:00Z,CAPE HATTERAS NC,0,0,0,10,10
Tropical Depression,Fourteen,1,2002-10-14T15:00:00Z,MUAN 219N 850W,16,3,0,0,19
Tropical Depression,Fourteen,1,2002-10-14T15:00:00Z,NORFOLK VA,0,0,0,7,7
Tropical Depression,Fourteen,1,2002-10-14T15:00:00Z,MYMM 224N 730W,0,0,1,1,2
Tropical Depression,Fourteen,1,2002-10-14T15:00:00Z,OCEAN CITY MD,0,0,0,4,4
Tropical Depression,Fourteen,1,2002-10-14T15:00:00Z,MYSM 241N 745W,0,0,7,2,9
Tropical Depression,Fourteen,1,2002-10-14T15:00:00Z,ATLANTIC CITY NJ,0,0,0,3,3
Tropical Depression,Fourteen,1,2002-10-14T15:00:00Z,MYEG 235N 758W,0,2,8,1,11
Tropical Depression,Fourteen,1,2002-10-14T15:00:00Z,KEY WEST FL,3,21,2,0,26
Tropical Depression,Fourteen,1,2002-10-14T15:00:00Z,MYAK 241N 776W,0,9,10,0,19
Tropical Depression,Fourteen,1,2002-10-14T15:00:00Z,MARCO ISLAND FL,0,14,7,0,21
Tropical Depression,Fourteen,1,2002-10-14T15:00:00Z,MYNN 251N 775W,0,6,13,1,20
Tropical Depression,Fourteen,1,2002-10-14T15:00:00Z,FT MYERS FL,0,9,9,1,19
Tropical Depression,Fourteen,1,2002-10-14T15:00:00Z,MYGF 266N 787W,0,5,15,1,21
Tropical Depression,Fourteen,1,2002-10-14T15:00:00Z,VENICE FL,0,5,10,0,15
Tropical Depression,Fourteen,1,2002-10-14T15:00:00Z,BERMUDA,0,0,0,2,2
Tropical Depression,Fourteen,1,2002-10-14T15:00:00Z,TAMPA FL,0,2,9,2,13
Tropical Depression,Fourteen,1,2002-10-14T15:00:00Z,MARATHON FL,2,21,3,0,26
Tropical Depression,Fourteen,1,2002-10-14T15:00:00Z,CEDAR KEY FL,0,0,6,3,9
Tropical Depression,Fourteen,1,2002-10-14T15:00:00Z,MIAMI FL,0,14,9,1,24
Tropical Depression,Fourteen,1,2002-10-14T15:00:00Z,ST MARKS FL,0,0,2,2,4
Tropical Depression,Fourteen,1,2002-10-14T15:00:00Z,W PALM BEACH FL,0,7,14,0,21
Tropical Depression,Fourteen,1,2002-10-14T15:00:00Z,APALACHICOLA FL,0,0,1,2,3
Tropical Depression,Fourteen,1,2002-10-14T15:00:00Z,FT PIERCE FL,0,3,15,1,19
Tropical Depression,Fourteen,1,2002-10-14T15:00:00Z,PANAMA CITY FL,0,0,1,1,2
Tropical Depression,Fourteen,1,2002-10-14T15:00:00Z,COCOA BEACH FL,0,2,12,2,16
Tropical Depression,Fourteen,1,2002-10-14T15:00:00Z,GULF 29N 85W,0,0,2,1,3
Tropical Depression,Fourteen,2,2002-10-14T21:00:00Z,21.6N  82.4W,36,0,0,0,36
Tropical Depression,Fourteen,2,2002-10-14T21:00:00Z,JACKSONVILLE FL,0,0,4,2,6
Tropical Depression,Fourteen,2,2002-10-14T21:00:00Z,23.9N  80.0W,2,21,3,0,26
Tropical Depression,Fourteen,2,2002-10-14T21:00:00Z,SAVANNAH GA,0,0,2,3,5
Tropical Depression,Fourteen,2,2002-10-14T21:00:00Z,27.6N  76.3W,0,0,16,3,19
Tropical Depression,Fourteen,2,2002-10-14T21:00:00Z,CHARLESTON SC,0,0,1,6,7
Tropical Depression,Fourteen,2,2002-10-14T21:00:00Z,MWCG 193N 814W,38,0,0,0,38
Tropical Depression,Fourteen,2,2002-10-14T21:00:00Z,MYRTLE BEACH SC,0,0,1,7,8
Tropical Depression,Fourteen,2,2002-10-14T21:00:00Z,MUCM 214N 779W,1,10,3,0,14
Tropical Depression,Fourteen,2,2002-10-14T21:00:00Z,WILMINGTON NC,0,0,0,9,9
Tropical Depression,Fourteen,2,2002-10-14T21:00:00Z,MUCF 221N 805W,16,11,0,0,27
Tropical Depression,Fourteen,2,2002-10-14T21:00:00Z,MOREHEAD CITY NC,0,0,0,10,10
Tropical Depression,Fourteen,2,2002-10-14T21:00:00Z,MUSN 216N 826W,36,0,0,0,36
Tropical Depression,Fourteen,2,2002-10-14T21:00:00Z,CAPE HATTERAS NC,0,0,0,11,11
Tropical Depression,Fourteen,2,2002-10-14T21:00:00Z,MUHA 230N 824W,21,7,0,0,28
Tropical Depression,Fourteen,2,2002-10-14T21:00:00Z,NORFOLK VA,0,0,0,8,8
Tropical Depression,Fourteen,2,2002-10-14T21:00:00Z,MUAN 219N 850W,14,2,0,0,16
Tropical Depression,Fourteen,2,2002-10-14T21:00:00Z,OCEAN CITY MD,0,0,0,7,7
Tropical Depression,Fourteen,2,2002-10-14T21:00:00Z,MYMM 224N 730W,0,0,2,1,3
Tropical Depression,Fourteen,2,2002-10-14T21:00:00Z,ATLANTIC CITY NJ,0,0,0,5,5
Tropical Depression,Fourteen,2,2002-10-14T21:00:00Z,MYSM 241N 745W,0,1,8,2,11
Tropical Depression,Fourteen,2,2002-10-14T21:00:00Z,NEW YORK CITY NY,0,0,0,4,4
Tropical Depression,Fourteen,2,2002-10-14T21:00:00Z,MYEG 235N 758W,0,3,10,0,13
Tropical Depression,Fourteen,2,2002-10-14T21:00:00Z,MONTAUK POINT NY,0,0,0,4,4
Tropical Depression,Fourteen,2,2002-10-14T21:00:00Z,MYAK 241N 776W,0,11,10,0,21
Tropical Depression,Fourteen,2,2002-10-14T21:00:00Z,PROVIDENCE RI,0,0,0,3,3
Tropical Depression,Fourteen,2,2002-10-14T21:00:00Z,MYNN 251N 775W,0,7,14,1,22
Tropical Depression,Fourteen,2,2002-10-14T21:00:00Z,NANTUCKET MA,0,0,0,3,3
Tropical Depression,Fourteen,2,2002-10-14T21:00:00Z,MYGF 266N 787W,0,5,16,1,22
Tropical Depression,Fourteen,2,2002-10-14T21:00:00Z,HYANNIS MA,0,0,0,3,3
Tropical Depression,Fourteen,2,2002-10-14T21:00:00Z,BERMUDA,0,0,0,5,5
Tropical Depression,Fourteen,2,2002-10-14T21:00:00Z,BOSTON MA,0,0,0,2,2
Tropical Depression,Fourteen,2,2002-10-14T21:00:00Z,MARATHON FL,2,20,3,0,25
Tropical Depression,Fourteen,2,2002-10-14T21:00:00Z,KEY WEST FL,4,18,2,0,24
Tropical Depression,Fourteen,2,2002-10-14T21:00:00Z,MIAMI FL,0,14,9,0,23
Tropical Depression,Fourteen,2,2002-10-14T21:00:00Z,MARCO ISLAND FL,0,13,6,0,19
Tropical Depression,Fourteen,2,2002-10-14T21:00:00Z,W PALM BEACH FL,0,7,13,0,20
Tropical Depression,Fourteen,2,2002-10-14T21:00:00Z,FT MYERS FL,0,9,7,0,16
Tropical Depression,Fourteen,2,2002-10-14T21:00:00Z,FT PIERCE FL,0,4,13,0,17
Tropical Depression,Fourteen,2,2002-10-14T21:00:00Z,VENICE FL,0,5,7,0,12
Tropical Depression,Fourteen,2,2002-10-14T21:00:00Z,COCOA BEACH FL,0,2,12,1,15
Tropical Depression,Fourteen,2,2002-10-14T21:00:00Z,TAMPA FL,0,2,6,1,9
Tropical Depression,Fourteen,2,2002-10-14T21:00:00Z,DAYTONA BEACH FL,0,0,9,2,11
Tropical Depression,Fourteen,2,2002-10-14T21:00:00Z,CEDAR KEY FL,0,0,4,1,5
Tropical Depression,Fourteen,3,2002-10-15T03:00:00Z,21.4N  80.6W,36,2,0,0,38
Tropical Depression,Fourteen,3,2002-10-15T03:00:00Z,MYRTLE BEACH SC,0,0,2,3,5
Tropical Depression,Fourteen,3,2002-10-15T03:00:00Z,24.5N  78.0W,1,22,4,0,27
Tropical Depression,Fourteen,3,2002-10-15T03:00:00Z,WILMINGTON NC,0,0,2,4,6
Tropical Depression,Fourteen,3,2002-10-15T03:00:00Z,29.1N  74.0W,0,0,14,5,19
Tropical Depression,Fourteen,3,2002-10-15T03:00:00Z,MOREHEAD CITY NC,0,0,1,8,9
Tropical Depression,Fourteen,3,2002-10-15T03:00:00Z,MKJS 185N 779W,2,3,0,0,5
Tropical Depression,Fourteen,3,2002-10-15T03:00:00Z,CAPE HATTERAS NC,0,0,1,9,10
Tropical Depression,Fourteen,3,2002-10-15T03:00:00Z,MWCG 193N 814W,55,0,0,0,55
Tropical Depression,Fourteen,3,2002-10-15T03:00:00Z,NORFOLK VA,0,0,0,6,6
Tropical Depression,Fourteen,3,2002-10-15T03:00:00Z,MUGM 200N 751W,0,2,0,0,2
Tropical Depression,Fourteen,3,2002-10-15T03:00:00Z,OCEAN CITY MD,0,0,0,6,6
Tropical Depression,Fourteen,3,2002-10-15T03:00:00Z,MUCM 214N 779W,7,15,1,0,23
Tropical Depression,Fourteen,3,2002-10-15T03:00:00Z,ATLANTIC CITY NJ,0,0,0,5,5
Tropical Depression,Fourteen,3,2002-10-15T03:00:00Z,MUCF 221N 805W,28,6,0,0,34
Tropical Depression,Fourteen,3,2002-10-15T03:00:00Z,NEW YORK CITY NY,0,0,0,5,5
Tropical Depression,Fourteen,3,2002-10-15T03:00:00Z,MUSN 216N 826W,25,1,0,0,26
Tropical Depression,Fourteen,3,2002-10-15T03:00:00Z,MONTAUK POINT NY,0,0,0,7,7
Tropical Depression,Fourteen,3,2002-10-15T03:00:00Z,MUHA 230N 824W,11,8,0,0,19
Tropical Depression,Fourteen,3,2002-10-15T03:00:00Z,PROVIDENCE RI,0,0,0,6,6
Tropical Depression,Fourteen,3,2002-10-15T03:00:00Z,MYMM 224N 730W,0,1,2,0,3
Tropical Depression,Fourteen,3,2002-10-15T03:00:00Z,NANTUCKET MA,0,0,0,8,8
Tropical Depression,Fourteen,3,2002-10-15T03:00:00Z,MYSM 241N 745W,0,3,9,1,13
Tropical Depression,Fourteen,3,2002-10-15T03:00:00Z,HYANNIS MA,0,0,0,7,7
Tropical Depression,Fourteen,3,2002-10-15T03:00:00Z,MYEG 235N 758W,0,10,8,0,18
Tropical Depression,Fourteen,3,2002-10-15T03:00:00Z,BOSTON MA,0,0,0,5,5
Tropical Depression,Fourteen,3,2002-10-15T03:00:00Z,MYAK 241N 776W,1,21,4,0,26
Tropical Depression,Fourteen,3,2002-10-15T03:00:00Z,PORTLAND ME,0,0,0,4,4
Tropical Depression,Fourteen,3,2002-10-15T03:00:00Z,MYNN 251N 775W,0,18,8,0,26
Tropical Depression,Fourteen,3,2002-10-15T03:00:00Z,BAR HARBOR ME,0,0,0,4,4
Tropical Depression,Fourteen,3,2002-10-15T03:00:00Z,MYGF 266N 787W,0,12,12,0,24
Tropical Depression,Fourteen,3,2002-10-15T03:00:00Z,EASTPORT ME,0,0,0,3,3
Tropical Depression,Fourteen,3,2002-10-15T03:00:00Z,BERMUDA,0,0,0,6,6
Tropical Depression,Fourteen,3,2002-10-15T03:00:00Z,ST JOHN NB,0,0,0,3,3
Tropical Depression,Fourteen,3,2002-10-15T03:00:00Z,MARATHON FL,3,18,1,0,22
Tropical Depression,Fourteen,3,2002-10-15T03:00:00Z,MONCTON NB,0,0,0,2,2
Tropical Depression,Fourteen,3,2002-10-15T03:00:00Z,MIAMI FL,1,17,4,0,22
Tropical Depression,Fourteen,3,2002-10-15T03:00:00Z,YARMOUTH NS,0,0,0,4,4
Tropical Depression,Fourteen,3,2002-10-15T03:00:00Z,W PALM BEACH FL,0,12,7,0,19
Tropical Depression,Fourteen,3,2002-10-15T03:00:00Z,HALIFAX NS,0,0,0,2,2
Tropical Depression,Fourteen,3,2002-10-15T03:00:00Z,FT PIERCE FL,0,7,8,0,15
Tropical Depression,Fourteen,3,2002-10-15T03:00:00Z,KEY WEST FL,3,14,1,0,18
Tropical Depression,Fourteen,3,2002-10-15T03:00:00Z,COCOA BEACH FL,0,3,7,1,11
Tropical Depression,Fourteen,3,2002-10-15T03:00:00Z,MARCO ISLAND FL,0,11,2,0,13
Tropical Depression,Fourteen,3,2002-10-15T03:00:00Z,DAYTONA BEACH FL,0,1,5,0,6
Tropical Depression,Fourteen,3,2002-10-15T03:00:00Z,FT MYERS FL,0,7,2,0,9
Tropical Depression,Fourteen,3,2002-10-15T03:00:00Z,JACKSONVILLE FL,0,0,2,1,3
Tropical Depression,Fourteen,3,2002-10-15T03:00:00Z,VENICE FL,0,3,2,0,5
Tropical Depression,Fourteen,3,2002-10-15T03:00:00Z,SAVANNAH GA,0,0,2,0,2
Tropical Depression,Fourteen,3,2002-10-15T03:00:00Z,TAMPA FL,0,2,1,0,3
Tropical Depression,Fourteen,3,2002-10-15T03:00:00Z,CHARLESTON SC,0,0,2,2,4
Tropical Depression,Fourteen,4,2002-10-15T09:00:00Z,22.0N  80.0W,53,1,0,0,54
Tropical Depression,Fourteen,4,2002-10-15T09:00:00Z,MOREHEAD CITY NC,0,0,1,3,4
Tropical Depression,Fourteen,4,2002-10-15T09:00:00Z,25.0N  77.0W,2,27,2,0,31
Tropical Depression,Fourteen,4,2002-10-15T09:00:00Z,CAPE HATTERAS NC,0,0,1,4,5
Tropical Depression,Fourteen,4,2002-10-15T09:00:00Z,29.0N  73.0W,0,0,15,2,17
Tropical Depression,Fourteen,4,2002-10-15T09:00:00Z,NORFOLK VA,0,0,0,3,3
Tropical Depression,Fourteen,4,2002-10-15T09:00:00Z,MWCG 193N 814W,73,0,0,0,73
Tropical Depression,Fourteen,4,2002-10-15T09:00:00Z,OCEAN CITY MD,0,0,0,3,3
Tropical Depression,Fourteen,4,2002-10-15T09:00:00Z,MUCM 214N 779W,14,12,0,0,26
Tropical Depression,Fourteen,4,2002-10-15T09:00:00Z,ATLANTIC CITY NJ,0,0,0,3,3
Tropical Depression,Fourteen,4,2002-10-15T09:00:00Z,MUCF 221N 805W,54,0,0,0,54
Tropical Depression,Fourteen,4,2002-10-15T09:00:00Z,NEW YORK CITY NY,0,0,0,3,3
Tropical Depression,Fourteen,4,2002-10-15T09:00:00Z,MUSN 216N 826W,36,0,0,0,36
Tropical Depression,Fourteen,4,2002-10-15T09:00:00Z,MONTAUK POINT NY,0,0,0,4,4
Tropical Depression,Fourteen,4,2002-10-15T09:00:00Z,MUHA 230N 824W,11,6,0,0,17
Tropical Depression,Fourteen,4,2002-10-15T09:00:00Z,PROVIDENCE RI,0,0,0,4,4
Tropical Depression,Fourteen,4,2002-10-15T09:00:00Z,MYMM 224N 730W,0,1,3,0,4
Tropical Depression,Fourteen,4,2002-10-15T09:00:00Z,NANTUCKET MA,0,0,0,6,6
Tropical Depression,Fourteen,4,2002-10-15T09:00:00Z,MYSM 241N 745W,0,8,9,0,17
Tropical Depression,Fourteen,4,2002-10-15T09:00:00Z,HYANNIS MA,0,0,0,5,5
Tropical Depression,Fourteen,4,2002-10-15T09:00:00Z,MYEG 235N 758W,1,18,4,0,23
Tropical Depression,Fourteen,4,2002-10-15T09:00:00Z,BOSTON MA,0,0,0,4,4
Tropical Depression,Fourteen,4,2002-10-15T09:00:00Z,MYAK 241N 776W,8,27,0,0,35
Tropical Depression,Fourteen,4,2002-10-15T09:00:00Z,PORTLAND ME,0,0,0,3,3
Tropical Depression,Fourteen,4,2002-10-15T09:00:00Z,MYNN 251N 775W,3,28,1,0,32
Tropical Depression,Fourteen,4,2002-10-15T09:00:00Z,BAR HARBOR ME,0,0,0,3,3
Tropical Depression,Fourteen,4,2002-10-15T09:00:00Z,MYGF 266N 787W,0,19,4,0,23
Tropical Depression,Fourteen,4,2002-10-15T09:00:00Z,EASTPORT ME,0,0,0,3,3
Tropical Depression,Fourteen,4,2002-10-15T09:00:00Z,BERMUDA,0,0,0,7,7
Tropical Depression,Fourteen,4,2002-10-15T09:00:00Z,ST JOHN NB,0,0,0,2,2
Tropical Depression,Fourteen,4,2002-10-15T09:00:00Z,MARATHON FL,3,15,0,0,18
Tropical Depression,Fourteen,4,2002-10-15T09:00:00Z,YARMOUTH NS,0,0,0,3,3
Tropical Depression,Fourteen,4,2002-10-15T09:00:00Z,MIAMI FL,1,16,1,0,18
Tropical Depression,Fourteen,4,2002-10-15T09:00:00Z,HALIFAX NS,0,0,0,2,2
Tropical Depression,Fourteen,4,2002-10-15T09:00:00Z,W PALM BEACH FL,0,11,2,0,13
Tropical Depression,Fourteen,4,2002-10-15T09:00:00Z,KEY WEST FL,2,9,0,0,11
Tropical Depression,Fourteen,4,2002-10-15T09:00:00Z,FT PIERCE FL,0,5,2,0,7
Tropical Depression,Fourteen,4,2002-10-15T09:00:00Z,MARCO ISLAND FL,0,4,0,0,4
Tropical Depression,Fourteen,4,2002-10-15T09:00:00Z,COCOA BEACH FL,0,2,2,0,4
Tropical Depression,Fourteen,4,2002-10-15T09:00:00Z,FT MYERS FL,0,2,0,0,2
Tropical Depression,Fourteen,4,2002-10-15T09:00:00Z,WILMINGTON NC,0,0,1,1,2
Tropical Depression,Fourteen,5,2002-10-15T15:00:00Z,21.7N  79.2W,52,0,0,0,52
Tropical Depression,Fourteen,5,2002-10-15T15:00:00Z,COCOA BEACH FL,0,1,1,0,2
Tropical Depression,Fourteen,5,2002-10-15T15:00:00Z,24.6N  76.7W,1,26,3,0,30
Tropical Depression,Fourteen,5,2002-10-15T15:00:00Z,MOREHEAD CITY NC,0,0,1,1,2
Tropical Depression,Fourteen,5,2002-10-15T15:00:00Z,29.5N  72.3W,0,0,14,4,18
Tropical Depression,Fourteen,5,2002-10-15T15:00:00Z,CAPE HATTERAS NC,0,0,1,2,3
Tropical Depression,Fourteen,5,2002-10-15T15:00:00Z,MKJS 185N 779W,1,1,0,0,2
Tropical Depression,Fourteen,5,2002-10-15T15:00:00Z,MONTAUK POINT NY,0,0,0,3,3
Tropical Depression,Fourteen,5,2002-10-15T15:00:00Z,MWCG 193N 814W,91,0,0,0,91
Tropical Depression,Fourteen,5,2002-10-15T15:00:00Z,PROVIDENCE RI,0,0,0,3,3
Tropical Depression,Fourteen,5,2002-10-15T15:00:00Z,MUGM 200N 751W,0,2,1,0,3
Tropical Depression,Fourteen,5,2002-10-15T15:00:00Z,NANTUCKET MA,0,0,0,5,5
Tropical Depression,Fourteen,5,2002-10-15T15:00:00Z,MUCM 214N 779W,33,4,0,0,37
Tropical Depression,Fourteen,5,2002-10-15T15:00:00Z,HYANNIS MA,0,0,0,4,4
Tropical Depression,Fourteen,5,2002-10-15T15:00:00Z,MUCF 221N 805W,44,1,0,0,45
Tropical Depression,Fourteen,5,2002-10-15T15:00:00Z,BOSTON MA,0,0,0,3,3
Tropical Depression,Fourteen,5,2002-10-15T15:00:00Z,MUSN 216N 826W,14,2,0,0,16
Tropical Depression,Fourteen,5,2002-10-15T15:00:00Z,PORTLAND ME,0,0,0,2,2
Tropical Depression,Fourteen,5,2002-10-15T15:00:00Z,MUHA 230N 824W,4,3,0,0,7
Tropical Depression,Fourteen,5,2002-10-15T15:00:00Z,BAR HARBOR ME,0,0,0,3,3
Tropical Depression,Fourteen,5,2002-10-15T15:00:00Z,MYMM 224N 730W,0,2,4,0,6
Tropical Depression,Fourteen,5,2002-10-15T15:00:00Z,EASTPORT ME,0,0,0,4,4
Tropical Depression,Fourteen,5,2002-10-15T15:00:00Z,MYSM 241N 745W,0,13,9,0,22
Tropical Depression,Fourteen,5,2002-10-15T15:00:00Z,ST JOHN NB,0,0,0,4,4
Tropical Depression,Fourteen,5,2002-10-15T15:00:00Z,MYEG 235N 758W,2,21,4,0,27
Tropical Depression,Fourteen,5,2002-10-15T15:00:00Z,MONCTON NB,0,0,0,3,3
Tropical Depression,Fourteen,5,2002-10-15T15:00:00Z,MYAK 241N 776W,6,25,1,0,32
Tropical Depression,Fourteen,5,2002-10-15T15:00:00Z,YARMOUTH NS,0,0,0,5,5
Tropical Depression,Fourteen,5,2002-10-15T15:00:00Z,MYNN 251N 775W,1,25,3,0,29
Tropical Depression,Fourteen,5,2002-10-15T15:00:00Z,HALIFAX NS,0,0,0,5,5
Tropical Depression,Fourteen,5,2002-10-15T15:00:00Z,MYGF 266N 787W,0,12,5,0,17
Tropical Depression,Fourteen,5,2002-10-15T15:00:00Z,SABLE ISLAND NS,0,0,0,4,4
Tropical Depression,Fourteen,5,2002-10-15T15:00:00Z,BERMUDA,0,0,0,8,8
Tropical Depression,Fourteen,5,2002-10-15T15:00:00Z,SYDNEY NS,0,0,0,3,3
Tropical Depression,Fourteen,5,2002-10-15T15:00:00Z,MARATHON FL,1,8,1,0,10
Tropical Depression,Fourteen,5,2002-10-15T15:00:00Z,EDDY POINT NS,0,0,0,3,3
Tropical Depression,Fourteen,5,2002-10-15T15:00:00Z,MIAMI FL,0,9,1,0,10
Tropical Depression,Fourteen,5,2002-10-15T15:00:00Z,KEY WEST FL,0,5,0,0,5
Tropical Depression,Fourteen,5,2002-10-15T15:00:00Z,W PALM BEACH FL,0,5,2,0,7
Tropical Depression,Fourteen,5,2002-10-15T15:00:00Z,MARCO ISLAND FL,0,2,0,0,2
Tropical Depression,Fourteen,5,2002-10-15T15:00:00Z,FT PIERCE FL,0,2,2,0,4
Tropical Depression,Fourteen,6,2002-10-15T21:00:00Z,22.5N  78.7W,39,1,0,0,40
Tropical Depression,Fourteen,6,2002-10-15T21:00:00Z,FT PIERCE FL,0,2,0,0,2
Tropical Depression,Fourteen,6,2002-10-15T21:00:00Z,25.5N  76.0W,0,21,2,0,23
Tropical Depression,Fourteen,6,2002-10-15T21:00:00Z,MOREHEAD CITY NC,0,0,1,1,2
Tropical Depression,Fourteen,6,2002-10-15T21:00:00Z,29.5N  72.3W,0,1,13,2,16
Tropical Depression,Fourteen,6,2002-10-15T21:00:00Z,CAPE HATTERAS NC,0,0,2,1,3
Tropical Depression,Fourteen,6,2002-10-15T21:00:00Z,MKJS 185N 779W,2,1,0,0,3
Tropical Depression,Fourteen,6,2002-10-15T21:00:00Z,OCEAN CITY MD,0,0,0,2,2
Tropical Depression,Fourteen,6,2002-10-15T21:00:00Z,MWCG 193N 814W,99,0,0,0,99
Tropical Depression,Fourteen,6,2002-10-15T21:00:00Z,ATLANTIC CITY NJ,0,0,0,2,2
Tropical Depression,Fourteen,6,2002-10-15T21:00:00Z,MUGM 200N 751W,0,3,1,0,4
Tropical Depression,Fourteen,6,2002-10-15T21:00:00Z,NEW YORK CITY NY,0,0,0,2,2
Tropical Depression,Fourteen,6,2002-10-15T21:00:00Z,MUCM 214N 779W,31,2,0,0,33
Tropical Depression,Fourteen,6,2002-10-15T21:00:00Z,MONTAUK POINT NY,0,0,0,4,4
Tropical Depression,Fourteen,6,2002-10-15T21:00:00Z,MUCF 221N 805W,42,0,0,0,42
Tropical Depression,Fourteen,6,2002-10-15T21:00:00Z,PROVIDENCE RI,0,0,0,4,4
Tropical Depression,Fourteen,6,2002-10-15T21:00:00Z,MUSN 216N 826W,6,0,0,0,6
Tropical Depression,Fourteen,6,2002-10-15T21:00:00Z,NANTUCKET MA,0,0,0,6,6
Tropical Depression,Fourteen,6,2002-10-15T21:00:00Z,MUHA 230N 824W,2,0,0,0,2
Tropical Depression,Fourteen,6,2002-10-15T21:00:00Z,HYANNIS MA,0,0,0,5,5
Tropical Depression,Fourteen,6,2002-10-15T21:00:00Z,MBJT 215N 712W,0,0,2,0,2
Tropical Depression,Fourteen,6,2002-10-15T21:00:00Z,BOSTON MA,0,0,0,4,4
Tropical Depression,Fourteen,6,2002-10-15T21:00:00Z,MYMM 224N 730W,0,3,3,0,6
Tropical Depression,Fourteen,6,2002-10-15T21:00:00Z,PORTLAND ME,0,0,0,3,3
Tropical Depression,Fourteen,6,2002-10-15T21:00:00Z,MYSM 241N 745W,0,14,4,0,18
Tropical Depression,Fourteen,6,2002-10-15T21:00:00Z,BAR HARBOR ME,0,0,0,4,4
Tropical Depression,Fourteen,6,2002-10-15T21:00:00Z,MYEG 235N 758W,2,19,1,0,22
Tropical Depression,Fourteen,6,2002-10-15T21:00:00Z,EASTPORT ME,0,0,0,4,4
Tropical Depression,Fourteen,6,2002-10-15T21:00:00Z,MYAK 241N 776W,14,14,0,0,28
Tropical Depression,Fourteen,6,2002-10-15T21:00:00Z,ST JOHN NB,0,0,0,4,4
Tropical Depression,Fourteen,6,2002-10-15T21:00:00Z,MYNN 251N 775W,5,19,0,0,24
Tropical Depression,Fourteen,6,2002-10-15T21:00:00Z,MONCTON NB,0,0,0,3,3
Tropical Depression,Fourteen,6,2002-10-15T21:00:00Z,MYGF 266N 787W,1,11,1,0,13
Tropical Depression,Fourteen,6,2002-10-15T21:00:00Z,YARMOUTH NS,0,0,0,6,6
Tropical Depression,Fourteen,6,2002-10-15T21:00:00Z,BERMUDA,0,0,0,8,8
Tropical Depression,Fourteen,6,2002-10-15T21:00:00Z,HALIFAX NS,0,0,0,5,5
Tropical Depression,Fourteen,6,2002-10-15T21:00:00Z,MARATHON FL,2,2,0,0,4
Tropical Depression,Fourteen,6,2002-10-15T21:00:00Z,SABLE ISLAND NS,0,0,0,3,3
Tropical Depression,Fourteen,6,2002-10-15T21:00:00Z,MIAMI FL,1,4,0,0,5
Tropical Depression,Fourteen,6,2002-10-15T21:00:00Z,SYDNEY NS,0,0,0,2,2
Tropical Depression,Fourteen,6,2002-10-15T21:00:00Z,W PALM BEACH FL,0,3,1,0,4
Tropical Depression,Fourteen,6,2002-10-15T21:00:00Z,EDDY POINT NS,0,0,0,3,3
Tropical Depression,Fourteen,7,2002-10-16T03:00:00Z,23.5N  78.0W,45,0,1,0,46
Tropical Depression,Fourteen,7,2002-10-16T03:00:00Z,MIAMI FL,2,2,0,0,4
Tropical Depression,Fourteen,7,2002-10-16T03:00:00Z,26.0N  75.5W,5,20,0,0,25
Tropical Depression,Fourteen,7,2002-10-16T03:00:00Z,W PALM BEACH FL,1,1,1,0,3
Tropical Depression,Fourteen,7,2002-10-16T03:00:00Z,29.0N  72.5W,0,5,11,1,17
Tropical Depression,Fourteen,7,2002-10-16T03:00:00Z,MOREHEAD CITY NC,0,0,1,1,2
Tropical Depression,Fourteen,7,2002-10-16T03:00:00Z,MWCG 193N 814W,99,0,0,0,99
Tropical Depression,Fourteen,7,2002-10-16T03:00:00Z,CAPE HATTERAS NC,0,0,1,2,3
Tropical Depression,Fourteen,7,2002-10-16T03:00:00Z,MUGM 200N 751W,0,1,1,0,2
Tropical Depression,Fourteen,7,2002-10-16T03:00:00Z,NORFOLK VA,0,0,0,2,2
Tropical Depression,Fourteen,7,2002-10-16T03:00:00Z,MUCM 214N 779W,31,0,0,0,31
Tropical Depression,Fourteen,7,2002-10-16T03:00:00Z,OCEAN CITY MD,0,0,0,2,2
Tropical Depression,Fourteen,7,2002-10-16T03:00:00Z,MUCF 221N 805W,64,1,0,0,65
Tropical Depression,Fourteen,7,2002-10-16T03:00:00Z,ATLANTIC CITY NJ,0,0,0,2,2
Tropical Depression,Fourteen,7,2002-10-16T03:00:00Z,MUSN 216N 826W,20,0,0,0,20
Tropical Depression,Fourteen,7,2002-10-16T03:00:00Z,NEW YORK CITY NY,0,0,0,2,2
Tropical Depression,Fourteen,7,2002-10-16T03:00:00Z,MUHA 230N 824W,2,0,0,0,2
Tropical Depression,Fourteen,7,2002-10-16T03:00:00Z,MONTAUK POINT NY,0,0,0,4,4
Tropical Depression,Fourteen,7,2002-10-16T03:00:00Z,MBJT 215N 712W,0,0,1,1,2
Tropical Depression,Fourteen,7,2002-10-16T03:00:00Z,PROVIDENCE RI,0,0,0,3,3
Tropical Depression,Fourteen,7,2002-10-16T03:00:00Z,MYMM 224N 730W,0,2,4,0,6
Tropical Depression,Fourteen,7,2002-10-16T03:00:00Z,NANTUCKET MA,0,0,0,5,5
Tropical Depression,Fourteen,7,2002-10-16T03:00:00Z,MYSM 241N 745W,2,16,1,0,19
Tropical Depression,Fourteen,7,2002-10-16T03:00:00Z,HYANNIS MA,0,0,0,4,4
Tropical Depression,Fourteen,7,2002-10-16T03:00:00Z,MYEG 235N 758W,16,9,0,0,25
Tropical Depression,Fourteen,7,2002-10-16T03:00:00Z,BOSTON MA,0,0,0,3,3
Tropical Depression,Fourteen,7,2002-10-16T03:00:00Z,MYAK 241N 776W,39,1,0,0,40
Tropical Depression,Fourteen,7,2002-10-16T03:00:00Z,PORTLAND ME,0,0,0,2,2
Tropical Depression,Fourteen,7,2002-10-16T03:00:00Z,MYNN 251N 775W,27,5,0,0,32
Tropical Depression,Fourteen,7,2002-10-16T03:00:00Z,BAR HARBOR ME,0,0,0,2,2
Tropical Depression,Fourteen,7,2002-10-16T03:00:00Z,MYGF 266N 787W,3,9,0,0,12
Tropical Depression,Fourteen,7,2002-10-16T03:00:00Z,EASTPORT ME,0,0,0,2,2
Tropical Depression,Fourteen,7,2002-10-16T03:00:00Z,BERMUDA,0,0,0,9,9
Tropical Depression,Fourteen,7,2002-10-16T03:00:00Z,YARMOUTH NS,0,0,0,3,3
Tropical Depression,Fourteen,7,2002-10-16T03:00:00Z,MARATHON FL,3,1,0,0,4
Tropical Depression,Fourteen,7,2002-10-16T03:00:00Z,HALIFAX NS,0,0,0,2,2
Tropical Depression,Fourteen,8,2002-10-16T09:00:00Z,24.7N  77.0W,25,7,0,0,32
Tropical Depression,Fourteen,8,2002-10-16T09:00:00Z,MYAK 241N 776W,35,2,0,0,37
Tropical Depression,Fourteen,8,2002-10-16T09:00:00Z,27.5N  74.5W,0,18,0,0,18
Tropical Depression,Fourteen,8,2002-10-16T09:00:00Z,MYNN 251N 775W,26,5,0,0,31
Tropical Depression,Fourteen,8,2002-10-16T09:00:00Z,MWCG 193N 814W,50,0,0,0,50
Tropical Depression,Fourteen,8,2002-10-16T09:00:00Z,MYGF 266N 787W,11,7,0,0,18
Tropical Depression,Fourteen,8,2002-10-16T09:00:00Z,MUGM 200N 751W,1,1,0,0,2
Tropical Depression,Fourteen,8,2002-10-16T09:00:00Z,MARATHON FL,10,0,0,0,10
Tropical Depression,Fourteen,8,2002-10-16T09:00:00Z,MUCM 214N 779W,31,0,0,0,31
Tropical Depression,Fourteen,8,2002-10-16T09:00:00Z,MIAMI FL,11,1,0,0,12
Tropical Depression,Fourteen,8,2002-10-16T09:00:00Z,MUCF 221N 805W,72,0,0,0,72
Tropical Depression,Fourteen,8,2002-10-16T09:00:00Z,W PALM BEACH FL,6,1,0,0,7
Tropical Depression,Fourteen,8,2002-10-16T09:00:00Z,MYMM 224N 730W,0,5,0,0,5
Tropical Depression,Fourteen,8,2002-10-16T09:00:00Z,FT PIERCE FL,2,1,0,0,3
Tropical Depression,Fourteen,8,2002-10-16T09:00:00Z,MYSM 241N 745W,2,18,0,0,20
Tropical Depression,Fourteen,8,2002-10-16T09:00:00Z,KEY WEST FL,3,0,0,0,3
Tropical Depression,Fourteen,8,2002-10-16T09:00:00Z,MYEG 235N 758W,15,11,0,0,26
Tropical Depression,Fourteen,9,2002-10-16T15:00:00Z,26.5N  76.0W,35,5,0,0,40
Tropical Depression,Fourteen,9,2002-10-16T15:00:00Z,MYGF 266N 787W,29,2,0,0,31
Tropical Depression,Fourteen,9,2002-10-16T15:00:00Z,30.0N  72.0W,0,20,0,0,20
Tropical Depression,Fourteen,9,2002-10-16T15:00:00Z,MARATHON FL,8,0,0,0,8
Tropical Depression,Fourteen,9,2002-10-16T15:00:00Z,MUCM 214N 779W,11,0,0,0,11
Tropical Depression,Fourteen,9,2002-10-16T15:00:00Z,MIAMI FL,15,1,0,0,16
Tropical Depression,Fourteen,9,2002-10-16T15:00:00Z,MUCF 221N 805W,99,0,0,0,99
Tropical Depression,Fourteen,9,2002-10-16T15:00:00Z,W PALM BEACH FL,11,1,0,0,12
Tropical Depression,Fourteen,9,2002-10-16T15:00:00Z,MYSM 241N 745W,12,6,0,0,18
Tropical Depression,Fourteen,9,2002-10-16T15:00:00Z,FT PIERCE FL,5,1,0,0,6
Tropical Depression,Fourteen,9,2002-10-16T15:00:00Z,MYEG 235N 758W,22,2,0,0,24
Tropical Depression,Fourteen,9,2002-10-16T15:00:00Z,COCOA BEACH FL,2,0,0,0,2
Tropical Depression,Fourteen,9,2002-10-16T15:00:00Z,MYAK 241N 776W,52,0,0,0,52
Tropical Depression,Fourteen,9,2002-10-16T15:00:00Z,KEY WEST FL,2,0,0,0,2
Tropical Depression,Fourteen,9,2002-10-16T15:00:00Z,MYNN 251N 775W,48,0,0,0,48
Tropical Depression,Fourteen,10,2002-10-16T21:00:00Z,26.5N  76.0W,35,7,0,0,42
Tropical Depression,Fourteen,10,2002-10-16T21:00:00Z,MYAK 241N 776W,62,0,0,0,62
Tropical Depression,Fourteen,10,2002-10-16T21:00:00Z,30.0N  72.0W,0,19,0,0,19
Tropical Depression,Fourteen,10,2002-10-16T21:00:00Z,MYNN 251N 775W,53,0,0,0,53
Tropical Depression,Fourteen,10,2002-10-16T21:00:00Z,MUCM 214N 779W,7,0,0,0,7
Tropical Depression,Fourteen,10,2002-10-16T21:00:00Z,MYGF 266N 787W,20,2,0,0,22
Tropical Depression,Fourteen,10,2002-10-16T21:00:00Z,MUCF 221N 805W,99,0,0,0,99
Tropical Depression,Fourteen,10,2002-10-16T21:00:00Z,MIAMI FL,3,0,0,0,3
Tropical Depression,Fourteen,10,2002-10-16T21:00:00Z,MYSM 241N 745W,10,7,0,0,17
Tropical Depression,Fourteen,10,2002-10-16T21:00:00Z,W PALM BEACH FL,2,1,0,0,3
Tropical Depression,Fourteen,10,2002-10-16T21:00:00Z,MYEG 235N 758W,24,2,0,0,26
Tropical Storm,Ana,1,2003-04-21T03:00:00Z,30.3N  62.5W,51,0,0,0,51
Tropical Storm,Ana,1,2003-04-21T03:00:00Z,30.0N  56.5W,0,2,15,3,20
Tropical Storm,Ana,1,2003-04-21T03:00:00Z,30.0N  59.8W,1,26,2,0,29
Tropical Storm,Ana,1,2003-04-21T03:00:00Z,BERMUDA,39,0,0,0,39
Tropical Storm,Ana,2,2003-04-21T09:00:00Z,29.2N  61.5W,49,1,0,0,50
Tropical Storm,Ana,2,2003-04-21T09:00:00Z,29.5N  55.5W,0,3,14,2,19
Tropical Storm,Ana,2,2003-04-21T09:00:00Z,29.2N  58.5W,0,27,1,0,28
Tropical Storm,Ana,2,2003-04-21T09:00:00Z,BERMUDA,1,0,0,1,2
Tropical Storm,Ana,3,2003-04-21T15:00:00Z,29.3N  59.6W,51,2,0,0,53
Tropical Storm,Ana,3,2003-04-21T15:00:00Z,30.0N  53.0W,0,4,13,2,19
Tropical Storm,Ana,3,2003-04-21T15:00:00Z,29.6N  56.1W,0,28,1,0,29
Tropical Storm,Ana,5,2003-04-22T03:00:00Z,29.9N  54.2W,38,4,0,0,42
Tropical Storm,Ana,5,2003-04-22T03:00:00Z,31.4N  46.5W,0,2,13,2,17
Tropical Storm,Ana,5,2003-04-22T03:00:00Z,30.7N  50.4W,0,21,3,0,24
Tropical Storm,Ana,6,2003-04-22T09:00:00Z,30.7N  52.5W,33,5,0,0,38
Tropical Storm,Ana,6,2003-04-22T09:00:00Z,32.0N  45.0W,0,3,11,3,17
Tropical Storm,Ana,6,2003-04-22T09:00:00Z,31.5N  48.5W,0,20,2,0,22
Tropical Storm,Ana,7,2003-04-22T15:00:00Z,31.4N  51.2W,31,2,0,0,33
Tropical Storm,Ana,7,2003-04-22T15:00:00Z,32.4N  45.0W,0,7,8,2,17
Tropical Storm,Ana,7,2003-04-22T15:00:00Z,31.9N  47.5W,0,19,1,1,21
Tropical Storm,Ana,8,2003-04-22T21:00:00Z,31.5N  49.8W,38,1,0,0,39
Tropical Storm,Ana,8,2003-04-22T21:00:00Z,32.1N  44.3W,0,16,4,1,21
Tropical Storm,Ana,8,2003-04-22T21:00:00Z,31.9N  46.7W,9,18,0,1,28
Tropical Storm,Ana,9,2003-04-23T03:00:00Z,31.5N  48.1W,32,0,0,0,32
Tropical Storm,Ana,9,2003-04-23T03:00:00Z,32.2N  42.8W,0,10,5,2,17
Tropical Storm,Ana,9,2003-04-23T03:00:00Z,31.9N  45.3W,8,12,1,1,22
Tropical Storm,Ana,10,2003-04-23T09:00:00Z,31.8N  46.2W,38,0,0,0,38
Tropical Storm,Ana,10,2003-04-23T09:00:00Z,32.5N  40.5W,0,11,6,2,19
Tropical Storm,Ana,10,2003-04-23T09:00:00Z,32.1N  43.5W,14,10,1,0,25
Tropical Storm,Ana,11,2003-04-23T15:00:00Z,32.9N  45.5W,26,1,0,0,27
Tropical Storm,Ana,11,2003-04-23T15:00:00Z,33.5N  40.0W,0,10,7,2,19
Tropical Storm,Ana,11,2003-04-23T15:00:00Z,33.4N  43.1W,9,10,2,1,22
Tropical Storm,Ana,12,2003-04-23T21:00:00Z,33.0N  46.0W,28,0,1,0,29
Tropical Storm,Ana,12,2003-04-23T21:00:00Z,33.9N  39.5W,0,10,7,2,19
Tropical Storm,Ana,12,2003-04-23T21:00:00Z,33.6N  43.0W,8,13,1,1,23
Tropical Storm,Ana,13,2003-04-24T03:00:00Z,33.0N  44.5W,26,1,1,0,28
Tropical Storm,Ana,13,2003-04-24T03:00:00Z,34.0N  37.5W,0,10,7,1,18
Tropical Storm,Ana,13,2003-04-24T03:00:00Z,33.5N  41.0W,5,15,2,0,22
Tropical Depression,Two,1,2003-06-11T03:00:00Z,10.5N  47.0W,48,0,0,0,48
Tropical Depression,Two,1,2003-06-11T03:00:00Z,TDPR 153N 614W,0,0,0,7,7
Tropical Depression,Two,1,2003-06-11T03:00:00Z,11.5N  49.5W,12,22,0,0,34
Tropical Depression,Two,1,2003-06-11T03:00:00Z,SVBS 157N 636W,0,0,0,3,3
Tropical Depression,Two,1,2003-06-11T03:00:00Z,12.5N  52.0W,0,18,7,1,26
Tropical Depression,Two,1,2003-06-11T03:00:00Z,TFFR 163N 615W,0,0,0,8,8
Tropical Depression,Two,1,2003-06-11T03:00:00Z,TTPP 106N 614W,0,0,0,2,2
Tropical Depression,Two,1,2003-06-11T03:00:00Z,TAPA 171N 618W,0,0,0,7,7
Tropical Depression,Two,1,2003-06-11T03:00:00Z,TTPT 112N 608W,0,0,0,4,4
Tropical Depression,Two,1,2003-06-11T03:00:00Z,TKPK 173N 627W,0,0,0,5,5
Tropical Depression,Two,1,2003-06-11T03:00:00Z,TGPY 120N 618W,0,0,0,3,3
Tropical Depression,Two,1,2003-06-11T03:00:00Z,TNCM 181N 631W,0,0,0,4,4
Tropical Depression,Two,1,2003-06-11T03:00:00Z,TBPB 131N 595W,0,0,0,10,10
Tropical Depression,Two,1,2003-06-11T03:00:00Z,TISX 177N 648W,0,0,0,2,2
Tropical Depression,Two,1,2003-06-11T03:00:00Z,TVSV 131N 612W,0,0,0,6,6
Tropical Depression,Two,1,2003-06-11T03:00:00Z,TIST 183N 650W,0,0,0,2,2
Tropical Depression,Two,1,2003-06-11T03:00:00Z,TLPL 138N 610W,0,0,0,7,7
Tropical Depression,Two,1,2003-06-11T03:00:00Z,ST CROIX VI,0,0,0,2,2
Tropical Depression,Two,1,2003-06-11T03:00:00Z,TFFF 146N 610W,0,0,0,8,8
Tropical Depression,Two,1,2003-06-11T03:00:00Z,ST THOMAS VI,0,0,0,2,2
Tropical Depression,Two,2,2003-06-11T09:00:00Z,11.2N  48.3W,48,0,0,0,48
Tropical Depression,Two,2,2003-06-11T09:00:00Z,TDPR 153N 614W,0,0,0,9,9
Tropical Depression,Two,2,2003-06-11T09:00:00Z,12.1N  50.8W,12,22,0,0,34
Tropical Depression,Two,2,2003-06-11T09:00:00Z,SVBS 157N 636W,0,0,0,4,4
Tropical Depression,Two,2,2003-06-11T09:00:00Z,13.0N  53.0W,0,20,6,0,26
Tropical Depression,Two,2,2003-06-11T09:00:00Z,TFFR 163N 615W,0,0,0,10,10
Tropical Depression,Two,2,2003-06-11T09:00:00Z,TTPP 106N 614W,0,0,0,3,3
Tropical Depression,Two,2,2003-06-11T09:00:00Z,TAPA 171N 618W,0,0,0,9,9
Tropical Depression,Two,2,2003-06-11T09:00:00Z,TTPT 112N 608W,0,0,0,5,5
Tropical Depression,Two,2,2003-06-11T09:00:00Z,TKPK 173N 627W,0,0,0,7,7
Tropical Depression,Two,2,2003-06-11T09:00:00Z,TGPY 120N 618W,0,0,0,4,4
Tropical Depression,Two,2,2003-06-11T09:00:00Z,TNCM 181N 631W,0,0,0,6,6
Tropical Depression,Two,2,2003-06-11T09:00:00Z,TBPB 131N 595W,0,0,0,11,11
Tropical Depression,Two,2,2003-06-11T09:00:00Z,TISX 177N 648W,0,0,0,2,2
Tropical Depression,Two,2,2003-06-11T09:00:00Z,TVSV 131N 612W,0,0,0,7,7
Tropical Depression,Two,2,2003-06-11T09:00:00Z,TIST 183N 650W,0,0,0,2,2
Tropical Depression,Two,2,2003-06-11T09:00:00Z,TLPL 138N 610W,0,0,0,9,9
Tropical Depression,Two,2,2003-06-11T09:00:00Z,ST CROIX VI,0,0,0,2,2
Tropical Depression,Two,2,2003-06-11T09:00:00Z,TFFF 146N 610W,0,0,0,10,10
Tropical Depression,Two,2,2003-06-11T09:00:00Z,ST THOMAS VI,0,0,0,2,2
Tropical Depression,Two,3,2003-06-11T15:00:00Z,11.0N  50.3W,47,0,0,0,47
Tropical Depression,Two,3,2003-06-11T15:00:00Z,TFFR 163N 615W,0,0,2,14,16
Tropical Depression,Two,3,2003-06-11T15:00:00Z,11.7N  52.8W,12,21,0,0,33
Tropical Depression,Two,3,2003-06-11T15:00:00Z,TAPA 171N 618W,0,0,1,14,15
Tropical Depression,Two,3,2003-06-11T15:00:00Z,12.5N  55.5W,0,16,10,1,27
Tropical Depression,Two,3,2003-06-11T15:00:00Z,TKPK 173N 627W,0,0,0,13,13
Tropical Depression,Two,3,2003-06-11T15:00:00Z,SVMG 110N 640W,0,0,0,5,5
Tropical Depression,Two,3,2003-06-11T15:00:00Z,TNCM 181N 631W,0,0,0,12,12
Tropical Depression,Two,3,2003-06-11T15:00:00Z,TTPP 106N 614W,0,0,0,10,10
Tropical Depression,Two,3,2003-06-11T15:00:00Z,TISX 177N 648W,0,0,0,9,9
Tropical Depression,Two,3,2003-06-11T15:00:00Z,TTPT 112N 608W,0,0,1,12,13
Tropical Depression,Two,3,2003-06-11T15:00:00Z,TIST 183N 650W,0,0,0,8,8
Tropical Depression,Two,3,2003-06-11T15:00:00Z,TGPY 120N 618W,0,0,0,12,12
Tropical Depression,Two,3,2003-06-11T15:00:00Z,TJPS 180N 666W,0,0,0,5,5
Tropical Depression,Two,3,2003-06-11T15:00:00Z,TBPB 131N 595W,0,0,8,11,19
Tropical Depression,Two,3,2003-06-11T15:00:00Z,TJSJ 184N 661W,0,0,0,6,6
Tropical Depression,Two,3,2003-06-11T15:00:00Z,TVSV 131N 612W,0,0,1,14,15
Tropical Depression,Two,3,2003-06-11T15:00:00Z,ST CROIX VI,0,0,0,9,9
Tropical Depression,Two,3,2003-06-11T15:00:00Z,TLPL 138N 610W,0,0,2,15,17
Tropical Depression,Two,3,2003-06-11T15:00:00Z,ST THOMAS VI,0,0,0,8,8
Tropical Depression,Two,3,2003-06-11T15:00:00Z,TFFF 146N 610W,0,0,3,14,17
Tropical Depression,Two,3,2003-06-11T15:00:00Z,SAN JUAN PR,0,0,0,6,6
Tropical Depression,Two,3,2003-06-11T15:00:00Z,TDPR 153N 614W,0,0,2,14,16
Tropical Depression,Two,3,2003-06-11T15:00:00Z,PONCE PR,0,0,0,5,5
Tropical Depression,Two,3,2003-06-11T15:00:00Z,SVBS 157N 636W,0,0,0,12,12
Tropical Depression,Two,4,2003-06-11T21:00:00Z,10.4N  52.3W,48,1,0,0,49
Tropical Depression,Two,4,2003-06-11T21:00:00Z,SVBS 157N 636W,0,0,0,16,16
Tropical Depression,Two,4,2003-06-11T21:00:00Z,11.0N  55.5W,1,34,1,0,36
Tropical Depression,Two,4,2003-06-11T21:00:00Z,TFFR 163N 615W,0,0,1,11,12
Tropical Depression,Two,4,2003-06-11T21:00:00Z,11.5N  59.0W,0,3,24,1,28
Tropical Depression,Two,4,2003-06-11T21:00:00Z,TAPA 171N 618W,0,0,0,8,8
Tropical Depression,Two,4,2003-06-11T21:00:00Z,TNCC 122N 690W,0,0,0,7,7
Tropical Depression,Two,4,2003-06-11T21:00:00Z,TKPK 173N 627W,0,0,0,8,8
Tropical Depression,Two,4,2003-06-11T21:00:00Z,SVMG 110N 640W,0,0,1,16,17
Tropical Depression,Two,4,2003-06-11T21:00:00Z,TNCM 181N 631W,0,0,0,5,5
Tropical Depression,Two,4,2003-06-11T21:00:00Z,TTPP 106N 614W,0,0,11,9,20
Tropical Depression,Two,4,2003-06-11T21:00:00Z,TISX 177N 648W,0,0,0,7,7
Tropical Depression,Two,4,2003-06-11T21:00:00Z,TTPT 112N 608W,0,0,17,6,23
Tropical Depression,Two,4,2003-06-11T21:00:00Z,TIST 183N 650W,0,0,0,5,5
Tropical Depression,Two,4,2003-06-11T21:00:00Z,TGPY 120N 618W,0,0,11,13,24
Tropical Depression,Two,4,2003-06-11T21:00:00Z,TJPS 180N 666W,0,0,0,5,5
Tropical Depression,Two,4,2003-06-11T21:00:00Z,TBPB 131N 595W,0,1,22,3,26
Tropical Depression,Two,4,2003-06-11T21:00:00Z,TJSJ 184N 661W,0,0,0,4,4
Tropical Depression,Two,4,2003-06-11T21:00:00Z,TVSV 131N 612W,0,0,13,11,24
Tropical Depression,Two,4,2003-06-11T21:00:00Z,ST CROIX VI,0,0,0,7,7
Tropical Depression,Two,4,2003-06-11T21:00:00Z,TLPL 138N 610W,0,0,11,12,23
Tropical Depression,Two,4,2003-06-11T21:00:00Z,ST THOMAS VI,0,0,0,5,5
Tropical Depression,Two,4,2003-06-11T21:00:00Z,TFFF 146N 610W,0,0,7,13,20
Tropical Depression,Two,4,2003-06-11T21:00:00Z,SAN JUAN PR,0,0,0,4,4
Tropical Depression,Two,4,2003-06-11T21:00:00Z,TDPR 153N 614W,0,0,3,14,17
Tropical Depression,Two,4,2003-06-11T21:00:00Z,PONCE PR,0,0,0,5,5
Tropical Storm,Bill,1,2003-06-29T15:00:00Z,26.8N  93.8W,40,0,0,0,40
Tropical Storm,Bill,1,2003-06-29T15:00:00Z,GALVESTON TX,2,22,1,1,26
Tropical Storm,Bill,1,2003-06-29T15:00:00Z,28.7N  94.2W,9,18,1,0,28
Tropical Storm,Bill,1,2003-06-29T15:00:00Z,FREEPORT TX,3,21,1,1,26
Tropical Storm,Bill,1,2003-06-29T15:00:00Z,30.2N  94.2W,0,17,4,2,23
Tropical Storm,Bill,1,2003-06-29T15:00:00Z,PORT O CONNOR TX,3,17,1,1,22
Tropical Storm,Bill,1,2003-06-29T15:00:00Z,APALACHICOLA FL,0,0,0,2,2
Tropical Storm,Bill,1,2003-06-29T15:00:00Z,CORPUSCHRISTI TX,2,9,1,2,14
Tropical Storm,Bill,1,2003-06-29T15:00:00Z,PANAMA CITY FL,0,0,0,2,2
Tropical Storm,Bill,1,2003-06-29T15:00:00Z,BROWNSVILLE TX,3,2,0,2,7
Tropical Storm,Bill,1,2003-06-29T15:00:00Z,PENSACOLA FL,0,0,0,5,5
Tropical Storm,Bill,1,2003-06-29T15:00:00Z,GULF 29N 87W,0,0,0,4,4
Tropical Storm,Bill,1,2003-06-29T15:00:00Z,MOBILE AL,0,0,1,6,7
Tropical Storm,Bill,1,2003-06-29T15:00:00Z,GULF 28N 89W,0,1,3,4,8
Tropical Storm,Bill,1,2003-06-29T15:00:00Z,GULFPORT MS,0,0,3,6,9
Tropical Storm,Bill,1,2003-06-29T15:00:00Z,GULF 28N 91W,4,9,2,2,17
Tropical Storm,Bill,1,2003-06-29T15:00:00Z,BURAS LA,0,1,5,5,11
Tropical Storm,Bill,1,2003-06-29T15:00:00Z,GULF 28N 93W,20,8,0,1,29
Tropical Storm,Bill,1,2003-06-29T15:00:00Z,NEW ORLEANS LA,0,2,6,5,13
Tropical Storm,Bill,1,2003-06-29T15:00:00Z,GULF 28N 95W,17,12,0,1,30
Tropical Storm,Bill,1,2003-06-29T15:00:00Z,NEW IBERIA LA,0,9,6,3,18
Tropical Storm,Bill,1,2003-06-29T15:00:00Z,GULF 27N 96W,17,5,1,0,23
Tropical Storm,Bill,1,2003-06-29T15:00:00Z,PORT ARTHUR TX,0,18,4,1,23
Tropical Storm,Bill,1,2003-06-29T15:00:00Z,GULF 25N 96W,10,1,1,0,12
Tropical Storm,Bill,2,2003-06-29T21:00:00Z,28.5N  92.5W,37,0,1,0,38
Tropical Storm,Bill,2,2003-06-29T21:00:00Z,PENSACOLA FL,0,0,7,7,14
Tropical Storm,Bill,2,2003-06-29T21:00:00Z,30.5N  92.0W,12,16,1,0,29
Tropical Storm,Bill,2,2003-06-29T21:00:00Z,MOBILE AL,0,3,9,5,17
Tropical Storm,Bill,2,2003-06-29T21:00:00Z,31.5N  90.5W,1,14,5,2,22
Tropical Storm,Bill,2,2003-06-29T21:00:00Z,GULFPORT MS,0,8,7,4,19
Tropical Storm,Bill,2,2003-06-29T21:00:00Z,FT PIERCE FL,0,0,0,2,2
Tropical Storm,Bill,2,2003-06-29T21:00:00Z,BURAS LA,4,11,3,1,19
Tropical Storm,Bill,2,2003-06-29T21:00:00Z,COCOA BEACH FL,0,0,0,2,2
Tropical Storm,Bill,2,2003-06-29T21:00:00Z,NEW ORLEANS LA,6,13,3,1,23
Tropical Storm,Bill,2,2003-06-29T21:00:00Z,DAYTONA BEACH FL,0,0,0,3,3
Tropical Storm,Bill,2,2003-06-29T21:00:00Z,NEW IBERIA LA,18,12,0,1,31
Tropical Storm,Bill,2,2003-06-29T21:00:00Z,JACKSONVILLE FL,0,0,0,5,5
Tropical Storm,Bill,2,2003-06-29T21:00:00Z,PORT ARTHUR TX,17,9,1,0,27
Tropical Storm,Bill,2,2003-06-29T21:00:00Z,SAVANNAH GA,0,0,0,5,5
Tropical Storm,Bill,2,2003-06-29T21:00:00Z,GALVESTON TX,14,6,0,0,20
Tropical Storm,Bill,2,2003-06-29T21:00:00Z,CHARLESTON SC,0,0,0,4,4
Tropical Storm,Bill,2,2003-06-29T21:00:00Z,FREEPORT TX,8,5,1,0,14
Tropical Storm,Bill,2,2003-06-29T21:00:00Z,MYRTLE BEACH SC,0,0,0,2,2
Tropical Storm,Bill,2,2003-06-29T21:00:00Z,PORT O CONNOR TX,2,1,1,0,4
Tropical Storm,Bill,2,2003-06-29T21:00:00Z,FT MYERS FL,0,0,0,2,2
Tropical Storm,Bill,2,2003-06-29T21:00:00Z,GULF 29N 85W,0,0,1,7,8
Tropical Storm,Bill,2,2003-06-29T21:00:00Z,VENICE FL,0,0,0,3,3
Tropical Storm,Bill,2,2003-06-29T21:00:00Z,GULF 29N 87W,0,0,5,7,12
Tropical Storm,Bill,2,2003-06-29T21:00:00Z,TAMPA FL,0,0,0,4,4
Tropical Storm,Bill,2,2003-06-29T21:00:00Z,GULF 28N 89W,5,5,3,2,15
Tropical Storm,Bill,2,2003-06-29T21:00:00Z,CEDAR KEY FL,0,0,0,6,6
Tropical Storm,Bill,2,2003-06-29T21:00:00Z,GULF 28N 91W,33,0,1,0,34
Tropical Storm,Bill,2,2003-06-29T21:00:00Z,ST MARKS FL,0,0,0,9,9
Tropical Storm,Bill,2,2003-06-29T21:00:00Z,GULF 28N 93W,40,0,0,0,40
Tropical Storm,Bill,2,2003-06-29T21:00:00Z,APALACHICOLA FL,0,0,1,8,9
Tropical Storm,Bill,2,2003-06-29T21:00:00Z,GULF 28N 95W,13,2,1,0,16
Tropical Storm,Bill,2,2003-06-29T21:00:00Z,PANAMA CITY FL,0,0,2,9,11
Tropical Storm,Bill,2,2003-06-29T21:00:00Z,GULF 27N 96W,2,0,1,0,3
Tropical Storm,Bill,3,2003-06-30T03:00:00Z,29.6N  91.9W,47,0,0,0,47
Tropical Storm,Bill,3,2003-06-30T03:00:00Z,APALACHICOLA FL,0,0,2,7,9
Tropical Storm,Bill,3,2003-06-30T03:00:00Z,31.9N  91.0W,10,25,0,0,35
Tropical Storm,Bill,3,2003-06-30T03:00:00Z,PANAMA CITY FL,0,0,4,7,11
Tropical Storm,Bill,3,2003-06-30T03:00:00Z,33.3N  88.5W,0,6,16,2,24
Tropical Storm,Bill,3,2003-06-30T03:00:00Z,PENSACOLA FL,0,1,11,3,15
Tropical Storm,Bill,3,2003-06-30T03:00:00Z,FT PIERCE FL,0,0,0,2,2
Tropical Storm,Bill,3,2003-06-30T03:00:00Z,MOBILE AL,0,8,11,1,20
Tropical Storm,Bill,3,2003-06-30T03:00:00Z,COCOA BEACH FL,0,0,0,3,3
Tropical Storm,Bill,3,2003-06-30T03:00:00Z,GULFPORT MS,4,13,5,1,23
Tropical Storm,Bill,3,2003-06-30T03:00:00Z,DAYTONA BEACH FL,0,0,0,4,4
Tropical Storm,Bill,3,2003-06-30T03:00:00Z,BURAS LA,16,6,1,0,23
Tropical Storm,Bill,3,2003-06-30T03:00:00Z,JACKSONVILLE FL,0,0,0,7,7
Tropical Storm,Bill,3,2003-06-30T03:00:00Z,NEW ORLEANS LA,25,7,0,0,32
Tropical Storm,Bill,3,2003-06-30T03:00:00Z,SAVANNAH GA,0,0,0,8,8
Tropical Storm,Bill,3,2003-06-30T03:00:00Z,NEW IBERIA LA,44,0,0,0,44
Tropical Storm,Bill,3,2003-06-30T03:00:00Z,CHARLESTON SC,0,0,0,7,7
Tropical Storm,Bill,3,2003-06-30T03:00:00Z,PORT ARTHUR TX,23,3,0,1,27
Tropical Storm,Bill,3,2003-06-30T03:00:00Z,MYRTLE BEACH SC,0,0,0,6,6
Tropical Storm,Bill,3,2003-06-30T03:00:00Z,GALVESTON TX,10,3,0,0,13
Tropical Storm,Bill,3,2003-06-30T03:00:00Z,WILMINGTON NC,0,0,0,4,4
Tropical Storm,Bill,3,2003-06-30T03:00:00Z,FREEPORT TX,3,1,0,0,4
Tropical Storm,Bill,3,2003-06-30T03:00:00Z,MOREHEAD CITY NC,0,0,0,3,3
Tropical Storm,Bill,3,2003-06-30T03:00:00Z,GULF 29N 85W,0,0,2,6,8
Tropical Storm,Bill,3,2003-06-30T03:00:00Z,CAPE HATTERAS NC,0,0,0,2,2
Tropical Storm,Bill,3,2003-06-30T03:00:00Z,GULF 29N 87W,0,0,6,4,10
Tropical Storm,Bill,3,2003-06-30T03:00:00Z,NORFOLK VA,0,0,0,2,2
Tropical Storm,Bill,3,2003-06-30T03:00:00Z,GULF 28N 89W,8,3,2,0,13
Tropical Storm,Bill,3,2003-06-30T03:00:00Z,VENICE FL,0,0,0,2,2
Tropical Storm,Bill,3,2003-06-30T03:00:00Z,GULF 28N 91W,63,0,0,0,63
Tropical Storm,Bill,3,2003-06-30T03:00:00Z,TAMPA FL,0,0,0,3,3
Tropical Storm,Bill,3,2003-06-30T03:00:00Z,GULF 28N 93W,44,0,0,0,44
Tropical Storm,Bill,3,2003-06-30T03:00:00Z,CEDAR KEY FL,0,0,0,6,6
Tropical Storm,Bill,3,2003-06-30T03:00:00Z,GULF 28N 95W,3,1,0,0,4
Tropical Storm,Bill,3,2003-06-30T03:00:00Z,ST MARKS FL,0,0,1,8,9
Tropical Storm,Bill,4,2003-06-30T09:00:00Z,32.0N  91.0W,40,1,0,0,41
Tropical Storm,Bill,4,2003-06-30T09:00:00Z,CEDAR KEY FL,0,0,1,3,4
Tropical Storm,Bill,4,2003-06-30T09:00:00Z,34.0N  89.0W,7,18,1,0,26
Tropical Storm,Bill,4,2003-06-30T09:00:00Z,ST MARKS FL,0,0,3,4,7
Tropical Storm,Bill,4,2003-06-30T09:00:00Z,35.0N  86.0W,0,3,13,3,19
Tropical Storm,Bill,4,2003-06-30T09:00:00Z,APALACHICOLA FL,0,0,4,3,7
Tropical Storm,Bill,4,2003-06-30T09:00:00Z,COCOA BEACH FL,0,0,0,2,2
Tropical Storm,Bill,4,2003-06-30T09:00:00Z,PANAMA CITY FL,0,1,4,3,8
Tropical Storm,Bill,4,2003-06-30T09:00:00Z,DAYTONA BEACH FL,0,0,0,4,4
Tropical Storm,Bill,4,2003-06-30T09:00:00Z,PENSACOLA FL,1,6,4,1,12
Tropical Storm,Bill,4,2003-06-30T09:00:00Z,JACKSONVILLE FL,0,0,1,6,7
Tropical Storm,Bill,4,2003-06-30T09:00:00Z,MOBILE AL,7,9,1,0,17
Tropical Storm,Bill,4,2003-06-30T09:00:00Z,SAVANNAH GA,0,0,1,8,9
Tropical Storm,Bill,4,2003-06-30T09:00:00Z,GULFPORT MS,18,3,1,0,22
Tropical Storm,Bill,4,2003-06-30T09:00:00Z,CHARLESTON SC,0,0,0,9,9
Tropical Storm,Bill,4,2003-06-30T09:00:00Z,BURAS LA,26,0,0,0,26
Tropical Storm,Bill,4,2003-06-30T09:00:00Z,MYRTLE BEACH SC,0,0,0,9,9
Tropical Storm,Bill,4,2003-06-30T09:00:00Z,NEW ORLEANS LA,45,1,0,0,46
Tropical Storm,Bill,4,2003-06-30T09:00:00Z,WILMINGTON NC,0,0,0,8,8
Tropical Storm,Bill,4,2003-06-30T09:00:00Z,NEW IBERIA LA,63,0,0,0,63
Tropical Storm,Bill,4,2003-06-30T09:00:00Z,MOREHEAD CITY NC,0,0,0,7,7
Tropical Storm,Bill,4,2003-06-30T09:00:00Z,PORT ARTHUR TX,13,1,0,0,14
Tropical Storm,Bill,4,2003-06-30T09:00:00Z,CAPE HATTERAS NC,0,0,0,5,5
Tropical Storm,Bill,4,2003-06-30T09:00:00Z,GULF 29N 85W,0,0,2,3,5
Tropical Storm,Bill,4,2003-06-30T09:00:00Z,NORFOLK VA,0,0,0,6,6
Tropical Storm,Bill,4,2003-06-30T09:00:00Z,GULF 29N 87W,0,2,3,1,6
Tropical Storm,Bill,4,2003-06-30T09:00:00Z,OCEAN CITY MD,0,0,0,4,4
Tropical Storm,Bill,4,2003-06-30T09:00:00Z,GULF 28N 89W,3,2,1,0,6
Tropical Storm,Bill,4,2003-06-30T09:00:00Z,ATLANTIC CITY NJ,0,0,0,3,3
Tropical Storm,Bill,4,2003-06-30T09:00:00Z,GULF 28N 91W,99,0,0,0,99
Tropical Storm,Bill,4,2003-06-30T09:00:00Z,NEW YORK CITY NY,0,0,0,2,2
Tropical Storm,Bill,4,2003-06-30T09:00:00Z,GULF 28N 93W,57,0,0,0,57
Tropical Storm,Bill,4,2003-06-30T09:00:00Z,TAMPA FL,0,0,0,2,2
Tropical Storm,Bill,5,2003-06-30T15:00:00Z,32.7N  90.5W,32,0,0,0,32
Tropical Storm,Bill,5,2003-06-30T15:00:00Z,CEDAR KEY FL,0,0,1,2,3
Tropical Storm,Bill,5,2003-06-30T15:00:00Z,34.6N  88.7W,5,16,1,0,22
Tropical Storm,Bill,5,2003-06-30T15:00:00Z,ST MARKS FL,0,0,3,3,6
Tropical Storm,Bill,5,2003-06-30T15:00:00Z,36.0N  86.0W,0,4,11,3,18
Tropical Storm,Bill,5,2003-06-30T15:00:00Z,APALACHICOLA FL,0,1,1,2,4
Tropical Storm,Bill,5,2003-06-30T15:00:00Z,DAYTONA BEACH FL,0,0,0,3,3
Tropical Storm,Bill,5,2003-06-30T15:00:00Z,PANAMA CITY FL,0,2,2,2,6
Tropical Storm,Bill,5,2003-06-30T15:00:00Z,JACKSONVILLE FL,0,0,1,4,5
Tropical Storm,Bill,5,2003-06-30T15:00:00Z,PENSACOLA FL,2,6,1,1,10
Tropical Storm,Bill,5,2003-06-30T15:00:00Z,SAVANNAH GA,0,0,1,7,8
Tropical Storm,Bill,5,2003-06-30T15:00:00Z,MOBILE AL,9,5,0,1,15
Tropical Storm,Bill,5,2003-06-30T15:00:00Z,CHARLESTON SC,0,0,1,7,8
Tropical Storm,Bill,5,2003-06-30T15:00:00Z,GULFPORT MS,18,1,0,0,19
Tropical Storm,Bill,5,2003-06-30T15:00:00Z,MYRTLE BEACH SC,0,0,0,8,8
Tropical Storm,Bill,5,2003-06-30T15:00:00Z,BURAS LA,21,0,0,1,22
Tropical Storm,Bill,5,2003-06-30T15:00:00Z,WILMINGTON NC,0,0,0,7,7
Tropical Storm,Bill,5,2003-06-30T15:00:00Z,NEW ORLEANS LA,42,0,0,0,42
Tropical Storm,Bill,5,2003-06-30T15:00:00Z,MOREHEAD CITY NC,0,0,0,6,6
Tropical Storm,Bill,5,2003-06-30T15:00:00Z,NEW IBERIA LA,69,0,0,1,70
Tropical Storm,Bill,5,2003-06-30T15:00:00Z,CAPE HATTERAS NC,0,0,0,5,5
Tropical Storm,Bill,5,2003-06-30T15:00:00Z,GULF 29N 85W,0,0,1,2,3
Tropical Storm,Bill,5,2003-06-30T15:00:00Z,NORFOLK VA,0,0,0,6,6
Tropical Storm,Bill,5,2003-06-30T15:00:00Z,GULF 29N 87W,0,2,1,1,4
Tropical Storm,Bill,5,2003-06-30T15:00:00Z,OCEAN CITY MD,0,0,0,4,4
Tropical Storm,Bill,5,2003-06-30T15:00:00Z,GULF 28N 89W,2,0,0,0,2
Tropical Storm,Bill,5,2003-06-30T15:00:00Z,ATLANTIC CITY NJ,0,0,0,3,3
Tropical Storm,Bill,5,2003-06-30T15:00:00Z,GULF 28N 91W,99,0,0,0,99
Tropical Storm,Bill,6,2003-06-30T21:00:00Z,32.9N  89.1W,35,1,0,0,36
Tropical Storm,Bill,6,2003-06-30T21:00:00Z,TAMPA FL,0,0,1,1,2
Tropical Storm,Bill,6,2003-06-30T21:00:00Z,34.8N  86.8W,9,11,1,0,21
Tropical Storm,Bill,6,2003-06-30T21:00:00Z,CEDAR KEY FL,0,0,2,2,4
Tropical Storm,Bill,6,2003-06-30T21:00:00Z,36.0N  84.4W,0,6,7,3,16
Tropical Storm,Bill,6,2003-06-30T21:00:00Z,ST MARKS FL,0,2,3,2,7
Tropical Storm,Bill,6,2003-06-30T21:00:00Z,COCOA BEACH FL,0,0,0,2,2
Tropical Storm,Bill,6,2003-06-30T21:00:00Z,APALACHICOLA FL,0,2,3,1,6
Tropical Storm,Bill,6,2003-06-30T21:00:00Z,DAYTONA BEACH FL,0,0,1,2,3
Tropical Storm,Bill,6,2003-06-30T21:00:00Z,PANAMA CITY FL,0,4,2,1,7
Tropical Storm,Bill,6,2003-06-30T21:00:00Z,JACKSONVILLE FL,0,0,3,3,6
Tropical Storm,Bill,6,2003-06-30T21:00:00Z,PENSACOLA FL,8,5,0,1,14
Tropical Storm,Bill,6,2003-06-30T21:00:00Z,SAVANNAH GA,0,0,4,5,9
Tropical Storm,Bill,6,2003-06-30T21:00:00Z,MOBILE AL,24,1,0,0,25
Tropical Storm,Bill,6,2003-06-30T21:00:00Z,CHARLESTON SC,0,0,2,7,9
Tropical Storm,Bill,6,2003-06-30T21:00:00Z,GULFPORT MS,39,0,0,0,39
Tropical Storm,Bill,6,2003-06-30T21:00:00Z,MYRTLE BEACH SC,0,0,1,7,8
Tropical Storm,Bill,6,2003-06-30T21:00:00Z,BURAS LA,50,0,0,0,50
Tropical Storm,Bill,6,2003-06-30T21:00:00Z,WILMINGTON NC,0,0,0,8,8
Tropical Storm,Bill,6,2003-06-30T21:00:00Z,NEW ORLEANS LA,99,0,0,0,99
Tropical Storm,Bill,6,2003-06-30T21:00:00Z,MOREHEAD CITY NC,0,0,0,7,7
Tropical Storm,Bill,6,2003-06-30T21:00:00Z,NEW IBERIA LA,99,0,0,0,99
Tropical Storm,Bill,6,2003-06-30T21:00:00Z,CAPE HATTERAS NC,0,0,0,6,6
Tropical Storm,Bill,6,2003-06-30T21:00:00Z,GULF 29N 85W,0,1,2,1,4
Tropical Storm,Bill,6,2003-06-30T21:00:00Z,NORFOLK VA,0,0,0,7,7
Tropical Storm,Bill,6,2003-06-30T21:00:00Z,GULF 29N 87W,1,2,1,0,4
Tropical Storm,Bill,6,2003-06-30T21:00:00Z,OCEAN CITY MD,0,0,0,5,5
Tropical Storm,Bill,6,2003-06-30T21:00:00Z,GULF 28N 89W,2,1,0,0,3
Tropical Storm,Bill,6,2003-06-30T21:00:00Z,ATLANTIC CITY NJ,0,0,0,4,4
Tropical Storm,Bill,6,2003-06-30T21:00:00Z,GULF 28N 91W,99,0,0,0,99
Tropical Storm,Bill,6,2003-06-30T21:00:00Z,NEW YORK CITY NY,0,0,0,2,2
Tropical Storm,Bill,7,2003-07-01T03:00:00Z,34.3N  87.5W,52,0,0,0,52
Tropical Storm,Bill,7,2003-07-01T03:00:00Z,ATLANTIC CITY NJ,0,0,0,5,5
Tropical Storm,Bill,7,2003-07-01T03:00:00Z,35.7N  85.1W,15,10,0,1,26
Tropical Storm,Bill,7,2003-07-01T03:00:00Z,NEW YORK CITY NY,0,0,0,4,4
Tropical Storm,Bill,7,2003-07-01T03:00:00Z,36.8N  82.2W,0,7,7,2,16
Tropical Storm,Bill,7,2003-07-01T03:00:00Z,MONTAUK POINT NY,0,0,0,2,2
Tropical Storm,Bill,7,2003-07-01T03:00:00Z,COCOA BEACH FL,0,0,0,2,2
Tropical Storm,Bill,7,2003-07-01T03:00:00Z,CEDAR KEY FL,0,0,1,1,2
Tropical Storm,Bill,7,2003-07-01T03:00:00Z,DAYTONA BEACH FL,0,0,1,2,3
Tropical Storm,Bill,7,2003-07-01T03:00:00Z,ST MARKS FL,0,1,2,1,4
Tropical Storm,Bill,7,2003-07-01T03:00:00Z,JACKSONVILLE FL,0,0,3,3,6
Tropical Storm,Bill,7,2003-07-01T03:00:00Z,APALACHICOLA FL,0,1,1,1,3
Tropical Storm,Bill,7,2003-07-01T03:00:00Z,SAVANNAH GA,0,1,5,3,9
Tropical Storm,Bill,7,2003-07-01T03:00:00Z,PANAMA CITY FL,0,1,1,1,3
Tropical Storm,Bill,7,2003-07-01T03:00:00Z,CHARLESTON SC,0,0,5,5,10
Tropical Storm,Bill,7,2003-07-01T03:00:00Z,PENSACOLA FL,0,2,1,0,3
Tropical Storm,Bill,7,2003-07-01T03:00:00Z,MYRTLE BEACH SC,0,0,4,6,10
Tropical Storm,Bill,7,2003-07-01T03:00:00Z,MOBILE AL,15,0,0,0,15
Tropical Storm,Bill,7,2003-07-01T03:00:00Z,WILMINGTON NC,0,0,2,7,9
Tropical Storm,Bill,7,2003-07-01T03:00:00Z,GULFPORT MS,99,0,0,0,99
Tropical Storm,Bill,7,2003-07-01T03:00:00Z,MOREHEAD CITY NC,0,0,1,7,8
Tropical Storm,Bill,7,2003-07-01T03:00:00Z,BURAS LA,35,0,0,0,35
Tropical Storm,Bill,7,2003-07-01T03:00:00Z,CAPE HATTERAS NC,0,0,0,7,7
Tropical Storm,Bill,7,2003-07-01T03:00:00Z,NEW ORLEANS LA,99,0,0,0,99
Tropical Storm,Bill,7,2003-07-01T03:00:00Z,NORFOLK VA,0,0,1,7,8
Tropical Storm,Bill,7,2003-07-01T03:00:00Z,NEW IBERIA LA,8,0,0,0,8
Tropical Storm,Bill,7,2003-07-01T03:00:00Z,OCEAN CITY MD,0,0,0,6,6
Tropical Storm,Bill,7,2003-07-01T03:00:00Z,GULF 29N 85W,0,0,1,1,2
Tropical Depression,Bill,8,2003-07-01T09:00:00Z,35.0N  85.5W,38,0,0,0,38
Tropical Depression,Bill,8,2003-07-01T09:00:00Z,MOREHEAD CITY NC,0,0,4,0,4
Tropical Depression,Bill,8,2003-07-01T09:00:00Z,36.5N  83.0W,4,15,1,0,20
Tropical Depression,Bill,8,2003-07-01T09:00:00Z,CAPE HATTERAS NC,0,0,2,0,2
Tropical Depression,Bill,8,2003-07-01T09:00:00Z,38.0N  80.0W,0,5,8,0,13
Tropical Depression,Bill,8,2003-07-01T09:00:00Z,NORFOLK VA,0,0,4,0,4
Tropical Depression,Bill,8,2003-07-01T09:00:00Z,JACKSONVILLE FL,0,1,2,0,3
Tropical Depression,Bill,8,2003-07-01T09:00:00Z,OCEAN CITY MD,0,0,2,0,2
Tropical Depression,Bill,8,2003-07-01T09:00:00Z,SAVANNAH GA,0,4,3,0,7
Tropical Depression,Bill,8,2003-07-01T09:00:00Z,ST MARKS FL,0,1,1,0,2
Tropical Depression,Bill,8,2003-07-01T09:00:00Z,CHARLESTON SC,0,3,5,0,8
Tropical Depression,Bill,8,2003-07-01T09:00:00Z,PENSACOLA FL,11,0,0,0,11
Tropical Depression,Bill,8,2003-07-01T09:00:00Z,MYRTLE BEACH SC,0,2,5,0,7
Tropical Depression,Bill,8,2003-07-01T09:00:00Z,MOBILE AL,92,0,0,0,92
Tropical Depression,Bill,8,2003-07-01T09:00:00Z,WILMINGTON NC,0,1,5,0,6
Tropical Depression,Bill,8,2003-07-01T09:00:00Z,GULFPORT MS,99,0,0,0,99
Tropical Storm,Claudette,1,2003-07-08T21:00:00Z,16.9N  79.0W,48,2,0,0,50
Tropical Storm,Claudette,1,2003-07-08T21:00:00Z,MZBZ 175N 883W,0,0,8,8,16
Tropical Storm,Claudette,1,2003-07-08T21:00:00Z,18.0N  82.7W,0,37,1,0,38
Tropical Storm,Claudette,1,2003-07-08T21:00:00Z,MGPB 157N 886W,0,0,1,6,7
Tropical Storm,Claudette,1,2003-07-08T21:00:00Z,19.3N  86.0W,0,4,25,1,30
Tropical Storm,Claudette,1,2003-07-08T21:00:00Z,MHNJ 165N 859W,0,3,12,1,16
Tropical Storm,Claudette,1,2003-07-08T21:00:00Z,MTCA 183N 738W,4,0,0,0,4
Tropical Storm,Claudette,1,2003-07-08T21:00:00Z,MNPC 141N 834W,0,1,1,0,2
Tropical Storm,Claudette,1,2003-07-08T21:00:00Z,MKJP 179N 768W,43,0,0,0,43
Tropical Storm,Claudette,1,2003-07-08T21:00:00Z,MMFR 185N 926W,0,0,0,8,8
Tropical Storm,Claudette,1,2003-07-08T21:00:00Z,MKJS 185N 779W,32,2,0,0,34
Tropical Storm,Claudette,1,2003-07-08T21:00:00Z,MMMD 210N 897W,0,0,5,16,21
Tropical Storm,Claudette,1,2003-07-08T21:00:00Z,MWCG 193N 814W,0,34,1,0,35
Tropical Storm,Claudette,1,2003-07-08T21:00:00Z,GULF 28N 89W,0,0,0,3,3
Tropical Storm,Claudette,1,2003-07-08T21:00:00Z,MUCF 221N 805W,0,2,1,1,4
Tropical Storm,Claudette,1,2003-07-08T21:00:00Z,GULF 28N 91W,0,0,0,4,4
Tropical Storm,Claudette,1,2003-07-08T21:00:00Z,MUSN 216N 826W,0,7,10,0,17
Tropical Storm,Claudette,1,2003-07-08T21:00:00Z,GULF 28N 93W,0,0,0,3,3
Tropical Storm,Claudette,1,2003-07-08T21:00:00Z,MUHA 230N 824W,0,1,4,1,6
Tropical Storm,Claudette,1,2003-07-08T21:00:00Z,GULF 28N 95W,0,0,0,2,2
Tropical Storm,Claudette,1,2003-07-08T21:00:00Z,MUAN 219N 850W,0,1,20,1,22
Tropical Storm,Claudette,1,2003-07-08T21:00:00Z,GULF 27N 96W,0,0,0,2,2
Tropical Storm,Claudette,1,2003-07-08T21:00:00Z,MMCZ 205N 869W,0,0,25,2,27
Tropical Storm,Claudette,1,2003-07-08T21:00:00Z,GULF 25N 96W,0,0,0,3,3
Tropical Storm,Claudette,2,2003-07-09T03:00:00Z,17.0N  80.5W,49,2,0,0,51
Tropical Storm,Claudette,2,2003-07-09T03:00:00Z,MZBZ 175N 883W,0,1,12,3,16
Tropical Storm,Claudette,2,2003-07-09T03:00:00Z,18.5N  84.0W,0,36,1,0,37
Tropical Storm,Claudette,2,2003-07-09T03:00:00Z,MGPB 157N 886W,0,0,3,3,6
Tropical Storm,Claudette,2,2003-07-09T03:00:00Z,19.5N  87.0W,0,6,21,1,28
Tropical Storm,Claudette,2,2003-07-09T03:00:00Z,MHNJ 165N 859W,0,8,7,1,16
Tropical Storm,Claudette,2,2003-07-09T03:00:00Z,MKJP 179N 768W,35,0,0,0,35
Tropical Storm,Claudette,2,2003-07-09T03:00:00Z,MNPC 141N 834W,0,1,0,1,2
Tropical Storm,Claudette,2,2003-07-09T03:00:00Z,MKJS 185N 779W,28,0,0,0,28
Tropical Storm,Claudette,2,2003-07-09T03:00:00Z,MMFR 185N 926W,0,0,0,8,8
Tropical Storm,Claudette,2,2003-07-09T03:00:00Z,MWCG 193N 814W,8,26,0,1,35
Tropical Storm,Claudette,2,2003-07-09T03:00:00Z,MMMD 210N 897W,0,0,13,9,22
Tropical Storm,Claudette,2,2003-07-09T03:00:00Z,MUCF 221N 805W,0,2,0,0,2
Tropical Storm,Claudette,2,2003-07-09T03:00:00Z,GULF 28N 89W,0,0,0,3,3
Tropical Storm,Claudette,2,2003-07-09T03:00:00Z,MUSN 216N 826W,0,11,3,1,15
Tropical Storm,Claudette,2,2003-07-09T03:00:00Z,GULF 28N 91W,0,0,0,3,3
Tropical Storm,Claudette,2,2003-07-09T03:00:00Z,MUHA 230N 824W,0,2,2,1,5
Tropical Storm,Claudette,2,2003-07-09T03:00:00Z,GULF 28N 93W,0,0,0,3,3
Tropical Storm,Claudette,2,2003-07-09T03:00:00Z,MUAN 219N 850W,0,6,14,1,21
Tropical Storm,Claudette,2,2003-07-09T03:00:00Z,GULF 27N 96W,0,0,0,2,2
Tropical Storm,Claudette,2,2003-07-09T03:00:00Z,MMCZ 205N 869W,0,4,23,1,28
Tropical Storm,Claudette,2,2003-07-09T03:00:00Z,GULF 25N 96W,0,0,0,3,3
Tropical Storm,Claudette,3,2003-07-09T09:00:00Z,17.2N  82.5W,47,2,0,0,49
Tropical Storm,Claudette,3,2003-07-09T09:00:00Z,MMTX 210N 974W,0,0,0,2,2
Tropical Storm,Claudette,3,2003-07-09T09:00:00Z,18.7N  85.6W,0,36,0,0,36
Tropical Storm,Claudette,3,2003-07-09T09:00:00Z,MMVR 192N 961W,0,0,0,2,2
Tropical Storm,Claudette,3,2003-07-09T09:00:00Z,20.0N  88.0W,0,11,17,1,29
Tropical Storm,Claudette,3,2003-07-09T09:00:00Z,MMFR 185N 926W,0,0,1,8,9
Tropical Storm,Claudette,3,2003-07-09T09:00:00Z,MKJP 179N 768W,3,0,0,0,3
Tropical Storm,Claudette,3,2003-07-09T09:00:00Z,MMMD 210N 897W,0,0,20,4,24
Tropical Storm,Claudette,3,2003-07-09T09:00:00Z,MKJS 185N 779W,3,0,0,0,3
Tropical Storm,Claudette,3,2003-07-09T09:00:00Z,GALVESTON TX,0,0,0,2,2
Tropical Storm,Claudette,3,2003-07-09T09:00:00Z,MWCG 193N 814W,18,5,0,0,23
Tropical Storm,Claudette,3,2003-07-09T09:00:00Z,FREEPORT TX,0,0,0,2,2
Tropical Storm,Claudette,3,2003-07-09T09:00:00Z,MUSN 216N 826W,0,5,1,1,7
Tropical Storm,Claudette,3,2003-07-09T09:00:00Z,PORT O CONNOR TX,0,0,0,2,2
Tropical Storm,Claudette,3,2003-07-09T09:00:00Z,MUAN 219N 850W,0,12,6,0,18
Tropical Storm,Claudette,3,2003-07-09T09:00:00Z,BROWNSVILLE TX,0,0,0,3,3
Tropical Storm,Claudette,3,2003-07-09T09:00:00Z,MMCZ 205N 869W,0,20,10,0,30
Tropical Storm,Claudette,3,2003-07-09T09:00:00Z,GULF 28N 89W,0,0,0,4,4
Tropical Storm,Claudette,3,2003-07-09T09:00:00Z,MZBZ 175N 883W,0,6,10,2,18
Tropical Storm,Claudette,3,2003-07-09T09:00:00Z,GULF 28N 91W,0,0,0,6,6
Tropical Storm,Claudette,3,2003-07-09T09:00:00Z,MGPB 157N 886W,0,1,3,2,6
Tropical Storm,Claudette,3,2003-07-09T09:00:00Z,GULF 28N 93W,0,0,0,6,6
Tropical Storm,Claudette,3,2003-07-09T09:00:00Z,MHNJ 165N 859W,1,18,1,0,20
Tropical Storm,Claudette,3,2003-07-09T09:00:00Z,GULF 28N 95W,0,0,0,4,4
Tropical Storm,Claudette,3,2003-07-09T09:00:00Z,MMSO 238N 982W,0,0,0,2,2
Tropical Storm,Claudette,3,2003-07-09T09:00:00Z,GULF 27N 96W,0,0,0,4,4
Tropical Storm,Claudette,3,2003-07-09T09:00:00Z,MMTM 222N 979W,0,0,0,2,2
Tropical Storm,Claudette,3,2003-07-09T09:00:00Z,GULF 25N 96W,0,0,0,6,6
Tropical Storm,Claudette,4,2003-07-09T15:00:00Z,17.6N  83.8W,48,1,0,0,49
Tropical Storm,Claudette,4,2003-07-09T15:00:00Z,BURAS LA,0,0,0,2,2
Tropical Storm,Claudette,4,2003-07-09T15:00:00Z,19.1N  86.7W,1,35,0,0,36
Tropical Storm,Claudette,4,2003-07-09T15:00:00Z,NEW ORLEANS LA,0,0,0,2,2
Tropical Storm,Claudette,4,2003-07-09T15:00:00Z,20.5N  89.0W,0,11,17,1,29
Tropical Storm,Claudette,4,2003-07-09T15:00:00Z,NEW IBERIA LA,0,0,0,2,2
Tropical Storm,Claudette,4,2003-07-09T15:00:00Z,MWCG 193N 814W,16,1,0,0,17
Tropical Storm,Claudette,4,2003-07-09T15:00:00Z,PORT ARTHUR TX,0,0,0,2,2
Tropical Storm,Claudette,4,2003-07-09T15:00:00Z,MUSN 216N 826W,0,3,0,0,3
Tropical Storm,Claudette,4,2003-07-09T15:00:00Z,GALVESTON TX,0,0,0,3,3
Tropical Storm,Claudette,4,2003-07-09T15:00:00Z,MUAN 219N 850W,0,12,3,1,16
Tropical Storm,Claudette,4,2003-07-09T15:00:00Z,FREEPORT TX,0,0,0,3,3
Tropical Storm,Claudette,4,2003-07-09T15:00:00Z,MMCZ 205N 869W,0,30,2,0,32
Tropical Storm,Claudette,4,2003-07-09T15:00:00Z,PORT O CONNOR TX,0,0,0,3,3
Tropical Storm,Claudette,4,2003-07-09T15:00:00Z,MZBZ 175N 883W,0,15,4,1,20
Tropical Storm,Claudette,4,2003-07-09T15:00:00Z,CORPUSCHRISTI TX,0,0,0,2,2
Tropical Storm,Claudette,4,2003-07-09T15:00:00Z,MGPB 157N 886W,0,2,2,1,5
Tropical Storm,Claudette,4,2003-07-09T15:00:00Z,BROWNSVILLE TX,0,0,0,4,4
Tropical Storm,Claudette,4,2003-07-09T15:00:00Z,MHNJ 165N 859W,10,13,0,0,23
Tropical Storm,Claudette,4,2003-07-09T15:00:00Z,GULF 28N 89W,0,0,0,5,5
Tropical Storm,Claudette,4,2003-07-09T15:00:00Z,MMSO 238N 982W,0,0,0,2,2
Tropical Storm,Claudette,4,2003-07-09T15:00:00Z,GULF 28N 91W,0,0,0,7,7
Tropical Storm,Claudette,4,2003-07-09T15:00:00Z,MMTM 222N 979W,0,0,0,2,2
Tropical Storm,Claudette,4,2003-07-09T15:00:00Z,GULF 28N 93W,0,0,0,8,8
Tropical Storm,Claudette,4,2003-07-09T15:00:00Z,MMTX 210N 974W,0,0,0,2,2
Tropical Storm,Claudette,4,2003-07-09T15:00:00Z,GULF 28N 95W,0,0,0,6,6
Tropical Storm,Claudette,4,2003-07-09T15:00:00Z,MMVR 192N 961W,0,0,0,2,2
Tropical Storm,Claudette,4,2003-07-09T15:00:00Z,GULF 27N 96W,0,0,0,6,6
Tropical Storm,Claudette,4,2003-07-09T15:00:00Z,MMFR 185N 926W,0,0,3,7,10
Tropical Storm,Claudette,4,2003-07-09T15:00:00Z,GULF 25N 96W,0,0,0,8,8
Tropical Storm,Claudette,4,2003-07-09T15:00:00Z,MMMD 210N 897W,0,4,21,2,27
Tropical Storm,Claudette,5,2003-07-09T21:00:00Z,18.3N  85.6W,48,1,0,0,49
Tropical Storm,Claudette,5,2003-07-09T21:00:00Z,BURAS LA,0,0,0,3,3
Tropical Storm,Claudette,5,2003-07-09T21:00:00Z,19.8N  88.1W,2,32,1,0,35
Tropical Storm,Claudette,5,2003-07-09T21:00:00Z,NEW ORLEANS LA,0,0,0,2,2
Tropical Storm,Claudette,5,2003-07-09T21:00:00Z,21.2N  90.0W,0,16,11,1,28
Tropical Storm,Claudette,5,2003-07-09T21:00:00Z,NEW IBERIA LA,0,0,0,3,3
Tropical Storm,Claudette,5,2003-07-09T21:00:00Z,MWCG 193N 814W,7,0,0,0,7
Tropical Storm,Claudette,5,2003-07-09T21:00:00Z,PORT ARTHUR TX,0,0,0,4,4
Tropical Storm,Claudette,5,2003-07-09T21:00:00Z,MUAN 219N 850W,2,10,0,1,13
Tropical Storm,Claudette,5,2003-07-09T21:00:00Z,GALVESTON TX,0,0,0,5,5
Tropical Storm,Claudette,5,2003-07-09T21:00:00Z,MMCZ 205N 869W,5,29,0,0,34
Tropical Storm,Claudette,5,2003-07-09T21:00:00Z,FREEPORT TX,0,0,0,5,5
Tropical Storm,Claudette,5,2003-07-09T21:00:00Z,MZBZ 175N 883W,5,15,1,0,21
Tropical Storm,Claudette,5,2003-07-09T21:00:00Z,PORT O CONNOR TX,0,0,0,5,5
Tropical Storm,Claudette,5,2003-07-09T21:00:00Z,MGPB 157N 886W,1,1,1,1,4
Tropical Storm,Claudette,5,2003-07-09T21:00:00Z,CORPUSCHRISTI TX,0,0,0,4,4
Tropical Storm,Claudette,5,2003-07-09T21:00:00Z,MHNJ 165N 859W,19,1,0,1,21
Tropical Storm,Claudette,5,2003-07-09T21:00:00Z,BROWNSVILLE TX,0,0,0,6,6
Tropical Storm,Claudette,5,2003-07-09T21:00:00Z,MMSO 238N 982W,0,0,0,4,4
Tropical Storm,Claudette,5,2003-07-09T21:00:00Z,GULF 28N 89W,0,0,0,5,5
Tropical Storm,Claudette,5,2003-07-09T21:00:00Z,MMTM 222N 979W,0,0,0,3,3
Tropical Storm,Claudette,5,2003-07-09T21:00:00Z,GULF 28N 91W,0,0,0,9,9
Tropical Storm,Claudette,5,2003-07-09T21:00:00Z,MMTX 210N 974W,0,0,0,3,3
Tropical Storm,Claudette,5,2003-07-09T21:00:00Z,GULF 28N 93W,0,0,0,10,10
Tropical Storm,Claudette,5,2003-07-09T21:00:00Z,MMVR 192N 961W,0,0,0,3,3
Tropical Storm,Claudette,5,2003-07-09T21:00:00Z,GULF 28N 95W,0,0,0,8,8
Tropical Storm,Claudette,5,2003-07-09T21:00:00Z,MMFR 185N 926W,0,0,5,5,10
Tropical Storm,Claudette,5,2003-07-09T21:00:00Z,GULF 27N 96W,0,0,0,8,8
Tropical Storm,Claudette,5,2003-07-09T21:00:00Z,MMMD 210N 897W,0,20,8,1,29
Tropical Storm,Claudette,5,2003-07-09T21:00:00Z,GULF 25N 96W,0,0,0,11,11
Tropical Storm,Claudette,6,2003-07-10T03:00:00Z,19.0N  86.0W,47,0,0,0,47
Tropical Storm,Claudette,6,2003-07-10T03:00:00Z,BURAS LA,0,0,0,4,4
Tropical Storm,Claudette,6,2003-07-10T03:00:00Z,20.5N  88.5W,2,31,0,0,33
Tropical Storm,Claudette,6,2003-07-10T03:00:00Z,NEW ORLEANS LA,0,0,0,4,4
Tropical Storm,Claudette,6,2003-07-10T03:00:00Z,22.0N  90.5W,0,12,14,1,27
Tropical Storm,Claudette,6,2003-07-10T03:00:00Z,NEW IBERIA LA,0,0,0,5,5
Tropical Storm,Claudette,6,2003-07-10T03:00:00Z,MWCG 193N 814W,3,0,0,0,3
Tropical Storm,Claudette,6,2003-07-10T03:00:00Z,PORT ARTHUR TX,0,0,0,6,6
Tropical Storm,Claudette,6,2003-07-10T03:00:00Z,MUAN 219N 850W,5,10,0,0,15
Tropical Storm,Claudette,6,2003-07-10T03:00:00Z,GALVESTON TX,0,0,0,7,7
Tropical Storm,Claudette,6,2003-07-10T03:00:00Z,MMCZ 205N 869W,19,18,0,0,37
Tropical Storm,Claudette,6,2003-07-10T03:00:00Z,FREEPORT TX,0,0,0,7,7
Tropical Storm,Claudette,6,2003-07-10T03:00:00Z,MZBZ 175N 883W,8,8,0,0,16
Tropical Storm,Claudette,6,2003-07-10T03:00:00Z,PORT O CONNOR TX,0,0,0,7,7
Tropical Storm,Claudette,6,2003-07-10T03:00:00Z,MHNJ 165N 859W,15,0,0,0,15
Tropical Storm,Claudette,6,2003-07-10T03:00:00Z,CORPUSCHRISTI TX,0,0,0,6,6
Tropical Storm,Claudette,6,2003-07-10T03:00:00Z,MMSO 238N 982W,0,0,0,5,5
Tropical Storm,Claudette,6,2003-07-10T03:00:00Z,BROWNSVILLE TX,0,0,0,8,8
Tropical Storm,Claudette,6,2003-07-10T03:00:00Z,MMTM 222N 979W,0,0,0,4,4
Tropical Storm,Claudette,6,2003-07-10T03:00:00Z,GULF 28N 89W,0,0,1,6,7
Tropical Storm,Claudette,6,2003-07-10T03:00:00Z,MMTX 210N 974W,0,0,0,4,4
Tropical Storm,Claudette,6,2003-07-10T03:00:00Z,GULF 28N 91W,0,0,1,10,11
Tropical Storm,Claudette,6,2003-07-10T03:00:00Z,MMVR 192N 961W,0,0,0,3,3
Tropical Storm,Claudette,6,2003-07-10T03:00:00Z,GULF 28N 93W,0,0,0,12,12
Tropical Storm,Claudette,6,2003-07-10T03:00:00Z,MMFR 185N 926W,0,1,6,2,9
Tropical Storm,Claudette,6,2003-07-10T03:00:00Z,GULF 28N 95W,0,0,0,10,10
Tropical Storm,Claudette,6,2003-07-10T03:00:00Z,MMMD 210N 897W,0,25,4,0,29
Tropical Storm,Claudette,6,2003-07-10T03:00:00Z,GULF 27N 96W,0,0,0,10,10
Tropical Storm,Claudette,6,2003-07-10T03:00:00Z,GULFPORT MS,0,0,0,2,2
Tropical Storm,Claudette,6,2003-07-10T03:00:00Z,GULF 25N 96W,0,0,0,12,12
Tropical Storm,Claudette,7,2003-07-10T09:00:00Z,19.5N  87.0W,43,1,0,0,44
Tropical Storm,Claudette,7,2003-07-10T09:00:00Z,NEW ORLEANS LA,0,0,0,4,4
Tropical Storm,Claudette,7,2003-07-10T09:00:00Z,21.5N  89.5W,0,30,0,0,30
Tropical Storm,Claudette,7,2003-07-10T09:00:00Z,NEW IBERIA LA,0,0,0,5,5
Tropical Storm,Claudette,7,2003-07-10T09:00:00Z,23.3N  91.6W,0,8,16,1,25
Tropical Storm,Claudette,7,2003-07-10T09:00:00Z,PORT ARTHUR TX,0,0,0,6,6
Tropical Storm,Claudette,7,2003-07-10T09:00:00Z,MUAN 219N 850W,3,5,1,0,9
Tropical Storm,Claudette,7,2003-07-10T09:00:00Z,GALVESTON TX,0,0,0,8,8
Tropical Storm,Claudette,7,2003-07-10T09:00:00Z,MMCZ 205N 869W,27,8,0,0,35
Tropical Storm,Claudette,7,2003-07-10T09:00:00Z,FREEPORT TX,0,0,0,8,8
Tropical Storm,Claudette,7,2003-07-10T09:00:00Z,MZBZ 175N 883W,15,2,0,0,17
Tropical Storm,Claudette,7,2003-07-10T09:00:00Z,PORT O CONNOR TX,0,0,0,9,9
Tropical Storm,Claudette,7,2003-07-10T09:00:00Z,MHNJ 165N 859W,20,0,0,0,20
Tropical Storm,Claudette,7,2003-07-10T09:00:00Z,CORPUSCHRISTI TX,0,0,0,9,9
Tropical Storm,Claudette,7,2003-07-10T09:00:00Z,MMSO 238N 982W,0,0,1,8,9
Tropical Storm,Claudette,7,2003-07-10T09:00:00Z,BROWNSVILLE TX,0,0,2,9,11
Tropical Storm,Claudette,7,2003-07-10T09:00:00Z,MMTM 222N 979W,0,0,1,7,8
Tropical Storm,Claudette,7,2003-07-10T09:00:00Z,GULF 29N 87W,0,0,0,2,2
Tropical Storm,Claudette,7,2003-07-10T09:00:00Z,MMTX 210N 974W,0,0,1,6,7
Tropical Storm,Claudette,7,2003-07-10T09:00:00Z,GULF 28N 89W,0,0,1,6,7
Tropical Storm,Claudette,7,2003-07-10T09:00:00Z,MMVR 192N 961W,0,0,0,4,4
Tropical Storm,Claudette,7,2003-07-10T09:00:00Z,GULF 28N 91W,0,0,2,8,10
Tropical Storm,Claudette,7,2003-07-10T09:00:00Z,MMFR 185N 926W,0,2,1,3,6
Tropical Storm,Claudette,7,2003-07-10T09:00:00Z,GULF 28N 93W,0,0,2,9,11
Tropical Storm,Claudette,7,2003-07-10T09:00:00Z,MMMD 210N 897W,0,31,0,0,31
Tropical Storm,Claudette,7,2003-07-10T09:00:00Z,GULF 28N 95W,0,0,1,10,11
Tropical Storm,Claudette,7,2003-07-10T09:00:00Z,MOBILE AL,0,0,0,2,2
Tropical Storm,Claudette,7,2003-07-10T09:00:00Z,GULF 27N 96W,0,0,2,10,12
Tropical Storm,Claudette,7,2003-07-10T09:00:00Z,GULFPORT MS,0,0,0,3,3
Tropical Storm,Claudette,7,2003-07-10T09:00:00Z,GULF 25N 96W,0,0,6,9,15
Tropical Storm,Claudette,7,2003-07-10T09:00:00Z,BURAS LA,0,0,0,5,5
Tropical Storm,Claudette,8,2003-07-10T15:00:00Z,20.7N  87.6W,44,0,0,0,44
Tropical Storm,Claudette,8,2003-07-10T15:00:00Z,NEW ORLEANS LA,0,0,0,5,5
Tropical Storm,Claudette,8,2003-07-10T15:00:00Z,22.3N  89.9W,1,29,0,0,30
Tropical Storm,Claudette,8,2003-07-10T15:00:00Z,NEW IBERIA LA,0,0,0,6,6
Tropical Storm,Claudette,8,2003-07-10T15:00:00Z,23.5N  91.6W,0,16,7,1,24
Tropical Storm,Claudette,8,2003-07-10T15:00:00Z,PORT ARTHUR TX,0,0,0,7,7
Tropical Storm,Claudette,8,2003-07-10T15:00:00Z,MUAN 219N 850W,11,3,0,0,14
Tropical Storm,Claudette,8,2003-07-10T15:00:00Z,GALVESTON TX,0,0,0,9,9
Tropical Storm,Claudette,8,2003-07-10T15:00:00Z,MMCZ 205N 869W,50,0,0,0,50
Tropical Storm,Claudette,8,2003-07-10T15:00:00Z,FREEPORT TX,0,0,0,9,9
Tropical Storm,Claudette,8,2003-07-10T15:00:00Z,MZBZ 175N 883W,2,0,0,1,3
Tropical Storm,Claudette,8,2003-07-10T15:00:00Z,PORT O CONNOR TX,0,0,0,10,10
Tropical Storm,Claudette,8,2003-07-10T15:00:00Z,MMSO 238N 982W,0,0,1,8,9
Tropical Storm,Claudette,8,2003-07-10T15:00:00Z,CORPUSCHRISTI TX,0,0,0,9,9
Tropical Storm,Claudette,8,2003-07-10T15:00:00Z,MMTM 222N 979W,0,0,1,6,7
Tropical Storm,Claudette,8,2003-07-10T15:00:00Z,BROWNSVILLE TX,0,0,2,10,12
Tropical Storm,Claudette,8,2003-07-10T15:00:00Z,MMTX 210N 974W,0,0,1,5,6
Tropical Storm,Claudette,8,2003-07-10T15:00:00Z,GULF 29N 87W,0,0,0,2,2
Tropical Storm,Claudette,8,2003-07-10T15:00:00Z,MMVR 192N 961W,0,0,0,3,3
Tropical Storm,Claudette,8,2003-07-10T15:00:00Z,GULF 28N 89W,0,0,1,6,7
Tropical Storm,Claudette,8,2003-07-10T15:00:00Z,MMFR 185N 926W,0,0,1,3,4
Tropical Storm,Claudette,8,2003-07-10T15:00:00Z,GULF 28N 91W,0,0,2,8,10
Tropical Storm,Claudette,8,2003-07-10T15:00:00Z,MMMD 210N 897W,13,19,0,0,32
Tropical Storm,Claudette,8,2003-07-10T15:00:00Z,GULF 28N 93W,0,0,2,10,12
Tropical Storm,Claudette,8,2003-07-10T15:00:00Z,MOBILE AL,0,0,0,2,2
Tropical Storm,Claudette,8,2003-07-10T15:00:00Z,GULF 28N 95W,0,0,1,11,12
Tropical Storm,Claudette,8,2003-07-10T15:00:00Z,GULFPORT MS,0,0,0,3,3
Tropical Storm,Claudette,8,2003-07-10T15:00:00Z,GULF 27N 96W,0,0,2,11,13
Tropical Storm,Claudette,8,2003-07-10T15:00:00Z,BURAS LA,0,0,0,5,5
Tropical Storm,Claudette,8,2003-07-10T15:00:00Z,GULF 25N 96W,0,0,6,9,15
Tropical Storm,Claudette,9,2003-07-10T21:00:00Z,21.6N  87.9W,43,0,0,0,43
Tropical Storm,Claudette,9,2003-07-10T21:00:00Z,NEW ORLEANS LA,0,0,0,7,7
Tropical Storm,Claudette,9,2003-07-10T21:00:00Z,23.1N  89.6W,4,24,0,1,29
Tropical Storm,Claudette,9,2003-07-10T21:00:00Z,NEW IBERIA LA,0,0,1,7,8
Tropical Storm,Claudette,9,2003-07-10T21:00:00Z,24.2N  91.0W,0,19,4,1,24
Tropical Storm,Claudette,9,2003-07-10T21:00:00Z,PORT ARTHUR TX,0,0,1,8,9
Tropical Storm,Claudette,9,2003-07-10T21:00:00Z,MUAN 219N 850W,21,1,0,0,22
Tropical Storm,Claudette,9,2003-07-10T21:00:00Z,GALVESTON TX,0,0,1,9,10
Tropical Storm,Claudette,9,2003-07-10T21:00:00Z,MMCZ 205N 869W,59,0,0,0,59
Tropical Storm,Claudette,9,2003-07-10T21:00:00Z,FREEPORT TX,0,0,1,9,10
Tropical Storm,Claudette,9,2003-07-10T21:00:00Z,MMSO 238N 982W,0,0,0,7,7
Tropical Storm,Claudette,9,2003-07-10T21:00:00Z,PORT O CONNOR TX,0,0,1,9,10
Tropical Storm,Claudette,9,2003-07-10T21:00:00Z,MMTM 222N 979W,0,0,0,5,5
Tropical Storm,Claudette,9,2003-07-10T21:00:00Z,CORPUSCHRISTI TX,0,0,1,8,9
Tropical Storm,Claudette,9,2003-07-10T21:00:00Z,MMTX 210N 974W,0,0,0,4,4
Tropical Storm,Claudette,9,2003-07-10T21:00:00Z,BROWNSVILLE TX,0,0,1,9,10
Tropical Storm,Claudette,9,2003-07-10T21:00:00Z,MMVR 192N 961W,0,0,0,2,2
Tropical Storm,Claudette,9,2003-07-10T21:00:00Z,GULF 29N 87W,0,0,0,4,4
Tropical Storm,Claudette,9,2003-07-10T21:00:00Z,MMFR 185N 926W,0,0,0,2,2
Tropical Storm,Claudette,9,2003-07-10T21:00:00Z,GULF 28N 89W,0,0,3,7,10
Tropical Storm,Claudette,9,2003-07-10T21:00:00Z,MMMD 210N 897W,24,3,0,0,27
Tropical Storm,Claudette,9,2003-07-10T21:00:00Z,GULF 28N 91W,0,0,5,8,13
Tropical Storm,Claudette,9,2003-07-10T21:00:00Z,PENSACOLA FL,0,0,0,2,2
Tropical Storm,Claudette,9,2003-07-10T21:00:00Z,GULF 28N 93W,0,0,5,9,14
Tropical Storm,Claudette,9,2003-07-10T21:00:00Z,MOBILE AL,0,0,0,3,3
Tropical Storm,Claudette,9,2003-07-10T21:00:00Z,GULF 28N 95W,0,0,3,10,13
Tropical Storm,Claudette,9,2003-07-10T21:00:00Z,GULFPORT MS,0,0,0,4,4
Tropical Storm,Claudette,9,2003-07-10T21:00:00Z,GULF 27N 96W,0,0,3,10,13
Tropical Storm,Claudette,9,2003-07-10T21:00:00Z,BURAS LA,0,0,1,6,7
Tropical Storm,Claudette,9,2003-07-10T21:00:00Z,GULF 25N 96W,0,0,5,8,13
Tropical Storm,Claudette,10,2003-07-11T03:00:00Z,23.0N  89.5W,41,0,0,1,42
Tropical Storm,Claudette,10,2003-07-11T03:00:00Z,NEW IBERIA LA,0,0,2,7,9
Tropical Storm,Claudette,10,2003-07-11T03:00:00Z,24.5N  91.5W,5,25,0,1,31
Tropical Storm,Claudette,10,2003-07-11T03:00:00Z,PORT ARTHUR TX,0,0,4,8,12
Tropical Storm,Claudette,10,2003-07-11T03:00:00Z,25.5N  93.0W,0,20,4,1,25
Tropical Storm,Claudette,10,2003-07-11T03:00:00Z,GALVESTON TX,0,0,6,8,14
Tropical Storm,Claudette,10,2003-07-11T03:00:00Z,MUAN 219N 850W,19,0,0,1,20
Tropical Storm,Claudette,10,2003-07-11T03:00:00Z,FREEPORT TX,0,0,7,7,14
Tropical Storm,Claudette,10,2003-07-11T03:00:00Z,MMCZ 205N 869W,86,0,0,0,86
Tropical Storm,Claudette,10,2003-07-11T03:00:00Z,PORT O CONNOR TX,0,0,7,8,15
Tropical Storm,Claudette,10,2003-07-11T03:00:00Z,MMSO 238N 982W,0,0,1,8,9
Tropical Storm,Claudette,10,2003-07-11T03:00:00Z,CORPUSCHRISTI TX,0,0,5,9,14
Tropical Storm,Claudette,10,2003-07-11T03:00:00Z,MMTM 222N 979W,0,0,0,6,6
Tropical Storm,Claudette,10,2003-07-11T03:00:00Z,BROWNSVILLE TX,0,0,6,8,14
Tropical Storm,Claudette,10,2003-07-11T03:00:00Z,MMTX 210N 974W,0,0,0,5,5
Tropical Storm,Claudette,10,2003-07-11T03:00:00Z,GULF 29N 87W,0,0,0,2,2
Tropical Storm,Claudette,10,2003-07-11T03:00:00Z,MMVR 192N 961W,0,0,0,2,2
Tropical Storm,Claudette,10,2003-07-11T03:00:00Z,GULF 28N 89W,0,0,3,5,8
Tropical Storm,Claudette,10,2003-07-11T03:00:00Z,MMMD 210N 897W,27,0,0,0,27
Tropical Storm,Claudette,10,2003-07-11T03:00:00Z,GULF 28N 91W,0,2,7,5,14
Tropical Storm,Claudette,10,2003-07-11T03:00:00Z,MOBILE AL,0,0,0,2,2
Tropical Storm,Claudette,10,2003-07-11T03:00:00Z,GULF 28N 93W,0,2,11,4,17
Tropical Storm,Claudette,10,2003-07-11T03:00:00Z,GULFPORT MS,0,0,0,4,4
Tropical Storm,Claudette,10,2003-07-11T03:00:00Z,GULF 28N 95W,0,1,11,5,17
Tropical Storm,Claudette,10,2003-07-11T03:00:00Z,BURAS LA,0,0,1,5,6
Tropical Storm,Claudette,10,2003-07-11T03:00:00Z,GULF 27N 96W,0,1,11,5,17
Tropical Storm,Claudette,10,2003-07-11T03:00:00Z,NEW ORLEANS LA,0,0,1,5,6
Tropical Storm,Claudette,10,2003-07-11T03:00:00Z,GULF 25N 96W,0,3,8,5,16
Tropical Storm,Claudette,11,2003-07-11T09:00:00Z,23.9N  90.7W,43,0,0,0,43
Tropical Storm,Claudette,11,2003-07-11T09:00:00Z,PORT ARTHUR TX,0,0,3,8,11
Tropical Storm,Claudette,11,2003-07-11T09:00:00Z,25.2N  92.4W,6,24,0,1,31
Tropical Storm,Claudette,11,2003-07-11T09:00:00Z,GALVESTON TX,0,0,7,7,14
Tropical Storm,Claudette,11,2003-07-11T09:00:00Z,25.8N  93.5W,0,24,2,0,26
Tropical Storm,Claudette,11,2003-07-11T09:00:00Z,FREEPORT TX,0,0,8,7,15
Tropical Storm,Claudette,11,2003-07-11T09:00:00Z,MUAN 219N 850W,5,0,0,0,5
Tropical Storm,Claudette,11,2003-07-11T09:00:00Z,PORT O CONNOR TX,0,1,9,6,16
Tropical Storm,Claudette,11,2003-07-11T09:00:00Z,MMCZ 205N 869W,99,0,0,0,99
Tropical Storm,Claudette,11,2003-07-11T09:00:00Z,CORPUSCHRISTI TX,0,1,8,6,15
Tropical Storm,Claudette,11,2003-07-11T09:00:00Z,MMSO 238N 982W,0,0,1,8,9
Tropical Storm,Claudette,11,2003-07-11T09:00:00Z,BROWNSVILLE TX,0,2,8,5,15
Tropical Storm,Claudette,11,2003-07-11T09:00:00Z,MMTM 222N 979W,0,0,0,5,5
Tropical Storm,Claudette,11,2003-07-11T09:00:00Z,GULF 29N 87W,0,0,0,2,2
Tropical Storm,Claudette,11,2003-07-11T09:00:00Z,MMTX 210N 974W,0,0,0,3,3
Tropical Storm,Claudette,11,2003-07-11T09:00:00Z,GULF 28N 89W,0,0,2,4,6
Tropical Storm,Claudette,11,2003-07-11T09:00:00Z,MMMD 210N 897W,28,0,0,0,28
Tropical Storm,Claudette,11,2003-07-11T09:00:00Z,GULF 28N 91W,0,2,6,4,12
Tropical Storm,Claudette,11,2003-07-11T09:00:00Z,MOBILE AL,0,0,0,2,2
Tropical Storm,Claudette,11,2003-07-11T09:00:00Z,GULF 28N 93W,0,4,9,4,17
Tropical Storm,Claudette,11,2003-07-11T09:00:00Z,GULFPORT MS,0,0,0,3,3
Tropical Storm,Claudette,11,2003-07-11T09:00:00Z,GULF 28N 95W,0,3,11,4,18
Tropical Storm,Claudette,11,2003-07-11T09:00:00Z,BURAS LA,0,0,1,4,5
Tropical Storm,Claudette,11,2003-07-11T09:00:00Z,GULF 27N 96W,0,6,9,4,19
Tropical Storm,Claudette,11,2003-07-11T09:00:00Z,NEW ORLEANS LA,0,0,0,5,5
Tropical Storm,Claudette,11,2003-07-11T09:00:00Z,GULF 25N 96W,0,8,5,4,17
Tropical Storm,Claudette,11,2003-07-11T09:00:00Z,NEW IBERIA LA,0,0,1,7,8
Tropical Storm,Claudette,12,2003-07-11T15:00:00Z,24.3N  90.4W,41,1,0,0,42
Tropical Storm,Claudette,12,2003-07-11T15:00:00Z,NEW IBERIA LA,0,0,4,6,10
Tropical Storm,Claudette,12,2003-07-11T15:00:00Z,25.2N  91.5W,20,8,1,0,29
Tropical Storm,Claudette,12,2003-07-11T15:00:00Z,PORT ARTHUR TX,0,0,5,7,12
Tropical Storm,Claudette,12,2003-07-11T15:00:00Z,25.8N  92.6W,4,18,2,1,25
Tropical Storm,Claudette,12,2003-07-11T15:00:00Z,GALVESTON TX,0,0,7,7,14
Tropical Storm,Claudette,12,2003-07-11T15:00:00Z,MMCZ 205N 869W,99,0,0,0,99
Tropical Storm,Claudette,12,2003-07-11T15:00:00Z,FREEPORT TX,0,0,7,7,14
Tropical Storm,Claudette,12,2003-07-11T15:00:00Z,MMSO 238N 982W,0,0,1,8,9
Tropical Storm,Claudette,12,2003-07-11T15:00:00Z,PORT O CONNOR TX,0,0,6,8,14
Tropical Storm,Claudette,12,2003-07-11T15:00:00Z,MMTM 222N 979W,0,0,0,7,7
Tropical Storm,Claudette,12,2003-07-11T15:00:00Z,CORPUSCHRISTI TX,0,0,4,9,13
Tropical Storm,Claudette,12,2003-07-11T15:00:00Z,MMTX 210N 974W,0,0,0,5,5
Tropical Storm,Claudette,12,2003-07-11T15:00:00Z,BROWNSVILLE TX,0,0,5,8,13
Tropical Storm,Claudette,12,2003-07-11T15:00:00Z,MMVR 192N 961W,0,0,0,2,2
Tropical Storm,Claudette,12,2003-07-11T15:00:00Z,GULF 29N 87W,0,0,0,2,2
Tropical Storm,Claudette,12,2003-07-11T15:00:00Z,MMMD 210N 897W,17,0,1,0,18
Tropical Storm,Claudette,12,2003-07-11T15:00:00Z,GULF 28N 89W,0,2,4,4,10
Tropical Storm,Claudette,12,2003-07-11T15:00:00Z,PENSACOLA FL,0,0,0,2,2
Tropical Storm,Claudette,12,2003-07-11T15:00:00Z,GULF 28N 91W,0,6,6,4,16
Tropical Storm,Claudette,12,2003-07-11T15:00:00Z,MOBILE AL,0,0,0,3,3
Tropical Storm,Claudette,12,2003-07-11T15:00:00Z,GULF 28N 93W,0,6,8,4,18
Tropical Storm,Claudette,12,2003-07-11T15:00:00Z,GULFPORT MS,0,0,1,3,4
Tropical Storm,Claudette,12,2003-07-11T15:00:00Z,GULF 28N 95W,0,2,9,6,17
Tropical Storm,Claudette,12,2003-07-11T15:00:00Z,BURAS LA,0,0,3,5,8
Tropical Storm,Claudette,12,2003-07-11T15:00:00Z,GULF 27N 96W,0,2,8,7,17
Tropical Storm,Claudette,12,2003-07-11T15:00:00Z,NEW ORLEANS LA,0,0,2,6,8
Tropical Storm,Claudette,12,2003-07-11T15:00:00Z,GULF 25N 96W,0,3,6,7,16
Tropical Storm,Claudette,13,2003-07-11T21:00:00Z,24.6N  91.0W,41,0,0,1,42
Tropical Storm,Claudette,13,2003-07-11T21:00:00Z,GALVESTON TX,0,1,6,6,13
Tropical Storm,Claudette,13,2003-07-11T21:00:00Z,25.3N  92.0W,26,3,0,1,30
Tropical Storm,Claudette,13,2003-07-11T21:00:00Z,FREEPORT TX,0,1,7,6,14
Tropical Storm,Claudette,13,2003-07-11T21:00:00Z,25.8N  93.2W,10,11,2,1,24
Tropical Storm,Claudette,13,2003-07-11T21:00:00Z,PORT O CONNOR TX,0,1,7,7,15
Tropical Storm,Claudette,13,2003-07-11T21:00:00Z,MMSO 238N 982W,0,0,1,8,9
Tropical Storm,Claudette,13,2003-07-11T21:00:00Z,CORPUSCHRISTI TX,0,0,7,7,14
Tropical Storm,Claudette,13,2003-07-11T21:00:00Z,MMTM 222N 979W,0,0,0,6,6
Tropical Storm,Claudette,13,2003-07-11T21:00:00Z,BROWNSVILLE TX,0,1,6,7,14
Tropical Storm,Claudette,13,2003-07-11T21:00:00Z,MMTX 210N 974W,0,0,0,3,3
Tropical Storm,Claudette,13,2003-07-11T21:00:00Z,GULF 29N 87W,0,0,0,2,2
Tropical Storm,Claudette,13,2003-07-11T21:00:00Z,MMMD 210N 897W,5,0,1,0,6
Tropical Storm,Claudette,13,2003-07-11T21:00:00Z,GULF 28N 89W,0,2,2,3,7
Tropical Storm,Claudette,13,2003-07-11T21:00:00Z,GULFPORT MS,0,0,0,3,3
Tropical Storm,Claudette,13,2003-07-11T21:00:00Z,GULF 28N 91W,0,6,5,3,14
Tropical Storm,Claudette,13,2003-07-11T21:00:00Z,BURAS LA,0,0,1,4,5
Tropical Storm,Claudette,13,2003-07-11T21:00:00Z,GULF 28N 93W,0,8,6,3,17
Tropical Storm,Claudette,13,2003-07-11T21:00:00Z,NEW ORLEANS LA,0,0,1,4,5
Tropical Storm,Claudette,13,2003-07-11T21:00:00Z,GULF 28N 95W,0,4,9,4,17
Tropical Storm,Claudette,13,2003-07-11T21:00:00Z,NEW IBERIA LA,0,0,2,6,8
Tropical Storm,Claudette,13,2003-07-11T21:00:00Z,GULF 27N 96W,0,4,9,5,18
Tropical Storm,Claudette,13,2003-07-11T21:00:00Z,PORT ARTHUR TX,0,0,4,6,10
Tropical Storm,Claudette,13,2003-07-11T21:00:00Z,GULF 25N 96W,0,5,5,6,16
Tropical Storm,Claudette,14,2003-07-12T03:00:00Z,25.0N  92.0W,46,0,0,0,46
Tropical Storm,Claudette,14,2003-07-12T03:00:00Z,GALVESTON TX,0,1,7,6,14
Tropical Storm,Claudette,14,2003-07-12T03:00:00Z,25.5N  93.0W,27,1,1,0,29
Tropical Storm,Claudette,14,2003-07-12T03:00:00Z,FREEPORT TX,0,2,8,5,15
Tropical Storm,Claudette,14,2003-07-12T03:00:00Z,26.0N  94.5W,9,11,2,2,24
Tropical Storm,Claudette,14,2003-07-12T03:00:00Z,PORT O CONNOR TX,0,3,9,5,17
Tropical Storm,Claudette,14,2003-07-12T03:00:00Z,MMSO 238N 982W,0,0,3,8,11
Tropical Storm,Claudette,14,2003-07-12T03:00:00Z,CORPUSCHRISTI TX,0,2,10,5,17
Tropical Storm,Claudette,14,2003-07-12T03:00:00Z,MMTM 222N 979W,0,0,0,6,6
Tropical Storm,Claudette,14,2003-07-12T03:00:00Z,BROWNSVILLE TX,0,4,8,5,17
Tropical Storm,Claudette,14,2003-07-12T03:00:00Z,MMTX 210N 974W,0,0,0,4,4
Tropical Storm,Claudette,14,2003-07-12T03:00:00Z,GULF 28N 89W,0,1,1,3,5
Tropical Storm,Claudette,14,2003-07-12T03:00:00Z,MMMD 210N 897W,1,0,0,1,2
Tropical Storm,Claudette,14,2003-07-12T03:00:00Z,GULF 28N 91W,1,4,4,2,11
Tropical Storm,Claudette,14,2003-07-12T03:00:00Z,GULFPORT MS,0,0,0,2,2
Tropical Storm,Claudette,14,2003-07-12T03:00:00Z,GULF 28N 93W,1,9,4,3,17
Tropical Storm,Claudette,14,2003-07-12T03:00:00Z,BURAS LA,0,0,1,2,3
Tropical Storm,Claudette,14,2003-07-12T03:00:00Z,GULF 28N 95W,0,9,7,3,19
Tropical Storm,Claudette,14,2003-07-12T03:00:00Z,NEW ORLEANS LA,0,0,0,3,3
Tropical Storm,Claudette,14,2003-07-12T03:00:00Z,GULF 27N 96W,0,10,8,3,21
Tropical Storm,Claudette,14,2003-07-12T03:00:00Z,NEW IBERIA LA,0,0,2,4,6
Tropical Storm,Claudette,14,2003-07-12T03:00:00Z,GULF 25N 96W,2,8,5,3,18
Tropical Storm,Claudette,14,2003-07-12T03:00:00Z,PORT ARTHUR TX,0,0,4,6,10
Tropical Storm,Claudette,15,2003-07-12T09:00:00Z,25.2N  92.7W,45,0,0,0,45
Tropical Storm,Claudette,15,2003-07-12T09:00:00Z,FREEPORT TX,0,4,6,5,15
Tropical Storm,Claudette,15,2003-07-12T09:00:00Z,25.7N  93.9W,25,3,0,1,29
Tropical Storm,Claudette,15,2003-07-12T09:00:00Z,PORT O CONNOR TX,0,6,7,4,17
Tropical Storm,Claudette,15,2003-07-12T09:00:00Z,26.0N  95.1W,12,10,2,1,25
Tropical Storm,Claudette,15,2003-07-12T09:00:00Z,CORPUSCHRISTI TX,0,5,8,5,18
Tropical Storm,Claudette,15,2003-07-12T09:00:00Z,MMSO 238N 982W,0,1,3,7,11
Tropical Storm,Claudette,15,2003-07-12T09:00:00Z,BROWNSVILLE TX,0,9,5,4,18
Tropical Storm,Claudette,15,2003-07-12T09:00:00Z,MMTM 222N 979W,0,0,1,6,7
Tropical Storm,Claudette,15,2003-07-12T09:00:00Z,GULF 28N 89W,0,0,1,2,3
Tropical Storm,Claudette,15,2003-07-12T09:00:00Z,MMTX 210N 974W,0,0,0,4,4
Tropical Storm,Claudette,15,2003-07-12T09:00:00Z,GULF 28N 91W,1,4,2,3,10
Tropical Storm,Claudette,15,2003-07-12T09:00:00Z,BURAS LA,0,0,0,3,3
Tropical Storm,Claudette,15,2003-07-12T09:00:00Z,GULF 28N 93W,2,8,4,2,16
Tropical Storm,Claudette,15,2003-07-12T09:00:00Z,NEW ORLEANS LA,0,0,0,3,3
Tropical Storm,Claudette,15,2003-07-12T09:00:00Z,GULF 28N 95W,1,10,5,3,19
Tropical Storm,Claudette,15,2003-07-12T09:00:00Z,NEW IBERIA LA,0,0,1,4,5
Tropical Storm,Claudette,15,2003-07-12T09:00:00Z,GULF 27N 96W,1,15,3,3,22
Tropical Storm,Claudette,15,2003-07-12T09:00:00Z,PORT ARTHUR TX,0,0,4,5,9
Tropical Storm,Claudette,15,2003-07-12T09:00:00Z,GULF 25N 96W,6,9,3,2,20
Tropical Storm,Claudette,15,2003-07-12T09:00:00Z,GALVESTON TX,0,2,6,5,13
Tropical Storm,Claudette,16,2003-07-12T15:00:00Z,25.5N  93.3W,46,1,0,0,47
Tropical Storm,Claudette,16,2003-07-12T15:00:00Z,FREEPORT TX,0,5,5,4,14
Tropical Storm,Claudette,16,2003-07-12T15:00:00Z,25.8N  94.5W,27,1,1,0,29
Tropical Storm,Claudette,16,2003-07-12T15:00:00Z,PORT O CONNOR TX,0,9,5,4,18
Tropical Storm,Claudette,16,2003-07-12T15:00:00Z,26.0N  95.5W,18,5,2,1,26
Tropical Storm,Claudette,16,2003-07-12T15:00:00Z,CORPUSCHRISTI TX,1,10,5,3,19
Tropical Storm,Claudette,16,2003-07-12T15:00:00Z,MMSO 238N 982W,0,1,3,7,11
Tropical Storm,Claudette,16,2003-07-12T15:00:00Z,BROWNSVILLE TX,3,10,4,3,20
Tropical Storm,Claudette,16,2003-07-12T15:00:00Z,MMTM 222N 979W,0,0,0,6,6
Tropical Storm,Claudette,16,2003-07-12T15:00:00Z,GULF 28N 89W,0,0,1,2,3
Tropical Storm,Claudette,16,2003-07-12T15:00:00Z,MMTX 210N 974W,0,0,0,4,4
Tropical Storm,Claudette,16,2003-07-12T15:00:00Z,GULF 28N 91W,1,2,2,3,8
Tropical Storm,Claudette,16,2003-07-12T15:00:00Z,BURAS LA,0,0,0,2,2
Tropical Storm,Claudette,16,2003-07-12T15:00:00Z,GULF 28N 93W,4,6,3,2,15
Tropical Storm,Claudette,16,2003-07-12T15:00:00Z,NEW ORLEANS LA,0,0,0,2,2
Tropical Storm,Claudette,16,2003-07-12T15:00:00Z,GULF 28N 95W,3,10,4,2,19
Tropical Storm,Claudette,16,2003-07-12T15:00:00Z,NEW IBERIA LA,0,0,1,3,4
Tropical Storm,Claudette,16,2003-07-12T15:00:00Z,GULF 27N 96W,8,12,2,1,23
Tropical Storm,Claudette,16,2003-07-12T15:00:00Z,PORT ARTHUR TX,0,0,3,5,8
Tropical Storm,Claudette,16,2003-07-12T15:00:00Z,GULF 25N 96W,11,5,3,2,21
Tropical Storm,Claudette,16,2003-07-12T15:00:00Z,GALVESTON TX,0,2,5,5,12
Tropical Storm,Claudette,17,2003-07-12T21:00:00Z,25.8N  93.2W,47,0,0,0,47
Tropical Storm,Claudette,17,2003-07-12T21:00:00Z,GALVESTON TX,0,6,5,3,14
Tropical Storm,Claudette,17,2003-07-12T21:00:00Z,26.0N  94.3W,29,1,1,0,31
Tropical Storm,Claudette,17,2003-07-12T21:00:00Z,FREEPORT TX,1,8,5,3,17
Tropical Storm,Claudette,17,2003-07-12T21:00:00Z,26.0N  95.5W,17,5,2,1,25
Tropical Storm,Claudette,17,2003-07-12T21:00:00Z,PORT O CONNOR TX,1,11,5,3,20
Tropical Storm,Claudette,17,2003-07-12T21:00:00Z,MMSO 238N 982W,0,0,5,7,12
Tropical Storm,Claudette,17,2003-07-12T21:00:00Z,CORPUSCHRISTI TX,1,10,6,3,20
Tropical Storm,Claudette,17,2003-07-12T21:00:00Z,MMTM 222N 979W,0,0,1,7,8
Tropical Storm,Claudette,17,2003-07-12T21:00:00Z,BROWNSVILLE TX,3,8,5,3,19
Tropical Storm,Claudette,17,2003-07-12T21:00:00Z,MMTX 210N 974W,0,0,0,5,5
Tropical Storm,Claudette,17,2003-07-12T21:00:00Z,GULF 28N 89W,0,0,1,2,3
Tropical Storm,Claudette,17,2003-07-12T21:00:00Z,MMVR 192N 961W,0,0,0,2,2
Tropical Storm,Claudette,17,2003-07-12T21:00:00Z,GULF 28N 91W,4,2,1,3,10
Tropical Storm,Claudette,17,2003-07-12T21:00:00Z,BURAS LA,0,0,0,2,2
Tropical Storm,Claudette,17,2003-07-12T21:00:00Z,GULF 28N 93W,9,5,2,2,18
Tropical Storm,Claudette,17,2003-07-12T21:00:00Z,NEW ORLEANS LA,0,0,0,3,3
Tropical Storm,Claudette,17,2003-07-12T21:00:00Z,GULF 28N 95W,7,10,3,1,21
Tropical Storm,Claudette,17,2003-07-12T21:00:00Z,NEW IBERIA LA,0,0,1,4,5
Tropical Storm,Claudette,17,2003-07-12T21:00:00Z,GULF 27N 96W,11,10,2,1,24
Tropical Storm,Claudette,17,2003-07-12T21:00:00Z,PORT ARTHUR TX,0,1,4,4,9
Tropical Storm,Claudette,17,2003-07-12T21:00:00Z,GULF 25N 96W,8,6,4,2,20
Tropical Storm,Claudette,18,2003-07-13T03:00:00Z,26.0N  94.0W,54,0,0,0,54
Tropical Storm,Claudette,18,2003-07-13T03:00:00Z,FREEPORT TX,3,6,3,3,15
Tropical Storm,Claudette,18,2003-07-13T03:00:00Z,26.0N  95.2W,30,1,0,0,31
Tropical Storm,Claudette,18,2003-07-13T03:00:00Z,PORT O CONNOR TX,5,9,3,2,19
Tropical Storm,Claudette,18,2003-07-13T03:00:00Z,26.0N  96.5W,17,5,1,1,24
Tropical Storm,Claudette,18,2003-07-13T03:00:00Z,CORPUSCHRISTI TX,5,10,4,2,21
Tropical Storm,Claudette,18,2003-07-13T03:00:00Z,MMSO 238N 982W,0,2,5,5,12
Tropical Storm,Claudette,18,2003-07-13T03:00:00Z,BROWNSVILLE TX,9,8,3,2,22
Tropical Storm,Claudette,18,2003-07-13T03:00:00Z,MMTM 222N 979W,0,0,1,6,7
Tropical Storm,Claudette,18,2003-07-13T03:00:00Z,GULF 28N 89W,0,0,1,1,2
Tropical Storm,Claudette,18,2003-07-13T03:00:00Z,MMTX 210N 974W,0,0,0,3,3
Tropical Storm,Claudette,18,2003-07-13T03:00:00Z,GULF 28N 91W,3,2,1,2,8
Tropical Storm,Claudette,18,2003-07-13T03:00:00Z,BURAS LA,0,0,0,2,2
Tropical Storm,Claudette,18,2003-07-13T03:00:00Z,GULF 28N 93W,13,2,2,1,18
Tropical Storm,Claudette,18,2003-07-13T03:00:00Z,NEW ORLEANS LA,0,0,0,2,2
Tropical Storm,Claudette,18,2003-07-13T03:00:00Z,GULF 28N 95W,13,5,2,1,21
Tropical Storm,Claudette,18,2003-07-13T03:00:00Z,NEW IBERIA LA,0,0,1,3,4
Tropical Storm,Claudette,18,2003-07-13T03:00:00Z,GULF 27N 96W,19,4,2,1,26
Tropical Storm,Claudette,18,2003-07-13T03:00:00Z,PORT ARTHUR TX,0,1,2,5,8
Tropical Storm,Claudette,18,2003-07-13T03:00:00Z,GULF 25N 96W,14,4,2,1,21
Tropical Storm,Claudette,18,2003-07-13T03:00:00Z,GALVESTON TX,2,4,3,3,12
Tropical Storm,Claudette,19,2003-07-13T09:00:00Z,25.7N  94.6W,51,0,0,0,51
Tropical Storm,Claudette,19,2003-07-13T09:00:00Z,FREEPORT TX,1,4,4,4,13
Tropical Storm,Claudette,19,2003-07-13T09:00:00Z,25.9N  95.8W,28,1,0,1,30
Tropical Storm,Claudette,19,2003-07-13T09:00:00Z,PORT O CONNOR TX,2,8,4,3,17
Tropical Storm,Claudette,19,2003-07-13T09:00:00Z,26.0N  97.2W,14,7,2,1,24
Tropical Storm,Claudette,19,2003-07-13T09:00:00Z,CORPUSCHRISTI TX,2,12,4,2,20
Tropical Storm,Claudette,19,2003-07-13T09:00:00Z,MMSO 238N 982W,1,4,4,4,13
Tropical Storm,Claudette,19,2003-07-13T09:00:00Z,BROWNSVILLE TX,12,8,2,2,24
Tropical Storm,Claudette,19,2003-07-13T09:00:00Z,MMTM 222N 979W,0,0,1,5,6
Tropical Storm,Claudette,19,2003-07-13T09:00:00Z,GULF 28N 91W,1,2,1,2,6
Tropical Storm,Claudette,19,2003-07-13T09:00:00Z,MMTX 210N 974W,0,0,0,3,3
Tropical Storm,Claudette,19,2003-07-13T09:00:00Z,GULF 28N 93W,8,3,1,2,14
Tropical Storm,Claudette,19,2003-07-13T09:00:00Z,NEW IBERIA LA,0,0,1,2,3
Tropical Storm,Claudette,19,2003-07-13T09:00:00Z,GULF 28N 95W,8,6,2,2,18
Tropical Storm,Claudette,19,2003-07-13T09:00:00Z,PORT ARTHUR TX,0,0,2,5,7
Tropical Storm,Claudette,19,2003-07-13T09:00:00Z,GULF 27N 96W,16,6,1,1,24
Tropical Storm,Claudette,19,2003-07-13T09:00:00Z,GALVESTON TX,0,3,4,4,11
Tropical Storm,Claudette,19,2003-07-13T09:00:00Z,GULF 25N 96W,21,2,1,1,25
Tropical Storm,Claudette,20,2003-07-13T15:00:00Z,26.1N  94.2W,50,0,0,0,50
Tropical Storm,Claudette,20,2003-07-13T15:00:00Z,FREEPORT TX,3,8,4,2,17
Tropical Storm,Claudette,20,2003-07-13T15:00:00Z,26.4N  95.5W,27,1,1,0,29
Tropical Storm,Claudette,20,2003-07-13T15:00:00Z,PORT O CONNOR TX,6,11,3,2,22
Tropical Storm,Claudette,20,2003-07-13T15:00:00Z,26.5N  97.0W,13,9,2,1,25
Tropical Storm,Claudette,20,2003-07-13T15:00:00Z,CORPUSCHRISTI TX,5,14,3,1,23
Tropical Storm,Claudette,20,2003-07-13T15:00:00Z,MMSO 238N 982W,0,1,5,7,13
Tropical Storm,Claudette,20,2003-07-13T15:00:00Z,BROWNSVILLE TX,8,9,3,2,22
Tropical Storm,Claudette,20,2003-07-13T15:00:00Z,MMTM 222N 979W,0,0,1,6,7
Tropical Storm,Claudette,20,2003-07-13T15:00:00Z,GULF 28N 91W,2,2,1,1,6
Tropical Storm,Claudette,20,2003-07-13T15:00:00Z,MMTX 210N 974W,0,0,0,4,4
Tropical Storm,Claudette,20,2003-07-13T15:00:00Z,GULF 28N 93W,13,2,1,1,17
Tropical Storm,Claudette,20,2003-07-13T15:00:00Z,NEW IBERIA LA,0,0,1,2,3
Tropical Storm,Claudette,20,2003-07-13T15:00:00Z,GULF 28N 95W,14,6,1,1,22
Tropical Storm,Claudette,20,2003-07-13T15:00:00Z,PORT ARTHUR TX,0,2,2,4,8
Tropical Storm,Claudette,20,2003-07-13T15:00:00Z,GULF 27N 96W,20,6,1,0,27
Tropical Storm,Claudette,20,2003-07-13T15:00:00Z,GALVESTON TX,2,6,3,3,14
Tropical Storm,Claudette,20,2003-07-13T15:00:00Z,GULF 25N 96W,14,3,2,2,21
Tropical Storm,Claudette,21,2003-07-13T21:00:00Z,26.0N  94.0W,44,0,0,0,44
Tropical Storm,Claudette,21,2003-07-13T21:00:00Z,FREEPORT TX,5,8,3,2,18
Tropical Storm,Claudette,21,2003-07-13T21:00:00Z,26.3N  95.4W,27,1,1,0,29
Tropical Storm,Claudette,21,2003-07-13T21:00:00Z,PORT O CONNOR TX,7,11,2,2,22
Tropical Storm,Claudette,21,2003-07-13T21:00:00Z,26.5N  97.0W,11,10,2,1,24
Tropical Storm,Claudette,21,2003-07-13T21:00:00Z,CORPUSCHRISTI TX,5,13,3,2,23
Tropical Storm,Claudette,21,2003-07-13T21:00:00Z,MMSO 238N 982W,0,2,6,5,13
Tropical Storm,Claudette,21,2003-07-13T21:00:00Z,BROWNSVILLE TX,7,10,3,2,22
Tropical Storm,Claudette,21,2003-07-13T21:00:00Z,MMTM 222N 979W,0,0,2,6,8
Tropical Storm,Claudette,21,2003-07-13T21:00:00Z,GULF 28N 91W,3,2,1,1,7
Tropical Storm,Claudette,21,2003-07-13T21:00:00Z,MMTX 210N 974W,0,0,0,4,4
Tropical Storm,Claudette,21,2003-07-13T21:00:00Z,GULF 28N 93W,13,3,1,1,18
Tropical Storm,Claudette,21,2003-07-13T21:00:00Z,NEW IBERIA LA,0,1,0,3,4
Tropical Storm,Claudette,21,2003-07-13T21:00:00Z,GULF 28N 95W,16,5,1,1,23
Tropical Storm,Claudette,21,2003-07-13T21:00:00Z,PORT ARTHUR TX,1,3,2,3,9
Tropical Storm,Claudette,21,2003-07-13T21:00:00Z,GULF 27N 96W,20,5,1,1,27
Tropical Storm,Claudette,21,2003-07-13T21:00:00Z,GALVESTON TX,3,7,3,2,15
Tropical Storm,Claudette,21,2003-07-13T21:00:00Z,GULF 25N 96W,14,5,2,1,22
Tropical Storm,Claudette,22,2003-07-14T03:00:00Z,26.5N  94.0W,40,0,0,0,40
Tropical Storm,Claudette,22,2003-07-14T03:00:00Z,FREEPORT TX,8,9,2,1,20
Tropical Storm,Claudette,22,2003-07-14T03:00:00Z,26.6N  95.5W,23,2,1,1,27
Tropical Storm,Claudette,22,2003-07-14T03:00:00Z,PORT O CONNOR TX,10,10,2,2,24
Tropical Storm,Claudette,22,2003-07-14T03:00:00Z,26.7N  97.0W,10,10,2,2,24
Tropical Storm,Claudette,22,2003-07-14T03:00:00Z,CORPUSCHRISTI TX,6,13,3,1,23
Tropical Storm,Claudette,22,2003-07-14T03:00:00Z,MMSO 238N 982W,0,1,5,6,12
Tropical Storm,Claudette,22,2003-07-14T03:00:00Z,BROWNSVILLE TX,4,10,4,2,20
Tropical Storm,Claudette,22,2003-07-14T03:00:00Z,MMTM 222N 979W,0,0,1,6,7
Tropical Storm,Claudette,22,2003-07-14T03:00:00Z,GULF 28N 91W,7,2,0,1,10
Tropical Storm,Claudette,22,2003-07-14T03:00:00Z,MMTX 210N 974W,0,0,0,4,4
Tropical Storm,Claudette,22,2003-07-14T03:00:00Z,GULF 28N 93W,21,1,0,1,23
Tropical Storm,Claudette,22,2003-07-14T03:00:00Z,NEW ORLEANS LA,0,0,0,2,2
Tropical Storm,Claudette,22,2003-07-14T03:00:00Z,GULF 28N 95W,21,3,1,1,26
Tropical Storm,Claudette,22,2003-07-14T03:00:00Z,NEW IBERIA LA,0,1,1,3,5
Tropical Storm,Claudette,22,2003-07-14T03:00:00Z,GULF 27N 96W,19,5,2,0,26
Tropical Storm,Claudette,22,2003-07-14T03:00:00Z,PORT ARTHUR TX,1,6,2,3,12
Tropical Storm,Claudette,22,2003-07-14T03:00:00Z,GULF 25N 96W,5,8,3,2,18
Tropical Storm,Claudette,22,2003-07-14T03:00:00Z,GALVESTON TX,5,9,2,2,18
Tropical Storm,Claudette,23,2003-07-14T09:00:00Z,27.2N  94.3W,42,0,1,0,43
Tropical Storm,Claudette,23,2003-07-14T09:00:00Z,FREEPORT TX,20,4,1,0,25
Tropical Storm,Claudette,23,2003-07-14T09:00:00Z,27.5N  95.7W,27,1,1,0,29
Tropical Storm,Claudette,23,2003-07-14T09:00:00Z,PORT O CONNOR TX,19,6,1,1,27
Tropical Storm,Claudette,23,2003-07-14T09:00:00Z,27.7N  97.3W,12,9,2,1,24
Tropical Storm,Claudette,23,2003-07-14T09:00:00Z,CORPUSCHRISTI TX,10,10,2,2,24
Tropical Storm,Claudette,23,2003-07-14T09:00:00Z,MMSO 238N 982W,0,0,3,5,8
Tropical Storm,Claudette,23,2003-07-14T09:00:00Z,BROWNSVILLE TX,3,8,3,3,17
Tropical Storm,Claudette,23,2003-07-14T09:00:00Z,MMTM 222N 979W,0,0,0,3,3
Tropical Storm,Claudette,23,2003-07-14T09:00:00Z,GULF 28N 91W,10,0,1,0,11
Tropical Storm,Claudette,23,2003-07-14T09:00:00Z,MMTX 210N 974W,0,0,0,2,2
Tropical Storm,Claudette,23,2003-07-14T09:00:00Z,GULF 28N 93W,32,1,0,0,33
Tropical Storm,Claudette,23,2003-07-14T09:00:00Z,NEW ORLEANS LA,0,0,0,2,2
Tropical Storm,Claudette,23,2003-07-14T09:00:00Z,GULF 28N 95W,31,1,0,0,32
Tropical Storm,Claudette,23,2003-07-14T09:00:00Z,NEW IBERIA LA,1,2,1,2,6
Tropical Storm,Claudette,23,2003-07-14T09:00:00Z,GULF 27N 96W,22,2,1,1,26
Tropical Storm,Claudette,23,2003-07-14T09:00:00Z,PORT ARTHUR TX,6,6,2,1,15
Tropical Storm,Claudette,23,2003-07-14T09:00:00Z,GULF 25N 96W,3,6,3,2,14
Tropical Storm,Claudette,23,2003-07-14T09:00:00Z,GALVESTON TX,16,4,2,0,22
Tropical Storm,Claudette,24,2003-07-14T15:00:00Z,27.8N  94.5W,42,1,0,0,43
Tropical Storm,Claudette,24,2003-07-14T15:00:00Z,PORT O CONNOR TX,21,6,1,0,28
Tropical Storm,Claudette,24,2003-07-14T15:00:00Z,28.3N  96.3W,22,5,1,0,28
Tropical Storm,Claudette,24,2003-07-14T15:00:00Z,CORPUSCHRISTI TX,10,10,2,1,23
Tropical Storm,Claudette,24,2003-07-14T15:00:00Z,28.6N  98.2W,6,13,3,2,24
Tropical Storm,Claudette,24,2003-07-14T15:00:00Z,BROWNSVILLE TX,2,7,3,2,14
Tropical Storm,Claudette,24,2003-07-14T15:00:00Z,MMSO 238N 982W,0,0,2,3,5
Tropical Storm,Claudette,24,2003-07-14T15:00:00Z,GULF 28N 91W,11,1,0,0,12
Tropical Storm,Claudette,24,2003-07-14T15:00:00Z,MMTM 222N 979W,0,0,0,2,2
Tropical Storm,Claudette,24,2003-07-14T15:00:00Z,GULF 28N 93W,55,0,0,0,55
Tropical Storm,Claudette,24,2003-07-14T15:00:00Z,NEW IBERIA LA,3,3,0,1,7
Tropical Storm,Claudette,24,2003-07-14T15:00:00Z,GULF 28N 95W,34,1,0,0,35
Tropical Storm,Claudette,24,2003-07-14T15:00:00Z,PORT ARTHUR TX,14,4,0,1,19
Tropical Storm,Claudette,24,2003-07-14T15:00:00Z,GULF 27N 96W,18,4,1,0,23
Tropical Storm,Claudette,24,2003-07-14T15:00:00Z,GALVESTON TX,24,2,0,0,26
Tropical Storm,Claudette,24,2003-07-14T15:00:00Z,GULF 25N 96W,2,5,2,2,11
Tropical Storm,Claudette,24,2003-07-14T15:00:00Z,FREEPORT TX,26,2,0,0,28
Tropical Storm,Claudette,25,2003-07-14T21:00:00Z,28.3N  95.6W,42,0,0,0,42
Tropical Storm,Claudette,25,2003-07-14T21:00:00Z,PORT O CONNOR TX,32,0,1,0,33
Tropical Storm,Claudette,25,2003-07-14T21:00:00Z,28.7N  97.3W,23,3,1,1,28
Tropical Storm,Claudette,25,2003-07-14T21:00:00Z,CORPUSCHRISTI TX,17,5,1,0,23
Tropical Storm,Claudette,25,2003-07-14T21:00:00Z,29.0N  99.1W,7,13,3,1,24
Tropical Storm,Claudette,25,2003-07-14T21:00:00Z,BROWNSVILLE TX,2,5,3,2,12
Tropical Storm,Claudette,25,2003-07-14T21:00:00Z,MMSO 238N 982W,0,0,1,3,4
Tropical Storm,Claudette,25,2003-07-14T21:00:00Z,GULF 28N 91W,3,1,0,1,5
Tropical Storm,Claudette,25,2003-07-14T21:00:00Z,NEW IBERIA LA,3,2,0,1,6
Tropical Storm,Claudette,25,2003-07-14T21:00:00Z,GULF 28N 93W,99,0,0,0,99
Tropical Storm,Claudette,25,2003-07-14T21:00:00Z,PORT ARTHUR TX,17,1,1,0,19
Tropical Storm,Claudette,25,2003-07-14T21:00:00Z,GULF 28N 95W,52,0,0,0,52
Tropical Storm,Claudette,25,2003-07-14T21:00:00Z,GALVESTON TX,34,0,0,0,34
Tropical Storm,Claudette,25,2003-07-14T21:00:00Z,GULF 27N 96W,19,2,0,1,22
Tropical Storm,Claudette,25,2003-07-14T21:00:00Z,FREEPORT TX,38,0,0,0,38
Tropical Storm,Claudette,25,2003-07-14T21:00:00Z,GULF 25N 96W,0,2,2,2,6
Tropical Storm,Claudette,26,2003-07-15T03:00:00Z,28.2N  97.0W,42,0,0,0,42
Tropical Storm,Claudette,26,2003-07-15T03:00:00Z,PORT O CONNOR TX,51,0,0,0,51
Tropical Storm,Claudette,26,2003-07-15T03:00:00Z,28.5N  99.0W,23,5,1,0,29
Tropical Storm,Claudette,26,2003-07-15T03:00:00Z,CORPUSCHRISTI TX,34,0,0,0,34
Tropical Storm,Claudette,26,2003-07-15T03:00:00Z,28.5N 101.0W,5,16,2,1,24
Tropical Storm,Claudette,26,2003-07-15T03:00:00Z,BROWNSVILLE TX,7,2,1,1,11
Tropical Storm,Claudette,26,2003-07-15T03:00:00Z,MMSO 238N 982W,0,0,0,2,2
Tropical Storm,Claudette,26,2003-07-15T03:00:00Z,GULF 28N 93W,99,0,0,0,99
Tropical Storm,Claudette,26,2003-07-15T03:00:00Z,PORT ARTHUR TX,17,1,0,0,18
Tropical Storm,Claudette,26,2003-07-15T03:00:00Z,GULF 28N 95W,99,0,0,0,99
Tropical Storm,Claudette,26,2003-07-15T03:00:00Z,GALVESTON TX,48,0,0,0,48
Tropical Storm,Claudette,26,2003-07-15T03:00:00Z,GULF 27N 96W,36,0,0,0,36
Tropical Storm,Claudette,26,2003-07-15T03:00:00Z,FREEPORT TX,55,0,0,0,55
Tropical Storm,Claudette,26,2003-07-15T03:00:00Z,GULF 25N 96W,1,0,0,1,2
Hurricane,Claudette,27,2003-07-15T09:00:00Z,28.3N  99.0W,39,1,0,0,40
Hurricane,Claudette,27,2003-07-15T09:00:00Z,PORT O CONNOR TX,80,0,0,1,81
Hurricane,Claudette,27,2003-07-15T09:00:00Z,28.9N 101.6W,14,15,1,0,30
Hurricane,Claudette,27,2003-07-15T09:00:00Z,CORPUSCHRISTI TX,56,0,0,0,56
Hurricane,Claudette,27,2003-07-15T09:00:00Z,29.6N 104.6W,0,14,12,1,27
Hurricane,Claudette,27,2003-07-15T09:00:00Z,BROWNSVILLE TX,4,0,0,1,5
Hurricane,Claudette,27,2003-07-15T09:00:00Z,PORT ARTHUR TX,1,1,0,0,2
Hurricane,Claudette,27,2003-07-15T09:00:00Z,GULF 28N 95W,99,0,0,0,99
Hurricane,Claudette,27,2003-07-15T09:00:00Z,GALVESTON TX,65,0,0,0,65
Hurricane,Claudette,27,2003-07-15T09:00:00Z,GULF 27N 96W,51,0,0,0,51
Hurricane,Claudette,27,2003-07-15T09:00:00Z,FREEPORT TX,76,0,0,0,76
Hurricane,Claudette,28,2003-07-15T15:00:00Z,29.0N  99.8W,40,0,0,0,40
Hurricane,Claudette,28,2003-07-15T15:00:00Z,PORT O CONNOR TX,99,0,0,0,99
Hurricane,Claudette,28,2003-07-15T15:00:00Z,29.5N 102.3W,18,11,1,0,30
Hurricane,Claudette,28,2003-07-15T15:00:00Z,CORPUSCHRISTI TX,53,0,0,0,53
Hurricane,Claudette,28,2003-07-15T15:00:00Z,30.0N 104.5W,2,18,3,0,23
Hurricane,Claudette,28,2003-07-15T15:00:00Z,GULF 28N 95W,99,0,0,0,99
Hurricane,Claudette,28,2003-07-15T15:00:00Z,GALVESTON TX,67,0,0,0,67
Hurricane,Claudette,28,2003-07-15T15:00:00Z,GULF 27N 96W,15,0,0,0,15
Hurricane,Claudette,28,2003-07-15T15:00:00Z,FREEPORT TX,99,0,0,0,99
Tropical Storm,Claudette,29,2003-07-15T21:00:00Z,29.6N 102.0W,39,0,0,0,39
Tropical Storm,Claudette,29,2003-07-15T21:00:00Z,FREEPORT TX,5,0,0,0,5
Tropical Storm,Claudette,29,2003-07-15T21:00:00Z,30.3N 104.7W,13,17,0,0,30
Tropical Storm,Claudette,29,2003-07-15T21:00:00Z,PORT O CONNOR TX,99,0,0,0,99
Tropical Storm,Claudette,29,2003-07-15T21:00:00Z,,99,0,0,0,99
Tropical Storm,Claudette,29,2003-07-15T21:00:00Z,CORPUSCHRISTI TX,99,0,0,0,99
Tropical Storm,Claudette,30,2003-07-16T03:00:00Z,29.5N 103.5W,41,0,0,0,41
Tropical Storm,Claudette,30,2003-07-16T03:00:00Z,,99,0,0,0,99
Tropical Storm,Claudette,30,2003-07-16T03:00:00Z,30.5N 106.5W,6,25,0,0,31
Tropical Storm,Claudette,30,2003-07-16T03:00:00Z,CORPUSCHRISTI TX,99,0,0,0,99
Tropical Depression,Five,1,2003-07-16T15:00:00Z,35.0N  57.0W,38,0,0,0,38
Tropical Depression,Five,1,2003-07-16T15:00:00Z,SYDNEY NS,0,0,2,4,6
Tropical Depression,Five,1,2003-07-16T15:00:00Z,37.0N  56.5W,15,6,1,1,23
Tropical Depression,Five,1,2003-07-16T15:00:00Z,EDDY POINT NS,0,0,2,4,6
Tropical Depression,Five,1,2003-07-16T15:00:00Z,38.5N  55.0W,2,11,4,1,18
Tropical Depression,Five,1,2003-07-16T15:00:00Z,PTX BASQUES NFLD,0,0,1,4,5
Tropical Depression,Five,1,2003-07-16T15:00:00Z,ST JOHN NB,0,0,0,2,2
Tropical Depression,Five,1,2003-07-16T15:00:00Z,BURGEO NFLD,0,0,1,4,5
Tropical Depression,Five,1,2003-07-16T15:00:00Z,MONCTON NB,0,0,0,3,3
Tropical Depression,Five,1,2003-07-16T15:00:00Z,ILE ST PIERRE,0,0,1,6,7
Tropical Depression,Five,1,2003-07-16T15:00:00Z,YARMOUTH NS,0,0,0,2,2
Tropical Depression,Five,1,2003-07-16T15:00:00Z,CAPE RACE NFLD,0,0,0,6,6
Tropical Depression,Five,1,2003-07-16T15:00:00Z,HALIFAX NS,0,0,2,2,4
Tropical Depression,Five,1,2003-07-16T15:00:00Z,HIBERNIA OILFLD,0,0,0,3,3
Tropical Depression,Five,1,2003-07-16T15:00:00Z,SABLE ISLAND NS,0,1,5,4,10
Tropical Depression,Five,2,2003-07-16T21:00:00Z,35.5N  56.5W,36,0,0,0,36
Tropical Depression,Five,2,2003-07-16T21:00:00Z,EDDY POINT NS,0,0,2,4,6
Tropical Depression,Five,2,2003-07-16T21:00:00Z,37.5N  55.5W,12,9,1,0,22
Tropical Depression,Five,2,2003-07-16T21:00:00Z,PTX BASQUES NFLD,0,0,1,4,5
Tropical Depression,Five,2,2003-07-16T21:00:00Z,39.0N  54.0W,1,12,4,1,18
Tropical Depression,Five,2,2003-07-16T21:00:00Z,BURGEO NFLD,0,0,1,5,6
Tropical Depression,Five,2,2003-07-16T21:00:00Z,MONCTON NB,0,0,0,2,2
Tropical Depression,Five,2,2003-07-16T21:00:00Z,ILE ST PIERRE,0,0,2,6,8
Tropical Depression,Five,2,2003-07-16T21:00:00Z,HALIFAX NS,0,0,1,2,3
Tropical Depression,Five,2,2003-07-16T21:00:00Z,CAPE RACE NFLD,0,0,1,6,7
Tropical Depression,Five,2,2003-07-16T21:00:00Z,SABLE ISLAND NS,0,1,5,3,9
Tropical Depression,Five,2,2003-07-16T21:00:00Z,HIBERNIA OILFLD,0,0,0,4,4
Tropical Depression,Five,2,2003-07-16T21:00:00Z,SYDNEY NS,0,0,2,4,6
Tropical Storm,Danny,3,2003-07-17T03:00:00Z,35.5N  56.5W,38,0,0,0,38
Tropical Storm,Danny,3,2003-07-17T03:00:00Z,EDDY POINT NS,0,0,2,3,5
Tropical Storm,Danny,3,2003-07-17T03:00:00Z,37.5N  55.5W,13,7,2,0,22
Tropical Storm,Danny,3,2003-07-17T03:00:00Z,PTX BASQUES NFLD,0,0,1,4,5
Tropical Storm,Danny,3,2003-07-17T03:00:00Z,39.0N  54.0W,1,12,4,1,18
Tropical Storm,Danny,3,2003-07-17T03:00:00Z,BURGEO NFLD,0,0,1,5,6
Tropical Storm,Danny,3,2003-07-17T03:00:00Z,HALIFAX NS,0,0,1,1,2
Tropical Storm,Danny,3,2003-07-17T03:00:00Z,ILE ST PIERRE,0,0,2,5,7
Tropical Storm,Danny,3,2003-07-17T03:00:00Z,SABLE ISLAND NS,0,2,4,2,8
Tropical Storm,Danny,3,2003-07-17T03:00:00Z,CAPE RACE NFLD,0,0,1,7,8
Tropical Storm,Danny,3,2003-07-17T03:00:00Z,SYDNEY NS,0,0,2,4,6
Tropical Storm,Danny,3,2003-07-17T03:00:00Z,HIBERNIA OILFLD,0,0,0,5,5
Tropical Storm,Danny,4,2003-07-17T09:00:00Z,36.6N  55.9W,33,1,0,0,34
Tropical Storm,Danny,4,2003-07-17T09:00:00Z,PTX BASQUES NFLD,0,0,2,2,4
Tropical Storm,Danny,4,2003-07-17T09:00:00Z,38.4N  54.5W,11,8,1,1,21
Tropical Storm,Danny,4,2003-07-17T09:00:00Z,BURGEO NFLD,0,0,3,3,6
Tropical Storm,Danny,4,2003-07-17T09:00:00Z,39.7N  52.5W,1,10,4,2,17
Tropical Storm,Danny,4,2003-07-17T09:00:00Z,ILE ST PIERRE,0,1,4,3,8
Tropical Storm,Danny,4,2003-07-17T09:00:00Z,SABLE ISLAND NS,0,2,3,1,6
Tropical Storm,Danny,4,2003-07-17T09:00:00Z,CAPE RACE NFLD,0,0,4,5,9
Tropical Storm,Danny,4,2003-07-17T09:00:00Z,SYDNEY NS,0,1,2,1,4
Tropical Storm,Danny,4,2003-07-17T09:00:00Z,HIBERNIA OILFLD,0,0,0,6,6
Tropical Storm,Danny,4,2003-07-17T09:00:00Z,EDDY POINT NS,0,0,2,1,3
Tropical Storm,Danny,5,2003-07-17T15:00:00Z,38.5N  55.5W,28,0,0,0,28
Tropical Storm,Danny,5,2003-07-17T15:00:00Z,PTX BASQUES NFLD,0,1,1,1,3
Tropical Storm,Danny,5,2003-07-17T15:00:00Z,40.5N  52.5W,2,16,2,0,20
Tropical Storm,Danny,5,2003-07-17T15:00:00Z,BURGEO NFLD,0,1,3,1,5
Tropical Storm,Danny,5,2003-07-17T15:00:00Z,42.0N  49.5W,0,5,9,2,16
Tropical Storm,Danny,5,2003-07-17T15:00:00Z,ILE ST PIERRE,0,3,4,2,9
Tropical Storm,Danny,5,2003-07-17T15:00:00Z,SABLE ISLAND NS,0,3,0,1,4
Tropical Storm,Danny,5,2003-07-17T15:00:00Z,CAPE RACE NFLD,0,3,7,2,12
Tropical Storm,Danny,5,2003-07-17T15:00:00Z,SYDNEY NS,0,1,1,0,2
Tropical Storm,Danny,5,2003-07-17T15:00:00Z,HIBERNIA OILFLD,0,0,5,6,11
Tropical Storm,Danny,6,2003-07-17T21:00:00Z,39.5N  54.5W,26,5,0,0,31
Tropical Storm,Danny,6,2003-07-17T21:00:00Z,ILE ST PIERRE,0,2,0,1,3
Tropical Storm,Danny,6,2003-07-17T21:00:00Z,42.0N  50.5W,0,20,2,1,23
Tropical Storm,Danny,6,2003-07-17T21:00:00Z,CAPE RACE NFLD,0,6,4,0,10
Tropical Storm,Danny,6,2003-07-17T21:00:00Z,43.0N  46.0W,0,1,14,2,17
Tropical Storm,Danny,6,2003-07-17T21:00:00Z,HIBERNIA OILFLD,0,1,11,2,14
Tropical Storm,Danny,7,2003-07-18T03:00:00Z,40.7N  52.3W,18,2,0,1,21
Tropical Storm,Danny,7,2003-07-18T03:00:00Z,ILE ST PIERRE,0,2,1,0,3
Tropical Storm,Danny,7,2003-07-18T03:00:00Z,42.5N  48.0W,1,12,2,1,16
Tropical Storm,Danny,7,2003-07-18T03:00:00Z,CAPE RACE NFLD,1,5,1,1,8
Tropical Storm,Danny,7,2003-07-18T03:00:00Z,42.5N  43.5W,0,4,7,3,14
Tropical Storm,Danny,7,2003-07-18T03:00:00Z,HIBERNIA OILFLD,0,5,4,1,10
Tropical Storm,Danny,8,2003-07-18T09:00:00Z,41.6N  50.9W,19,1,0,0,20
Tropical Storm,Danny,8,2003-07-18T09:00:00Z,ILE ST PIERRE,1,0,1,0,2
Tropical Storm,Danny,8,2003-07-18T09:00:00Z,42.8N  46.6W,3,8,2,1,14
Tropical Storm,Danny,8,2003-07-18T09:00:00Z,CAPE RACE NFLD,2,3,0,1,6
Tropical Storm,Danny,8,2003-07-18T09:00:00Z,42.6N  42.5W,0,5,4,3,12
Tropical Storm,Danny,8,2003-07-18T09:00:00Z,HIBERNIA OILFLD,0,6,2,0,8
Tropical Storm,Danny,9,2003-07-18T15:00:00Z,42.0N  48.9W,25,0,0,0,25
Tropical Storm,Danny,9,2003-07-18T15:00:00Z,41.5N  40.5W,0,4,7,3,14
Tropical Storm,Danny,9,2003-07-18T15:00:00Z,43.0N  45.0W,3,12,1,1,17
Tropical Storm,Danny,9,2003-07-18T15:00:00Z,HIBERNIA OILFLD,0,5,1,0,6
Hurricane,Danny,10,2003-07-18T21:00:00Z,42.5N  46.5W,26,1,0,0,27
Hurricane,Danny,10,2003-07-18T21:00:00Z,41.5N  39.0W,0,8,3,3,14
Hurricane,Danny,10,2003-07-18T21:00:00Z,42.5N  42.0W,3,12,1,1,17
Hurricane,Danny,10,2003-07-18T21:00:00Z,HIBERNIA OILFLD,1,1,0,1,3
Hurricane,Danny,11,2003-07-19T03:00:00Z,42.6N  44.2W,23,1,0,0,24
Hurricane,Danny,11,2003-07-19T03:00:00Z,40.8N  38.7W,0,9,3,3,15
Hurricane,Danny,11,2003-07-19T03:00:00Z,42.1N  40.6W,5,10,2,1,18
Hurricane,Danny,12,2003-07-19T09:00:00Z,42.4N  42.7W,29,1,0,0,30
Hurricane,Danny,12,2003-07-19T09:00:00Z,39.8N  37.8W,0,9,3,3,15
Hurricane,Danny,12,2003-07-19T09:00:00Z,41.4N  39.7W,7,9,1,1,18
Hurricane,Danny,13,2003-07-19T15:00:00Z,43.0N  40.5W,25,1,0,0,26
Hurricane,Danny,13,2003-07-19T15:00:00Z,39.0N  37.0W,0,7,4,3,14
Hurricane,Danny,13,2003-07-19T15:00:00Z,41.5N  38.0W,8,7,1,1,17
Tropical Storm,Danny,14,2003-07-19T21:00:00Z,42.0N  39.0W,26,0,0,1,27
Tropical Storm,Danny,14,2003-07-19T21:00:00Z,38.5N  37.0W,2,8,3,2,15
Tropical Storm,Danny,14,2003-07-19T21:00:00Z,40.0N  37.5W,10,5,2,1,18
Tropical Storm,Danny,15,2003-07-20T03:00:00Z,40.9N  38.6W,30,0,0,0,30
Tropical Storm,Danny,15,2003-07-20T03:00:00Z,37.5N  37.3W,3,10,2,2,17
Tropical Storm,Danny,15,2003-07-20T03:00:00Z,39.1N  37.4W,13,5,1,1,20
Tropical Storm,Danny,16,2003-07-20T09:00:00Z,40.0N  37.8W,28,0,0,1,29
Tropical Storm,Danny,16,2003-07-20T09:00:00Z,36.8N  37.4W,5,8,3,1,17
Tropical Storm,Danny,16,2003-07-20T09:00:00Z,38.5N  37.4W,16,3,1,1,21
Tropical Storm,Danny,17,2003-07-20T15:00:00Z,39.1N  36.8W,28,1,0,0,29
Tropical Storm,Danny,17,2003-07-20T15:00:00Z,36.0N  36.5W,4,9,2,2,17
Tropical Storm,Danny,17,2003-07-20T15:00:00Z,37.5N  36.5W,15,3,1,1,20
Tropical Depression,Danny,18,2003-07-20T21:00:00Z,37.3N  36.2W,28,1,0,0,29
Tropical Depression,Danny,18,2003-07-20T21:00:00Z,34.0N  37.0W,3,9,3,2,17
Tropical Depression,Danny,18,2003-07-20T21:00:00Z,35.5N  36.0W,14,4,1,1,20
Tropical Depression,Six,1,2003-07-19T21:00:00Z,13.0N  49.5W,48,0,0,0,48
Tropical Depression,Six,1,2003-07-19T21:00:00Z,TFFR 163N 615W,0,0,3,15,18
Tropical Depression,Six,1,2003-07-19T21:00:00Z,13.5N  52.5W,6,27,0,0,33
Tropical Depression,Six,1,2003-07-19T21:00:00Z,TAPA 171N 618W,0,0,2,15,17
Tropical Depression,Six,1,2003-07-19T21:00:00Z,14.0N  56.0W,0,8,17,1,26
Tropical Depression,Six,1,2003-07-19T21:00:00Z,TKPK 173N 627W,0,0,1,15,16
Tropical Depression,Six,1,2003-07-19T21:00:00Z,SVMG 110N 640W,0,0,0,6,6
Tropical Depression,Six,1,2003-07-19T21:00:00Z,TNCM 181N 631W,0,0,1,14,15
Tropical Depression,Six,1,2003-07-19T21:00:00Z,TTPP 106N 614W,0,0,0,9,9
Tropical Depression,Six,1,2003-07-19T21:00:00Z,TISX 177N 648W,0,0,0,12,12
Tropical Depression,Six,1,2003-07-19T21:00:00Z,TTPT 112N 608W,0,0,1,11,12
Tropical Depression,Six,1,2003-07-19T21:00:00Z,TIST 183N 650W,0,0,0,12,12
Tropical Depression,Six,1,2003-07-19T21:00:00Z,TGPY 120N 618W,0,0,0,12,12
Tropical Depression,Six,1,2003-07-19T21:00:00Z,TJPS 180N 666W,0,0,0,9,9
Tropical Depression,Six,1,2003-07-19T21:00:00Z,TBPB 131N 595W,0,0,7,11,18
Tropical Depression,Six,1,2003-07-19T21:00:00Z,MDSD 185N 697W,0,0,0,2,2
Tropical Depression,Six,1,2003-07-19T21:00:00Z,TVSV 131N 612W,0,0,2,13,15
Tropical Depression,Six,1,2003-07-19T21:00:00Z,TJSJ 184N 661W,0,0,0,10,10
Tropical Depression,Six,1,2003-07-19T21:00:00Z,TLPL 138N 610W,0,0,3,14,17
Tropical Depression,Six,1,2003-07-19T21:00:00Z,ST CROIX VI,0,0,0,12,12
Tropical Depression,Six,1,2003-07-19T21:00:00Z,TFFF 146N 610W,0,0,3,15,18
Tropical Depression,Six,1,2003-07-19T21:00:00Z,ST THOMAS VI,0,0,0,12,12
Tropical Depression,Six,1,2003-07-19T21:00:00Z,TDPR 153N 614W,0,0,3,15,18
Tropical Depression,Six,1,2003-07-19T21:00:00Z,SAN JUAN PR,0,0,0,10,10
Tropical Depression,Six,1,2003-07-19T21:00:00Z,SVBS 157N 636W,0,0,0,14,14
Tropical Depression,Six,1,2003-07-19T21:00:00Z,PONCE PR,0,0,0,9,9
Tropical Depression,Six,2,2003-07-20T03:00:00Z,13.3N  51.9W,50,1,0,0,51
Tropical Depression,Six,2,2003-07-20T03:00:00Z,TFFR 163N 615W,0,0,5,17,22
Tropical Depression,Six,2,2003-07-20T03:00:00Z,13.9N  55.0W,1,32,1,0,34
Tropical Depression,Six,2,2003-07-20T03:00:00Z,TAPA 171N 618W,0,0,2,19,21
Tropical Depression,Six,2,2003-07-20T03:00:00Z,14.6N  58.1W,0,4,22,0,26
Tropical Depression,Six,2,2003-07-20T03:00:00Z,TKPK 173N 627W,0,0,1,20,21
Tropical Depression,Six,2,2003-07-20T03:00:00Z,SVMG 110N 640W,0,0,0,2,2
Tropical Depression,Six,2,2003-07-20T03:00:00Z,TNCM 181N 631W,0,0,0,19,19
Tropical Depression,Six,2,2003-07-20T03:00:00Z,TTPP 106N 614W,0,0,0,3,3
Tropical Depression,Six,2,2003-07-20T03:00:00Z,TISX 177N 648W,0,0,0,18,18
Tropical Depression,Six,2,2003-07-20T03:00:00Z,TTPT 112N 608W,0,0,2,3,5
Tropical Depression,Six,2,2003-07-20T03:00:00Z,TIST 183N 650W,0,0,0,17,17
Tropical Depression,Six,2,2003-07-20T03:00:00Z,TGPY 120N 618W,0,0,2,7,9
Tropical Depression,Six,2,2003-07-20T03:00:00Z,TJPS 180N 666W,0,0,0,14,14
Tropical Depression,Six,2,2003-07-20T03:00:00Z,TBPB 131N 595W,0,0,14,4,18
Tropical Depression,Six,2,2003-07-20T03:00:00Z,MDSD 185N 697W,0,0,0,3,3
Tropical Depression,Six,2,2003-07-20T03:00:00Z,TVSV 131N 612W,0,0,6,9,15
Tropical Depression,Six,2,2003-07-20T03:00:00Z,TJSJ 184N 661W,0,0,0,14,14
Tropical Depression,Six,2,2003-07-20T03:00:00Z,TLPL 138N 610W,0,0,8,10,18
Tropical Depression,Six,2,2003-07-20T03:00:00Z,ST CROIX VI,0,0,0,18,18
Tropical Depression,Six,2,2003-07-20T03:00:00Z,TFFF 146N 610W,0,0,9,12,21
Tropical Depression,Six,2,2003-07-20T03:00:00Z,ST THOMAS VI,0,0,0,17,17
Tropical Depression,Six,2,2003-07-20T03:00:00Z,TDPR 153N 614W,0,0,7,15,22
Tropical Depression,Six,2,2003-07-20T03:00:00Z,SAN JUAN PR,0,0,0,14,14
Tropical Depression,Six,2,2003-07-20T03:00:00Z,SVBS 157N 636W,0,0,0,20,20
Tropical Depression,Six,2,2003-07-20T03:00:00Z,PONCE PR,0,0,0,14,14
Tropical Depression,Six,3,2003-07-20T09:00:00Z,13.8N  54.3W,48,1,0,0,49
Tropical Depression,Six,3,2003-07-20T09:00:00Z,TNCM 181N 631W,0,0,4,15,19
Tropical Depression,Six,3,2003-07-20T09:00:00Z,14.4N  57.6W,1,32,1,0,34
Tropical Depression,Six,3,2003-07-20T09:00:00Z,TISX 177N 648W,0,0,1,19,20
Tropical Depression,Six,3,2003-07-20T09:00:00Z,15.1N  60.7W,0,4,21,1,26
Tropical Depression,Six,3,2003-07-20T09:00:00Z,TIST 183N 650W,0,0,1,18,19
Tropical Depression,Six,3,2003-07-20T09:00:00Z,SVMG 110N 640W,0,0,0,2,2
Tropical Depression,Six,3,2003-07-20T09:00:00Z,TJPS 180N 666W,0,0,0,19,19
Tropical Depression,Six,3,2003-07-20T09:00:00Z,TTPT 112N 608W,0,1,2,1,4
Tropical Depression,Six,3,2003-07-20T09:00:00Z,MDSD 185N 697W,0,0,0,12,12
Tropical Depression,Six,3,2003-07-20T09:00:00Z,TGPY 120N 618W,0,0,6,2,8
Tropical Depression,Six,3,2003-07-20T09:00:00Z,MDCB 176N 714W,0,0,0,7,7
Tropical Depression,Six,3,2003-07-20T09:00:00Z,TBPB 131N 595W,0,11,8,0,19
Tropical Depression,Six,3,2003-07-20T09:00:00Z,MTPP 186N 724W,0,0,0,4,4
Tropical Depression,Six,3,2003-07-20T09:00:00Z,TVSV 131N 612W,0,2,13,1,16
Tropical Depression,Six,3,2003-07-20T09:00:00Z,MTCA 183N 738W,0,0,0,2,2
Tropical Depression,Six,3,2003-07-20T09:00:00Z,TLPL 138N 610W,0,3,16,1,20
Tropical Depression,Six,3,2003-07-20T09:00:00Z,TJSJ 184N 661W,0,0,0,19,19
Tropical Depression,Six,3,2003-07-20T09:00:00Z,TFFF 146N 610W,0,3,20,1,24
Tropical Depression,Six,3,2003-07-20T09:00:00Z,MDPP 198N 707W,0,0,0,7,7
Tropical Depression,Six,3,2003-07-20T09:00:00Z,TDPR 153N 614W,0,1,22,2,25
Tropical Depression,Six,3,2003-07-20T09:00:00Z,MBJT 215N 712W,0,0,0,3,3
Tropical Depression,Six,3,2003-07-20T09:00:00Z,SVBS 157N 636W,0,0,9,13,22
Tropical Depression,Six,3,2003-07-20T09:00:00Z,ST CROIX VI,0,0,1,19,20
Tropical Depression,Six,3,2003-07-20T09:00:00Z,TFFR 163N 615W,0,1,20,3,24
Tropical Depression,Six,3,2003-07-20T09:00:00Z,ST THOMAS VI,0,0,1,18,19
Tropical Depression,Six,3,2003-07-20T09:00:00Z,TAPA 171N 618W,0,0,16,7,23
Tropical Depression,Six,3,2003-07-20T09:00:00Z,SAN JUAN PR,0,0,0,19,19
Tropical Depression,Six,3,2003-07-20T09:00:00Z,TKPK 173N 627W,0,0,10,12,22
Tropical Depression,Six,3,2003-07-20T09:00:00Z,PONCE PR,0,0,0,19,19
Tropical Depression,Six,4,2003-07-20T15:00:00Z,14.0N  56.9W,50,1,1,0,52
Tropical Depression,Six,4,2003-07-20T15:00:00Z,MDSD 185N 697W,0,0,0,24,24
Tropical Depression,Six,4,2003-07-20T15:00:00Z,14.9N  60.6W,0,34,2,0,36
Tropical Depression,Six,4,2003-07-20T15:00:00Z,MDCB 176N 714W,0,0,0,21,21
Tropical Depression,Six,4,2003-07-20T15:00:00Z,16.1N  64.4W,0,1,26,1,28
Tropical Depression,Six,4,2003-07-20T15:00:00Z,MTPP 186N 724W,0,0,0,21,21
Tropical Depression,Six,4,2003-07-20T15:00:00Z,TNCC 122N 690W,0,0,0,2,2
Tropical Depression,Six,4,2003-07-20T15:00:00Z,MTCA 183N 738W,0,0,0,16,16
Tropical Depression,Six,4,2003-07-20T15:00:00Z,TTPT 112N 608W,0,2,1,0,3
Tropical Depression,Six,4,2003-07-20T15:00:00Z,MKJP 179N 768W,0,0,0,4,4
Tropical Depression,Six,4,2003-07-20T15:00:00Z,TGPY 120N 618W,0,4,3,0,7
Tropical Depression,Six,4,2003-07-20T15:00:00Z,MKJS 185N 779W,0,0,0,2,2
Tropical Depression,Six,4,2003-07-20T15:00:00Z,TBPB 131N 595W,3,23,1,0,27
Tropical Depression,Six,4,2003-07-20T15:00:00Z,MUGM 200N 751W,0,0,0,12,12
Tropical Depression,Six,4,2003-07-20T15:00:00Z,TVSV 131N 612W,0,17,3,0,20
Tropical Depression,Six,4,2003-07-20T15:00:00Z,MUCM 214N 779W,0,0,0,2,2
Tropical Depression,Six,4,2003-07-20T15:00:00Z,TLPL 138N 610W,0,25,3,0,28
Tropical Depression,Six,4,2003-07-20T15:00:00Z,TJSJ 184N 661W,0,0,12,13,25
Tropical Depression,Six,4,2003-07-20T15:00:00Z,TFFF 146N 610W,0,30,3,0,33
Tropical Depression,Six,4,2003-07-20T15:00:00Z,MDPP 198N 707W,0,0,0,22,22
Tropical Depression,Six,4,2003-07-20T15:00:00Z,TDPR 153N 614W,0,28,6,0,34
Tropical Depression,Six,4,2003-07-20T15:00:00Z,MBJT 215N 712W,0,0,0,15,15
Tropical Depression,Six,4,2003-07-20T15:00:00Z,SVBS 157N 636W,0,4,25,0,29
Tropical Depression,Six,4,2003-07-20T15:00:00Z,MYMM 224N 730W,0,0,0,9,9
Tropical Depression,Six,4,2003-07-20T15:00:00Z,TFFR 163N 615W,0,23,10,0,33
Tropical Depression,Six,4,2003-07-20T15:00:00Z,MYSM 241N 745W,0,0,0,2,2
Tropical Depression,Six,4,2003-07-20T15:00:00Z,TAPA 171N 618W,0,14,16,0,30
Tropical Depression,Six,4,2003-07-20T15:00:00Z,MYEG 235N 758W,0,0,0,2,2
Tropical Depression,Six,4,2003-07-20T15:00:00Z,TKPK 173N 627W,0,5,24,0,29
Tropical Depression,Six,4,2003-07-20T15:00:00Z,ST CROIX VI,0,0,22,5,27
Tropical Depression,Six,4,2003-07-20T15:00:00Z,TNCM 181N 631W,0,1,23,1,25
Tropical Depression,Six,4,2003-07-20T15:00:00Z,ST THOMAS VI,0,0,18,7,25
Tropical Depression,Six,4,2003-07-20T15:00:00Z,TISX 177N 648W,0,0,22,5,27
Tropical Depression,Six,4,2003-07-20T15:00:00Z,SAN JUAN PR,0,0,12,13,25
Tropical Depression,Six,4,2003-07-20T15:00:00Z,TIST 183N 650W,0,0,18,7,25
Tropical Depression,Six,4,2003-07-20T15:00:00Z,PONCE PR,0,0,10,15,25
Tropical Depression,Six,4,2003-07-20T15:00:00Z,TJPS 180N 666W,0,0,10,15,25
Tropical Depression,Six,5,2003-07-20T21:00:00Z,14.5N  59.8W,52,2,0,0,54
Tropical Depression,Six,5,2003-07-20T21:00:00Z,MTCA 183N 738W,0,0,0,22,22
Tropical Depression,Six,5,2003-07-20T21:00:00Z,15.5N  63.9W,0,34,2,0,36
Tropical Depression,Six,5,2003-07-20T21:00:00Z,MKJP 179N 768W,0,0,0,13,13
Tropical Depression,Six,5,2003-07-20T21:00:00Z,16.6N  67.7W,0,1,25,2,28
Tropical Depression,Six,5,2003-07-20T21:00:00Z,MKJS 185N 779W,0,0,0,11,11
Tropical Depression,Six,5,2003-07-20T21:00:00Z,TGPY 120N 618W,1,3,0,0,4
Tropical Depression,Six,5,2003-07-20T21:00:00Z,MWCG 193N 814W,0,0,0,2,2
Tropical Depression,Six,5,2003-07-20T21:00:00Z,TBPB 131N 595W,29,1,0,0,30
Tropical Depression,Six,5,2003-07-20T21:00:00Z,MUGM 200N 751W,0,0,0,21,21
Tropical Depression,Six,5,2003-07-20T21:00:00Z,TVSV 131N 612W,12,11,0,0,23
Tropical Depression,Six,5,2003-07-20T21:00:00Z,MUCM 214N 779W,0,0,0,12,12
Tropical Depression,Six,5,2003-07-20T21:00:00Z,TLPL 138N 610W,24,13,0,0,37
Tropical Depression,Six,5,2003-07-20T21:00:00Z,MUCF 221N 805W,0,0,0,3,3
Tropical Depression,Six,5,2003-07-20T21:00:00Z,TFFF 146N 610W,31,15,0,0,46
Tropical Depression,Six,5,2003-07-20T21:00:00Z,TJSJ 184N 661W,0,2,22,1,25
Tropical Depression,Six,5,2003-07-20T21:00:00Z,TDPR 153N 614W,17,29,0,0,46
Tropical Depression,Six,5,2003-07-20T21:00:00Z,MDPP 198N 707W,0,0,2,20,22
Tropical Depression,Six,5,2003-07-20T21:00:00Z,SVBS 157N 636W,0,36,1,1,38
Tropical Depression,Six,5,2003-07-20T21:00:00Z,MBJT 215N 712W,0,0,0,15,15
Tropical Depression,Six,5,2003-07-20T21:00:00Z,TFFR 163N 615W,7,34,0,0,41
Tropical Depression,Six,5,2003-07-20T21:00:00Z,MYMM 224N 730W,0,0,0,13,13
Tropical Depression,Six,5,2003-07-20T21:00:00Z,TAPA 171N 618W,1,31,0,0,32
Tropical Depression,Six,5,2003-07-20T21:00:00Z,MYSM 241N 745W,0,0,0,5,5
Tropical Depression,Six,5,2003-07-20T21:00:00Z,TKPK 173N 627W,0,29,2,0,31
Tropical Depression,Six,5,2003-07-20T21:00:00Z,MYEG 235N 758W,0,0,0,8,8
Tropical Depression,Six,5,2003-07-20T21:00:00Z,TNCM 181N 631W,0,18,5,0,23
Tropical Depression,Six,5,2003-07-20T21:00:00Z,MYAK 241N 776W,0,0,0,4,4
Tropical Depression,Six,5,2003-07-20T21:00:00Z,TISX 177N 648W,0,14,14,1,29
Tropical Depression,Six,5,2003-07-20T21:00:00Z,MYNN 251N 775W,0,0,0,2,2
Tropical Depression,Six,5,2003-07-20T21:00:00Z,TIST 183N 650W,0,7,17,1,25
Tropical Depression,Six,5,2003-07-20T21:00:00Z,ST CROIX VI,0,14,14,1,29
Tropical Depression,Six,5,2003-07-20T21:00:00Z,TJPS 180N 666W,0,2,24,1,27
Tropical Depression,Six,5,2003-07-20T21:00:00Z,ST THOMAS VI,0,7,17,1,25
Tropical Depression,Six,5,2003-07-20T21:00:00Z,MDSD 185N 697W,0,0,11,14,25
Tropical Depression,Six,5,2003-07-20T21:00:00Z,SAN JUAN PR,0,2,22,1,25
Tropical Depression,Six,5,2003-07-20T21:00:00Z,MDCB 176N 714W,0,0,4,20,24
Tropical Depression,Six,5,2003-07-20T21:00:00Z,PONCE PR,0,2,24,1,27
Tropical Depression,Six,5,2003-07-20T21:00:00Z,MTPP 186N 724W,0,0,1,23,24
Tropical Depression,Six,6,2003-07-21T03:00:00Z,15.0N  61.5W,52,2,0,0,54
Tropical Depression,Six,6,2003-07-21T03:00:00Z,MKJP 179N 768W,0,0,0,15,15
Tropical Depression,Six,6,2003-07-21T03:00:00Z,16.1N  65.4W,0,34,2,0,36
Tropical Depression,Six,6,2003-07-21T03:00:00Z,MKJS 185N 779W,0,0,0,13,13
Tropical Depression,Six,6,2003-07-21T03:00:00Z,17.2N  69.0W,0,1,25,1,27
Tropical Depression,Six,6,2003-07-21T03:00:00Z,MWCG 193N 814W,0,0,0,3,3
Tropical Depression,Six,6,2003-07-21T03:00:00Z,TGPY 120N 618W,2,0,0,0,2
Tropical Depression,Six,6,2003-07-21T03:00:00Z,MUGM 200N 751W,0,0,0,22,22
Tropical Depression,Six,6,2003-07-21T03:00:00Z,TBPB 131N 595W,24,0,0,0,24
Tropical Depression,Six,6,2003-07-21T03:00:00Z,MUCM 214N 779W,0,0,0,16,16
Tropical Depression,Six,6,2003-07-21T03:00:00Z,TVSV 131N 612W,17,1,0,0,18
Tropical Depression,Six,6,2003-07-21T03:00:00Z,MUCF 221N 805W,0,0,0,7,7
Tropical Depression,Six,6,2003-07-21T03:00:00Z,TLPL 138N 610W,39,1,0,0,40
Tropical Depression,Six,6,2003-07-21T03:00:00Z,MUSN 216N 826W,0,0,0,2,2
Tropical Depression,Six,6,2003-07-21T03:00:00Z,TFFF 146N 610W,54,1,0,0,55
Tropical Depression,Six,6,2003-07-21T03:00:00Z,MUHA 230N 824W,0,0,0,2,2
Tropical Depression,Six,6,2003-07-21T03:00:00Z,TDPR 153N 614W,54,2,0,0,56
Tropical Depression,Six,6,2003-07-21T03:00:00Z,TJSJ 184N 661W,0,15,12,0,27
Tropical Depression,Six,6,2003-07-21T03:00:00Z,SVBS 157N 636W,7,36,0,0,43
Tropical Depression,Six,6,2003-07-21T03:00:00Z,MDPP 198N 707W,0,0,9,14,23
Tropical Depression,Six,6,2003-07-21T03:00:00Z,TFFR 163N 615W,44,5,0,0,49
Tropical Depression,Six,6,2003-07-21T03:00:00Z,MBJT 215N 712W,0,0,1,15,16
Tropical Depression,Six,6,2003-07-21T03:00:00Z,TAPA 171N 618W,24,14,0,0,38
Tropical Depression,Six,6,2003-07-21T03:00:00Z,MYMM 224N 730W,0,0,0,14,14
Tropical Depression,Six,6,2003-07-21T03:00:00Z,TKPK 173N 627W,8,28,0,0,36
Tropical Depression,Six,6,2003-07-21T03:00:00Z,MYSM 241N 745W,0,0,0,7,7
Tropical Depression,Six,6,2003-07-21T03:00:00Z,TNCM 181N 631W,1,24,1,0,26
Tropical Depression,Six,6,2003-07-21T03:00:00Z,MYEG 235N 758W,0,0,0,11,11
Tropical Depression,Six,6,2003-07-21T03:00:00Z,TISX 177N 648W,0,30,2,0,32
Tropical Depression,Six,6,2003-07-21T03:00:00Z,MYAK 241N 776W,0,0,0,7,7
Tropical Depression,Six,6,2003-07-21T03:00:00Z,TIST 183N 650W,0,22,5,0,27
Tropical Depression,Six,6,2003-07-21T03:00:00Z,MYNN 251N 775W,0,0,0,3,3
Tropical Depression,Six,6,2003-07-21T03:00:00Z,TJPS 180N 666W,0,15,15,0,30
Tropical Depression,Six,6,2003-07-21T03:00:00Z,ST CROIX VI,0,30,2,0,32
Tropical Depression,Six,6,2003-07-21T03:00:00Z,MDSD 185N 697W,0,0,21,5,26
Tropical Depression,Six,6,2003-07-21T03:00:00Z,ST THOMAS VI,0,22,5,0,27
Tropical Depression,Six,6,2003-07-21T03:00:00Z,MDCB 176N 714W,0,0,13,11,24
Tropical Depression,Six,6,2003-07-21T03:00:00Z,SAN JUAN PR,0,15,12,0,27
Tropical Depression,Six,6,2003-07-21T03:00:00Z,MTPP 186N 724W,0,0,5,19,24
Tropical Depression,Six,6,2003-07-21T03:00:00Z,PONCE PR,0,15,15,0,30
Tropical Depression,Six,6,2003-07-21T03:00:00Z,MTCA 183N 738W,0,0,1,21,22
Tropical Depression,Six,6,2003-07-21T03:00:00Z,MARATHON FL,0,0,0,2,2
Tropical Depression,Six,7,2003-07-21T09:00:00Z,15.5N  63.5W,50,2,0,0,52
Tropical Depression,Six,7,2003-07-21T09:00:00Z,MUGM 200N 751W,0,0,1,22,23
Tropical Depression,Six,7,2003-07-21T09:00:00Z,16.6N  67.3W,0,34,2,0,36
Tropical Depression,Six,7,2003-07-21T09:00:00Z,MUCM 214N 779W,0,0,0,20,20
Tropical Depression,Six,7,2003-07-21T09:00:00Z,17.7N  70.8W,0,2,24,2,28
Tropical Depression,Six,7,2003-07-21T09:00:00Z,MUCF 221N 805W,0,0,0,12,12
Tropical Depression,Six,7,2003-07-21T09:00:00Z,TBPB 131N 595W,13,0,0,0,13
Tropical Depression,Six,7,2003-07-21T09:00:00Z,MUSN 216N 826W,0,0,0,5,5
Tropical Depression,Six,7,2003-07-21T09:00:00Z,TVSV 131N 612W,8,0,0,0,8
Tropical Depression,Six,7,2003-07-21T09:00:00Z,MUHA 230N 824W,0,0,0,5,5
Tropical Depression,Six,7,2003-07-21T09:00:00Z,TLPL 138N 610W,35,0,0,0,35
Tropical Depression,Six,7,2003-07-21T09:00:00Z,TJSJ 184N 661W,0,29,2,0,31
Tropical Depression,Six,7,2003-07-21T09:00:00Z,TFFF 146N 610W,65,0,0,0,65
Tropical Depression,Six,7,2003-07-21T09:00:00Z,MDPP 198N 707W,0,0,21,4,25
Tropical Depression,Six,7,2003-07-21T09:00:00Z,TDPR 153N 614W,68,0,0,0,68
Tropical Depression,Six,7,2003-07-21T09:00:00Z,MBJT 215N 712W,0,0,8,9,17
Tropical Depression,Six,7,2003-07-21T09:00:00Z,SVBS 157N 636W,49,3,0,0,52
Tropical Depression,Six,7,2003-07-21T09:00:00Z,MYMM 224N 730W,0,0,1,14,15
Tropical Depression,Six,7,2003-07-21T09:00:00Z,TFFR 163N 615W,59,0,0,0,59
Tropical Depression,Six,7,2003-07-21T09:00:00Z,MYSM 241N 745W,0,0,0,9,9
Tropical Depression,Six,7,2003-07-21T09:00:00Z,TAPA 171N 618W,40,1,0,0,41
Tropical Depression,Six,7,2003-07-21T09:00:00Z,MYEG 235N 758W,0,0,0,14,14
Tropical Depression,Six,7,2003-07-21T09:00:00Z,TKPK 173N 627W,36,3,0,0,39
Tropical Depression,Six,7,2003-07-21T09:00:00Z,MYAK 241N 776W,0,0,0,12,12
Tropical Depression,Six,7,2003-07-21T09:00:00Z,TNCM 181N 631W,14,11,0,0,25
Tropical Depression,Six,7,2003-07-21T09:00:00Z,MYNN 251N 775W,0,0,0,7,7
Tropical Depression,Six,7,2003-07-21T09:00:00Z,TISX 177N 648W,7,30,0,0,37
Tropical Depression,Six,7,2003-07-21T09:00:00Z,MYGF 266N 787W,0,0,0,2,2
Tropical Depression,Six,7,2003-07-21T09:00:00Z,TIST 183N 650W,2,28,0,0,30
Tropical Depression,Six,7,2003-07-21T09:00:00Z,ST CROIX VI,7,30,0,0,37
Tropical Depression,Six,7,2003-07-21T09:00:00Z,TJPS 180N 666W,0,32,2,0,34
Tropical Depression,Six,7,2003-07-21T09:00:00Z,ST THOMAS VI,2,28,0,0,30
Tropical Depression,Six,7,2003-07-21T09:00:00Z,MDSD 185N 697W,0,5,24,0,29
Tropical Depression,Six,7,2003-07-21T09:00:00Z,SAN JUAN PR,0,29,2,0,31
Tropical Depression,Six,7,2003-07-21T09:00:00Z,MDCB 176N 714W,0,1,23,2,26
Tropical Depression,Six,7,2003-07-21T09:00:00Z,PONCE PR,0,32,2,0,34
Tropical Depression,Six,7,2003-07-21T09:00:00Z,MTPP 186N 724W,0,0,18,8,26
Tropical Depression,Six,7,2003-07-21T09:00:00Z,MARATHON FL,0,0,0,5,5
Tropical Depression,Six,7,2003-07-21T09:00:00Z,MTCA 183N 738W,0,0,8,15,23
Tropical Depression,Six,7,2003-07-21T09:00:00Z,MIAMI FL,0,0,0,3,3
Tropical Depression,Six,7,2003-07-21T09:00:00Z,MKJP 179N 768W,0,0,0,16,16
Tropical Depression,Six,7,2003-07-21T09:00:00Z,W PALM BEACH FL,0,0,0,2,2
Tropical Depression,Six,7,2003-07-21T09:00:00Z,MKJS 185N 779W,0,0,0,16,16
Tropical Depression,Six,7,2003-07-21T09:00:00Z,KEY WEST FL,0,0,0,4,4
Tropical Depression,Six,7,2003-07-21T09:00:00Z,MWCG 193N 814W,0,0,0,6,6
Tropical Depression,Six,7,2003-07-21T09:00:00Z,MARCO ISLAND FL,0,0,0,2,2
Tropical Depression,Six,8,2003-07-21T15:00:00Z,15.9N  66.4W,50,3,0,0,53
Tropical Depression,Six,8,2003-07-21T15:00:00Z,MUSN 216N 826W,0,0,0,13,13
Tropical Depression,Six,8,2003-07-21T15:00:00Z,17.3N  70.1W,0,35,2,0,37
Tropical Depression,Six,8,2003-07-21T15:00:00Z,MUHA 230N 824W,0,0,0,15,15
Tropical Depression,Six,8,2003-07-21T15:00:00Z,19.0N  74.0W,0,1,26,1,28
Tropical Depression,Six,8,2003-07-21T15:00:00Z,MUAN 219N 850W,0,0,0,5,5
Tropical Depression,Six,8,2003-07-21T15:00:00Z,TBPB 131N 595W,17,0,0,0,17
Tropical Depression,Six,8,2003-07-21T15:00:00Z,TJSJ 184N 661W,15,12,0,0,27
Tropical Depression,Six,8,2003-07-21T15:00:00Z,TVSV 131N 612W,8,0,0,0,8
Tropical Depression,Six,8,2003-07-21T15:00:00Z,MDPP 198N 707W,0,12,16,0,28
Tropical Depression,Six,8,2003-07-21T15:00:00Z,TLPL 138N 610W,49,0,0,0,49
Tropical Depression,Six,8,2003-07-21T15:00:00Z,MBJT 215N 712W,0,1,13,2,16
Tropical Depression,Six,8,2003-07-21T15:00:00Z,TFFF 146N 610W,89,0,0,0,89
Tropical Depression,Six,8,2003-07-21T15:00:00Z,MYMM 224N 730W,0,0,9,6,15
Tropical Depression,Six,8,2003-07-21T15:00:00Z,TDPR 153N 614W,89,0,0,0,89
Tropical Depression,Six,8,2003-07-21T15:00:00Z,MYSM 241N 745W,0,0,1,10,11
Tropical Depression,Six,8,2003-07-21T15:00:00Z,SVBS 157N 636W,75,0,0,0,75
Tropical Depression,Six,8,2003-07-21T15:00:00Z,MYEG 235N 758W,0,0,1,15,16
Tropical Depression,Six,8,2003-07-21T15:00:00Z,TFFR 163N 615W,58,0,0,0,58
Tropical Depression,Six,8,2003-07-21T15:00:00Z,MYAK 241N 776W,0,0,0,17,17
Tropical Depression,Six,8,2003-07-21T15:00:00Z,TAPA 171N 618W,21,0,0,0,21
Tropical Depression,Six,8,2003-07-21T15:00:00Z,MYNN 251N 775W,0,0,0,12,12
Tropical Depression,Six,8,2003-07-21T15:00:00Z,TKPK 173N 627W,24,0,0,0,24
Tropical Depression,Six,8,2003-07-21T15:00:00Z,MYGF 266N 787W,0,0,0,7,7
Tropical Depression,Six,8,2003-07-21T15:00:00Z,TNCM 181N 631W,7,0,0,0,7
Tropical Depression,Six,8,2003-07-21T15:00:00Z,ST CROIX VI,31,2,0,0,33
Tropical Depression,Six,8,2003-07-21T15:00:00Z,TISX 177N 648W,31,2,0,0,33
Tropical Depression,Six,8,2003-07-21T15:00:00Z,ST THOMAS VI,16,3,0,0,19
Tropical Depression,Six,8,2003-07-21T15:00:00Z,TIST 183N 650W,16,3,0,0,19
Tropical Depression,Six,8,2003-07-21T15:00:00Z,SAN JUAN PR,15,12,0,0,27
Tropical Depression,Six,8,2003-07-21T15:00:00Z,TJPS 180N 666W,21,15,0,0,36
Tropical Depression,Six,8,2003-07-21T15:00:00Z,PONCE PR,21,15,0,0,36
Tropical Depression,Six,8,2003-07-21T15:00:00Z,MDSD 185N 697W,0,32,3,0,35
Tropical Depression,Six,8,2003-07-21T15:00:00Z,MARATHON FL,0,0,0,15,15
Tropical Depression,Six,8,2003-07-21T15:00:00Z,MDCB 176N 714W,0,23,10,0,33
Tropical Depression,Six,8,2003-07-21T15:00:00Z,MIAMI FL,0,0,0,11,11
Tropical Depression,Six,8,2003-07-21T15:00:00Z,MTPP 186N 724W,0,8,24,0,32
Tropical Depression,Six,8,2003-07-21T15:00:00Z,W PALM BEACH FL,0,0,0,7,7
Tropical Depression,Six,8,2003-07-21T15:00:00Z,MTCA 183N 738W,0,1,25,1,27
Tropical Depression,Six,8,2003-07-21T15:00:00Z,FT PIERCE FL,0,0,0,4,4
Tropical Depression,Six,8,2003-07-21T15:00:00Z,MKJP 179N 768W,0,0,8,8,16
Tropical Depression,Six,8,2003-07-21T15:00:00Z,COCOA BEACH FL,0,0,0,2,2
Tropical Depression,Six,8,2003-07-21T15:00:00Z,MKJS 185N 779W,0,0,4,12,16
Tropical Depression,Six,8,2003-07-21T15:00:00Z,KEY WEST FL,0,0,0,15,15
Tropical Depression,Six,8,2003-07-21T15:00:00Z,MWCG 193N 814W,0,0,0,10,10
Tropical Depression,Six,8,2003-07-21T15:00:00Z,MARCO ISLAND FL,0,0,0,10,10
Tropical Depression,Six,8,2003-07-21T15:00:00Z,MUGM 200N 751W,0,0,20,6,26
Tropical Depression,Six,8,2003-07-21T15:00:00Z,FT MYERS FL,0,0,0,7,7
Tropical Depression,Six,8,2003-07-21T15:00:00Z,MUCM 214N 779W,0,0,2,20,22
Tropical Depression,Six,8,2003-07-21T15:00:00Z,VENICE FL,0,0,0,5,5
Tropical Depression,Six,8,2003-07-21T15:00:00Z,MUCF 221N 805W,0,0,0,19,19
Tropical Depression,Six,8,2003-07-21T15:00:00Z,TAMPA FL,0,0,0,2,2
Tropical Depression,Seven,1,2003-07-25T18:00:00Z,33.5N  81.5W,34,0,0,0,34
Tropical Depression,Seven,1,2003-07-25T18:00:00Z,SAVANNAH GA,62,0,0,0,62
Tropical Depression,Seven,1,2003-07-25T18:00:00Z,35.5N  81.0W,2,18,0,0,20
Tropical Depression,Seven,1,2003-07-25T18:00:00Z,CHARLESTON SC,29,1,0,0,30
Tropical Depression,Seven,1,2003-07-25T18:00:00Z,DAYTONA BEACH FL,99,0,0,0,99
Tropical Depression,Seven,1,2003-07-25T18:00:00Z,MYRTLE BEACH SC,6,9,0,0,15
Tropical Depression,Seven,1,2003-07-25T18:00:00Z,JACKSONVILLE FL,79,0,0,0,79
Tropical Depression,Seven,1,2003-07-25T18:00:00Z,WILMINGTON NC,0,7,0,0,7
Tropical Depression,Seven,2,2003-07-25T21:00:00Z,34.5N  81.0W,34,1,0,0,35
Tropical Depression,Seven,2,2003-07-25T21:00:00Z,CHARLESTON SC,43,0,0,0,43
Tropical Depression,Seven,2,2003-07-25T21:00:00Z,36.5N  80.5W,2,19,0,0,21
Tropical Depression,Seven,2,2003-07-25T21:00:00Z,MYRTLE BEACH SC,17,3,0,0,20
Tropical Depression,Seven,2,2003-07-25T21:00:00Z,JACKSONVILLE FL,99,0,0,0,99
Tropical Depression,Seven,2,2003-07-25T21:00:00Z,WILMINGTON NC,3,9,0,0,12
Tropical Depression,Seven,2,2003-07-25T21:00:00Z,SAVANNAH GA,89,0,0,0,89
Tropical Depression,Seven,2,2003-07-25T21:00:00Z,MOREHEAD CITY NC,0,4,0,0,4
Tropical Depression,Seven,3,2003-07-26T03:00:00Z,34.0N  81.5W,29,1,0,0,30
Tropical Depression,Seven,3,2003-07-26T03:00:00Z,CHARLESTON SC,30,1,0,0,31
Tropical Depression,Seven,3,2003-07-26T03:00:00Z,35.5N  81.0W,6,12,0,0,18
Tropical Depression,Seven,3,2003-07-26T03:00:00Z,MYRTLE BEACH SC,6,8,0,0,14
Tropical Depression,Seven,3,2003-07-26T03:00:00Z,DAYTONA BEACH FL,5,0,0,0,5
Tropical Depression,Seven,3,2003-07-26T03:00:00Z,WILMINGTON NC,1,5,0,0,6
Tropical Depression,Seven,3,2003-07-26T03:00:00Z,JACKSONVILLE FL,99,0,0,0,99
Tropical Depression,Seven,3,2003-07-26T03:00:00Z,CEDAR KEY FL,4,0,0,0,4
Tropical Depression,Seven,3,2003-07-26T03:00:00Z,SAVANNAH GA,99,0,0,0,99
Tropical Storm,Erika,1,2003-08-14T21:00:00Z,26.0N  92.0W,45,2,0,0,47
Tropical Storm,Erika,1,2003-08-14T21:00:00Z,FREEPORT TX,0,12,7,1,20
Tropical Storm,Erika,1,2003-08-14T21:00:00Z,26.0N  95.0W,1,29,0,0,30
Tropical Storm,Erika,1,2003-08-14T21:00:00Z,PORT O CONNOR TX,0,10,11,1,22
Tropical Storm,Erika,1,2003-08-14T21:00:00Z,26.0N  97.5W,0,8,14,1,23
Tropical Storm,Erika,1,2003-08-14T21:00:00Z,CORPUSCHRISTI TX,0,5,16,2,23
Tropical Storm,Erika,1,2003-08-14T21:00:00Z,MMSO 238N 982W,0,1,9,4,14
Tropical Storm,Erika,1,2003-08-14T21:00:00Z,BROWNSVILLE TX,0,9,13,1,23
Tropical Storm,Erika,1,2003-08-14T21:00:00Z,MMTM 222N 979W,0,0,2,3,5
Tropical Storm,Erika,1,2003-08-14T21:00:00Z,GULF 29N 87W,2,0,0,0,2
Tropical Storm,Erika,1,2003-08-14T21:00:00Z,VENICE FL,29,0,0,0,29
Tropical Storm,Erika,1,2003-08-14T21:00:00Z,GULF 28N 89W,39,0,0,0,39
Tropical Storm,Erika,1,2003-08-14T21:00:00Z,TAMPA FL,4,0,0,0,4
Tropical Storm,Erika,1,2003-08-14T21:00:00Z,GULF 28N 91W,38,1,1,0,40
Tropical Storm,Erika,1,2003-08-14T21:00:00Z,BURAS LA,4,1,0,0,5
Tropical Storm,Erika,1,2003-08-14T21:00:00Z,GULF 28N 93W,16,17,0,0,33
Tropical Storm,Erika,1,2003-08-14T21:00:00Z,NEW ORLEANS LA,2,0,1,0,3
Tropical Storm,Erika,1,2003-08-14T21:00:00Z,GULF 28N 95W,1,24,2,0,27
Tropical Storm,Erika,1,2003-08-14T21:00:00Z,NEW IBERIA LA,2,4,1,1,8
Tropical Storm,Erika,1,2003-08-14T21:00:00Z,GULF 27N 96W,0,23,5,0,28
Tropical Storm,Erika,1,2003-08-14T21:00:00Z,PORT ARTHUR TX,0,7,4,1,12
Tropical Storm,Erika,1,2003-08-14T21:00:00Z,GULF 25N 96W,0,18,4,0,22
Tropical Storm,Erika,1,2003-08-14T21:00:00Z,GALVESTON TX,0,12,5,1,18
Tropical Storm,Erika,2,2003-08-15T03:00:00Z,26.5N  93.7W,41,1,0,0,42
Tropical Storm,Erika,2,2003-08-15T03:00:00Z,PORT O CONNOR TX,1,20,1,1,23
Tropical Storm,Erika,2,2003-08-15T03:00:00Z,26.4N  97.0W,5,25,1,0,31
Tropical Storm,Erika,2,2003-08-15T03:00:00Z,CORPUSCHRISTI TX,1,22,2,1,26
Tropical Storm,Erika,2,2003-08-15T03:00:00Z,26.3N  99.9W,0,15,8,1,24
Tropical Storm,Erika,2,2003-08-15T03:00:00Z,BROWNSVILLE TX,3,24,1,0,28
Tropical Storm,Erika,2,2003-08-15T03:00:00Z,MMSO 238N 982W,0,7,4,2,13
Tropical Storm,Erika,2,2003-08-15T03:00:00Z,GULF 28N 89W,46,0,0,0,46
Tropical Storm,Erika,2,2003-08-15T03:00:00Z,MMTM 222N 979W,0,0,2,2,4
Tropical Storm,Erika,2,2003-08-15T03:00:00Z,GULF 28N 91W,42,0,0,1,43
Tropical Storm,Erika,2,2003-08-15T03:00:00Z,BURAS LA,2,0,0,0,2
Tropical Storm,Erika,2,2003-08-15T03:00:00Z,GULF 28N 93W,31,2,0,0,33
Tropical Storm,Erika,2,2003-08-15T03:00:00Z,NEW IBERIA LA,1,2,0,0,3
Tropical Storm,Erika,2,2003-08-15T03:00:00Z,GULF 28N 95W,12,15,1,0,28
Tropical Storm,Erika,2,2003-08-15T03:00:00Z,PORT ARTHUR TX,1,3,2,0,6
Tropical Storm,Erika,2,2003-08-15T03:00:00Z,GULF 27N 96W,12,20,1,0,33
Tropical Storm,Erika,2,2003-08-15T03:00:00Z,GALVESTON TX,1,11,1,1,14
Tropical Storm,Erika,2,2003-08-15T03:00:00Z,GULF 25N 96W,9,13,1,0,23
Tropical Storm,Erika,2,2003-08-15T03:00:00Z,FREEPORT TX,1,14,2,0,17
Tropical Storm,Erika,3,2003-08-15T09:00:00Z,26.0N  95.5W,40,0,0,0,40
Tropical Storm,Erika,3,2003-08-15T09:00:00Z,PORT O CONNOR TX,8,10,1,1,20
Tropical Storm,Erika,3,2003-08-15T09:00:00Z,25.8N  98.4W,12,18,1,0,31
Tropical Storm,Erika,3,2003-08-15T09:00:00Z,CORPUSCHRISTI TX,8,15,1,1,25
Tropical Storm,Erika,3,2003-08-15T09:00:00Z,25.4N  99.8W,3,20,2,1,26
Tropical Storm,Erika,3,2003-08-15T09:00:00Z,BROWNSVILLE TX,23,10,1,0,34
Tropical Storm,Erika,3,2003-08-15T09:00:00Z,MMSO 238N 982W,3,11,2,1,17
Tropical Storm,Erika,3,2003-08-15T09:00:00Z,GULF 28N 89W,21,0,0,0,21
Tropical Storm,Erika,3,2003-08-15T09:00:00Z,MMTM 222N 979W,0,1,3,3,7
Tropical Storm,Erika,3,2003-08-15T09:00:00Z,GULF 28N 91W,28,0,0,0,28
Tropical Storm,Erika,3,2003-08-15T09:00:00Z,MMTX 210N 974W,0,0,0,3,3
Tropical Storm,Erika,3,2003-08-15T09:00:00Z,GULF 28N 93W,29,0,0,0,29
Tropical Storm,Erika,3,2003-08-15T09:00:00Z,PORT ARTHUR TX,1,0,1,2,4
Tropical Storm,Erika,3,2003-08-15T09:00:00Z,GULF 28N 95W,22,3,0,0,25
Tropical Storm,Erika,3,2003-08-15T09:00:00Z,GALVESTON TX,3,4,0,2,9
Tropical Storm,Erika,3,2003-08-15T09:00:00Z,GULF 27N 96W,32,3,0,0,35
Tropical Storm,Erika,3,2003-08-15T09:00:00Z,FREEPORT TX,5,6,1,1,13
Tropical Storm,Erika,3,2003-08-15T09:00:00Z,GULF 25N 96W,26,3,0,0,29
Tropical Storm,Erika,4,2003-08-15T15:00:00Z,26.0N  98.0W,40,0,0,0,40
Tropical Storm,Erika,4,2003-08-15T15:00:00Z,CORPUSCHRISTI TX,26,1,1,0,28
Tropical Storm,Erika,4,2003-08-15T15:00:00Z,26.0N 100.5W,17,12,0,0,29
Tropical Storm,Erika,4,2003-08-15T15:00:00Z,BROWNSVILLE TX,45,0,0,0,45
Tropical Storm,Erika,4,2003-08-15T15:00:00Z,26.0N 102.5W,2,19,2,0,23
Tropical Storm,Erika,4,2003-08-15T15:00:00Z,GULF 28N 91W,6,0,0,0,6
Tropical Storm,Erika,4,2003-08-15T15:00:00Z,MMSO 238N 982W,6,4,1,0,11
Tropical Storm,Erika,4,2003-08-15T15:00:00Z,GULF 28N 93W,19,0,0,0,19
Tropical Storm,Erika,4,2003-08-15T15:00:00Z,GALVESTON TX,2,0,1,0,3
Tropical Storm,Erika,4,2003-08-15T15:00:00Z,GULF 28N 95W,28,0,0,0,28
Tropical Storm,Erika,4,2003-08-15T15:00:00Z,FREEPORT TX,5,1,1,0,7
Tropical Storm,Erika,4,2003-08-15T15:00:00Z,GULF 27N 96W,55,0,0,0,55
Tropical Storm,Erika,4,2003-08-15T15:00:00Z,PORT O CONNOR TX,17,1,0,0,18
Tropical Storm,Erika,4,2003-08-15T15:00:00Z,GULF 25N 96W,34,0,0,0,34
Tropical Storm,Erika,5,2003-08-15T21:00:00Z,26.0N 100.0W,40,1,0,0,41
Tropical Storm,Erika,5,2003-08-15T21:00:00Z,BROWNSVILLE TX,65,0,0,0,65
Tropical Storm,Erika,5,2003-08-15T21:00:00Z,26.0N 103.0W,11,19,0,0,30
Tropical Storm,Erika,5,2003-08-15T21:00:00Z,GULF 28N 93W,2,0,0,0,2
Tropical Storm,Erika,5,2003-08-15T21:00:00Z,26.0N 106.0W,0,15,8,0,23
Tropical Storm,Erika,5,2003-08-15T21:00:00Z,GULF 28N 95W,12,0,0,0,12
Tropical Storm,Erika,5,2003-08-15T21:00:00Z,MMSO 238N 982W,4,0,1,0,5
Tropical Storm,Erika,5,2003-08-15T21:00:00Z,GULF 27N 96W,70,0,0,0,70
Tropical Storm,Erika,5,2003-08-15T21:00:00Z,PORT O CONNOR TX,9,1,0,0,10
Tropical Storm,Erika,5,2003-08-15T21:00:00Z,GULF 25N 96W,35,1,0,0,36
Tropical Storm,Erika,5,2003-08-15T21:00:00Z,CORPUSCHRISTI TX,30,0,0,0,30
Tropical Storm,Erika,6,2003-08-16T03:00:00Z,26.0N 101.0W,39,0,0,0,39
Tropical Storm,Erika,6,2003-08-16T03:00:00Z,CORPUSCHRISTI TX,29,0,0,0,29
Tropical Storm,Erika,6,2003-08-16T03:00:00Z,26.0N 104.0W,11,19,0,0,30
Tropical Storm,Erika,6,2003-08-16T03:00:00Z,BROWNSVILLE TX,80,0,0,0,80
Tropical Storm,Erika,6,2003-08-16T03:00:00Z,,99,0,0,0,99
Tropical Storm,Erika,6,2003-08-16T03:00:00Z,GULF 28N 95W,3,0,0,0,3
Tropical Storm,Erika,6,2003-08-16T03:00:00Z,MMSO 238N 982W,1,1,0,0,2
Tropical Storm,Erika,6,2003-08-16T03:00:00Z,GULF 27N 96W,85,0,0,0,85
Tropical Storm,Erika,6,2003-08-16T03:00:00Z,PORT O CONNOR TX,3,0,0,0,3
Tropical Storm,Erika,6,2003-08-16T03:00:00Z,GULF 25N 96W,39,0,0,0,39
Tropical Storm,Erika,7,2003-08-16T09:00:00Z,25.5N 102.0W,41,0,0,0,41
Tropical Storm,Erika,7,2003-08-16T09:00:00Z,CORPUSCHRISTI TX,2,0,0,0,2
Tropical Storm,Erika,7,2003-08-16T09:00:00Z,26.0N 104.5W,12,18,0,0,30
Tropical Storm,Erika,7,2003-08-16T09:00:00Z,BROWNSVILLE TX,99,0,0,0,99
Tropical Storm,Erika,7,2003-08-16T09:00:00Z,,99,0,0,0,99
Tropical Storm,Erika,7,2003-08-16T09:00:00Z,GULF 27N 96W,38,0,0,0,38
Tropical Storm,Erika,7,2003-08-16T09:00:00Z,MMSO 238N 982W,5,0,0,0,5
Tropical Storm,Erika,7,2003-08-16T09:00:00Z,GULF 25N 96W,99,0,0,0,99
Tropical Storm,Erika,8,2003-08-16T15:00:00Z,25.0N 103.0W,40,0,0,0,40
Tropical Storm,Erika,8,2003-08-16T15:00:00Z,MMSO 238N 982W,6,0,0,0,6
Tropical Storm,Erika,8,2003-08-16T15:00:00Z,,99,0,0,0,99
Tropical Storm,Erika,8,2003-08-16T15:00:00Z,BROWNSVILLE TX,99,0,0,0,99
Tropical Storm,Erika,8,2003-08-16T15:00:00Z,,99,0,0,0,99
Tropical Depression,Erika,9,2003-08-16T21:00:00Z,24.0N 105.0W,40,0,0,0,40
Tropical Depression,Erika,9,2003-08-16T21:00:00Z,,99,0,0,0,99
Tropical Depression,Erika,9,2003-08-16T21:00:00Z,,99,0,0,0,99
Tropical Depression,Erika,9,2003-08-16T21:00:00Z,MMSO 238N 982W,10,0,0,0,10
Tropical Depression,Nine,1,2003-08-21T21:00:00Z,16.5N  70.0W,48,0,0,0,48
Tropical Depression,Nine,1,2003-08-21T21:00:00Z,MBJT 215N 712W,0,2,9,3,14
Tropical Depression,Nine,1,2003-08-21T21:00:00Z,17.5N  72.0W,13,20,0,0,33
Tropical Depression,Nine,1,2003-08-21T21:00:00Z,MYMM 224N 730W,0,0,10,6,16
Tropical Depression,Nine,1,2003-08-21T21:00:00Z,19.0N  74.0W,0,13,15,1,29
Tropical Depression,Nine,1,2003-08-21T21:00:00Z,MYSM 241N 745W,0,0,1,13,14
Tropical Depression,Nine,1,2003-08-21T21:00:00Z,TJPS 180N 666W,5,0,0,0,5
Tropical Depression,Nine,1,2003-08-21T21:00:00Z,MYEG 235N 758W,0,0,2,15,17
Tropical Depression,Nine,1,2003-08-21T21:00:00Z,MDSD 185N 697W,21,7,0,0,28
Tropical Depression,Nine,1,2003-08-21T21:00:00Z,MYAK 241N 776W,0,0,0,15,15
Tropical Depression,Nine,1,2003-08-21T21:00:00Z,MDCB 176N 714W,22,14,0,0,36
Tropical Depression,Nine,1,2003-08-21T21:00:00Z,MYNN 251N 775W,0,0,0,12,12
Tropical Depression,Nine,1,2003-08-21T21:00:00Z,MTPP 186N 724W,1,28,2,0,31
Tropical Depression,Nine,1,2003-08-21T21:00:00Z,MYGF 266N 787W,0,0,0,7,7
Tropical Depression,Nine,1,2003-08-21T21:00:00Z,MTCA 183N 738W,0,20,9,0,29
Tropical Depression,Nine,1,2003-08-21T21:00:00Z,PONCE PR,5,0,0,0,5
Tropical Depression,Nine,1,2003-08-21T21:00:00Z,MKJP 179N 768W,0,0,10,5,15
Tropical Depression,Nine,1,2003-08-21T21:00:00Z,MARATHON FL,0,0,0,6,6
Tropical Depression,Nine,1,2003-08-21T21:00:00Z,MKJS 185N 779W,0,0,5,8,13
Tropical Depression,Nine,1,2003-08-21T21:00:00Z,MIAMI FL,0,0,0,7,7
Tropical Depression,Nine,1,2003-08-21T21:00:00Z,MWCG 193N 814W,0,0,0,3,3
Tropical Depression,Nine,1,2003-08-21T21:00:00Z,W PALM BEACH FL,0,0,0,5,5
Tropical Depression,Nine,1,2003-08-21T21:00:00Z,MUGM 200N 751W,0,1,21,2,24
Tropical Depression,Nine,1,2003-08-21T21:00:00Z,FT PIERCE FL,0,0,0,3,3
Tropical Depression,Nine,1,2003-08-21T21:00:00Z,MUCM 214N 779W,0,0,3,14,17
Tropical Depression,Nine,1,2003-08-21T21:00:00Z,COCOA BEACH FL,0,0,0,2,2
Tropical Depression,Nine,1,2003-08-21T21:00:00Z,MUCF 221N 805W,0,0,0,9,9
Tropical Depression,Nine,1,2003-08-21T21:00:00Z,KEY WEST FL,0,0,0,5,5
Tropical Depression,Nine,1,2003-08-21T21:00:00Z,MUSN 216N 826W,0,0,0,2,2
Tropical Depression,Nine,1,2003-08-21T21:00:00Z,MARCO ISLAND FL,0,0,0,3,3
Tropical Depression,Nine,1,2003-08-21T21:00:00Z,MUHA 230N 824W,0,0,0,3,3
Tropical Depression,Nine,1,2003-08-21T21:00:00Z,FT MYERS FL,0,0,0,3,3
Tropical Depression,Nine,1,2003-08-21T21:00:00Z,MDPP 198N 707W,1,17,3,0,21
Tropical Depression,Nine,2,2003-08-22T03:00:00Z,17.2N  70.6W,46,0,0,0,46
Tropical Depression,Nine,2,2003-08-22T03:00:00Z,MBJT 215N 712W,0,8,6,2,16
Tropical Depression,Nine,2,2003-08-22T03:00:00Z,18.4N  72.4W,13,19,1,0,33
Tropical Depression,Nine,2,2003-08-22T03:00:00Z,MYMM 224N 730W,0,2,11,5,18
Tropical Depression,Nine,2,2003-08-22T03:00:00Z,19.5N  74.0W,0,20,6,1,27
Tropical Depression,Nine,2,2003-08-22T03:00:00Z,MYSM 241N 745W,0,0,3,11,14
Tropical Depression,Nine,2,2003-08-22T03:00:00Z,TJPS 180N 666W,4,0,0,0,4
Tropical Depression,Nine,2,2003-08-22T03:00:00Z,MYEG 235N 758W,0,0,4,13,17
Tropical Depression,Nine,2,2003-08-22T03:00:00Z,MDSD 185N 697W,32,1,0,0,33
Tropical Depression,Nine,2,2003-08-22T03:00:00Z,MYAK 241N 776W,0,0,1,14,15
Tropical Depression,Nine,2,2003-08-22T03:00:00Z,MDCB 176N 714W,37,2,0,0,39
Tropical Depression,Nine,2,2003-08-22T03:00:00Z,MYNN 251N 775W,0,0,0,12,12
Tropical Depression,Nine,2,2003-08-22T03:00:00Z,MTPP 186N 724W,11,21,0,0,32
Tropical Depression,Nine,2,2003-08-22T03:00:00Z,MYGF 266N 787W,0,0,0,8,8
Tropical Depression,Nine,2,2003-08-22T03:00:00Z,MTCA 183N 738W,2,22,2,0,26
Tropical Depression,Nine,2,2003-08-22T03:00:00Z,PONCE PR,4,0,0,0,4
Tropical Depression,Nine,2,2003-08-22T03:00:00Z,MKJP 179N 768W,0,2,7,5,14
Tropical Depression,Nine,2,2003-08-22T03:00:00Z,MARATHON FL,0,0,0,7,7
Tropical Depression,Nine,2,2003-08-22T03:00:00Z,MKJS 185N 779W,0,0,5,7,12
Tropical Depression,Nine,2,2003-08-22T03:00:00Z,MIAMI FL,0,0,0,7,7
Tropical Depression,Nine,2,2003-08-22T03:00:00Z,MWCG 193N 814W,0,0,0,4,4
Tropical Depression,Nine,2,2003-08-22T03:00:00Z,W PALM BEACH FL,0,0,0,6,6
Tropical Depression,Nine,2,2003-08-22T03:00:00Z,MUGM 200N 751W,0,8,14,2,24
Tropical Depression,Nine,2,2003-08-22T03:00:00Z,FT PIERCE FL,0,0,0,4,4
Tropical Depression,Nine,2,2003-08-22T03:00:00Z,MUCM 214N 779W,0,0,5,12,17
Tropical Depression,Nine,2,2003-08-22T03:00:00Z,COCOA BEACH FL,0,0,0,2,2
Tropical Depression,Nine,2,2003-08-22T03:00:00Z,MUCF 221N 805W,0,0,0,9,9
Tropical Depression,Nine,2,2003-08-22T03:00:00Z,KEY WEST FL,0,0,0,5,5
Tropical Depression,Nine,2,2003-08-22T03:00:00Z,MUSN 216N 826W,0,0,0,3,3
Tropical Depression,Nine,2,2003-08-22T03:00:00Z,MARCO ISLAND FL,0,0,0,4,4
Tropical Depression,Nine,2,2003-08-22T03:00:00Z,MUHA 230N 824W,0,0,0,4,4
Tropical Depression,Nine,2,2003-08-22T03:00:00Z,FT MYERS FL,0,0,0,3,3
Tropical Depression,Nine,2,2003-08-22T03:00:00Z,MDPP 198N 707W,7,16,0,1,24
Tropical Depression,Nine,2,2003-08-22T03:00:00Z,VENICE FL,0,0,0,2,2
Tropical Depression,Nine,3,2003-08-22T09:00:00Z,17.9N  71.5W,45,0,0,0,45
Tropical Depression,Nine,3,2003-08-22T09:00:00Z,MYMM 224N 730W,0,8,8,3,19
Tropical Depression,Nine,3,2003-08-22T09:00:00Z,19.0N  73.2W,14,18,0,1,33
Tropical Depression,Nine,3,2003-08-22T09:00:00Z,MYSM 241N 745W,0,0,8,8,16
Tropical Depression,Nine,3,2003-08-22T09:00:00Z,20.0N  74.6W,0,22,4,1,27
Tropical Depression,Nine,3,2003-08-22T09:00:00Z,MYEG 235N 758W,0,0,9,10,19
Tropical Depression,Nine,3,2003-08-22T09:00:00Z,MDSD 185N 697W,42,0,0,0,42
Tropical Depression,Nine,3,2003-08-22T09:00:00Z,MYAK 241N 776W,0,0,2,14,16
Tropical Depression,Nine,3,2003-08-22T09:00:00Z,MDCB 176N 714W,47,0,0,0,47
Tropical Depression,Nine,3,2003-08-22T09:00:00Z,MYNN 251N 775W,0,0,1,13,14
Tropical Depression,Nine,3,2003-08-22T09:00:00Z,MTPP 186N 724W,32,4,0,0,36
Tropical Depression,Nine,3,2003-08-22T09:00:00Z,MYGF 266N 787W,0,0,0,10,10
Tropical Depression,Nine,3,2003-08-22T09:00:00Z,MTCA 183N 738W,11,18,0,0,29
Tropical Depression,Nine,3,2003-08-22T09:00:00Z,MARATHON FL,0,0,0,8,8
Tropical Depression,Nine,3,2003-08-22T09:00:00Z,MKJP 179N 768W,0,5,6,3,14
Tropical Depression,Nine,3,2003-08-22T09:00:00Z,MIAMI FL,0,0,0,9,9
Tropical Depression,Nine,3,2003-08-22T09:00:00Z,MKJS 185N 779W,0,1,7,5,13
Tropical Depression,Nine,3,2003-08-22T09:00:00Z,W PALM BEACH FL,0,0,0,8,8
Tropical Depression,Nine,3,2003-08-22T09:00:00Z,MWCG 193N 814W,0,0,0,4,4
Tropical Depression,Nine,3,2003-08-22T09:00:00Z,FT PIERCE FL,0,0,0,6,6
Tropical Depression,Nine,3,2003-08-22T09:00:00Z,MUGM 200N 751W,0,18,6,2,26
Tropical Depression,Nine,3,2003-08-22T09:00:00Z,COCOA BEACH FL,0,0,0,4,4
Tropical Depression,Nine,3,2003-08-22T09:00:00Z,MUCM 214N 779W,0,0,9,9,18
Tropical Depression,Nine,3,2003-08-22T09:00:00Z,DAYTONA BEACH FL,0,0,0,2,2
Tropical Depression,Nine,3,2003-08-22T09:00:00Z,MUCF 221N 805W,0,0,0,10,10
Tropical Depression,Nine,3,2003-08-22T09:00:00Z,KEY WEST FL,0,0,0,6,6
Tropical Depression,Nine,3,2003-08-22T09:00:00Z,MUSN 216N 826W,0,0,0,3,3
Tropical Depression,Nine,3,2003-08-22T09:00:00Z,MARCO ISLAND FL,0,0,0,6,6
Tropical Depression,Nine,3,2003-08-22T09:00:00Z,MUHA 230N 824W,0,0,0,5,5
Tropical Depression,Nine,3,2003-08-22T09:00:00Z,FT MYERS FL,0,0,0,4,4
Tropical Depression,Nine,3,2003-08-22T09:00:00Z,MDPP 198N 707W,22,3,1,0,26
Tropical Depression,Nine,3,2003-08-22T09:00:00Z,VENICE FL,0,0,0,3,3
Tropical Depression,Nine,3,2003-08-22T09:00:00Z,MBJT 215N 712W,1,12,2,1,16
Tropical Depression,Nine,3,2003-08-22T09:00:00Z,TAMPA FL,0,0,0,2,2
Tropical Depression,Nine,4,2003-08-22T15:00:00Z,18.5N  72.0W,47,0,0,0,47
Tropical Depression,Nine,4,2003-08-22T15:00:00Z,MYEG 235N 758W,0,3,18,3,24
Tropical Depression,Nine,4,2003-08-22T15:00:00Z,20.0N  74.0W,7,27,1,0,35
Tropical Depression,Nine,4,2003-08-22T15:00:00Z,MYAK 241N 776W,0,0,12,9,21
Tropical Depression,Nine,4,2003-08-22T15:00:00Z,21.5N  75.5W,0,19,8,1,28
Tropical Depression,Nine,4,2003-08-22T15:00:00Z,MYNN 251N 775W,0,0,9,10,19
Tropical Depression,Nine,4,2003-08-22T15:00:00Z,MDSD 185N 697W,51,0,0,1,52
Tropical Depression,Nine,4,2003-08-22T15:00:00Z,MYGF 266N 787W,0,0,1,14,15
Tropical Depression,Nine,4,2003-08-22T15:00:00Z,MDCB 176N 714W,53,0,0,0,53
Tropical Depression,Nine,4,2003-08-22T15:00:00Z,MARATHON FL,0,0,0,11,11
Tropical Depression,Nine,4,2003-08-22T15:00:00Z,MTPP 186N 724W,43,1,0,0,44
Tropical Depression,Nine,4,2003-08-22T15:00:00Z,MIAMI FL,0,0,0,13,13
Tropical Depression,Nine,4,2003-08-22T15:00:00Z,MTCA 183N 738W,22,10,0,0,32
Tropical Depression,Nine,4,2003-08-22T15:00:00Z,W PALM BEACH FL,0,0,0,13,13
Tropical Depression,Nine,4,2003-08-22T15:00:00Z,MKJP 179N 768W,0,5,4,3,12
Tropical Depression,Nine,4,2003-08-22T15:00:00Z,FT PIERCE FL,0,0,0,11,11
Tropical Depression,Nine,4,2003-08-22T15:00:00Z,MKJS 185N 779W,0,1,6,4,11
Tropical Depression,Nine,4,2003-08-22T15:00:00Z,COCOA BEACH FL,0,0,0,9,9
Tropical Depression,Nine,4,2003-08-22T15:00:00Z,MWCG 193N 814W,0,0,0,2,2
Tropical Depression,Nine,4,2003-08-22T15:00:00Z,DAYTONA BEACH FL,0,0,0,7,7
Tropical Depression,Nine,4,2003-08-22T15:00:00Z,MUGM 200N 751W,1,26,2,0,29
Tropical Depression,Nine,4,2003-08-22T15:00:00Z,JACKSONVILLE FL,0,0,0,4,4
Tropical Depression,Nine,4,2003-08-22T15:00:00Z,MUCM 214N 779W,0,1,13,5,19
Tropical Depression,Nine,4,2003-08-22T15:00:00Z,SAVANNAH GA,0,0,0,2,2
Tropical Depression,Nine,4,2003-08-22T15:00:00Z,MUCF 221N 805W,0,0,1,9,10
Tropical Depression,Nine,4,2003-08-22T15:00:00Z,KEY WEST FL,0,0,0,8,8
Tropical Depression,Nine,4,2003-08-22T15:00:00Z,MUSN 216N 826W,0,0,0,3,3
Tropical Depression,Nine,4,2003-08-22T15:00:00Z,MARCO ISLAND FL,0,0,0,9,9
Tropical Depression,Nine,4,2003-08-22T15:00:00Z,MUHA 230N 824W,0,0,0,5,5
Tropical Depression,Nine,4,2003-08-22T15:00:00Z,FT MYERS FL,0,0,0,8,8
Tropical Depression,Nine,4,2003-08-22T15:00:00Z,MDPP 198N 707W,31,1,0,0,32
Tropical Depression,Nine,4,2003-08-22T15:00:00Z,VENICE FL,0,0,0,6,6
Tropical Depression,Nine,4,2003-08-22T15:00:00Z,MBJT 215N 712W,4,13,1,0,18
Tropical Depression,Nine,4,2003-08-22T15:00:00Z,TAMPA FL,0,0,0,6,6
Tropical Depression,Nine,4,2003-08-22T15:00:00Z,MYMM 224N 730W,0,19,3,1,23
Tropical Depression,Nine,4,2003-08-22T15:00:00Z,CEDAR KEY FL,0,0,0,4,4
Tropical Depression,Nine,4,2003-08-22T15:00:00Z,MYSM 241N 745W,0,3,15,3,21
Tropical Depression,Ten,1,2003-08-27T21:00:00Z,15.6N  37.1W,45,0,0,0,45
Tropical Depression,Ten,1,2003-08-27T21:00:00Z,16.5N  43.0W,0,12,12,1,25
Tropical Depression,Ten,1,2003-08-27T21:00:00Z,16.1N  40.0W,6,25,0,0,31
Tropical Depression,Ten,2,2003-08-28T03:00:00Z,15.6N  38.5W,45,0,0,0,45
Tropical Depression,Ten,2,2003-08-28T03:00:00Z,16.5N  44.0W,0,15,8,1,24
Tropical Depression,Ten,2,2003-08-28T03:00:00Z,16.1N  41.4W,6,25,0,0,31
Tropical Depression,Ten,3,2003-08-28T09:00:00Z,15.4N  40.9W,47,0,0,0,47
Tropical Depression,Ten,3,2003-08-28T09:00:00Z,16.5N  45.7W,0,18,7,1,26
Tropical Depression,Ten,3,2003-08-28T09:00:00Z,15.9N  43.2W,16,17,0,0,33
Tropical Depression,Ten,4,2003-08-28T15:00:00Z,15.8N  42.3W,45,0,0,0,45
Tropical Depression,Ten,4,2003-08-28T15:00:00Z,16.9N  47.0W,0,18,6,1,25
Tropical Depression,Ten,4,2003-08-28T15:00:00Z,16.4N  44.7W,14,17,0,1,32
Tropical Storm,Fabian,5,2003-08-28T21:00:00Z,16.2N  44.0W,44,0,0,1,45
Tropical Storm,Fabian,5,2003-08-28T21:00:00Z,17.4N  49.0W,0,17,6,2,25
Tropical Storm,Fabian,5,2003-08-28T21:00:00Z,16.8N  46.5W,12,19,0,0,31
Tropical Storm,Fabian,6,2003-08-29T03:00:00Z,16.2N  46.0W,46,0,0,0,46
Tropical Storm,Fabian,6,2003-08-29T03:00:00Z,17.5N  50.5W,0,22,3,1,26
Tropical Storm,Fabian,6,2003-08-29T03:00:00Z,17.0N  48.5W,14,20,0,1,35
Tropical Storm,Fabian,7,2003-08-29T09:00:00Z,16.4N  47.9W,46,0,0,0,46
Tropical Storm,Fabian,7,2003-08-29T09:00:00Z,TDPR 153N 614W,0,0,0,2,2
Tropical Storm,Fabian,7,2003-08-29T09:00:00Z,17.2N  50.3W,16,17,1,0,34
Tropical Storm,Fabian,7,2003-08-29T09:00:00Z,TFFR 163N 615W,0,0,0,3,3
Tropical Storm,Fabian,7,2003-08-29T09:00:00Z,17.8N  52.2W,0,23,2,1,26
Tropical Storm,Fabian,7,2003-08-29T09:00:00Z,TAPA 171N 618W,0,0,0,3,3
Tropical Storm,Fabian,7,2003-08-29T09:00:00Z,TBPB 131N 595W,0,0,0,2,2
Tropical Storm,Fabian,7,2003-08-29T09:00:00Z,TKPK 173N 627W,0,0,0,2,2
Tropical Storm,Fabian,7,2003-08-29T09:00:00Z,TFFF 146N 610W,0,0,0,2,2
Tropical Storm,Fabian,7,2003-08-29T09:00:00Z,TNCM 181N 631W,0,0,0,2,2
Tropical Storm,Fabian,8,2003-08-29T15:00:00Z,16.5N  48.5W,46,0,0,0,46
Tropical Storm,Fabian,8,2003-08-29T15:00:00Z,TDPR 153N 614W,0,0,0,3,3
Tropical Storm,Fabian,8,2003-08-29T15:00:00Z,17.5N  51.0W,14,19,0,1,34
Tropical Storm,Fabian,8,2003-08-29T15:00:00Z,TFFR 163N 615W,0,0,0,5,5
Tropical Storm,Fabian,8,2003-08-29T15:00:00Z,18.5N  53.5W,0,18,7,1,26
Tropical Storm,Fabian,8,2003-08-29T15:00:00Z,TAPA 171N 618W,0,0,0,5,5
Tropical Storm,Fabian,8,2003-08-29T15:00:00Z,TBPB 131N 595W,0,0,0,3,3
Tropical Storm,Fabian,8,2003-08-29T15:00:00Z,TKPK 173N 627W,0,0,0,4,4
Tropical Storm,Fabian,8,2003-08-29T15:00:00Z,TLPL 138N 610W,0,0,0,2,2
Tropical Storm,Fabian,8,2003-08-29T15:00:00Z,TNCM 181N 631W,0,0,0,4,4
Tropical Storm,Fabian,8,2003-08-29T15:00:00Z,TFFF 146N 610W,0,0,0,3,3
Hurricane,Fabian,9,2003-08-29T21:00:00Z,17.0N  50.0W,44,0,0,0,44
Hurricane,Fabian,9,2003-08-29T21:00:00Z,TFFR 163N 615W,0,0,0,7,7
Hurricane,Fabian,9,2003-08-29T21:00:00Z,18.0N  52.5W,11,20,0,0,31
Hurricane,Fabian,9,2003-08-29T21:00:00Z,TAPA 171N 618W,0,0,0,8,8
Hurricane,Fabian,9,2003-08-29T21:00:00Z,18.5N  55.0W,0,16,7,1,24
Hurricane,Fabian,9,2003-08-29T21:00:00Z,TKPK 173N 627W,0,0,0,6,6
Hurricane,Fabian,9,2003-08-29T21:00:00Z,TBPB 131N 595W,0,0,0,6,6
Hurricane,Fabian,9,2003-08-29T21:00:00Z,TNCM 181N 631W,0,0,0,6,6
Hurricane,Fabian,9,2003-08-29T21:00:00Z,TVSV 131N 612W,0,0,0,3,3
Hurricane,Fabian,9,2003-08-29T21:00:00Z,TISX 177N 648W,0,0,0,2,2
Hurricane,Fabian,9,2003-08-29T21:00:00Z,TLPL 138N 610W,0,0,0,4,4
Hurricane,Fabian,9,2003-08-29T21:00:00Z,TIST 183N 650W,0,0,0,2,2
Hurricane,Fabian,9,2003-08-29T21:00:00Z,TFFF 146N 610W,0,0,0,6,6
Hurricane,Fabian,9,2003-08-29T21:00:00Z,ST CROIX VI,0,0,0,2,2
Hurricane,Fabian,9,2003-08-29T21:00:00Z,TDPR 153N 614W,0,0,0,6,6
Hurricane,Fabian,9,2003-08-29T21:00:00Z,ST THOMAS VI,0,0,0,2,2
Hurricane,Fabian,9,2003-08-29T21:00:00Z,SVBS 157N 636W,0,0,0,2,2
Hurricane,Fabian,10,2003-08-30T03:00:00Z,17.8N  50.5W,51,0,0,0,51
Hurricane,Fabian,10,2003-08-30T03:00:00Z,TFFR 163N 615W,0,0,0,4,4
Hurricane,Fabian,10,2003-08-30T03:00:00Z,18.5N  52.9W,6,27,1,0,34
Hurricane,Fabian,10,2003-08-30T03:00:00Z,TAPA 171N 618W,0,0,0,5,5
Hurricane,Fabian,10,2003-08-30T03:00:00Z,19.0N  55.0W,0,16,9,1,26
Hurricane,Fabian,10,2003-08-30T03:00:00Z,TKPK 173N 627W,0,0,0,4,4
Hurricane,Fabian,10,2003-08-30T03:00:00Z,TDPR 153N 614W,0,0,0,2,2
Hurricane,Fabian,10,2003-08-30T03:00:00Z,TNCM 181N 631W,0,0,0,4,4
Hurricane,Fabian,11,2003-08-30T09:00:00Z,18.0N  51.8W,48,0,0,0,48
Hurricane,Fabian,11,2003-08-30T09:00:00Z,TFFR 163N 615W,0,0,0,4,4
Hurricane,Fabian,11,2003-08-30T09:00:00Z,18.6N  54.0W,6,26,0,0,32
Hurricane,Fabian,11,2003-08-30T09:00:00Z,TAPA 171N 618W,0,0,0,6,6
Hurricane,Fabian,11,2003-08-30T09:00:00Z,19.2N  56.1W,0,14,11,1,26
Hurricane,Fabian,11,2003-08-30T09:00:00Z,TKPK 173N 627W,0,0,0,4,4
Hurricane,Fabian,11,2003-08-30T09:00:00Z,TDPR 153N 614W,0,0,0,2,2
Hurricane,Fabian,11,2003-08-30T09:00:00Z,TNCM 181N 631W,0,0,0,5,5
Hurricane,Fabian,12,2003-08-30T15:00:00Z,18.5N  53.0W,48,0,0,0,48
Hurricane,Fabian,12,2003-08-30T15:00:00Z,TKPK 173N 627W,0,0,0,8,8
Hurricane,Fabian,12,2003-08-30T15:00:00Z,19.0N  55.5W,6,27,0,0,33
Hurricane,Fabian,12,2003-08-30T15:00:00Z,TNCM 181N 631W,0,0,0,9,9
Hurricane,Fabian,12,2003-08-30T15:00:00Z,19.5N  57.5W,0,17,8,1,26
Hurricane,Fabian,12,2003-08-30T15:00:00Z,TISX 177N 648W,0,0,0,4,4
Hurricane,Fabian,12,2003-08-30T15:00:00Z,TFFF 146N 610W,0,0,0,3,3
Hurricane,Fabian,12,2003-08-30T15:00:00Z,TIST 183N 650W,0,0,0,5,5
Hurricane,Fabian,12,2003-08-30T15:00:00Z,TDPR 153N 614W,0,0,0,4,4
Hurricane,Fabian,12,2003-08-30T15:00:00Z,TJSJ 184N 661W,0,0,0,2,2
Hurricane,Fabian,12,2003-08-30T15:00:00Z,SVBS 157N 636W,0,0,0,2,2
Hurricane,Fabian,12,2003-08-30T15:00:00Z,ST CROIX VI,0,0,0,4,4
Hurricane,Fabian,12,2003-08-30T15:00:00Z,TFFR 163N 615W,0,0,1,6,7
Hurricane,Fabian,12,2003-08-30T15:00:00Z,ST THOMAS VI,0,0,0,5,5
Hurricane,Fabian,12,2003-08-30T15:00:00Z,TAPA 171N 618W,0,0,1,9,10
Hurricane,Fabian,12,2003-08-30T15:00:00Z,SAN JUAN PR,0,0,0,2,2
Hurricane,Fabian,13,2003-08-30T21:00:00Z,18.0N  54.2W,46,0,0,0,46
Hurricane,Fabian,13,2003-08-30T21:00:00Z,TNCM 181N 631W,0,0,2,9,11
Hurricane,Fabian,13,2003-08-30T21:00:00Z,18.5N  56.5W,7,25,0,0,32
Hurricane,Fabian,13,2003-08-30T21:00:00Z,TISX 177N 648W,0,0,0,5,5
Hurricane,Fabian,13,2003-08-30T21:00:00Z,19.5N  59.0W,0,9,18,1,28
Hurricane,Fabian,13,2003-08-30T21:00:00Z,TIST 183N 650W,0,0,0,6,6
Hurricane,Fabian,13,2003-08-30T21:00:00Z,TFFF 146N 610W,0,0,1,2,3
Hurricane,Fabian,13,2003-08-30T21:00:00Z,TJPS 180N 666W,0,0,0,2,2
Hurricane,Fabian,13,2003-08-30T21:00:00Z,TDPR 153N 614W,0,0,1,3,4
Hurricane,Fabian,13,2003-08-30T21:00:00Z,TJSJ 184N 661W,0,0,0,3,3
Hurricane,Fabian,13,2003-08-30T21:00:00Z,SVBS 157N 636W,0,0,0,2,2
Hurricane,Fabian,13,2003-08-30T21:00:00Z,ST CROIX VI,0,0,0,5,5
Hurricane,Fabian,13,2003-08-30T21:00:00Z,TFFR 163N 615W,0,0,2,6,8
Hurricane,Fabian,13,2003-08-30T21:00:00Z,ST THOMAS VI,0,0,0,6,6
Hurricane,Fabian,13,2003-08-30T21:00:00Z,TAPA 171N 618W,0,0,4,7,11
Hurricane,Fabian,13,2003-08-30T21:00:00Z,SAN JUAN PR,0,0,0,3,3
Hurricane,Fabian,13,2003-08-30T21:00:00Z,TKPK 173N 627W,0,0,2,7,9
Hurricane,Fabian,13,2003-08-30T21:00:00Z,PONCE PR,0,0,0,2,2
Hurricane,Fabian,14,2003-08-31T03:00:00Z,18.6N  54.7W,47,0,0,0,47
Hurricane,Fabian,14,2003-08-31T03:00:00Z,TNCM 181N 631W,0,0,2,8,10
Hurricane,Fabian,14,2003-08-31T03:00:00Z,19.2N  57.1W,7,26,1,0,34
Hurricane,Fabian,14,2003-08-31T03:00:00Z,TISX 177N 648W,0,0,0,4,4
Hurricane,Fabian,14,2003-08-31T03:00:00Z,20.1N  59.2W,0,16,10,1,27
Hurricane,Fabian,14,2003-08-31T03:00:00Z,TIST 183N 650W,0,0,0,6,6
Hurricane,Fabian,14,2003-08-31T03:00:00Z,TFFF 146N 610W,0,0,0,2,2
Hurricane,Fabian,14,2003-08-31T03:00:00Z,TJPS 180N 666W,0,0,0,2,2
Hurricane,Fabian,14,2003-08-31T03:00:00Z,TDPR 153N 614W,0,0,1,2,3
Hurricane,Fabian,14,2003-08-31T03:00:00Z,TJSJ 184N 661W,0,0,0,3,3
Hurricane,Fabian,14,2003-08-31T03:00:00Z,SVBS 157N 636W,0,0,0,2,2
Hurricane,Fabian,14,2003-08-31T03:00:00Z,ST CROIX VI,0,0,0,4,4
Hurricane,Fabian,14,2003-08-31T03:00:00Z,TFFR 163N 615W,0,0,2,4,6
Hurricane,Fabian,14,2003-08-31T03:00:00Z,ST THOMAS VI,0,0,0,6,6
Hurricane,Fabian,14,2003-08-31T03:00:00Z,TAPA 171N 618W,0,0,4,5,9
Hurricane,Fabian,14,2003-08-31T03:00:00Z,SAN JUAN PR,0,0,0,3,3
Hurricane,Fabian,14,2003-08-31T03:00:00Z,TKPK 173N 627W,0,0,2,6,8
Hurricane,Fabian,14,2003-08-31T03:00:00Z,PONCE PR,0,0,0,2,2
Hurricane,Fabian,15,2003-08-31T09:00:00Z,19.3N  55.8W,49,0,0,0,49
Hurricane,Fabian,15,2003-08-31T09:00:00Z,TISX 177N 648W,0,0,0,3,3
Hurricane,Fabian,15,2003-08-31T09:00:00Z,20.1N  57.8W,13,20,0,0,33
Hurricane,Fabian,15,2003-08-31T09:00:00Z,TIST 183N 650W,0,0,0,4,4
Hurricane,Fabian,15,2003-08-31T09:00:00Z,21.0N  59.8W,0,17,9,1,27
Hurricane,Fabian,15,2003-08-31T09:00:00Z,TJSJ 184N 661W,0,0,0,2,2
Hurricane,Fabian,15,2003-08-31T09:00:00Z,TFFR 163N 615W,0,0,2,2,4
Hurricane,Fabian,15,2003-08-31T09:00:00Z,ST CROIX VI,0,0,0,3,3
Hurricane,Fabian,15,2003-08-31T09:00:00Z,TAPA 171N 618W,0,0,3,3,6
Hurricane,Fabian,15,2003-08-31T09:00:00Z,ST THOMAS VI,0,0,0,4,4
Hurricane,Fabian,15,2003-08-31T09:00:00Z,TKPK 173N 627W,0,0,2,3,5
Hurricane,Fabian,15,2003-08-31T09:00:00Z,SAN JUAN PR,0,0,0,2,2
Hurricane,Fabian,15,2003-08-31T09:00:00Z,TNCM 181N 631W,0,0,2,6,8
Hurricane,Fabian,16,2003-08-31T15:00:00Z,19.3N  57.3W,47,0,0,0,47
Hurricane,Fabian,16,2003-08-31T15:00:00Z,TIST 183N 650W,0,0,2,5,7
Hurricane,Fabian,16,2003-08-31T15:00:00Z,20.0N  59.5W,6,26,0,0,32
Hurricane,Fabian,16,2003-08-31T15:00:00Z,TJPS 180N 666W,0,0,0,3,3
Hurricane,Fabian,16,2003-08-31T15:00:00Z,21.0N  61.5W,0,14,11,1,26
Hurricane,Fabian,16,2003-08-31T15:00:00Z,TJSJ 184N 661W,0,0,1,4,5
Hurricane,Fabian,16,2003-08-31T15:00:00Z,TFFR 163N 615W,0,1,2,1,4
Hurricane,Fabian,16,2003-08-31T15:00:00Z,ST CROIX VI,0,0,2,3,5
Hurricane,Fabian,16,2003-08-31T15:00:00Z,TAPA 171N 618W,0,3,4,1,8
Hurricane,Fabian,16,2003-08-31T15:00:00Z,ST THOMAS VI,0,0,2,5,7
Hurricane,Fabian,16,2003-08-31T15:00:00Z,TKPK 173N 627W,0,1,4,3,8
Hurricane,Fabian,16,2003-08-31T15:00:00Z,SAN JUAN PR,0,0,1,4,5
Hurricane,Fabian,16,2003-08-31T15:00:00Z,TNCM 181N 631W,0,1,7,3,11
Hurricane,Fabian,16,2003-08-31T15:00:00Z,PONCE PR,0,0,0,3,3
Hurricane,Fabian,16,2003-08-31T15:00:00Z,TISX 177N 648W,0,0,2,3,5
Hurricane,Fabian,17,2003-08-31T21:00:00Z,19.0N  58.0W,50,0,0,0,50
Hurricane,Fabian,17,2003-08-31T21:00:00Z,TIST 183N 650W,0,0,3,3,6
Hurricane,Fabian,17,2003-08-31T21:00:00Z,20.0N  60.0W,8,25,0,0,33
Hurricane,Fabian,17,2003-08-31T21:00:00Z,TJPS 180N 666W,0,0,0,2,2
Hurricane,Fabian,17,2003-08-31T21:00:00Z,21.0N  62.0W,0,13,12,1,26
Hurricane,Fabian,17,2003-08-31T21:00:00Z,TJSJ 184N 661W,0,0,1,3,4
Hurricane,Fabian,17,2003-08-31T21:00:00Z,TFFR 163N 615W,0,1,1,0,2
Hurricane,Fabian,17,2003-08-31T21:00:00Z,ST CROIX VI,0,0,2,2,4
Hurricane,Fabian,17,2003-08-31T21:00:00Z,TAPA 171N 618W,0,3,3,0,6
Hurricane,Fabian,17,2003-08-31T21:00:00Z,ST THOMAS VI,0,0,3,3,6
Hurricane,Fabian,17,2003-08-31T21:00:00Z,TKPK 173N 627W,0,1,4,1,6
Hurricane,Fabian,17,2003-08-31T21:00:00Z,SAN JUAN PR,0,0,1,3,4
Hurricane,Fabian,17,2003-08-31T21:00:00Z,TNCM 181N 631W,0,2,6,2,10
Hurricane,Fabian,17,2003-08-31T21:00:00Z,PONCE PR,0,0,0,2,2
Hurricane,Fabian,17,2003-08-31T21:00:00Z,TISX 177N 648W,0,0,2,2,4
Hurricane,Fabian,18,2003-09-01T03:00:00Z,19.6N  58.6W,46,0,0,0,46
Hurricane,Fabian,18,2003-09-01T03:00:00Z,TISX 177N 648W,0,0,3,3,6
Hurricane,Fabian,18,2003-09-01T03:00:00Z,20.5N  60.6W,9,22,1,0,32
Hurricane,Fabian,18,2003-09-01T03:00:00Z,TIST 183N 650W,0,0,4,4,8
Hurricane,Fabian,18,2003-09-01T03:00:00Z,21.5N  62.5W,0,15,10,1,26
Hurricane,Fabian,18,2003-09-01T03:00:00Z,TJPS 180N 666W,0,0,1,2,3
Hurricane,Fabian,18,2003-09-01T03:00:00Z,TDPR 153N 614W,0,1,0,1,2
Hurricane,Fabian,18,2003-09-01T03:00:00Z,TJSJ 184N 661W,0,0,1,4,5
Hurricane,Fabian,18,2003-09-01T03:00:00Z,SVBS 157N 636W,0,0,1,1,2
Hurricane,Fabian,18,2003-09-01T03:00:00Z,ST CROIX VI,0,0,3,3,6
Hurricane,Fabian,18,2003-09-01T03:00:00Z,TFFR 163N 615W,0,3,2,1,6
Hurricane,Fabian,18,2003-09-01T03:00:00Z,ST THOMAS VI,0,0,4,4,8
Hurricane,Fabian,18,2003-09-01T03:00:00Z,TAPA 171N 618W,0,6,3,1,10
Hurricane,Fabian,18,2003-09-01T03:00:00Z,SAN JUAN PR,0,0,1,4,5
Hurricane,Fabian,18,2003-09-01T03:00:00Z,TKPK 173N 627W,0,3,5,1,9
Hurricane,Fabian,18,2003-09-01T03:00:00Z,PONCE PR,0,0,1,2,3
Hurricane,Fabian,18,2003-09-01T03:00:00Z,TNCM 181N 631W,0,4,6,2,12
Hurricane,Fabian,19,2003-09-01T09:00:00Z,19.6N  59.2W,48,0,0,0,48
Hurricane,Fabian,19,2003-09-01T09:00:00Z,TIST 183N 650W,0,0,4,2,6
Hurricane,Fabian,19,2003-09-01T09:00:00Z,20.7N  61.2W,12,22,0,0,34
Hurricane,Fabian,19,2003-09-01T09:00:00Z,TJPS 180N 666W,0,0,0,2,2
Hurricane,Fabian,19,2003-09-01T09:00:00Z,22.0N  63.0W,0,19,8,1,28
Hurricane,Fabian,19,2003-09-01T09:00:00Z,TJSJ 184N 661W,0,0,1,3,4
Hurricane,Fabian,19,2003-09-01T09:00:00Z,TFFR 163N 615W,0,3,1,0,4
Hurricane,Fabian,19,2003-09-01T09:00:00Z,ST CROIX VI,0,0,3,2,5
Hurricane,Fabian,19,2003-09-01T09:00:00Z,TAPA 171N 618W,1,6,2,0,9
Hurricane,Fabian,19,2003-09-01T09:00:00Z,ST THOMAS VI,0,0,4,2,6
Hurricane,Fabian,19,2003-09-01T09:00:00Z,TKPK 173N 627W,0,4,3,1,8
Hurricane,Fabian,19,2003-09-01T09:00:00Z,SAN JUAN PR,0,0,1,3,4
Hurricane,Fabian,19,2003-09-01T09:00:00Z,TNCM 181N 631W,0,6,4,1,11
Hurricane,Fabian,19,2003-09-01T09:00:00Z,PONCE PR,0,0,0,2,2
Hurricane,Fabian,19,2003-09-01T09:00:00Z,TISX 177N 648W,0,0,3,2,5
Hurricane,Fabian,20,2003-09-01T15:00:00Z,20.0N  60.2W,46,0,0,0,46
Hurricane,Fabian,20,2003-09-01T15:00:00Z,TIST 183N 650W,0,2,4,2,8
Hurricane,Fabian,20,2003-09-01T15:00:00Z,21.0N  62.0W,12,19,1,0,32
Hurricane,Fabian,20,2003-09-01T15:00:00Z,TJPS 180N 666W,0,0,1,2,3
Hurricane,Fabian,20,2003-09-01T15:00:00Z,22.3N  63.6W,0,18,7,2,27
Hurricane,Fabian,20,2003-09-01T15:00:00Z,TJSJ 184N 661W,0,0,3,2,5
Hurricane,Fabian,20,2003-09-01T15:00:00Z,TFFR 163N 615W,1,3,0,1,5
Hurricane,Fabian,20,2003-09-01T15:00:00Z,ST CROIX VI,0,1,3,2,6
Hurricane,Fabian,20,2003-09-01T15:00:00Z,TAPA 171N 618W,3,6,1,0,10
Hurricane,Fabian,20,2003-09-01T15:00:00Z,ST THOMAS VI,0,2,4,2,8
Hurricane,Fabian,20,2003-09-01T15:00:00Z,TKPK 173N 627W,1,6,2,0,9
Hurricane,Fabian,20,2003-09-01T15:00:00Z,SAN JUAN PR,0,0,3,2,5
Hurricane,Fabian,20,2003-09-01T15:00:00Z,TNCM 181N 631W,1,9,3,0,13
Hurricane,Fabian,20,2003-09-01T15:00:00Z,PONCE PR,0,0,1,2,3
Hurricane,Fabian,20,2003-09-01T15:00:00Z,TISX 177N 648W,0,1,3,2,6
Hurricane,Fabian,21,2003-09-01T21:00:00Z,20.5N  61.0W,47,0,0,0,47
Hurricane,Fabian,21,2003-09-01T21:00:00Z,TIST 183N 650W,0,3,3,1,7
Hurricane,Fabian,21,2003-09-01T21:00:00Z,21.5N  62.5W,18,13,1,0,32
Hurricane,Fabian,21,2003-09-01T21:00:00Z,TJPS 180N 666W,0,0,1,1,2
Hurricane,Fabian,21,2003-09-01T21:00:00Z,23.0N  64.0W,0,17,9,1,27
Hurricane,Fabian,21,2003-09-01T21:00:00Z,TJSJ 184N 661W,0,1,2,1,4
Hurricane,Fabian,21,2003-09-01T21:00:00Z,TFFR 163N 615W,1,0,1,0,2
Hurricane,Fabian,21,2003-09-01T21:00:00Z,BERMUDA,0,0,0,4,4
Hurricane,Fabian,21,2003-09-01T21:00:00Z,TAPA 171N 618W,4,3,0,0,7
Hurricane,Fabian,21,2003-09-01T21:00:00Z,ST CROIX VI,0,2,2,1,5
Hurricane,Fabian,21,2003-09-01T21:00:00Z,TKPK 173N 627W,3,4,1,0,8
Hurricane,Fabian,21,2003-09-01T21:00:00Z,ST THOMAS VI,0,3,3,1,7
Hurricane,Fabian,21,2003-09-01T21:00:00Z,TNCM 181N 631W,4,7,1,0,12
Hurricane,Fabian,21,2003-09-01T21:00:00Z,SAN JUAN PR,0,1,2,1,4
Hurricane,Fabian,21,2003-09-01T21:00:00Z,TISX 177N 648W,0,2,2,1,5
Hurricane,Fabian,21,2003-09-01T21:00:00Z,PONCE PR,0,0,1,1,2
Hurricane,Fabian,22,2003-09-02T03:00:00Z,20.8N  62.1W,51,0,0,0,51
Hurricane,Fabian,22,2003-09-02T03:00:00Z,TJPS 180N 666W,0,1,0,1,2
Hurricane,Fabian,22,2003-09-02T03:00:00Z,22.1N  63.6W,15,18,1,0,34
Hurricane,Fabian,22,2003-09-02T03:00:00Z,TJSJ 184N 661W,0,2,1,1,4
Hurricane,Fabian,22,2003-09-02T03:00:00Z,23.3N  64.7W,0,22,4,0,26
Hurricane,Fabian,22,2003-09-02T03:00:00Z,BERMUDA,0,0,0,3,3
Hurricane,Fabian,22,2003-09-02T03:00:00Z,TAPA 171N 618W,3,1,0,0,4
Hurricane,Fabian,22,2003-09-02T03:00:00Z,ST CROIX VI,1,2,1,0,4
Hurricane,Fabian,22,2003-09-02T03:00:00Z,TKPK 173N 627W,4,1,0,0,5
Hurricane,Fabian,22,2003-09-02T03:00:00Z,ST THOMAS VI,1,5,0,1,7
Hurricane,Fabian,22,2003-09-02T03:00:00Z,TNCM 181N 631W,11,2,0,0,13
Hurricane,Fabian,22,2003-09-02T03:00:00Z,SAN JUAN PR,0,2,1,1,4
Hurricane,Fabian,22,2003-09-02T03:00:00Z,TISX 177N 648W,1,2,1,0,4
Hurricane,Fabian,22,2003-09-02T03:00:00Z,PONCE PR,0,1,0,1,2
Hurricane,Fabian,22,2003-09-02T03:00:00Z,TIST 183N 650W,1,5,0,1,7
Hurricane,Fabian,23,2003-09-02T09:00:00Z,21.5N  63.0W,57,0,0,0,57
Hurricane,Fabian,23,2003-09-02T09:00:00Z,24.5N  65.2W,0,23,5,0,28
Hurricane,Fabian,23,2003-09-02T09:00:00Z,23.0N  64.3W,14,23,0,0,37
Hurricane,Fabian,23,2003-09-02T09:00:00Z,BERMUDA,0,0,0,6,6
Hurricane,Fabian,24,2003-09-02T15:00:00Z,22.2N  62.9W,56,0,0,0,56
Hurricane,Fabian,24,2003-09-02T15:00:00Z,25.1N  65.3W,0,21,6,0,27
Hurricane,Fabian,24,2003-09-02T15:00:00Z,23.5N  64.2W,18,17,0,0,35
Hurricane,Fabian,24,2003-09-02T15:00:00Z,BERMUDA,0,0,0,10,10
Hurricane,Fabian,25,2003-09-02T21:00:00Z,22.7N  63.5W,50,1,0,0,51
Hurricane,Fabian,25,2003-09-02T21:00:00Z,26.0N  66.0W,0,12,16,1,29
Hurricane,Fabian,25,2003-09-02T21:00:00Z,24.1N  64.7W,10,25,0,0,35
Hurricane,Fabian,25,2003-09-02T21:00:00Z,BERMUDA,0,0,0,14,14
Hurricane,Fabian,26,2003-09-03T03:00:00Z,23.4N  63.9W,48,0,0,0,48
Hurricane,Fabian,26,2003-09-03T03:00:00Z,27.2N  66.0W,0,14,12,1,27
Hurricane,Fabian,26,2003-09-03T03:00:00Z,25.0N  65.1W,14,18,0,0,32
Hurricane,Fabian,26,2003-09-03T03:00:00Z,BERMUDA,0,0,1,15,16
Hurricane,Fabian,27,2003-09-03T09:00:00Z,24.0N  64.5W,50,0,0,0,50
Hurricane,Fabian,27,2003-09-03T09:00:00Z,28.0N  66.3W,0,16,11,1,28
Hurricane,Fabian,27,2003-09-03T09:00:00Z,25.8N  65.5W,21,13,0,0,34
Hurricane,Fabian,27,2003-09-03T09:00:00Z,BERMUDA,0,0,1,16,17
Hurricane,Fabian,28,2003-09-03T15:00:00Z,25.0N  65.0W,46,0,0,0,46
Hurricane,Fabian,28,2003-09-03T15:00:00Z,29.5N  66.5W,0,12,14,1,27
Hurricane,Fabian,28,2003-09-03T15:00:00Z,27.0N  66.0W,15,18,0,0,33
Hurricane,Fabian,28,2003-09-03T15:00:00Z,BERMUDA,0,0,7,11,18
Hurricane,Fabian,29,2003-09-03T21:00:00Z,26.0N  65.5W,45,0,0,0,45
Hurricane,Fabian,29,2003-09-03T21:00:00Z,PROVIDENCE RI,0,0,0,2,2
Hurricane,Fabian,29,2003-09-03T21:00:00Z,28.5N  66.5W,9,24,0,0,33
Hurricane,Fabian,29,2003-09-03T21:00:00Z,NANTUCKET MA,0,0,0,3,3
Hurricane,Fabian,29,2003-09-03T21:00:00Z,31.5N  66.5W,0,8,17,0,25
Hurricane,Fabian,29,2003-09-03T21:00:00Z,HYANNIS MA,0,0,0,2,2
Hurricane,Fabian,29,2003-09-03T21:00:00Z,BERMUDA,0,2,16,3,21
Hurricane,Fabian,29,2003-09-03T21:00:00Z,YARMOUTH NS,0,0,0,2,2
Hurricane,Fabian,29,2003-09-03T21:00:00Z,MONTAUK POINT NY,0,0,0,2,2
Hurricane,Fabian,30,2003-09-04T03:00:00Z,27.1N  65.1W,39,0,0,0,39
Hurricane,Fabian,30,2003-09-04T03:00:00Z,BAR HARBOR ME,0,0,0,2,2
Hurricane,Fabian,30,2003-09-04T03:00:00Z,29.7N  65.7W,6,21,0,0,27
Hurricane,Fabian,30,2003-09-04T03:00:00Z,EASTPORT ME,0,0,0,2,2
Hurricane,Fabian,30,2003-09-04T03:00:00Z,32.4N  65.3W,0,9,11,2,22
Hurricane,Fabian,30,2003-09-04T03:00:00Z,ST JOHN NB,0,0,0,2,2
Hurricane,Fabian,30,2003-09-04T03:00:00Z,BERMUDA,0,8,11,2,21
Hurricane,Fabian,30,2003-09-04T03:00:00Z,YARMOUTH NS,0,0,0,4,4
Hurricane,Fabian,30,2003-09-04T03:00:00Z,PROVIDENCE RI,0,0,0,2,2
Hurricane,Fabian,30,2003-09-04T03:00:00Z,HALIFAX NS,0,0,0,3,3
Hurricane,Fabian,30,2003-09-04T03:00:00Z,NANTUCKET MA,0,0,0,4,4
Hurricane,Fabian,30,2003-09-04T03:00:00Z,SABLE ISLAND NS,0,0,0,3,3
Hurricane,Fabian,30,2003-09-04T03:00:00Z,HYANNIS MA,0,0,0,3,3
Hurricane,Fabian,30,2003-09-04T03:00:00Z,EDDY POINT NS,0,0,0,2,2
Hurricane,Fabian,31,2003-09-04T09:00:00Z,28.3N  65.3W,39,0,1,0,40
Hurricane,Fabian,31,2003-09-04T09:00:00Z,ST JOHN NB,0,0,0,3,3
Hurricane,Fabian,31,2003-09-04T09:00:00Z,31.0N  65.4W,4,21,1,0,26
Hurricane,Fabian,31,2003-09-04T09:00:00Z,MONCTON NB,0,0,0,2,2
Hurricane,Fabian,31,2003-09-04T09:00:00Z,33.7N  64.5W,0,6,13,2,21
Hurricane,Fabian,31,2003-09-04T09:00:00Z,YARMOUTH NS,0,0,0,5,5
Hurricane,Fabian,31,2003-09-04T09:00:00Z,BERMUDA,0,15,6,1,22
Hurricane,Fabian,31,2003-09-04T09:00:00Z,HALIFAX NS,0,0,0,6,6
Hurricane,Fabian,31,2003-09-04T09:00:00Z,NANTUCKET MA,0,0,0,3,3
Hurricane,Fabian,31,2003-09-04T09:00:00Z,SABLE ISLAND NS,0,0,0,8,8
Hurricane,Fabian,31,2003-09-04T09:00:00Z,HYANNIS MA,0,0,0,2,2
Hurricane,Fabian,31,2003-09-04T09:00:00Z,SYDNEY NS,0,0,0,3,3
Hurricane,Fabian,31,2003-09-04T09:00:00Z,BAR HARBOR ME,0,0,0,2,2
Hurricane,Fabian,31,2003-09-04T09:00:00Z,EDDY POINT NS,0,0,0,5,5
Hurricane,Fabian,31,2003-09-04T09:00:00Z,EASTPORT ME,0,0,0,3,3
Hurricane,Fabian,32,2003-09-04T15:00:00Z,29.5N  65.4W,56,0,0,0,56
Hurricane,Fabian,32,2003-09-04T15:00:00Z,ST JOHN NB,0,0,0,3,3
Hurricane,Fabian,32,2003-09-04T15:00:00Z,32.5N  65.0W,1,29,0,0,30
Hurricane,Fabian,32,2003-09-04T15:00:00Z,MONCTON NB,0,0,0,2,2
Hurricane,Fabian,32,2003-09-04T15:00:00Z,35.0N  63.5W,0,3,14,2,19
Hurricane,Fabian,32,2003-09-04T15:00:00Z,YARMOUTH NS,0,0,0,4,4
Hurricane,Fabian,32,2003-09-04T15:00:00Z,BERMUDA,1,28,1,0,30
Hurricane,Fabian,32,2003-09-04T15:00:00Z,HALIFAX NS,0,0,0,4,4
Hurricane,Fabian,32,2003-09-04T15:00:00Z,NANTUCKET MA,0,0,0,3,3
Hurricane,Fabian,32,2003-09-04T15:00:00Z,SABLE ISLAND NS,0,0,0,6,6
Hurricane,Fabian,32,2003-09-04T15:00:00Z,HYANNIS MA,0,0,0,2,2
Hurricane,Fabian,32,2003-09-04T15:00:00Z,SYDNEY NS,0,0,0,3,3
Hurricane,Fabian,32,2003-09-04T15:00:00Z,BAR HARBOR ME,0,0,0,2,2
Hurricane,Fabian,32,2003-09-04T15:00:00Z,EDDY POINT NS,0,0,0,4,4
Hurricane,Fabian,32,2003-09-04T15:00:00Z,EASTPORT ME,0,0,0,2,2
Hurricane,Fabian,33,2003-09-04T21:00:00Z,31.0N  65.5W,45,0,0,0,45
Hurricane,Fabian,33,2003-09-04T21:00:00Z,HALIFAX NS,0,0,0,4,4
Hurricane,Fabian,33,2003-09-04T21:00:00Z,33.5N  64.5W,2,21,1,0,24
Hurricane,Fabian,33,2003-09-04T21:00:00Z,SABLE ISLAND NS,0,0,0,7,7
Hurricane,Fabian,33,2003-09-04T21:00:00Z,36.0N  62.0W,0,2,12,3,17
Hurricane,Fabian,33,2003-09-04T21:00:00Z,SYDNEY NS,0,0,0,4,4
Hurricane,Fabian,33,2003-09-04T21:00:00Z,BERMUDA,16,14,0,0,30
Hurricane,Fabian,33,2003-09-04T21:00:00Z,EDDY POINT NS,0,0,0,5,5
Hurricane,Fabian,33,2003-09-04T21:00:00Z,EASTPORT ME,0,0,0,2,2
Hurricane,Fabian,33,2003-09-04T21:00:00Z,PTX BASQUES NFLD,0,0,0,2,2
Hurricane,Fabian,33,2003-09-04T21:00:00Z,ST JOHN NB,0,0,0,2,2
Hurricane,Fabian,33,2003-09-04T21:00:00Z,BURGEO NFLD,0,0,0,2,2
Hurricane,Fabian,33,2003-09-04T21:00:00Z,MONCTON NB,0,0,0,2,2
Hurricane,Fabian,33,2003-09-04T21:00:00Z,ILE ST PIERRE,0,0,0,3,3
Hurricane,Fabian,33,2003-09-04T21:00:00Z,YARMOUTH NS,0,0,0,3,3
Hurricane,Fabian,33,2003-09-04T21:00:00Z,CAPE RACE NFLD,0,0,0,2,2
Hurricane,Fabian,34,2003-09-05T03:00:00Z,32.6N  64.7W,35,1,0,1,37
Hurricane,Fabian,34,2003-09-05T03:00:00Z,SABLE ISLAND NS,0,0,0,9,9
Hurricane,Fabian,34,2003-09-05T03:00:00Z,34.9N  63.2W,1,17,3,1,22
Hurricane,Fabian,34,2003-09-05T03:00:00Z,SYDNEY NS,0,0,0,6,6
Hurricane,Fabian,34,2003-09-05T03:00:00Z,37.1N  60.5W,0,1,12,4,17
Hurricane,Fabian,34,2003-09-05T03:00:00Z,EDDY POINT NS,0,0,0,6,6
Hurricane,Fabian,34,2003-09-05T03:00:00Z,BERMUDA,37,1,0,0,38
Hurricane,Fabian,34,2003-09-05T03:00:00Z,PTX BASQUES NFLD,0,0,0,5,5
Hurricane,Fabian,34,2003-09-05T03:00:00Z,ST JOHN NB,0,0,0,2,2
Hurricane,Fabian,34,2003-09-05T03:00:00Z,BURGEO NFLD,0,0,0,5,5
Hurricane,Fabian,34,2003-09-05T03:00:00Z,MONCTON NB,0,0,0,2,2
Hurricane,Fabian,34,2003-09-05T03:00:00Z,ILE ST PIERRE,0,0,0,7,7
Hurricane,Fabian,34,2003-09-05T03:00:00Z,YARMOUTH NS,0,0,0,3,3
Hurricane,Fabian,34,2003-09-05T03:00:00Z,CAPE RACE NFLD,0,0,0,6,6
Hurricane,Fabian,34,2003-09-05T03:00:00Z,HALIFAX NS,0,0,0,5,5
Hurricane,Fabian,34,2003-09-05T03:00:00Z,HIBERNIA OILFLD,0,0,0,2,2
Hurricane,Fabian,35,2003-09-05T09:00:00Z,34.3N  64.0W,29,6,0,0,35
Hurricane,Fabian,35,2003-09-05T09:00:00Z,SYDNEY NS,0,0,0,5,5
Hurricane,Fabian,35,2003-09-05T09:00:00Z,36.5N  61.5W,0,15,6,0,21
Hurricane,Fabian,35,2003-09-05T09:00:00Z,EDDY POINT NS,0,0,0,5,5
Hurricane,Fabian,35,2003-09-05T09:00:00Z,38.8N  58.5W,0,0,11,5,16
Hurricane,Fabian,35,2003-09-05T09:00:00Z,PTX BASQUES NFLD,0,0,0,4,4
Hurricane,Fabian,35,2003-09-05T09:00:00Z,BERMUDA,56,0,0,0,56
Hurricane,Fabian,35,2003-09-05T09:00:00Z,BURGEO NFLD,0,0,0,6,6
Hurricane,Fabian,35,2003-09-05T09:00:00Z,YARMOUTH NS,0,0,0,2,2
Hurricane,Fabian,35,2003-09-05T09:00:00Z,ILE ST PIERRE,0,0,0,7,7
Hurricane,Fabian,35,2003-09-05T09:00:00Z,HALIFAX NS,0,0,0,3,3
Hurricane,Fabian,35,2003-09-05T09:00:00Z,CAPE RACE NFLD,0,0,0,8,8
Hurricane,Fabian,35,2003-09-05T09:00:00Z,SABLE ISLAND NS,0,0,0,8,8
Hurricane,Fabian,35,2003-09-05T09:00:00Z,HIBERNIA OILFLD,0,0,0,6,6
Hurricane,Fabian,36,2003-09-05T15:00:00Z,35.5N  63.0W,25,2,0,0,27
Hurricane,Fabian,36,2003-09-05T15:00:00Z,EDDY POINT NS,0,0,3,3,6
Hurricane,Fabian,36,2003-09-05T15:00:00Z,37.5N  60.0W,0,14,4,1,19
Hurricane,Fabian,36,2003-09-05T15:00:00Z,PTX BASQUES NFLD,0,0,1,4,5
Hurricane,Fabian,36,2003-09-05T15:00:00Z,40.0N  56.0W,0,0,11,4,15
Hurricane,Fabian,36,2003-09-05T15:00:00Z,BURGEO NFLD,0,0,1,6,7
Hurricane,Fabian,36,2003-09-05T15:00:00Z,BERMUDA,81,0,0,0,81
Hurricane,Fabian,36,2003-09-05T15:00:00Z,ILE ST PIERRE,0,0,1,7,8
Hurricane,Fabian,36,2003-09-05T15:00:00Z,HALIFAX NS,0,0,3,1,4
Hurricane,Fabian,36,2003-09-05T15:00:00Z,CAPE RACE NFLD,0,0,0,10,10
Hurricane,Fabian,36,2003-09-05T15:00:00Z,SABLE ISLAND NS,0,0,6,4,10
Hurricane,Fabian,36,2003-09-05T15:00:00Z,HIBERNIA OILFLD,0,0,0,8,8
Hurricane,Fabian,36,2003-09-05T15:00:00Z,SYDNEY NS,0,0,2,4,6
Hurricane,Fabian,37,2003-09-05T21:00:00Z,37.0N  61.0W,28,0,0,0,28
Hurricane,Fabian,37,2003-09-05T21:00:00Z,EDDY POINT NS,0,2,2,0,4
Hurricane,Fabian,37,2003-09-05T21:00:00Z,39.5N  57.0W,0,12,2,0,14
Hurricane,Fabian,37,2003-09-05T21:00:00Z,PTX BASQUES NFLD,0,1,3,1,5
Hurricane,Fabian,37,2003-09-05T21:00:00Z,42.5N  52.5W,0,1,7,3,11
Hurricane,Fabian,37,2003-09-05T21:00:00Z,BURGEO NFLD,0,1,3,2,6
Hurricane,Fabian,37,2003-09-05T21:00:00Z,BERMUDA,99,0,0,0,99
Hurricane,Fabian,37,2003-09-05T21:00:00Z,ILE ST PIERRE,0,1,5,2,8
Hurricane,Fabian,37,2003-09-05T21:00:00Z,HALIFAX NS,0,1,1,0,2
Hurricane,Fabian,37,2003-09-05T21:00:00Z,CAPE RACE NFLD,0,0,5,5,10
Hurricane,Fabian,37,2003-09-05T21:00:00Z,SABLE ISLAND NS,0,5,2,1,8
Hurricane,Fabian,37,2003-09-05T21:00:00Z,HIBERNIA OILFLD,0,0,1,9,10
Hurricane,Fabian,37,2003-09-05T21:00:00Z,SYDNEY NS,0,1,3,1,5
Hurricane,Fabian,38,2003-09-06T03:00:00Z,38.6N  58.7W,23,4,0,0,27
Hurricane,Fabian,38,2003-09-06T03:00:00Z,PTX BASQUES NFLD,0,0,1,1,2
Hurricane,Fabian,38,2003-09-06T03:00:00Z,41.3N  54.7W,0,17,2,0,19
Hurricane,Fabian,38,2003-09-06T03:00:00Z,BURGEO NFLD,0,1,1,1,3
Hurricane,Fabian,38,2003-09-06T03:00:00Z,43.5N  49.5W,0,1,11,2,14
Hurricane,Fabian,38,2003-09-06T03:00:00Z,ILE ST PIERRE,0,2,4,1,7
Hurricane,Fabian,38,2003-09-06T03:00:00Z,BERMUDA,99,0,0,0,99
Hurricane,Fabian,38,2003-09-06T03:00:00Z,CAPE RACE NFLD,0,2,8,1,11
Hurricane,Fabian,38,2003-09-06T03:00:00Z,SABLE ISLAND NS,0,4,1,1,6
Hurricane,Fabian,38,2003-09-06T03:00:00Z,HIBERNIA OILFLD,0,0,7,5,12
Hurricane,Fabian,38,2003-09-06T03:00:00Z,SYDNEY NS,0,1,0,1,2
Hurricane,Fabian,39,2003-09-06T09:00:00Z,40.1N  57.2W,27,5,0,0,32
Hurricane,Fabian,39,2003-09-06T09:00:00Z,BURGEO NFLD,0,0,2,1,3
Hurricane,Fabian,39,2003-09-06T09:00:00Z,42.5N  52.7W,0,20,2,0,22
Hurricane,Fabian,39,2003-09-06T09:00:00Z,ILE ST PIERRE,0,2,4,1,7
Hurricane,Fabian,39,2003-09-06T09:00:00Z,44.8N  48.6W,0,4,11,2,17
Hurricane,Fabian,39,2003-09-06T09:00:00Z,CAPE RACE NFLD,0,4,8,1,13
Hurricane,Fabian,39,2003-09-06T09:00:00Z,SABLE ISLAND NS,1,2,1,0,4
Hurricane,Fabian,39,2003-09-06T09:00:00Z,HIBERNIA OILFLD,0,1,11,3,15
Hurricane,Fabian,40,2003-09-06T15:00:00Z,41.0N  54.5W,20,4,0,0,24
Hurricane,Fabian,40,2003-09-06T15:00:00Z,ILE ST PIERRE,0,4,0,1,5
Hurricane,Fabian,40,2003-09-06T15:00:00Z,43.5N  49.5W,1,17,4,0,22
Hurricane,Fabian,40,2003-09-06T15:00:00Z,CAPE RACE NFLD,1,9,3,1,14
Hurricane,Fabian,40,2003-09-06T15:00:00Z,47.5N  43.0W,0,0,13,2,15
Hurricane,Fabian,40,2003-09-06T15:00:00Z,HIBERNIA OILFLD,0,6,12,0,18
Hurricane,Fabian,41,2003-09-06T21:00:00Z,44.0N  50.5W,26,2,0,1,29
Hurricane,Fabian,41,2003-09-06T21:00:00Z,ILE ST PIERRE,2,0,0,0,2
Hurricane,Fabian,41,2003-09-06T21:00:00Z,47.5N  45.5W,1,13,1,1,16
Hurricane,Fabian,41,2003-09-06T21:00:00Z,CAPE RACE NFLD,8,4,0,0,12
Hurricane,Fabian,41,2003-09-06T21:00:00Z,51.5N  40.0W,0,1,8,3,12
Hurricane,Fabian,41,2003-09-06T21:00:00Z,HIBERNIA OILFLD,3,13,1,0,17
Hurricane,Fabian,42,2003-09-07T03:00:00Z,43.5N  48.9W,25,3,0,0,28
Hurricane,Fabian,42,2003-09-07T03:00:00Z,CAPE RACE NFLD,2,1,0,0,3
Hurricane,Fabian,42,2003-09-07T03:00:00Z,48.0N  42.5W,0,16,4,0,20
Hurricane,Fabian,42,2003-09-07T03:00:00Z,HIBERNIA OILFLD,4,9,1,1,15
Hurricane,Fabian,42,2003-09-07T03:00:00Z,53.2N  34.8W,0,1,10,2,13
Hurricane,Fabian,43,2003-09-07T09:00:00Z,46.1N  44.8W,27,5,0,0,32
Hurricane,Fabian,43,2003-09-07T09:00:00Z,55.0N  30.0W,0,1,8,3,12
Hurricane,Fabian,43,2003-09-07T09:00:00Z,51.2N  36.8W,0,13,2,1,16
Hurricane,Fabian,43,2003-09-07T09:00:00Z,HIBERNIA OILFLD,12,2,0,0,14
Hurricane,Fabian,44,2003-09-07T15:00:00Z,48.5N  41.5W,31,3,0,1,35
Hurricane,Fabian,44,2003-09-07T15:00:00Z,58.0N  30.0W,0,2,8,3,13
Hurricane,Fabian,44,2003-09-07T15:00:00Z,53.0N  34.0W,0,15,2,0,17
Hurricane,Fabian,44,2003-09-07T15:00:00Z,HIBERNIA OILFLD,15,0,0,0,15
Hurricane,Fabian,45,2003-09-07T21:00:00Z,51.0N  38.0W,31,2,0,0,33
Hurricane,Fabian,45,2003-09-07T21:00:00Z,60.0N  33.0W,0,5,5,3,13
Hurricane,Fabian,45,2003-09-07T21:00:00Z,56.0N  32.0W,0,15,1,0,16
Hurricane,Fabian,45,2003-09-07T21:00:00Z,HIBERNIA OILFLD,7,0,0,0,7
Hurricane,Fabian,46,2003-09-08T03:00:00Z,54.6N  33.3W,29,2,0,0,31
Hurricane,Fabian,46,2003-09-08T03:00:00Z,60.8N  32.4W,0,9,3,2,14
Hurricane,Fabian,46,2003-09-08T03:00:00Z,58.6N  31.6W,3,13,1,1,18
Hurricane,Fabian,47,2003-09-08T09:00:00Z,56.9N  32.1W,29,0,0,0,29
Hurricane,Fabian,47,2003-09-08T09:00:00Z,61.5N  33.3W,1,10,2,3,16
Hurricane,Fabian,47,2003-09-08T09:00:00Z,59.9N  31.4W,7,10,1,1,19
Hurricane,Fabian,48,2003-09-08T15:00:00Z,58.0N  32.7W,29,0,1,0,30
Hurricane,Fabian,48,2003-09-08T15:00:00Z,58.7N  38.4W,7,6,2,2,17
Hurricane,Fabian,48,2003-09-08T15:00:00Z,59.7N  35.2W,13,5,1,1,20
Hurricane,Fabian,48,2003-09-08T15:00:00Z,HIBERNIA OILFLD,0,0,0,2,2
Tropical Depression,Eleven,1,2003-08-30T15:00:00Z,28.5N  96.5W,39,0,0,0,39
Tropical Depression,Eleven,1,2003-08-30T15:00:00Z,CORPUSCHRISTI TX,31,1,0,0,32
Tropical Depression,Eleven,1,2003-08-30T15:00:00Z,30.5N  98.0W,13,19,0,0,32
Tropical Depression,Eleven,1,2003-08-30T15:00:00Z,BROWNSVILLE TX,17,1,0,0,18
Tropical Depression,Eleven,1,2003-08-30T15:00:00Z,32.0N 100.0W,1,19,6,0,26
Tropical Depression,Eleven,1,2003-08-30T15:00:00Z,GULF 28N 93W,26,0,0,0,26
Tropical Depression,Eleven,1,2003-08-30T15:00:00Z,PORT ARTHUR TX,9,5,1,0,15
Tropical Depression,Eleven,1,2003-08-30T15:00:00Z,GULF 28N 95W,47,0,0,0,47
Tropical Depression,Eleven,1,2003-08-30T15:00:00Z,GALVESTON TX,26,1,0,0,27
Tropical Depression,Eleven,1,2003-08-30T15:00:00Z,GULF 27N 96W,48,0,0,0,48
Tropical Depression,Eleven,1,2003-08-30T15:00:00Z,FREEPORT TX,34,0,0,0,34
Tropical Depression,Eleven,1,2003-08-30T15:00:00Z,GULF 25N 96W,24,0,0,0,24
Tropical Depression,Eleven,1,2003-08-30T15:00:00Z,PORT O CONNOR TX,40,0,0,0,40
Tropical Storm,Grace,2,2003-08-30T21:00:00Z,28.0N  96.1W,39,0,0,0,39
Tropical Storm,Grace,2,2003-08-30T21:00:00Z,PORT O CONNOR TX,33,2,0,0,35
Tropical Storm,Grace,2,2003-08-30T21:00:00Z,29.7N  97.5W,13,18,0,0,31
Tropical Storm,Grace,2,2003-08-30T21:00:00Z,CORPUSCHRISTI TX,27,3,0,0,30
Tropical Storm,Grace,2,2003-08-30T21:00:00Z,30.9N  99.1W,1,21,3,0,25
Tropical Storm,Grace,2,2003-08-30T21:00:00Z,BROWNSVILLE TX,18,1,0,0,19
Tropical Storm,Grace,2,2003-08-30T21:00:00Z,NEW IBERIA LA,0,1,1,0,2
Tropical Storm,Grace,2,2003-08-30T21:00:00Z,GULF 28N 93W,16,1,0,0,17
Tropical Storm,Grace,2,2003-08-30T21:00:00Z,PORT ARTHUR TX,5,8,1,0,14
Tropical Storm,Grace,2,2003-08-30T21:00:00Z,GULF 28N 95W,39,0,0,0,39
Tropical Storm,Grace,2,2003-08-30T21:00:00Z,GALVESTON TX,18,6,0,0,24
Tropical Storm,Grace,2,2003-08-30T21:00:00Z,GULF 27N 96W,49,0,0,0,49
Tropical Storm,Grace,2,2003-08-30T21:00:00Z,FREEPORT TX,25,4,0,0,29
Tropical Storm,Grace,2,2003-08-30T21:00:00Z,GULF 25N 96W,31,0,0,0,31
Tropical Storm,Grace,3,2003-08-31T03:00:00Z,27.8N  96.9W,38,0,0,0,38
Tropical Storm,Grace,3,2003-08-31T03:00:00Z,PORT O CONNOR TX,33,1,0,0,34
Tropical Storm,Grace,3,2003-08-31T03:00:00Z,28.6N  98.4W,23,5,1,0,29
Tropical Storm,Grace,3,2003-08-31T03:00:00Z,CORPUSCHRISTI TX,33,1,0,0,34
Tropical Storm,Grace,3,2003-08-31T03:00:00Z,29.2N 100.0W,8,14,2,0,24
Tropical Storm,Grace,3,2003-08-31T03:00:00Z,BROWNSVILLE TX,27,1,0,0,28
Tropical Storm,Grace,3,2003-08-31T03:00:00Z,MMSO 238N 982W,1,0,1,0,2
Tropical Storm,Grace,3,2003-08-31T03:00:00Z,GULF 28N 93W,7,1,0,0,8
Tropical Storm,Grace,3,2003-08-31T03:00:00Z,PORT ARTHUR TX,2,3,1,0,6
Tropical Storm,Grace,3,2003-08-31T03:00:00Z,GULF 28N 95W,32,0,0,0,32
Tropical Storm,Grace,3,2003-08-31T03:00:00Z,GALVESTON TX,12,3,0,0,15
Tropical Storm,Grace,3,2003-08-31T03:00:00Z,GULF 27N 96W,53,0,0,0,53
Tropical Storm,Grace,3,2003-08-31T03:00:00Z,FREEPORT TX,20,2,0,0,22
Tropical Storm,Grace,3,2003-08-31T03:00:00Z,GULF 25N 96W,44,0,0,0,44
Tropical Storm,Grace,4,2003-08-31T09:00:00Z,29.0N  98.5W,40,0,0,0,40
Tropical Storm,Grace,4,2003-08-31T09:00:00Z,PORT O CONNOR TX,54,0,0,0,54
Tropical Storm,Grace,4,2003-08-31T09:00:00Z,29.5N  99.5W,30,1,0,0,31
Tropical Storm,Grace,4,2003-08-31T09:00:00Z,CORPUSCHRISTI TX,63,0,0,0,63
Tropical Storm,Grace,4,2003-08-31T09:00:00Z,30.0N 100.5W,20,5,1,0,26
Tropical Storm,Grace,4,2003-08-31T09:00:00Z,BROWNSVILLE TX,30,0,0,0,30
Tropical Storm,Grace,4,2003-08-31T09:00:00Z,PORT ARTHUR TX,1,0,1,0,2
Tropical Storm,Grace,4,2003-08-31T09:00:00Z,GULF 28N 95W,47,0,0,0,47
Tropical Storm,Grace,4,2003-08-31T09:00:00Z,GALVESTON TX,7,2,1,0,10
Tropical Storm,Grace,4,2003-08-31T09:00:00Z,GULF 27N 96W,99,0,0,0,99
Tropical Storm,Grace,4,2003-08-31T09:00:00Z,FREEPORT TX,21,0,0,0,21
Tropical Storm,Grace,4,2003-08-31T09:00:00Z,GULF 25N 96W,2,1,0,0,3
Tropical Depression,Twelve,1,2003-09-03T21:00:00Z,29.2N  84.5W,37,1,0,0,38
Tropical Depression,Twelve,1,2003-09-03T21:00:00Z,WILMINGTON NC,0,0,1,7,8
Tropical Depression,Twelve,1,2003-09-03T21:00:00Z,29.5N  82.5W,11,9,2,0,22
Tropical Depression,Twelve,1,2003-09-03T21:00:00Z,MOREHEAD CITY NC,0,0,0,6,6
Tropical Depression,Twelve,1,2003-09-03T21:00:00Z,30.0N  80.5W,0,9,5,2,16
Tropical Depression,Twelve,1,2003-09-03T21:00:00Z,CAPE HATTERAS NC,0,0,0,5,5
Tropical Depression,Twelve,1,2003-09-03T21:00:00Z,MUCM 214N 779W,0,0,0,2,2
Tropical Depression,Twelve,1,2003-09-03T21:00:00Z,NORFOLK VA,0,0,0,4,4
Tropical Depression,Twelve,1,2003-09-03T21:00:00Z,MUCF 221N 805W,0,0,1,1,2
Tropical Depression,Twelve,1,2003-09-03T21:00:00Z,OCEAN CITY MD,0,0,0,2,2
Tropical Depression,Twelve,1,2003-09-03T21:00:00Z,MUHA 230N 824W,0,0,1,1,2
Tropical Depression,Twelve,1,2003-09-03T21:00:00Z,KEY WEST FL,0,2,3,2,7
Tropical Depression,Twelve,1,2003-09-03T21:00:00Z,MYMM 224N 730W,0,0,0,2,2
Tropical Depression,Twelve,1,2003-09-03T21:00:00Z,MARCO ISLAND FL,0,7,4,1,12
Tropical Depression,Twelve,1,2003-09-03T21:00:00Z,MYSM 241N 745W,0,0,0,4,4
Tropical Depression,Twelve,1,2003-09-03T21:00:00Z,FT MYERS FL,1,10,2,1,14
Tropical Depression,Twelve,1,2003-09-03T21:00:00Z,MYEG 235N 758W,0,0,1,3,4
Tropical Depression,Twelve,1,2003-09-03T21:00:00Z,VENICE FL,4,10,2,1,17
Tropical Depression,Twelve,1,2003-09-03T21:00:00Z,MYAK 241N 776W,0,0,2,4,6
Tropical Depression,Twelve,1,2003-09-03T21:00:00Z,TAMPA FL,8,11,1,1,21
Tropical Depression,Twelve,1,2003-09-03T21:00:00Z,MYNN 251N 775W,0,0,4,4,8
Tropical Depression,Twelve,1,2003-09-03T21:00:00Z,CEDAR KEY FL,18,6,1,0,25
Tropical Depression,Twelve,1,2003-09-03T21:00:00Z,MYGF 266N 787W,0,2,6,4,12
Tropical Depression,Twelve,1,2003-09-03T21:00:00Z,ST MARKS FL,26,2,1,0,29
Tropical Depression,Twelve,1,2003-09-03T21:00:00Z,MARATHON FL,0,2,4,2,8
Tropical Depression,Twelve,1,2003-09-03T21:00:00Z,APALACHICOLA FL,39,0,0,0,39
Tropical Depression,Twelve,1,2003-09-03T21:00:00Z,MIAMI FL,0,4,5,2,11
Tropical Depression,Twelve,1,2003-09-03T21:00:00Z,PANAMA CITY FL,40,0,0,0,40
Tropical Depression,Twelve,1,2003-09-03T21:00:00Z,W PALM BEACH FL,0,6,5,2,13
Tropical Depression,Twelve,1,2003-09-03T21:00:00Z,PENSACOLA FL,28,0,0,0,28
Tropical Depression,Twelve,1,2003-09-03T21:00:00Z,FT PIERCE FL,0,8,5,2,15
Tropical Depression,Twelve,1,2003-09-03T21:00:00Z,MOBILE AL,9,2,0,1,12
Tropical Depression,Twelve,1,2003-09-03T21:00:00Z,COCOA BEACH FL,1,10,4,1,16
Tropical Depression,Twelve,1,2003-09-03T21:00:00Z,GULFPORT MS,3,2,1,0,6
Tropical Depression,Twelve,1,2003-09-03T21:00:00Z,DAYTONA BEACH FL,2,11,3,2,18
Tropical Depression,Twelve,1,2003-09-03T21:00:00Z,BURAS LA,3,1,0,0,4
Tropical Depression,Twelve,1,2003-09-03T21:00:00Z,JACKSONVILLE FL,2,11,3,2,18
Tropical Depression,Twelve,1,2003-09-03T21:00:00Z,GULF 29N 85W,44,0,0,0,44
Tropical Depression,Twelve,1,2003-09-03T21:00:00Z,SAVANNAH GA,0,5,6,3,14
Tropical Depression,Twelve,1,2003-09-03T21:00:00Z,GULF 29N 87W,65,0,0,0,65
Tropical Depression,Twelve,1,2003-09-03T21:00:00Z,CHARLESTON SC,0,1,5,6,12
Tropical Depression,Twelve,1,2003-09-03T21:00:00Z,GULF 28N 89W,29,0,0,0,29
Tropical Depression,Twelve,1,2003-09-03T21:00:00Z,MYRTLE BEACH SC,0,0,3,7,10
Tropical Depression,Twelve,2,2003-09-04T03:00:00Z,28.5N  84.6W,45,0,0,0,45
Tropical Depression,Twelve,2,2003-09-04T03:00:00Z,WILMINGTON NC,0,0,1,7,8
Tropical Depression,Twelve,2,2003-09-04T03:00:00Z,29.0N  82.8W,16,6,1,1,24
Tropical Depression,Twelve,2,2003-09-04T03:00:00Z,MOREHEAD CITY NC,0,0,0,7,7
Tropical Depression,Twelve,2,2003-09-04T03:00:00Z,29.3N  81.0W,1,10,4,3,18
Tropical Depression,Twelve,2,2003-09-04T03:00:00Z,CAPE HATTERAS NC,0,0,0,6,6
Tropical Depression,Twelve,2,2003-09-04T03:00:00Z,MUCM 214N 779W,0,0,0,2,2
Tropical Depression,Twelve,2,2003-09-04T03:00:00Z,NORFOLK VA,0,0,0,4,4
Tropical Depression,Twelve,2,2003-09-04T03:00:00Z,MUCF 221N 805W,0,0,1,3,4
Tropical Depression,Twelve,2,2003-09-04T03:00:00Z,OCEAN CITY MD,0,0,0,2,2
Tropical Depression,Twelve,2,2003-09-04T03:00:00Z,MUSN 216N 826W,0,0,1,2,3
Tropical Depression,Twelve,2,2003-09-04T03:00:00Z,ATLANTIC CITY NJ,0,0,0,2,2
Tropical Depression,Twelve,2,2003-09-04T03:00:00Z,MUHA 230N 824W,0,1,2,3,6
Tropical Depression,Twelve,2,2003-09-04T03:00:00Z,KEY WEST FL,0,3,4,3,10
Tropical Depression,Twelve,2,2003-09-04T03:00:00Z,MUAN 219N 850W,0,0,1,1,2
Tropical Depression,Twelve,2,2003-09-04T03:00:00Z,MARCO ISLAND FL,0,9,4,2,15
Tropical Depression,Twelve,2,2003-09-04T03:00:00Z,MYSM 241N 745W,0,0,0,2,2
Tropical Depression,Twelve,2,2003-09-04T03:00:00Z,FT MYERS FL,1,11,3,2,17
Tropical Depression,Twelve,2,2003-09-04T03:00:00Z,MYEG 235N 758W,0,0,0,2,2
Tropical Depression,Twelve,2,2003-09-04T03:00:00Z,VENICE FL,7,10,2,1,20
Tropical Depression,Twelve,2,2003-09-04T03:00:00Z,MYAK 241N 776W,0,0,1,4,5
Tropical Depression,Twelve,2,2003-09-04T03:00:00Z,TAMPA FL,12,8,2,0,22
Tropical Depression,Twelve,2,2003-09-04T03:00:00Z,MYNN 251N 775W,0,0,2,5,7
Tropical Depression,Twelve,2,2003-09-04T03:00:00Z,CEDAR KEY FL,18,5,1,1,25
Tropical Depression,Twelve,2,2003-09-04T03:00:00Z,MYGF 266N 787W,0,1,5,5,11
Tropical Depression,Twelve,2,2003-09-04T03:00:00Z,ST MARKS FL,16,5,1,0,22
Tropical Depression,Twelve,2,2003-09-04T03:00:00Z,MARATHON FL,0,2,5,3,10
Tropical Depression,Twelve,2,2003-09-04T03:00:00Z,APALACHICOLA FL,29,0,0,1,30
Tropical Depression,Twelve,2,2003-09-04T03:00:00Z,MIAMI FL,0,3,6,3,12
Tropical Depression,Twelve,2,2003-09-04T03:00:00Z,PANAMA CITY FL,22,2,0,0,24
Tropical Depression,Twelve,2,2003-09-04T03:00:00Z,W PALM BEACH FL,0,4,6,4,14
Tropical Depression,Twelve,2,2003-09-04T03:00:00Z,PENSACOLA FL,6,4,1,0,11
Tropical Depression,Twelve,2,2003-09-04T03:00:00Z,FT PIERCE FL,0,7,5,3,15
Tropical Depression,Twelve,2,2003-09-04T03:00:00Z,MOBILE AL,1,2,1,1,5
Tropical Depression,Twelve,2,2003-09-04T03:00:00Z,COCOA BEACH FL,0,9,5,3,17
Tropical Depression,Twelve,2,2003-09-04T03:00:00Z,GULFPORT MS,0,1,1,1,3
Tropical Depression,Twelve,2,2003-09-04T03:00:00Z,DAYTONA BEACH FL,1,11,4,2,18
Tropical Depression,Twelve,2,2003-09-04T03:00:00Z,BURAS LA,1,1,0,1,3
Tropical Depression,Twelve,2,2003-09-04T03:00:00Z,JACKSONVILLE FL,1,10,4,2,17
Tropical Depression,Twelve,2,2003-09-04T03:00:00Z,GULF 29N 85W,43,0,0,0,43
Tropical Depression,Twelve,2,2003-09-04T03:00:00Z,SAVANNAH GA,0,3,6,4,13
Tropical Depression,Twelve,2,2003-09-04T03:00:00Z,GULF 29N 87W,44,0,0,0,44
Tropical Depression,Twelve,2,2003-09-04T03:00:00Z,CHARLESTON SC,0,1,5,5,11
Tropical Depression,Twelve,2,2003-09-04T03:00:00Z,GULF 28N 89W,30,0,0,0,30
Tropical Depression,Twelve,2,2003-09-04T03:00:00Z,MYRTLE BEACH SC,0,0,3,7,10
Tropical Depression,Twelve,3,2003-09-04T09:00:00Z,28.5N  85.3W,45,0,0,0,45
Tropical Depression,Twelve,3,2003-09-04T09:00:00Z,CAPE HATTERAS NC,0,0,0,4,4
Tropical Depression,Twelve,3,2003-09-04T09:00:00Z,28.8N  84.1W,24,2,0,1,27
Tropical Depression,Twelve,3,2003-09-04T09:00:00Z,NORFOLK VA,0,0,0,4,4
Tropical Depression,Twelve,3,2003-09-04T09:00:00Z,29.2N  82.5W,5,8,3,2,18
Tropical Depression,Twelve,3,2003-09-04T09:00:00Z,OCEAN CITY MD,0,0,0,2,2
Tropical Depression,Twelve,3,2003-09-04T09:00:00Z,MUCF 221N 805W,0,0,1,2,3
Tropical Depression,Twelve,3,2003-09-04T09:00:00Z,KEY WEST FL,0,2,4,4,10
Tropical Depression,Twelve,3,2003-09-04T09:00:00Z,MUSN 216N 826W,0,0,1,2,3
Tropical Depression,Twelve,3,2003-09-04T09:00:00Z,MARCO ISLAND FL,0,6,4,3,13
Tropical Depression,Twelve,3,2003-09-04T09:00:00Z,MUHA 230N 824W,0,1,2,3,6
Tropical Depression,Twelve,3,2003-09-04T09:00:00Z,FT MYERS FL,1,7,4,3,15
Tropical Depression,Twelve,3,2003-09-04T09:00:00Z,MUAN 219N 850W,0,0,2,2,4
Tropical Depression,Twelve,3,2003-09-04T09:00:00Z,VENICE FL,4,8,3,2,17
Tropical Depression,Twelve,3,2003-09-04T09:00:00Z,MYAK 241N 776W,0,0,1,2,3
Tropical Depression,Twelve,3,2003-09-04T09:00:00Z,TAMPA FL,7,7,3,1,18
Tropical Depression,Twelve,3,2003-09-04T09:00:00Z,MYNN 251N 775W,0,0,1,3,4
Tropical Depression,Twelve,3,2003-09-04T09:00:00Z,CEDAR KEY FL,10,6,2,2,20
Tropical Depression,Twelve,3,2003-09-04T09:00:00Z,MYGF 266N 787W,0,0,3,5,8
Tropical Depression,Twelve,3,2003-09-04T09:00:00Z,ST MARKS FL,12,5,2,1,20
Tropical Depression,Twelve,3,2003-09-04T09:00:00Z,MARATHON FL,0,2,4,3,9
Tropical Depression,Twelve,3,2003-09-04T09:00:00Z,APALACHICOLA FL,24,1,1,0,26
Tropical Depression,Twelve,3,2003-09-04T09:00:00Z,MIAMI FL,0,2,4,4,10
Tropical Depression,Twelve,3,2003-09-04T09:00:00Z,PANAMA CITY FL,22,2,0,0,24
Tropical Depression,Twelve,3,2003-09-04T09:00:00Z,W PALM BEACH FL,0,2,5,4,11
Tropical Depression,Twelve,3,2003-09-04T09:00:00Z,PENSACOLA FL,12,4,1,0,17
Tropical Depression,Twelve,3,2003-09-04T09:00:00Z,FT PIERCE FL,0,3,6,4,13
Tropical Depression,Twelve,3,2003-09-04T09:00:00Z,MOBILE AL,4,5,2,0,11
Tropical Depression,Twelve,3,2003-09-04T09:00:00Z,COCOA BEACH FL,0,5,5,4,14
Tropical Depression,Twelve,3,2003-09-04T09:00:00Z,GULFPORT MS,3,4,1,1,9
Tropical Depression,Twelve,3,2003-09-04T09:00:00Z,DAYTONA BEACH FL,0,6,5,4,15
Tropical Depression,Twelve,3,2003-09-04T09:00:00Z,BURAS LA,4,3,1,1,9
Tropical Depression,Twelve,3,2003-09-04T09:00:00Z,JACKSONVILLE FL,0,6,6,3,15
Tropical Depression,Twelve,3,2003-09-04T09:00:00Z,NEW ORLEANS LA,1,2,1,0,4
Tropical Depression,Twelve,3,2003-09-04T09:00:00Z,SAVANNAH GA,0,2,6,5,13
Tropical Depression,Twelve,3,2003-09-04T09:00:00Z,GULF 29N 85W,34,0,0,0,34
Tropical Depression,Twelve,3,2003-09-04T09:00:00Z,CHARLESTON SC,0,0,4,7,11
Tropical Depression,Twelve,3,2003-09-04T09:00:00Z,GULF 29N 87W,49,0,0,0,49
Tropical Depression,Twelve,3,2003-09-04T09:00:00Z,MYRTLE BEACH SC,0,0,2,7,9
Tropical Depression,Twelve,3,2003-09-04T09:00:00Z,GULF 28N 89W,69,0,0,0,69
Tropical Depression,Twelve,3,2003-09-04T09:00:00Z,WILMINGTON NC,0,0,1,6,7
Tropical Depression,Twelve,3,2003-09-04T09:00:00Z,GULF 28N 91W,0,1,1,0,2
Tropical Depression,Twelve,3,2003-09-04T09:00:00Z,MOREHEAD CITY NC,0,0,0,6,6
Tropical Depression,Twelve,4,2003-09-04T15:00:00Z,28.5N  85.0W,32,0,0,0,32
Tropical Depression,Twelve,4,2003-09-04T15:00:00Z,NORFOLK VA,0,0,0,4,4
Tropical Depression,Twelve,4,2003-09-04T15:00:00Z,28.9N  83.6W,17,2,2,1,22
Tropical Depression,Twelve,4,2003-09-04T15:00:00Z,OCEAN CITY MD,0,0,0,2,2
Tropical Depression,Twelve,4,2003-09-04T15:00:00Z,29.5N  82.5W,6,7,3,2,18
Tropical Depression,Twelve,4,2003-09-04T15:00:00Z,KEY WEST FL,0,1,1,4,6
Tropical Depression,Twelve,4,2003-09-04T15:00:00Z,MUHA 230N 824W,0,0,1,2,3
Tropical Depression,Twelve,4,2003-09-04T15:00:00Z,MARCO ISLAND FL,0,2,4,4,10
Tropical Depression,Twelve,4,2003-09-04T15:00:00Z,MUAN 219N 850W,0,0,1,1,2
Tropical Depression,Twelve,4,2003-09-04T15:00:00Z,FT MYERS FL,0,4,4,4,12
Tropical Depression,Twelve,4,2003-09-04T15:00:00Z,MYNN 251N 775W,0,0,0,2,2
Tropical Depression,Twelve,4,2003-09-04T15:00:00Z,VENICE FL,2,6,4,2,14
Tropical Depression,Twelve,4,2003-09-04T15:00:00Z,MYGF 266N 787W,0,0,1,4,5
Tropical Depression,Twelve,4,2003-09-04T15:00:00Z,TAMPA FL,4,7,3,2,16
Tropical Depression,Twelve,4,2003-09-04T15:00:00Z,MARATHON FL,0,0,2,3,5
Tropical Depression,Twelve,4,2003-09-04T15:00:00Z,CEDAR KEY FL,11,5,2,1,19
Tropical Depression,Twelve,4,2003-09-04T15:00:00Z,MIAMI FL,0,0,2,5,7
Tropical Depression,Twelve,4,2003-09-04T15:00:00Z,ST MARKS FL,17,2,2,1,22
Tropical Depression,Twelve,4,2003-09-04T15:00:00Z,W PALM BEACH FL,0,1,2,5,8
Tropical Depression,Twelve,4,2003-09-04T15:00:00Z,APALACHICOLA FL,24,1,1,0,26
Tropical Depression,Twelve,4,2003-09-04T15:00:00Z,FT PIERCE FL,0,1,4,5,10
Tropical Depression,Twelve,4,2003-09-04T15:00:00Z,PANAMA CITY FL,21,2,0,1,24
Tropical Depression,Twelve,4,2003-09-04T15:00:00Z,COCOA BEACH FL,0,3,4,5,12
Tropical Depression,Twelve,4,2003-09-04T15:00:00Z,PENSACOLA FL,8,3,1,1,13
Tropical Depression,Twelve,4,2003-09-04T15:00:00Z,DAYTONA BEACH FL,0,6,4,4,14
Tropical Depression,Twelve,4,2003-09-04T15:00:00Z,MOBILE AL,1,3,2,1,7
Tropical Depression,Twelve,4,2003-09-04T15:00:00Z,JACKSONVILLE FL,1,8,4,3,16
Tropical Depression,Twelve,4,2003-09-04T15:00:00Z,GULFPORT MS,0,2,1,2,5
Tropical Depression,Twelve,4,2003-09-04T15:00:00Z,SAVANNAH GA,0,4,5,5,14
Tropical Depression,Twelve,4,2003-09-04T15:00:00Z,BURAS LA,0,2,1,1,4
Tropical Depression,Twelve,4,2003-09-04T15:00:00Z,CHARLESTON SC,0,1,5,6,12
Tropical Depression,Twelve,4,2003-09-04T15:00:00Z,NEW ORLEANS LA,0,0,1,1,2
Tropical Depression,Twelve,4,2003-09-04T15:00:00Z,MYRTLE BEACH SC,0,0,3,7,10
Tropical Depression,Twelve,4,2003-09-04T15:00:00Z,GULF 29N 85W,30,0,1,0,31
Tropical Depression,Twelve,4,2003-09-04T15:00:00Z,WILMINGTON NC,0,0,1,7,8
Tropical Depression,Twelve,4,2003-09-04T15:00:00Z,GULF 29N 87W,34,0,0,0,34
Tropical Depression,Twelve,4,2003-09-04T15:00:00Z,MOREHEAD CITY NC,0,0,1,6,7
Tropical Depression,Twelve,4,2003-09-04T15:00:00Z,GULF 28N 89W,16,0,0,1,17
Tropical Depression,Twelve,4,2003-09-04T15:00:00Z,CAPE HATTERAS NC,0,0,0,5,5
Tropical Depression,Twelve,5,2003-09-04T21:00:00Z,28.3N  83.8W,35,0,0,0,35
Tropical Depression,Twelve,5,2003-09-04T21:00:00Z,NORFOLK VA,0,0,0,5,5
Tropical Depression,Twelve,5,2003-09-04T21:00:00Z,28.8N  82.6W,20,2,1,0,23
Tropical Depression,Twelve,5,2003-09-04T21:00:00Z,OCEAN CITY MD,0,0,0,3,3
Tropical Depression,Twelve,5,2003-09-04T21:00:00Z,29.5N  81.5W,9,6,2,2,19
Tropical Depression,Twelve,5,2003-09-04T21:00:00Z,ATLANTIC CITY NJ,0,0,0,2,2
Tropical Depression,Twelve,5,2003-09-04T21:00:00Z,MUHA 230N 824W,0,0,1,2,3
Tropical Depression,Twelve,5,2003-09-04T21:00:00Z,KEY WEST FL,0,1,2,3,6
Tropical Depression,Twelve,5,2003-09-04T21:00:00Z,MUAN 219N 850W,0,0,1,1,2
Tropical Depression,Twelve,5,2003-09-04T21:00:00Z,MARCO ISLAND FL,1,4,3,3,11
Tropical Depression,Twelve,5,2003-09-04T21:00:00Z,MYNN 251N 775W,0,0,0,2,2
Tropical Depression,Twelve,5,2003-09-04T21:00:00Z,FT MYERS FL,4,5,3,2,14
Tropical Depression,Twelve,5,2003-09-04T21:00:00Z,MYGF 266N 787W,0,1,2,4,7
Tropical Depression,Twelve,5,2003-09-04T21:00:00Z,VENICE FL,12,3,2,1,18
Tropical Depression,Twelve,5,2003-09-04T21:00:00Z,MARATHON FL,0,1,2,2,5
Tropical Depression,Twelve,5,2003-09-04T21:00:00Z,TAMPA FL,17,3,1,1,22
Tropical Depression,Twelve,5,2003-09-04T21:00:00Z,MIAMI FL,0,1,3,3,7
Tropical Depression,Twelve,5,2003-09-04T21:00:00Z,CEDAR KEY FL,22,2,0,1,25
Tropical Depression,Twelve,5,2003-09-04T21:00:00Z,W PALM BEACH FL,0,3,3,4,10
Tropical Depression,Twelve,5,2003-09-04T21:00:00Z,ST MARKS FL,15,3,1,1,20
Tropical Depression,Twelve,5,2003-09-04T21:00:00Z,FT PIERCE FL,1,5,3,3,12
Tropical Depression,Twelve,5,2003-09-04T21:00:00Z,APALACHICOLA FL,19,2,1,0,22
Tropical Depression,Twelve,5,2003-09-04T21:00:00Z,COCOA BEACH FL,3,6,3,3,15
Tropical Depression,Twelve,5,2003-09-04T21:00:00Z,PANAMA CITY FL,12,3,1,1,17
Tropical Depression,Twelve,5,2003-09-04T21:00:00Z,DAYTONA BEACH FL,7,6,3,2,18
Tropical Depression,Twelve,5,2003-09-04T21:00:00Z,PENSACOLA FL,1,3,2,2,8
Tropical Depression,Twelve,5,2003-09-04T21:00:00Z,JACKSONVILLE FL,6,7,3,2,18
Tropical Depression,Twelve,5,2003-09-04T21:00:00Z,MOBILE AL,0,1,2,1,4
Tropical Depression,Twelve,5,2003-09-04T21:00:00Z,SAVANNAH GA,1,6,4,4,15
Tropical Depression,Twelve,5,2003-09-04T21:00:00Z,GULFPORT MS,0,0,1,2,3
Tropical Depression,Twelve,5,2003-09-04T21:00:00Z,CHARLESTON SC,0,3,5,5,13
Tropical Depression,Twelve,5,2003-09-04T21:00:00Z,BURAS LA,0,0,1,1,2
Tropical Depression,Twelve,5,2003-09-04T21:00:00Z,MYRTLE BEACH SC,0,1,4,6,11
Tropical Depression,Twelve,5,2003-09-04T21:00:00Z,GULF 29N 85W,34,1,0,0,35
Tropical Depression,Twelve,5,2003-09-04T21:00:00Z,WILMINGTON NC,0,0,3,7,10
Tropical Depression,Twelve,5,2003-09-04T21:00:00Z,GULF 29N 87W,13,2,0,1,16
Tropical Depression,Twelve,5,2003-09-04T21:00:00Z,MOREHEAD CITY NC,0,0,2,6,8
Tropical Depression,Twelve,5,2003-09-04T21:00:00Z,GULF 28N 89W,1,1,2,1,5
Tropical Depression,Twelve,5,2003-09-04T21:00:00Z,CAPE HATTERAS NC,0,0,1,6,7
Tropical Depression,Twelve,6,2003-09-05T03:00:00Z,28.3N  83.2W,41,1,0,0,42
Tropical Depression,Twelve,6,2003-09-05T03:00:00Z,CAPE HATTERAS NC,0,0,1,7,8
Tropical Depression,Twelve,6,2003-09-05T03:00:00Z,29.0N  81.9W,22,2,1,0,25
Tropical Depression,Twelve,6,2003-09-05T03:00:00Z,NORFOLK VA,0,0,0,5,5
Tropical Depression,Twelve,6,2003-09-05T03:00:00Z,30.0N  80.5W,3,10,4,2,19
Tropical Depression,Twelve,6,2003-09-05T03:00:00Z,OCEAN CITY MD,0,0,0,3,3
Tropical Depression,Twelve,6,2003-09-05T03:00:00Z,MUHA 230N 824W,0,0,2,1,3
Tropical Depression,Twelve,6,2003-09-05T03:00:00Z,ATLANTIC CITY NJ,0,0,0,2,2
Tropical Depression,Twelve,6,2003-09-05T03:00:00Z,MYAK 241N 776W,0,0,1,1,2
Tropical Depression,Twelve,6,2003-09-05T03:00:00Z,KEY WEST FL,0,3,3,2,8
Tropical Depression,Twelve,6,2003-09-05T03:00:00Z,MYNN 251N 775W,0,0,1,3,4
Tropical Depression,Twelve,6,2003-09-05T03:00:00Z,MARCO ISLAND FL,7,5,2,1,15
Tropical Depression,Twelve,6,2003-09-05T03:00:00Z,MYGF 266N 787W,0,3,4,3,10
Tropical Depression,Twelve,6,2003-09-05T03:00:00Z,FT MYERS FL,14,3,1,1,19
Tropical Depression,Twelve,6,2003-09-05T03:00:00Z,MARATHON FL,0,3,3,2,8
Tropical Depression,Twelve,6,2003-09-05T03:00:00Z,VENICE FL,25,1,0,1,27
Tropical Depression,Twelve,6,2003-09-05T03:00:00Z,MIAMI FL,1,5,3,2,11
Tropical Depression,Twelve,6,2003-09-05T03:00:00Z,TAMPA FL,32,0,0,0,32
Tropical Depression,Twelve,6,2003-09-05T03:00:00Z,W PALM BEACH FL,2,7,3,2,14
Tropical Depression,Twelve,6,2003-09-05T03:00:00Z,CEDAR KEY FL,30,1,0,1,32
Tropical Depression,Twelve,6,2003-09-05T03:00:00Z,FT PIERCE FL,5,7,3,2,17
Tropical Depression,Twelve,6,2003-09-05T03:00:00Z,ST MARKS FL,16,3,1,1,21
Tropical Depression,Twelve,6,2003-09-05T03:00:00Z,COCOA BEACH FL,9,6,3,1,19
Tropical Depression,Twelve,6,2003-09-05T03:00:00Z,APALACHICOLA FL,19,2,1,0,22
Tropical Depression,Twelve,6,2003-09-05T03:00:00Z,DAYTONA BEACH FL,12,6,2,1,21
Tropical Depression,Twelve,6,2003-09-05T03:00:00Z,PANAMA CITY FL,12,3,1,1,17
Tropical Depression,Twelve,6,2003-09-05T03:00:00Z,JACKSONVILLE FL,7,9,2,2,20
Tropical Depression,Twelve,6,2003-09-05T03:00:00Z,PENSACOLA FL,1,2,2,2,7
Tropical Depression,Twelve,6,2003-09-05T03:00:00Z,SAVANNAH GA,0,7,5,4,16
Tropical Depression,Twelve,6,2003-09-05T03:00:00Z,MOBILE AL,0,1,1,1,3
Tropical Depression,Twelve,6,2003-09-05T03:00:00Z,CHARLESTON SC,0,2,7,5,14
Tropical Depression,Twelve,6,2003-09-05T03:00:00Z,GULFPORT MS,0,0,1,1,2
Tropical Depression,Twelve,6,2003-09-05T03:00:00Z,MYRTLE BEACH SC,0,0,6,6,12
Tropical Depression,Twelve,6,2003-09-05T03:00:00Z,GULF 29N 85W,33,0,0,0,33
Tropical Depression,Twelve,6,2003-09-05T03:00:00Z,WILMINGTON NC,0,0,3,7,10
Tropical Depression,Twelve,6,2003-09-05T03:00:00Z,GULF 29N 87W,9,1,1,1,12
Tropical Depression,Twelve,6,2003-09-05T03:00:00Z,MOREHEAD CITY NC,0,0,2,7,9
Tropical Depression,Twelve,6,2003-09-05T03:00:00Z,GULF 28N 89W,0,1,0,1,2
Tropical Storm,Henri,7,2003-09-05T09:00:00Z,28.7N  82.6W,43,0,0,0,43
Tropical Storm,Henri,7,2003-09-05T09:00:00Z,CAPE HATTERAS NC,0,0,1,8,9
Tropical Storm,Henri,7,2003-09-05T09:00:00Z,29.6N  81.5W,23,2,1,0,26
Tropical Storm,Henri,7,2003-09-05T09:00:00Z,NORFOLK VA,0,0,1,6,7
Tropical Storm,Henri,7,2003-09-05T09:00:00Z,30.8N  80.2W,3,11,3,2,19
Tropical Storm,Henri,7,2003-09-05T09:00:00Z,OCEAN CITY MD,0,0,0,5,5
Tropical Storm,Henri,7,2003-09-05T09:00:00Z,MUHA 230N 824W,0,0,1,1,2
Tropical Storm,Henri,7,2003-09-05T09:00:00Z,ATLANTIC CITY NJ,0,0,0,3,3
Tropical Storm,Henri,7,2003-09-05T09:00:00Z,MYAK 241N 776W,0,0,1,1,2
Tropical Storm,Henri,7,2003-09-05T09:00:00Z,NEW YORK CITY NY,0,0,0,2,2
Tropical Storm,Henri,7,2003-09-05T09:00:00Z,MYNN 251N 775W,0,0,2,2,4
Tropical Storm,Henri,7,2003-09-05T09:00:00Z,KEY WEST FL,0,2,2,2,6
Tropical Storm,Henri,7,2003-09-05T09:00:00Z,MYGF 266N 787W,0,4,3,3,10
Tropical Storm,Henri,7,2003-09-05T09:00:00Z,MARCO ISLAND FL,6,4,2,1,13
Tropical Storm,Henri,7,2003-09-05T09:00:00Z,MARATHON FL,0,2,3,2,7
Tropical Storm,Henri,7,2003-09-05T09:00:00Z,FT MYERS FL,14,3,1,0,18
Tropical Storm,Henri,7,2003-09-05T09:00:00Z,MIAMI FL,1,5,2,2,10
Tropical Storm,Henri,7,2003-09-05T09:00:00Z,VENICE FL,29,0,0,0,29
Tropical Storm,Henri,7,2003-09-05T09:00:00Z,W PALM BEACH FL,3,6,3,2,14
Tropical Storm,Henri,7,2003-09-05T09:00:00Z,TAMPA FL,44,0,0,0,44
Tropical Storm,Henri,7,2003-09-05T09:00:00Z,FT PIERCE FL,9,5,2,1,17
Tropical Storm,Henri,7,2003-09-05T09:00:00Z,CEDAR KEY FL,40,0,0,0,40
Tropical Storm,Henri,7,2003-09-05T09:00:00Z,COCOA BEACH FL,16,3,1,1,21
Tropical Storm,Henri,7,2003-09-05T09:00:00Z,ST MARKS FL,17,3,1,0,21
Tropical Storm,Henri,7,2003-09-05T09:00:00Z,DAYTONA BEACH FL,22,2,1,0,25
Tropical Storm,Henri,7,2003-09-05T09:00:00Z,APALACHICOLA FL,16,2,1,0,19
Tropical Storm,Henri,7,2003-09-05T09:00:00Z,JACKSONVILLE FL,15,5,2,1,23
Tropical Storm,Henri,7,2003-09-05T09:00:00Z,PANAMA CITY FL,7,5,1,1,14
Tropical Storm,Henri,7,2003-09-05T09:00:00Z,SAVANNAH GA,1,10,4,2,17
Tropical Storm,Henri,7,2003-09-05T09:00:00Z,PENSACOLA FL,0,3,2,1,6
Tropical Storm,Henri,7,2003-09-05T09:00:00Z,CHARLESTON SC,0,5,7,4,16
Tropical Storm,Henri,7,2003-09-05T09:00:00Z,MOBILE AL,0,1,1,1,3
Tropical Storm,Henri,7,2003-09-05T09:00:00Z,MYRTLE BEACH SC,0,2,6,6,14
Tropical Storm,Henri,7,2003-09-05T09:00:00Z,GULFPORT MS,0,0,1,1,2
Tropical Storm,Henri,7,2003-09-05T09:00:00Z,WILMINGTON NC,0,0,6,6,12
Tropical Storm,Henri,7,2003-09-05T09:00:00Z,GULF 29N 85W,29,1,0,0,30
Tropical Storm,Henri,7,2003-09-05T09:00:00Z,MOREHEAD CITY NC,0,0,3,8,11
Tropical Storm,Henri,7,2003-09-05T09:00:00Z,GULF 29N 87W,2,3,1,1,7
Tropical Storm,Henri,8,2003-09-05T15:00:00Z,29.6N  81.8W,38,0,0,0,38
Tropical Storm,Henri,8,2003-09-05T15:00:00Z,OCEAN CITY MD,0,0,0,6,6
Tropical Storm,Henri,8,2003-09-05T15:00:00Z,30.7N  80.7W,19,3,1,1,24
Tropical Storm,Henri,8,2003-09-05T15:00:00Z,ATLANTIC CITY NJ,0,0,0,5,5
Tropical Storm,Henri,8,2003-09-05T15:00:00Z,31.8N  79.5W,3,10,3,2,18
Tropical Storm,Henri,8,2003-09-05T15:00:00Z,NEW YORK CITY NY,0,0,0,4,4
Tropical Storm,Henri,8,2003-09-05T15:00:00Z,MUHA 230N 824W,0,0,1,1,2
Tropical Storm,Henri,8,2003-09-05T15:00:00Z,MONTAUK POINT NY,0,0,0,2,2
Tropical Storm,Henri,8,2003-09-05T15:00:00Z,MYAK 241N 776W,0,0,1,1,2
Tropical Storm,Henri,8,2003-09-05T15:00:00Z,PROVIDENCE RI,0,0,0,2,2
Tropical Storm,Henri,8,2003-09-05T15:00:00Z,MYNN 251N 775W,0,0,1,3,4
Tropical Storm,Henri,8,2003-09-05T15:00:00Z,NANTUCKET MA,0,0,0,2,2
Tropical Storm,Henri,8,2003-09-05T15:00:00Z,MYGF 266N 787W,0,3,3,3,9
Tropical Storm,Henri,8,2003-09-05T15:00:00Z,HYANNIS MA,0,0,0,2,2
Tropical Storm,Henri,8,2003-09-05T15:00:00Z,MARATHON FL,0,1,2,2,5
Tropical Storm,Henri,8,2003-09-05T15:00:00Z,BOSTON MA,0,0,0,2,2
Tropical Storm,Henri,8,2003-09-05T15:00:00Z,MIAMI FL,1,3,2,3,9
Tropical Storm,Henri,8,2003-09-05T15:00:00Z,KEY WEST FL,0,1,2,1,4
Tropical Storm,Henri,8,2003-09-05T15:00:00Z,W PALM BEACH FL,4,4,2,2,12
Tropical Storm,Henri,8,2003-09-05T15:00:00Z,MARCO ISLAND FL,3,4,2,1,10
Tropical Storm,Henri,8,2003-09-05T15:00:00Z,FT PIERCE FL,12,2,2,1,17
Tropical Storm,Henri,8,2003-09-05T15:00:00Z,FT MYERS FL,11,2,1,1,15
Tropical Storm,Henri,8,2003-09-05T15:00:00Z,COCOA BEACH FL,21,1,1,0,23
Tropical Storm,Henri,8,2003-09-05T15:00:00Z,VENICE FL,25,1,0,0,26
Tropical Storm,Henri,8,2003-09-05T15:00:00Z,DAYTONA BEACH FL,31,1,0,0,32
Tropical Storm,Henri,8,2003-09-05T15:00:00Z,TAMPA FL,52,0,0,0,52
Tropical Storm,Henri,8,2003-09-05T15:00:00Z,JACKSONVILLE FL,28,0,1,0,29
Tropical Storm,Henri,8,2003-09-05T15:00:00Z,CEDAR KEY FL,58,0,0,0,58
Tropical Storm,Henri,8,2003-09-05T15:00:00Z,SAVANNAH GA,7,10,2,1,20
Tropical Storm,Henri,8,2003-09-05T15:00:00Z,ST MARKS FL,24,0,1,0,25
Tropical Storm,Henri,8,2003-09-05T15:00:00Z,CHARLESTON SC,1,10,4,2,17
Tropical Storm,Henri,8,2003-09-05T15:00:00Z,APALACHICOLA FL,21,0,1,0,22
Tropical Storm,Henri,8,2003-09-05T15:00:00Z,MYRTLE BEACH SC,0,5,6,4,15
Tropical Storm,Henri,8,2003-09-05T15:00:00Z,PANAMA CITY FL,10,1,1,0,12
Tropical Storm,Henri,8,2003-09-05T15:00:00Z,WILMINGTON NC,0,2,6,5,13
Tropical Storm,Henri,8,2003-09-05T15:00:00Z,PENSACOLA FL,0,1,1,0,2
Tropical Storm,Henri,8,2003-09-05T15:00:00Z,MOREHEAD CITY NC,0,0,5,6,11
Tropical Storm,Henri,8,2003-09-05T15:00:00Z,GULF 29N 85W,35,0,0,0,35
Tropical Storm,Henri,8,2003-09-05T15:00:00Z,CAPE HATTERAS NC,0,0,2,7,9
Tropical Storm,Henri,8,2003-09-05T15:00:00Z,GULF 29N 87W,1,1,0,1,3
Tropical Storm,Henri,8,2003-09-05T15:00:00Z,NORFOLK VA,0,0,2,7,9
Tropical Storm,Henri,9,2003-09-05T21:00:00Z,30.1N  81.8W,43,1,0,0,44
Tropical Storm,Henri,9,2003-09-05T21:00:00Z,CAPE HATTERAS NC,0,0,2,7,9
Tropical Storm,Henri,9,2003-09-05T21:00:00Z,31.2N  80.3W,15,7,1,0,23
Tropical Storm,Henri,9,2003-09-05T21:00:00Z,NORFOLK VA,0,0,1,7,8
Tropical Storm,Henri,9,2003-09-05T21:00:00Z,32.0N  79.0W,1,10,4,2,17
Tropical Storm,Henri,9,2003-09-05T21:00:00Z,OCEAN CITY MD,0,0,0,6,6
Tropical Storm,Henri,9,2003-09-05T21:00:00Z,MYEG 235N 758W,0,0,0,2,2
Tropical Storm,Henri,9,2003-09-05T21:00:00Z,ATLANTIC CITY NJ,0,0,0,5,5
Tropical Storm,Henri,9,2003-09-05T21:00:00Z,MYAK 241N 776W,0,0,1,2,3
Tropical Storm,Henri,9,2003-09-05T21:00:00Z,NEW YORK CITY NY,0,0,0,3,3
Tropical Storm,Henri,9,2003-09-05T21:00:00Z,MYNN 251N 775W,0,0,2,3,5
Tropical Storm,Henri,9,2003-09-05T21:00:00Z,MONTAUK POINT NY,0,0,0,2,2
Tropical Storm,Henri,9,2003-09-05T21:00:00Z,MYGF 266N 787W,0,3,4,3,10
Tropical Storm,Henri,9,2003-09-05T21:00:00Z,PROVIDENCE RI,0,0,0,2,2
Tropical Storm,Henri,9,2003-09-05T21:00:00Z,MARATHON FL,0,1,1,2,4
Tropical Storm,Henri,9,2003-09-05T21:00:00Z,KEY WEST FL,0,0,2,1,3
Tropical Storm,Henri,9,2003-09-05T21:00:00Z,MIAMI FL,0,3,3,2,8
Tropical Storm,Henri,9,2003-09-05T21:00:00Z,MARCO ISLAND FL,0,4,2,2,8
Tropical Storm,Henri,9,2003-09-05T21:00:00Z,W PALM BEACH FL,1,6,3,1,11
Tropical Storm,Henri,9,2003-09-05T21:00:00Z,FT MYERS FL,3,5,2,1,11
Tropical Storm,Henri,9,2003-09-05T21:00:00Z,FT PIERCE FL,8,6,1,1,16
Tropical Storm,Henri,9,2003-09-05T21:00:00Z,VENICE FL,17,1,0,1,19
Tropical Storm,Henri,9,2003-09-05T21:00:00Z,COCOA BEACH FL,22,1,0,1,24
Tropical Storm,Henri,9,2003-09-05T21:00:00Z,TAMPA FL,53,0,0,0,53
Tropical Storm,Henri,9,2003-09-05T21:00:00Z,DAYTONA BEACH FL,39,1,0,0,40
Tropical Storm,Henri,9,2003-09-05T21:00:00Z,CEDAR KEY FL,99,0,0,0,99
Tropical Storm,Henri,9,2003-09-05T21:00:00Z,JACKSONVILLE FL,37,0,0,1,38
Tropical Storm,Henri,9,2003-09-05T21:00:00Z,ST MARKS FL,32,0,0,0,32
Tropical Storm,Henri,9,2003-09-05T21:00:00Z,SAVANNAH GA,9,11,1,1,22
Tropical Storm,Henri,9,2003-09-05T21:00:00Z,APALACHICOLA FL,29,0,0,0,29
Tropical Storm,Henri,9,2003-09-05T21:00:00Z,CHARLESTON SC,1,11,3,2,17
Tropical Storm,Henri,9,2003-09-05T21:00:00Z,PANAMA CITY FL,15,0,0,1,16
Tropical Storm,Henri,9,2003-09-05T21:00:00Z,MYRTLE BEACH SC,0,4,7,3,14
Tropical Storm,Henri,9,2003-09-05T21:00:00Z,PENSACOLA FL,0,1,0,1,2
Tropical Storm,Henri,9,2003-09-05T21:00:00Z,WILMINGTON NC,0,1,6,5,12
Tropical Storm,Henri,9,2003-09-05T21:00:00Z,GULF 29N 85W,99,0,0,0,99
Tropical Storm,Henri,9,2003-09-05T21:00:00Z,MOREHEAD CITY NC,0,0,4,7,11
Tropical Storm,Henri,9,2003-09-05T21:00:00Z,GULF 29N 87W,2,0,1,0,3
Tropical Storm,Henri,10,2003-09-06T03:00:00Z,29.0N  82.0W,37,0,0,0,37
Tropical Storm,Henri,10,2003-09-06T03:00:00Z,CAPE HATTERAS NC,0,1,4,6,11
Tropical Storm,Henri,10,2003-09-06T03:00:00Z,30.2N  80.4W,19,3,1,1,24
Tropical Storm,Henri,10,2003-09-06T03:00:00Z,NORFOLK VA,0,0,2,7,9
Tropical Storm,Henri,10,2003-09-06T03:00:00Z,31.2N  79.0W,6,10,2,2,20
Tropical Storm,Henri,10,2003-09-06T03:00:00Z,OCEAN CITY MD,0,0,1,5,6
Tropical Storm,Henri,10,2003-09-06T03:00:00Z,MYNN 251N 775W,0,0,0,3,3
Tropical Storm,Henri,10,2003-09-06T03:00:00Z,ATLANTIC CITY NJ,0,0,0,4,4
Tropical Storm,Henri,10,2003-09-06T03:00:00Z,MYGF 266N 787W,0,2,2,4,8
Tropical Storm,Henri,10,2003-09-06T03:00:00Z,NEW YORK CITY NY,0,0,0,2,2
Tropical Storm,Henri,10,2003-09-06T03:00:00Z,MARATHON FL,0,1,1,2,4
Tropical Storm,Henri,10,2003-09-06T03:00:00Z,KEY WEST FL,0,1,1,1,3
Tropical Storm,Henri,10,2003-09-06T03:00:00Z,MIAMI FL,1,2,1,3,7
Tropical Storm,Henri,10,2003-09-06T03:00:00Z,MARCO ISLAND FL,4,3,1,2,10
Tropical Storm,Henri,10,2003-09-06T03:00:00Z,W PALM BEACH FL,3,4,2,2,11
Tropical Storm,Henri,10,2003-09-06T03:00:00Z,FT MYERS FL,11,2,1,1,15
Tropical Storm,Henri,10,2003-09-06T03:00:00Z,FT PIERCE FL,9,4,1,2,16
Tropical Storm,Henri,10,2003-09-06T03:00:00Z,VENICE FL,25,0,1,0,26
Tropical Storm,Henri,10,2003-09-06T03:00:00Z,COCOA BEACH FL,17,2,1,1,21
Tropical Storm,Henri,10,2003-09-06T03:00:00Z,TAMPA FL,45,0,0,0,45
Tropical Storm,Henri,10,2003-09-06T03:00:00Z,DAYTONA BEACH FL,26,1,1,0,28
Tropical Storm,Henri,10,2003-09-06T03:00:00Z,CEDAR KEY FL,43,0,0,0,43
Tropical Storm,Henri,10,2003-09-06T03:00:00Z,JACKSONVILLE FL,22,2,1,0,25
Tropical Storm,Henri,10,2003-09-06T03:00:00Z,ST MARKS FL,15,2,1,0,18
Tropical Storm,Henri,10,2003-09-06T03:00:00Z,SAVANNAH GA,6,10,2,1,19
Tropical Storm,Henri,10,2003-09-06T03:00:00Z,APALACHICOLA FL,13,1,1,1,16
Tropical Storm,Henri,10,2003-09-06T03:00:00Z,CHARLESTON SC,1,11,3,3,18
Tropical Storm,Henri,10,2003-09-06T03:00:00Z,PANAMA CITY FL,6,3,1,1,11
Tropical Storm,Henri,10,2003-09-06T03:00:00Z,MYRTLE BEACH SC,0,7,5,4,16
Tropical Storm,Henri,10,2003-09-06T03:00:00Z,PENSACOLA FL,0,1,1,1,3
Tropical Storm,Henri,10,2003-09-06T03:00:00Z,WILMINGTON NC,0,4,6,5,15
Tropical Storm,Henri,10,2003-09-06T03:00:00Z,GULF 29N 85W,17,1,0,1,19
Tropical Storm,Henri,10,2003-09-06T03:00:00Z,MOREHEAD CITY NC,0,2,5,6,13
Tropical Storm,Henri,10,2003-09-06T03:00:00Z,GULF 29N 87W,2,1,1,1,5
Tropical Depression,Henri,11,2003-09-06T09:00:00Z,29.1N  81.1W,34,1,0,0,35
Tropical Depression,Henri,11,2003-09-06T09:00:00Z,WILMINGTON NC,0,2,6,4,12
Tropical Depression,Henri,11,2003-09-06T09:00:00Z,30.0N  79.8W,17,3,1,1,22
Tropical Depression,Henri,11,2003-09-06T09:00:00Z,MOREHEAD CITY NC,0,1,4,6,11
Tropical Depression,Henri,11,2003-09-06T09:00:00Z,30.8N  78.3W,3,8,3,3,17
Tropical Depression,Henri,11,2003-09-06T09:00:00Z,CAPE HATTERAS NC,0,0,3,7,10
Tropical Depression,Henri,11,2003-09-06T09:00:00Z,MUHA 230N 824W,0,0,1,1,2
Tropical Depression,Henri,11,2003-09-06T09:00:00Z,NORFOLK VA,0,0,2,6,8
Tropical Depression,Henri,11,2003-09-06T09:00:00Z,MYEG 235N 758W,0,0,0,2,2
Tropical Depression,Henri,11,2003-09-06T09:00:00Z,OCEAN CITY MD,0,0,0,5,5
Tropical Depression,Henri,11,2003-09-06T09:00:00Z,MYAK 241N 776W,0,0,1,2,3
Tropical Depression,Henri,11,2003-09-06T09:00:00Z,ATLANTIC CITY NJ,0,0,0,4,4
Tropical Depression,Henri,11,2003-09-06T09:00:00Z,MYNN 251N 775W,0,0,2,3,5
Tropical Depression,Henri,11,2003-09-06T09:00:00Z,NEW YORK CITY NY,0,0,0,2,2
Tropical Depression,Henri,11,2003-09-06T09:00:00Z,MYGF 266N 787W,1,4,3,3,11
Tropical Depression,Henri,11,2003-09-06T09:00:00Z,MONTAUK POINT NY,0,0,0,2,2
Tropical Depression,Henri,11,2003-09-06T09:00:00Z,MARATHON FL,0,3,2,1,6
Tropical Depression,Henri,11,2003-09-06T09:00:00Z,KEY WEST FL,0,2,2,2,6
Tropical Depression,Henri,11,2003-09-06T09:00:00Z,MIAMI FL,2,4,3,1,10
Tropical Depression,Henri,11,2003-09-06T09:00:00Z,MARCO ISLAND FL,10,2,1,1,14
Tropical Depression,Henri,11,2003-09-06T09:00:00Z,W PALM BEACH FL,7,4,2,1,14
Tropical Depression,Henri,11,2003-09-06T09:00:00Z,FT MYERS FL,22,0,1,0,23
Tropical Depression,Henri,11,2003-09-06T09:00:00Z,FT PIERCE FL,16,2,1,1,20
Tropical Depression,Henri,11,2003-09-06T09:00:00Z,VENICE FL,99,0,0,0,99
Tropical Depression,Henri,11,2003-09-06T09:00:00Z,COCOA BEACH FL,26,1,0,0,27
Tropical Depression,Henri,11,2003-09-06T09:00:00Z,TAMPA FL,99,0,0,0,99
Tropical Depression,Henri,11,2003-09-06T09:00:00Z,DAYTONA BEACH FL,34,0,0,0,34
Tropical Depression,Henri,11,2003-09-06T09:00:00Z,CEDAR KEY FL,40,0,0,0,40
Tropical Depression,Henri,11,2003-09-06T09:00:00Z,JACKSONVILLE FL,23,1,0,1,25
Tropical Depression,Henri,11,2003-09-06T09:00:00Z,ST MARKS FL,9,3,0,1,13
Tropical Depression,Henri,11,2003-09-06T09:00:00Z,SAVANNAH GA,5,8,3,1,17
Tropical Depression,Henri,11,2003-09-06T09:00:00Z,APALACHICOLA FL,4,3,1,1,9
Tropical Depression,Henri,11,2003-09-06T09:00:00Z,CHARLESTON SC,1,9,3,2,15
Tropical Depression,Henri,11,2003-09-06T09:00:00Z,PANAMA CITY FL,1,2,1,0,4
Tropical Depression,Henri,11,2003-09-06T09:00:00Z,MYRTLE BEACH SC,0,5,5,4,14
Tropical Depression,Henri,11,2003-09-06T09:00:00Z,GULF 29N 85W,9,1,1,0,11
Tropical Depression,Henri,12,2003-09-06T15:00:00Z,31.0N  77.5W,35,1,0,0,36
Tropical Depression,Henri,12,2003-09-06T15:00:00Z,MYRTLE BEACH SC,2,6,3,2,13
Tropical Depression,Henri,12,2003-09-06T15:00:00Z,31.6N  76.0W,17,4,1,1,23
Tropical Depression,Henri,12,2003-09-06T15:00:00Z,WILMINGTON NC,1,6,3,3,13
Tropical Depression,Henri,12,2003-09-06T15:00:00Z,32.0N  75.0W,6,9,3,1,19
Tropical Depression,Henri,12,2003-09-06T15:00:00Z,MOREHEAD CITY NC,0,7,3,3,13
Tropical Depression,Henri,12,2003-09-06T15:00:00Z,MUCM 214N 779W,0,0,0,2,2
Tropical Depression,Henri,12,2003-09-06T15:00:00Z,CAPE HATTERAS NC,0,4,5,3,12
Tropical Depression,Henri,12,2003-09-06T15:00:00Z,MUCF 221N 805W,0,0,0,2,2
Tropical Depression,Henri,12,2003-09-06T15:00:00Z,NORFOLK VA,0,1,3,4,8
Tropical Depression,Henri,12,2003-09-06T15:00:00Z,MUHA 230N 824W,0,0,0,2,2
Tropical Depression,Henri,12,2003-09-06T15:00:00Z,OCEAN CITY MD,0,0,2,4,6
Tropical Depression,Henri,12,2003-09-06T15:00:00Z,MYSM 241N 745W,0,0,1,3,4
Tropical Depression,Henri,12,2003-09-06T15:00:00Z,ATLANTIC CITY NJ,0,0,1,3,4
Tropical Depression,Henri,12,2003-09-06T15:00:00Z,MYEG 235N 758W,0,0,0,4,4
Tropical Depression,Henri,12,2003-09-06T15:00:00Z,NEW YORK CITY NY,0,0,0,3,3
Tropical Depression,Henri,12,2003-09-06T15:00:00Z,MYAK 241N 776W,0,0,1,4,5
Tropical Depression,Henri,12,2003-09-06T15:00:00Z,MONTAUK POINT NY,0,0,0,3,3
Tropical Depression,Henri,12,2003-09-06T15:00:00Z,MYNN 251N 775W,0,1,2,4,7
Tropical Depression,Henri,12,2003-09-06T15:00:00Z,PROVIDENCE RI,0,0,0,3,3
Tropical Depression,Henri,12,2003-09-06T15:00:00Z,MYGF 266N 787W,2,3,2,3,10
Tropical Depression,Henri,12,2003-09-06T15:00:00Z,NANTUCKET MA,0,0,0,3,3
Tropical Depression,Henri,12,2003-09-06T15:00:00Z,MARATHON FL,0,0,1,3,4
Tropical Depression,Henri,12,2003-09-06T15:00:00Z,HYANNIS MA,0,0,0,3,3
Tropical Depression,Henri,12,2003-09-06T15:00:00Z,MIAMI FL,0,1,2,3,6
Tropical Depression,Henri,12,2003-09-06T15:00:00Z,BOSTON MA,0,0,0,2,2
Tropical Depression,Henri,12,2003-09-06T15:00:00Z,W PALM BEACH FL,2,1,2,3,8
Tropical Depression,Henri,12,2003-09-06T15:00:00Z,KEY WEST FL,0,0,0,3,3
Tropical Depression,Henri,12,2003-09-06T15:00:00Z,FT PIERCE FL,46,0,0,0,46
Tropical Depression,Henri,12,2003-09-06T15:00:00Z,MARCO ISLAND FL,0,0,1,4,5
Tropical Depression,Henri,12,2003-09-06T15:00:00Z,COCOA BEACH FL,99,0,0,0,99
Tropical Depression,Henri,12,2003-09-06T15:00:00Z,FT MYERS FL,3,0,1,2,6
Tropical Depression,Henri,12,2003-09-06T15:00:00Z,DAYTONA BEACH FL,99,0,0,0,99
Tropical Depression,Henri,12,2003-09-06T15:00:00Z,VENICE FL,9,0,0,1,10
Tropical Depression,Henri,12,2003-09-06T15:00:00Z,JACKSONVILLE FL,7,1,1,2,11
Tropical Depression,Henri,12,2003-09-06T15:00:00Z,TAMPA FL,99,0,0,0,99
Tropical Depression,Henri,12,2003-09-06T15:00:00Z,SAVANNAH GA,2,3,2,2,9
Tropical Depression,Henri,12,2003-09-06T15:00:00Z,CEDAR KEY FL,2,0,1,2,5
Tropical Depression,Henri,12,2003-09-06T15:00:00Z,CHARLESTON SC,3,5,2,2,12
Tropical Depression,Henri,12,2003-09-06T15:00:00Z,ST MARKS FL,0,0,0,2,2
Tropical Depression,Henri,13,2003-09-06T21:00:00Z,31.3N  76.6W,36,0,0,0,36
Tropical Depression,Henri,13,2003-09-06T21:00:00Z,MOREHEAD CITY NC,1,6,3,3,13
Tropical Depression,Henri,13,2003-09-06T21:00:00Z,32.0N  75.2W,15,5,1,1,22
Tropical Depression,Henri,13,2003-09-06T21:00:00Z,CAPE HATTERAS NC,0,5,4,3,12
Tropical Depression,Henri,13,2003-09-06T21:00:00Z,32.5N  74.0W,4,10,3,1,18
Tropical Depression,Henri,13,2003-09-06T21:00:00Z,NORFOLK VA,0,1,2,4,7
Tropical Depression,Henri,13,2003-09-06T21:00:00Z,MYSM 241N 745W,0,0,0,3,3
Tropical Depression,Henri,13,2003-09-06T21:00:00Z,OCEAN CITY MD,0,0,1,4,5
Tropical Depression,Henri,13,2003-09-06T21:00:00Z,MYEG 235N 758W,0,0,0,3,3
Tropical Depression,Henri,13,2003-09-06T21:00:00Z,ATLANTIC CITY NJ,0,0,1,3,4
Tropical Depression,Henri,13,2003-09-06T21:00:00Z,MYAK 241N 776W,0,0,1,3,4
Tropical Depression,Henri,13,2003-09-06T21:00:00Z,NEW YORK CITY NY,0,0,0,3,3
Tropical Depression,Henri,13,2003-09-06T21:00:00Z,MYNN 251N 775W,0,0,2,3,5
Tropical Depression,Henri,13,2003-09-06T21:00:00Z,MONTAUK POINT NY,0,0,0,3,3
Tropical Depression,Henri,13,2003-09-06T21:00:00Z,MYGF 266N 787W,1,2,2,3,8
Tropical Depression,Henri,13,2003-09-06T21:00:00Z,PROVIDENCE RI,0,0,0,3,3
Tropical Depression,Henri,13,2003-09-06T21:00:00Z,BERMUDA,0,0,0,2,2
Tropical Depression,Henri,13,2003-09-06T21:00:00Z,NANTUCKET MA,0,0,0,4,4
Tropical Depression,Henri,13,2003-09-06T21:00:00Z,MARATHON FL,0,0,0,2,2
Tropical Depression,Henri,13,2003-09-06T21:00:00Z,HYANNIS MA,0,0,0,3,3
Tropical Depression,Henri,13,2003-09-06T21:00:00Z,MIAMI FL,0,0,1,3,4
Tropical Depression,Henri,13,2003-09-06T21:00:00Z,BOSTON MA,0,0,0,2,2
Tropical Depression,Henri,13,2003-09-06T21:00:00Z,W PALM BEACH FL,0,2,1,3,6
Tropical Depression,Henri,13,2003-09-06T21:00:00Z,PORTLAND ME,0,0,0,2,2
Tropical Depression,Henri,13,2003-09-06T21:00:00Z,FT PIERCE FL,12,1,0,1,14
Tropical Depression,Henri,13,2003-09-06T21:00:00Z,BAR HARBOR ME,0,0,0,2,2
Tropical Depression,Henri,13,2003-09-06T21:00:00Z,COCOA BEACH FL,99,0,0,0,99
Tropical Depression,Henri,13,2003-09-06T21:00:00Z,YARMOUTH NS,0,0,0,2,2
Tropical Depression,Henri,13,2003-09-06T21:00:00Z,DAYTONA BEACH FL,99,0,0,0,99
Tropical Depression,Henri,13,2003-09-06T21:00:00Z,KEY WEST FL,0,0,0,2,2
Tropical Depression,Henri,13,2003-09-06T21:00:00Z,JACKSONVILLE FL,1,1,1,2,5
Tropical Depression,Henri,13,2003-09-06T21:00:00Z,MARCO ISLAND FL,0,0,1,2,3
Tropical Depression,Henri,13,2003-09-06T21:00:00Z,SAVANNAH GA,1,1,1,2,5
Tropical Depression,Henri,13,2003-09-06T21:00:00Z,FT MYERS FL,0,0,1,2,3
Tropical Depression,Henri,13,2003-09-06T21:00:00Z,CHARLESTON SC,2,3,1,2,8
Tropical Depression,Henri,13,2003-09-06T21:00:00Z,VENICE FL,0,0,1,1,2
Tropical Depression,Henri,13,2003-09-06T21:00:00Z,MYRTLE BEACH SC,2,4,2,2,10
Tropical Depression,Henri,13,2003-09-06T21:00:00Z,TAMPA FL,0,0,1,1,2
Tropical Depression,Henri,13,2003-09-06T21:00:00Z,WILMINGTON NC,1,5,3,2,11
Tropical Depression,Henri,13,2003-09-06T21:00:00Z,CEDAR KEY FL,0,0,1,1,2
Tropical Depression,Henri,14,2003-09-07T03:00:00Z,32.5N  75.9W,30,0,1,0,31
Tropical Depression,Henri,14,2003-09-07T03:00:00Z,ATLANTIC CITY NJ,0,0,3,2,5
Tropical Depression,Henri,14,2003-09-07T03:00:00Z,33.6N  73.9W,4,14,1,1,20
Tropical Depression,Henri,14,2003-09-07T03:00:00Z,NEW YORK CITY NY,0,0,1,3,4
Tropical Depression,Henri,14,2003-09-07T03:00:00Z,34.3N  71.9W,0,9,5,2,16
Tropical Depression,Henri,14,2003-09-07T03:00:00Z,MONTAUK POINT NY,0,0,1,4,5
Tropical Depression,Henri,14,2003-09-07T03:00:00Z,MYMM 224N 730W,0,0,0,2,2
Tropical Depression,Henri,14,2003-09-07T03:00:00Z,PROVIDENCE RI,0,0,1,4,5
Tropical Depression,Henri,14,2003-09-07T03:00:00Z,MYSM 241N 745W,0,0,0,2,2
Tropical Depression,Henri,14,2003-09-07T03:00:00Z,NANTUCKET MA,0,0,1,5,6
Tropical Depression,Henri,14,2003-09-07T03:00:00Z,MYEG 235N 758W,0,0,0,2,2
Tropical Depression,Henri,14,2003-09-07T03:00:00Z,HYANNIS MA,0,0,1,4,5
Tropical Depression,Henri,14,2003-09-07T03:00:00Z,BERMUDA,0,0,0,3,3
Tropical Depression,Henri,14,2003-09-07T03:00:00Z,BOSTON MA,0,0,0,4,4
Tropical Depression,Henri,14,2003-09-07T03:00:00Z,SAVANNAH GA,2,0,0,0,2
Tropical Depression,Henri,14,2003-09-07T03:00:00Z,PORTLAND ME,0,0,0,3,3
Tropical Depression,Henri,14,2003-09-07T03:00:00Z,CHARLESTON SC,10,0,0,1,11
Tropical Depression,Henri,14,2003-09-07T03:00:00Z,BAR HARBOR ME,0,0,0,3,3
Tropical Depression,Henri,14,2003-09-07T03:00:00Z,MYRTLE BEACH SC,11,1,1,0,13
Tropical Depression,Henri,14,2003-09-07T03:00:00Z,EASTPORT ME,0,0,0,3,3
Tropical Depression,Henri,14,2003-09-07T03:00:00Z,WILMINGTON NC,10,3,1,0,14
Tropical Depression,Henri,14,2003-09-07T03:00:00Z,ST JOHN NB,0,0,0,2,2
Tropical Depression,Henri,14,2003-09-07T03:00:00Z,MOREHEAD CITY NC,7,7,1,1,16
Tropical Depression,Henri,14,2003-09-07T03:00:00Z,MONCTON NB,0,0,0,2,2
Tropical Depression,Henri,14,2003-09-07T03:00:00Z,CAPE HATTERAS NC,2,10,2,1,15
Tropical Depression,Henri,14,2003-09-07T03:00:00Z,YARMOUTH NS,0,0,0,3,3
Tropical Depression,Henri,14,2003-09-07T03:00:00Z,NORFOLK VA,0,4,3,1,8
Tropical Depression,Henri,14,2003-09-07T03:00:00Z,HALIFAX NS,0,0,0,2,2
Tropical Depression,Henri,14,2003-09-07T03:00:00Z,OCEAN CITY MD,0,1,3,3,7
Tropical Depression,Henri,15,2003-09-07T09:00:00Z,32.8N  77.0W,27,1,0,0,28
Tropical Depression,Henri,15,2003-09-07T09:00:00Z,WILMINGTON NC,14,2,1,0,17
Tropical Depression,Henri,15,2003-09-07T09:00:00Z,33.7N  75.5W,10,8,1,1,20
Tropical Depression,Henri,15,2003-09-07T09:00:00Z,MOREHEAD CITY NC,13,4,1,1,19
Tropical Depression,Henri,15,2003-09-07T09:00:00Z,34.5N  74.0W,1,11,4,2,18
Tropical Depression,Henri,15,2003-09-07T09:00:00Z,CAPE HATTERAS NC,6,9,2,1,18
Tropical Depression,Henri,15,2003-09-07T09:00:00Z,MYSM 241N 745W,0,0,0,2,2
Tropical Depression,Henri,15,2003-09-07T09:00:00Z,NORFOLK VA,2,7,2,2,13
Tropical Depression,Henri,15,2003-09-07T09:00:00Z,MYEG 235N 758W,0,0,0,2,2
Tropical Depression,Henri,15,2003-09-07T09:00:00Z,OCEAN CITY MD,0,6,3,3,12
Tropical Depression,Henri,15,2003-09-07T09:00:00Z,MYAK 241N 776W,0,0,1,1,2
Tropical Depression,Henri,15,2003-09-07T09:00:00Z,ATLANTIC CITY NJ,0,3,3,4,10
Tropical Depression,Henri,15,2003-09-07T09:00:00Z,MYNN 251N 775W,0,1,1,2,4
Tropical Depression,Henri,15,2003-09-07T09:00:00Z,NEW YORK CITY NY,0,1,3,4,8
Tropical Depression,Henri,15,2003-09-07T09:00:00Z,MYGF 266N 787W,1,2,2,1,6
Tropical Depression,Henri,15,2003-09-07T09:00:00Z,MONTAUK POINT NY,0,1,3,5,9
Tropical Depression,Henri,15,2003-09-07T09:00:00Z,BERMUDA,0,0,0,2,2
Tropical Depression,Henri,15,2003-09-07T09:00:00Z,PROVIDENCE RI,0,0,3,5,8
Tropical Depression,Henri,15,2003-09-07T09:00:00Z,MIAMI FL,0,1,0,1,2
Tropical Depression,Henri,15,2003-09-07T09:00:00Z,NANTUCKET MA,0,0,3,5,8
Tropical Depression,Henri,15,2003-09-07T09:00:00Z,W PALM BEACH FL,0,1,1,1,3
Tropical Depression,Henri,15,2003-09-07T09:00:00Z,HYANNIS MA,0,0,3,5,8
Tropical Depression,Henri,15,2003-09-07T09:00:00Z,FT PIERCE FL,0,2,1,1,4
Tropical Depression,Henri,15,2003-09-07T09:00:00Z,BOSTON MA,0,0,2,5,7
Tropical Depression,Henri,15,2003-09-07T09:00:00Z,COCOA BEACH FL,0,2,0,1,3
Tropical Depression,Henri,15,2003-09-07T09:00:00Z,PORTLAND ME,0,0,1,4,5
Tropical Depression,Henri,15,2003-09-07T09:00:00Z,DAYTONA BEACH FL,0,1,0,1,2
Tropical Depression,Henri,15,2003-09-07T09:00:00Z,BAR HARBOR ME,0,0,0,4,4
Tropical Depression,Henri,15,2003-09-07T09:00:00Z,SAVANNAH GA,0,1,0,1,2
Tropical Depression,Henri,15,2003-09-07T09:00:00Z,EASTPORT ME,0,0,0,3,3
Tropical Depression,Henri,15,2003-09-07T09:00:00Z,CHARLESTON SC,7,1,0,1,9
Tropical Depression,Henri,15,2003-09-07T09:00:00Z,ST JOHN NB,0,0,0,2,2
Tropical Depression,Henri,15,2003-09-07T09:00:00Z,MYRTLE BEACH SC,13,1,1,0,15
Tropical Depression,Henri,15,2003-09-07T09:00:00Z,YARMOUTH NS,0,0,0,3,3
Tropical Depression,Henri,16,2003-09-07T15:00:00Z,33.2N  75.7W,29,1,0,0,30
Tropical Depression,Henri,16,2003-09-07T15:00:00Z,NORFOLK VA,2,3,2,2,9
Tropical Depression,Henri,16,2003-09-07T15:00:00Z,34.1N  74.2W,14,5,2,1,22
Tropical Depression,Henri,16,2003-09-07T15:00:00Z,OCEAN CITY MD,0,3,2,3,8
Tropical Depression,Henri,16,2003-09-07T15:00:00Z,34.8N  72.5W,2,12,3,2,19
Tropical Depression,Henri,16,2003-09-07T15:00:00Z,ATLANTIC CITY NJ,0,1,2,3,6
Tropical Depression,Henri,16,2003-09-07T15:00:00Z,MYSM 241N 745W,0,0,0,2,2
Tropical Depression,Henri,16,2003-09-07T15:00:00Z,NEW YORK CITY NY,0,0,2,3,5
Tropical Depression,Henri,16,2003-09-07T15:00:00Z,MYEG 235N 758W,0,0,0,2,2
Tropical Depression,Henri,16,2003-09-07T15:00:00Z,MONTAUK POINT NY,0,1,2,4,7
Tropical Depression,Henri,16,2003-09-07T15:00:00Z,MYAK 241N 776W,0,0,0,2,2
Tropical Depression,Henri,16,2003-09-07T15:00:00Z,PROVIDENCE RI,0,0,2,4,6
Tropical Depression,Henri,16,2003-09-07T15:00:00Z,MYNN 251N 775W,0,0,1,2,3
Tropical Depression,Henri,16,2003-09-07T15:00:00Z,NANTUCKET MA,0,0,3,5,8
Tropical Depression,Henri,16,2003-09-07T15:00:00Z,MYGF 266N 787W,0,1,1,2,4
Tropical Depression,Henri,16,2003-09-07T15:00:00Z,HYANNIS MA,0,0,3,4,7
Tropical Depression,Henri,16,2003-09-07T15:00:00Z,BERMUDA,0,0,0,3,3
Tropical Depression,Henri,16,2003-09-07T15:00:00Z,BOSTON MA,0,0,1,4,5
Tropical Depression,Henri,16,2003-09-07T15:00:00Z,MIAMI FL,0,0,1,1,2
Tropical Depression,Henri,16,2003-09-07T15:00:00Z,PORTLAND ME,0,0,0,4,4
Tropical Depression,Henri,16,2003-09-07T15:00:00Z,W PALM BEACH FL,0,0,1,1,2
Tropical Depression,Henri,16,2003-09-07T15:00:00Z,BAR HARBOR ME,0,0,0,4,4
Tropical Depression,Henri,16,2003-09-07T15:00:00Z,FT PIERCE FL,0,1,0,1,2
Tropical Depression,Henri,16,2003-09-07T15:00:00Z,EASTPORT ME,0,0,0,3,3
Tropical Depression,Henri,16,2003-09-07T15:00:00Z,COCOA BEACH FL,0,1,0,1,2
Tropical Depression,Henri,16,2003-09-07T15:00:00Z,ST JOHN NB,0,0,0,3,3
Tropical Depression,Henri,16,2003-09-07T15:00:00Z,DAYTONA BEACH FL,0,0,1,1,2
Tropical Depression,Henri,16,2003-09-07T15:00:00Z,MONCTON NB,0,0,0,2,2
Tropical Depression,Henri,16,2003-09-07T15:00:00Z,CHARLESTON SC,0,1,0,2,3
Tropical Depression,Henri,16,2003-09-07T15:00:00Z,YARMOUTH NS,0,0,1,4,5
Tropical Depression,Henri,16,2003-09-07T15:00:00Z,MYRTLE BEACH SC,2,1,1,2,6
Tropical Depression,Henri,16,2003-09-07T15:00:00Z,HALIFAX NS,0,0,0,3,3
Tropical Depression,Henri,16,2003-09-07T15:00:00Z,WILMINGTON NC,6,2,1,1,10
Tropical Depression,Henri,16,2003-09-07T15:00:00Z,SABLE ISLAND NS,0,0,0,2,2
Tropical Depression,Henri,16,2003-09-07T15:00:00Z,MOREHEAD CITY NC,12,2,1,1,16
Tropical Depression,Henri,16,2003-09-07T15:00:00Z,EDDY POINT NS,0,0,0,2,2
Tropical Depression,Henri,16,2003-09-07T15:00:00Z,CAPE HATTERAS NC,12,4,1,1,18
Tropical Depression,Henri,17,2003-09-07T21:00:00Z,33.5N  75.0W,33,0,0,0,33
Tropical Depression,Henri,17,2003-09-07T21:00:00Z,NEW YORK CITY NY,0,0,1,3,4
Tropical Depression,Henri,17,2003-09-07T21:00:00Z,34.2N  73.4W,8,11,1,1,21
Tropical Depression,Henri,17,2003-09-07T21:00:00Z,MONTAUK POINT NY,0,0,1,4,5
Tropical Depression,Henri,17,2003-09-07T21:00:00Z,34.6N  71.7W,0,11,4,2,17
Tropical Depression,Henri,17,2003-09-07T21:00:00Z,PROVIDENCE RI,0,0,1,4,5
Tropical Depression,Henri,17,2003-09-07T21:00:00Z,MYMM 224N 730W,0,0,0,2,2
Tropical Depression,Henri,17,2003-09-07T21:00:00Z,NANTUCKET MA,0,0,1,5,6
Tropical Depression,Henri,17,2003-09-07T21:00:00Z,MYSM 241N 745W,0,0,0,2,2
Tropical Depression,Henri,17,2003-09-07T21:00:00Z,HYANNIS MA,0,0,1,5,6
Tropical Depression,Henri,17,2003-09-07T21:00:00Z,MYEG 235N 758W,0,0,0,2,2
Tropical Depression,Henri,17,2003-09-07T21:00:00Z,BOSTON MA,0,0,1,3,4
Tropical Depression,Henri,17,2003-09-07T21:00:00Z,BERMUDA,0,0,0,3,3
Tropical Depression,Henri,17,2003-09-07T21:00:00Z,PORTLAND ME,0,0,0,3,3
Tropical Depression,Henri,17,2003-09-07T21:00:00Z,MYRTLE BEACH SC,10,0,0,1,11
Tropical Depression,Henri,17,2003-09-07T21:00:00Z,BAR HARBOR ME,0,0,0,3,3
Tropical Depression,Henri,17,2003-09-07T21:00:00Z,WILMINGTON NC,15,0,0,1,16
Tropical Depression,Henri,17,2003-09-07T21:00:00Z,EASTPORT ME,0,0,0,3,3
Tropical Depression,Henri,17,2003-09-07T21:00:00Z,MOREHEAD CITY NC,17,1,1,0,19
Tropical Depression,Henri,17,2003-09-07T21:00:00Z,ST JOHN NB,0,0,0,3,3
Tropical Depression,Henri,17,2003-09-07T21:00:00Z,CAPE HATTERAS NC,11,5,1,0,17
Tropical Depression,Henri,17,2003-09-07T21:00:00Z,MONCTON NB,0,0,0,2,2
Tropical Depression,Henri,17,2003-09-07T21:00:00Z,NORFOLK VA,1,4,2,1,8
Tropical Depression,Henri,17,2003-09-07T21:00:00Z,YARMOUTH NS,0,0,0,4,4
Tropical Depression,Henri,17,2003-09-07T21:00:00Z,OCEAN CITY MD,0,2,2,2,6
Tropical Depression,Henri,17,2003-09-07T21:00:00Z,HALIFAX NS,0,0,0,2,2
Tropical Depression,Henri,17,2003-09-07T21:00:00Z,ATLANTIC CITY NJ,0,1,1,3,5
Tropical Depression,Henri,18,2003-09-08T03:00:00Z,33.6N  74.2W,27,1,0,1,29
Tropical Depression,Henri,18,2003-09-08T03:00:00Z,NORFOLK VA,0,1,1,3,5
Tropical Depression,Henri,18,2003-09-08T03:00:00Z,34.3N  72.7W,15,4,1,1,21
Tropical Depression,Henri,18,2003-09-08T03:00:00Z,OCEAN CITY MD,0,0,1,4,5
Tropical Depression,Henri,18,2003-09-08T03:00:00Z,34.7N  71.1W,4,10,3,2,19
Tropical Depression,Henri,18,2003-09-08T03:00:00Z,ATLANTIC CITY NJ,0,0,1,3,4
Tropical Depression,Henri,18,2003-09-08T03:00:00Z,MYGF 266N 787W,0,1,0,1,2
Tropical Depression,Henri,18,2003-09-08T03:00:00Z,NEW YORK CITY NY,0,0,0,3,3
Tropical Depression,Henri,18,2003-09-08T03:00:00Z,BERMUDA,0,0,2,6,8
Tropical Depression,Henri,18,2003-09-08T03:00:00Z,MONTAUK POINT NY,0,0,1,3,4
Tropical Depression,Henri,18,2003-09-08T03:00:00Z,FT PIERCE FL,0,0,1,1,2
Tropical Depression,Henri,18,2003-09-08T03:00:00Z,PROVIDENCE RI,0,0,0,4,4
Tropical Depression,Henri,18,2003-09-08T03:00:00Z,COCOA BEACH FL,0,0,1,1,2
Tropical Depression,Henri,18,2003-09-08T03:00:00Z,NANTUCKET MA,0,0,1,4,5
Tropical Depression,Henri,18,2003-09-08T03:00:00Z,CHARLESTON SC,0,0,1,1,2
Tropical Depression,Henri,18,2003-09-08T03:00:00Z,HYANNIS MA,0,0,1,3,4
Tropical Depression,Henri,18,2003-09-08T03:00:00Z,MYRTLE BEACH SC,0,1,1,2,4
Tropical Depression,Henri,18,2003-09-08T03:00:00Z,BOSTON MA,0,0,0,3,3
Tropical Depression,Henri,18,2003-09-08T03:00:00Z,WILMINGTON NC,0,2,1,3,6
Tropical Depression,Henri,18,2003-09-08T03:00:00Z,PORTLAND ME,0,0,0,2,2
Tropical Depression,Henri,18,2003-09-08T03:00:00Z,MOREHEAD CITY NC,2,3,2,2,9
Tropical Depression,Henri,18,2003-09-08T03:00:00Z,BAR HARBOR ME,0,0,0,2,2
Tropical Depression,Henri,18,2003-09-08T03:00:00Z,CAPE HATTERAS NC,5,3,2,2,12
Tropical Depression,Henri,18,2003-09-08T03:00:00Z,YARMOUTH NS,0,0,0,2,2
Tropical Depression,Henri,19,2003-09-08T09:00:00Z,33.8N  74.0W,34,0,0,0,34
Tropical Depression,Henri,19,2003-09-08T09:00:00Z,OCEAN CITY MD,0,3,2,2,7
Tropical Depression,Henri,19,2003-09-08T09:00:00Z,34.3N  73.0W,15,4,1,1,21
Tropical Depression,Henri,19,2003-09-08T09:00:00Z,ATLANTIC CITY NJ,0,1,2,3,6
Tropical Depression,Henri,19,2003-09-08T09:00:00Z,34.8N  72.0W,5,8,3,2,18
Tropical Depression,Henri,19,2003-09-08T09:00:00Z,NEW YORK CITY NY,0,0,2,3,5
Tropical Depression,Henri,19,2003-09-08T09:00:00Z,MYSM 241N 745W,0,0,0,3,3
Tropical Depression,Henri,19,2003-09-08T09:00:00Z,MONTAUK POINT NY,0,0,2,4,6
Tropical Depression,Henri,19,2003-09-08T09:00:00Z,MYEG 235N 758W,0,0,0,2,2
Tropical Depression,Henri,19,2003-09-08T09:00:00Z,PROVIDENCE RI,0,0,2,4,6
Tropical Depression,Henri,19,2003-09-08T09:00:00Z,MYAK 241N 776W,0,0,0,2,2
Tropical Depression,Henri,19,2003-09-08T09:00:00Z,NANTUCKET MA,0,0,2,5,7
Tropical Depression,Henri,19,2003-09-08T09:00:00Z,MYNN 251N 775W,0,0,0,3,3
Tropical Depression,Henri,19,2003-09-08T09:00:00Z,HYANNIS MA,0,0,2,4,6
Tropical Depression,Henri,19,2003-09-08T09:00:00Z,MYGF 266N 787W,0,0,0,3,3
Tropical Depression,Henri,19,2003-09-08T09:00:00Z,BOSTON MA,0,0,1,4,5
Tropical Depression,Henri,19,2003-09-08T09:00:00Z,BERMUDA,0,0,0,3,3
Tropical Depression,Henri,19,2003-09-08T09:00:00Z,PORTLAND ME,0,0,0,4,4
Tropical Depression,Henri,19,2003-09-08T09:00:00Z,W PALM BEACH FL,0,0,0,2,2
Tropical Depression,Henri,19,2003-09-08T09:00:00Z,BAR HARBOR ME,0,0,0,4,4
Tropical Depression,Henri,19,2003-09-08T09:00:00Z,FT PIERCE FL,0,0,0,2,2
Tropical Depression,Henri,19,2003-09-08T09:00:00Z,EASTPORT ME,0,0,0,3,3
Tropical Depression,Henri,19,2003-09-08T09:00:00Z,CHARLESTON SC,0,0,0,2,2
Tropical Depression,Henri,19,2003-09-08T09:00:00Z,ST JOHN NB,0,0,0,3,3
Tropical Depression,Henri,19,2003-09-08T09:00:00Z,MYRTLE BEACH SC,0,0,1,2,3
Tropical Depression,Henri,19,2003-09-08T09:00:00Z,MONCTON NB,0,0,0,2,2
Tropical Depression,Henri,19,2003-09-08T09:00:00Z,WILMINGTON NC,1,2,1,2,6
Tropical Depression,Henri,19,2003-09-08T09:00:00Z,YARMOUTH NS,0,0,0,4,4
Tropical Depression,Henri,19,2003-09-08T09:00:00Z,MOREHEAD CITY NC,9,2,1,1,13
Tropical Depression,Henri,19,2003-09-08T09:00:00Z,HALIFAX NS,0,0,0,3,3
Tropical Depression,Henri,19,2003-09-08T09:00:00Z,CAPE HATTERAS NC,13,2,1,1,17
Tropical Depression,Henri,19,2003-09-08T09:00:00Z,EDDY POINT NS,0,0,0,2,2
Tropical Depression,Henri,19,2003-09-08T09:00:00Z,NORFOLK VA,2,2,2,2,8
Tropical Depression,Henri,20,2003-09-08T15:00:00Z,33.8N  73.5W,33,0,0,0,33
Tropical Depression,Henri,20,2003-09-08T15:00:00Z,CAPE HATTERAS NC,10,3,1,1,15
Tropical Depression,Henri,20,2003-09-08T15:00:00Z,34.3N  72.5W,16,3,2,0,21
Tropical Depression,Henri,20,2003-09-08T15:00:00Z,NORFOLK VA,1,2,2,2,7
Tropical Depression,Henri,20,2003-09-08T15:00:00Z,34.7N  71.8W,9,6,2,2,19
Tropical Depression,Henri,20,2003-09-08T15:00:00Z,OCEAN CITY MD,0,1,2,3,6
Tropical Depression,Henri,20,2003-09-08T15:00:00Z,MYSM 241N 745W,0,0,0,2,2
Tropical Depression,Henri,20,2003-09-08T15:00:00Z,ATLANTIC CITY NJ,0,0,2,3,5
Tropical Depression,Henri,20,2003-09-08T15:00:00Z,MYEG 235N 758W,0,0,0,2,2
Tropical Depression,Henri,20,2003-09-08T15:00:00Z,NEW YORK CITY NY,0,0,1,3,4
Tropical Depression,Henri,20,2003-09-08T15:00:00Z,MYAK 241N 776W,0,0,0,2,2
Tropical Depression,Henri,20,2003-09-08T15:00:00Z,MONTAUK POINT NY,0,0,1,4,5
Tropical Depression,Henri,20,2003-09-08T15:00:00Z,MYNN 251N 775W,0,0,0,3,3
Tropical Depression,Henri,20,2003-09-08T15:00:00Z,PROVIDENCE RI,0,0,1,4,5
Tropical Depression,Henri,20,2003-09-08T15:00:00Z,MYGF 266N 787W,0,0,1,2,3
Tropical Depression,Henri,20,2003-09-08T15:00:00Z,NANTUCKET MA,0,0,1,5,6
Tropical Depression,Henri,20,2003-09-08T15:00:00Z,BERMUDA,0,0,0,3,3
Tropical Depression,Henri,20,2003-09-08T15:00:00Z,HYANNIS MA,0,0,1,4,5
Tropical Depression,Henri,20,2003-09-08T15:00:00Z,MIAMI FL,0,0,0,2,2
Tropical Depression,Henri,20,2003-09-08T15:00:00Z,BOSTON MA,0,0,0,4,4
Tropical Depression,Henri,20,2003-09-08T15:00:00Z,W PALM BEACH FL,0,0,0,2,2
Tropical Depression,Henri,20,2003-09-08T15:00:00Z,PORTLAND ME,0,0,0,3,3
Tropical Depression,Henri,20,2003-09-08T15:00:00Z,FT PIERCE FL,0,0,0,3,3
Tropical Depression,Henri,20,2003-09-08T15:00:00Z,BAR HARBOR ME,0,0,0,3,3
Tropical Depression,Henri,20,2003-09-08T15:00:00Z,COCOA BEACH FL,0,0,0,2,2
Tropical Depression,Henri,20,2003-09-08T15:00:00Z,EASTPORT ME,0,0,0,3,3
Tropical Depression,Henri,20,2003-09-08T15:00:00Z,DAYTONA BEACH FL,0,0,0,2,2
Tropical Depression,Henri,20,2003-09-08T15:00:00Z,ST JOHN NB,0,0,0,2,2
Tropical Depression,Henri,20,2003-09-08T15:00:00Z,JACKSONVILLE FL,0,0,0,2,2
Tropical Depression,Henri,20,2003-09-08T15:00:00Z,MONCTON NB,0,0,0,2,2
Tropical Depression,Henri,20,2003-09-08T15:00:00Z,SAVANNAH GA,0,0,0,2,2
Tropical Depression,Henri,20,2003-09-08T15:00:00Z,YARMOUTH NS,0,0,0,4,4
Tropical Depression,Henri,20,2003-09-08T15:00:00Z,CHARLESTON SC,0,0,1,2,3
Tropical Depression,Henri,20,2003-09-08T15:00:00Z,HALIFAX NS,0,0,0,3,3
Tropical Depression,Henri,20,2003-09-08T15:00:00Z,MYRTLE BEACH SC,0,0,2,2,4
Tropical Depression,Henri,20,2003-09-08T15:00:00Z,SABLE ISLAND NS,0,0,0,2,2
Tropical Depression,Henri,20,2003-09-08T15:00:00Z,WILMINGTON NC,1,1,2,3,7
Tropical Depression,Henri,20,2003-09-08T15:00:00Z,EDDY POINT NS,0,0,0,2,2
Tropical Depression,Henri,20,2003-09-08T15:00:00Z,MOREHEAD CITY NC,6,2,2,1,11
Tropical Depression,Henri,21,2003-09-08T21:00:00Z,34.0N  73.0W,34,0,0,0,34
Tropical Depression,Henri,21,2003-09-08T21:00:00Z,NORFOLK VA,0,2,1,3,6
Tropical Depression,Henri,21,2003-09-08T21:00:00Z,34.5N  72.0W,17,3,1,1,22
Tropical Depression,Henri,21,2003-09-08T21:00:00Z,OCEAN CITY MD,0,1,2,3,6
Tropical Depression,Henri,21,2003-09-08T21:00:00Z,35.0N  71.0W,7,6,2,2,17
Tropical Depression,Henri,21,2003-09-08T21:00:00Z,ATLANTIC CITY NJ,0,0,2,2,4
Tropical Depression,Henri,21,2003-09-08T21:00:00Z,MYSM 241N 745W,0,0,0,2,2
Tropical Depression,Henri,21,2003-09-08T21:00:00Z,NEW YORK CITY NY,0,0,1,3,4
Tropical Depression,Henri,21,2003-09-08T21:00:00Z,MYEG 235N 758W,0,0,0,2,2
Tropical Depression,Henri,21,2003-09-08T21:00:00Z,MONTAUK POINT NY,0,0,2,3,5
Tropical Depression,Henri,21,2003-09-08T21:00:00Z,MYAK 241N 776W,0,0,0,2,2
Tropical Depression,Henri,21,2003-09-08T21:00:00Z,PROVIDENCE RI,0,0,1,3,4
Tropical Depression,Henri,21,2003-09-08T21:00:00Z,MYNN 251N 775W,0,0,0,3,3
Tropical Depression,Henri,21,2003-09-08T21:00:00Z,NANTUCKET MA,0,0,2,4,6
Tropical Depression,Henri,21,2003-09-08T21:00:00Z,MYGF 266N 787W,0,0,0,3,3
Tropical Depression,Henri,21,2003-09-08T21:00:00Z,HYANNIS MA,0,0,1,4,5
Tropical Depression,Henri,21,2003-09-08T21:00:00Z,BERMUDA,0,0,0,3,3
Tropical Depression,Henri,21,2003-09-08T21:00:00Z,BOSTON MA,0,0,1,3,4
Tropical Depression,Henri,21,2003-09-08T21:00:00Z,MIAMI FL,0,0,0,2,2
Tropical Depression,Henri,21,2003-09-08T21:00:00Z,PORTLAND ME,0,0,0,2,2
Tropical Depression,Henri,21,2003-09-08T21:00:00Z,W PALM BEACH FL,0,0,0,2,2
Tropical Depression,Henri,21,2003-09-08T21:00:00Z,BAR HARBOR ME,0,0,0,3,3
Tropical Depression,Henri,21,2003-09-08T21:00:00Z,FT PIERCE FL,0,0,0,2,2
Tropical Depression,Henri,21,2003-09-08T21:00:00Z,EASTPORT ME,0,0,0,3,3
Tropical Depression,Henri,21,2003-09-08T21:00:00Z,COCOA BEACH FL,0,0,0,2,2
Tropical Depression,Henri,21,2003-09-08T21:00:00Z,ST JOHN NB,0,0,0,2,2
Tropical Depression,Henri,21,2003-09-08T21:00:00Z,DAYTONA BEACH FL,0,0,0,2,2
Tropical Depression,Henri,21,2003-09-08T21:00:00Z,MONCTON NB,0,0,0,2,2
Tropical Depression,Henri,21,2003-09-08T21:00:00Z,CHARLESTON SC,0,0,0,2,2
Tropical Depression,Henri,21,2003-09-08T21:00:00Z,YARMOUTH NS,0,0,0,4,4
Tropical Depression,Henri,21,2003-09-08T21:00:00Z,MYRTLE BEACH SC,0,0,1,2,3
Tropical Depression,Henri,21,2003-09-08T21:00:00Z,HALIFAX NS,0,0,0,3,3
Tropical Depression,Henri,21,2003-09-08T21:00:00Z,WILMINGTON NC,0,1,1,3,5
Tropical Depression,Henri,21,2003-09-08T21:00:00Z,SABLE ISLAND NS,0,0,0,2,2
Tropical Depression,Henri,21,2003-09-08T21:00:00Z,MOREHEAD CITY NC,1,3,2,2,8
Tropical Depression,Henri,21,2003-09-08T21:00:00Z,SYDNEY NS,0,0,0,2,2
Tropical Depression,Henri,21,2003-09-08T21:00:00Z,CAPE HATTERAS NC,5,3,2,2,12
Tropical Depression,Henri,21,2003-09-08T21:00:00Z,EDDY POINT NS,0,0,0,2,2
Tropical Storm,Isabel,1,2003-09-06T13:00:00Z,14.0N  37.5W,46,0,0,0,46
Tropical Storm,Isabel,1,2003-09-06T13:00:00Z,15.0N  42.5W,0,18,7,1,26
Tropical Storm,Isabel,1,2003-09-06T13:00:00Z,14.5N  40.0W,14,20,0,0,34
Tropical Storm,Isabel,2,2003-09-06T15:00:00Z,14.0N  39.0W,47,0,0,0,47
Tropical Storm,Isabel,2,2003-09-06T15:00:00Z,15.0N  44.0W,0,18,7,1,26
Tropical Storm,Isabel,2,2003-09-06T15:00:00Z,14.5N  41.5W,13,20,0,0,33
Tropical Storm,Isabel,3,2003-09-06T21:00:00Z,13.5N  38.5W,46,0,0,0,46
Tropical Storm,Isabel,3,2003-09-06T21:00:00Z,15.5N  43.0W,0,19,6,1,26
Tropical Storm,Isabel,3,2003-09-06T21:00:00Z,14.5N  40.5W,23,10,0,0,33
Tropical Storm,Isabel,4,2003-09-07T03:00:00Z,13.8N  39.4W,46,0,0,0,46
Tropical Storm,Isabel,4,2003-09-07T03:00:00Z,15.6N  44.4W,0,17,7,1,25
Tropical Storm,Isabel,4,2003-09-07T03:00:00Z,14.7N  41.8W,16,17,0,0,33
Tropical Storm,Isabel,5,2003-09-07T09:00:00Z,14.8N  40.9W,48,0,0,0,48
Tropical Storm,Isabel,5,2003-09-07T09:00:00Z,16.5N  45.3W,0,22,4,1,27
Tropical Storm,Isabel,5,2003-09-07T09:00:00Z,15.6N  43.2W,17,16,1,0,34
Hurricane,Isabel,6,2003-09-07T15:00:00Z,15.8N  41.3W,45,1,0,0,46
Hurricane,Isabel,6,2003-09-07T15:00:00Z,17.3N  46.3W,0,17,8,1,26
Hurricane,Isabel,6,2003-09-07T15:00:00Z,16.6N  43.8W,13,19,1,0,33
Hurricane,Isabel,7,2003-09-07T21:00:00Z,16.5N  42.8W,46,0,0,0,46
Hurricane,Isabel,7,2003-09-07T21:00:00Z,18.0N  47.7W,0,17,8,1,26
Hurricane,Isabel,7,2003-09-07T21:00:00Z,17.2N  45.2W,15,17,0,0,32
Hurricane,Isabel,8,2003-09-08T03:00:00Z,17.7N  44.4W,51,0,0,0,51
Hurricane,Isabel,8,2003-09-08T03:00:00Z,19.2N  49.3W,0,20,7,1,28
Hurricane,Isabel,8,2003-09-08T03:00:00Z,18.5N  46.9W,14,22,0,0,36
Hurricane,Isabel,9,2003-09-08T09:00:00Z,18.8N  45.7W,49,0,0,0,49
Hurricane,Isabel,9,2003-09-08T09:00:00Z,19.8N  50.3W,0,21,6,1,28
Hurricane,Isabel,9,2003-09-08T09:00:00Z,19.4N  48.0W,18,17,0,0,35
Hurricane,Isabel,10,2003-09-08T15:00:00Z,18.6N  46.8W,47,0,0,0,47
Hurricane,Isabel,10,2003-09-08T15:00:00Z,19.4N  51.1W,0,21,3,1,25
Hurricane,Isabel,10,2003-09-08T15:00:00Z,19.2N  49.1W,16,16,1,0,33
Hurricane,Isabel,10,2003-09-08T15:00:00Z,TAPA 171N 618W,0,0,0,2,2
Hurricane,Isabel,11,2003-09-08T21:00:00Z,19.2N  47.9W,47,0,0,0,47
Hurricane,Isabel,11,2003-09-08T21:00:00Z,TBPB 131N 595W,0,0,0,2,2
Hurricane,Isabel,11,2003-09-08T21:00:00Z,19.5N  50.0W,21,12,0,0,33
Hurricane,Isabel,11,2003-09-08T21:00:00Z,TFFR 163N 615W,0,0,0,2,2
Hurricane,Isabel,11,2003-09-08T21:00:00Z,19.5N  52.0W,0,21,4,1,26
Hurricane,Isabel,11,2003-09-08T21:00:00Z,TAPA 171N 618W,0,0,0,2,2
Hurricane,Isabel,12,2003-09-09T03:00:00Z,19.9N  48.5W,52,0,0,0,52
Hurricane,Isabel,12,2003-09-09T03:00:00Z,TFFF 146N 610W,0,0,0,2,2
Hurricane,Isabel,12,2003-09-09T03:00:00Z,20.0N  50.6W,23,14,0,0,37
Hurricane,Isabel,12,2003-09-09T03:00:00Z,TDPR 153N 614W,0,0,0,2,2
Hurricane,Isabel,12,2003-09-09T03:00:00Z,20.0N  52.5W,1,24,3,1,29
Hurricane,Isabel,12,2003-09-09T03:00:00Z,TFFR 163N 615W,0,0,0,3,3
Hurricane,Isabel,12,2003-09-09T03:00:00Z,TBPB 131N 595W,0,0,0,3,3
Hurricane,Isabel,12,2003-09-09T03:00:00Z,TAPA 171N 618W,0,0,0,3,3
Hurricane,Isabel,13,2003-09-09T09:00:00Z,20.3N  49.4W,60,0,0,0,60
Hurricane,Isabel,13,2003-09-09T09:00:00Z,TDPR 153N 614W,0,0,0,3,3
Hurricane,Isabel,13,2003-09-09T09:00:00Z,20.3N  51.3W,30,8,0,0,38
Hurricane,Isabel,13,2003-09-09T09:00:00Z,TFFR 163N 615W,0,0,0,3,3
Hurricane,Isabel,13,2003-09-09T09:00:00Z,20.0N  53.3W,1,23,3,1,28
Hurricane,Isabel,13,2003-09-09T09:00:00Z,TAPA 171N 618W,0,0,0,4,4
Hurricane,Isabel,13,2003-09-09T09:00:00Z,TBPB 131N 595W,0,0,0,3,3
Hurricane,Isabel,13,2003-09-09T09:00:00Z,TKPK 173N 627W,0,0,0,2,2
Hurricane,Isabel,13,2003-09-09T09:00:00Z,TLPL 138N 610W,0,0,0,2,2
Hurricane,Isabel,13,2003-09-09T09:00:00Z,TNCM 181N 631W,0,0,0,2,2
Hurricane,Isabel,13,2003-09-09T09:00:00Z,TFFF 146N 610W,0,0,0,3,3
Hurricane,Isabel,14,2003-09-09T15:00:00Z,20.3N  50.3W,49,0,0,0,49
Hurricane,Isabel,14,2003-09-09T15:00:00Z,19.9N  54.0W,0,20,5,1,26
Hurricane,Isabel,14,2003-09-09T15:00:00Z,20.2N  52.3W,15,18,0,0,33
Hurricane,Isabel,14,2003-09-09T15:00:00Z,TAPA 171N 618W,0,0,0,2,2
Hurricane,Isabel,15,2003-09-09T21:00:00Z,21.6N  51.4W,52,0,0,0,52
Hurricane,Isabel,15,2003-09-09T21:00:00Z,21.8N  54.6W,1,23,3,1,28
Hurricane,Isabel,15,2003-09-09T21:00:00Z,21.7N  53.1W,20,15,0,0,35
Hurricane,Isabel,16,2003-09-10T03:00:00Z,21.5N  52.3W,54,0,0,0,54
Hurricane,Isabel,16,2003-09-10T03:00:00Z,21.5N  55.5W,1,20,3,2,26
Hurricane,Isabel,16,2003-09-10T03:00:00Z,21.5N  53.9W,23,11,0,0,34
Hurricane,Isabel,17,2003-09-10T09:00:00Z,21.5N  54.2W,58,0,0,0,58
Hurricane,Isabel,17,2003-09-10T09:00:00Z,TNCM 181N 631W,0,0,0,5,5
Hurricane,Isabel,17,2003-09-10T09:00:00Z,21.5N  56.0W,20,16,1,0,37
Hurricane,Isabel,17,2003-09-10T09:00:00Z,TISX 177N 648W,0,0,0,2,2
Hurricane,Isabel,17,2003-09-10T09:00:00Z,21.5N  58.0W,0,19,7,1,27
Hurricane,Isabel,17,2003-09-10T09:00:00Z,TIST 183N 650W,0,0,0,3,3
Hurricane,Isabel,17,2003-09-10T09:00:00Z,TFFR 163N 615W,0,0,0,2,2
Hurricane,Isabel,17,2003-09-10T09:00:00Z,ST CROIX VI,0,0,0,2,2
Hurricane,Isabel,17,2003-09-10T09:00:00Z,TAPA 171N 618W,0,0,0,4,4
Hurricane,Isabel,17,2003-09-10T09:00:00Z,ST THOMAS VI,0,0,0,3,3
Hurricane,Isabel,17,2003-09-10T09:00:00Z,TKPK 173N 627W,0,0,0,4,4
Hurricane,Isabel,18,2003-09-10T15:00:00Z,21.7N  54.4W,57,0,0,0,57
Hurricane,Isabel,18,2003-09-10T15:00:00Z,TKPK 173N 627W,0,0,0,2,2
Hurricane,Isabel,18,2003-09-10T15:00:00Z,21.8N  56.0W,22,13,0,0,35
Hurricane,Isabel,18,2003-09-10T15:00:00Z,TNCM 181N 631W,0,0,0,4,4
Hurricane,Isabel,18,2003-09-10T15:00:00Z,21.9N  57.8W,0,20,5,1,26
Hurricane,Isabel,18,2003-09-10T15:00:00Z,TIST 183N 650W,0,0,0,2,2
Hurricane,Isabel,18,2003-09-10T15:00:00Z,TAPA 171N 618W,0,0,0,2,2
Hurricane,Isabel,18,2003-09-10T15:00:00Z,ST THOMAS VI,0,0,0,2,2
Hurricane,Isabel,19,2003-09-10T21:00:00Z,TFFR 163N 615W,0,0,0,2,2
Hurricane,Isabel,19,2003-09-10T21:00:00Z,ST CROIX VI,0,0,0,2,2
Hurricane,Isabel,19,2003-09-10T21:00:00Z,TAPA 171N 618W,0,0,0,3,3
Hurricane,Isabel,19,2003-09-10T21:00:00Z,ST THOMAS VI,0,0,0,3,3
Hurricane,Isabel,19,2003-09-10T21:00:00Z,TKPK 173N 627W,0,0,0,3,3
Hurricane,Isabel,19,2003-09-10T21:00:00Z,SAN JUAN PR,0,0,0,2,2
Hurricane,Isabel,19,2003-09-10T21:00:00Z,TNCM 181N 631W,0,0,0,5,5
Hurricane,Isabel,20,2003-09-11T03:00:00Z,TAPA 171N 618W,0,0,0,2,2
Hurricane,Isabel,20,2003-09-11T03:00:00Z,ST CROIX VI,0,0,0,2,2
Hurricane,Isabel,20,2003-09-11T03:00:00Z,TKPK 173N 627W,0,0,0,3,3
Hurricane,Isabel,20,2003-09-11T03:00:00Z,ST THOMAS VI,0,0,0,3,3
Hurricane,Isabel,20,2003-09-11T03:00:00Z,TNCM 181N 631W,0,0,1,4,5
Hurricane,Isabel,20,2003-09-11T03:00:00Z,SAN JUAN PR,0,0,0,2,2
Hurricane,Isabel,21,2003-09-11T09:00:00Z,TNCM 181N 631W,0,0,1,2,3
Hurricane,Isabel,21,2003-09-11T09:00:00Z,SAN JUAN PR,0,0,0,2,2
Hurricane,Isabel,22,2003-09-11T15:00:00Z,21.8N  58.0W,52,0,0,0,52
Hurricane,Isabel,22,2003-09-11T15:00:00Z,TIST 183N 650W,0,0,0,3,3
Hurricane,Isabel,22,2003-09-11T15:00:00Z,22.2N  60.0W,13,22,0,0,35
Hurricane,Isabel,22,2003-09-11T15:00:00Z,TJSJ 184N 661W,0,0,0,2,2
Hurricane,Isabel,22,2003-09-11T15:00:00Z,22.8N  61.9W,0,19,7,1,27
Hurricane,Isabel,22,2003-09-11T15:00:00Z,ST THOMAS VI,0,0,0,3,3
Hurricane,Isabel,22,2003-09-11T15:00:00Z,TNCM 181N 631W,0,0,1,2,3
Hurricane,Isabel,22,2003-09-11T15:00:00Z,SAN JUAN PR,0,0,0,2,2
Hurricane,Isabel,23,2003-09-11T21:00:00Z,21.9N  58.6W,56,0,0,0,56
Hurricane,Isabel,23,2003-09-11T21:00:00Z,TIST 183N 650W,0,0,1,2,3
Hurricane,Isabel,23,2003-09-11T21:00:00Z,22.4N  60.5W,15,21,0,0,36
Hurricane,Isabel,23,2003-09-11T21:00:00Z,TJSJ 184N 661W,0,0,0,3,3
Hurricane,Isabel,23,2003-09-11T21:00:00Z,22.9N  62.3W,0,20,6,1,27
Hurricane,Isabel,23,2003-09-11T21:00:00Z,ST CROIX VI,0,0,0,2,2
Hurricane,Isabel,23,2003-09-11T21:00:00Z,TNCM 181N 631W,0,0,1,2,3
Hurricane,Isabel,23,2003-09-11T21:00:00Z,ST THOMAS VI,0,0,1,2,3
Hurricane,Isabel,23,2003-09-11T21:00:00Z,TISX 177N 648W,0,0,0,2,2
Hurricane,Isabel,23,2003-09-11T21:00:00Z,SAN JUAN PR,0,0,0,3,3
Hurricane,Isabel,24,2003-09-12T03:00:00Z,22.3N  59.4W,56,0,0,0,56
Hurricane,Isabel,24,2003-09-12T03:00:00Z,TJSJ 184N 661W,0,0,0,2,2
Hurricane,Isabel,24,2003-09-12T03:00:00Z,22.7N  61.3W,17,19,0,0,36
Hurricane,Isabel,24,2003-09-12T03:00:00Z,MBJT 215N 712W,0,0,0,3,3
Hurricane,Isabel,24,2003-09-12T03:00:00Z,23.3N  63.2W,0,20,7,0,27
Hurricane,Isabel,24,2003-09-12T03:00:00Z,ST THOMAS VI,0,0,1,1,2
Hurricane,Isabel,24,2003-09-12T03:00:00Z,TNCM 181N 631W,0,0,1,1,2
Hurricane,Isabel,24,2003-09-12T03:00:00Z,SAN JUAN PR,0,0,0,2,2
Hurricane,Isabel,24,2003-09-12T03:00:00Z,TIST 183N 650W,0,0,1,1,2
Hurricane,Isabel,25,2003-09-12T09:00:00Z,22.5N  60.5W,57,0,0,0,57
Hurricane,Isabel,25,2003-09-12T09:00:00Z,MBJT 215N 712W,0,0,0,6,6
Hurricane,Isabel,25,2003-09-12T09:00:00Z,23.0N  62.5W,12,24,0,0,36
Hurricane,Isabel,25,2003-09-12T09:00:00Z,MYMM 224N 730W,0,0,0,4,4
Hurricane,Isabel,25,2003-09-12T09:00:00Z,23.5N  64.5W,0,18,8,1,27
Hurricane,Isabel,25,2003-09-12T09:00:00Z,MYSM 241N 745W,0,0,0,3,3
Hurricane,Isabel,25,2003-09-12T09:00:00Z,TJSJ 184N 661W,0,0,0,2,2
Hurricane,Isabel,25,2003-09-12T09:00:00Z,SAN JUAN PR,0,0,0,2,2
Hurricane,Isabel,25,2003-09-12T09:00:00Z,MDPP 198N 707W,0,0,0,2,2
Hurricane,Isabel,26,2003-09-12T15:00:00Z,22.2N  61.2W,54,0,0,0,54
Hurricane,Isabel,26,2003-09-12T15:00:00Z,MBJT 215N 712W,0,0,0,8,8
Hurricane,Isabel,26,2003-09-12T15:00:00Z,22.8N  63.4W,8,27,0,0,35
Hurricane,Isabel,26,2003-09-12T15:00:00Z,MYMM 224N 730W,0,0,0,7,7
Hurricane,Isabel,26,2003-09-12T15:00:00Z,23.4N  65.5W,0,15,11,0,26
Hurricane,Isabel,26,2003-09-12T15:00:00Z,MYSM 241N 745W,0,0,0,5,5
Hurricane,Isabel,26,2003-09-12T15:00:00Z,MDSD 185N 697W,0,0,0,2,2
Hurricane,Isabel,26,2003-09-12T15:00:00Z,MYEG 235N 758W,0,0,0,2,2
Hurricane,Isabel,26,2003-09-12T15:00:00Z,TJSJ 184N 661W,0,0,1,1,2
Hurricane,Isabel,26,2003-09-12T15:00:00Z,SAN JUAN PR,0,0,1,1,2
Hurricane,Isabel,26,2003-09-12T15:00:00Z,MDPP 198N 707W,0,0,0,4,4
Hurricane,Isabel,27,2003-09-12T21:00:00Z,22.4N  62.1W,52,0,0,0,52
Hurricane,Isabel,27,2003-09-12T21:00:00Z,MBJT 215N 712W,0,0,1,8,9
Hurricane,Isabel,27,2003-09-12T21:00:00Z,23.0N  64.3W,8,26,1,0,35
Hurricane,Isabel,27,2003-09-12T21:00:00Z,MYMM 224N 730W,0,0,0,7,7
Hurricane,Isabel,27,2003-09-12T21:00:00Z,23.6N  66.3W,0,18,8,1,27
Hurricane,Isabel,27,2003-09-12T21:00:00Z,MYSM 241N 745W,0,0,0,6,6
Hurricane,Isabel,27,2003-09-12T21:00:00Z,MDSD 185N 697W,0,0,0,2,2
Hurricane,Isabel,27,2003-09-12T21:00:00Z,MYEG 235N 758W,0,0,0,2,2
Hurricane,Isabel,27,2003-09-12T21:00:00Z,TJSJ 184N 661W,0,0,1,1,2
Hurricane,Isabel,27,2003-09-12T21:00:00Z,SAN JUAN PR,0,0,1,1,2
Hurricane,Isabel,27,2003-09-12T21:00:00Z,MDPP 198N 707W,0,0,0,4,4
Hurricane,Isabel,28,2003-09-13T03:00:00Z,22.8N  63.0W,52,0,0,0,52
Hurricane,Isabel,28,2003-09-13T03:00:00Z,MBJT 215N 712W,0,0,1,7,8
Hurricane,Isabel,28,2003-09-13T03:00:00Z,23.4N  65.1W,10,24,0,0,34
Hurricane,Isabel,28,2003-09-13T03:00:00Z,MYMM 224N 730W,0,0,0,7,7
Hurricane,Isabel,28,2003-09-13T03:00:00Z,24.0N  67.0W,0,19,7,1,27
Hurricane,Isabel,28,2003-09-13T03:00:00Z,MYSM 241N 745W,0,0,0,6,6
Hurricane,Isabel,28,2003-09-13T03:00:00Z,MDPP 198N 707W,0,0,0,3,3
Hurricane,Isabel,28,2003-09-13T03:00:00Z,MYEG 235N 758W,0,0,0,3,3
Hurricane,Isabel,29,2003-09-13T09:00:00Z,23.0N  63.7W,59,0,0,0,59
Hurricane,Isabel,29,2003-09-13T09:00:00Z,MYMM 224N 730W,0,0,0,5,5
Hurricane,Isabel,29,2003-09-13T09:00:00Z,23.5N  65.5W,17,20,0,0,37
Hurricane,Isabel,29,2003-09-13T09:00:00Z,MYSM 241N 745W,0,0,0,6,6
Hurricane,Isabel,29,2003-09-13T09:00:00Z,24.5N  67.5W,0,18,11,1,30
Hurricane,Isabel,29,2003-09-13T09:00:00Z,MYEG 235N 758W,0,0,0,2,2
Hurricane,Isabel,29,2003-09-13T09:00:00Z,MBJT 215N 712W,0,0,1,5,6
Hurricane,Isabel,30,2003-09-13T15:00:00Z,23.0N  64.8W,57,0,0,0,57
Hurricane,Isabel,30,2003-09-13T15:00:00Z,MYMM 224N 730W,0,0,2,6,8
Hurricane,Isabel,30,2003-09-13T15:00:00Z,23.7N  66.7W,15,21,0,1,37
Hurricane,Isabel,30,2003-09-13T15:00:00Z,MYSM 241N 745W,0,0,0,9,9
Hurricane,Isabel,30,2003-09-13T15:00:00Z,24.5N  68.7W,0,18,10,1,29
Hurricane,Isabel,30,2003-09-13T15:00:00Z,MYEG 235N 758W,0,0,0,4,4
Hurricane,Isabel,30,2003-09-13T15:00:00Z,MDPP 198N 707W,0,0,1,1,2
Hurricane,Isabel,30,2003-09-13T15:00:00Z,MYNN 251N 775W,0,0,0,2,2
Hurricane,Isabel,30,2003-09-13T15:00:00Z,MBJT 215N 712W,0,0,4,5,9
Hurricane,Isabel,31,2003-09-13T21:00:00Z,23.7N  66.2W,57,0,0,0,57
Hurricane,Isabel,31,2003-09-13T21:00:00Z,MYSM 241N 745W,0,0,1,8,9
Hurricane,Isabel,31,2003-09-13T21:00:00Z,24.4N  68.0W,16,21,0,0,37
Hurricane,Isabel,31,2003-09-13T21:00:00Z,MYEG 235N 758W,0,0,0,4,4
Hurricane,Isabel,31,2003-09-13T21:00:00Z,25.2N  69.4W,0,24,4,0,28
Hurricane,Isabel,31,2003-09-13T21:00:00Z,MYAK 241N 776W,0,0,0,2,2
Hurricane,Isabel,31,2003-09-13T21:00:00Z,MBJT 215N 712W,0,1,4,2,7
Hurricane,Isabel,31,2003-09-13T21:00:00Z,MYNN 251N 775W,0,0,0,3,3
Hurricane,Isabel,31,2003-09-13T21:00:00Z,MYMM 224N 730W,0,0,3,5,8
Hurricane,Isabel,31,2003-09-13T21:00:00Z,MYGF 266N 787W,0,0,0,2,2
Hurricane,Isabel,32,2003-09-14T03:00:00Z,24.5N  67.3W,58,0,0,0,58
Hurricane,Isabel,32,2003-09-14T03:00:00Z,MYMM 224N 730W,0,0,2,2,4
Hurricane,Isabel,32,2003-09-14T03:00:00Z,25.2N  68.7W,24,12,0,1,37
Hurricane,Isabel,32,2003-09-14T03:00:00Z,MYSM 241N 745W,0,0,2,5,7
Hurricane,Isabel,32,2003-09-14T03:00:00Z,25.9N  69.8W,1,25,1,1,28
Hurricane,Isabel,32,2003-09-14T03:00:00Z,MYEG 235N 758W,0,0,0,2,2
Hurricane,Isabel,32,2003-09-14T03:00:00Z,MBJT 215N 712W,0,1,1,1,3
Hurricane,Isabel,32,2003-09-14T03:00:00Z,MYNN 251N 775W,0,0,0,2,2
Hurricane,Isabel,33,2003-09-14T09:00:00Z,24.5N  68.5W,58,0,0,0,58
Hurricane,Isabel,33,2003-09-14T09:00:00Z,MYEG 235N 758W,0,0,0,2,2
Hurricane,Isabel,33,2003-09-14T09:00:00Z,25.5N  69.5W,33,5,0,0,38
Hurricane,Isabel,33,2003-09-14T09:00:00Z,MYNN 251N 775W,0,0,0,2,2
Hurricane,Isabel,33,2003-09-14T09:00:00Z,26.5N  70.5W,3,22,2,1,28
Hurricane,Isabel,33,2003-09-14T09:00:00Z,MYGF 266N 787W,0,0,0,2,2
Hurricane,Isabel,33,2003-09-14T09:00:00Z,MBJT 215N 712W,1,1,1,1,4
Hurricane,Isabel,33,2003-09-14T09:00:00Z,WILMINGTON NC,0,0,0,2,2
Hurricane,Isabel,33,2003-09-14T09:00:00Z,MYMM 224N 730W,0,1,2,1,4
Hurricane,Isabel,33,2003-09-14T09:00:00Z,MOREHEAD CITY NC,0,0,0,2,2
Hurricane,Isabel,33,2003-09-14T09:00:00Z,MYSM 241N 745W,0,0,3,4,7
Hurricane,Isabel,33,2003-09-14T09:00:00Z,CAPE HATTERAS NC,0,0,0,2,2
Hurricane,Isabel,34,2003-09-14T15:00:00Z,25.2N  69.6W,47,0,0,0,47
Hurricane,Isabel,34,2003-09-14T15:00:00Z,MYGF 266N 787W,0,0,0,2,2
Hurricane,Isabel,34,2003-09-14T15:00:00Z,26.1N  70.6W,29,3,0,1,33
Hurricane,Isabel,34,2003-09-14T15:00:00Z,CHARLESTON SC,0,0,0,3,3
Hurricane,Isabel,34,2003-09-14T15:00:00Z,27.2N  71.6W,4,19,2,1,26
Hurricane,Isabel,34,2003-09-14T15:00:00Z,MYRTLE BEACH SC,0,0,0,4,4
Hurricane,Isabel,34,2003-09-14T15:00:00Z,MYMM 224N 730W,0,2,1,1,4
Hurricane,Isabel,34,2003-09-14T15:00:00Z,WILMINGTON NC,0,0,0,5,5
Hurricane,Isabel,34,2003-09-14T15:00:00Z,MYSM 241N 745W,0,3,3,2,8
Hurricane,Isabel,34,2003-09-14T15:00:00Z,MOREHEAD CITY NC,0,0,0,6,6
Hurricane,Isabel,34,2003-09-14T15:00:00Z,MYEG 235N 758W,0,0,1,1,2
Hurricane,Isabel,34,2003-09-14T15:00:00Z,CAPE HATTERAS NC,0,0,0,6,6
Hurricane,Isabel,34,2003-09-14T15:00:00Z,MYNN 251N 775W,0,0,1,2,3
Hurricane,Isabel,34,2003-09-14T15:00:00Z,NORFOLK VA,0,0,0,2,2
Hurricane,Isabel,35,2003-09-14T21:00:00Z,25.7N  70.2W,49,0,0,0,49
Hurricane,Isabel,35,2003-09-14T21:00:00Z,SAVANNAH GA,0,0,0,2,2
Hurricane,Isabel,35,2003-09-14T21:00:00Z,26.7N  71.3W,27,5,1,0,33
Hurricane,Isabel,35,2003-09-14T21:00:00Z,CHARLESTON SC,0,0,0,5,5
Hurricane,Isabel,35,2003-09-14T21:00:00Z,28.0N  72.2W,2,20,3,1,26
Hurricane,Isabel,35,2003-09-14T21:00:00Z,MYRTLE BEACH SC,0,0,0,7,7
Hurricane,Isabel,35,2003-09-14T21:00:00Z,MYMM 224N 730W,0,2,1,1,4
Hurricane,Isabel,35,2003-09-14T21:00:00Z,WILMINGTON NC,0,0,0,9,9
Hurricane,Isabel,35,2003-09-14T21:00:00Z,MYSM 241N 745W,0,4,3,2,9
Hurricane,Isabel,35,2003-09-14T21:00:00Z,MOREHEAD CITY NC,0,0,0,11,11
Hurricane,Isabel,35,2003-09-14T21:00:00Z,MYEG 235N 758W,0,0,2,1,3
Hurricane,Isabel,35,2003-09-14T21:00:00Z,CAPE HATTERAS NC,0,0,0,11,11
Hurricane,Isabel,35,2003-09-14T21:00:00Z,MYNN 251N 775W,0,0,1,1,2
Hurricane,Isabel,35,2003-09-14T21:00:00Z,NORFOLK VA,0,0,0,6,6
Hurricane,Isabel,35,2003-09-14T21:00:00Z,MYGF 266N 787W,0,0,0,2,2
Hurricane,Isabel,35,2003-09-14T21:00:00Z,OCEAN CITY MD,0,0,0,3,3
Hurricane,Isabel,36,2003-09-15T03:00:00Z,26.2N  70.6W,45,0,0,0,45
Hurricane,Isabel,36,2003-09-15T03:00:00Z,WILMINGTON NC,0,0,0,12,12
Hurricane,Isabel,36,2003-09-15T03:00:00Z,27.6N  71.4W,21,8,1,0,30
Hurricane,Isabel,36,2003-09-15T03:00:00Z,MOREHEAD CITY NC,0,0,0,15,15
Hurricane,Isabel,36,2003-09-15T03:00:00Z,28.9N  72.1W,2,20,2,1,25
Hurricane,Isabel,36,2003-09-15T03:00:00Z,CAPE HATTERAS NC,0,0,0,16,16
Hurricane,Isabel,36,2003-09-15T03:00:00Z,MYSM 241N 745W,0,1,1,0,2
Hurricane,Isabel,36,2003-09-15T03:00:00Z,NORFOLK VA,0,0,0,12,12
Hurricane,Isabel,36,2003-09-15T03:00:00Z,SAVANNAH GA,0,0,0,2,2
Hurricane,Isabel,36,2003-09-15T03:00:00Z,OCEAN CITY MD,0,0,0,7,7
Hurricane,Isabel,36,2003-09-15T03:00:00Z,CHARLESTON SC,0,0,0,5,5
Hurricane,Isabel,36,2003-09-15T03:00:00Z,ATLANTIC CITY NJ,0,0,0,4,4
Hurricane,Isabel,36,2003-09-15T03:00:00Z,MYRTLE BEACH SC,0,0,0,9,9
Hurricane,Isabel,37,2003-09-15T09:00:00Z,26.5N  71.0W,52,0,0,0,52
Hurricane,Isabel,37,2003-09-15T09:00:00Z,WILMINGTON NC,0,0,0,12,12
Hurricane,Isabel,37,2003-09-15T09:00:00Z,27.9N  71.9W,24,6,0,0,30
Hurricane,Isabel,37,2003-09-15T09:00:00Z,MOREHEAD CITY NC,0,0,0,14,14
Hurricane,Isabel,37,2003-09-15T09:00:00Z,29.2N  72.6W,2,18,2,1,23
Hurricane,Isabel,37,2003-09-15T09:00:00Z,CAPE HATTERAS NC,0,0,0,14,14
Hurricane,Isabel,37,2003-09-15T09:00:00Z,JACKSONVILLE FL,0,0,0,2,2
Hurricane,Isabel,37,2003-09-15T09:00:00Z,NORFOLK VA,0,0,0,9,9
Hurricane,Isabel,37,2003-09-15T09:00:00Z,SAVANNAH GA,0,0,0,4,4
Hurricane,Isabel,37,2003-09-15T09:00:00Z,OCEAN CITY MD,0,0,0,5,5
Hurricane,Isabel,37,2003-09-15T09:00:00Z,CHARLESTON SC,0,0,0,8,8
Hurricane,Isabel,37,2003-09-15T09:00:00Z,ATLANTIC CITY NJ,0,0,0,2,2
Hurricane,Isabel,37,2003-09-15T09:00:00Z,MYRTLE BEACH SC,0,0,0,10,10
Hurricane,Isabel,38,2003-09-15T15:00:00Z,27.0N  71.2W,52,0,0,0,52
Hurricane,Isabel,38,2003-09-15T15:00:00Z,WILMINGTON NC,0,0,1,12,13
Hurricane,Isabel,38,2003-09-15T15:00:00Z,28.2N  72.0W,29,4,1,0,34
Hurricane,Isabel,38,2003-09-15T15:00:00Z,MOREHEAD CITY NC,0,0,1,14,15
Hurricane,Isabel,38,2003-09-15T15:00:00Z,30.0N  73.0W,0,17,6,1,24
Hurricane,Isabel,38,2003-09-15T15:00:00Z,CAPE HATTERAS NC,0,0,1,14,15
Hurricane,Isabel,38,2003-09-15T15:00:00Z,BERMUDA,0,0,0,2,2
Hurricane,Isabel,38,2003-09-15T15:00:00Z,NORFOLK VA,0,0,0,13,13
Hurricane,Isabel,38,2003-09-15T15:00:00Z,SAVANNAH GA,0,0,0,4,4
Hurricane,Isabel,38,2003-09-15T15:00:00Z,OCEAN CITY MD,0,0,0,10,10
Hurricane,Isabel,38,2003-09-15T15:00:00Z,CHARLESTON SC,0,0,0,7,7
Hurricane,Isabel,38,2003-09-15T15:00:00Z,ATLANTIC CITY NJ,0,0,0,6,6
Hurricane,Isabel,38,2003-09-15T15:00:00Z,MYRTLE BEACH SC,0,0,0,11,11
Hurricane,Isabel,38,2003-09-15T15:00:00Z,NEW YORK CITY NY,0,0,0,3,3
Hurricane,Isabel,39,2003-09-15T21:00:00Z,27.5N  71.6W,46,0,0,0,46
Hurricane,Isabel,39,2003-09-15T21:00:00Z,MOREHEAD CITY NC,0,0,2,14,16
Hurricane,Isabel,39,2003-09-15T21:00:00Z,29.0N  72.3W,22,5,0,0,27
Hurricane,Isabel,39,2003-09-15T21:00:00Z,CAPE HATTERAS NC,0,0,1,15,16
Hurricane,Isabel,39,2003-09-15T21:00:00Z,30.8N  73.2W,1,15,4,1,21
Hurricane,Isabel,39,2003-09-15T21:00:00Z,NORFOLK VA,0,0,0,14,14
Hurricane,Isabel,39,2003-09-15T21:00:00Z,SAVANNAH GA,0,0,0,4,4
Hurricane,Isabel,39,2003-09-15T21:00:00Z,OCEAN CITY MD,0,0,0,11,11
Hurricane,Isabel,39,2003-09-15T21:00:00Z,CHARLESTON SC,0,0,1,7,8
Hurricane,Isabel,39,2003-09-15T21:00:00Z,ATLANTIC CITY NJ,0,0,0,8,8
Hurricane,Isabel,39,2003-09-15T21:00:00Z,MYRTLE BEACH SC,0,0,1,11,12
Hurricane,Isabel,39,2003-09-15T21:00:00Z,NEW YORK CITY NY,0,0,0,4,4
Hurricane,Isabel,39,2003-09-15T21:00:00Z,WILMINGTON NC,0,0,2,12,14
Hurricane,Isabel,39,2003-09-15T21:00:00Z,MONTAUK POINT NY,0,0,0,2,2
Hurricane,Isabel,40,2003-09-16T03:00:00Z,28.4N  71.7W,46,0,0,0,46
Hurricane,Isabel,40,2003-09-16T03:00:00Z,MOREHEAD CITY NC,0,0,6,9,15
Hurricane,Isabel,40,2003-09-16T03:00:00Z,29.8N  72.5W,21,7,0,0,28
Hurricane,Isabel,40,2003-09-16T03:00:00Z,CAPE HATTERAS NC,0,0,5,10,15
Hurricane,Isabel,40,2003-09-16T03:00:00Z,31.5N  73.7W,1,15,4,1,21
Hurricane,Isabel,40,2003-09-16T03:00:00Z,NORFOLK VA,0,0,1,12,13
Hurricane,Isabel,40,2003-09-16T03:00:00Z,SAVANNAH GA,0,0,1,3,4
Hurricane,Isabel,40,2003-09-16T03:00:00Z,OCEAN CITY MD,0,0,0,10,10
Hurricane,Isabel,40,2003-09-16T03:00:00Z,CHARLESTON SC,0,0,2,6,8
Hurricane,Isabel,40,2003-09-16T03:00:00Z,ATLANTIC CITY NJ,0,0,0,7,7
Hurricane,Isabel,40,2003-09-16T03:00:00Z,MYRTLE BEACH SC,0,0,4,7,11
Hurricane,Isabel,40,2003-09-16T03:00:00Z,NEW YORK CITY NY,0,0,0,4,4
Hurricane,Isabel,40,2003-09-16T03:00:00Z,WILMINGTON NC,0,0,5,9,14
Hurricane,Isabel,40,2003-09-16T03:00:00Z,MONTAUK POINT NY,0,0,0,2,2
Hurricane,Isabel,41,2003-09-16T09:00:00Z,29.0N  72.1W,50,1,0,0,51
Hurricane,Isabel,41,2003-09-16T09:00:00Z,MOREHEAD CITY NC,0,2,12,4,18
Hurricane,Isabel,41,2003-09-16T09:00:00Z,30.7N  73.2W,23,6,0,0,29
Hurricane,Isabel,41,2003-09-16T09:00:00Z,CAPE HATTERAS NC,0,1,12,4,17
Hurricane,Isabel,41,2003-09-16T09:00:00Z,33.0N  74.7W,0,15,6,1,22
Hurricane,Isabel,41,2003-09-16T09:00:00Z,NORFOLK VA,0,0,6,9,15
Hurricane,Isabel,41,2003-09-16T09:00:00Z,SAVANNAH GA,0,0,1,3,4
Hurricane,Isabel,41,2003-09-16T09:00:00Z,OCEAN CITY MD,0,0,1,10,11
Hurricane,Isabel,41,2003-09-16T09:00:00Z,CHARLESTON SC,0,0,4,4,8
Hurricane,Isabel,41,2003-09-16T09:00:00Z,ATLANTIC CITY NJ,0,0,0,8,8
Hurricane,Isabel,41,2003-09-16T09:00:00Z,MYRTLE BEACH SC,0,1,7,5,13
Hurricane,Isabel,41,2003-09-16T09:00:00Z,NEW YORK CITY NY,0,0,0,5,5
Hurricane,Isabel,41,2003-09-16T09:00:00Z,WILMINGTON NC,0,1,11,4,16
Hurricane,Isabel,41,2003-09-16T09:00:00Z,MONTAUK POINT NY,0,0,0,2,2
Hurricane,Isabel,42,2003-09-16T15:00:00Z,29.9N  72.6W,51,0,0,0,51
Hurricane,Isabel,42,2003-09-16T15:00:00Z,CAPE HATTERAS NC,0,4,11,3,18
Hurricane,Isabel,42,2003-09-16T15:00:00Z,31.7N  73.9W,18,11,0,0,29
Hurricane,Isabel,42,2003-09-16T15:00:00Z,NORFOLK VA,0,0,8,7,15
Hurricane,Isabel,42,2003-09-16T15:00:00Z,33.8N  75.6W,0,15,5,1,21
Hurricane,Isabel,42,2003-09-16T15:00:00Z,OCEAN CITY MD,0,0,2,9,11
Hurricane,Isabel,42,2003-09-16T15:00:00Z,SAVANNAH GA,0,0,1,3,4
Hurricane,Isabel,42,2003-09-16T15:00:00Z,ATLANTIC CITY NJ,0,0,0,8,8
Hurricane,Isabel,42,2003-09-16T15:00:00Z,CHARLESTON SC,0,1,4,4,9
Hurricane,Isabel,42,2003-09-16T15:00:00Z,NEW YORK CITY NY,0,0,0,5,5
Hurricane,Isabel,42,2003-09-16T15:00:00Z,MYRTLE BEACH SC,0,3,8,3,14
Hurricane,Isabel,42,2003-09-16T15:00:00Z,MONTAUK POINT NY,0,0,0,3,3
Hurricane,Isabel,42,2003-09-16T15:00:00Z,WILMINGTON NC,0,5,10,2,17
Hurricane,Isabel,42,2003-09-16T15:00:00Z,PROVIDENCE RI,0,0,0,2,2
Hurricane,Isabel,42,2003-09-16T15:00:00Z,MOREHEAD CITY NC,0,6,11,2,19
Hurricane,Isabel,43,2003-09-16T21:00:00Z,30.5N  73.0W,47,0,0,0,47
Hurricane,Isabel,43,2003-09-16T21:00:00Z,NORFOLK VA,0,1,12,4,17
Hurricane,Isabel,43,2003-09-16T21:00:00Z,32.7N  74.6W,9,20,1,0,30
Hurricane,Isabel,43,2003-09-16T21:00:00Z,OCEAN CITY MD,0,0,3,9,12
Hurricane,Isabel,43,2003-09-16T21:00:00Z,35.0N  76.7W,0,12,9,1,22
Hurricane,Isabel,43,2003-09-16T21:00:00Z,ATLANTIC CITY NJ,0,0,1,9,10
Hurricane,Isabel,43,2003-09-16T21:00:00Z,SAVANNAH GA,0,0,1,1,2
Hurricane,Isabel,43,2003-09-16T21:00:00Z,NEW YORK CITY NY,0,0,0,7,7
Hurricane,Isabel,43,2003-09-16T21:00:00Z,CHARLESTON SC,0,1,4,2,7
Hurricane,Isabel,43,2003-09-16T21:00:00Z,MONTAUK POINT NY,0,0,0,4,4
Hurricane,Isabel,43,2003-09-16T21:00:00Z,MYRTLE BEACH SC,0,5,8,1,14
Hurricane,Isabel,43,2003-09-16T21:00:00Z,PROVIDENCE RI,0,0,0,3,3
Hurricane,Isabel,43,2003-09-16T21:00:00Z,WILMINGTON NC,0,11,8,1,20
Hurricane,Isabel,43,2003-09-16T21:00:00Z,NANTUCKET MA,0,0,0,2,2
Hurricane,Isabel,43,2003-09-16T21:00:00Z,MOREHEAD CITY NC,0,14,8,0,22
Hurricane,Isabel,43,2003-09-16T21:00:00Z,HYANNIS MA,0,0,0,2,2
Hurricane,Isabel,43,2003-09-16T21:00:00Z,CAPE HATTERAS NC,0,10,10,1,21
Hurricane,Isabel,43,2003-09-16T21:00:00Z,BOSTON MA,0,0,0,2,2
Hurricane,Isabel,44,2003-09-17T03:00:00Z,31.7N  73.7W,46,0,0,1,47
Hurricane,Isabel,44,2003-09-17T03:00:00Z,OCEAN CITY MD,0,1,7,5,13
Hurricane,Isabel,44,2003-09-17T03:00:00Z,34.0N  75.5W,7,20,0,0,27
Hurricane,Isabel,44,2003-09-17T03:00:00Z,ATLANTIC CITY NJ,0,0,3,8,11
Hurricane,Isabel,44,2003-09-17T03:00:00Z,36.6N  77.5W,0,9,9,2,20
Hurricane,Isabel,44,2003-09-17T03:00:00Z,NEW YORK CITY NY,0,0,1,7,8
Hurricane,Isabel,44,2003-09-17T03:00:00Z,CHARLESTON SC,0,1,3,1,5
Hurricane,Isabel,44,2003-09-17T03:00:00Z,MONTAUK POINT NY,0,0,0,5,5
Hurricane,Isabel,44,2003-09-17T03:00:00Z,MYRTLE BEACH SC,0,9,4,0,13
Hurricane,Isabel,44,2003-09-17T03:00:00Z,PROVIDENCE RI,0,0,0,4,4
Hurricane,Isabel,44,2003-09-17T03:00:00Z,WILMINGTON NC,1,16,2,0,19
Hurricane,Isabel,44,2003-09-17T03:00:00Z,NANTUCKET MA,0,0,0,3,3
Hurricane,Isabel,44,2003-09-17T03:00:00Z,MOREHEAD CITY NC,1,21,1,0,23
Hurricane,Isabel,44,2003-09-17T03:00:00Z,HYANNIS MA,0,0,0,3,3
Hurricane,Isabel,44,2003-09-17T03:00:00Z,CAPE HATTERAS NC,0,19,2,1,22
Hurricane,Isabel,44,2003-09-17T03:00:00Z,BOSTON MA,0,0,0,3,3
Hurricane,Isabel,44,2003-09-17T03:00:00Z,NORFOLK VA,0,6,10,2,18
Hurricane,Isabel,44,2003-09-17T03:00:00Z,PORTLAND ME,0,0,0,2,2
Hurricane,Isabel,45,2003-09-17T09:00:00Z,33.0N  74.6W,40,0,0,0,40
Hurricane,Isabel,45,2003-09-17T09:00:00Z,OCEAN CITY MD,0,5,9,2,16
Hurricane,Isabel,45,2003-09-17T09:00:00Z,35.2N  76.4W,7,20,1,0,28
Hurricane,Isabel,45,2003-09-17T09:00:00Z,ATLANTIC CITY NJ,0,1,6,6,13
Hurricane,Isabel,45,2003-09-17T09:00:00Z,38.2N  78.2W,0,8,11,1,20
Hurricane,Isabel,45,2003-09-17T09:00:00Z,NEW YORK CITY NY,0,0,2,8,10
Hurricane,Isabel,45,2003-09-17T09:00:00Z,CHARLESTON SC,1,4,2,0,7
Hurricane,Isabel,45,2003-09-17T09:00:00Z,MONTAUK POINT NY,0,0,0,7,7
Hurricane,Isabel,45,2003-09-17T09:00:00Z,MYRTLE BEACH SC,3,12,1,0,16
Hurricane,Isabel,45,2003-09-17T09:00:00Z,PROVIDENCE RI,0,0,0,6,6
Hurricane,Isabel,45,2003-09-17T09:00:00Z,WILMINGTON NC,7,16,1,0,24
Hurricane,Isabel,45,2003-09-17T09:00:00Z,NANTUCKET MA,0,0,0,4,4
Hurricane,Isabel,45,2003-09-17T09:00:00Z,MOREHEAD CITY NC,12,16,1,0,29
Hurricane,Isabel,45,2003-09-17T09:00:00Z,HYANNIS MA,0,0,0,4,4
Hurricane,Isabel,45,2003-09-17T09:00:00Z,CAPE HATTERAS NC,9,18,0,0,27
Hurricane,Isabel,45,2003-09-17T09:00:00Z,BOSTON MA,0,0,0,5,5
Hurricane,Isabel,45,2003-09-17T09:00:00Z,NORFOLK VA,0,18,4,0,22
Hurricane,Isabel,45,2003-09-17T09:00:00Z,PORTLAND ME,0,0,0,3,3
Hurricane,Isabel,46,2003-09-17T15:00:00Z,33.6N  75.4W,41,0,0,0,41
Hurricane,Isabel,46,2003-09-17T15:00:00Z,ATLANTIC CITY NJ,0,1,5,5,11
Hurricane,Isabel,46,2003-09-17T15:00:00Z,36.0N  77.3W,6,21,1,0,28
Hurricane,Isabel,46,2003-09-17T15:00:00Z,NEW YORK CITY NY,0,0,2,7,9
Hurricane,Isabel,46,2003-09-17T15:00:00Z,39.0N  79.0W,0,6,12,1,19
Hurricane,Isabel,46,2003-09-17T15:00:00Z,MONTAUK POINT NY,0,0,0,6,6
Hurricane,Isabel,46,2003-09-17T15:00:00Z,CHARLESTON SC,2,6,1,0,9
Hurricane,Isabel,46,2003-09-17T15:00:00Z,PROVIDENCE RI,0,0,0,6,6
Hurricane,Isabel,46,2003-09-17T15:00:00Z,MYRTLE BEACH SC,10,11,0,0,21
Hurricane,Isabel,46,2003-09-17T15:00:00Z,NANTUCKET MA,0,0,0,4,4
Hurricane,Isabel,46,2003-09-17T15:00:00Z,WILMINGTON NC,20,10,0,0,30
Hurricane,Isabel,46,2003-09-17T15:00:00Z,HYANNIS MA,0,0,0,4,4
Hurricane,Isabel,46,2003-09-17T15:00:00Z,MOREHEAD CITY NC,27,8,0,0,35
Hurricane,Isabel,46,2003-09-17T15:00:00Z,BOSTON MA,0,0,0,5,5
Hurricane,Isabel,46,2003-09-17T15:00:00Z,CAPE HATTERAS NC,19,10,0,0,29
Hurricane,Isabel,46,2003-09-17T15:00:00Z,PORTLAND ME,0,0,0,4,4
Hurricane,Isabel,46,2003-09-17T15:00:00Z,NORFOLK VA,2,18,1,1,22
Hurricane,Isabel,46,2003-09-17T15:00:00Z,BAR HARBOR ME,0,0,0,2,2
Hurricane,Isabel,46,2003-09-17T15:00:00Z,OCEAN CITY MD,0,5,7,2,14
Hurricane,Isabel,47,2003-09-17T21:00:00Z,35.0N  76.6W,36,1,0,0,37
Hurricane,Isabel,47,2003-09-17T21:00:00Z,ATLANTIC CITY NJ,0,1,6,4,11
Hurricane,Isabel,47,2003-09-17T21:00:00Z,37.6N  78.5W,4,21,2,0,27
Hurricane,Isabel,47,2003-09-17T21:00:00Z,NEW YORK CITY NY,0,0,3,6,9
Hurricane,Isabel,47,2003-09-17T21:00:00Z,41.5N  79.0W,0,1,14,4,19
Hurricane,Isabel,47,2003-09-17T21:00:00Z,MONTAUK POINT NY,0,0,1,4,5
Hurricane,Isabel,47,2003-09-17T21:00:00Z,CHARLESTON SC,3,3,0,0,6
Hurricane,Isabel,47,2003-09-17T21:00:00Z,PROVIDENCE RI,0,0,0,5,5
Hurricane,Isabel,47,2003-09-17T21:00:00Z,MYRTLE BEACH SC,20,2,0,0,22
Hurricane,Isabel,47,2003-09-17T21:00:00Z,NANTUCKET MA,0,0,0,3,3
Hurricane,Isabel,47,2003-09-17T21:00:00Z,WILMINGTON NC,34,1,0,0,35
Hurricane,Isabel,47,2003-09-17T21:00:00Z,HYANNIS MA,0,0,0,3,3
Hurricane,Isabel,47,2003-09-17T21:00:00Z,MOREHEAD CITY NC,39,0,0,0,39
Hurricane,Isabel,47,2003-09-17T21:00:00Z,BOSTON MA,0,0,0,4,4
Hurricane,Isabel,47,2003-09-17T21:00:00Z,CAPE HATTERAS NC,29,2,0,0,31
Hurricane,Isabel,47,2003-09-17T21:00:00Z,PORTLAND ME,0,0,0,4,4
Hurricane,Isabel,47,2003-09-17T21:00:00Z,NORFOLK VA,10,12,1,0,23
Hurricane,Isabel,47,2003-09-17T21:00:00Z,BAR HARBOR ME,0,0,0,2,2
Hurricane,Isabel,47,2003-09-17T21:00:00Z,OCEAN CITY MD,1,4,8,1,14
Hurricane,Isabel,47,2003-09-17T21:00:00Z,EASTPORT ME,0,0,0,2,2
Hurricane,Isabel,48,2003-09-18T03:00:00Z,36.5N  77.5W,41,0,0,0,41
Hurricane,Isabel,48,2003-09-18T03:00:00Z,NEW YORK CITY NY,0,3,9,1,13
Hurricane,Isabel,48,2003-09-18T03:00:00Z,39.5N  78.5W,4,23,0,0,27
Hurricane,Isabel,48,2003-09-18T03:00:00Z,MONTAUK POINT NY,0,0,5,3,8
Hurricane,Isabel,48,2003-09-18T03:00:00Z,43.0N  77.5W,0,3,14,3,20
Hurricane,Isabel,48,2003-09-18T03:00:00Z,PROVIDENCE RI,0,0,4,3,7
Hurricane,Isabel,48,2003-09-18T03:00:00Z,CHARLESTON SC,1,1,0,0,2
Hurricane,Isabel,48,2003-09-18T03:00:00Z,NANTUCKET MA,0,0,2,2,4
Hurricane,Isabel,48,2003-09-18T03:00:00Z,MYRTLE BEACH SC,18,0,0,0,18
Hurricane,Isabel,48,2003-09-18T03:00:00Z,HYANNIS MA,0,0,2,2,4
Hurricane,Isabel,48,2003-09-18T03:00:00Z,WILMINGTON NC,42,0,0,0,42
Hurricane,Isabel,48,2003-09-18T03:00:00Z,BOSTON MA,0,0,3,4,7
Hurricane,Isabel,48,2003-09-18T03:00:00Z,MOREHEAD CITY NC,55,0,0,0,55
Hurricane,Isabel,48,2003-09-18T03:00:00Z,PORTLAND ME,0,0,1,5,6
Hurricane,Isabel,48,2003-09-18T03:00:00Z,CAPE HATTERAS NC,46,0,0,0,46
Hurricane,Isabel,48,2003-09-18T03:00:00Z,BAR HARBOR ME,0,0,0,4,4
Hurricane,Isabel,48,2003-09-18T03:00:00Z,NORFOLK VA,30,2,0,1,33
Hurricane,Isabel,48,2003-09-18T03:00:00Z,EASTPORT ME,0,0,0,3,3
Hurricane,Isabel,48,2003-09-18T03:00:00Z,OCEAN CITY MD,6,11,1,0,18
Hurricane,Isabel,48,2003-09-18T03:00:00Z,ST JOHN NB,0,0,0,2,2
Hurricane,Isabel,48,2003-09-18T03:00:00Z,ATLANTIC CITY NJ,1,9,5,0,15
Hurricane,Isabel,49,2003-09-18T09:00:00Z,37.9N  78.2W,32,2,0,0,34
Hurricane,Isabel,49,2003-09-18T09:00:00Z,MONTAUK POINT NY,0,1,3,0,4
Hurricane,Isabel,49,2003-09-18T09:00:00Z,41.4N  78.5W,0,18,4,0,22
Hurricane,Isabel,49,2003-09-18T09:00:00Z,PROVIDENCE RI,0,1,3,0,4
Hurricane,Isabel,49,2003-09-18T09:00:00Z,47.0N  78.0W,0,0,10,3,13
Hurricane,Isabel,49,2003-09-18T09:00:00Z,NANTUCKET MA,0,0,2,0,2
Hurricane,Isabel,49,2003-09-18T09:00:00Z,WILMINGTON NC,23,0,0,0,23
Hurricane,Isabel,49,2003-09-18T09:00:00Z,HYANNIS MA,0,0,2,1,3
Hurricane,Isabel,49,2003-09-18T09:00:00Z,MOREHEAD CITY NC,77,0,0,0,77
Hurricane,Isabel,49,2003-09-18T09:00:00Z,BOSTON MA,0,0,3,1,4
Hurricane,Isabel,49,2003-09-18T09:00:00Z,CAPE HATTERAS NC,65,0,0,0,65
Hurricane,Isabel,49,2003-09-18T09:00:00Z,PORTLAND ME,0,0,3,1,4
Hurricane,Isabel,49,2003-09-18T09:00:00Z,NORFOLK VA,36,0,0,0,36
Hurricane,Isabel,49,2003-09-18T09:00:00Z,BAR HARBOR ME,0,0,1,2,3
Hurricane,Isabel,49,2003-09-18T09:00:00Z,OCEAN CITY MD,9,7,0,0,16
Hurricane,Isabel,49,2003-09-18T09:00:00Z,EASTPORT ME,0,0,1,1,2
Hurricane,Isabel,49,2003-09-18T09:00:00Z,ATLANTIC CITY NJ,2,10,2,0,14
Hurricane,Isabel,49,2003-09-18T09:00:00Z,ST JOHN NB,0,0,0,2,2
Hurricane,Isabel,49,2003-09-18T09:00:00Z,NEW YORK CITY NY,0,6,4,0,10
Hurricane,Isabel,49,2003-09-18T09:00:00Z,MONCTON NB,0,0,0,2,2
Hurricane,Isabel,50,2003-09-18T15:00:00Z,39.7N  78.7W,34,6,0,0,40
Hurricane,Isabel,50,2003-09-18T15:00:00Z,CAPE HATTERAS NC,99,0,0,0,99
Hurricane,Isabel,50,2003-09-18T15:00:00Z,44.5N  78.7W,0,19,7,0,26
Hurricane,Isabel,50,2003-09-18T15:00:00Z,NORFOLK VA,60,0,0,0,60
Hurricane,Isabel,50,2003-09-18T15:00:00Z,50.5N  77.0W,0,0,11,0,11
Hurricane,Isabel,50,2003-09-18T15:00:00Z,OCEAN CITY MD,10,1,0,0,11
Hurricane,Isabel,50,2003-09-18T15:00:00Z,WILMINGTON NC,4,0,0,0,4
Hurricane,Isabel,50,2003-09-18T15:00:00Z,ATLANTIC CITY NJ,3,2,0,0,5
Hurricane,Isabel,50,2003-09-18T15:00:00Z,MOREHEAD CITY NC,99,0,0,0,99
Hurricane,Isabel,50,2003-09-18T15:00:00Z,NEW YORK CITY NY,0,2,0,0,2
Hurricane,Isabel,51,2003-09-18T21:00:00Z,43.5N  79.7W,27,10,0,0,37
Hurricane,Isabel,51,2003-09-18T21:00:00Z,CAPE HATTERAS NC,99,0,0,0,99
Hurricane,Isabel,51,2003-09-18T21:00:00Z,49.5N  79.6W,0,12,8,0,20
Hurricane,Isabel,51,2003-09-18T21:00:00Z,NORFOLK VA,75,0,0,0,75
Hurricane,Isabel,51,2003-09-18T21:00:00Z,55.5N  76.5W,0,0,7,0,7
Hurricane,Isabel,51,2003-09-18T21:00:00Z,OCEAN CITY MD,2,0,0,0,2
Hurricane,Isabel,51,2003-09-18T21:00:00Z,MOREHEAD CITY NC,99,0,0,0,99
Tropical Storm,Isabel,52,2003-09-19T03:00:00Z,46.5N  79.5W,42,8,0,0,50
Tropical Storm,Isabel,52,2003-09-19T03:00:00Z,58.5N  75.5W,0,0,9,0,9
Tropical Storm,Isabel,52,2003-09-19T03:00:00Z,53.0N  79.0W,0,16,4,0,20
Tropical Storm,Isabel,52,2003-09-19T03:00:00Z,NORFOLK VA,51,0,0,0,51
Tropical Storm,Isabel,53,2003-09-19T09:00:00Z,49.4N  79.0W,19,5,0,0,24
Tropical Storm,Isabel,53,2003-09-19T09:00:00Z,61.1N  75.0W,0,0,11,0,11
Tropical Storm,Isabel,53,2003-09-19T09:00:00Z,56.0N  77.0W,0,14,4,0,18
Tropical Depression,Isabel,54,2003-09-19T15:00:00Z,54.0N  79.0W,21,8,0,0,29
Tropical Depression,Isabel,54,2003-09-19T15:00:00Z,60.0N  77.0W,0,15,0,0,15
Tropical Depression,Fourteen,1,2003-09-08T15:00:00Z,12.4N  24.0W,53,0,0,0,53
Tropical Depression,Fourteen,1,2003-09-08T15:00:00Z,14.4N  27.4W,1,22,3,1,27
Tropical Depression,Fourteen,1,2003-09-08T15:00:00Z,13.3N  25.8W,23,13,0,0,36
Tropical Depression,Fourteen,2,2003-09-08T21:00:00Z,13.3N  25.6W,57,0,0,0,57
Tropical Depression,Fourteen,2,2003-09-08T21:00:00Z,16.0N  28.4W,0,23,5,1,29
Tropical Depression,Fourteen,2,2003-09-08T21:00:00Z,14.6N  26.9W,25,12,1,0,38
Tropical Depression,Fourteen,3,2003-09-09T03:00:00Z,13.0N  25.5W,50,0,0,0,50
Tropical Depression,Fourteen,3,2003-09-09T03:00:00Z,16.0N  27.5W,2,22,3,1,28
Tropical Depression,Fourteen,3,2003-09-09T03:00:00Z,14.5N  26.5W,24,11,0,0,35
Tropical Depression,Fourteen,4,2003-09-09T09:00:00Z,13.7N  25.2W,60,0,0,0,60
Tropical Depression,Fourteen,4,2003-09-09T09:00:00Z,18.0N  28.0W,0,23,5,1,29
Tropical Depression,Fourteen,4,2003-09-09T09:00:00Z,16.0N  26.5W,18,22,0,0,40
Tropical Depression,Fourteen,5,2003-09-09T15:00:00Z,16.0N  26.2W,61,0,0,0,61
Tropical Depression,Fourteen,5,2003-09-09T15:00:00Z,20.0N  29.0W,0,22,5,1,28
Tropical Depression,Fourteen,5,2003-09-09T15:00:00Z,18.2N  27.5W,17,22,0,0,39
Tropical Depression,Fourteen,6,2003-09-09T21:00:00Z,18.0N  27.2W,40,0,0,0,40
Tropical Depression,Fourteen,6,2003-09-09T21:00:00Z,22.0N  30.0W,0,13,5,2,20
Tropical Depression,Fourteen,6,2003-09-09T21:00:00Z,20.0N  28.5W,13,12,1,0,26
Tropical Depression,Fourteen,7,2003-09-10T03:00:00Z,19.7N  26.4W,33,1,0,0,34
Tropical Depression,Fourteen,7,2003-09-10T03:00:00Z,22.8N  27.8W,3,19,0,0,22
Tropical Depression,Fourteen,8,2003-09-10T09:00:00Z,20.0N  26.5W,36,0,0,0,36
Tropical Depression,Fourteen,8,2003-09-10T09:00:00Z,22.5N  27.5W,7,14,0,0,21
Tropical Depression,Fourteen,9,2003-09-10T15:00:00Z,20.0N  26.6W,38,0,0,0,38
Tropical Depression,Fifteen,1,2003-09-25T15:00:00Z,32.0N  61.0W,31,0,0,1,32
Tropical Depression,Fifteen,1,2003-09-25T15:00:00Z,BAR HARBOR ME,0,0,0,5,5
Tropical Depression,Fifteen,1,2003-09-25T15:00:00Z,33.5N  61.5W,17,3,1,1,22
Tropical Depression,Fifteen,1,2003-09-25T15:00:00Z,EASTPORT ME,0,0,0,5,5
Tropical Depression,Fifteen,1,2003-09-25T15:00:00Z,35.0N  62.0W,8,6,3,1,18
Tropical Depression,Fifteen,1,2003-09-25T15:00:00Z,ST JOHN NB,0,0,0,5,5
Tropical Depression,Fifteen,1,2003-09-25T15:00:00Z,BERMUDA,2,8,3,2,15
Tropical Depression,Fifteen,1,2003-09-25T15:00:00Z,MONCTON NB,0,0,0,4,4
Tropical Depression,Fifteen,1,2003-09-25T15:00:00Z,MONTAUK POINT NY,0,0,0,2,2
Tropical Depression,Fifteen,1,2003-09-25T15:00:00Z,YARMOUTH NS,0,0,0,6,6
Tropical Depression,Fifteen,1,2003-09-25T15:00:00Z,PROVIDENCE RI,0,0,0,3,3
Tropical Depression,Fifteen,1,2003-09-25T15:00:00Z,HALIFAX NS,0,0,0,6,6
Tropical Depression,Fifteen,1,2003-09-25T15:00:00Z,NANTUCKET MA,0,0,0,4,4
Tropical Depression,Fifteen,1,2003-09-25T15:00:00Z,SABLE ISLAND NS,0,0,0,5,5
Tropical Depression,Fifteen,1,2003-09-25T15:00:00Z,HYANNIS MA,0,0,0,4,4
Tropical Depression,Fifteen,1,2003-09-25T15:00:00Z,SYDNEY NS,0,0,0,3,3
Tropical Depression,Fifteen,1,2003-09-25T15:00:00Z,BOSTON MA,0,0,0,3,3
Tropical Depression,Fifteen,1,2003-09-25T15:00:00Z,EDDY POINT NS,0,0,0,4,4
Tropical Depression,Fifteen,1,2003-09-25T15:00:00Z,PORTLAND ME,0,0,0,3,3
Tropical Storm,Juan,2,2003-09-25T21:00:00Z,33.5N  62.5W,30,0,0,1,31
Tropical Storm,Juan,2,2003-09-25T21:00:00Z,BAR HARBOR ME,0,0,0,7,7
Tropical Storm,Juan,2,2003-09-25T21:00:00Z,35.0N  63.0W,9,9,2,1,21
Tropical Storm,Juan,2,2003-09-25T21:00:00Z,EASTPORT ME,0,0,0,7,7
Tropical Storm,Juan,2,2003-09-25T21:00:00Z,37.0N  63.5W,0,8,6,3,17
Tropical Storm,Juan,2,2003-09-25T21:00:00Z,ST JOHN NB,0,0,0,6,6
Tropical Storm,Juan,2,2003-09-25T21:00:00Z,BERMUDA,21,1,1,0,23
Tropical Storm,Juan,2,2003-09-25T21:00:00Z,MONCTON NB,0,0,0,5,5
Tropical Storm,Juan,2,2003-09-25T21:00:00Z,NEW YORK CITY NY,0,0,0,2,2
Tropical Storm,Juan,2,2003-09-25T21:00:00Z,YARMOUTH NS,0,0,0,8,8
Tropical Storm,Juan,2,2003-09-25T21:00:00Z,MONTAUK POINT NY,0,0,1,4,5
Tropical Storm,Juan,2,2003-09-25T21:00:00Z,HALIFAX NS,0,0,0,7,7
Tropical Storm,Juan,2,2003-09-25T21:00:00Z,PROVIDENCE RI,0,0,1,4,5
Tropical Storm,Juan,2,2003-09-25T21:00:00Z,SABLE ISLAND NS,0,0,0,5,5
Tropical Storm,Juan,2,2003-09-25T21:00:00Z,NANTUCKET MA,0,0,2,5,7
Tropical Storm,Juan,2,2003-09-25T21:00:00Z,SYDNEY NS,0,0,0,3,3
Tropical Storm,Juan,2,2003-09-25T21:00:00Z,HYANNIS MA,0,0,1,6,7
Tropical Storm,Juan,2,2003-09-25T21:00:00Z,EDDY POINT NS,0,0,0,5,5
Tropical Storm,Juan,2,2003-09-25T21:00:00Z,BOSTON MA,0,0,1,5,6
Tropical Storm,Juan,2,2003-09-25T21:00:00Z,PTX BASQUES NFLD,0,0,0,2,2
Tropical Storm,Juan,2,2003-09-25T21:00:00Z,PORTLAND ME,0,0,0,6,6
Tropical Storm,Juan,3,2003-09-26T03:00:00Z,33.7N  62.5W,32,1,0,0,33
Tropical Storm,Juan,3,2003-09-26T03:00:00Z,BAR HARBOR ME,0,0,0,8,8
Tropical Storm,Juan,3,2003-09-26T03:00:00Z,35.6N  63.1W,6,14,1,1,22
Tropical Storm,Juan,3,2003-09-26T03:00:00Z,EASTPORT ME,0,0,0,8,8
Tropical Storm,Juan,3,2003-09-26T03:00:00Z,37.6N  63.5W,0,7,7,3,17
Tropical Storm,Juan,3,2003-09-26T03:00:00Z,ST JOHN NB,0,0,0,7,7
Tropical Storm,Juan,3,2003-09-26T03:00:00Z,BERMUDA,25,0,0,0,25
Tropical Storm,Juan,3,2003-09-26T03:00:00Z,MONCTON NB,0,0,0,6,6
Tropical Storm,Juan,3,2003-09-26T03:00:00Z,NEW YORK CITY NY,0,0,0,3,3
Tropical Storm,Juan,3,2003-09-26T03:00:00Z,YARMOUTH NS,0,0,0,9,9
Tropical Storm,Juan,3,2003-09-26T03:00:00Z,MONTAUK POINT NY,0,0,1,4,5
Tropical Storm,Juan,3,2003-09-26T03:00:00Z,HALIFAX NS,0,0,0,7,7
Tropical Storm,Juan,3,2003-09-26T03:00:00Z,PROVIDENCE RI,0,0,1,5,6
Tropical Storm,Juan,3,2003-09-26T03:00:00Z,SABLE ISLAND NS,0,0,0,6,6
Tropical Storm,Juan,3,2003-09-26T03:00:00Z,NANTUCKET MA,0,0,2,6,8
Tropical Storm,Juan,3,2003-09-26T03:00:00Z,SYDNEY NS,0,0,0,3,3
Tropical Storm,Juan,3,2003-09-26T03:00:00Z,HYANNIS MA,0,0,1,7,8
Tropical Storm,Juan,3,2003-09-26T03:00:00Z,EDDY POINT NS,0,0,0,5,5
Tropical Storm,Juan,3,2003-09-26T03:00:00Z,BOSTON MA,0,0,1,5,6
Tropical Storm,Juan,3,2003-09-26T03:00:00Z,PTX BASQUES NFLD,0,0,0,2,2
Tropical Storm,Juan,3,2003-09-26T03:00:00Z,PORTLAND ME,0,0,0,7,7
Tropical Storm,Juan,4,2003-09-26T09:00:00Z,34.3N  62.6W,34,0,0,0,34
Tropical Storm,Juan,4,2003-09-26T09:00:00Z,EASTPORT ME,0,0,1,9,10
Tropical Storm,Juan,4,2003-09-26T09:00:00Z,36.3N  63.3W,8,13,1,0,22
Tropical Storm,Juan,4,2003-09-26T09:00:00Z,ST JOHN NB,0,0,0,10,10
Tropical Storm,Juan,4,2003-09-26T09:00:00Z,38.4N  63.8W,0,9,6,2,17
Tropical Storm,Juan,4,2003-09-26T09:00:00Z,MONCTON NB,0,0,0,10,10
Tropical Storm,Juan,4,2003-09-26T09:00:00Z,BERMUDA,23,1,0,0,24
Tropical Storm,Juan,4,2003-09-26T09:00:00Z,YARMOUTH NS,0,0,2,10,12
Tropical Storm,Juan,4,2003-09-26T09:00:00Z,NEW YORK CITY NY,0,0,0,2,2
Tropical Storm,Juan,4,2003-09-26T09:00:00Z,HALIFAX NS,0,0,0,11,11
Tropical Storm,Juan,4,2003-09-26T09:00:00Z,MONTAUK POINT NY,0,0,2,4,6
Tropical Storm,Juan,4,2003-09-26T09:00:00Z,SABLE ISLAND NS,0,0,0,9,9
Tropical Storm,Juan,4,2003-09-26T09:00:00Z,PROVIDENCE RI,0,0,2,5,7
Tropical Storm,Juan,4,2003-09-26T09:00:00Z,SYDNEY NS,0,0,0,7,7
Tropical Storm,Juan,4,2003-09-26T09:00:00Z,NANTUCKET MA,0,0,4,5,9
Tropical Storm,Juan,4,2003-09-26T09:00:00Z,EDDY POINT NS,0,0,0,9,9
Tropical Storm,Juan,4,2003-09-26T09:00:00Z,HYANNIS MA,0,0,3,6,9
Tropical Storm,Juan,4,2003-09-26T09:00:00Z,PTX BASQUES NFLD,0,0,0,5,5
Tropical Storm,Juan,4,2003-09-26T09:00:00Z,BOSTON MA,0,0,2,5,7
Tropical Storm,Juan,4,2003-09-26T09:00:00Z,BURGEO NFLD,0,0,0,4,4
Tropical Storm,Juan,4,2003-09-26T09:00:00Z,PORTLAND ME,0,0,1,7,8
Tropical Storm,Juan,4,2003-09-26T09:00:00Z,ILE ST PIERRE,0,0,0,3,3
Tropical Storm,Juan,4,2003-09-26T09:00:00Z,BAR HARBOR ME,0,0,1,9,10
Hurricane,Juan,5,2003-09-26T15:00:00Z,35.5N  63.0W,29,0,0,0,29
Hurricane,Juan,5,2003-09-26T15:00:00Z,ST JOHN NB,0,0,2,11,13
Hurricane,Juan,5,2003-09-26T15:00:00Z,37.5N  63.5W,4,14,2,0,20
Hurricane,Juan,5,2003-09-26T15:00:00Z,MONCTON NB,0,0,1,12,13
Hurricane,Juan,5,2003-09-26T15:00:00Z,40.0N  64.0W,0,6,8,3,17
Hurricane,Juan,5,2003-09-26T15:00:00Z,YARMOUTH NS,0,0,5,9,14
Hurricane,Juan,5,2003-09-26T15:00:00Z,BERMUDA,13,1,0,0,14
Hurricane,Juan,5,2003-09-26T15:00:00Z,HALIFAX NS,0,0,2,12,14
Hurricane,Juan,5,2003-09-26T15:00:00Z,MONTAUK POINT NY,0,0,3,2,5
Hurricane,Juan,5,2003-09-26T15:00:00Z,SABLE ISLAND NS,0,0,1,10,11
Hurricane,Juan,5,2003-09-26T15:00:00Z,PROVIDENCE RI,0,0,3,4,7
Hurricane,Juan,5,2003-09-26T15:00:00Z,SYDNEY NS,0,0,0,11,11
Hurricane,Juan,5,2003-09-26T15:00:00Z,NANTUCKET MA,0,1,5,4,10
Hurricane,Juan,5,2003-09-26T15:00:00Z,EDDY POINT NS,0,0,0,12,12
Hurricane,Juan,5,2003-09-26T15:00:00Z,HYANNIS MA,0,0,5,4,9
Hurricane,Juan,5,2003-09-26T15:00:00Z,PTX BASQUES NFLD,0,0,0,9,9
Hurricane,Juan,5,2003-09-26T15:00:00Z,BOSTON MA,0,0,3,5,8
Hurricane,Juan,5,2003-09-26T15:00:00Z,BURGEO NFLD,0,0,0,7,7
Hurricane,Juan,5,2003-09-26T15:00:00Z,PORTLAND ME,0,0,3,6,9
Hurricane,Juan,5,2003-09-26T15:00:00Z,ILE ST PIERRE,0,0,0,6,6
Hurricane,Juan,5,2003-09-26T15:00:00Z,BAR HARBOR ME,0,0,3,9,12
Hurricane,Juan,5,2003-09-26T15:00:00Z,CAPE RACE NFLD,0,0,0,3,3
Hurricane,Juan,5,2003-09-26T15:00:00Z,EASTPORT ME,0,0,3,10,13
Hurricane,Juan,6,2003-09-26T21:00:00Z,36.5N  63.3W,32,1,0,0,33
Hurricane,Juan,6,2003-09-26T21:00:00Z,ST JOHN NB,0,0,6,8,14
Hurricane,Juan,6,2003-09-26T21:00:00Z,39.5N  63.5W,0,18,2,0,20
Hurricane,Juan,6,2003-09-26T21:00:00Z,MONCTON NB,0,0,3,11,14
Hurricane,Juan,6,2003-09-26T21:00:00Z,42.5N  63.5W,0,2,11,4,17
Hurricane,Juan,6,2003-09-26T21:00:00Z,YARMOUTH NS,0,1,10,5,16
Hurricane,Juan,6,2003-09-26T21:00:00Z,MONTAUK POINT NY,0,0,2,1,3
Hurricane,Juan,6,2003-09-26T21:00:00Z,HALIFAX NS,0,0,7,8,15
Hurricane,Juan,6,2003-09-26T21:00:00Z,PROVIDENCE RI,0,1,3,1,5
Hurricane,Juan,6,2003-09-26T21:00:00Z,SABLE ISLAND NS,0,0,3,10,13
Hurricane,Juan,6,2003-09-26T21:00:00Z,NANTUCKET MA,0,2,5,1,8
Hurricane,Juan,6,2003-09-26T21:00:00Z,SYDNEY NS,0,0,1,11,12
Hurricane,Juan,6,2003-09-26T21:00:00Z,HYANNIS MA,0,1,5,2,8
Hurricane,Juan,6,2003-09-26T21:00:00Z,EDDY POINT NS,0,0,2,11,13
Hurricane,Juan,6,2003-09-26T21:00:00Z,BOSTON MA,0,1,4,1,6
Hurricane,Juan,6,2003-09-26T21:00:00Z,PTX BASQUES NFLD,0,0,0,11,11
Hurricane,Juan,6,2003-09-26T21:00:00Z,PORTLAND ME,0,0,6,3,9
Hurricane,Juan,6,2003-09-26T21:00:00Z,BURGEO NFLD,0,0,0,10,10
Hurricane,Juan,6,2003-09-26T21:00:00Z,BAR HARBOR ME,0,0,8,4,12
Hurricane,Juan,6,2003-09-26T21:00:00Z,ILE ST PIERRE,0,0,0,8,8
Hurricane,Juan,6,2003-09-26T21:00:00Z,EASTPORT ME,0,0,8,6,14
Hurricane,Juan,6,2003-09-26T21:00:00Z,CAPE RACE NFLD,0,0,0,4,4
Hurricane,Juan,7,2003-09-27T03:00:00Z,37.2N  62.8W,30,1,0,0,31
Hurricane,Juan,7,2003-09-27T03:00:00Z,ST JOHN NB,0,2,12,2,16
Hurricane,Juan,7,2003-09-27T03:00:00Z,40.1N  63.2W,5,13,3,0,21
Hurricane,Juan,7,2003-09-27T03:00:00Z,MONCTON NB,0,1,10,5,16
Hurricane,Juan,7,2003-09-27T03:00:00Z,44.8N  62.8W,0,1,12,4,17
Hurricane,Juan,7,2003-09-27T03:00:00Z,YARMOUTH NS,0,5,11,1,17
Hurricane,Juan,7,2003-09-27T03:00:00Z,BERMUDA,1,1,0,0,2
Hurricane,Juan,7,2003-09-27T03:00:00Z,HALIFAX NS,0,2,12,3,17
Hurricane,Juan,7,2003-09-27T03:00:00Z,PROVIDENCE RI,0,1,1,0,2
Hurricane,Juan,7,2003-09-27T03:00:00Z,SABLE ISLAND NS,0,0,8,5,13
Hurricane,Juan,7,2003-09-27T03:00:00Z,NANTUCKET MA,0,2,2,1,5
Hurricane,Juan,7,2003-09-27T03:00:00Z,SYDNEY NS,0,0,4,9,13
Hurricane,Juan,7,2003-09-27T03:00:00Z,HYANNIS MA,0,2,2,1,5
Hurricane,Juan,7,2003-09-27T03:00:00Z,EDDY POINT NS,0,0,8,7,15
Hurricane,Juan,7,2003-09-27T03:00:00Z,BOSTON MA,0,1,2,0,3
Hurricane,Juan,7,2003-09-27T03:00:00Z,PTX BASQUES NFLD,0,0,1,11,12
Hurricane,Juan,7,2003-09-27T03:00:00Z,PORTLAND ME,0,1,4,1,6
Hurricane,Juan,7,2003-09-27T03:00:00Z,BURGEO NFLD,0,0,1,9,10
Hurricane,Juan,7,2003-09-27T03:00:00Z,BAR HARBOR ME,0,2,9,1,12
Hurricane,Juan,7,2003-09-27T03:00:00Z,ILE ST PIERRE,0,0,0,7,7
Hurricane,Juan,7,2003-09-27T03:00:00Z,EASTPORT ME,0,2,11,2,15
Hurricane,Juan,7,2003-09-27T03:00:00Z,CAPE RACE NFLD,0,0,0,3,3
Hurricane,Juan,8,2003-09-27T09:00:00Z,38.9N  63.4W,27,3,0,0,30
Hurricane,Juan,8,2003-09-27T09:00:00Z,MONCTON NB,0,3,15,1,19
Hurricane,Juan,8,2003-09-27T09:00:00Z,43.0N  63.2W,0,15,7,0,22
Hurricane,Juan,8,2003-09-27T09:00:00Z,YARMOUTH NS,0,14,6,0,20
Hurricane,Juan,8,2003-09-27T09:00:00Z,48.7N  62.0W,0,0,11,4,15
Hurricane,Juan,8,2003-09-27T09:00:00Z,HALIFAX NS,0,7,13,0,20
Hurricane,Juan,8,2003-09-27T09:00:00Z,NANTUCKET MA,0,3,0,0,3
Hurricane,Juan,8,2003-09-27T09:00:00Z,SABLE ISLAND NS,0,2,11,1,14
Hurricane,Juan,8,2003-09-27T09:00:00Z,HYANNIS MA,0,3,0,0,3
Hurricane,Juan,8,2003-09-27T09:00:00Z,SYDNEY NS,0,0,12,2,14
Hurricane,Juan,8,2003-09-27T09:00:00Z,BOSTON MA,0,2,0,0,2
Hurricane,Juan,8,2003-09-27T09:00:00Z,EDDY POINT NS,0,1,14,1,16
Hurricane,Juan,8,2003-09-27T09:00:00Z,PORTLAND ME,0,3,2,0,5
Hurricane,Juan,8,2003-09-27T09:00:00Z,PTX BASQUES NFLD,0,0,8,5,13
Hurricane,Juan,8,2003-09-27T09:00:00Z,BAR HARBOR ME,0,8,6,0,14
Hurricane,Juan,8,2003-09-27T09:00:00Z,BURGEO NFLD,0,0,5,5,10
Hurricane,Juan,8,2003-09-27T09:00:00Z,EASTPORT ME,0,8,9,0,17
Hurricane,Juan,8,2003-09-27T09:00:00Z,ILE ST PIERRE,0,0,3,4,7
Hurricane,Juan,8,2003-09-27T09:00:00Z,ST JOHN NB,0,7,12,0,19
Hurricane,Juan,8,2003-09-27T09:00:00Z,CAPE RACE NFLD,0,0,1,2,3
Hurricane,Juan,9,2003-09-27T15:00:00Z,40.5N  64.5W,26,2,0,0,28
Hurricane,Juan,9,2003-09-27T15:00:00Z,ST JOHN NB,0,15,6,0,21
Hurricane,Juan,9,2003-09-27T15:00:00Z,44.5N  64.0W,0,15,6,0,21
Hurricane,Juan,9,2003-09-27T15:00:00Z,MONCTON NB,0,9,11,0,20
Hurricane,Juan,9,2003-09-27T15:00:00Z,52.0N  61.0W,0,0,8,0,8
Hurricane,Juan,9,2003-09-27T15:00:00Z,YARMOUTH NS,3,17,2,0,22
Hurricane,Juan,9,2003-09-27T15:00:00Z,PROVIDENCE RI,1,1,0,0,2
Hurricane,Juan,9,2003-09-27T15:00:00Z,HALIFAX NS,0,14,7,0,21
Hurricane,Juan,9,2003-09-27T15:00:00Z,NANTUCKET MA,3,3,0,0,6
Hurricane,Juan,9,2003-09-27T15:00:00Z,SABLE ISLAND NS,0,4,7,0,11
Hurricane,Juan,9,2003-09-27T15:00:00Z,HYANNIS MA,2,4,0,0,6
Hurricane,Juan,9,2003-09-27T15:00:00Z,SYDNEY NS,0,1,11,0,12
Hurricane,Juan,9,2003-09-27T15:00:00Z,BOSTON MA,1,4,0,0,5
Hurricane,Juan,9,2003-09-27T15:00:00Z,EDDY POINT NS,0,4,11,0,15
Hurricane,Juan,9,2003-09-27T15:00:00Z,PORTLAND ME,1,8,0,0,9
Hurricane,Juan,9,2003-09-27T15:00:00Z,PTX BASQUES NFLD,0,0,10,0,10
Hurricane,Juan,9,2003-09-27T15:00:00Z,BAR HARBOR ME,2,13,2,0,17
Hurricane,Juan,9,2003-09-27T15:00:00Z,BURGEO NFLD,0,0,7,0,7
Hurricane,Juan,9,2003-09-27T15:00:00Z,EASTPORT ME,1,15,4,0,20
Hurricane,Juan,9,2003-09-27T15:00:00Z,ILE ST PIERRE,0,0,4,0,4
Hurricane,Juan,10,2003-09-27T21:00:00Z,42.5N  64.5W,24,6,0,0,30
Hurricane,Juan,10,2003-09-27T21:00:00Z,MONCTON NB,1,21,0,0,22
Hurricane,Juan,10,2003-09-27T21:00:00Z,48.0N  63.0W,0,13,0,0,13
Hurricane,Juan,10,2003-09-27T21:00:00Z,YARMOUTH NS,15,11,0,0,26
Hurricane,Juan,10,2003-09-27T21:00:00Z,NANTUCKET MA,2,0,0,0,2
Hurricane,Juan,10,2003-09-27T21:00:00Z,HALIFAX NS,3,20,0,0,23
Hurricane,Juan,10,2003-09-27T21:00:00Z,HYANNIS MA,1,1,0,0,2
Hurricane,Juan,10,2003-09-27T21:00:00Z,SABLE ISLAND NS,0,9,0,0,9
Hurricane,Juan,10,2003-09-27T21:00:00Z,PORTLAND ME,2,2,0,0,4
Hurricane,Juan,10,2003-09-27T21:00:00Z,SYDNEY NS,0,9,0,0,9
Hurricane,Juan,10,2003-09-27T21:00:00Z,BAR HARBOR ME,7,9,0,0,16
Hurricane,Juan,10,2003-09-27T21:00:00Z,EDDY POINT NS,0,14,0,0,14
Hurricane,Juan,10,2003-09-27T21:00:00Z,EASTPORT ME,7,15,0,0,22
Hurricane,Juan,10,2003-09-27T21:00:00Z,PTX BASQUES NFLD,0,4,0,0,4
Hurricane,Juan,10,2003-09-27T21:00:00Z,ST JOHN NB,4,19,0,0,23
Hurricane,Juan,10,2003-09-27T21:00:00Z,BURGEO NFLD,0,2,0,0,2
Hurricane,Juan,11,2003-09-28T03:00:00Z,44.3N  64.4W,33,7,0,0,40
Hurricane,Juan,11,2003-09-28T03:00:00Z,MONCTON NB,11,25,0,0,36
Hurricane,Juan,11,2003-09-28T03:00:00Z,50.7N  64.0W,0,20,0,0,20
Hurricane,Juan,11,2003-09-28T03:00:00Z,YARMOUTH NS,34,6,0,0,40
Hurricane,Juan,11,2003-09-28T03:00:00Z,NANTUCKET MA,2,0,0,0,2
Hurricane,Juan,11,2003-09-28T03:00:00Z,HALIFAX NS,26,10,0,0,36
Hurricane,Juan,11,2003-09-28T03:00:00Z,HYANNIS MA,2,0,0,0,2
Hurricane,Juan,11,2003-09-28T03:00:00Z,SABLE ISLAND NS,4,1,0,0,5
Hurricane,Juan,11,2003-09-28T03:00:00Z,PORTLAND ME,3,1,0,0,4
Hurricane,Juan,11,2003-09-28T03:00:00Z,SYDNEY NS,1,7,0,0,8
Hurricane,Juan,11,2003-09-28T03:00:00Z,BAR HARBOR ME,10,9,0,0,19
Hurricane,Juan,11,2003-09-28T03:00:00Z,EDDY POINT NS,6,11,0,0,17
Hurricane,Juan,11,2003-09-28T03:00:00Z,EASTPORT ME,18,14,0,0,32
Hurricane,Juan,11,2003-09-28T03:00:00Z,PTX BASQUES NFLD,0,6,0,0,6
Hurricane,Juan,11,2003-09-28T03:00:00Z,ST JOHN NB,19,18,0,0,37
Hurricane,Juan,11,2003-09-28T03:00:00Z,BURGEO NFLD,0,2,0,0,2
Hurricane,Juan,12,2003-09-28T09:00:00Z,46.0N  63.9W,19,5,0,0,24
Hurricane,Juan,12,2003-09-28T09:00:00Z,YARMOUTH NS,28,1,0,0,29
Hurricane,Juan,12,2003-09-28T09:00:00Z,53.8N  62.9W,0,12,0,0,12
Hurricane,Juan,12,2003-09-28T09:00:00Z,HALIFAX NS,26,2,0,0,28
Hurricane,Juan,12,2003-09-28T09:00:00Z,HYANNIS MA,2,0,0,0,2
Hurricane,Juan,12,2003-09-28T09:00:00Z,SABLE ISLAND NS,10,3,0,0,13
Hurricane,Juan,12,2003-09-28T09:00:00Z,PORTLAND ME,4,0,0,0,4
Hurricane,Juan,12,2003-09-28T09:00:00Z,SYDNEY NS,7,7,0,0,14
Hurricane,Juan,12,2003-09-28T09:00:00Z,BAR HARBOR ME,12,1,0,0,13
Hurricane,Juan,12,2003-09-28T09:00:00Z,EDDY POINT NS,14,5,0,0,19
Hurricane,Juan,12,2003-09-28T09:00:00Z,EASTPORT ME,19,2,0,0,21
Hurricane,Juan,12,2003-09-28T09:00:00Z,PTX BASQUES NFLD,2,9,0,0,11
Hurricane,Juan,12,2003-09-28T09:00:00Z,ST JOHN NB,22,2,0,0,24
Hurricane,Juan,12,2003-09-28T09:00:00Z,BURGEO NFLD,1,6,0,0,7
Hurricane,Juan,12,2003-09-28T09:00:00Z,MONCTON NB,18,5,0,0,23
Hurricane,Juan,12,2003-09-28T09:00:00Z,ILE ST PIERRE,1,2,0,0,3
Hurricane,Juan,13,2003-09-28T15:00:00Z,49.7N  63.2W,19,6,0,0,25
Hurricane,Juan,13,2003-09-28T15:00:00Z,HALIFAX NS,34,0,0,0,34
Hurricane,Juan,13,2003-09-28T15:00:00Z,57.0N  61.0W,0,15,0,0,15
Hurricane,Juan,13,2003-09-28T15:00:00Z,SABLE ISLAND NS,6,0,0,0,6
Hurricane,Juan,13,2003-09-28T15:00:00Z,BAR HARBOR ME,2,0,0,0,2
Hurricane,Juan,13,2003-09-28T15:00:00Z,SYDNEY NS,10,1,0,0,11
Hurricane,Juan,13,2003-09-28T15:00:00Z,EASTPORT ME,10,0,0,0,10
Hurricane,Juan,13,2003-09-28T15:00:00Z,EDDY POINT NS,17,0,0,0,17
Hurricane,Juan,13,2003-09-28T15:00:00Z,ST JOHN NB,21,0,0,0,21
Hurricane,Juan,13,2003-09-28T15:00:00Z,PTX BASQUES NFLD,8,1,0,0,9
Hurricane,Juan,13,2003-09-28T15:00:00Z,MONCTON NB,27,0,0,0,27
Hurricane,Juan,13,2003-09-28T15:00:00Z,BURGEO NFLD,3,1,0,0,4
Hurricane,Juan,13,2003-09-28T15:00:00Z,YARMOUTH NS,21,0,0,0,21
Hurricane,Juan,14,2003-09-28T21:00:00Z,53.0N  62.5W,23,0,0,0,23
Hurricane,Juan,14,2003-09-28T21:00:00Z,SABLE ISLAND NS,4,0,0,0,4
Hurricane,Juan,14,2003-09-28T21:00:00Z,EASTPORT ME,11,0,0,0,11
Hurricane,Juan,14,2003-09-28T21:00:00Z,SYDNEY NS,11,0,0,0,11
Hurricane,Juan,14,2003-09-28T21:00:00Z,ST JOHN NB,28,0,0,0,28
Hurricane,Juan,14,2003-09-28T21:00:00Z,EDDY POINT NS,20,0,0,0,20
Hurricane,Juan,14,2003-09-28T21:00:00Z,MONCTON NB,39,0,0,0,39
Hurricane,Juan,14,2003-09-28T21:00:00Z,PTX BASQUES NFLD,9,0,0,0,9
Hurricane,Juan,14,2003-09-28T21:00:00Z,YARMOUTH NS,23,0,0,0,23
Hurricane,Juan,14,2003-09-28T21:00:00Z,BURGEO NFLD,3,0,0,0,3
Hurricane,Juan,14,2003-09-28T21:00:00Z,HALIFAX NS,45,0,0,0,45
Hurricane,Juan,15,2003-09-29T03:00:00Z,58.0N  60.0W,20,5,0,0,25
Hurricane,Juan,15,2003-09-29T03:00:00Z,HALIFAX NS,99,0,0,0,99
Hurricane,Juan,15,2003-09-29T03:00:00Z,65.0N  55.0W,0,11,0,0,11
Hurricane,Juan,15,2003-09-29T03:00:00Z,SYDNEY NS,4,0,0,0,4
Hurricane,Juan,15,2003-09-29T03:00:00Z,ST JOHN NB,16,0,0,0,16
Hurricane,Juan,15,2003-09-29T03:00:00Z,EDDY POINT NS,11,0,0,0,11
Hurricane,Juan,15,2003-09-29T03:00:00Z,MONCTON NB,50,0,0,0,50
Hurricane,Juan,15,2003-09-29T03:00:00Z,PTX BASQUES NFLD,3,0,0,0,3
Tropical Storm,Juan,16,2003-09-29T09:00:00Z,61.1N  56.3W,25,0,0,0,25
Tropical Storm,Juan,16,2003-09-29T09:00:00Z,HALIFAX NS,12,0,0,0,12
Tropical Storm,Juan,16,2003-09-29T09:00:00Z,MONCTON NB,99,0,0,0,99
Tropical Storm,Juan,16,2003-09-29T09:00:00Z,EDDY POINT NS,2,0,0,0,2
Tropical Depression,Sixteen,1,2003-09-25T21:00:00Z,13.8N  42.5W,51,0,0,0,51
Tropical Depression,Sixteen,1,2003-09-25T21:00:00Z,16.0N  47.0W,0,24,4,1,29
Tropical Depression,Sixteen,1,2003-09-25T21:00:00Z,15.0N  45.0W,11,26,0,0,37
Tropical Depression,Sixteen,2,2003-09-26T03:00:00Z,15.1N  43.0W,55,0,0,0,55
Tropical Depression,Sixteen,2,2003-09-26T03:00:00Z,17.5N  47.0W,0,17,12,1,30
Tropical Depression,Sixteen,2,2003-09-26T03:00:00Z,16.3N  45.0W,9,29,0,0,38
Tropical Depression,Sixteen,3,2003-09-26T09:00:00Z,15.4N  43.8W,48,0,0,0,48
Tropical Depression,Sixteen,3,2003-09-26T09:00:00Z,17.6N  47.4W,0,20,6,1,27
Tropical Depression,Sixteen,3,2003-09-26T09:00:00Z,16.5N  45.7W,13,21,0,0,34
Tropical Depression,Sixteen,4,2003-09-26T15:00:00Z,18.9N  44.2W,55,0,0,0,55
Tropical Depression,Sixteen,4,2003-09-26T15:00:00Z,21.7N  47.6W,0,21,5,1,27
Tropical Depression,Sixteen,4,2003-09-26T15:00:00Z,20.3N  46.0W,18,17,1,0,36
Tropical Depression,Sixteen,5,2003-09-26T21:00:00Z,19.9N  44.5W,56,0,0,0,56
Tropical Depression,Sixteen,5,2003-09-26T21:00:00Z,22.9N  47.5W,1,23,3,1,28
Tropical Depression,Sixteen,5,2003-09-26T21:00:00Z,21.4N  46.1W,23,14,0,0,37
Tropical Depression,Sixteen,6,2003-09-27T03:00:00Z,21.9N  44.6W,41,0,0,0,41
Tropical Depression,Sixteen,6,2003-09-27T03:00:00Z,24.8N  46.1W,3,13,3,1,20
Tropical Depression,Sixteen,6,2003-09-27T03:00:00Z,23.6N  45.5W,16,7,1,1,25
Tropical Depression,Sixteen,7,2003-09-27T09:00:00Z,23.6N  45.0W,41,0,0,0,41
Tropical Depression,Sixteen,7,2003-09-27T09:00:00Z,26.6N  45.0W,7,9,2,2,20
Tropical Depression,Sixteen,7,2003-09-27T09:00:00Z,25.2N  45.5W,21,3,1,1,26
Tropical Depression,Sixteen,8,2003-09-27T15:00:00Z,23.9N  45.3W,37,0,0,0,37
Tropical Depression,Sixteen,8,2003-09-27T15:00:00Z,26.8N  44.5W,8,7,3,2,20
Tropical Depression,Sixteen,8,2003-09-27T15:00:00Z,25.3N  45.3W,23,1,1,1,26
Tropical Storm,Kate,9,2003-09-27T21:00:00Z,25.0N  45.0W,32,1,0,0,33
Tropical Storm,Kate,9,2003-09-27T21:00:00Z,28.0N  43.5W,5,9,3,2,19
Tropical Storm,Kate,9,2003-09-27T21:00:00Z,26.4N  44.6W,20,2,1,1,24
Tropical Storm,Kate,10,2003-09-28T03:00:00Z,25.8N  44.7W,35,0,1,0,36
Tropical Storm,Kate,10,2003-09-28T03:00:00Z,29.0N  42.0W,1,11,4,2,18
Tropical Storm,Kate,10,2003-09-28T03:00:00Z,27.4N  43.6W,17,4,1,1,23
Tropical Storm,Kate,11,2003-09-28T09:00:00Z,26.1N  43.4W,32,0,1,0,33
Tropical Storm,Kate,11,2003-09-28T09:00:00Z,28.5N  40.6W,1,13,3,2,19
Tropical Storm,Kate,11,2003-09-28T09:00:00Z,27.5N  42.1W,12,8,1,1,22
Tropical Storm,Kate,12,2003-09-28T15:00:00Z,26.8N  41.2W,40,0,0,0,40
Tropical Storm,Kate,12,2003-09-28T15:00:00Z,29.0N  38.2W,4,14,2,2,22
Tropical Storm,Kate,12,2003-09-28T15:00:00Z,28.0N  39.6W,19,5,1,0,25
Tropical Storm,Kate,13,2003-09-28T21:00:00Z,27.7N  40.0W,30,1,0,0,31
Tropical Storm,Kate,13,2003-09-28T21:00:00Z,29.9N  37.6W,3,13,3,2,21
Tropical Storm,Kate,13,2003-09-28T21:00:00Z,28.9N  38.4W,13,7,2,1,23
Tropical Storm,Kate,14,2003-09-29T03:00:00Z,29.3N  37.5W,33,0,1,0,34
Tropical Storm,Kate,14,2003-09-29T03:00:00Z,31.0N  36.7W,15,4,2,1,22
Tropical Storm,Kate,14,2003-09-29T03:00:00Z,30.2N  36.7W,22,2,1,0,25
Tropical Storm,Kate,15,2003-09-29T09:00:00Z,30.1N  37.1W,32,0,0,0,32
Tropical Storm,Kate,15,2003-09-29T09:00:00Z,31.3N  37.6W,20,2,1,0,23
Tropical Storm,Kate,15,2003-09-29T09:00:00Z,31.0N  37.1W,22,2,0,1,25
Tropical Storm,Kate,16,2003-09-29T15:00:00Z,30.8N  36.1W,39,0,0,1,40
Tropical Storm,Kate,16,2003-09-29T15:00:00Z,31.6N  36.8W,25,1,0,1,27
Tropical Storm,Kate,16,2003-09-29T15:00:00Z,31.3N  36.3W,31,0,1,0,32
Tropical Storm,Kate,17,2003-09-29T21:00:00Z,30.9N  35.2W,43,0,0,0,43
Tropical Storm,Kate,17,2003-09-29T21:00:00Z,31.8N  36.1W,21,1,1,1,24
Tropical Storm,Kate,17,2003-09-29T21:00:00Z,31.5N  35.5W,28,1,0,0,29
Hurricane,Kate,18,2003-09-30T03:00:00Z,31.5N  34.5W,53,0,0,0,53
Hurricane,Kate,18,2003-09-30T03:00:00Z,32.5N  36.0W,17,2,1,1,21
Hurricane,Kate,18,2003-09-30T03:00:00Z,32.0N  34.7W,37,0,0,0,37
Tropical Storm,Kate,19,2003-09-30T09:00:00Z,32.1N  35.7W,36,0,0,0,36
Tropical Storm,Kate,19,2003-09-30T09:00:00Z,32.4N  38.0W,11,4,2,1,18
Tropical Storm,Kate,19,2003-09-30T09:00:00Z,32.3N  36.6W,21,1,1,1,24
Tropical Storm,Kate,20,2003-09-30T15:00:00Z,32.4N  37.5W,30,0,1,0,31
Tropical Storm,Kate,20,2003-09-30T15:00:00Z,32.4N  41.0W,7,6,2,2,17
Tropical Storm,Kate,20,2003-09-30T15:00:00Z,32.4N  39.0W,19,2,1,0,22
Tropical Storm,Kate,21,2003-09-30T21:00:00Z,32.6N  39.8W,30,1,0,0,31
Tropical Storm,Kate,21,2003-09-30T21:00:00Z,32.4N  43.7W,5,7,2,3,17
Tropical Storm,Kate,21,2003-09-30T21:00:00Z,32.4N  41.5W,18,2,1,1,22
Tropical Storm,Kate,22,2003-10-01T03:00:00Z,32.2N  41.2W,30,0,0,0,30
Tropical Storm,Kate,22,2003-10-01T03:00:00Z,32.0N  45.5W,4,7,3,3,17
Tropical Storm,Kate,22,2003-10-01T03:00:00Z,32.0N  43.2W,16,3,1,1,21
Tropical Storm,Kate,23,2003-10-01T09:00:00Z,31.5N  43.0W,29,0,0,1,30
Tropical Storm,Kate,23,2003-10-01T09:00:00Z,31.0N  47.5W,3,9,2,2,16
Tropical Storm,Kate,23,2003-10-01T09:00:00Z,31.0N  45.5W,13,4,2,1,20
Tropical Storm,Kate,24,2003-10-01T15:00:00Z,31.5N  44.3W,29,0,0,1,30
Tropical Storm,Kate,24,2003-10-01T15:00:00Z,31.0N  49.1W,2,9,2,3,16
Tropical Storm,Kate,24,2003-10-01T15:00:00Z,31.2N  46.8W,13,4,2,1,20
Hurricane,Kate,25,2003-10-01T21:00:00Z,30.6N  45.8W,30,0,1,0,31
Hurricane,Kate,25,2003-10-01T21:00:00Z,30.5N  50.4W,4,7,3,2,16
Hurricane,Kate,25,2003-10-01T21:00:00Z,30.5N  48.0W,17,2,1,1,21
Hurricane,Kate,25,2003-10-01T21:00:00Z,BERMUDA,0,0,0,2,2
Hurricane,Kate,26,2003-10-02T03:00:00Z,30.0N  47.0W,29,0,0,1,30
Hurricane,Kate,26,2003-10-02T03:00:00Z,30.5N  51.5W,2,9,3,2,16
Hurricane,Kate,26,2003-10-02T03:00:00Z,30.2N  49.4W,13,4,2,1,20
Hurricane,Kate,26,2003-10-02T03:00:00Z,BERMUDA,0,0,0,2,2
Hurricane,Kate,27,2003-10-02T09:00:00Z,29.8N  48.0W,29,1,0,0,30
Hurricane,Kate,27,2003-10-02T09:00:00Z,30.5N  52.0W,3,8,3,2,16
Hurricane,Kate,27,2003-10-02T09:00:00Z,30.0N  50.0W,16,2,2,1,21
Hurricane,Kate,27,2003-10-02T09:00:00Z,BERMUDA,0,0,0,3,3
Hurricane,Kate,28,2003-10-02T15:00:00Z,29.8N  48.0W,30,1,0,0,31
Hurricane,Kate,28,2003-10-02T15:00:00Z,30.5N  52.4W,4,8,3,2,17
Hurricane,Kate,28,2003-10-02T15:00:00Z,30.0N  50.3W,16,3,1,1,21
Hurricane,Kate,28,2003-10-02T15:00:00Z,BERMUDA,0,0,0,3,3
Hurricane,Kate,29,2003-10-02T21:00:00Z,29.7N  48.9W,39,0,0,0,39
Hurricane,Kate,29,2003-10-02T21:00:00Z,30.5N  53.4W,0,15,4,2,21
Hurricane,Kate,29,2003-10-02T21:00:00Z,30.0N  51.2W,13,11,1,0,25
Hurricane,Kate,29,2003-10-02T21:00:00Z,BERMUDA,0,0,0,4,4
Hurricane,Kate,30,2003-10-03T03:00:00Z,29.8N  50.2W,44,0,0,0,44
Hurricane,Kate,30,2003-10-03T03:00:00Z,31.0N  54.7W,1,13,7,1,22
Hurricane,Kate,30,2003-10-03T03:00:00Z,30.1N  52.5W,15,12,1,0,28
Hurricane,Kate,30,2003-10-03T03:00:00Z,BERMUDA,0,0,0,4,4
Hurricane,Kate,31,2003-10-03T09:00:00Z,30.0N  52.0W,45,1,0,0,46
Hurricane,Kate,31,2003-10-03T09:00:00Z,32.0N  56.0W,1,18,5,1,25
Hurricane,Kate,31,2003-10-03T09:00:00Z,30.5N  54.5W,14,18,0,0,32
Hurricane,Kate,31,2003-10-03T09:00:00Z,BERMUDA,0,0,0,3,3
Hurricane,Kate,32,2003-10-03T15:00:00Z,30.0N  52.2W,39,0,0,0,39
Hurricane,Kate,32,2003-10-03T15:00:00Z,31.6N  55.4W,3,14,3,1,21
Hurricane,Kate,32,2003-10-03T15:00:00Z,30.6N  54.1W,17,7,1,0,25
Hurricane,Kate,32,2003-10-03T15:00:00Z,BERMUDA,0,0,0,3,3
Hurricane,Kate,33,2003-10-03T21:00:00Z,30.5N  53.6W,45,0,0,0,45
Hurricane,Kate,33,2003-10-03T21:00:00Z,SABLE ISLAND NS,0,0,0,6,6
Hurricane,Kate,33,2003-10-03T21:00:00Z,31.3N  55.4W,21,7,1,0,29
Hurricane,Kate,33,2003-10-03T21:00:00Z,SYDNEY NS,0,0,0,2,2
Hurricane,Kate,33,2003-10-03T21:00:00Z,33.0N  56.0W,6,13,2,2,23
Hurricane,Kate,33,2003-10-03T21:00:00Z,EDDY POINT NS,0,0,0,2,2
Hurricane,Kate,33,2003-10-03T21:00:00Z,HALIFAX NS,0,0,0,2,2
Hurricane,Kate,34,2003-10-04T03:00:00Z,30.7N  54.4W,39,0,0,0,39
Hurricane,Kate,34,2003-10-04T03:00:00Z,SABLE ISLAND NS,0,0,0,11,11
Hurricane,Kate,34,2003-10-04T03:00:00Z,31.8N  55.8W,20,4,1,0,25
Hurricane,Kate,34,2003-10-04T03:00:00Z,SYDNEY NS,0,0,0,6,6
Hurricane,Kate,34,2003-10-04T03:00:00Z,34.0N  56.5W,2,11,6,1,20
Hurricane,Kate,34,2003-10-04T03:00:00Z,EDDY POINT NS,0,0,0,6,6
Hurricane,Kate,34,2003-10-04T03:00:00Z,BERMUDA,0,0,1,1,2
Hurricane,Kate,34,2003-10-04T03:00:00Z,PTX BASQUES NFLD,0,0,0,3,3
Hurricane,Kate,34,2003-10-04T03:00:00Z,MONCTON NB,0,0,0,2,2
Hurricane,Kate,34,2003-10-04T03:00:00Z,BURGEO NFLD,0,0,0,4,4
Hurricane,Kate,34,2003-10-04T03:00:00Z,YARMOUTH NS,0,0,0,2,2
Hurricane,Kate,34,2003-10-04T03:00:00Z,ILE ST PIERRE,0,0,0,6,6
Hurricane,Kate,34,2003-10-04T03:00:00Z,HALIFAX NS,0,0,0,4,4
Hurricane,Kate,34,2003-10-04T03:00:00Z,CAPE RACE NFLD,0,0,0,5,5
Hurricane,Kate,35,2003-10-04T09:00:00Z,32.0N  56.0W,44,0,0,0,44
Hurricane,Kate,35,2003-10-04T09:00:00Z,SYDNEY NS,0,0,0,12,12
Hurricane,Kate,35,2003-10-04T09:00:00Z,33.5N  57.0W,22,5,1,0,28
Hurricane,Kate,35,2003-10-04T09:00:00Z,EDDY POINT NS,0,0,0,11,11
Hurricane,Kate,35,2003-10-04T09:00:00Z,36.0N  57.5W,1,12,8,2,23
Hurricane,Kate,35,2003-10-04T09:00:00Z,PTX BASQUES NFLD,0,0,0,10,10
Hurricane,Kate,35,2003-10-04T09:00:00Z,ST JOHN NB,0,0,0,3,3
Hurricane,Kate,35,2003-10-04T09:00:00Z,BURGEO NFLD,0,0,0,12,12
Hurricane,Kate,35,2003-10-04T09:00:00Z,MONCTON NB,0,0,0,4,4
Hurricane,Kate,35,2003-10-04T09:00:00Z,ILE ST PIERRE,0,0,0,14,14
Hurricane,Kate,35,2003-10-04T09:00:00Z,YARMOUTH NS,0,0,0,3,3
Hurricane,Kate,35,2003-10-04T09:00:00Z,CAPE RACE NFLD,0,0,0,13,13
Hurricane,Kate,35,2003-10-04T09:00:00Z,HALIFAX NS,0,0,0,7,7
Hurricane,Kate,35,2003-10-04T09:00:00Z,HIBERNIA OILFLD,0,0,0,4,4
Hurricane,Kate,35,2003-10-04T09:00:00Z,SABLE ISLAND NS,0,0,0,15,15
Hurricane,Kate,36,2003-10-04T15:00:00Z,31.7N  56.6W,41,0,0,0,41
Hurricane,Kate,36,2003-10-04T15:00:00Z,EDDY POINT NS,0,0,0,8,8
Hurricane,Kate,36,2003-10-04T15:00:00Z,33.5N  57.3W,18,6,1,0,25
Hurricane,Kate,36,2003-10-04T15:00:00Z,PTX BASQUES NFLD,0,0,0,9,9
Hurricane,Kate,36,2003-10-04T15:00:00Z,37.0N  57.2W,0,5,15,3,23
Hurricane,Kate,36,2003-10-04T15:00:00Z,BURGEO NFLD,0,0,0,12,12
Hurricane,Kate,36,2003-10-04T15:00:00Z,MONCTON NB,0,0,0,2,2
Hurricane,Kate,36,2003-10-04T15:00:00Z,ILE ST PIERRE,0,0,0,15,15
Hurricane,Kate,36,2003-10-04T15:00:00Z,HALIFAX NS,0,0,0,4,4
Hurricane,Kate,36,2003-10-04T15:00:00Z,CAPE RACE NFLD,0,0,0,17,17
Hurricane,Kate,36,2003-10-04T15:00:00Z,SABLE ISLAND NS,0,0,0,13,13
Hurricane,Kate,36,2003-10-04T15:00:00Z,HIBERNIA OILFLD,0,0,0,11,11
Hurricane,Kate,36,2003-10-04T15:00:00Z,SYDNEY NS,0,0,0,9,9
Hurricane,Kate,37,2003-10-04T21:00:00Z,32.8N  57.2W,36,0,0,0,36
Hurricane,Kate,37,2003-10-04T21:00:00Z,EDDY POINT NS,0,0,0,6,6
Hurricane,Kate,37,2003-10-04T21:00:00Z,35.7N  57.4W,2,24,3,0,29
Hurricane,Kate,37,2003-10-04T21:00:00Z,PTX BASQUES NFLD,0,0,0,9,9
Hurricane,Kate,37,2003-10-04T21:00:00Z,40.0N  56.0W,0,1,19,5,25
Hurricane,Kate,37,2003-10-04T21:00:00Z,BURGEO NFLD,0,0,0,13,13
Hurricane,Kate,37,2003-10-04T21:00:00Z,HALIFAX NS,0,0,0,3,3
Hurricane,Kate,37,2003-10-04T21:00:00Z,ILE ST PIERRE,0,0,0,17,17
Hurricane,Kate,37,2003-10-04T21:00:00Z,SABLE ISLAND NS,0,0,2,11,13
Hurricane,Kate,37,2003-10-04T21:00:00Z,CAPE RACE NFLD,0,0,0,21,21
Hurricane,Kate,37,2003-10-04T21:00:00Z,SYDNEY NS,0,0,0,9,9
Hurricane,Kate,37,2003-10-04T21:00:00Z,HIBERNIA OILFLD,0,0,0,18,18
Hurricane,Kate,38,2003-10-05T03:00:00Z,33.6N  57.2W,35,2,0,0,37
Hurricane,Kate,38,2003-10-05T03:00:00Z,PTX BASQUES NFLD,0,0,0,6,6
Hurricane,Kate,38,2003-10-05T03:00:00Z,37.1N  56.7W,0,24,6,0,30
Hurricane,Kate,38,2003-10-05T03:00:00Z,BURGEO NFLD,0,0,0,10,10
Hurricane,Kate,38,2003-10-05T03:00:00Z,42.0N  54.0W,0,0,17,7,24
Hurricane,Kate,38,2003-10-05T03:00:00Z,ILE ST PIERRE,0,0,1,14,15
Hurricane,Kate,38,2003-10-05T03:00:00Z,SABLE ISLAND NS,0,0,4,4,8
Hurricane,Kate,38,2003-10-05T03:00:00Z,CAPE RACE NFLD,0,0,1,19,20
Hurricane,Kate,38,2003-10-05T03:00:00Z,SYDNEY NS,0,0,1,4,5
Hurricane,Kate,38,2003-10-05T03:00:00Z,HIBERNIA OILFLD,0,0,0,19,19
Hurricane,Kate,38,2003-10-05T03:00:00Z,EDDY POINT NS,0,0,1,2,3
Hurricane,Kate,39,2003-10-05T09:00:00Z,34.0N  57.0W,28,3,0,0,31
Hurricane,Kate,39,2003-10-05T09:00:00Z,PTX BASQUES NFLD,0,0,1,4,5
Hurricane,Kate,39,2003-10-05T09:00:00Z,37.0N  56.0W,0,20,5,1,26
Hurricane,Kate,39,2003-10-05T09:00:00Z,BURGEO NFLD,0,0,1,7,8
Hurricane,Kate,39,2003-10-05T09:00:00Z,42.0N  53.5W,0,0,16,6,22
Hurricane,Kate,39,2003-10-05T09:00:00Z,ILE ST PIERRE,0,0,2,10,12
Hurricane,Kate,39,2003-10-05T09:00:00Z,SABLE ISLAND NS,0,0,5,3,8
Hurricane,Kate,39,2003-10-05T09:00:00Z,CAPE RACE NFLD,0,0,2,15,17
Hurricane,Kate,39,2003-10-05T09:00:00Z,SYDNEY NS,0,0,1,4,5
Hurricane,Kate,39,2003-10-05T09:00:00Z,HIBERNIA OILFLD,0,0,0,18,18
Hurricane,Kate,39,2003-10-05T09:00:00Z,EDDY POINT NS,0,0,1,2,3
Hurricane,Kate,40,2003-10-05T15:00:00Z,35.4N  56.4W,42,4,0,0,46
Hurricane,Kate,40,2003-10-05T15:00:00Z,BURGEO NFLD,0,0,3,1,4
Hurricane,Kate,40,2003-10-05T15:00:00Z,39.5N  54.5W,0,28,6,0,34
Hurricane,Kate,40,2003-10-05T15:00:00Z,ILE ST PIERRE,0,0,7,1,8
Hurricane,Kate,40,2003-10-05T15:00:00Z,45.0N  50.0W,0,0,15,7,22
Hurricane,Kate,40,2003-10-05T15:00:00Z,CAPE RACE NFLD,0,0,13,5,18
Hurricane,Kate,40,2003-10-05T15:00:00Z,SABLE ISLAND NS,0,1,1,0,2
Hurricane,Kate,40,2003-10-05T15:00:00Z,HIBERNIA OILFLD,0,0,3,16,19
Hurricane,Kate,41,2003-10-05T21:00:00Z,37.0N  56.0W,29,3,1,0,33
Hurricane,Kate,41,2003-10-05T21:00:00Z,BURGEO NFLD,0,1,2,0,3
Hurricane,Kate,41,2003-10-05T21:00:00Z,41.0N  53.0W,0,19,5,0,24
Hurricane,Kate,41,2003-10-05T21:00:00Z,ILE ST PIERRE,0,3,4,0,7
Hurricane,Kate,41,2003-10-05T21:00:00Z,47.5N  47.5W,0,0,13,3,16
Hurricane,Kate,41,2003-10-05T21:00:00Z,CAPE RACE NFLD,0,3,12,0,15
Hurricane,Kate,41,2003-10-05T21:00:00Z,SABLE ISLAND NS,0,2,0,0,2
Hurricane,Kate,41,2003-10-05T21:00:00Z,HIBERNIA OILFLD,0,0,14,2,16
Hurricane,Kate,42,2003-10-06T03:00:00Z,39.1N  54.5W,33,2,0,0,35
Hurricane,Kate,42,2003-10-06T03:00:00Z,PTX BASQUES NFLD,0,2,1,0,3
Hurricane,Kate,42,2003-10-06T03:00:00Z,44.3N  50.8W,0,14,3,0,17
Hurricane,Kate,42,2003-10-06T03:00:00Z,BURGEO NFLD,0,3,2,0,5
Hurricane,Kate,42,2003-10-06T03:00:00Z,50.0N  44.4W,0,0,8,3,11
Hurricane,Kate,42,2003-10-06T03:00:00Z,ILE ST PIERRE,0,6,4,0,10
Hurricane,Kate,42,2003-10-06T03:00:00Z,SABLE ISLAND NS,0,2,1,0,3
Hurricane,Kate,42,2003-10-06T03:00:00Z,CAPE RACE NFLD,0,9,5,1,15
Hurricane,Kate,42,2003-10-06T03:00:00Z,SYDNEY NS,0,2,0,0,2
Hurricane,Kate,42,2003-10-06T03:00:00Z,HIBERNIA OILFLD,0,3,10,1,14
Hurricane,Kate,43,2003-10-06T09:00:00Z,42.3N  52.4W,21,5,0,0,26
Hurricane,Kate,43,2003-10-06T09:00:00Z,ILE ST PIERRE,1,1,0,0,2
Hurricane,Kate,43,2003-10-06T09:00:00Z,49.0N  47.0W,0,14,4,0,18
Hurricane,Kate,43,2003-10-06T09:00:00Z,CAPE RACE NFLD,2,8,1,0,11
Hurricane,Kate,43,2003-10-06T09:00:00Z,56.0N  40.0W,0,0,10,2,12
Hurricane,Kate,43,2003-10-06T09:00:00Z,HIBERNIA OILFLD,0,17,2,0,19
Hurricane,Kate,44,2003-10-06T15:00:00Z,45.6N  49.6W,26,5,0,0,31
Hurricane,Kate,44,2003-10-06T15:00:00Z,ILE ST PIERRE,1,1,0,0,2
Hurricane,Kate,44,2003-10-06T15:00:00Z,52.2N  43.5W,0,13,2,1,16
Hurricane,Kate,44,2003-10-06T15:00:00Z,CAPE RACE NFLD,9,2,0,0,11
Hurricane,Kate,44,2003-10-06T15:00:00Z,57.1N  36.1W,0,0,8,3,11
Hurricane,Kate,44,2003-10-06T15:00:00Z,HIBERNIA OILFLD,14,13,0,0,27
Hurricane,Kate,45,2003-10-06T21:00:00Z,48.5N  47.4W,26,5,0,0,31
Hurricane,Kate,45,2003-10-06T21:00:00Z,CAPE RACE NFLD,12,0,0,0,12
Hurricane,Kate,45,2003-10-06T21:00:00Z,55.7N  40.7W,0,12,2,1,15
Hurricane,Kate,45,2003-10-06T21:00:00Z,HIBERNIA OILFLD,31,2,0,0,33
Hurricane,Kate,45,2003-10-06T21:00:00Z,58.9N  33.1W,0,1,7,3,11
Hurricane,Kate,46,2003-10-07T03:00:00Z,50.9N  44.4W,31,4,0,1,36
Hurricane,Kate,46,2003-10-07T03:00:00Z,CAPE RACE NFLD,4,0,0,0,4
Hurricane,Kate,46,2003-10-07T03:00:00Z,56.1N  37.4W,0,16,1,0,17
Hurricane,Kate,46,2003-10-07T03:00:00Z,HIBERNIA OILFLD,33,0,0,0,33
Hurricane,Kate,46,2003-10-07T03:00:00Z,58.7N  30.6W,0,3,7,2,12
Tropical Storm,Kate,47,2003-10-07T09:00:00Z,53.0N  40.0W,29,3,0,0,32
Tropical Storm,Kate,47,2003-10-07T09:00:00Z,59.0N  25.0W,0,2,7,2,11
Tropical Storm,Kate,47,2003-10-07T09:00:00Z,57.0N  34.0W,1,14,1,0,16
Tropical Storm,Kate,47,2003-10-07T09:00:00Z,HIBERNIA OILFLD,26,0,0,0,26
Tropical Storm,Kate,48,2003-10-07T15:00:00Z,57.5N  37.0W,31,1,0,0,32
Tropical Storm,Kate,48,2003-10-07T15:00:00Z,61.0N  21.0W,0,1,7,3,11
Tropical Storm,Kate,48,2003-10-07T15:00:00Z,60.0N  31.0W,5,11,1,0,17
Tropical Storm,Kate,48,2003-10-07T15:00:00Z,HIBERNIA OILFLD,23,0,0,0,23
Tropical Storm,Kate,49,2003-10-07T21:00:00Z,59.5N  35.5W,31,1,0,0,32
Tropical Storm,Kate,49,2003-10-07T21:00:00Z,61.0N  18.0W,0,2,6,3,11
Tropical Storm,Kate,49,2003-10-07T21:00:00Z,61.0N  27.5W,3,12,1,0,16
Tropical Storm,Kate,49,2003-10-07T21:00:00Z,HIBERNIA OILFLD,99,0,0,0,99
Tropical Storm,Larry,1,2003-10-02T00:00:00Z,21.0N  93.5W,99,0,0,0,99
Tropical Storm,Larry,1,2003-10-02T00:00:00Z,PORT ARTHUR TX,0,0,0,2,2
Tropical Storm,Larry,1,2003-10-02T00:00:00Z,21.0N  93.5W,99,0,0,0,99
Tropical Storm,Larry,1,2003-10-02T00:00:00Z,GALVESTON TX,0,0,0,3,3
Tropical Storm,Larry,1,2003-10-02T00:00:00Z,21.0N  93.5W,99,0,0,0,99
Tropical Storm,Larry,1,2003-10-02T00:00:00Z,FREEPORT TX,0,0,0,3,3
Tropical Storm,Larry,1,2003-10-02T00:00:00Z,MMCZ 205N 869W,0,0,0,3,3
Tropical Storm,Larry,1,2003-10-02T00:00:00Z,PORT O CONNOR TX,0,0,0,4,4
Tropical Storm,Larry,1,2003-10-02T00:00:00Z,MZBZ 175N 883W,0,0,0,3,3
Tropical Storm,Larry,1,2003-10-02T00:00:00Z,CORPUSCHRISTI TX,0,0,0,4,4
Tropical Storm,Larry,1,2003-10-02T00:00:00Z,MGPB 157N 886W,0,0,0,2,2
Tropical Storm,Larry,1,2003-10-02T00:00:00Z,BROWNSVILLE TX,0,0,2,6,8
Tropical Storm,Larry,1,2003-10-02T00:00:00Z,MMSO 238N 982W,0,0,3,7,10
Tropical Storm,Larry,1,2003-10-02T00:00:00Z,GULF 28N 89W,0,0,0,2,2
Tropical Storm,Larry,1,2003-10-02T00:00:00Z,MMTM 222N 979W,0,2,4,6,12
Tropical Storm,Larry,1,2003-10-02T00:00:00Z,GULF 28N 91W,0,0,0,4,4
Tropical Storm,Larry,1,2003-10-02T00:00:00Z,MMTX 210N 974W,1,4,4,5,14
Tropical Storm,Larry,1,2003-10-02T00:00:00Z,GULF 28N 93W,0,0,1,4,5
Tropical Storm,Larry,1,2003-10-02T00:00:00Z,MMVR 192N 961W,6,4,4,3,17
Tropical Storm,Larry,1,2003-10-02T00:00:00Z,GULF 28N 95W,0,0,1,4,5
Tropical Storm,Larry,1,2003-10-02T00:00:00Z,MMFR 185N 926W,9,4,2,3,18
Tropical Storm,Larry,1,2003-10-02T00:00:00Z,GULF 27N 96W,0,0,2,5,7
Tropical Storm,Larry,1,2003-10-02T00:00:00Z,MMMD 210N 897W,1,2,2,5,10
Tropical Storm,Larry,1,2003-10-02T00:00:00Z,GULF 25N 96W,0,3,5,5,13
Tropical Storm,Larry,2,2003-10-02T03:00:00Z,21.0N  93.5W,99,0,0,0,99
Tropical Storm,Larry,2,2003-10-02T03:00:00Z,PORT ARTHUR TX,0,0,0,2,2
Tropical Storm,Larry,2,2003-10-02T03:00:00Z,21.0N  93.5W,99,0,0,0,99
Tropical Storm,Larry,2,2003-10-02T03:00:00Z,GALVESTON TX,0,0,0,3,3
Tropical Storm,Larry,2,2003-10-02T03:00:00Z,21.0N  93.5W,99,0,0,0,99
Tropical Storm,Larry,2,2003-10-02T03:00:00Z,FREEPORT TX,0,0,0,3,3
Tropical Storm,Larry,2,2003-10-02T03:00:00Z,MMCZ 205N 869W,0,0,0,3,3
Tropical Storm,Larry,2,2003-10-02T03:00:00Z,PORT O CONNOR TX,0,0,0,4,4
Tropical Storm,Larry,2,2003-10-02T03:00:00Z,MZBZ 175N 883W,0,0,0,3,3
Tropical Storm,Larry,2,2003-10-02T03:00:00Z,CORPUSCHRISTI TX,0,0,0,4,4
Tropical Storm,Larry,2,2003-10-02T03:00:00Z,MGPB 157N 886W,0,0,0,2,2
Tropical Storm,Larry,2,2003-10-02T03:00:00Z,BROWNSVILLE TX,0,0,2,6,8
Tropical Storm,Larry,2,2003-10-02T03:00:00Z,MMSO 238N 982W,0,0,3,6,9
Tropical Storm,Larry,2,2003-10-02T03:00:00Z,GULF 28N 89W,0,0,0,2,2
Tropical Storm,Larry,2,2003-10-02T03:00:00Z,MMTM 222N 979W,0,2,3,7,12
Tropical Storm,Larry,2,2003-10-02T03:00:00Z,GULF 28N 91W,0,0,0,4,4
Tropical Storm,Larry,2,2003-10-02T03:00:00Z,MMTX 210N 974W,1,3,5,5,14
Tropical Storm,Larry,2,2003-10-02T03:00:00Z,GULF 28N 93W,0,0,1,4,5
Tropical Storm,Larry,2,2003-10-02T03:00:00Z,MMVR 192N 961W,6,4,4,3,17
Tropical Storm,Larry,2,2003-10-02T03:00:00Z,GULF 28N 95W,0,0,1,4,5
Tropical Storm,Larry,2,2003-10-02T03:00:00Z,MMFR 185N 926W,9,4,3,2,18
Tropical Storm,Larry,2,2003-10-02T03:00:00Z,GULF 27N 96W,0,0,2,5,7
Tropical Storm,Larry,2,2003-10-02T03:00:00Z,MMMD 210N 897W,1,2,3,5,11
Tropical Storm,Larry,2,2003-10-02T03:00:00Z,GULF 25N 96W,0,2,5,6,13
Tropical Storm,Larry,3,2003-10-02T09:00:00Z,21.0N  93.5W,99,0,0,0,99
Tropical Storm,Larry,3,2003-10-02T09:00:00Z,PORT ARTHUR TX,0,0,0,2,2
Tropical Storm,Larry,3,2003-10-02T09:00:00Z,21.0N  93.5W,99,0,0,0,99
Tropical Storm,Larry,3,2003-10-02T09:00:00Z,GALVESTON TX,0,0,0,3,3
Tropical Storm,Larry,3,2003-10-02T09:00:00Z,21.0N  93.5W,99,0,0,0,99
Tropical Storm,Larry,3,2003-10-02T09:00:00Z,FREEPORT TX,0,0,0,3,3
Tropical Storm,Larry,3,2003-10-02T09:00:00Z,MMCZ 205N 869W,0,0,0,2,2
Tropical Storm,Larry,3,2003-10-02T09:00:00Z,PORT O CONNOR TX,0,0,0,4,4
Tropical Storm,Larry,3,2003-10-02T09:00:00Z,MZBZ 175N 883W,0,0,0,3,3
Tropical Storm,Larry,3,2003-10-02T09:00:00Z,CORPUSCHRISTI TX,0,0,0,4,4
Tropical Storm,Larry,3,2003-10-02T09:00:00Z,MGPB 157N 886W,0,0,0,2,2
Tropical Storm,Larry,3,2003-10-02T09:00:00Z,BROWNSVILLE TX,0,0,2,6,8
Tropical Storm,Larry,3,2003-10-02T09:00:00Z,MMSO 238N 982W,0,0,3,7,10
Tropical Storm,Larry,3,2003-10-02T09:00:00Z,GULF 28N 89W,0,0,0,2,2
Tropical Storm,Larry,3,2003-10-02T09:00:00Z,MMTM 222N 979W,0,2,3,7,12
Tropical Storm,Larry,3,2003-10-02T09:00:00Z,GULF 28N 91W,0,0,1,3,4
Tropical Storm,Larry,3,2003-10-02T09:00:00Z,MMTX 210N 974W,1,3,5,5,14
Tropical Storm,Larry,3,2003-10-02T09:00:00Z,GULF 28N 93W,0,0,1,5,6
Tropical Storm,Larry,3,2003-10-02T09:00:00Z,MMVR 192N 961W,6,4,4,3,17
Tropical Storm,Larry,3,2003-10-02T09:00:00Z,GULF 28N 95W,0,0,1,5,6
Tropical Storm,Larry,3,2003-10-02T09:00:00Z,MMFR 185N 926W,9,4,3,2,18
Tropical Storm,Larry,3,2003-10-02T09:00:00Z,GULF 27N 96W,0,0,2,6,8
Tropical Storm,Larry,3,2003-10-02T09:00:00Z,MMMD 210N 897W,1,2,3,4,10
Tropical Storm,Larry,3,2003-10-02T09:00:00Z,GULF 25N 96W,0,2,5,6,13
Tropical Storm,Larry,4,2003-10-02T15:00:00Z,21.0N  93.5W,99,0,0,0,99
Tropical Storm,Larry,4,2003-10-02T15:00:00Z,PORT ARTHUR TX,0,0,0,2,2
Tropical Storm,Larry,4,2003-10-02T15:00:00Z,21.0N  93.5W,99,0,0,0,99
Tropical Storm,Larry,4,2003-10-02T15:00:00Z,GALVESTON TX,0,0,0,3,3
Tropical Storm,Larry,4,2003-10-02T15:00:00Z,21.0N  93.5W,99,0,0,0,99
Tropical Storm,Larry,4,2003-10-02T15:00:00Z,FREEPORT TX,0,0,0,3,3
Tropical Storm,Larry,4,2003-10-02T15:00:00Z,MMCZ 205N 869W,0,0,0,2,2
Tropical Storm,Larry,4,2003-10-02T15:00:00Z,PORT O CONNOR TX,0,0,0,4,4
Tropical Storm,Larry,4,2003-10-02T15:00:00Z,MZBZ 175N 883W,0,0,0,3,3
Tropical Storm,Larry,4,2003-10-02T15:00:00Z,CORPUSCHRISTI TX,0,0,0,4,4
Tropical Storm,Larry,4,2003-10-02T15:00:00Z,MGPB 157N 886W,0,0,0,2,2
Tropical Storm,Larry,4,2003-10-02T15:00:00Z,BROWNSVILLE TX,0,0,2,6,8
Tropical Storm,Larry,4,2003-10-02T15:00:00Z,MMSO 238N 982W,0,0,3,7,10
Tropical Storm,Larry,4,2003-10-02T15:00:00Z,GULF 28N 89W,0,0,0,2,2
Tropical Storm,Larry,4,2003-10-02T15:00:00Z,MMTM 222N 979W,0,2,3,7,12
Tropical Storm,Larry,4,2003-10-02T15:00:00Z,GULF 28N 91W,0,0,1,3,4
Tropical Storm,Larry,4,2003-10-02T15:00:00Z,MMTX 210N 974W,1,3,5,5,14
Tropical Storm,Larry,4,2003-10-02T15:00:00Z,GULF 28N 93W,0,0,1,5,6
Tropical Storm,Larry,4,2003-10-02T15:00:00Z,MMVR 192N 961W,6,4,4,3,17
Tropical Storm,Larry,4,2003-10-02T15:00:00Z,GULF 28N 95W,0,0,1,5,6
Tropical Storm,Larry,4,2003-10-02T15:00:00Z,MMFR 185N 926W,9,4,3,2,18
Tropical Storm,Larry,4,2003-10-02T15:00:00Z,GULF 27N 96W,0,0,2,6,8
Tropical Storm,Larry,4,2003-10-02T15:00:00Z,MMMD 210N 897W,1,2,3,4,10
Tropical Storm,Larry,4,2003-10-02T15:00:00Z,GULF 25N 96W,0,2,5,6,13
Tropical Storm,Larry,5,2003-10-02T21:00:00Z,19.8N  93.7W,99,0,0,0,99
Tropical Storm,Larry,5,2003-10-02T21:00:00Z,MMTX 210N 974W,1,5,5,5,16
Tropical Storm,Larry,5,2003-10-02T21:00:00Z,19.5N  93.8W,99,0,0,0,99
Tropical Storm,Larry,5,2003-10-02T21:00:00Z,MMVR 192N 961W,8,7,4,2,21
Tropical Storm,Larry,5,2003-10-02T21:00:00Z,19.2N  93.9W,35,0,0,1,36
Tropical Storm,Larry,5,2003-10-02T21:00:00Z,MMFR 185N 926W,13,3,1,3,20
Tropical Storm,Larry,5,2003-10-02T21:00:00Z,MZBZ 175N 883W,0,0,0,3,3
Tropical Storm,Larry,5,2003-10-02T21:00:00Z,MMMD 210N 897W,0,0,1,6,7
Tropical Storm,Larry,5,2003-10-02T21:00:00Z,MGPB 157N 886W,0,0,0,2,2
Tropical Storm,Larry,5,2003-10-02T21:00:00Z,BROWNSVILLE TX,0,0,0,4,4
Tropical Storm,Larry,5,2003-10-02T21:00:00Z,MMSO 238N 982W,0,0,2,6,8
Tropical Storm,Larry,5,2003-10-02T21:00:00Z,GULF 27N 96W,0,0,0,3,3
Tropical Storm,Larry,5,2003-10-02T21:00:00Z,MMTM 222N 979W,0,2,4,6,12
Tropical Storm,Larry,5,2003-10-02T21:00:00Z,GULF 25N 96W,0,1,2,5,8
Tropical Storm,Larry,6,2003-10-03T03:00:00Z,19.9N  94.4W,99,0,0,0,99
Tropical Storm,Larry,6,2003-10-03T03:00:00Z,MMVR 192N 961W,14,6,2,2,24
Tropical Storm,Larry,6,2003-10-03T03:00:00Z,19.6N  94.6W,99,0,0,0,99
Tropical Storm,Larry,6,2003-10-03T03:00:00Z,MMFR 185N 926W,4,4,4,4,16
Tropical Storm,Larry,6,2003-10-03T03:00:00Z,19.2N  94.9W,30,1,0,1,32
Tropical Storm,Larry,6,2003-10-03T03:00:00Z,MMMD 210N 897W,0,0,1,5,6
Tropical Storm,Larry,6,2003-10-03T03:00:00Z,MZBZ 175N 883W,0,0,0,2,2
Tropical Storm,Larry,6,2003-10-03T03:00:00Z,BROWNSVILLE TX,0,0,0,4,4
Tropical Storm,Larry,6,2003-10-03T03:00:00Z,MMSO 238N 982W,0,0,3,6,9
Tropical Storm,Larry,6,2003-10-03T03:00:00Z,GULF 27N 96W,0,0,0,2,2
Tropical Storm,Larry,6,2003-10-03T03:00:00Z,MMTM 222N 979W,0,4,5,5,14
Tropical Storm,Larry,6,2003-10-03T03:00:00Z,GULF 25N 96W,0,1,2,5,8
Tropical Storm,Larry,6,2003-10-03T03:00:00Z,MMTX 210N 974W,3,7,5,4,19
Tropical Storm,Larry,7,2003-10-03T09:00:00Z,20.0N  94.0W,99,0,0,0,99
Tropical Storm,Larry,7,2003-10-03T09:00:00Z,MMTX 210N 974W,4,5,4,4,17
Tropical Storm,Larry,7,2003-10-03T09:00:00Z,19.5N  94.0W,99,0,0,0,99
Tropical Storm,Larry,7,2003-10-03T09:00:00Z,MMVR 192N 961W,19,3,1,2,25
Tropical Storm,Larry,7,2003-10-03T09:00:00Z,19.5N  94.0W,99,0,0,0,99
Tropical Storm,Larry,7,2003-10-03T09:00:00Z,MMFR 185N 926W,13,4,2,2,21
Tropical Storm,Larry,7,2003-10-03T09:00:00Z,MMCZ 205N 869W,0,0,0,3,3
Tropical Storm,Larry,7,2003-10-03T09:00:00Z,MMMD 210N 897W,0,1,4,4,9
Tropical Storm,Larry,7,2003-10-03T09:00:00Z,MZBZ 175N 883W,0,0,0,4,4
Tropical Storm,Larry,7,2003-10-03T09:00:00Z,BROWNSVILLE TX,0,0,0,4,4
Tropical Storm,Larry,7,2003-10-03T09:00:00Z,MGPB 157N 886W,0,0,0,3,3
Tropical Storm,Larry,7,2003-10-03T09:00:00Z,GULF 27N 96W,0,0,0,3,3
Tropical Storm,Larry,7,2003-10-03T09:00:00Z,MMSO 238N 982W,0,0,2,6,8
Tropical Storm,Larry,7,2003-10-03T09:00:00Z,GULF 25N 96W,0,0,2,6,8
Tropical Storm,Larry,7,2003-10-03T09:00:00Z,MMTM 222N 979W,0,3,4,6,13
Tropical Storm,Larry,8,2003-10-03T15:00:00Z,19.5N  94.7W,99,0,0,0,99
Tropical Storm,Larry,8,2003-10-03T15:00:00Z,MMTX 210N 974W,11,4,3,2,20
Tropical Storm,Larry,8,2003-10-03T15:00:00Z,19.3N  94.7W,99,0,0,0,99
Tropical Storm,Larry,8,2003-10-03T15:00:00Z,MMVR 192N 961W,28,1,1,0,30
Tropical Storm,Larry,8,2003-10-03T15:00:00Z,19.0N  94.7W,99,0,0,0,99
Tropical Storm,Larry,8,2003-10-03T15:00:00Z,MMFR 185N 926W,7,3,3,4,17
Tropical Storm,Larry,8,2003-10-03T15:00:00Z,MZBZ 175N 883W,0,0,0,2,2
Tropical Storm,Larry,8,2003-10-03T15:00:00Z,MMMD 210N 897W,0,0,0,5,5
Tropical Storm,Larry,8,2003-10-03T15:00:00Z,MGPB 157N 886W,0,0,0,2,2
Tropical Storm,Larry,8,2003-10-03T15:00:00Z,BROWNSVILLE TX,0,0,1,3,4
Tropical Storm,Larry,8,2003-10-03T15:00:00Z,MMSO 238N 982W,0,1,3,5,9
Tropical Storm,Larry,8,2003-10-03T15:00:00Z,GULF 27N 96W,0,0,0,2,2
Tropical Storm,Larry,8,2003-10-03T15:00:00Z,MMTM 222N 979W,2,5,4,4,15
Tropical Storm,Larry,8,2003-10-03T15:00:00Z,GULF 25N 96W,0,1,2,5,8
Tropical Storm,Larry,9,2003-10-03T21:00:00Z,19.4N  94.7W,99,0,0,0,99
Tropical Storm,Larry,9,2003-10-03T21:00:00Z,MMTX 210N 974W,10,5,2,3,20
Tropical Storm,Larry,9,2003-10-03T21:00:00Z,19.2N  94.7W,99,0,0,0,99
Tropical Storm,Larry,9,2003-10-03T21:00:00Z,MMVR 192N 961W,29,1,0,1,31
Tropical Storm,Larry,9,2003-10-03T21:00:00Z,18.9N  94.7W,99,0,0,0,99
Tropical Storm,Larry,9,2003-10-03T21:00:00Z,MMFR 185N 926W,6,4,3,4,17
Tropical Storm,Larry,9,2003-10-03T21:00:00Z,MZBZ 175N 883W,0,0,0,2,2
Tropical Storm,Larry,9,2003-10-03T21:00:00Z,MMMD 210N 897W,0,0,0,5,5
Tropical Storm,Larry,9,2003-10-03T21:00:00Z,MGPB 157N 886W,0,0,0,2,2
Tropical Storm,Larry,9,2003-10-03T21:00:00Z,BROWNSVILLE TX,0,0,1,3,4
Tropical Storm,Larry,9,2003-10-03T21:00:00Z,MMSO 238N 982W,0,1,3,5,9
Tropical Storm,Larry,9,2003-10-03T21:00:00Z,GULF 27N 96W,0,0,0,2,2
Tropical Storm,Larry,9,2003-10-03T21:00:00Z,MMTM 222N 979W,2,4,4,5,15
Tropical Storm,Larry,9,2003-10-03T21:00:00Z,GULF 25N 96W,0,0,3,4,7
Tropical Storm,Larry,10,2003-10-04T03:00:00Z,19.3N  94.8W,99,0,0,0,99
Tropical Storm,Larry,10,2003-10-04T03:00:00Z,MMTX 210N 974W,8,4,4,3,19
Tropical Storm,Larry,10,2003-10-04T03:00:00Z,19.0N  94.8W,99,0,0,0,99
Tropical Storm,Larry,10,2003-10-04T03:00:00Z,MMVR 192N 961W,29,1,0,1,31
Tropical Storm,Larry,10,2003-10-04T03:00:00Z,18.8N  94.9W,99,0,0,0,99
Tropical Storm,Larry,10,2003-10-04T03:00:00Z,MMFR 185N 926W,2,4,4,5,15
Tropical Storm,Larry,10,2003-10-04T03:00:00Z,MZBZ 175N 883W,0,0,0,2,2
Tropical Storm,Larry,10,2003-10-04T03:00:00Z,MMMD 210N 897W,0,0,1,4,5
Tropical Storm,Larry,10,2003-10-04T03:00:00Z,MGPB 157N 886W,0,0,0,2,2
Tropical Storm,Larry,10,2003-10-04T03:00:00Z,BROWNSVILLE TX,0,0,0,4,4
Tropical Storm,Larry,10,2003-10-04T03:00:00Z,MMSO 238N 982W,0,0,2,6,8
Tropical Storm,Larry,10,2003-10-04T03:00:00Z,GULF 27N 96W,0,0,0,2,2
Tropical Storm,Larry,10,2003-10-04T03:00:00Z,MMTM 222N 979W,1,3,4,6,14
Tropical Storm,Larry,10,2003-10-04T03:00:00Z,GULF 25N 96W,0,0,2,5,7
Tropical Storm,Larry,11,2003-10-04T09:00:00Z,18.9N  94.1W,99,0,0,0,99
Tropical Storm,Larry,11,2003-10-04T09:00:00Z,MMTX 210N 974W,4,5,4,3,16
Tropical Storm,Larry,11,2003-10-04T09:00:00Z,18.5N  94.2W,99,0,0,0,99
Tropical Storm,Larry,11,2003-10-04T09:00:00Z,MMVR 192N 961W,19,3,1,2,25
Tropical Storm,Larry,11,2003-10-04T09:00:00Z,18.1N  94.3W,25,2,1,0,28
Tropical Storm,Larry,11,2003-10-04T09:00:00Z,MMFR 185N 926W,16,2,1,2,21
Tropical Storm,Larry,11,2003-10-04T09:00:00Z,MZBZ 175N 883W,0,0,0,3,3
Tropical Storm,Larry,11,2003-10-04T09:00:00Z,MMMD 210N 897W,0,0,1,4,5
Tropical Storm,Larry,11,2003-10-04T09:00:00Z,MGPB 157N 886W,0,0,0,3,3
Tropical Storm,Larry,11,2003-10-04T09:00:00Z,BROWNSVILLE TX,0,0,0,3,3
Tropical Storm,Larry,11,2003-10-04T09:00:00Z,MMSO 238N 982W,0,0,2,5,7
Tropical Storm,Larry,11,2003-10-04T09:00:00Z,GULF 25N 96W,0,0,2,3,5
Tropical Storm,Larry,11,2003-10-04T09:00:00Z,MMTM 222N 979W,0,3,4,5,12
Tropical Storm,Larry,12,2003-10-04T15:00:00Z,18.5N  93.6W,99,0,0,0,99
Tropical Storm,Larry,12,2003-10-04T15:00:00Z,MMTM 222N 979W,0,1,3,5,9
Tropical Storm,Larry,12,2003-10-04T15:00:00Z,17.9N  93.7W,27,1,1,1,30
Tropical Storm,Larry,12,2003-10-04T15:00:00Z,MMTX 210N 974W,1,4,5,4,14
Tropical Storm,Larry,12,2003-10-04T15:00:00Z,17.3N  94.0W,16,4,3,1,24
Tropical Storm,Larry,12,2003-10-04T15:00:00Z,MMVR 192N 961W,17,3,2,2,24
Tropical Storm,Larry,12,2003-10-04T15:00:00Z,MZBZ 175N 883W,0,0,0,4,4
Tropical Storm,Larry,12,2003-10-04T15:00:00Z,MMFR 185N 926W,26,1,1,0,28
Tropical Storm,Larry,12,2003-10-04T15:00:00Z,MGPB 157N 886W,0,0,1,3,4
Tropical Storm,Larry,12,2003-10-04T15:00:00Z,MMMD 210N 897W,0,0,1,4,5
Tropical Storm,Larry,12,2003-10-04T15:00:00Z,MMSO 238N 982W,0,0,1,3,4
Tropical Storm,Larry,12,2003-10-04T15:00:00Z,GULF 25N 96W,0,0,0,3,3
Tropical Storm,Larry,13,2003-10-04T21:00:00Z,17.8N  93.8W,99,0,0,0,99
Tropical Storm,Larry,13,2003-10-04T21:00:00Z,MMSO 238N 982W,0,0,0,3,3
Tropical Storm,Larry,13,2003-10-04T21:00:00Z,17.3N  94.0W,41,0,0,0,41
Tropical Storm,Larry,13,2003-10-04T21:00:00Z,MMTM 222N 979W,0,0,2,5,7
Tropical Storm,Larry,13,2003-10-04T21:00:00Z,16.7N  94.3W,26,1,1,1,29
Tropical Storm,Larry,13,2003-10-04T21:00:00Z,MMTX 210N 974W,0,3,4,4,11
Tropical Storm,Larry,13,2003-10-04T21:00:00Z,MZBZ 175N 883W,0,0,0,2,2
Tropical Storm,Larry,13,2003-10-04T21:00:00Z,MMVR 192N 961W,14,4,2,1,21
Tropical Storm,Larry,13,2003-10-04T21:00:00Z,MGPB 157N 886W,0,0,0,2,2
Tropical Storm,Larry,13,2003-10-04T21:00:00Z,MMFR 185N 926W,30,0,0,0,30
Tropical Storm,Larry,14,2003-10-05T03:00:00Z,17.5N  94.1W,53,0,0,0,53
Tropical Storm,Larry,14,2003-10-05T03:00:00Z,MMTM 222N 979W,0,0,2,5,7
Tropical Storm,Larry,14,2003-10-05T03:00:00Z,17.0N  94.5W,35,0,1,0,36
Tropical Storm,Larry,14,2003-10-05T03:00:00Z,MMTX 210N 974W,0,3,4,5,12
Tropical Storm,Larry,14,2003-10-05T03:00:00Z,16.5N  95.0W,23,2,1,1,27
Tropical Storm,Larry,14,2003-10-05T03:00:00Z,MMVR 192N 961W,14,4,2,2,22
Tropical Storm,Larry,14,2003-10-05T03:00:00Z,MMSO 238N 982W,0,0,0,3,3
Tropical Storm,Larry,14,2003-10-05T03:00:00Z,MMFR 185N 926W,99,0,0,0,99
Tropical Storm,Larry,15,2003-10-05T09:00:00Z,17.0N  93.5W,42,0,0,0,42
Tropical Storm,Larry,15,2003-10-05T09:00:00Z,MMTX 210N 974W,0,1,2,5,8
Tropical Storm,Larry,15,2003-10-05T09:00:00Z,16.0N  94.0W,27,1,1,0,29
Tropical Storm,Larry,15,2003-10-05T09:00:00Z,MMVR 192N 961W,8,4,2,3,17
Tropical Storm,Larry,15,2003-10-05T09:00:00Z,15.5N  94.5W,17,6,2,1,26
Tropical Storm,Larry,15,2003-10-05T09:00:00Z,MMFR 185N 926W,99,0,0,0,99
Tropical Storm,Larry,15,2003-10-05T09:00:00Z,MMTM 222N 979W,0,0,1,3,4
Tropical Storm,Larry,16,2003-10-05T15:00:00Z,16.9N  93.7W,48,0,0,0,48
Tropical Storm,Larry,16,2003-10-05T15:00:00Z,MMTM 222N 979W,0,0,1,3,4
Tropical Storm,Larry,16,2003-10-05T15:00:00Z,16.0N  94.0W,28,1,1,0,30
Tropical Storm,Larry,16,2003-10-05T15:00:00Z,MMTX 210N 974W,0,1,2,5,8
Tropical Storm,Larry,16,2003-10-05T15:00:00Z,15.5N  95.0W,17,5,1,1,24
Tropical Storm,Larry,16,2003-10-05T15:00:00Z,MMVR 192N 961W,7,4,3,3,17
Tropical Storm,Larry,16,2003-10-05T15:00:00Z,MMSO 238N 982W,0,0,0,2,2
Tropical Storm,Larry,16,2003-10-05T15:00:00Z,MMFR 185N 926W,99,0,0,0,99
Tropical Storm,Larry,17,2003-10-05T21:00:00Z,17.1N  94.1W,55,0,0,0,55
Tropical Storm,Larry,17,2003-10-05T21:00:00Z,MMVR 192N 961W,11,4,0,0,15
Tropical Storm,Larry,17,2003-10-05T21:00:00Z,16.5N  94.5W,37,0,0,0,37
Tropical Storm,Larry,17,2003-10-05T21:00:00Z,MMFR 185N 926W,36,0,0,0,36
Tropical Storm,Larry,17,2003-10-05T21:00:00Z,,99,0,0,0,99
Tropical Depression,Larry,18,2003-10-06T03:00:00Z,16.6N  94.3W,52,0,0,0,52
Tropical Depression,Larry,18,2003-10-06T03:00:00Z,MMVR 192N 961W,8,0,0,0,8
Tropical Depression,Larry,18,2003-10-06T03:00:00Z,,99,0,0,0,99
Tropical Depression,Larry,18,2003-10-06T03:00:00Z,MMFR 185N 926W,13,0,0,0,13
Tropical Depression,Larry,18,2003-10-06T03:00:00Z,,99,0,0,0,99
Tropical Depression,Larry,19,2003-10-06T09:00:00Z,,99,0,0,0,99
Tropical Depression,Larry,19,2003-10-06T09:00:00Z,,99,0,0,0,99
Tropical Depression,Larry,19,2003-10-06T09:00:00Z,,99,0,0,0,99
Tropical Depression,Larry,19,2003-10-06T09:00:00Z,MMFR 185N 926W,3,0,0,0,3
Tropical Storm,Mindy,1,2003-10-10T21:00:00Z,21.8N  71.3W,52,0,0,0,52
Tropical Storm,Mindy,1,2003-10-10T21:00:00Z,MYMM 224N 730W,25,8,0,0,33
Tropical Storm,Mindy,1,2003-10-10T21:00:00Z,24.0N  72.0W,12,21,1,0,34
Tropical Storm,Mindy,1,2003-10-10T21:00:00Z,MYSM 241N 745W,1,17,2,0,20
Tropical Storm,Mindy,1,2003-10-10T21:00:00Z,26.5N  71.5W,0,11,13,1,25
Tropical Storm,Mindy,1,2003-10-10T21:00:00Z,MYEG 235N 758W,0,5,3,0,8
Tropical Storm,Mindy,1,2003-10-10T21:00:00Z,MDSD 185N 697W,99,0,0,0,99
Tropical Storm,Mindy,1,2003-10-10T21:00:00Z,MYNN 251N 775W,0,0,2,0,2
Tropical Storm,Mindy,1,2003-10-10T21:00:00Z,MTPP 186N 724W,2,1,0,0,3
Tropical Storm,Mindy,1,2003-10-10T21:00:00Z,BERMUDA,0,0,0,9,9
Tropical Storm,Mindy,1,2003-10-10T21:00:00Z,MDPP 198N 707W,67,0,0,0,67
Tropical Storm,Mindy,1,2003-10-10T21:00:00Z,CAPE HATTERAS NC,0,0,0,2,2
Tropical Storm,Mindy,1,2003-10-10T21:00:00Z,MBJT 215N 712W,57,0,0,0,57
Tropical Storm,Mindy,2,2003-10-11T03:00:00Z,23.3N  71.7W,55,0,0,0,55
Tropical Storm,Mindy,2,2003-10-11T03:00:00Z,MYMM 224N 730W,33,0,0,0,33
Tropical Storm,Mindy,2,2003-10-11T03:00:00Z,25.2N  71.8W,17,14,1,0,32
Tropical Storm,Mindy,2,2003-10-11T03:00:00Z,MYSM 241N 745W,7,11,0,1,19
Tropical Storm,Mindy,2,2003-10-11T03:00:00Z,28.0N  70.4W,0,3,20,1,24
Tropical Storm,Mindy,2,2003-10-11T03:00:00Z,MYEG 235N 758W,0,3,1,0,4
Tropical Storm,Mindy,2,2003-10-11T03:00:00Z,MDPP 198N 707W,99,0,0,0,99
Tropical Storm,Mindy,2,2003-10-11T03:00:00Z,BERMUDA,0,0,0,15,15
Tropical Storm,Mindy,2,2003-10-11T03:00:00Z,MBJT 215N 712W,86,0,0,0,86
Tropical Storm,Mindy,2,2003-10-11T03:00:00Z,CAPE HATTERAS NC,0,0,0,2,2
Tropical Storm,Mindy,3,2003-10-11T09:00:00Z,25.0N  71.5W,49,0,0,0,49
Tropical Storm,Mindy,3,2003-10-11T09:00:00Z,MYSM 241N 745W,6,7,0,0,13
Tropical Storm,Mindy,3,2003-10-11T09:00:00Z,27.0N  71.0W,11,19,1,0,31
Tropical Storm,Mindy,3,2003-10-11T09:00:00Z,BERMUDA,0,0,0,13,13
Tropical Storm,Mindy,3,2003-10-11T09:00:00Z,29.5N  68.5W,0,1,17,3,21
Tropical Storm,Mindy,3,2003-10-11T09:00:00Z,CAPE HATTERAS NC,0,0,0,2,2
Tropical Storm,Mindy,3,2003-10-11T09:00:00Z,MBJT 215N 712W,99,0,0,0,99
Tropical Storm,Mindy,3,2003-10-11T09:00:00Z,NANTUCKET MA,0,0,0,2,2
Tropical Storm,Mindy,3,2003-10-11T09:00:00Z,MYMM 224N 730W,28,0,0,0,28
Tropical Storm,Mindy,4,2003-10-11T15:00:00Z,26.1N  71.9W,51,0,0,0,51
Tropical Storm,Mindy,4,2003-10-11T15:00:00Z,MYMM 224N 730W,77,0,0,0,77
Tropical Storm,Mindy,4,2003-10-11T15:00:00Z,28.0N  70.2W,5,25,4,0,34
Tropical Storm,Mindy,4,2003-10-11T15:00:00Z,MYSM 241N 745W,30,1,0,0,31
Tropical Storm,Mindy,4,2003-10-11T15:00:00Z,30.6N  66.8W,0,1,17,3,21
Tropical Storm,Mindy,4,2003-10-11T15:00:00Z,BERMUDA,0,0,5,11,16
Tropical Storm,Mindy,4,2003-10-11T15:00:00Z,MBJT 215N 712W,99,0,0,0,99
Tropical Storm,Mindy,4,2003-10-11T15:00:00Z,NANTUCKET MA,0,0,0,2,2
Tropical Storm,Mindy,5,2003-10-11T21:00:00Z,26.5N  70.9W,45,1,0,0,46
Tropical Storm,Mindy,5,2003-10-11T21:00:00Z,MYMM 224N 730W,11,0,0,0,11
Tropical Storm,Mindy,5,2003-10-11T21:00:00Z,28.5N  68.5W,2,27,8,1,38
Tropical Storm,Mindy,5,2003-10-11T21:00:00Z,MYSM 241N 745W,19,0,0,0,19
Tropical Storm,Mindy,5,2003-10-11T21:00:00Z,32.0N  64.0W,0,0,17,5,22
Tropical Storm,Mindy,5,2003-10-11T21:00:00Z,BERMUDA,0,0,17,5,22
Tropical Storm,Mindy,5,2003-10-11T21:00:00Z,MBJT 215N 712W,16,0,0,0,16
Tropical Storm,Mindy,6,2003-10-12T03:00:00Z,27.5N  70.0W,45,0,0,0,45
Tropical Storm,Mindy,6,2003-10-12T03:00:00Z,BERMUDA,0,5,11,1,17
Tropical Storm,Mindy,6,2003-10-12T03:00:00Z,30.3N  66.5W,0,19,3,0,22
Tropical Storm,Mindy,6,2003-10-12T03:00:00Z,HALIFAX NS,0,0,0,2,2
Tropical Storm,Mindy,6,2003-10-12T03:00:00Z,33.5N  62.0W,0,0,11,2,13
Tropical Storm,Mindy,6,2003-10-12T03:00:00Z,SABLE ISLAND NS,0,0,0,3,3
Tropical Storm,Mindy,6,2003-10-12T03:00:00Z,MYSM 241N 745W,3,0,0,0,3
Tropical Storm,Mindy,7,2003-10-12T09:00:00Z,28.0N  68.9W,20,5,0,0,25
Tropical Storm,Mindy,7,2003-10-12T09:00:00Z,SABLE ISLAND NS,0,0,0,3,3
Tropical Storm,Mindy,7,2003-10-12T09:00:00Z,30.5N  64.9W,0,15,2,1,18
Tropical Storm,Mindy,7,2003-10-12T09:00:00Z,BURGEO NFLD,0,0,0,2,2
Tropical Storm,Mindy,7,2003-10-12T09:00:00Z,32.3N  61.0W,0,1,11,2,14
Tropical Storm,Mindy,7,2003-10-12T09:00:00Z,ILE ST PIERRE,0,0,0,2,2
Tropical Storm,Mindy,7,2003-10-12T09:00:00Z,BERMUDA,0,10,4,1,15
Tropical Storm,Mindy,7,2003-10-12T09:00:00Z,CAPE RACE NFLD,0,0,0,2,2
Tropical Storm,Mindy,8,2003-10-12T15:00:00Z,28.8N  67.8W,35,3,0,0,38
Tropical Storm,Mindy,8,2003-10-12T15:00:00Z,BERMUDA,0,12,5,1,18
Tropical Storm,Mindy,8,2003-10-12T15:00:00Z,30.6N  64.5W,0,20,2,1,23
Tropical Storm,Mindy,8,2003-10-12T15:00:00Z,SABLE ISLAND NS,0,0,0,2,2
Tropical Storm,Mindy,8,2003-10-12T15:00:00Z,32.0N  61.0W,0,2,11,2,15
Tropical Depression,Mindy,9,2003-10-12T21:00:00Z,27.7N  68.8W,25,1,0,0,26
Tropical Depression,Mindy,9,2003-10-12T21:00:00Z,MBJT 215N 712W,1,2,0,1,4
Tropical Depression,Mindy,9,2003-10-12T21:00:00Z,28.6N  66.8W,6,12,1,1,20
Tropical Depression,Mindy,9,2003-10-12T21:00:00Z,BERMUDA,0,7,6,2,15
Tropical Depression,Mindy,9,2003-10-12T21:00:00Z,30.0N  64.0W,0,6,10,1,17
Tropical Depression,Mindy,10,2003-10-13T03:00:00Z,25.9N  68.4W,38,1,0,0,39
Tropical Depression,Mindy,10,2003-10-13T03:00:00Z,MDPP 198N 707W,0,0,1,1,2
Tropical Depression,Mindy,10,2003-10-13T03:00:00Z,25.9N  66.8W,20,3,0,1,24
Tropical Depression,Mindy,10,2003-10-13T03:00:00Z,MBJT 215N 712W,0,2,2,1,5
Tropical Depression,Mindy,10,2003-10-13T03:00:00Z,26.3N  64.5W,1,9,4,3,17
Tropical Depression,Mindy,10,2003-10-13T03:00:00Z,MYMM 224N 730W,0,1,1,1,3
Tropical Depression,Mindy,10,2003-10-13T03:00:00Z,TIST 183N 650W,0,0,0,2,2
Tropical Depression,Mindy,10,2003-10-13T03:00:00Z,BERMUDA,0,0,2,3,5
Tropical Depression,Mindy,10,2003-10-13T03:00:00Z,TJPS 180N 666W,0,0,0,2,2
Tropical Depression,Mindy,10,2003-10-13T03:00:00Z,ST THOMAS VI,0,0,0,2,2
Tropical Depression,Mindy,10,2003-10-13T03:00:00Z,MDSD 185N 697W,0,0,1,1,2
Tropical Depression,Mindy,10,2003-10-13T03:00:00Z,SAN JUAN PR,0,0,0,2,2
Tropical Depression,Mindy,10,2003-10-13T03:00:00Z,TJSJ 184N 661W,0,0,0,2,2
Tropical Depression,Mindy,10,2003-10-13T03:00:00Z,PONCE PR,0,0,0,2,2
Tropical Depression,Mindy,11,2003-10-13T09:00:00Z,25.9N  66.4W,31,0,1,0,32
Tropical Depression,Mindy,11,2003-10-13T09:00:00Z,26.9N  62.3W,1,12,3,2,18
Tropical Depression,Mindy,11,2003-10-13T09:00:00Z,26.2N  64.4W,13,6,2,0,21
Tropical Depression,Mindy,11,2003-10-13T09:00:00Z,BERMUDA,0,0,0,2,2
Tropical Depression,Mindy,12,2003-10-13T15:00:00Z,26.5N  65.0W,30,0,0,0,30
Tropical Depression,Mindy,12,2003-10-13T15:00:00Z,27.2N  62.5W,7,12,0,0,19
Tropical Depression,Mindy,13,2003-10-13T21:00:00Z,27.1N  63.4W,34,0,0,0,34
Tropical Depression,Mindy,13,2003-10-13T21:00:00Z,BERMUDA,0,3,0,0,3
Tropical Depression,Mindy,13,2003-10-13T21:00:00Z,28.0N  61.0W,4,15,0,0,19
Tropical Depression,Mindy,14,2003-10-14T03:00:00Z,26.5N  65.2W,29,0,0,0,29
Tropical Depression,Nineteen,1,2003-10-13T21:00:00Z,10.0N  41.0W,57,0,0,0,57
Tropical Depression,Nineteen,1,2003-10-13T21:00:00Z,10.8N  43.4W,14,14,1,1,30
Tropical Depression,Nineteen,1,2003-10-13T21:00:00Z,10.4N  42.2W,37,1,0,0,38
Tropical Depression,Nineteen,2,2003-10-14T03:00:00Z,10.4N  41.3W,65,0,0,0,65
Tropical Depression,Nineteen,2,2003-10-14T03:00:00Z,11.5N  42.5W,34,1,1,0,36
Tropical Depression,Nineteen,2,2003-10-14T03:00:00Z,11.0N  42.0W,45,0,0,0,45
Tropical Depression,Nineteen,3,2003-10-14T09:00:00Z,10.9N  43.0W,57,0,0,0,57
Tropical Depression,Nineteen,3,2003-10-14T09:00:00Z,12.0N  45.0W,22,9,0,1,32
Tropical Depression,Nineteen,3,2003-10-14T09:00:00Z,11.4N  44.1W,39,0,1,0,40
Tropical Depression,Nineteen,4,2003-10-14T15:00:00Z,11.9N  43.6W,64,0,0,0,64
Tropical Depression,Nineteen,4,2003-10-14T15:00:00Z,13.3N  44.8W,24,8,1,0,33
Tropical Depression,Nineteen,4,2003-10-14T15:00:00Z,12.6N  44.3W,41,1,0,0,42
Tropical Depression,Nineteen,5,2003-10-14T21:00:00Z,12.5N  44.2W,54,0,0,0,54
Tropical Depression,Nineteen,5,2003-10-14T21:00:00Z,14.2N  45.4W,19,8,1,1,29
Tropical Depression,Nineteen,5,2003-10-14T21:00:00Z,13.3N  44.8W,36,0,1,0,37
Tropical Storm,Nicholas,6,2003-10-15T03:00:00Z,13.1N  44.6W,60,0,0,0,60
Tropical Storm,Nicholas,6,2003-10-15T03:00:00Z,15.0N  46.0W,16,12,1,1,30
Tropical Storm,Nicholas,6,2003-10-15T03:00:00Z,14.0N  45.3W,38,1,1,0,40
Tropical Storm,Nicholas,7,2003-10-15T09:00:00Z,13.3N  45.7W,57,0,0,0,57
Tropical Storm,Nicholas,7,2003-10-15T09:00:00Z,15.7N  47.2W,8,21,1,1,31
Tropical Storm,Nicholas,7,2003-10-15T09:00:00Z,14.5N  46.7W,28,8,1,0,37
Tropical Storm,Nicholas,8,2003-10-15T15:00:00Z,13.5N  46.1W,51,0,0,0,51
Tropical Storm,Nicholas,8,2003-10-15T15:00:00Z,16.0N  47.6W,7,20,1,1,29
Tropical Storm,Nicholas,8,2003-10-15T15:00:00Z,14.7N  47.0W,29,7,0,0,36
Tropical Storm,Nicholas,9,2003-10-15T21:00:00Z,14.1N  46.5W,54,0,0,0,54
Tropical Storm,Nicholas,9,2003-10-15T21:00:00Z,16.4N  47.7W,15,10,1,1,27
Tropical Storm,Nicholas,9,2003-10-15T21:00:00Z,15.3N  47.1W,36,2,0,0,38
Tropical Storm,Nicholas,10,2003-10-16T03:00:00Z,14.9N  46.8W,66,0,0,0,66
Tropical Storm,Nicholas,10,2003-10-16T03:00:00Z,17.0N  48.0W,23,8,1,0,32
Tropical Storm,Nicholas,10,2003-10-16T03:00:00Z,16.0N  47.3W,44,0,0,0,44
Tropical Storm,Nicholas,11,2003-10-16T09:00:00Z,15.3N  47.5W,38,0,0,0,38
Tropical Storm,Nicholas,11,2003-10-16T09:00:00Z,17.3N  48.9W,6,11,3,3,23
Tropical Storm,Nicholas,11,2003-10-16T09:00:00Z,16.3N  48.1W,22,3,1,1,27
Tropical Storm,Nicholas,12,2003-10-16T15:00:00Z,15.9N  47.8W,43,0,0,0,43
Tropical Storm,Nicholas,12,2003-10-16T15:00:00Z,17.5N  49.1W,14,6,1,2,23
Tropical Storm,Nicholas,12,2003-10-16T15:00:00Z,16.7N  48.3W,28,1,0,1,30
Tropical Storm,Nicholas,13,2003-10-16T21:00:00Z,16.4N  48.3W,45,0,0,0,45
Tropical Storm,Nicholas,13,2003-10-16T21:00:00Z,18.0N  49.9W,12,7,2,2,23
Tropical Storm,Nicholas,13,2003-10-16T21:00:00Z,17.3N  49.1W,25,1,1,1,28
Tropical Storm,Nicholas,14,2003-10-17T03:00:00Z,16.4N  49.1W,45,0,0,0,45
Tropical Storm,Nicholas,14,2003-10-17T03:00:00Z,18.0N  51.0W,9,9,3,2,23
Tropical Storm,Nicholas,14,2003-10-17T03:00:00Z,17.2N  50.0W,24,2,1,0,27
Tropical Storm,Nicholas,15,2003-10-17T09:00:00Z,16.8N  49.2W,50,0,0,0,50
Tropical Storm,Nicholas,15,2003-10-17T09:00:00Z,18.4N  50.6W,13,6,2,2,23
Tropical Storm,Nicholas,15,2003-10-17T09:00:00Z,17.6N  49.9W,26,2,0,1,29
Tropical Storm,Nicholas,16,2003-10-17T15:00:00Z,17.7N  49.3W,47,0,0,0,47
Tropical Storm,Nicholas,16,2003-10-17T15:00:00Z,19.1N  50.6W,15,6,2,1,24
Tropical Storm,Nicholas,16,2003-10-17T15:00:00Z,18.4N  49.9W,27,1,1,1,30
Tropical Storm,Nicholas,17,2003-10-17T21:00:00Z,17.9N  49.4W,43,0,0,0,43
Tropical Storm,Nicholas,17,2003-10-17T21:00:00Z,19.2N  50.5W,16,4,2,2,24
Tropical Storm,Nicholas,17,2003-10-17T21:00:00Z,18.6N  50.0W,24,2,0,1,27
Tropical Storm,Nicholas,18,2003-10-18T03:00:00Z,18.2N  49.3W,44,0,0,0,44
Tropical Storm,Nicholas,18,2003-10-18T03:00:00Z,19.5N  50.5W,17,3,2,2,24
Tropical Storm,Nicholas,18,2003-10-18T03:00:00Z,18.8N  49.8W,29,0,1,0,30
Tropical Storm,Nicholas,19,2003-10-18T09:00:00Z,18.4N  49.3W,49,0,0,0,49
Tropical Storm,Nicholas,19,2003-10-18T09:00:00Z,19.6N  50.4W,19,3,1,2,25
Tropical Storm,Nicholas,19,2003-10-18T09:00:00Z,19.0N  49.8W,31,1,0,0,32
Tropical Storm,Nicholas,20,2003-10-18T15:00:00Z,18.1N  48.2W,48,0,0,0,48
Tropical Storm,Nicholas,20,2003-10-18T15:00:00Z,19.5N  49.6W,15,4,3,1,23
Tropical Storm,Nicholas,20,2003-10-18T15:00:00Z,18.8N  48.8W,27,1,0,1,29
Tropical Storm,Nicholas,21,2003-10-18T21:00:00Z,18.4N  48.4W,47,0,0,0,47
Tropical Storm,Nicholas,21,2003-10-18T21:00:00Z,19.7N  49.7W,17,3,2,2,24
Tropical Storm,Nicholas,21,2003-10-18T21:00:00Z,19.1N  49.1W,26,1,1,0,28
Tropical Storm,Nicholas,22,2003-10-19T03:00:00Z,17.9N  48.8W,99,0,0,0,99
Tropical Storm,Nicholas,22,2003-10-19T03:00:00Z,19.4N  49.9W,16,4,2,2,24
Tropical Storm,Nicholas,22,2003-10-19T03:00:00Z,18.5N  49.3W,31,1,0,0,32
Tropical Storm,Nicholas,23,2003-10-19T09:00:00Z,18.2N  49.0W,99,0,0,0,99
Tropical Storm,Nicholas,23,2003-10-19T09:00:00Z,19.8N  50.2W,12,5,3,2,22
Tropical Storm,Nicholas,23,2003-10-19T09:00:00Z,18.9N  49.6W,25,1,1,0,27
Tropical Storm,Nicholas,24,2003-10-19T15:00:00Z,18.8N  48.5W,46,0,0,0,46
Tropical Storm,Nicholas,24,2003-10-19T15:00:00Z,20.2N  50.0W,15,4,2,2,23
Tropical Storm,Nicholas,24,2003-10-19T15:00:00Z,19.4N  49.2W,28,1,0,1,30
Tropical Storm,Nicholas,25,2003-10-19T21:00:00Z,18.8N  48.5W,51,0,0,0,51
Tropical Storm,Nicholas,25,2003-10-19T21:00:00Z,20.2N  50.0W,13,5,3,2,23
Tropical Storm,Nicholas,25,2003-10-19T21:00:00Z,19.4N  49.2W,27,1,1,0,29
Tropical Storm,Nicholas,26,2003-10-20T03:00:00Z,18.4N  48.4W,42,0,0,0,42
Tropical Storm,Nicholas,26,2003-10-20T03:00:00Z,20.2N  50.0W,14,5,2,2,23
Tropical Storm,Nicholas,26,2003-10-20T03:00:00Z,19.3N  49.2W,26,1,1,0,28
Tropical Storm,Nicholas,27,2003-10-20T09:00:00Z,18.5N  48.9W,41,0,0,0,41
Tropical Storm,Nicholas,27,2003-10-20T09:00:00Z,20.4N  50.9W,4,13,3,2,22
Tropical Storm,Nicholas,27,2003-10-20T09:00:00Z,19.4N  49.9W,20,3,1,1,25
Tropical Storm,Nicholas,28,2003-10-20T15:00:00Z,18.9N  50.0W,43,0,0,0,43
Tropical Storm,Nicholas,28,2003-10-20T15:00:00Z,20.5N  52.0W,7,9,3,3,22
Tropical Storm,Nicholas,28,2003-10-20T15:00:00Z,19.6N  50.9W,23,2,0,1,26
Tropical Storm,Nicholas,29,2003-10-20T21:00:00Z,19.0N  51.1W,48,0,0,0,48
Tropical Storm,Nicholas,29,2003-10-20T21:00:00Z,21.0N  53.0W,8,10,2,2,22
Tropical Storm,Nicholas,29,2003-10-20T21:00:00Z,19.9N  52.1W,24,2,0,1,27
Tropical Storm,Nicholas,30,2003-10-21T03:00:00Z,19.6N  51.8W,40,0,0,0,40
Tropical Storm,Nicholas,30,2003-10-21T03:00:00Z,22.2N  53.3W,3,12,4,2,21
Tropical Storm,Nicholas,30,2003-10-21T03:00:00Z,20.7N  52.7W,19,4,1,1,25
Tropical Storm,Nicholas,31,2003-10-21T09:00:00Z,20.1N  52.3W,40,0,0,0,40
Tropical Storm,Nicholas,31,2003-10-21T09:00:00Z,23.2N  53.6W,1,13,4,3,21
Tropical Storm,Nicholas,31,2003-10-21T09:00:00Z,21.5N  53.1W,17,6,1,1,25
Tropical Storm,Nicholas,32,2003-10-21T15:00:00Z,20.3N  53.2W,39,0,0,0,39
Tropical Storm,Nicholas,32,2003-10-21T15:00:00Z,24.4N  54.1W,0,11,8,2,21
Tropical Storm,Nicholas,32,2003-10-21T15:00:00Z,22.2N  53.8W,11,13,1,0,25
Tropical Storm,Nicholas,33,2003-10-21T21:00:00Z,21.1N  54.0W,32,1,0,0,33
Tropical Storm,Nicholas,33,2003-10-21T21:00:00Z,25.6N  54.4W,0,9,9,2,20
Tropical Storm,Nicholas,33,2003-10-21T21:00:00Z,23.4N  54.4W,4,18,1,1,24
Tropical Storm,Nicholas,34,2003-10-22T03:00:00Z,21.3N  54.6W,35,0,0,0,35
Tropical Storm,Nicholas,34,2003-10-22T03:00:00Z,26.5N  55.0W,0,6,13,2,21
Tropical Storm,Nicholas,34,2003-10-22T03:00:00Z,23.5N  55.0W,7,16,1,0,24
Tropical Storm,Nicholas,34,2003-10-22T03:00:00Z,BERMUDA,0,0,0,2,2
Tropical Storm,Nicholas,35,2003-10-22T09:00:00Z,20.3N  55.7W,38,0,0,0,38
Tropical Storm,Nicholas,35,2003-10-22T09:00:00Z,25.5N  56.0W,0,7,13,2,22
Tropical Storm,Nicholas,35,2003-10-22T09:00:00Z,22.3N  56.0W,14,10,1,0,25
Tropical Storm,Nicholas,35,2003-10-22T09:00:00Z,BERMUDA,0,0,0,3,3
Tropical Storm,Nicholas,36,2003-10-22T15:00:00Z,21.6N  55.6W,32,0,0,0,32
Tropical Storm,Nicholas,36,2003-10-22T15:00:00Z,24.0N  56.0W,1,21,0,0,22
Tropical Storm,Nicholas,37,2003-10-22T21:00:00Z,22.5N  56.0W,34,0,0,0,34
Tropical Storm,Nicholas,37,2003-10-22T21:00:00Z,25.0N  56.0W,2,21,0,0,23
Tropical Storm,Nicholas,38,2003-10-23T03:00:00Z,24.7N  56.9W,38,0,0,0,38
Tropical Storm,Nicholas,38,2003-10-23T03:00:00Z,27.0N  57.0W,15,11,0,0,26
Tropical Depression,Nicholas,39,2003-10-23T09:00:00Z,26.5N  57.0W,40,0,0,0,40
Tropical Depression,Nicholas,39,2003-10-23T09:00:00Z,29.0N  57.0W,7,18,0,0,25
Tropical Depression,Nicholas,40,2003-10-23T15:00:00Z,27.5N  57.0W,51,0,0,0,51
Tropical Depression,Twenty,1,2003-12-04T15:00:00Z,17.5N  74.7W,40,0,0,0,40
Tropical Depression,Twenty,1,2003-12-04T15:00:00Z,MUCM 214N 779W,0,4,1,0,5
Tropical Depression,Twenty,1,2003-12-04T15:00:00Z,21.0N  73.5W,1,20,2,0,23
Tropical Depression,Twenty,1,2003-12-04T15:00:00Z,MDPP 198N 707W,0,9,6,1,16
Tropical Depression,Twenty,1,2003-12-04T15:00:00Z,25.0N  70.5W,0,1,13,4,18
Tropical Depression,Twenty,1,2003-12-04T15:00:00Z,MBJT 215N 712W,0,10,8,1,19
Tropical Depression,Twenty,1,2003-12-04T15:00:00Z,MDSD 185N 697W,0,3,5,1,9
Tropical Depression,Twenty,1,2003-12-04T15:00:00Z,MYMM 224N 730W,0,14,6,1,21
Tropical Depression,Twenty,1,2003-12-04T15:00:00Z,MDCB 176N 714W,4,10,1,1,16
Tropical Depression,Twenty,1,2003-12-04T15:00:00Z,MYSM 241N 745W,0,7,8,1,16
Tropical Depression,Twenty,1,2003-12-04T15:00:00Z,MTPP 186N 724W,10,12,1,0,23
Tropical Depression,Twenty,1,2003-12-04T15:00:00Z,MYEG 235N 758W,0,7,5,1,13
Tropical Depression,Twenty,1,2003-12-04T15:00:00Z,MTCA 183N 738W,27,5,0,0,32
Tropical Depression,Twenty,1,2003-12-04T15:00:00Z,MYAK 241N 776W,0,1,3,0,4
Tropical Depression,Twenty,1,2003-12-04T15:00:00Z,MKJP 179N 768W,17,4,0,0,21
Tropical Depression,Twenty,1,2003-12-04T15:00:00Z,MYNN 251N 775W,0,1,2,0,3
Tropical Depression,Twenty,1,2003-12-04T15:00:00Z,MKJS 185N 779W,3,5,0,0,8
Tropical Depression,Twenty,1,2003-12-04T15:00:00Z,BERMUDA,0,0,0,13,13
Tropical Depression,Twenty,1,2003-12-04T15:00:00Z,MUGM 200N 751W,7,17,0,0,24
Tropical Storm,Odette,2,2003-12-04T21:00:00Z,18.5N  74.0W,40,0,0,0,40
Tropical Storm,Odette,2,2003-12-04T21:00:00Z,MUGM 200N 751W,16,9,1,0,26
Tropical Storm,Odette,2,2003-12-04T21:00:00Z,22.0N  72.5W,2,18,6,0,26
Tropical Storm,Odette,2,2003-12-04T21:00:00Z,MUCM 214N 779W,0,3,1,0,4
Tropical Storm,Odette,2,2003-12-04T21:00:00Z,28.0N  68.0W,0,0,10,0,10
Tropical Storm,Odette,2,2003-12-04T21:00:00Z,MDPP 198N 707W,4,13,4,0,21
Tropical Storm,Odette,2,2003-12-04T21:00:00Z,MDSD 185N 697W,1,6,3,0,10
Tropical Storm,Odette,2,2003-12-04T21:00:00Z,MBJT 215N 712W,1,16,7,0,24
Tropical Storm,Odette,2,2003-12-04T21:00:00Z,MDCB 176N 714W,16,5,1,0,22
Tropical Storm,Odette,2,2003-12-04T21:00:00Z,MYMM 224N 730W,1,18,6,0,25
Tropical Storm,Odette,2,2003-12-04T21:00:00Z,MTPP 186N 724W,28,3,0,0,31
Tropical Storm,Odette,2,2003-12-04T21:00:00Z,MYSM 241N 745W,0,9,7,0,16
Tropical Storm,Odette,2,2003-12-04T21:00:00Z,MTCA 183N 738W,42,0,0,0,42
Tropical Storm,Odette,2,2003-12-04T21:00:00Z,MYEG 235N 758W,0,8,3,0,11
Tropical Storm,Odette,2,2003-12-04T21:00:00Z,MKJP 179N 768W,14,3,0,0,17
Tropical Storm,Odette,2,2003-12-04T21:00:00Z,MYAK 241N 776W,0,1,1,0,2
Tropical Storm,Odette,2,2003-12-04T21:00:00Z,MKJS 185N 779W,2,3,0,0,5
Tropical Storm,Odette,2,2003-12-04T21:00:00Z,MYNN 251N 775W,0,1,1,0,2
Tropical Storm,Odette,3,2003-12-05T03:00:00Z,17.9N  73.3W,31,1,0,0,32
Tropical Storm,Odette,3,2003-12-05T03:00:00Z,MUGM 200N 751W,7,11,0,0,18
Tropical Storm,Odette,3,2003-12-05T03:00:00Z,21.4N  71.3W,0,17,4,0,21
Tropical Storm,Odette,3,2003-12-05T03:00:00Z,MUCM 214N 779W,0,2,0,0,2
Tropical Storm,Odette,3,2003-12-05T03:00:00Z,26.5N  67.5W,0,0,9,0,9
Tropical Storm,Odette,3,2003-12-05T03:00:00Z,TJSJ 184N 661W,0,1,3,0,4
Tropical Storm,Odette,3,2003-12-05T03:00:00Z,TIST 183N 650W,0,0,2,0,2
Tropical Storm,Odette,3,2003-12-05T03:00:00Z,MDPP 198N 707W,3,17,2,0,22
Tropical Storm,Odette,3,2003-12-05T03:00:00Z,TJPS 180N 666W,0,2,2,0,4
Tropical Storm,Odette,3,2003-12-05T03:00:00Z,MBJT 215N 712W,0,17,4,0,21
Tropical Storm,Odette,3,2003-12-05T03:00:00Z,MDSD 185N 697W,3,13,2,0,18
Tropical Storm,Odette,3,2003-12-05T03:00:00Z,MYMM 224N 730W,0,15,3,0,18
Tropical Storm,Odette,3,2003-12-05T03:00:00Z,MDCB 176N 714W,21,4,0,0,25
Tropical Storm,Odette,3,2003-12-05T03:00:00Z,MYSM 241N 745W,0,5,5,0,10
Tropical Storm,Odette,3,2003-12-05T03:00:00Z,MTPP 186N 724W,22,6,0,0,28
Tropical Storm,Odette,3,2003-12-05T03:00:00Z,MYEG 235N 758W,0,4,2,0,6
Tropical Storm,Odette,3,2003-12-05T03:00:00Z,MTCA 183N 738W,28,2,0,0,30
Tropical Storm,Odette,3,2003-12-05T03:00:00Z,ST THOMAS VI,0,0,2,0,2
Tropical Storm,Odette,3,2003-12-05T03:00:00Z,MKJP 179N 768W,8,3,0,0,11
Tropical Storm,Odette,3,2003-12-05T03:00:00Z,SAN JUAN PR,0,1,3,0,4
Tropical Storm,Odette,3,2003-12-05T03:00:00Z,MKJS 185N 779W,1,2,0,0,3
Tropical Storm,Odette,3,2003-12-05T03:00:00Z,PONCE PR,0,2,2,0,4
Tropical Storm,Odette,4,2003-12-05T09:00:00Z,17.6N  72.7W,41,0,0,0,41
Tropical Storm,Odette,4,2003-12-05T09:00:00Z,MUGM 200N 751W,4,10,1,0,15
Tropical Storm,Odette,4,2003-12-05T09:00:00Z,20.5N  70.5W,1,21,8,0,30
Tropical Storm,Odette,4,2003-12-05T09:00:00Z,TJSJ 184N 661W,0,1,2,0,3
Tropical Storm,Odette,4,2003-12-05T09:00:00Z,26.7N  65.5W,0,0,11,0,11
Tropical Storm,Odette,4,2003-12-05T09:00:00Z,MDPP 198N 707W,2,23,6,0,31
Tropical Storm,Odette,4,2003-12-05T09:00:00Z,TJPS 180N 666W,0,1,2,0,3
Tropical Storm,Odette,4,2003-12-05T09:00:00Z,MBJT 215N 712W,0,19,10,0,29
Tropical Storm,Odette,4,2003-12-05T09:00:00Z,MDSD 185N 697W,3,17,5,0,25
Tropical Storm,Odette,4,2003-12-05T09:00:00Z,MYMM 224N 730W,0,11,6,0,17
Tropical Storm,Odette,4,2003-12-05T09:00:00Z,MDCB 176N 714W,28,6,0,0,34
Tropical Storm,Odette,4,2003-12-05T09:00:00Z,MYSM 241N 745W,0,1,2,0,3
Tropical Storm,Odette,4,2003-12-05T09:00:00Z,MTPP 186N 724W,27,9,0,0,36
Tropical Storm,Odette,4,2003-12-05T09:00:00Z,SAN JUAN PR,0,1,2,0,3
Tropical Storm,Odette,4,2003-12-05T09:00:00Z,MTCA 183N 738W,33,3,0,0,36
Tropical Storm,Odette,4,2003-12-05T09:00:00Z,PONCE PR,0,1,2,0,3
Tropical Storm,Odette,4,2003-12-05T09:00:00Z,MKJP 179N 768W,5,3,0,0,8
Tropical Storm,Odette,5,2003-12-05T15:00:00Z,17.0N  72.5W,52,3,0,0,55
Tropical Storm,Odette,5,2003-12-05T15:00:00Z,MUGM 200N 751W,0,5,1,0,6
Tropical Storm,Odette,5,2003-12-05T15:00:00Z,20.0N  71.0W,0,33,7,0,40
Tropical Storm,Odette,5,2003-12-05T15:00:00Z,TJSJ 184N 661W,0,0,2,0,2
Tropical Storm,Odette,5,2003-12-05T15:00:00Z,23.5N  67.0W,0,0,18,0,18
Tropical Storm,Odette,5,2003-12-05T15:00:00Z,MDPP 198N 707W,0,32,8,0,40
Tropical Storm,Odette,5,2003-12-05T15:00:00Z,TJPS 180N 666W,0,0,2,0,2
Tropical Storm,Odette,5,2003-12-05T15:00:00Z,MBJT 215N 712W,0,15,18,0,33
Tropical Storm,Odette,5,2003-12-05T15:00:00Z,MDSD 185N 697W,2,21,7,0,30
Tropical Storm,Odette,5,2003-12-05T15:00:00Z,MYMM 224N 730W,0,3,9,0,12
Tropical Storm,Odette,5,2003-12-05T15:00:00Z,MDCB 176N 714W,29,16,1,0,46
Tropical Storm,Odette,5,2003-12-05T15:00:00Z,SAN JUAN PR,0,0,2,0,2
Tropical Storm,Odette,5,2003-12-05T15:00:00Z,MTPP 186N 724W,13,32,1,0,46
Tropical Storm,Odette,5,2003-12-05T15:00:00Z,PONCE PR,0,0,2,0,2
Tropical Storm,Odette,5,2003-12-05T15:00:00Z,MTCA 183N 738W,13,23,0,0,36
Tropical Storm,Odette,6,2003-12-05T21:00:00Z,19.0N  71.5W,32,0,0,0,32
Tropical Storm,Odette,6,2003-12-05T21:00:00Z,MTCA 183N 738W,23,0,0,0,23
Tropical Storm,Odette,6,2003-12-05T21:00:00Z,21.0N  69.5W,3,13,2,0,18
Tropical Storm,Odette,6,2003-12-05T21:00:00Z,MUGM 200N 751W,3,2,0,0,5
Tropical Storm,Odette,6,2003-12-05T21:00:00Z,24.5N  65.0W,0,0,8,0,8
Tropical Storm,Odette,6,2003-12-05T21:00:00Z,TJSJ 184N 661W,0,4,7,0,11
Tropical Storm,Odette,6,2003-12-05T21:00:00Z,SVBS 157N 636W,0,0,2,0,2
Tropical Storm,Odette,6,2003-12-05T21:00:00Z,MDPP 198N 707W,19,4,1,0,24
Tropical Storm,Odette,6,2003-12-05T21:00:00Z,TKPK 173N 627W,0,0,2,0,2
Tropical Storm,Odette,6,2003-12-05T21:00:00Z,MBJT 215N 712W,5,12,1,0,18
Tropical Storm,Odette,6,2003-12-05T21:00:00Z,TNCM 181N 631W,0,0,3,0,3
Tropical Storm,Odette,6,2003-12-05T21:00:00Z,MYMM 224N 730W,2,9,1,0,12
Tropical Storm,Odette,6,2003-12-05T21:00:00Z,TISX 177N 648W,0,1,5,0,6
Tropical Storm,Odette,6,2003-12-05T21:00:00Z,MYSM 241N 745W,0,2,1,0,3
Tropical Storm,Odette,6,2003-12-05T21:00:00Z,TIST 183N 650W,0,2,5,0,7
Tropical Storm,Odette,6,2003-12-05T21:00:00Z,ST CROIX VI,0,1,5,0,6
Tropical Storm,Odette,6,2003-12-05T21:00:00Z,TJPS 180N 666W,0,6,5,0,11
Tropical Storm,Odette,6,2003-12-05T21:00:00Z,ST THOMAS VI,0,2,5,0,7
Tropical Storm,Odette,6,2003-12-05T21:00:00Z,MDSD 185N 697W,19,3,0,0,22
Tropical Storm,Odette,6,2003-12-05T21:00:00Z,SAN JUAN PR,0,4,7,0,11
Tropical Storm,Odette,6,2003-12-05T21:00:00Z,MDCB 176N 714W,44,0,0,0,44
Tropical Storm,Odette,6,2003-12-05T21:00:00Z,PONCE PR,0,6,5,0,11
Tropical Storm,Odette,6,2003-12-05T21:00:00Z,MTPP 186N 724W,35,1,0,0,36
Tropical Storm,Odette,7,2003-12-06T03:00:00Z,19.0N  70.6W,30,1,0,0,31
Tropical Storm,Odette,7,2003-12-06T03:00:00Z,MTCA 183N 738W,9,2,0,0,11
Tropical Storm,Odette,7,2003-12-06T03:00:00Z,22.0N  67.9W,1,16,5,0,22
Tropical Storm,Odette,7,2003-12-06T03:00:00Z,TJSJ 184N 661W,1,8,4,0,13
Tropical Storm,Odette,7,2003-12-06T03:00:00Z,27.5N  62.5W,0,0,8,0,8
Tropical Storm,Odette,7,2003-12-06T03:00:00Z,MDPP 198N 707W,23,4,0,0,27
Tropical Storm,Odette,7,2003-12-06T03:00:00Z,TNCM 181N 631W,0,1,2,0,3
Tropical Storm,Odette,7,2003-12-06T03:00:00Z,MBJT 215N 712W,6,12,1,0,19
Tropical Storm,Odette,7,2003-12-06T03:00:00Z,TISX 177N 648W,0,3,2,0,5
Tropical Storm,Odette,7,2003-12-06T03:00:00Z,MYMM 224N 730W,1,5,1,0,7
Tropical Storm,Odette,7,2003-12-06T03:00:00Z,TIST 183N 650W,0,4,4,0,8
Tropical Storm,Odette,7,2003-12-06T03:00:00Z,BERMUDA,0,0,3,0,3
Tropical Storm,Odette,7,2003-12-06T03:00:00Z,TJPS 180N 666W,2,9,3,0,14
Tropical Storm,Odette,7,2003-12-06T03:00:00Z,ST CROIX VI,0,3,2,0,5
Tropical Storm,Odette,7,2003-12-06T03:00:00Z,MDSD 185N 697W,29,1,0,0,30
Tropical Storm,Odette,7,2003-12-06T03:00:00Z,ST THOMAS VI,0,4,4,0,8
Tropical Storm,Odette,7,2003-12-06T03:00:00Z,MDCB 176N 714W,43,0,0,0,43
Tropical Storm,Odette,7,2003-12-06T03:00:00Z,SAN JUAN PR,1,8,4,0,13
Tropical Storm,Odette,7,2003-12-06T03:00:00Z,MTPP 186N 724W,25,0,0,0,25
Tropical Storm,Odette,7,2003-12-06T03:00:00Z,PONCE PR,2,9,3,0,14
Tropical Storm,Odette,8,2003-12-06T09:00:00Z,20.7N  69.3W,35,1,0,0,36
Tropical Storm,Odette,8,2003-12-06T09:00:00Z,MTCA 183N 738W,2,0,0,0,2
Tropical Storm,Odette,8,2003-12-06T09:00:00Z,24.2N  65.8W,0,18,2,0,20
Tropical Storm,Odette,8,2003-12-06T09:00:00Z,TJSJ 184N 661W,3,7,1,0,11
Tropical Storm,Odette,8,2003-12-06T09:00:00Z,28.5N  60.7W,0,0,10,0,10
Tropical Storm,Odette,8,2003-12-06T09:00:00Z,MDPP 198N 707W,42,0,0,0,42
Tropical Storm,Odette,8,2003-12-06T09:00:00Z,TNCM 181N 631W,0,1,2,0,3
Tropical Storm,Odette,8,2003-12-06T09:00:00Z,MBJT 215N 712W,19,2,0,0,21
Tropical Storm,Odette,8,2003-12-06T09:00:00Z,TISX 177N 648W,0,3,1,0,4
Tropical Storm,Odette,8,2003-12-06T09:00:00Z,MYMM 224N 730W,1,1,0,0,2
Tropical Storm,Odette,8,2003-12-06T09:00:00Z,TIST 183N 650W,0,5,1,0,6
Tropical Storm,Odette,8,2003-12-06T09:00:00Z,BERMUDA,0,0,4,0,4
Tropical Storm,Odette,8,2003-12-06T09:00:00Z,TJPS 180N 666W,4,6,0,0,10
Tropical Storm,Odette,8,2003-12-06T09:00:00Z,ST CROIX VI,0,3,1,0,4
Tropical Storm,Odette,8,2003-12-06T09:00:00Z,MDSD 185N 697W,46,0,0,0,46
Tropical Storm,Odette,8,2003-12-06T09:00:00Z,ST THOMAS VI,0,5,1,0,6
Tropical Storm,Odette,8,2003-12-06T09:00:00Z,MDCB 176N 714W,75,0,0,0,75
Tropical Storm,Odette,8,2003-12-06T09:00:00Z,SAN JUAN PR,3,7,1,0,11
Tropical Storm,Odette,8,2003-12-06T09:00:00Z,MTPP 186N 724W,38,0,0,0,38
Tropical Storm,Odette,8,2003-12-06T09:00:00Z,PONCE PR,4,6,0,0,10
Tropical Storm,Odette,9,2003-12-06T15:00:00Z,21.2N  68.7W,34,3,0,0,37
Tropical Storm,Odette,9,2003-12-06T15:00:00Z,MTCA 183N 738W,3,0,0,0,3
Tropical Storm,Odette,9,2003-12-06T15:00:00Z,25.5N  64.0W,0,17,3,0,20
Tropical Storm,Odette,9,2003-12-06T15:00:00Z,TJSJ 184N 661W,5,4,0,0,9
Tropical Storm,Odette,9,2003-12-06T15:00:00Z,29.5N  58.4W,0,0,11,0,11
Tropical Storm,Odette,9,2003-12-06T15:00:00Z,MDPP 198N 707W,54,0,0,0,54
Tropical Storm,Odette,9,2003-12-06T15:00:00Z,TISX 177N 648W,1,1,0,0,2
Tropical Storm,Odette,9,2003-12-06T15:00:00Z,MBJT 215N 712W,21,1,0,0,22
Tropical Storm,Odette,9,2003-12-06T15:00:00Z,TIST 183N 650W,1,3,0,0,4
Tropical Storm,Odette,9,2003-12-06T15:00:00Z,BERMUDA,0,0,3,0,3
Tropical Storm,Odette,9,2003-12-06T15:00:00Z,TJPS 180N 666W,6,2,0,0,8
Tropical Storm,Odette,9,2003-12-06T15:00:00Z,ST CROIX VI,1,1,0,0,2
Tropical Storm,Odette,9,2003-12-06T15:00:00Z,MDSD 185N 697W,54,0,0,0,54
Tropical Storm,Odette,9,2003-12-06T15:00:00Z,ST THOMAS VI,1,3,0,0,4
Tropical Storm,Odette,9,2003-12-06T15:00:00Z,MDCB 176N 714W,99,0,0,0,99
Tropical Storm,Odette,9,2003-12-06T15:00:00Z,SAN JUAN PR,5,4,0,0,9
Tropical Storm,Odette,9,2003-12-06T15:00:00Z,MTPP 186N 724W,60,0,0,0,60
Tropical Storm,Odette,9,2003-12-06T15:00:00Z,PONCE PR,6,2,0,0,8
Tropical Storm,Odette,10,2003-12-06T21:00:00Z,21.5N  68.5W,39,2,0,0,41
Tropical Storm,Odette,10,2003-12-06T21:00:00Z,MTCA 183N 738W,21,0,0,0,21
Tropical Storm,Odette,10,2003-12-06T21:00:00Z,24.5N  64.5W,0,18,4,0,22
Tropical Storm,Odette,10,2003-12-06T21:00:00Z,TJSJ 184N 661W,2,4,0,0,6
Tropical Storm,Odette,10,2003-12-06T21:00:00Z,27.5N  59.5W,0,0,11,0,11
Tropical Storm,Odette,10,2003-12-06T21:00:00Z,MDPP 198N 707W,66,0,0,0,66
Tropical Storm,Odette,10,2003-12-06T21:00:00Z,TNCM 181N 631W,0,1,1,0,2
Tropical Storm,Odette,10,2003-12-06T21:00:00Z,MBJT 215N 712W,28,1,0,0,29
Tropical Storm,Odette,10,2003-12-06T21:00:00Z,TISX 177N 648W,0,2,0,0,2
Tropical Storm,Odette,10,2003-12-06T21:00:00Z,BERMUDA,0,0,2,0,2
Tropical Storm,Odette,10,2003-12-06T21:00:00Z,TIST 183N 650W,0,3,1,0,4
Tropical Storm,Odette,10,2003-12-06T21:00:00Z,ST CROIX VI,0,2,0,0,2
Tropical Storm,Odette,10,2003-12-06T21:00:00Z,TJPS 180N 666W,2,2,0,0,4
Tropical Storm,Odette,10,2003-12-06T21:00:00Z,ST THOMAS VI,0,3,1,0,4
Tropical Storm,Odette,10,2003-12-06T21:00:00Z,MDSD 185N 697W,50,0,0,0,50
Tropical Storm,Odette,10,2003-12-06T21:00:00Z,SAN JUAN PR,2,4,0,0,6
Tropical Storm,Odette,10,2003-12-06T21:00:00Z,MDCB 176N 714W,99,0,0,0,99
Tropical Storm,Odette,10,2003-12-06T21:00:00Z,PONCE PR,2,2,0,0,4
Tropical Storm,Odette,10,2003-12-06T21:00:00Z,MTPP 186N 724W,74,0,0,0,74
Tropical Storm,Odette,11,2003-12-07T03:00:00Z,23.0N  66.5W,35,3,0,0,38
Tropical Storm,Odette,11,2003-12-07T03:00:00Z,TJSJ 184N 661W,2,1,0,0,3
Tropical Storm,Odette,11,2003-12-07T03:00:00Z,25.8N  62.3W,0,20,2,0,22
Tropical Storm,Odette,11,2003-12-07T03:00:00Z,MDPP 198N 707W,68,0,0,0,68
Tropical Storm,Odette,11,2003-12-07T03:00:00Z,29.0N  57.0W,0,0,12,2,14
Tropical Storm,Odette,11,2003-12-07T03:00:00Z,MBJT 215N 712W,15,0,0,0,15
Tropical Storm,Odette,11,2003-12-07T03:00:00Z,TJPS 180N 666W,2,0,0,0,2
Tropical Storm,Odette,11,2003-12-07T03:00:00Z,BERMUDA,0,0,2,0,2
Tropical Storm,Odette,11,2003-12-07T03:00:00Z,MDSD 185N 697W,70,0,0,0,70
Tropical Storm,Odette,11,2003-12-07T03:00:00Z,SAN JUAN PR,2,1,0,0,3
Tropical Storm,Odette,11,2003-12-07T03:00:00Z,MDCB 176N 714W,99,0,0,0,99
Tropical Storm,Odette,11,2003-12-07T03:00:00Z,PONCE PR,2,0,0,0,2
Tropical Storm,Odette,11,2003-12-07T03:00:00Z,MTPP 186N 724W,45,0,0,0,45
Tropical Storm,Odette,12,2003-12-07T09:00:00Z,24.0N  65.0W,33,3,0,0,36
Tropical Storm,Odette,12,2003-12-07T09:00:00Z,MDCB 176N 714W,5,0,0,0,5
Tropical Storm,Odette,12,2003-12-07T09:00:00Z,26.7N  60.4W,0,19,2,0,21
Tropical Storm,Odette,12,2003-12-07T09:00:00Z,MTPP 186N 724W,4,0,0,0,4
Tropical Storm,Odette,12,2003-12-07T09:00:00Z,29.0N  55.0W,0,0,12,2,14
Tropical Storm,Odette,12,2003-12-07T09:00:00Z,MDPP 198N 707W,99,0,0,0,99
Tropical Storm,Odette,12,2003-12-07T09:00:00Z,MDSD 185N 697W,99,0,0,0,99
Tropical Storm,Peter,1,2003-12-09T15:00:00Z,23.5N  34.5W,31,1,0,0,32
Tropical Storm,Peter,1,2003-12-09T15:00:00Z,25.5N  32.5W,5,13,0,0,18
Tropical Storm,Peter,2,2003-12-09T17:00:00Z,23.5N  34.5W,31,1,0,0,32
Tropical Storm,Peter,2,2003-12-09T17:00:00Z,25.5N  32.5W,5,13,0,0,18
Tropical Storm,Peter,3,2003-12-09T21:00:00Z,26.0N  35.3W,34,1,0,0,35
Tropical Storm,Peter,3,2003-12-09T21:00:00Z,29.3N  32.0W,0,19,0,0,19
Tropical Storm,Peter,4,2003-12-10T03:00:00Z,28.1N  36.0W,32,0,0,0,32
Tropical Depression,Peter,5,2003-12-10T09:00:00Z,29.4N  33.9W,36,0,0,0,36
Tropical Depression,Peter,6,2003-12-10T15:00:00Z,30.0N  34.0W,34,0,0,0,34
Tropical Depression,One,1,2004-07-31T21:00:00Z,32.9N  79.2W,47,0,0,0,47
Tropical Depression,One,1,2004-07-31T21:00:00Z,NORFOLK VA,0,1,10,5,16
Tropical Depression,One,1,2004-07-31T21:00:00Z,34.0N  78.0W,17,7,1,0,25
Tropical Depression,One,1,2004-07-31T21:00:00Z,OCEAN CITY MD,0,0,3,9,12
Tropical Depression,One,1,2004-07-31T21:00:00Z,35.2N  76.6W,0,12,5,2,19
Tropical Depression,One,1,2004-07-31T21:00:00Z,ATLANTIC CITY NJ,0,0,1,9,10
Tropical Depression,One,1,2004-07-31T21:00:00Z,JACKSONVILLE FL,2,0,0,1,3
Tropical Depression,One,1,2004-07-31T21:00:00Z,NEW YORK CITY NY,0,0,0,7,7
Tropical Depression,One,1,2004-07-31T21:00:00Z,SAVANNAH GA,26,0,0,0,26
Tropical Depression,One,1,2004-07-31T21:00:00Z,MONTAUK POINT NY,0,0,0,5,5
Tropical Depression,One,1,2004-07-31T21:00:00Z,CHARLESTON SC,45,0,0,0,45
Tropical Depression,One,1,2004-07-31T21:00:00Z,PROVIDENCE RI,0,0,0,3,3
Tropical Depression,One,1,2004-07-31T21:00:00Z,MYRTLE BEACH SC,30,1,0,0,31
Tropical Depression,One,1,2004-07-31T21:00:00Z,NANTUCKET MA,0,0,0,3,3
Tropical Depression,One,1,2004-07-31T21:00:00Z,WILMINGTON NC,12,10,2,0,24
Tropical Depression,One,1,2004-07-31T21:00:00Z,HYANNIS MA,0,0,0,3,3
Tropical Depression,One,1,2004-07-31T21:00:00Z,MOREHEAD CITY NC,2,13,4,1,20
Tropical Depression,One,1,2004-07-31T21:00:00Z,BOSTON MA,0,0,0,2,2
Tropical Depression,One,1,2004-07-31T21:00:00Z,CAPE HATTERAS NC,0,7,8,3,18
Tropical Depression,One,2,2004-08-01T03:00:00Z,33.5N  79.0W,32,1,0,0,33
Tropical Depression,One,2,2004-08-01T03:00:00Z,OCEAN CITY MD,0,0,6,7,13
Tropical Depression,One,2,2004-08-01T03:00:00Z,34.5N  77.5W,13,6,2,0,21
Tropical Depression,One,2,2004-08-01T03:00:00Z,ATLANTIC CITY NJ,0,0,2,10,12
Tropical Depression,One,2,2004-08-01T03:00:00Z,36.0N  75.0W,0,3,10,3,16
Tropical Depression,One,2,2004-08-01T03:00:00Z,NEW YORK CITY NY,0,0,0,10,10
Tropical Depression,One,2,2004-08-01T03:00:00Z,BERMUDA,0,0,0,3,3
Tropical Depression,One,2,2004-08-01T03:00:00Z,MONTAUK POINT NY,0,0,0,9,9
Tropical Depression,One,2,2004-08-01T03:00:00Z,JACKSONVILLE FL,3,1,0,0,4
Tropical Depression,One,2,2004-08-01T03:00:00Z,PROVIDENCE RI,0,0,0,8,8
Tropical Depression,One,2,2004-08-01T03:00:00Z,SAVANNAH GA,30,1,0,0,31
Tropical Depression,One,2,2004-08-01T03:00:00Z,NANTUCKET MA,0,0,0,7,7
Tropical Depression,One,2,2004-08-01T03:00:00Z,CHARLESTON SC,46,0,0,1,47
Tropical Depression,One,2,2004-08-01T03:00:00Z,HYANNIS MA,0,0,0,7,7
Tropical Depression,One,2,2004-08-01T03:00:00Z,MYRTLE BEACH SC,30,1,0,0,31
Tropical Depression,One,2,2004-08-01T03:00:00Z,BOSTON MA,0,0,0,6,6
Tropical Depression,One,2,2004-08-01T03:00:00Z,WILMINGTON NC,18,4,1,0,23
Tropical Depression,One,2,2004-08-01T03:00:00Z,PORTLAND ME,0,0,0,4,4
Tropical Depression,One,2,2004-08-01T03:00:00Z,MOREHEAD CITY NC,6,9,4,1,20
Tropical Depression,One,2,2004-08-01T03:00:00Z,BAR HARBOR ME,0,0,0,3,3
Tropical Depression,One,2,2004-08-01T03:00:00Z,CAPE HATTERAS NC,1,7,8,2,18
Tropical Depression,One,2,2004-08-01T03:00:00Z,YARMOUTH NS,0,0,0,2,2
Tropical Depression,One,2,2004-08-01T03:00:00Z,NORFOLK VA,0,3,10,3,16
Tropical Depression,One,3,2004-08-01T09:00:00Z,34.0N  78.2W,28,1,0,0,29
Tropical Depression,One,3,2004-08-01T09:00:00Z,OCEAN CITY MD,0,0,5,9,14
Tropical Depression,One,3,2004-08-01T09:00:00Z,34.8N  77.0W,7,11,2,1,21
Tropical Depression,One,3,2004-08-01T09:00:00Z,ATLANTIC CITY NJ,0,0,1,11,12
Tropical Depression,One,3,2004-08-01T09:00:00Z,35.7N  75.5W,0,6,8,3,17
Tropical Depression,One,3,2004-08-01T09:00:00Z,NEW YORK CITY NY,0,0,0,11,11
Tropical Depression,One,3,2004-08-01T09:00:00Z,BERMUDA,0,0,0,2,2
Tropical Depression,One,3,2004-08-01T09:00:00Z,MONTAUK POINT NY,0,0,0,9,9
Tropical Depression,One,3,2004-08-01T09:00:00Z,SAVANNAH GA,17,0,0,0,17
Tropical Depression,One,3,2004-08-01T09:00:00Z,PROVIDENCE RI,0,0,0,8,8
Tropical Depression,One,3,2004-08-01T09:00:00Z,CHARLESTON SC,61,0,0,0,61
Tropical Depression,One,3,2004-08-01T09:00:00Z,NANTUCKET MA,0,0,0,8,8
Tropical Depression,One,3,2004-08-01T09:00:00Z,MYRTLE BEACH SC,38,0,1,0,39
Tropical Depression,One,3,2004-08-01T09:00:00Z,HYANNIS MA,0,0,0,7,7
Tropical Depression,One,3,2004-08-01T09:00:00Z,WILMINGTON NC,22,3,1,0,26
Tropical Depression,One,3,2004-08-01T09:00:00Z,BOSTON MA,0,0,0,7,7
Tropical Depression,One,3,2004-08-01T09:00:00Z,MOREHEAD CITY NC,6,11,3,1,21
Tropical Depression,One,3,2004-08-01T09:00:00Z,PORTLAND ME,0,0,0,4,4
Tropical Depression,One,3,2004-08-01T09:00:00Z,CAPE HATTERAS NC,0,8,7,3,18
Tropical Depression,One,3,2004-08-01T09:00:00Z,BAR HARBOR ME,0,0,0,2,2
Tropical Depression,One,3,2004-08-01T09:00:00Z,NORFOLK VA,0,4,9,4,17
Tropical Depression,One,3,2004-08-01T09:00:00Z,YARMOUTH NS,0,0,0,2,2
Tropical Depression,One,4,2004-08-01T15:00:00Z,34.1N  77.8W,38,1,0,0,39
Tropical Depression,One,4,2004-08-01T15:00:00Z,ATLANTIC CITY NJ,0,0,9,6,15
Tropical Depression,One,4,2004-08-01T15:00:00Z,35.1N  76.2W,5,17,2,1,25
Tropical Depression,One,4,2004-08-01T15:00:00Z,NEW YORK CITY NY,0,0,4,9,13
Tropical Depression,One,4,2004-08-01T15:00:00Z,36.5N  74.0W,0,3,13,3,19
Tropical Depression,One,4,2004-08-01T15:00:00Z,MONTAUK POINT NY,0,0,1,11,12
Tropical Depression,One,4,2004-08-01T15:00:00Z,BERMUDA,0,0,0,2,2
Tropical Depression,One,4,2004-08-01T15:00:00Z,PROVIDENCE RI,0,0,0,11,11
Tropical Depression,One,4,2004-08-01T15:00:00Z,SAVANNAH GA,7,1,1,0,9
Tropical Depression,One,4,2004-08-01T15:00:00Z,NANTUCKET MA,0,0,0,11,11
Tropical Depression,One,4,2004-08-01T15:00:00Z,CHARLESTON SC,99,0,0,0,99
Tropical Depression,One,4,2004-08-01T15:00:00Z,HYANNIS MA,0,0,0,11,11
Tropical Depression,One,4,2004-08-01T15:00:00Z,MYRTLE BEACH SC,62,0,0,0,62
Tropical Depression,One,4,2004-08-01T15:00:00Z,BOSTON MA,0,0,0,10,10
Tropical Depression,One,4,2004-08-01T15:00:00Z,WILMINGTON NC,38,0,0,0,38
Tropical Depression,One,4,2004-08-01T15:00:00Z,PORTLAND ME,0,0,0,8,8
Tropical Depression,One,4,2004-08-01T15:00:00Z,MOREHEAD CITY NC,15,11,1,0,27
Tropical Depression,One,4,2004-08-01T15:00:00Z,BAR HARBOR ME,0,0,0,6,6
Tropical Depression,One,4,2004-08-01T15:00:00Z,CAPE HATTERAS NC,1,16,5,0,22
Tropical Depression,One,4,2004-08-01T15:00:00Z,EASTPORT ME,0,0,0,4,4
Tropical Depression,One,4,2004-08-01T15:00:00Z,NORFOLK VA,0,14,6,1,21
Tropical Depression,One,4,2004-08-01T15:00:00Z,ST JOHN NB,0,0,0,3,3
Tropical Depression,One,4,2004-08-01T15:00:00Z,OCEAN CITY MD,0,3,12,3,18
Tropical Depression,One,4,2004-08-01T15:00:00Z,YARMOUTH NS,0,0,0,4,4
Tropical Storm,Alex,5,2004-08-01T21:00:00Z,33.5N  77.8W,32,0,0,1,33
Tropical Storm,Alex,5,2004-08-01T21:00:00Z,MONTAUK POINT NY,0,0,2,9,11
Tropical Storm,Alex,5,2004-08-01T21:00:00Z,34.7N  75.7W,4,16,2,0,22
Tropical Storm,Alex,5,2004-08-01T21:00:00Z,PROVIDENCE RI,0,0,1,10,11
Tropical Storm,Alex,5,2004-08-01T21:00:00Z,36.5N  72.5W,0,1,11,4,16
Tropical Storm,Alex,5,2004-08-01T21:00:00Z,NANTUCKET MA,0,0,0,11,11
Tropical Storm,Alex,5,2004-08-01T21:00:00Z,BERMUDA,0,0,0,4,4
Tropical Storm,Alex,5,2004-08-01T21:00:00Z,HYANNIS MA,0,0,0,10,10
Tropical Storm,Alex,5,2004-08-01T21:00:00Z,SAVANNAH GA,18,0,0,0,18
Tropical Storm,Alex,5,2004-08-01T21:00:00Z,BOSTON MA,0,0,0,10,10
Tropical Storm,Alex,5,2004-08-01T21:00:00Z,CHARLESTON SC,42,0,0,0,42
Tropical Storm,Alex,5,2004-08-01T21:00:00Z,PORTLAND ME,0,0,0,8,8
Tropical Storm,Alex,5,2004-08-01T21:00:00Z,MYRTLE BEACH SC,35,0,0,0,35
Tropical Storm,Alex,5,2004-08-01T21:00:00Z,BAR HARBOR ME,0,0,0,7,7
Tropical Storm,Alex,5,2004-08-01T21:00:00Z,WILMINGTON NC,25,4,0,0,29
Tropical Storm,Alex,5,2004-08-01T21:00:00Z,EASTPORT ME,0,0,0,6,6
Tropical Storm,Alex,5,2004-08-01T21:00:00Z,MOREHEAD CITY NC,11,12,1,0,24
Tropical Storm,Alex,5,2004-08-01T21:00:00Z,ST JOHN NB,0,0,0,5,5
Tropical Storm,Alex,5,2004-08-01T21:00:00Z,CAPE HATTERAS NC,2,15,4,0,21
Tropical Storm,Alex,5,2004-08-01T21:00:00Z,MONCTON NB,0,0,0,4,4
Tropical Storm,Alex,5,2004-08-01T21:00:00Z,NORFOLK VA,0,11,7,1,19
Tropical Storm,Alex,5,2004-08-01T21:00:00Z,YARMOUTH NS,0,0,0,7,7
Tropical Storm,Alex,5,2004-08-01T21:00:00Z,OCEAN CITY MD,0,2,12,1,15
Tropical Storm,Alex,5,2004-08-01T21:00:00Z,HALIFAX NS,0,0,0,4,4
Tropical Storm,Alex,5,2004-08-01T21:00:00Z,ATLANTIC CITY NJ,0,0,9,4,13
Tropical Storm,Alex,5,2004-08-01T21:00:00Z,SABLE ISLAND NS,0,0,0,2,2
Tropical Storm,Alex,5,2004-08-01T21:00:00Z,NEW YORK CITY NY,0,0,5,6,11
Tropical Storm,Alex,5,2004-08-01T21:00:00Z,EDDY POINT NS,0,0,0,2,2
Tropical Storm,Alex,6,2004-08-02T03:00:00Z,33.1N  77.5W,32,1,0,1,34
Tropical Storm,Alex,6,2004-08-02T03:00:00Z,NANTUCKET MA,0,0,3,10,13
Tropical Storm,Alex,6,2004-08-02T03:00:00Z,34.7N  74.9W,0,20,4,0,24
Tropical Storm,Alex,6,2004-08-02T03:00:00Z,HYANNIS MA,0,0,2,10,12
Tropical Storm,Alex,6,2004-08-02T03:00:00Z,36.7N  71.6W,0,1,14,4,19
Tropical Storm,Alex,6,2004-08-02T03:00:00Z,BOSTON MA,0,0,2,8,10
Tropical Storm,Alex,6,2004-08-02T03:00:00Z,BERMUDA,0,0,0,4,4
Tropical Storm,Alex,6,2004-08-02T03:00:00Z,PORTLAND ME,0,0,1,7,8
Tropical Storm,Alex,6,2004-08-02T03:00:00Z,SAVANNAH GA,61,0,0,0,61
Tropical Storm,Alex,6,2004-08-02T03:00:00Z,BAR HARBOR ME,0,0,0,8,8
Tropical Storm,Alex,6,2004-08-02T03:00:00Z,CHARLESTON SC,39,0,0,0,39
Tropical Storm,Alex,6,2004-08-02T03:00:00Z,EASTPORT ME,0,0,0,8,8
Tropical Storm,Alex,6,2004-08-02T03:00:00Z,MYRTLE BEACH SC,29,0,0,1,30
Tropical Storm,Alex,6,2004-08-02T03:00:00Z,ST JOHN NB,0,0,0,7,7
Tropical Storm,Alex,6,2004-08-02T03:00:00Z,WILMINGTON NC,22,6,0,0,28
Tropical Storm,Alex,6,2004-08-02T03:00:00Z,MONCTON NB,0,0,0,6,6
Tropical Storm,Alex,6,2004-08-02T03:00:00Z,MOREHEAD CITY NC,9,17,1,0,27
Tropical Storm,Alex,6,2004-08-02T03:00:00Z,YARMOUTH NS,0,0,0,10,10
Tropical Storm,Alex,6,2004-08-02T03:00:00Z,CAPE HATTERAS NC,1,21,2,0,24
Tropical Storm,Alex,6,2004-08-02T03:00:00Z,HALIFAX NS,0,0,0,8,8
Tropical Storm,Alex,6,2004-08-02T03:00:00Z,NORFOLK VA,0,13,4,0,17
Tropical Storm,Alex,6,2004-08-02T03:00:00Z,SABLE ISLAND NS,0,0,0,6,6
Tropical Storm,Alex,6,2004-08-02T03:00:00Z,OCEAN CITY MD,0,5,8,1,14
Tropical Storm,Alex,6,2004-08-02T03:00:00Z,SYDNEY NS,0,0,0,4,4
Tropical Storm,Alex,6,2004-08-02T03:00:00Z,ATLANTIC CITY NJ,0,1,8,3,12
Tropical Storm,Alex,6,2004-08-02T03:00:00Z,EDDY POINT NS,0,0,0,6,6
Tropical Storm,Alex,6,2004-08-02T03:00:00Z,NEW YORK CITY NY,0,0,6,4,10
Tropical Storm,Alex,6,2004-08-02T03:00:00Z,PTX BASQUES NFLD,0,0,0,2,2
Tropical Storm,Alex,6,2004-08-02T03:00:00Z,MONTAUK POINT NY,0,0,5,7,12
Tropical Storm,Alex,6,2004-08-02T03:00:00Z,BURGEO NFLD,0,0,0,2,2
Tropical Storm,Alex,6,2004-08-02T03:00:00Z,PROVIDENCE RI,0,0,3,8,11
Tropical Storm,Alex,6,2004-08-02T03:00:00Z,ILE ST PIERRE,0,0,0,2,2
Tropical Storm,Alex,7,2004-08-02T09:00:00Z,33.4N  77.3W,30,4,0,0,34
Tropical Storm,Alex,7,2004-08-02T09:00:00Z,NANTUCKET MA,0,0,4,10,14
Tropical Storm,Alex,7,2004-08-02T09:00:00Z,35.3N  74.3W,0,19,5,0,24
Tropical Storm,Alex,7,2004-08-02T09:00:00Z,HYANNIS MA,0,0,4,9,13
Tropical Storm,Alex,7,2004-08-02T09:00:00Z,37.5N  70.5W,0,0,14,5,19
Tropical Storm,Alex,7,2004-08-02T09:00:00Z,BOSTON MA,0,0,3,8,11
Tropical Storm,Alex,7,2004-08-02T09:00:00Z,BERMUDA,0,0,0,3,3
Tropical Storm,Alex,7,2004-08-02T09:00:00Z,PORTLAND ME,0,0,1,8,9
Tropical Storm,Alex,7,2004-08-02T09:00:00Z,SAVANNAH GA,11,0,0,0,11
Tropical Storm,Alex,7,2004-08-02T09:00:00Z,BAR HARBOR ME,0,0,0,9,9
Tropical Storm,Alex,7,2004-08-02T09:00:00Z,CHARLESTON SC,50,0,0,0,50
Tropical Storm,Alex,7,2004-08-02T09:00:00Z,EASTPORT ME,0,0,0,9,9
Tropical Storm,Alex,7,2004-08-02T09:00:00Z,MYRTLE BEACH SC,34,0,1,0,35
Tropical Storm,Alex,7,2004-08-02T09:00:00Z,ST JOHN NB,0,0,0,9,9
Tropical Storm,Alex,7,2004-08-02T09:00:00Z,WILMINGTON NC,25,5,0,0,30
Tropical Storm,Alex,7,2004-08-02T09:00:00Z,MONCTON NB,0,0,0,8,8
Tropical Storm,Alex,7,2004-08-02T09:00:00Z,MOREHEAD CITY NC,9,20,0,0,29
Tropical Storm,Alex,7,2004-08-02T09:00:00Z,YARMOUTH NS,0,0,0,12,12
Tropical Storm,Alex,7,2004-08-02T09:00:00Z,CAPE HATTERAS NC,1,24,1,0,26
Tropical Storm,Alex,7,2004-08-02T09:00:00Z,HALIFAX NS,0,0,0,10,10
Tropical Storm,Alex,7,2004-08-02T09:00:00Z,NORFOLK VA,0,17,2,1,20
Tropical Storm,Alex,7,2004-08-02T09:00:00Z,SABLE ISLAND NS,0,0,0,9,9
Tropical Storm,Alex,7,2004-08-02T09:00:00Z,OCEAN CITY MD,0,7,9,0,16
Tropical Storm,Alex,7,2004-08-02T09:00:00Z,SYDNEY NS,0,0,0,6,6
Tropical Storm,Alex,7,2004-08-02T09:00:00Z,ATLANTIC CITY NJ,0,2,10,1,13
Tropical Storm,Alex,7,2004-08-02T09:00:00Z,EDDY POINT NS,0,0,0,8,8
Tropical Storm,Alex,7,2004-08-02T09:00:00Z,NEW YORK CITY NY,0,1,8,2,11
Tropical Storm,Alex,7,2004-08-02T09:00:00Z,PTX BASQUES NFLD,0,0,0,4,4
Tropical Storm,Alex,7,2004-08-02T09:00:00Z,MONTAUK POINT NY,0,0,7,6,13
Tropical Storm,Alex,7,2004-08-02T09:00:00Z,BURGEO NFLD,0,0,0,3,3
Tropical Storm,Alex,7,2004-08-02T09:00:00Z,PROVIDENCE RI,0,0,5,7,12
Tropical Storm,Alex,7,2004-08-02T09:00:00Z,ILE ST PIERRE,0,0,0,2,2
Tropical Storm,Alex,8,2004-08-02T12:00:00Z,33.4N  77.3W,32,6,0,0,38
Tropical Storm,Alex,8,2004-08-02T12:00:00Z,NANTUCKET MA,0,0,5,9,14
Tropical Storm,Alex,8,2004-08-02T12:00:00Z,35.3N  74.3W,0,23,5,0,28
Tropical Storm,Alex,8,2004-08-02T12:00:00Z,HYANNIS MA,0,0,4,9,13
Tropical Storm,Alex,8,2004-08-02T12:00:00Z,37.5N  70.5W,0,1,16,5,22
Tropical Storm,Alex,8,2004-08-02T12:00:00Z,BOSTON MA,0,0,2,6,8
Tropical Storm,Alex,8,2004-08-02T12:00:00Z,BERMUDA,0,0,0,2,2
Tropical Storm,Alex,8,2004-08-02T12:00:00Z,PORTLAND ME,0,0,1,4,5
Tropical Storm,Alex,8,2004-08-02T12:00:00Z,SAVANNAH GA,4,1,0,0,5
Tropical Storm,Alex,8,2004-08-02T12:00:00Z,BAR HARBOR ME,0,0,0,7,7
Tropical Storm,Alex,8,2004-08-02T12:00:00Z,CHARLESTON SC,42,0,0,0,42
Tropical Storm,Alex,8,2004-08-02T12:00:00Z,EASTPORT ME,0,0,0,7,7
Tropical Storm,Alex,8,2004-08-02T12:00:00Z,MYRTLE BEACH SC,38,0,0,0,38
Tropical Storm,Alex,8,2004-08-02T12:00:00Z,ST JOHN NB,0,0,0,7,7
Tropical Storm,Alex,8,2004-08-02T12:00:00Z,WILMINGTON NC,30,6,0,0,36
Tropical Storm,Alex,8,2004-08-02T12:00:00Z,MONCTON NB,0,0,0,6,6
Tropical Storm,Alex,8,2004-08-02T12:00:00Z,MOREHEAD CITY NC,14,20,0,0,34
Tropical Storm,Alex,8,2004-08-02T12:00:00Z,YARMOUTH NS,0,0,0,11,11
Tropical Storm,Alex,8,2004-08-02T12:00:00Z,CAPE HATTERAS NC,2,28,1,0,31
Tropical Storm,Alex,8,2004-08-02T12:00:00Z,HALIFAX NS,0,0,0,10,10
Tropical Storm,Alex,8,2004-08-02T12:00:00Z,NORFOLK VA,0,17,4,0,21
Tropical Storm,Alex,8,2004-08-02T12:00:00Z,SABLE ISLAND NS,0,0,0,9,9
Tropical Storm,Alex,8,2004-08-02T12:00:00Z,OCEAN CITY MD,0,7,8,1,16
Tropical Storm,Alex,8,2004-08-02T12:00:00Z,SYDNEY NS,0,0,0,6,6
Tropical Storm,Alex,8,2004-08-02T12:00:00Z,ATLANTIC CITY NJ,0,2,7,2,11
Tropical Storm,Alex,8,2004-08-02T12:00:00Z,EDDY POINT NS,0,0,0,8,8
Tropical Storm,Alex,8,2004-08-02T12:00:00Z,NEW YORK CITY NY,0,0,5,3,8
Tropical Storm,Alex,8,2004-08-02T12:00:00Z,PTX BASQUES NFLD,0,0,0,4,4
Tropical Storm,Alex,8,2004-08-02T12:00:00Z,MONTAUK POINT NY,0,0,5,7,12
Tropical Storm,Alex,8,2004-08-02T12:00:00Z,BURGEO NFLD,0,0,0,3,3
Tropical Storm,Alex,8,2004-08-02T12:00:00Z,PROVIDENCE RI,0,0,4,6,10
Tropical Storm,Alex,8,2004-08-02T12:00:00Z,ILE ST PIERRE,0,0,0,2,2
Tropical Storm,Alex,9,2004-08-02T15:00:00Z,33.8N  76.0W,32,7,0,0,39
Tropical Storm,Alex,9,2004-08-02T15:00:00Z,BOSTON MA,0,0,2,3,5
Tropical Storm,Alex,9,2004-08-02T15:00:00Z,35.8N  73.0W,0,23,6,0,29
Tropical Storm,Alex,9,2004-08-02T15:00:00Z,PORTLAND ME,0,0,1,2,3
Tropical Storm,Alex,9,2004-08-02T15:00:00Z,38.0N  69.0W,0,1,16,7,24
Tropical Storm,Alex,9,2004-08-02T15:00:00Z,BAR HARBOR ME,0,0,0,4,4
Tropical Storm,Alex,9,2004-08-02T15:00:00Z,CHARLESTON SC,27,0,0,0,27
Tropical Storm,Alex,9,2004-08-02T15:00:00Z,EASTPORT ME,0,0,0,5,5
Tropical Storm,Alex,9,2004-08-02T15:00:00Z,MYRTLE BEACH SC,37,0,0,0,37
Tropical Storm,Alex,9,2004-08-02T15:00:00Z,ST JOHN NB,0,0,0,6,6
Tropical Storm,Alex,9,2004-08-02T15:00:00Z,WILMINGTON NC,37,0,0,0,37
Tropical Storm,Alex,9,2004-08-02T15:00:00Z,MONCTON NB,0,0,0,5,5
Tropical Storm,Alex,9,2004-08-02T15:00:00Z,MOREHEAD CITY NC,30,6,0,0,36
Tropical Storm,Alex,9,2004-08-02T15:00:00Z,YARMOUTH NS,0,0,1,10,11
Tropical Storm,Alex,9,2004-08-02T15:00:00Z,CAPE HATTERAS NC,13,20,0,0,33
Tropical Storm,Alex,9,2004-08-02T15:00:00Z,HALIFAX NS,0,0,0,11,11
Tropical Storm,Alex,9,2004-08-02T15:00:00Z,NORFOLK VA,2,15,2,0,19
Tropical Storm,Alex,9,2004-08-02T15:00:00Z,SABLE ISLAND NS,0,0,0,13,13
Tropical Storm,Alex,9,2004-08-02T15:00:00Z,OCEAN CITY MD,0,8,5,1,14
Tropical Storm,Alex,9,2004-08-02T15:00:00Z,SYDNEY NS,0,0,0,8,8
Tropical Storm,Alex,9,2004-08-02T15:00:00Z,ATLANTIC CITY NJ,0,2,5,1,8
Tropical Storm,Alex,9,2004-08-02T15:00:00Z,EDDY POINT NS,0,0,0,10,10
Tropical Storm,Alex,9,2004-08-02T15:00:00Z,NEW YORK CITY NY,0,1,3,1,5
Tropical Storm,Alex,9,2004-08-02T15:00:00Z,PTX BASQUES NFLD,0,0,0,5,5
Tropical Storm,Alex,9,2004-08-02T15:00:00Z,MONTAUK POINT NY,0,0,6,3,9
Tropical Storm,Alex,9,2004-08-02T15:00:00Z,BURGEO NFLD,0,0,0,5,5
Tropical Storm,Alex,9,2004-08-02T15:00:00Z,PROVIDENCE RI,0,0,4,3,7
Tropical Storm,Alex,9,2004-08-02T15:00:00Z,ILE ST PIERRE,0,0,0,6,6
Tropical Storm,Alex,9,2004-08-02T15:00:00Z,NANTUCKET MA,0,0,7,7,14
Tropical Storm,Alex,9,2004-08-02T15:00:00Z,CAPE RACE NFLD,0,0,0,3,3
Tropical Storm,Alex,9,2004-08-02T15:00:00Z,HYANNIS MA,0,0,5,6,11
Tropical Storm,Alex,10,2004-08-02T21:00:00Z,34.8N  75.3W,41,0,0,0,41
Tropical Storm,Alex,10,2004-08-02T21:00:00Z,BOSTON MA,0,1,7,1,9
Tropical Storm,Alex,10,2004-08-02T21:00:00Z,36.7N  72.0W,2,18,2,0,22
Tropical Storm,Alex,10,2004-08-02T21:00:00Z,PORTLAND ME,0,0,5,2,7
Tropical Storm,Alex,10,2004-08-02T21:00:00Z,39.0N  67.0W,0,1,11,3,15
Tropical Storm,Alex,10,2004-08-02T21:00:00Z,BAR HARBOR ME,0,0,3,4,7
Tropical Storm,Alex,10,2004-08-02T21:00:00Z,BERMUDA,0,0,2,1,3
Tropical Storm,Alex,10,2004-08-02T21:00:00Z,EASTPORT ME,0,0,2,5,7
Tropical Storm,Alex,10,2004-08-02T21:00:00Z,CHARLESTON SC,29,0,0,0,29
Tropical Storm,Alex,10,2004-08-02T21:00:00Z,ST JOHN NB,0,0,1,6,7
Tropical Storm,Alex,10,2004-08-02T21:00:00Z,MYRTLE BEACH SC,43,0,0,0,43
Tropical Storm,Alex,10,2004-08-02T21:00:00Z,MONCTON NB,0,0,1,6,7
Tropical Storm,Alex,10,2004-08-02T21:00:00Z,WILMINGTON NC,46,0,0,0,46
Tropical Storm,Alex,10,2004-08-02T21:00:00Z,YARMOUTH NS,0,0,3,6,9
Tropical Storm,Alex,10,2004-08-02T21:00:00Z,MOREHEAD CITY NC,46,0,0,0,46
Tropical Storm,Alex,10,2004-08-02T21:00:00Z,HALIFAX NS,0,0,1,8,9
Tropical Storm,Alex,10,2004-08-02T21:00:00Z,CAPE HATTERAS NC,39,0,0,0,39
Tropical Storm,Alex,10,2004-08-02T21:00:00Z,SABLE ISLAND NS,0,0,0,10,10
Tropical Storm,Alex,10,2004-08-02T21:00:00Z,NORFOLK VA,15,7,0,0,22
Tropical Storm,Alex,10,2004-08-02T21:00:00Z,SYDNEY NS,0,0,0,8,8
Tropical Storm,Alex,10,2004-08-02T21:00:00Z,OCEAN CITY MD,2,13,1,0,16
Tropical Storm,Alex,10,2004-08-02T21:00:00Z,EDDY POINT NS,0,0,0,9,9
Tropical Storm,Alex,10,2004-08-02T21:00:00Z,ATLANTIC CITY NJ,0,9,3,0,12
Tropical Storm,Alex,10,2004-08-02T21:00:00Z,PTX BASQUES NFLD,0,0,0,6,6
Tropical Storm,Alex,10,2004-08-02T21:00:00Z,NEW YORK CITY NY,0,5,5,0,10
Tropical Storm,Alex,10,2004-08-02T21:00:00Z,BURGEO NFLD,0,0,0,7,7
Tropical Storm,Alex,10,2004-08-02T21:00:00Z,MONTAUK POINT NY,0,3,8,0,11
Tropical Storm,Alex,10,2004-08-02T21:00:00Z,ILE ST PIERRE,0,0,0,7,7
Tropical Storm,Alex,10,2004-08-02T21:00:00Z,PROVIDENCE RI,0,2,7,1,10
Tropical Storm,Alex,10,2004-08-02T21:00:00Z,CAPE RACE NFLD,0,0,0,6,6
Tropical Storm,Alex,10,2004-08-02T21:00:00Z,NANTUCKET MA,0,2,9,1,12
Tropical Storm,Alex,10,2004-08-02T21:00:00Z,HIBERNIA OILFLD,0,0,0,2,2
Tropical Storm,Alex,10,2004-08-02T21:00:00Z,HYANNIS MA,0,1,9,1,11
Tropical Storm,Alex,11,2004-08-03T03:00:00Z,35.7N  74.3W,29,4,0,0,33
Tropical Storm,Alex,11,2004-08-03T03:00:00Z,BOSTON MA,0,1,4,1,6
Tropical Storm,Alex,11,2004-08-03T03:00:00Z,37.4N  70.7W,0,17,7,0,24
Tropical Storm,Alex,11,2004-08-03T03:00:00Z,PORTLAND ME,0,0,3,1,4
Tropical Storm,Alex,11,2004-08-03T03:00:00Z,39.9N  64.6W,0,0,10,3,13
Tropical Storm,Alex,11,2004-08-03T03:00:00Z,BAR HARBOR ME,0,0,3,2,5
Tropical Storm,Alex,11,2004-08-03T03:00:00Z,BERMUDA,0,0,2,2,4
Tropical Storm,Alex,11,2004-08-03T03:00:00Z,EASTPORT ME,0,0,3,2,5
Tropical Storm,Alex,11,2004-08-03T03:00:00Z,MYRTLE BEACH SC,29,0,0,0,29
Tropical Storm,Alex,11,2004-08-03T03:00:00Z,ST JOHN NB,0,0,2,4,6
Tropical Storm,Alex,11,2004-08-03T03:00:00Z,WILMINGTON NC,56,0,0,0,56
Tropical Storm,Alex,11,2004-08-03T03:00:00Z,MONCTON NB,0,0,1,4,5
Tropical Storm,Alex,11,2004-08-03T03:00:00Z,MOREHEAD CITY NC,52,0,0,0,52
Tropical Storm,Alex,11,2004-08-03T03:00:00Z,YARMOUTH NS,0,0,5,3,8
Tropical Storm,Alex,11,2004-08-03T03:00:00Z,CAPE HATTERAS NC,40,0,0,0,40
Tropical Storm,Alex,11,2004-08-03T03:00:00Z,HALIFAX NS,0,0,2,6,8
Tropical Storm,Alex,11,2004-08-03T03:00:00Z,NORFOLK VA,17,4,0,0,21
Tropical Storm,Alex,11,2004-08-03T03:00:00Z,SABLE ISLAND NS,0,0,1,8,9
Tropical Storm,Alex,11,2004-08-03T03:00:00Z,OCEAN CITY MD,4,11,1,0,16
Tropical Storm,Alex,11,2004-08-03T03:00:00Z,SYDNEY NS,0,0,0,7,7
Tropical Storm,Alex,11,2004-08-03T03:00:00Z,ATLANTIC CITY NJ,0,8,2,0,10
Tropical Storm,Alex,11,2004-08-03T03:00:00Z,EDDY POINT NS,0,0,1,7,8
Tropical Storm,Alex,11,2004-08-03T03:00:00Z,NEW YORK CITY NY,0,4,2,0,6
Tropical Storm,Alex,11,2004-08-03T03:00:00Z,PTX BASQUES NFLD,0,0,0,6,6
Tropical Storm,Alex,11,2004-08-03T03:00:00Z,MONTAUK POINT NY,0,3,5,1,9
Tropical Storm,Alex,11,2004-08-03T03:00:00Z,BURGEO NFLD,0,0,0,6,6
Tropical Storm,Alex,11,2004-08-03T03:00:00Z,PROVIDENCE RI,0,1,6,0,7
Tropical Storm,Alex,11,2004-08-03T03:00:00Z,ILE ST PIERRE,0,0,0,7,7
Tropical Storm,Alex,11,2004-08-03T03:00:00Z,NANTUCKET MA,0,1,9,1,11
Tropical Storm,Alex,11,2004-08-03T03:00:00Z,CAPE RACE NFLD,0,0,0,6,6
Tropical Storm,Alex,11,2004-08-03T03:00:00Z,HYANNIS MA,0,1,7,1,9
Tropical Storm,Alex,11,2004-08-03T03:00:00Z,HIBERNIA OILFLD,0,0,0,4,4
Hurricane,Alex,12,2004-08-03T09:00:00Z,36.3N  72.6W,28,4,0,0,32
Hurricane,Alex,12,2004-08-03T09:00:00Z,BOSTON MA,0,1,1,0,2
Hurricane,Alex,12,2004-08-03T09:00:00Z,37.8N  68.4W,0,17,4,0,21
Hurricane,Alex,12,2004-08-03T09:00:00Z,BAR HARBOR ME,0,0,1,1,2
Hurricane,Alex,12,2004-08-03T09:00:00Z,39.4N  63.4W,0,0,12,3,15
Hurricane,Alex,12,2004-08-03T09:00:00Z,EASTPORT ME,0,0,1,1,2
Hurricane,Alex,12,2004-08-03T09:00:00Z,BERMUDA,0,0,3,2,5
Hurricane,Alex,12,2004-08-03T09:00:00Z,ST JOHN NB,0,0,2,1,3
Hurricane,Alex,12,2004-08-03T09:00:00Z,WILMINGTON NC,18,0,0,0,18
Hurricane,Alex,12,2004-08-03T09:00:00Z,MONCTON NB,0,0,1,2,3
Hurricane,Alex,12,2004-08-03T09:00:00Z,MOREHEAD CITY NC,58,0,0,0,58
Hurricane,Alex,12,2004-08-03T09:00:00Z,YARMOUTH NS,0,0,4,2,6
Hurricane,Alex,12,2004-08-03T09:00:00Z,CAPE HATTERAS NC,50,0,0,0,50
Hurricane,Alex,12,2004-08-03T09:00:00Z,HALIFAX NS,0,0,3,4,7
Hurricane,Alex,12,2004-08-03T09:00:00Z,NORFOLK VA,10,0,0,0,10
Hurricane,Alex,12,2004-08-03T09:00:00Z,SABLE ISLAND NS,0,0,2,8,10
Hurricane,Alex,12,2004-08-03T09:00:00Z,OCEAN CITY MD,5,2,0,0,7
Hurricane,Alex,12,2004-08-03T09:00:00Z,SYDNEY NS,0,0,1,5,6
Hurricane,Alex,12,2004-08-03T09:00:00Z,ATLANTIC CITY NJ,1,2,0,0,3
Hurricane,Alex,12,2004-08-03T09:00:00Z,EDDY POINT NS,0,0,2,5,7
Hurricane,Alex,12,2004-08-03T09:00:00Z,NEW YORK CITY NY,0,2,0,0,2
Hurricane,Alex,12,2004-08-03T09:00:00Z,PTX BASQUES NFLD,0,0,0,5,5
Hurricane,Alex,12,2004-08-03T09:00:00Z,MONTAUK POINT NY,0,2,1,0,3
Hurricane,Alex,12,2004-08-03T09:00:00Z,BURGEO NFLD,0,0,0,6,6
Hurricane,Alex,12,2004-08-03T09:00:00Z,PROVIDENCE RI,0,2,1,0,3
Hurricane,Alex,12,2004-08-03T09:00:00Z,ILE ST PIERRE,0,0,0,7,7
Hurricane,Alex,12,2004-08-03T09:00:00Z,NANTUCKET MA,0,4,3,0,7
Hurricane,Alex,12,2004-08-03T09:00:00Z,CAPE RACE NFLD,0,0,0,7,7
Hurricane,Alex,12,2004-08-03T09:00:00Z,HYANNIS MA,0,2,3,0,5
Hurricane,Alex,12,2004-08-03T09:00:00Z,HIBERNIA OILFLD,0,0,0,6,6
Hurricane,Alex,13,2004-08-03T15:00:00Z,37.4N  70.3W,39,0,0,0,39
Hurricane,Alex,13,2004-08-03T15:00:00Z,EASTPORT ME,0,1,1,0,2
Hurricane,Alex,13,2004-08-03T15:00:00Z,38.5N  66.0W,0,16,2,0,18
Hurricane,Alex,13,2004-08-03T15:00:00Z,ST JOHN NB,0,1,1,1,3
Hurricane,Alex,13,2004-08-03T15:00:00Z,39.5N  61.0W,0,1,8,2,11
Hurricane,Alex,13,2004-08-03T15:00:00Z,MONCTON NB,0,0,2,1,3
Hurricane,Alex,13,2004-08-03T15:00:00Z,BERMUDA,0,0,3,2,5
Hurricane,Alex,13,2004-08-03T15:00:00Z,YARMOUTH NS,0,3,3,0,6
Hurricane,Alex,13,2004-08-03T15:00:00Z,MOREHEAD CITY NC,99,0,0,0,99
Hurricane,Alex,13,2004-08-03T15:00:00Z,HALIFAX NS,0,1,5,1,7
Hurricane,Alex,13,2004-08-03T15:00:00Z,CAPE HATTERAS NC,99,0,0,0,99
Hurricane,Alex,13,2004-08-03T15:00:00Z,SABLE ISLAND NS,0,0,6,3,9
Hurricane,Alex,13,2004-08-03T15:00:00Z,NORFOLK VA,5,0,0,0,5
Hurricane,Alex,13,2004-08-03T15:00:00Z,SYDNEY NS,0,0,4,2,6
Hurricane,Alex,13,2004-08-03T15:00:00Z,OCEAN CITY MD,3,0,0,0,3
Hurricane,Alex,13,2004-08-03T15:00:00Z,EDDY POINT NS,0,0,5,2,7
Hurricane,Alex,13,2004-08-03T15:00:00Z,MONTAUK POINT NY,0,3,0,0,3
Hurricane,Alex,13,2004-08-03T15:00:00Z,PTX BASQUES NFLD,0,0,2,3,5
Hurricane,Alex,13,2004-08-03T15:00:00Z,PROVIDENCE RI,0,2,0,0,2
Hurricane,Alex,13,2004-08-03T15:00:00Z,BURGEO NFLD,0,0,2,4,6
Hurricane,Alex,13,2004-08-03T15:00:00Z,NANTUCKET MA,0,6,1,0,7
Hurricane,Alex,13,2004-08-03T15:00:00Z,ILE ST PIERRE,0,0,1,6,7
Hurricane,Alex,13,2004-08-03T15:00:00Z,HYANNIS MA,0,4,1,0,5
Hurricane,Alex,13,2004-08-03T15:00:00Z,CAPE RACE NFLD,0,0,0,8,8
Hurricane,Alex,13,2004-08-03T15:00:00Z,BOSTON MA,0,1,1,0,2
Hurricane,Alex,13,2004-08-03T15:00:00Z,HIBERNIA OILFLD,0,0,0,7,7
Hurricane,Alex,14,2004-08-03T21:00:00Z,38.0N  68.6W,35,2,0,0,37
Hurricane,Alex,14,2004-08-03T21:00:00Z,MONCTON NB,0,0,2,0,2
Hurricane,Alex,14,2004-08-03T21:00:00Z,39.4N  64.1W,0,16,1,1,18
Hurricane,Alex,14,2004-08-03T21:00:00Z,YARMOUTH NS,0,3,2,0,5
Hurricane,Alex,14,2004-08-03T21:00:00Z,41.5N  59.0W,0,1,8,3,12
Hurricane,Alex,14,2004-08-03T21:00:00Z,HALIFAX NS,0,2,5,0,7
Hurricane,Alex,14,2004-08-03T21:00:00Z,BERMUDA,0,0,2,1,3
Hurricane,Alex,14,2004-08-03T21:00:00Z,SABLE ISLAND NS,0,2,8,1,11
Hurricane,Alex,14,2004-08-03T21:00:00Z,CAPE HATTERAS NC,99,0,0,0,99
Hurricane,Alex,14,2004-08-03T21:00:00Z,SYDNEY NS,0,0,5,2,7
Hurricane,Alex,14,2004-08-03T21:00:00Z,OCEAN CITY MD,2,0,0,0,2
Hurricane,Alex,14,2004-08-03T21:00:00Z,EDDY POINT NS,0,1,5,2,8
Hurricane,Alex,14,2004-08-03T21:00:00Z,MONTAUK POINT NY,1,1,0,0,2
Hurricane,Alex,14,2004-08-03T21:00:00Z,PTX BASQUES NFLD,0,0,3,2,5
Hurricane,Alex,14,2004-08-03T21:00:00Z,PROVIDENCE RI,0,2,0,0,2
Hurricane,Alex,14,2004-08-03T21:00:00Z,BURGEO NFLD,0,0,3,3,6
Hurricane,Alex,14,2004-08-03T21:00:00Z,NANTUCKET MA,1,5,1,0,7
Hurricane,Alex,14,2004-08-03T21:00:00Z,ILE ST PIERRE,0,0,4,4,8
Hurricane,Alex,14,2004-08-03T21:00:00Z,HYANNIS MA,1,2,1,0,4
Hurricane,Alex,14,2004-08-03T21:00:00Z,CAPE RACE NFLD,0,0,2,7,9
Hurricane,Alex,14,2004-08-03T21:00:00Z,EASTPORT ME,0,1,0,1,2
Hurricane,Alex,14,2004-08-03T21:00:00Z,HIBERNIA OILFLD,0,0,0,8,8
Hurricane,Alex,14,2004-08-03T21:00:00Z,ST JOHN NB,0,1,1,0,2
Hurricane,Alex,15,2004-08-04T03:00:00Z,38.6N  66.3W,23,2,1,0,26
Hurricane,Alex,15,2004-08-04T03:00:00Z,SYDNEY NS,0,2,5,0,7
Hurricane,Alex,15,2004-08-04T03:00:00Z,40.7N  61.1W,0,14,4,0,18
Hurricane,Alex,15,2004-08-04T03:00:00Z,EDDY POINT NS,0,4,3,1,8
Hurricane,Alex,15,2004-08-04T03:00:00Z,43.3N  54.5W,0,1,9,2,12
Hurricane,Alex,15,2004-08-04T03:00:00Z,PTX BASQUES NFLD,0,1,3,0,4
Hurricane,Alex,15,2004-08-04T03:00:00Z,NANTUCKET MA,3,2,0,0,5
Hurricane,Alex,15,2004-08-04T03:00:00Z,BURGEO NFLD,0,1,4,1,6
Hurricane,Alex,15,2004-08-04T03:00:00Z,HYANNIS MA,2,1,0,0,3
Hurricane,Alex,15,2004-08-04T03:00:00Z,ILE ST PIERRE,0,1,7,2,10
Hurricane,Alex,15,2004-08-04T03:00:00Z,YARMOUTH NS,0,4,0,1,5
Hurricane,Alex,15,2004-08-04T03:00:00Z,CAPE RACE NFLD,0,0,7,4,11
Hurricane,Alex,15,2004-08-04T03:00:00Z,HALIFAX NS,0,5,2,0,7
Hurricane,Alex,15,2004-08-04T03:00:00Z,HIBERNIA OILFLD,0,0,2,8,10
Hurricane,Alex,15,2004-08-04T03:00:00Z,SABLE ISLAND NS,0,8,6,0,14
Hurricane,Alex,16,2004-08-04T09:00:00Z,39.8N  63.8W,20,4,0,0,24
Hurricane,Alex,16,2004-08-04T09:00:00Z,EDDY POINT NS,0,5,1,0,6
Hurricane,Alex,16,2004-08-04T09:00:00Z,42.0N  58.0W,0,12,3,1,16
Hurricane,Alex,16,2004-08-04T09:00:00Z,PTX BASQUES NFLD,0,2,1,0,3
Hurricane,Alex,16,2004-08-04T09:00:00Z,44.5N  50.0W,0,0,7,4,11
Hurricane,Alex,16,2004-08-04T09:00:00Z,BURGEO NFLD,0,2,3,0,5
Hurricane,Alex,16,2004-08-04T09:00:00Z,YARMOUTH NS,1,1,0,0,2
Hurricane,Alex,16,2004-08-04T09:00:00Z,ILE ST PIERRE,0,4,5,0,9
Hurricane,Alex,16,2004-08-04T09:00:00Z,HALIFAX NS,1,3,1,0,5
Hurricane,Alex,16,2004-08-04T09:00:00Z,CAPE RACE NFLD,0,2,8,0,10
Hurricane,Alex,16,2004-08-04T09:00:00Z,SABLE ISLAND NS,0,12,2,0,14
Hurricane,Alex,16,2004-08-04T09:00:00Z,HIBERNIA OILFLD,0,0,6,4,10
Hurricane,Alex,16,2004-08-04T09:00:00Z,SYDNEY NS,0,4,2,0,6
Hurricane,Alex,17,2004-08-04T15:00:00Z,40.6N  60.6W,22,6,0,0,28
Hurricane,Alex,17,2004-08-04T15:00:00Z,BURGEO NFLD,0,1,1,0,2
Hurricane,Alex,17,2004-08-04T15:00:00Z,43.1N  53.3W,0,12,5,0,17
Hurricane,Alex,17,2004-08-04T15:00:00Z,ILE ST PIERRE,0,4,2,0,6
Hurricane,Alex,17,2004-08-04T15:00:00Z,45.2N  44.6W,0,0,7,4,11
Hurricane,Alex,17,2004-08-04T15:00:00Z,CAPE RACE NFLD,0,6,5,0,11
Hurricane,Alex,17,2004-08-04T15:00:00Z,SABLE ISLAND NS,4,6,0,0,10
Hurricane,Alex,17,2004-08-04T15:00:00Z,HIBERNIA OILFLD,0,2,9,1,12
Hurricane,Alex,18,2004-08-04T21:00:00Z,42.0N  56.4W,22,10,0,0,32
Hurricane,Alex,18,2004-08-04T21:00:00Z,ILE ST PIERRE,0,2,0,0,2
Hurricane,Alex,18,2004-08-04T21:00:00Z,44.6N  47.4W,0,13,7,0,20
Hurricane,Alex,18,2004-08-04T21:00:00Z,CAPE RACE NFLD,0,8,1,0,9
Hurricane,Alex,18,2004-08-04T21:00:00Z,45.4N  37.5W,0,0,8,0,8
Hurricane,Alex,18,2004-08-04T21:00:00Z,HIBERNIA OILFLD,0,8,6,0,14
Hurricane,Alex,18,2004-08-04T21:00:00Z,SABLE ISLAND NS,4,0,0,0,4
Hurricane,Alex,19,2004-08-05T03:00:00Z,43.8N  51.5W,14,7,0,0,21
Hurricane,Alex,19,2004-08-05T03:00:00Z,SABLE ISLAND NS,2,0,0,0,2
Hurricane,Alex,19,2004-08-05T03:00:00Z,45.8N  41.1W,0,9,4,0,13
Hurricane,Alex,19,2004-08-05T03:00:00Z,CAPE RACE NFLD,6,2,0,0,8
Hurricane,Alex,19,2004-08-05T03:00:00Z,47.1N  30.0W,0,0,6,0,6
Hurricane,Alex,19,2004-08-05T03:00:00Z,HIBERNIA OILFLD,3,9,1,0,13
Hurricane,Alex,20,2004-08-05T09:00:00Z,45.0N  46.5W,26,5,0,0,31
Hurricane,Alex,20,2004-08-05T09:00:00Z,CAPE RACE NFLD,5,0,0,0,5
Hurricane,Alex,20,2004-08-05T09:00:00Z,47.0N  36.5W,0,13,3,0,16
Hurricane,Alex,20,2004-08-05T09:00:00Z,HIBERNIA OILFLD,14,2,0,0,16
Hurricane,Alex,20,2004-08-05T09:00:00Z,47.0N  26.5W,0,0,8,0,8
Hurricane,Alex,21,2004-08-05T15:00:00Z,46.5N  42.0W,29,4,0,0,33
Hurricane,Alex,21,2004-08-05T15:00:00Z,CAPE RACE NFLD,6,0,0,0,6
Hurricane,Alex,21,2004-08-05T15:00:00Z,47.0N  32.0W,0,13,3,0,16
Hurricane,Alex,21,2004-08-05T15:00:00Z,HIBERNIA OILFLD,21,0,0,0,21
Hurricane,Alex,21,2004-08-05T15:00:00Z,47.0N  22.0W,0,0,7,0,7
Hurricane,Alex,22,2004-08-05T21:00:00Z,47.0N  35.0W,26,4,0,0,30
Hurricane,Alex,22,2004-08-05T21:00:00Z,HIBERNIA OILFLD,15,0,0,0,15
Hurricane,Alex,22,2004-08-05T21:00:00Z,47.0N  25.0W,0,13,0,0,13
Hurricane,Alex,23,2004-08-06T03:00:00Z,47.1N  29.9W,28,4,0,0,32
Hurricane,Alex,23,2004-08-06T03:00:00Z,47.0N  20.0W,0,13,0,0,13
Hurricane,Alex,24,2004-08-06T09:00:00Z,47.0N  22.0W,27,0,0,0,27
Tropical Depression,Two,1,2004-08-03T15:00:00Z,15.0N  60.5W,53,1,0,0,54
Tropical Depression,Two,1,2004-08-03T15:00:00Z,TJPS 180N 666W,0,5,22,1,28
Tropical Depression,Two,1,2004-08-03T15:00:00Z,16.5N  64.0W,0,35,0,0,35
Tropical Depression,Two,1,2004-08-03T15:00:00Z,MDSD 185N 697W,0,0,11,8,19
Tropical Depression,Two,1,2004-08-03T15:00:00Z,18.0N  67.0W,0,3,23,1,27
Tropical Depression,Two,1,2004-08-03T15:00:00Z,MDCB 176N 714W,0,0,3,8,11
Tropical Depression,Two,1,2004-08-03T15:00:00Z,TGPY 120N 618W,1,1,0,0,2
Tropical Depression,Two,1,2004-08-03T15:00:00Z,MTPP 186N 724W,0,0,1,10,11
Tropical Depression,Two,1,2004-08-03T15:00:00Z,TBPB 131N 595W,23,0,0,0,23
Tropical Depression,Two,1,2004-08-03T15:00:00Z,MTCA 183N 738W,0,0,0,5,5
Tropical Depression,Two,1,2004-08-03T15:00:00Z,TVSV 131N 612W,13,2,0,0,15
Tropical Depression,Two,1,2004-08-03T15:00:00Z,MUGM 200N 751W,0,0,0,4,4
Tropical Depression,Two,1,2004-08-03T15:00:00Z,TLPL 138N 610W,31,2,0,0,33
Tropical Depression,Two,1,2004-08-03T15:00:00Z,TJSJ 184N 661W,0,7,21,0,28
Tropical Depression,Two,1,2004-08-03T15:00:00Z,TFFF 146N 610W,43,4,0,0,47
Tropical Depression,Two,1,2004-08-03T15:00:00Z,MDPP 198N 707W,0,0,3,15,18
Tropical Depression,Two,1,2004-08-03T15:00:00Z,TDPR 153N 614W,39,9,0,0,48
Tropical Depression,Two,1,2004-08-03T15:00:00Z,MBJT 215N 712W,0,0,1,16,17
Tropical Depression,Two,1,2004-08-03T15:00:00Z,80400 157N 636W,1,34,0,1,36
Tropical Depression,Two,1,2004-08-03T15:00:00Z,MYMM 224N 730W,0,0,0,12,12
Tropical Depression,Two,1,2004-08-03T15:00:00Z,TFFR 163N 615W,26,20,0,0,46
Tropical Depression,Two,1,2004-08-03T15:00:00Z,MYSM 241N 745W,0,0,0,5,5
Tropical Depression,Two,1,2004-08-03T15:00:00Z,TAPA 171N 618W,8,31,0,0,39
Tropical Depression,Two,1,2004-08-03T15:00:00Z,MYEG 235N 758W,0,0,0,3,3
Tropical Depression,Two,1,2004-08-03T15:00:00Z,TKPK 173N 627W,1,36,0,0,37
Tropical Depression,Two,1,2004-08-03T15:00:00Z,ST CROIX VI,0,24,8,0,32
Tropical Depression,Two,1,2004-08-03T15:00:00Z,TNCM 181N 631W,0,28,2,0,30
Tropical Depression,Two,1,2004-08-03T15:00:00Z,ST THOMAS VI,0,17,13,0,30
Tropical Depression,Two,1,2004-08-03T15:00:00Z,TISX 177N 648W,0,24,8,0,32
Tropical Depression,Two,1,2004-08-03T15:00:00Z,SAN JUAN PR,0,7,21,0,28
Tropical Depression,Two,1,2004-08-03T15:00:00Z,TIST 183N 650W,0,17,13,0,30
Tropical Depression,Two,1,2004-08-03T15:00:00Z,PONCE PR,0,5,22,1,28
Tropical Depression,Two,2,2004-08-03T21:00:00Z,15.5N  63.5W,52,1,0,0,53
Tropical Depression,Two,2,2004-08-03T21:00:00Z,MDCB 176N 714W,0,0,10,6,16
Tropical Depression,Two,2,2004-08-03T21:00:00Z,16.5N  66.5W,1,32,0,0,33
Tropical Depression,Two,2,2004-08-03T21:00:00Z,MTPP 186N 724W,0,0,4,11,15
Tropical Depression,Two,2,2004-08-03T21:00:00Z,18.0N  68.5W,0,10,15,1,26
Tropical Depression,Two,2,2004-08-03T21:00:00Z,MTCA 183N 738W,0,0,1,8,9
Tropical Depression,Two,2,2004-08-03T21:00:00Z,TBPB 131N 595W,48,0,0,0,48
Tropical Depression,Two,2,2004-08-03T21:00:00Z,MUGM 200N 751W,0,0,0,8,8
Tropical Depression,Two,2,2004-08-03T21:00:00Z,TVSV 131N 612W,24,0,0,0,24
Tropical Depression,Two,2,2004-08-03T21:00:00Z,MUCM 214N 779W,0,0,0,2,2
Tropical Depression,Two,2,2004-08-03T21:00:00Z,TLPL 138N 610W,60,0,0,0,60
Tropical Depression,Two,2,2004-08-03T21:00:00Z,TJSJ 184N 661W,0,25,2,0,27
Tropical Depression,Two,2,2004-08-03T21:00:00Z,TFFF 146N 610W,78,0,0,0,78
Tropical Depression,Two,2,2004-08-03T21:00:00Z,MDPP 198N 707W,0,0,11,10,21
Tropical Depression,Two,2,2004-08-03T21:00:00Z,TDPR 153N 614W,71,0,0,0,71
Tropical Depression,Two,2,2004-08-03T21:00:00Z,MBJT 215N 712W,0,0,2,17,19
Tropical Depression,Two,2,2004-08-03T21:00:00Z,80400 157N 636W,50,2,0,0,52
Tropical Depression,Two,2,2004-08-03T21:00:00Z,MYMM 224N 730W,0,0,0,16,16
Tropical Depression,Two,2,2004-08-03T21:00:00Z,TFFR 163N 615W,54,0,0,0,54
Tropical Depression,Two,2,2004-08-03T21:00:00Z,MYSM 241N 745W,0,0,0,10,10
Tropical Depression,Two,2,2004-08-03T21:00:00Z,TAPA 171N 618W,34,0,0,0,34
Tropical Depression,Two,2,2004-08-03T21:00:00Z,MYEG 235N 758W,0,0,0,7,7
Tropical Depression,Two,2,2004-08-03T21:00:00Z,TKPK 173N 627W,35,3,0,0,38
Tropical Depression,Two,2,2004-08-03T21:00:00Z,MYAK 241N 776W,0,0,0,2,2
Tropical Depression,Two,2,2004-08-03T21:00:00Z,TNCM 181N 631W,15,10,0,0,25
Tropical Depression,Two,2,2004-08-03T21:00:00Z,MYNN 251N 775W,0,0,0,2,2
Tropical Depression,Two,2,2004-08-03T21:00:00Z,TISX 177N 648W,7,27,0,0,34
Tropical Depression,Two,2,2004-08-03T21:00:00Z,ST CROIX VI,7,27,0,0,34
Tropical Depression,Two,2,2004-08-03T21:00:00Z,TIST 183N 650W,2,26,0,0,28
Tropical Depression,Two,2,2004-08-03T21:00:00Z,ST THOMAS VI,2,26,0,0,28
Tropical Depression,Two,2,2004-08-03T21:00:00Z,TJPS 180N 666W,0,27,2,1,30
Tropical Depression,Two,2,2004-08-03T21:00:00Z,SAN JUAN PR,0,25,2,0,27
Tropical Depression,Two,2,2004-08-03T21:00:00Z,MDSD 185N 697W,0,1,19,3,23
Tropical Depression,Two,2,2004-08-03T21:00:00Z,PONCE PR,0,27,2,1,30
Tropical Depression,Two,3,2004-08-04T03:00:00Z,15.3N  64.3W,51,0,0,0,51
Tropical Depression,Two,3,2004-08-04T03:00:00Z,MDCB 176N 714W,0,0,13,3,16
Tropical Depression,Two,3,2004-08-04T03:00:00Z,16.7N  67.0W,1,32,1,0,34
Tropical Depression,Two,3,2004-08-04T03:00:00Z,MTPP 186N 724W,0,0,7,8,15
Tropical Depression,Two,3,2004-08-04T03:00:00Z,18.3N  69.0W,0,10,15,1,26
Tropical Depression,Two,3,2004-08-04T03:00:00Z,MTCA 183N 738W,0,0,2,7,9
Tropical Depression,Two,3,2004-08-04T03:00:00Z,TBPB 131N 595W,60,0,0,0,60
Tropical Depression,Two,3,2004-08-04T03:00:00Z,MUGM 200N 751W,0,0,0,8,8
Tropical Depression,Two,3,2004-08-04T03:00:00Z,TVSV 131N 612W,34,0,0,0,34
Tropical Depression,Two,3,2004-08-04T03:00:00Z,MUCM 214N 779W,0,0,0,2,2
Tropical Depression,Two,3,2004-08-04T03:00:00Z,TLPL 138N 610W,75,0,0,0,75
Tropical Depression,Two,3,2004-08-04T03:00:00Z,TJSJ 184N 661W,1,25,2,0,28
Tropical Depression,Two,3,2004-08-04T03:00:00Z,TFFF 146N 610W,83,0,0,0,83
Tropical Depression,Two,3,2004-08-04T03:00:00Z,MDPP 198N 707W,0,0,15,6,21
Tropical Depression,Two,3,2004-08-04T03:00:00Z,TDPR 153N 614W,78,0,0,0,78
Tropical Depression,Two,3,2004-08-04T03:00:00Z,MBJT 215N 712W,0,0,4,16,20
Tropical Depression,Two,3,2004-08-04T03:00:00Z,80400 157N 636W,56,1,0,0,57
Tropical Depression,Two,3,2004-08-04T03:00:00Z,MYMM 224N 730W,0,0,0,16,16
Tropical Depression,Two,3,2004-08-04T03:00:00Z,TFFR 163N 615W,46,0,0,0,46
Tropical Depression,Two,3,2004-08-04T03:00:00Z,MYSM 241N 745W,0,0,0,11,11
Tropical Depression,Two,3,2004-08-04T03:00:00Z,TAPA 171N 618W,21,0,0,0,21
Tropical Depression,Two,3,2004-08-04T03:00:00Z,MYEG 235N 758W,0,0,0,8,8
Tropical Depression,Two,3,2004-08-04T03:00:00Z,TKPK 173N 627W,26,1,1,0,28
Tropical Depression,Two,3,2004-08-04T03:00:00Z,MYAK 241N 776W,0,0,0,3,3
Tropical Depression,Two,3,2004-08-04T03:00:00Z,TNCM 181N 631W,10,6,1,0,17
Tropical Depression,Two,3,2004-08-04T03:00:00Z,MYNN 251N 775W,0,0,0,2,2
Tropical Depression,Two,3,2004-08-04T03:00:00Z,TISX 177N 648W,13,19,0,0,32
Tropical Depression,Two,3,2004-08-04T03:00:00Z,ST CROIX VI,13,19,0,0,32
Tropical Depression,Two,3,2004-08-04T03:00:00Z,TIST 183N 650W,4,21,1,0,26
Tropical Depression,Two,3,2004-08-04T03:00:00Z,ST THOMAS VI,4,21,1,0,26
Tropical Depression,Two,3,2004-08-04T03:00:00Z,TJPS 180N 666W,0,29,1,1,31
Tropical Depression,Two,3,2004-08-04T03:00:00Z,SAN JUAN PR,1,25,2,0,28
Tropical Depression,Two,3,2004-08-04T03:00:00Z,MDSD 185N 697W,0,4,19,1,24
Tropical Depression,Two,3,2004-08-04T03:00:00Z,PONCE PR,0,29,1,1,31
Tropical Depression,Two,4,2004-08-04T09:00:00Z,15.8N  66.8W,51,0,0,0,51
Tropical Depression,Two,4,2004-08-04T09:00:00Z,MTPP 186N 724W,0,4,16,1,21
Tropical Depression,Two,4,2004-08-04T09:00:00Z,17.3N  69.2W,5,29,0,0,34
Tropical Depression,Two,4,2004-08-04T09:00:00Z,MTCA 183N 738W,0,0,10,3,13
Tropical Depression,Two,4,2004-08-04T09:00:00Z,19.5N  70.8W,0,11,16,1,28
Tropical Depression,Two,4,2004-08-04T09:00:00Z,MUGM 200N 751W,0,0,4,7,11
Tropical Depression,Two,4,2004-08-04T09:00:00Z,TBPB 131N 595W,99,0,0,0,99
Tropical Depression,Two,4,2004-08-04T09:00:00Z,MUCM 214N 779W,0,0,0,3,3
Tropical Depression,Two,4,2004-08-04T09:00:00Z,TVSV 131N 612W,99,0,0,0,99
Tropical Depression,Two,4,2004-08-04T09:00:00Z,TJSJ 184N 661W,14,8,0,0,22
Tropical Depression,Two,4,2004-08-04T09:00:00Z,TLPL 138N 610W,99,0,0,0,99
Tropical Depression,Two,4,2004-08-04T09:00:00Z,MDPP 198N 707W,0,9,18,0,27
Tropical Depression,Two,4,2004-08-04T09:00:00Z,TFFF 146N 610W,99,0,0,0,99
Tropical Depression,Two,4,2004-08-04T09:00:00Z,MBJT 215N 712W,0,1,17,5,23
Tropical Depression,Two,4,2004-08-04T09:00:00Z,TDPR 153N 614W,83,0,0,0,83
Tropical Depression,Two,4,2004-08-04T09:00:00Z,MYMM 224N 730W,0,0,7,13,20
Tropical Depression,Two,4,2004-08-04T09:00:00Z,80400 157N 636W,75,0,0,0,75
Tropical Depression,Two,4,2004-08-04T09:00:00Z,MYSM 241N 745W,0,0,0,15,15
Tropical Depression,Two,4,2004-08-04T09:00:00Z,TFFR 163N 615W,15,0,0,0,15
Tropical Depression,Two,4,2004-08-04T09:00:00Z,MYEG 235N 758W,0,0,0,11,11
Tropical Depression,Two,4,2004-08-04T09:00:00Z,TAPA 171N 618W,2,0,0,0,2
Tropical Depression,Two,4,2004-08-04T09:00:00Z,MYAK 241N 776W,0,0,0,5,5
Tropical Depression,Two,4,2004-08-04T09:00:00Z,TKPK 173N 627W,4,0,0,0,4
Tropical Depression,Two,4,2004-08-04T09:00:00Z,MYNN 251N 775W,0,0,0,5,5
Tropical Depression,Two,4,2004-08-04T09:00:00Z,TISX 177N 648W,21,1,0,1,23
Tropical Depression,Two,4,2004-08-04T09:00:00Z,MYGF 266N 787W,0,0,0,2,2
Tropical Depression,Two,4,2004-08-04T09:00:00Z,TIST 183N 650W,9,4,0,0,13
Tropical Depression,Two,4,2004-08-04T09:00:00Z,ST CROIX VI,21,1,0,1,23
Tropical Depression,Two,4,2004-08-04T09:00:00Z,TJPS 180N 666W,23,8,0,0,31
Tropical Depression,Two,4,2004-08-04T09:00:00Z,ST THOMAS VI,9,4,0,0,13
Tropical Depression,Two,4,2004-08-04T09:00:00Z,MDSD 185N 697W,0,27,4,0,31
Tropical Depression,Two,4,2004-08-04T09:00:00Z,SAN JUAN PR,14,8,0,0,22
Tropical Depression,Two,4,2004-08-04T09:00:00Z,MDCB 176N 714W,0,16,9,0,25
Tropical Depression,Two,4,2004-08-04T09:00:00Z,PONCE PR,23,8,0,0,31
Tropical Depression,Two,5,2004-08-04T15:00:00Z,15.6N  68.2W,52,0,0,0,52
Tropical Depression,Two,5,2004-08-04T15:00:00Z,MUGM 200N 751W,0,0,7,5,12
Tropical Depression,Two,5,2004-08-04T15:00:00Z,17.5N  70.5W,1,33,0,1,35
Tropical Depression,Two,5,2004-08-04T15:00:00Z,MUCM 214N 779W,0,0,0,3,3
Tropical Depression,Two,5,2004-08-04T15:00:00Z,20.0N  71.5W,0,10,16,1,27
Tropical Depression,Two,5,2004-08-04T15:00:00Z,TJSJ 184N 661W,6,2,1,0,9
Tropical Depression,Two,5,2004-08-04T15:00:00Z,TVSV 131N 612W,99,0,0,0,99
Tropical Depression,Two,5,2004-08-04T15:00:00Z,MDPP 198N 707W,0,16,11,1,28
Tropical Depression,Two,5,2004-08-04T15:00:00Z,TLPL 138N 610W,99,0,0,0,99
Tropical Depression,Two,5,2004-08-04T15:00:00Z,MBJT 215N 712W,0,2,18,3,23
Tropical Depression,Two,5,2004-08-04T15:00:00Z,TFFF 146N 610W,77,0,0,0,77
Tropical Depression,Two,5,2004-08-04T15:00:00Z,MYMM 224N 730W,0,0,10,11,21
Tropical Depression,Two,5,2004-08-04T15:00:00Z,TDPR 153N 614W,54,0,0,0,54
Tropical Depression,Two,5,2004-08-04T15:00:00Z,MYSM 241N 745W,0,0,1,16,17
Tropical Depression,Two,5,2004-08-04T15:00:00Z,80400 157N 636W,65,0,0,0,65
Tropical Depression,Two,5,2004-08-04T15:00:00Z,MYEG 235N 758W,0,0,0,13,13
Tropical Depression,Two,5,2004-08-04T15:00:00Z,TISX 177N 648W,3,0,0,0,3
Tropical Depression,Two,5,2004-08-04T15:00:00Z,MYAK 241N 776W,0,0,0,7,7
Tropical Depression,Two,5,2004-08-04T15:00:00Z,TJPS 180N 666W,18,3,0,0,21
Tropical Depression,Two,5,2004-08-04T15:00:00Z,MYNN 251N 775W,0,0,0,7,7
Tropical Depression,Two,5,2004-08-04T15:00:00Z,MDSD 185N 697W,2,29,1,0,32
Tropical Depression,Two,5,2004-08-04T15:00:00Z,MYGF 266N 787W,0,0,0,3,3
Tropical Depression,Two,5,2004-08-04T15:00:00Z,MDCB 176N 714W,0,28,2,0,30
Tropical Depression,Two,5,2004-08-04T15:00:00Z,ST CROIX VI,3,0,0,0,3
Tropical Depression,Two,5,2004-08-04T15:00:00Z,MTPP 186N 724W,0,13,12,0,25
Tropical Depression,Two,5,2004-08-04T15:00:00Z,SAN JUAN PR,6,2,1,0,9
Tropical Depression,Two,5,2004-08-04T15:00:00Z,MTCA 183N 738W,0,3,13,0,16
Tropical Depression,Two,5,2004-08-04T15:00:00Z,PONCE PR,18,3,0,0,21
Tropical Depression,Two,5,2004-08-04T15:00:00Z,MKJP 179N 768W,0,0,1,1,2
Tropical Depression,Two,5,2004-08-04T15:00:00Z,15.6N  68.2W,52,0,0,0,52
Tropical Depression,Two,5,2004-08-04T15:00:00Z,MUGM 200N 751W,0,0,7,5,12
Tropical Depression,Two,5,2004-08-04T15:00:00Z,17.5N  70.5W,1,33,0,1,35
Tropical Depression,Two,5,2004-08-04T15:00:00Z,MUCM 214N 779W,0,0,0,3,3
Tropical Depression,Two,5,2004-08-04T15:00:00Z,20.0N  71.5W,0,10,16,1,27
Tropical Depression,Two,5,2004-08-04T15:00:00Z,TJSJ 184N 661W,6,2,1,0,9
Tropical Depression,Two,5,2004-08-04T15:00:00Z,TVSV 131N 612W,99,0,0,0,99
Tropical Depression,Two,5,2004-08-04T15:00:00Z,MDPP 198N 707W,0,16,11,1,28
Tropical Depression,Two,5,2004-08-04T15:00:00Z,TLPL 138N 610W,99,0,0,0,99
Tropical Depression,Two,5,2004-08-04T15:00:00Z,MBJT 215N 712W,0,2,18,3,23
Tropical Depression,Two,5,2004-08-04T15:00:00Z,TFFF 146N 610W,77,0,0,0,77
Tropical Depression,Two,5,2004-08-04T15:00:00Z,MYMM 224N 730W,0,0,10,11,21
Tropical Depression,Two,5,2004-08-04T15:00:00Z,TDPR 153N 614W,54,0,0,0,54
Tropical Depression,Two,5,2004-08-04T15:00:00Z,MYSM 241N 745W,0,0,1,16,17
Tropical Depression,Two,5,2004-08-04T15:00:00Z,80400 157N 636W,65,0,0,0,65
Tropical Depression,Two,5,2004-08-04T15:00:00Z,MYEG 235N 758W,0,0,0,13,13
Tropical Depression,Two,5,2004-08-04T15:00:00Z,TISX 177N 648W,3,0,0,0,3
Tropical Depression,Two,5,2004-08-04T15:00:00Z,MYAK 241N 776W,0,0,0,7,7
Tropical Depression,Two,5,2004-08-04T15:00:00Z,TJPS 180N 666W,18,3,0,0,21
Tropical Depression,Two,5,2004-08-04T15:00:00Z,MYNN 251N 775W,0,0,0,7,7
Tropical Depression,Two,5,2004-08-04T15:00:00Z,MDSD 185N 697W,2,29,1,0,32
Tropical Depression,Two,5,2004-08-04T15:00:00Z,MYGF 266N 787W,0,0,0,3,3
Tropical Depression,Two,5,2004-08-04T15:00:00Z,MDCB 176N 714W,0,28,2,0,30
Tropical Depression,Two,5,2004-08-04T15:00:00Z,ST CROIX VI,3,0,0,0,3
Tropical Depression,Two,5,2004-08-04T15:00:00Z,MTPP 186N 724W,0,13,12,0,25
Tropical Depression,Two,5,2004-08-04T15:00:00Z,SAN JUAN PR,6,2,1,0,9
Tropical Depression,Two,5,2004-08-04T15:00:00Z,MTCA 183N 738W,0,3,13,0,16
Tropical Depression,Two,5,2004-08-04T15:00:00Z,PONCE PR,18,3,0,0,21
Tropical Depression,Two,5,2004-08-04T15:00:00Z,MKJP 179N 768W,0,0,1,1,2
Tropical Storm,Bonnie,7,2004-08-09T21:00:00Z,25.3N  90.3W,42,1,0,0,43
Tropical Storm,Bonnie,7,2004-08-09T21:00:00Z,PANAMA CITY FL,0,0,2,11,13
Tropical Storm,Bonnie,7,2004-08-09T21:00:00Z,26.5N  90.2W,19,8,1,0,28
Tropical Storm,Bonnie,7,2004-08-09T21:00:00Z,PENSACOLA FL,0,0,4,11,15
Tropical Storm,Bonnie,7,2004-08-09T21:00:00Z,27.4N  89.5W,4,16,3,1,24
Tropical Storm,Bonnie,7,2004-08-09T21:00:00Z,MOBILE AL,0,0,6,10,16
Tropical Storm,Bonnie,7,2004-08-09T21:00:00Z,MUAN 219N 850W,0,0,0,2,2
Tropical Storm,Bonnie,7,2004-08-09T21:00:00Z,GULFPORT MS,0,1,9,7,17
Tropical Storm,Bonnie,7,2004-08-09T21:00:00Z,W PALM BEACH FL,0,0,0,2,2
Tropical Storm,Bonnie,7,2004-08-09T21:00:00Z,BURAS LA,0,5,10,4,19
Tropical Storm,Bonnie,7,2004-08-09T21:00:00Z,FT PIERCE FL,0,0,0,2,2
Tropical Storm,Bonnie,7,2004-08-09T21:00:00Z,NEW ORLEANS LA,0,3,10,5,18
Tropical Storm,Bonnie,7,2004-08-09T21:00:00Z,COCOA BEACH FL,0,0,0,3,3
Tropical Storm,Bonnie,7,2004-08-09T21:00:00Z,NEW IBERIA LA,0,4,9,4,17
Tropical Storm,Bonnie,7,2004-08-09T21:00:00Z,DAYTONA BEACH FL,0,0,0,4,4
Tropical Storm,Bonnie,7,2004-08-09T21:00:00Z,PORT ARTHUR TX,0,2,6,4,12
Tropical Storm,Bonnie,7,2004-08-09T21:00:00Z,JACKSONVILLE FL,0,0,0,5,5
Tropical Storm,Bonnie,7,2004-08-09T21:00:00Z,GALVESTON TX,0,2,4,4,10
Tropical Storm,Bonnie,7,2004-08-09T21:00:00Z,SAVANNAH GA,0,0,0,4,4
Tropical Storm,Bonnie,7,2004-08-09T21:00:00Z,FREEPORT TX,0,1,3,3,7
Tropical Storm,Bonnie,7,2004-08-09T21:00:00Z,CHARLESTON SC,0,0,0,2,2
Tropical Storm,Bonnie,7,2004-08-09T21:00:00Z,PORT O CONNOR TX,0,0,2,2,4
Tropical Storm,Bonnie,7,2004-08-09T21:00:00Z,KEY WEST FL,0,0,0,2,2
Tropical Storm,Bonnie,7,2004-08-09T21:00:00Z,GULF 29N 85W,0,0,2,10,12
Tropical Storm,Bonnie,7,2004-08-09T21:00:00Z,MARCO ISLAND FL,0,0,0,3,3
Tropical Storm,Bonnie,7,2004-08-09T21:00:00Z,GULF 29N 87W,0,1,7,8,16
Tropical Storm,Bonnie,7,2004-08-09T21:00:00Z,FT MYERS FL,0,0,0,4,4
Tropical Storm,Bonnie,7,2004-08-09T21:00:00Z,GULF 28N 89W,1,13,5,2,21
Tropical Storm,Bonnie,7,2004-08-09T21:00:00Z,VENICE FL,0,0,0,6,6
Tropical Storm,Bonnie,7,2004-08-09T21:00:00Z,GULF 28N 91W,1,18,3,1,23
Tropical Storm,Bonnie,7,2004-08-09T21:00:00Z,TAMPA FL,0,0,0,6,6
Tropical Storm,Bonnie,7,2004-08-09T21:00:00Z,GULF 28N 93W,0,13,3,2,18
Tropical Storm,Bonnie,7,2004-08-09T21:00:00Z,CEDAR KEY FL,0,0,0,8,8
Tropical Storm,Bonnie,7,2004-08-09T21:00:00Z,GULF 28N 95W,0,3,3,3,9
Tropical Storm,Bonnie,7,2004-08-09T21:00:00Z,ST MARKS FL,0,0,0,10,10
Tropical Storm,Bonnie,7,2004-08-09T21:00:00Z,GULF 27N 96W,0,1,1,2,4
Tropical Storm,Bonnie,7,2004-08-09T21:00:00Z,APALACHICOLA FL,0,0,1,11,12
Tropical Storm,Bonnie,7,2004-08-09T21:00:00Z,GULF 25N 96W,0,0,0,2,2
Tropical Storm,Bonnie,8,2004-08-10T03:00:00Z,25.3N  90.2W,38,1,0,0,39
Tropical Storm,Bonnie,8,2004-08-10T03:00:00Z,CEDAR KEY FL,0,0,1,10,11
Tropical Storm,Bonnie,8,2004-08-10T03:00:00Z,26.6N  89.7W,17,9,1,0,27
Tropical Storm,Bonnie,8,2004-08-10T03:00:00Z,ST MARKS FL,0,0,1,12,13
Tropical Storm,Bonnie,8,2004-08-10T03:00:00Z,27.7N  88.5W,1,15,4,2,22
Tropical Storm,Bonnie,8,2004-08-10T03:00:00Z,APALACHICOLA FL,0,0,3,12,15
Tropical Storm,Bonnie,8,2004-08-10T03:00:00Z,MUAN 219N 850W,0,0,0,2,2
Tropical Storm,Bonnie,8,2004-08-10T03:00:00Z,PANAMA CITY FL,0,0,4,11,15
Tropical Storm,Bonnie,8,2004-08-10T03:00:00Z,MYGF 266N 787W,0,0,0,2,2
Tropical Storm,Bonnie,8,2004-08-10T03:00:00Z,PENSACOLA FL,0,0,8,9,17
Tropical Storm,Bonnie,8,2004-08-10T03:00:00Z,MARATHON FL,0,0,0,2,2
Tropical Storm,Bonnie,8,2004-08-10T03:00:00Z,MOBILE AL,0,0,10,7,17
Tropical Storm,Bonnie,8,2004-08-10T03:00:00Z,MIAMI FL,0,0,0,3,3
Tropical Storm,Bonnie,8,2004-08-10T03:00:00Z,GULFPORT MS,0,1,11,6,18
Tropical Storm,Bonnie,8,2004-08-10T03:00:00Z,W PALM BEACH FL,0,0,0,3,3
Tropical Storm,Bonnie,8,2004-08-10T03:00:00Z,BURAS LA,0,7,10,3,20
Tropical Storm,Bonnie,8,2004-08-10T03:00:00Z,FT PIERCE FL,0,0,0,4,4
Tropical Storm,Bonnie,8,2004-08-10T03:00:00Z,NEW ORLEANS LA,0,4,11,3,18
Tropical Storm,Bonnie,8,2004-08-10T03:00:00Z,COCOA BEACH FL,0,0,0,5,5
Tropical Storm,Bonnie,8,2004-08-10T03:00:00Z,NEW IBERIA LA,0,4,9,3,16
Tropical Storm,Bonnie,8,2004-08-10T03:00:00Z,DAYTONA BEACH FL,0,0,0,7,7
Tropical Storm,Bonnie,8,2004-08-10T03:00:00Z,PORT ARTHUR TX,0,2,5,2,9
Tropical Storm,Bonnie,8,2004-08-10T03:00:00Z,JACKSONVILLE FL,0,0,0,9,9
Tropical Storm,Bonnie,8,2004-08-10T03:00:00Z,GALVESTON TX,0,2,3,2,7
Tropical Storm,Bonnie,8,2004-08-10T03:00:00Z,SAVANNAH GA,0,0,0,7,7
Tropical Storm,Bonnie,8,2004-08-10T03:00:00Z,FREEPORT TX,0,1,2,2,5
Tropical Storm,Bonnie,8,2004-08-10T03:00:00Z,CHARLESTON SC,0,0,0,5,5
Tropical Storm,Bonnie,8,2004-08-10T03:00:00Z,PORT O CONNOR TX,0,0,1,1,2
Tropical Storm,Bonnie,8,2004-08-10T03:00:00Z,MYRTLE BEACH SC,0,0,0,3,3
Tropical Storm,Bonnie,8,2004-08-10T03:00:00Z,GULF 29N 85W,0,0,5,10,15
Tropical Storm,Bonnie,8,2004-08-10T03:00:00Z,WILMINGTON NC,0,0,0,2,2
Tropical Storm,Bonnie,8,2004-08-10T03:00:00Z,GULF 29N 87W,0,2,10,6,18
Tropical Storm,Bonnie,8,2004-08-10T03:00:00Z,KEY WEST FL,0,0,0,3,3
Tropical Storm,Bonnie,8,2004-08-10T03:00:00Z,GULF 28N 89W,1,15,5,2,23
Tropical Storm,Bonnie,8,2004-08-10T03:00:00Z,MARCO ISLAND FL,0,0,0,5,5
Tropical Storm,Bonnie,8,2004-08-10T03:00:00Z,GULF 28N 91W,1,19,2,1,23
Tropical Storm,Bonnie,8,2004-08-10T03:00:00Z,FT MYERS FL,0,0,0,6,6
Tropical Storm,Bonnie,8,2004-08-10T03:00:00Z,GULF 28N 93W,0,12,3,1,16
Tropical Storm,Bonnie,8,2004-08-10T03:00:00Z,VENICE FL,0,0,1,7,8
Tropical Storm,Bonnie,8,2004-08-10T03:00:00Z,GULF 28N 95W,0,2,3,1,6
Tropical Storm,Bonnie,8,2004-08-10T03:00:00Z,TAMPA FL,0,0,1,8,9
Tropical Storm,Bonnie,8,2004-08-10T03:00:00Z,GULF 27N 96W,0,1,0,1,2
Tropical Storm,Bonnie,9,2004-08-10T09:00:00Z,25.5N  90.7W,38,1,0,0,39
Tropical Storm,Bonnie,9,2004-08-10T09:00:00Z,TAMPA FL,0,0,1,11,12
Tropical Storm,Bonnie,9,2004-08-10T09:00:00Z,26.6N  89.8W,17,8,1,0,26
Tropical Storm,Bonnie,9,2004-08-10T09:00:00Z,CEDAR KEY FL,0,0,1,14,15
Tropical Storm,Bonnie,9,2004-08-10T09:00:00Z,28.0N  88.0W,0,11,10,1,22
Tropical Storm,Bonnie,9,2004-08-10T09:00:00Z,ST MARKS FL,0,0,2,16,18
Tropical Storm,Bonnie,9,2004-08-10T09:00:00Z,MYGF 266N 787W,0,0,0,2,2
Tropical Storm,Bonnie,9,2004-08-10T09:00:00Z,APALACHICOLA FL,0,0,6,13,19
Tropical Storm,Bonnie,9,2004-08-10T09:00:00Z,MARATHON FL,0,0,0,2,2
Tropical Storm,Bonnie,9,2004-08-10T09:00:00Z,PANAMA CITY FL,0,0,7,13,20
Tropical Storm,Bonnie,9,2004-08-10T09:00:00Z,MIAMI FL,0,0,0,3,3
Tropical Storm,Bonnie,9,2004-08-10T09:00:00Z,PENSACOLA FL,0,0,11,9,20
Tropical Storm,Bonnie,9,2004-08-10T09:00:00Z,W PALM BEACH FL,0,0,0,5,5
Tropical Storm,Bonnie,9,2004-08-10T09:00:00Z,MOBILE AL,0,0,12,8,20
Tropical Storm,Bonnie,9,2004-08-10T09:00:00Z,FT PIERCE FL,0,0,0,7,7
Tropical Storm,Bonnie,9,2004-08-10T09:00:00Z,GULFPORT MS,0,1,14,5,20
Tropical Storm,Bonnie,9,2004-08-10T09:00:00Z,COCOA BEACH FL,0,0,0,9,9
Tropical Storm,Bonnie,9,2004-08-10T09:00:00Z,BURAS LA,0,7,12,2,21
Tropical Storm,Bonnie,9,2004-08-10T09:00:00Z,DAYTONA BEACH FL,0,0,0,11,11
Tropical Storm,Bonnie,9,2004-08-10T09:00:00Z,NEW ORLEANS LA,0,4,12,3,19
Tropical Storm,Bonnie,9,2004-08-10T09:00:00Z,JACKSONVILLE FL,0,0,0,14,14
Tropical Storm,Bonnie,9,2004-08-10T09:00:00Z,NEW IBERIA LA,0,4,9,2,15
Tropical Storm,Bonnie,9,2004-08-10T09:00:00Z,SAVANNAH GA,0,0,0,14,14
Tropical Storm,Bonnie,9,2004-08-10T09:00:00Z,PORT ARTHUR TX,0,1,5,1,7
Tropical Storm,Bonnie,9,2004-08-10T09:00:00Z,CHARLESTON SC,0,0,0,12,12
Tropical Storm,Bonnie,9,2004-08-10T09:00:00Z,GALVESTON TX,0,1,3,1,5
Tropical Storm,Bonnie,9,2004-08-10T09:00:00Z,MYRTLE BEACH SC,0,0,0,10,10
Tropical Storm,Bonnie,9,2004-08-10T09:00:00Z,FREEPORT TX,0,1,2,0,3
Tropical Storm,Bonnie,9,2004-08-10T09:00:00Z,WILMINGTON NC,0,0,0,7,7
Tropical Storm,Bonnie,9,2004-08-10T09:00:00Z,GULF 29N 85W,0,0,7,11,18
Tropical Storm,Bonnie,9,2004-08-10T09:00:00Z,MOREHEAD CITY NC,0,0,0,5,5
Tropical Storm,Bonnie,9,2004-08-10T09:00:00Z,GULF 29N 87W,0,2,14,5,21
Tropical Storm,Bonnie,9,2004-08-10T09:00:00Z,CAPE HATTERAS NC,0,0,0,3,3
Tropical Storm,Bonnie,9,2004-08-10T09:00:00Z,GULF 28N 89W,1,15,6,1,23
Tropical Storm,Bonnie,9,2004-08-10T09:00:00Z,NORFOLK VA,0,0,0,3,3
Tropical Storm,Bonnie,9,2004-08-10T09:00:00Z,GULF 28N 91W,1,18,3,0,22
Tropical Storm,Bonnie,9,2004-08-10T09:00:00Z,KEY WEST FL,0,0,0,3,3
Tropical Storm,Bonnie,9,2004-08-10T09:00:00Z,GULF 28N 93W,0,12,3,0,15
Tropical Storm,Bonnie,9,2004-08-10T09:00:00Z,MARCO ISLAND FL,0,0,0,6,6
Tropical Storm,Bonnie,9,2004-08-10T09:00:00Z,GULF 28N 95W,0,3,2,0,5
Tropical Storm,Bonnie,9,2004-08-10T09:00:00Z,FT MYERS FL,0,0,1,7,8
Tropical Storm,Bonnie,9,2004-08-10T09:00:00Z,GULF 27N 96W,0,1,1,0,2
Tropical Storm,Bonnie,9,2004-08-10T09:00:00Z,VENICE FL,0,0,1,10,11
Tropical Storm,Bonnie,10,2004-08-10T15:00:00Z,26.2N  90.3W,37,1,0,0,38
Tropical Storm,Bonnie,10,2004-08-10T15:00:00Z,KEY WEST FL,0,0,0,2,2
Tropical Storm,Bonnie,10,2004-08-10T15:00:00Z,27.4N  89.0W,15,13,2,0,30
Tropical Storm,Bonnie,10,2004-08-10T15:00:00Z,MARCO ISLAND FL,0,0,1,5,6
Tropical Storm,Bonnie,10,2004-08-10T15:00:00Z,29.5N  86.2W,0,2,20,2,24
Tropical Storm,Bonnie,10,2004-08-10T15:00:00Z,FT MYERS FL,0,0,1,7,8
Tropical Storm,Bonnie,10,2004-08-10T15:00:00Z,MYGF 266N 787W,0,0,0,3,3
Tropical Storm,Bonnie,10,2004-08-10T15:00:00Z,VENICE FL,0,0,3,8,11
Tropical Storm,Bonnie,10,2004-08-10T15:00:00Z,MARATHON FL,0,0,0,2,2
Tropical Storm,Bonnie,10,2004-08-10T15:00:00Z,TAMPA FL,0,0,3,10,13
Tropical Storm,Bonnie,10,2004-08-10T15:00:00Z,MIAMI FL,0,0,0,4,4
Tropical Storm,Bonnie,10,2004-08-10T15:00:00Z,CEDAR KEY FL,0,0,5,12,17
Tropical Storm,Bonnie,10,2004-08-10T15:00:00Z,W PALM BEACH FL,0,0,0,5,5
Tropical Storm,Bonnie,10,2004-08-10T15:00:00Z,ST MARKS FL,0,0,11,9,20
Tropical Storm,Bonnie,10,2004-08-10T15:00:00Z,FT PIERCE FL,0,0,0,8,8
Tropical Storm,Bonnie,10,2004-08-10T15:00:00Z,APALACHICOLA FL,0,0,16,6,22
Tropical Storm,Bonnie,10,2004-08-10T15:00:00Z,COCOA BEACH FL,0,0,0,10,10
Tropical Storm,Bonnie,10,2004-08-10T15:00:00Z,PANAMA CITY FL,0,0,19,4,23
Tropical Storm,Bonnie,10,2004-08-10T15:00:00Z,DAYTONA BEACH FL,0,0,1,12,13
Tropical Storm,Bonnie,10,2004-08-10T15:00:00Z,PENSACOLA FL,0,2,20,2,24
Tropical Storm,Bonnie,10,2004-08-10T15:00:00Z,JACKSONVILLE FL,0,0,1,15,16
Tropical Storm,Bonnie,10,2004-08-10T15:00:00Z,MOBILE AL,0,5,17,1,23
Tropical Storm,Bonnie,10,2004-08-10T15:00:00Z,SAVANNAH GA,0,0,0,17,17
Tropical Storm,Bonnie,10,2004-08-10T15:00:00Z,GULFPORT MS,0,9,14,0,23
Tropical Storm,Bonnie,10,2004-08-10T15:00:00Z,CHARLESTON SC,0,0,0,15,15
Tropical Storm,Bonnie,10,2004-08-10T15:00:00Z,BURAS LA,1,17,8,0,26
Tropical Storm,Bonnie,10,2004-08-10T15:00:00Z,MYRTLE BEACH SC,0,0,0,14,14
Tropical Storm,Bonnie,10,2004-08-10T15:00:00Z,NEW ORLEANS LA,0,13,8,0,21
Tropical Storm,Bonnie,10,2004-08-10T15:00:00Z,WILMINGTON NC,0,0,0,13,13
Tropical Storm,Bonnie,10,2004-08-10T15:00:00Z,NEW IBERIA LA,0,8,5,0,13
Tropical Storm,Bonnie,10,2004-08-10T15:00:00Z,MOREHEAD CITY NC,0,0,0,11,11
Tropical Storm,Bonnie,10,2004-08-10T15:00:00Z,PORT ARTHUR TX,0,1,0,1,2
Tropical Storm,Bonnie,10,2004-08-10T15:00:00Z,CAPE HATTERAS NC,0,0,0,9,9
Tropical Storm,Bonnie,10,2004-08-10T15:00:00Z,GULF 29N 85W,0,0,17,4,21
Tropical Storm,Bonnie,10,2004-08-10T15:00:00Z,NORFOLK VA,0,0,0,9,9
Tropical Storm,Bonnie,10,2004-08-10T15:00:00Z,GULF 29N 87W,0,7,19,0,26
Tropical Storm,Bonnie,10,2004-08-10T15:00:00Z,OCEAN CITY MD,0,0,0,6,6
Tropical Storm,Bonnie,10,2004-08-10T15:00:00Z,GULF 28N 89W,8,18,4,0,30
Tropical Storm,Bonnie,10,2004-08-10T15:00:00Z,ATLANTIC CITY NJ,0,0,0,4,4
Tropical Storm,Bonnie,10,2004-08-10T15:00:00Z,GULF 28N 91W,14,10,1,0,25
Tropical Storm,Bonnie,10,2004-08-10T15:00:00Z,NEW YORK CITY NY,0,0,0,2,2
Tropical Storm,Bonnie,10,2004-08-10T15:00:00Z,GULF 28N 93W,5,6,1,0,12
Tropical Storm,Bonnie,11,2004-08-10T21:00:00Z,26.8N  89.5W,34,0,0,0,34
Tropical Storm,Bonnie,11,2004-08-10T21:00:00Z,MONTAUK POINT NY,0,0,0,2,2
Tropical Storm,Bonnie,11,2004-08-10T21:00:00Z,28.5N  87.5W,5,21,3,0,29
Tropical Storm,Bonnie,11,2004-08-10T21:00:00Z,KEY WEST FL,0,0,1,1,2
Tropical Storm,Bonnie,11,2004-08-10T21:00:00Z,31.0N  84.0W,0,1,19,2,22
Tropical Storm,Bonnie,11,2004-08-10T21:00:00Z,MARCO ISLAND FL,0,0,2,3,5
Tropical Storm,Bonnie,11,2004-08-10T21:00:00Z,MYGF 266N 787W,0,0,0,3,3
Tropical Storm,Bonnie,11,2004-08-10T21:00:00Z,FT MYERS FL,0,0,3,4,7
Tropical Storm,Bonnie,11,2004-08-10T21:00:00Z,MARATHON FL,0,0,0,2,2
Tropical Storm,Bonnie,11,2004-08-10T21:00:00Z,VENICE FL,0,0,6,4,10
Tropical Storm,Bonnie,11,2004-08-10T21:00:00Z,MIAMI FL,0,0,0,3,3
Tropical Storm,Bonnie,11,2004-08-10T21:00:00Z,TAMPA FL,0,0,8,5,13
Tropical Storm,Bonnie,11,2004-08-10T21:00:00Z,W PALM BEACH FL,0,0,1,4,5
Tropical Storm,Bonnie,11,2004-08-10T21:00:00Z,CEDAR KEY FL,0,0,14,3,17
Tropical Storm,Bonnie,11,2004-08-10T21:00:00Z,FT PIERCE FL,0,0,1,6,7
Tropical Storm,Bonnie,11,2004-08-10T21:00:00Z,ST MARKS FL,0,2,19,1,22
Tropical Storm,Bonnie,11,2004-08-10T21:00:00Z,COCOA BEACH FL,0,0,2,8,10
Tropical Storm,Bonnie,11,2004-08-10T21:00:00Z,APALACHICOLA FL,0,5,19,0,24
Tropical Storm,Bonnie,11,2004-08-10T21:00:00Z,DAYTONA BEACH FL,0,0,4,9,13
Tropical Storm,Bonnie,11,2004-08-10T21:00:00Z,PANAMA CITY FL,0,9,17,0,26
Tropical Storm,Bonnie,11,2004-08-10T21:00:00Z,JACKSONVILLE FL,0,0,8,9,17
Tropical Storm,Bonnie,11,2004-08-10T21:00:00Z,PENSACOLA FL,0,18,9,0,27
Tropical Storm,Bonnie,11,2004-08-10T21:00:00Z,SAVANNAH GA,0,0,5,13,18
Tropical Storm,Bonnie,11,2004-08-10T21:00:00Z,MOBILE AL,1,18,5,0,24
Tropical Storm,Bonnie,11,2004-08-10T21:00:00Z,CHARLESTON SC,0,0,2,14,16
Tropical Storm,Bonnie,11,2004-08-10T21:00:00Z,GULFPORT MS,2,17,3,0,22
Tropical Storm,Bonnie,11,2004-08-10T21:00:00Z,MYRTLE BEACH SC,0,0,0,15,15
Tropical Storm,Bonnie,11,2004-08-10T21:00:00Z,BURAS LA,9,14,0,1,24
Tropical Storm,Bonnie,11,2004-08-10T21:00:00Z,WILMINGTON NC,0,0,0,13,13
Tropical Storm,Bonnie,11,2004-08-10T21:00:00Z,NEW ORLEANS LA,5,11,1,0,17
Tropical Storm,Bonnie,11,2004-08-10T21:00:00Z,MOREHEAD CITY NC,0,0,0,12,12
Tropical Storm,Bonnie,11,2004-08-10T21:00:00Z,NEW IBERIA LA,2,4,0,0,6
Tropical Storm,Bonnie,11,2004-08-10T21:00:00Z,CAPE HATTERAS NC,0,0,0,10,10
Tropical Storm,Bonnie,11,2004-08-10T21:00:00Z,GULF 29N 85W,0,6,17,1,24
Tropical Storm,Bonnie,11,2004-08-10T21:00:00Z,NORFOLK VA,0,0,0,11,11
Tropical Storm,Bonnie,11,2004-08-10T21:00:00Z,GULF 29N 87W,2,21,6,0,29
Tropical Storm,Bonnie,11,2004-08-10T21:00:00Z,OCEAN CITY MD,0,0,0,8,8
Tropical Storm,Bonnie,11,2004-08-10T21:00:00Z,GULF 28N 89W,21,8,0,1,30
Tropical Storm,Bonnie,11,2004-08-10T21:00:00Z,ATLANTIC CITY NJ,0,0,0,6,6
Tropical Storm,Bonnie,11,2004-08-10T21:00:00Z,GULF 28N 91W,20,2,0,0,22
Tropical Storm,Bonnie,11,2004-08-10T21:00:00Z,NEW YORK CITY NY,0,0,0,4,4
Tropical Storm,Bonnie,11,2004-08-10T21:00:00Z,GULF 28N 93W,4,1,0,0,5
Tropical Storm,Bonnie,12,2004-08-11T03:00:00Z,27.6N  89.0W,45,0,0,0,45
Tropical Storm,Bonnie,12,2004-08-11T03:00:00Z,BOSTON MA,0,0,0,7,7
Tropical Storm,Bonnie,12,2004-08-11T03:00:00Z,29.8N  86.7W,6,28,2,0,36
Tropical Storm,Bonnie,12,2004-08-11T03:00:00Z,PORTLAND ME,0,0,0,5,5
Tropical Storm,Bonnie,12,2004-08-11T03:00:00Z,32.5N  83.2W,0,1,23,3,27
Tropical Storm,Bonnie,12,2004-08-11T03:00:00Z,BAR HARBOR ME,0,0,0,3,3
Tropical Storm,Bonnie,12,2004-08-11T03:00:00Z,COCOA BEACH FL,0,0,1,1,2
Tropical Storm,Bonnie,12,2004-08-11T03:00:00Z,EASTPORT ME,0,0,0,2,2
Tropical Storm,Bonnie,12,2004-08-11T03:00:00Z,DAYTONA BEACH FL,0,0,4,2,6
Tropical Storm,Bonnie,12,2004-08-11T03:00:00Z,VENICE FL,0,0,2,0,2
Tropical Storm,Bonnie,12,2004-08-11T03:00:00Z,JACKSONVILLE FL,0,0,11,4,15
Tropical Storm,Bonnie,12,2004-08-11T03:00:00Z,TAMPA FL,0,0,4,1,5
Tropical Storm,Bonnie,12,2004-08-11T03:00:00Z,SAVANNAH GA,0,0,11,8,19
Tropical Storm,Bonnie,12,2004-08-11T03:00:00Z,CEDAR KEY FL,0,1,11,2,14
Tropical Storm,Bonnie,12,2004-08-11T03:00:00Z,CHARLESTON SC,0,0,5,12,17
Tropical Storm,Bonnie,12,2004-08-11T03:00:00Z,ST MARKS FL,0,8,17,0,25
Tropical Storm,Bonnie,12,2004-08-11T03:00:00Z,MYRTLE BEACH SC,0,0,2,14,16
Tropical Storm,Bonnie,12,2004-08-11T03:00:00Z,APALACHICOLA FL,0,16,11,1,28
Tropical Storm,Bonnie,12,2004-08-11T03:00:00Z,WILMINGTON NC,0,0,1,13,14
Tropical Storm,Bonnie,12,2004-08-11T03:00:00Z,PANAMA CITY FL,1,23,8,0,32
Tropical Storm,Bonnie,12,2004-08-11T03:00:00Z,MOREHEAD CITY NC,0,0,0,12,12
Tropical Storm,Bonnie,12,2004-08-11T03:00:00Z,PENSACOLA FL,5,29,3,0,37
Tropical Storm,Bonnie,12,2004-08-11T03:00:00Z,CAPE HATTERAS NC,0,0,0,11,11
Tropical Storm,Bonnie,12,2004-08-11T03:00:00Z,MOBILE AL,7,25,1,0,33
Tropical Storm,Bonnie,12,2004-08-11T03:00:00Z,NORFOLK VA,0,0,0,15,15
Tropical Storm,Bonnie,12,2004-08-11T03:00:00Z,GULFPORT MS,9,20,1,0,30
Tropical Storm,Bonnie,12,2004-08-11T03:00:00Z,OCEAN CITY MD,0,0,0,14,14
Tropical Storm,Bonnie,12,2004-08-11T03:00:00Z,BURAS LA,22,11,0,0,33
Tropical Storm,Bonnie,12,2004-08-11T03:00:00Z,ATLANTIC CITY NJ,0,0,0,14,14
Tropical Storm,Bonnie,12,2004-08-11T03:00:00Z,NEW ORLEANS LA,8,13,0,0,21
Tropical Storm,Bonnie,12,2004-08-11T03:00:00Z,NEW YORK CITY NY,0,0,0,12,12
Tropical Storm,Bonnie,12,2004-08-11T03:00:00Z,NEW IBERIA LA,1,2,0,0,3
Tropical Storm,Bonnie,12,2004-08-11T03:00:00Z,MONTAUK POINT NY,0,0,0,9,9
Tropical Storm,Bonnie,12,2004-08-11T03:00:00Z,GULF 29N 85W,0,14,10,0,24
Tropical Storm,Bonnie,12,2004-08-11T03:00:00Z,PROVIDENCE RI,0,0,0,8,8
Tropical Storm,Bonnie,12,2004-08-11T03:00:00Z,GULF 29N 87W,13,23,1,0,37
Tropical Storm,Bonnie,12,2004-08-11T03:00:00Z,NANTUCKET MA,0,0,0,6,6
Tropical Storm,Bonnie,12,2004-08-11T03:00:00Z,GULF 28N 89W,43,1,0,0,44
Tropical Storm,Bonnie,12,2004-08-11T03:00:00Z,HYANNIS MA,0,0,0,6,6
Tropical Storm,Bonnie,12,2004-08-11T03:00:00Z,GULF 28N 91W,27,1,1,0,29
Tropical Storm,Bonnie,13,2004-08-11T09:00:00Z,28.6N  88.0W,33,0,0,0,33
Tropical Storm,Bonnie,13,2004-08-11T09:00:00Z,PORTLAND ME,0,0,0,7,7
Tropical Storm,Bonnie,13,2004-08-11T09:00:00Z,31.0N  85.0W,2,17,3,0,22
Tropical Storm,Bonnie,13,2004-08-11T09:00:00Z,BAR HARBOR ME,0,0,0,4,4
Tropical Storm,Bonnie,13,2004-08-11T09:00:00Z,34.0N  81.5W,0,1,12,4,17
Tropical Storm,Bonnie,13,2004-08-11T09:00:00Z,EASTPORT ME,0,0,0,3,3
Tropical Storm,Bonnie,13,2004-08-11T09:00:00Z,W PALM BEACH FL,0,0,1,1,2
Tropical Storm,Bonnie,13,2004-08-11T09:00:00Z,ST JOHN NB,0,0,0,2,2
Tropical Storm,Bonnie,13,2004-08-11T09:00:00Z,FT PIERCE FL,0,0,2,1,3
Tropical Storm,Bonnie,13,2004-08-11T09:00:00Z,YARMOUTH NS,0,0,0,2,2
Tropical Storm,Bonnie,13,2004-08-11T09:00:00Z,COCOA BEACH FL,0,0,4,1,5
Tropical Storm,Bonnie,13,2004-08-11T09:00:00Z,MARCO ISLAND FL,0,0,2,0,2
Tropical Storm,Bonnie,13,2004-08-11T09:00:00Z,DAYTONA BEACH FL,0,1,7,1,9
Tropical Storm,Bonnie,13,2004-08-11T09:00:00Z,FT MYERS FL,0,1,2,0,3
Tropical Storm,Bonnie,13,2004-08-11T09:00:00Z,JACKSONVILLE FL,0,2,10,1,13
Tropical Storm,Bonnie,13,2004-08-11T09:00:00Z,VENICE FL,0,2,3,0,5
Tropical Storm,Bonnie,13,2004-08-11T09:00:00Z,SAVANNAH GA,0,1,12,2,15
Tropical Storm,Bonnie,13,2004-08-11T09:00:00Z,TAMPA FL,0,3,5,1,9
Tropical Storm,Bonnie,13,2004-08-11T09:00:00Z,CHARLESTON SC,0,0,9,5,14
Tropical Storm,Bonnie,13,2004-08-11T09:00:00Z,CEDAR KEY FL,0,7,6,0,13
Tropical Storm,Bonnie,13,2004-08-11T09:00:00Z,MYRTLE BEACH SC,0,0,5,8,13
Tropical Storm,Bonnie,13,2004-08-11T09:00:00Z,ST MARKS FL,1,15,3,0,19
Tropical Storm,Bonnie,13,2004-08-11T09:00:00Z,WILMINGTON NC,0,0,2,10,12
Tropical Storm,Bonnie,13,2004-08-11T09:00:00Z,APALACHICOLA FL,3,17,1,0,21
Tropical Storm,Bonnie,13,2004-08-11T09:00:00Z,MOREHEAD CITY NC,0,0,1,10,11
Tropical Storm,Bonnie,13,2004-08-11T09:00:00Z,PANAMA CITY FL,6,17,1,0,24
Tropical Storm,Bonnie,13,2004-08-11T09:00:00Z,CAPE HATTERAS NC,0,0,0,10,10
Tropical Storm,Bonnie,13,2004-08-11T09:00:00Z,PENSACOLA FL,17,10,0,0,27
Tropical Storm,Bonnie,13,2004-08-11T09:00:00Z,NORFOLK VA,0,0,0,13,13
Tropical Storm,Bonnie,13,2004-08-11T09:00:00Z,MOBILE AL,18,6,1,0,25
Tropical Storm,Bonnie,13,2004-08-11T09:00:00Z,OCEAN CITY MD,0,0,0,12,12
Tropical Storm,Bonnie,13,2004-08-11T09:00:00Z,GULFPORT MS,19,4,0,0,23
Tropical Storm,Bonnie,13,2004-08-11T09:00:00Z,ATLANTIC CITY NJ,0,0,0,12,12
Tropical Storm,Bonnie,13,2004-08-11T09:00:00Z,BURAS LA,25,1,0,0,26
Tropical Storm,Bonnie,13,2004-08-11T09:00:00Z,NEW YORK CITY NY,0,0,0,12,12
Tropical Storm,Bonnie,13,2004-08-11T09:00:00Z,NEW ORLEANS LA,14,2,0,0,16
Tropical Storm,Bonnie,13,2004-08-11T09:00:00Z,MONTAUK POINT NY,0,0,0,10,10
Tropical Storm,Bonnie,13,2004-08-11T09:00:00Z,NEW IBERIA LA,1,1,0,0,2
Tropical Storm,Bonnie,13,2004-08-11T09:00:00Z,PROVIDENCE RI,0,0,0,9,9
Tropical Storm,Bonnie,13,2004-08-11T09:00:00Z,GULF 29N 85W,4,15,1,0,20
Tropical Storm,Bonnie,13,2004-08-11T09:00:00Z,NANTUCKET MA,0,0,0,7,7
Tropical Storm,Bonnie,13,2004-08-11T09:00:00Z,GULF 29N 87W,24,5,0,0,29
Tropical Storm,Bonnie,13,2004-08-11T09:00:00Z,HYANNIS MA,0,0,0,7,7
Tropical Storm,Bonnie,13,2004-08-11T09:00:00Z,GULF 28N 89W,40,0,1,0,41
Tropical Storm,Bonnie,13,2004-08-11T09:00:00Z,BOSTON MA,0,0,0,8,8
Tropical Storm,Bonnie,13,2004-08-11T09:00:00Z,GULF 28N 91W,23,0,0,0,23
Tropical Storm,Bonnie,14,2004-08-11T15:00:00Z,29.6N  86.5W,45,1,0,0,46
Tropical Storm,Bonnie,14,2004-08-11T15:00:00Z,PORTLAND ME,0,0,0,9,9
Tropical Storm,Bonnie,14,2004-08-11T15:00:00Z,32.3N  83.4W,1,21,3,0,25
Tropical Storm,Bonnie,14,2004-08-11T15:00:00Z,BAR HARBOR ME,0,0,0,7,7
Tropical Storm,Bonnie,14,2004-08-11T15:00:00Z,36.0N  79.5W,0,0,13,4,17
Tropical Storm,Bonnie,14,2004-08-11T15:00:00Z,EASTPORT ME,0,0,0,5,5
Tropical Storm,Bonnie,14,2004-08-11T15:00:00Z,FT PIERCE FL,0,1,1,1,3
Tropical Storm,Bonnie,14,2004-08-11T15:00:00Z,ST JOHN NB,0,0,0,4,4
Tropical Storm,Bonnie,14,2004-08-11T15:00:00Z,COCOA BEACH FL,0,2,3,0,5
Tropical Storm,Bonnie,14,2004-08-11T15:00:00Z,MONCTON NB,0,0,0,3,3
Tropical Storm,Bonnie,14,2004-08-11T15:00:00Z,DAYTONA BEACH FL,0,6,5,0,11
Tropical Storm,Bonnie,14,2004-08-11T15:00:00Z,YARMOUTH NS,0,0,0,4,4
Tropical Storm,Bonnie,14,2004-08-11T15:00:00Z,JACKSONVILLE FL,0,13,5,0,18
Tropical Storm,Bonnie,14,2004-08-11T15:00:00Z,FT MYERS FL,0,1,1,0,2
Tropical Storm,Bonnie,14,2004-08-11T15:00:00Z,SAVANNAH GA,0,10,9,1,20
Tropical Storm,Bonnie,14,2004-08-11T15:00:00Z,VENICE FL,0,3,1,0,4
Tropical Storm,Bonnie,14,2004-08-11T15:00:00Z,CHARLESTON SC,0,3,13,1,17
Tropical Storm,Bonnie,14,2004-08-11T15:00:00Z,TAMPA FL,1,6,3,0,10
Tropical Storm,Bonnie,14,2004-08-11T15:00:00Z,MYRTLE BEACH SC,0,1,12,2,15
Tropical Storm,Bonnie,14,2004-08-11T15:00:00Z,CEDAR KEY FL,3,14,2,0,19
Tropical Storm,Bonnie,14,2004-08-11T15:00:00Z,WILMINGTON NC,0,0,9,5,14
Tropical Storm,Bonnie,14,2004-08-11T15:00:00Z,ST MARKS FL,13,17,0,0,30
Tropical Storm,Bonnie,14,2004-08-11T15:00:00Z,MOREHEAD CITY NC,0,0,5,7,12
Tropical Storm,Bonnie,14,2004-08-11T15:00:00Z,APALACHICOLA FL,27,8,0,0,35
Tropical Storm,Bonnie,14,2004-08-11T15:00:00Z,CAPE HATTERAS NC,0,0,3,8,11
Tropical Storm,Bonnie,14,2004-08-11T15:00:00Z,PANAMA CITY FL,34,5,0,0,39
Tropical Storm,Bonnie,14,2004-08-11T15:00:00Z,NORFOLK VA,0,0,3,10,13
Tropical Storm,Bonnie,14,2004-08-11T15:00:00Z,PENSACOLA FL,36,3,0,0,39
Tropical Storm,Bonnie,14,2004-08-11T15:00:00Z,OCEAN CITY MD,0,0,1,11,12
Tropical Storm,Bonnie,14,2004-08-11T15:00:00Z,MOBILE AL,27,4,0,0,31
Tropical Storm,Bonnie,14,2004-08-11T15:00:00Z,ATLANTIC CITY NJ,0,0,1,11,12
Tropical Storm,Bonnie,14,2004-08-11T15:00:00Z,GULFPORT MS,25,2,0,0,27
Tropical Storm,Bonnie,14,2004-08-11T15:00:00Z,NEW YORK CITY NY,0,0,0,12,12
Tropical Storm,Bonnie,14,2004-08-11T15:00:00Z,BURAS LA,37,0,0,0,37
Tropical Storm,Bonnie,14,2004-08-11T15:00:00Z,MONTAUK POINT NY,0,0,0,10,10
Tropical Storm,Bonnie,14,2004-08-11T15:00:00Z,NEW ORLEANS LA,14,2,0,0,16
Tropical Storm,Bonnie,14,2004-08-11T15:00:00Z,PROVIDENCE RI,0,0,0,10,10
Tropical Storm,Bonnie,14,2004-08-11T15:00:00Z,GULF 29N 85W,27,6,0,0,33
Tropical Storm,Bonnie,14,2004-08-11T15:00:00Z,NANTUCKET MA,0,0,0,8,8
Tropical Storm,Bonnie,14,2004-08-11T15:00:00Z,GULF 29N 87W,52,0,0,0,52
Tropical Storm,Bonnie,14,2004-08-11T15:00:00Z,HYANNIS MA,0,0,0,9,9
Tropical Storm,Bonnie,14,2004-08-11T15:00:00Z,GULF 28N 89W,65,0,0,0,65
Tropical Storm,Bonnie,14,2004-08-11T15:00:00Z,BOSTON MA,0,0,0,10,10
Tropical Storm,Bonnie,14,2004-08-11T15:00:00Z,GULF 28N 91W,37,0,0,0,37
Tropical Storm,Bonnie,15,2004-08-11T21:00:00Z,30.8N  84.7W,32,2,0,0,34
Tropical Storm,Bonnie,15,2004-08-11T21:00:00Z,BAR HARBOR ME,0,0,0,10,10
Tropical Storm,Bonnie,15,2004-08-11T21:00:00Z,34.1N  81.3W,0,17,3,0,20
Tropical Storm,Bonnie,15,2004-08-11T21:00:00Z,EASTPORT ME,0,0,0,9,9
Tropical Storm,Bonnie,15,2004-08-11T21:00:00Z,38.3N  77.0W,0,1,11,2,14
Tropical Storm,Bonnie,15,2004-08-11T21:00:00Z,ST JOHN NB,0,0,0,8,8
Tropical Storm,Bonnie,15,2004-08-11T21:00:00Z,W PALM BEACH FL,0,1,1,0,2
Tropical Storm,Bonnie,15,2004-08-11T21:00:00Z,MONCTON NB,0,0,0,7,7
Tropical Storm,Bonnie,15,2004-08-11T21:00:00Z,FT PIERCE FL,0,3,0,0,3
Tropical Storm,Bonnie,15,2004-08-11T21:00:00Z,YARMOUTH NS,0,0,0,7,7
Tropical Storm,Bonnie,15,2004-08-11T21:00:00Z,COCOA BEACH FL,0,5,1,0,6
Tropical Storm,Bonnie,15,2004-08-11T21:00:00Z,HALIFAX NS,0,0,0,5,5
Tropical Storm,Bonnie,15,2004-08-11T21:00:00Z,DAYTONA BEACH FL,1,10,2,0,13
Tropical Storm,Bonnie,15,2004-08-11T21:00:00Z,SABLE ISLAND NS,0,0,0,2,2
Tropical Storm,Bonnie,15,2004-08-11T21:00:00Z,JACKSONVILLE FL,3,16,0,0,19
Tropical Storm,Bonnie,15,2004-08-11T21:00:00Z,SYDNEY NS,0,0,0,2,2
Tropical Storm,Bonnie,15,2004-08-11T21:00:00Z,SAVANNAH GA,1,18,1,0,20
Tropical Storm,Bonnie,15,2004-08-11T21:00:00Z,EDDY POINT NS,0,0,0,3,3
Tropical Storm,Bonnie,15,2004-08-11T21:00:00Z,CHARLESTON SC,0,14,4,0,18
Tropical Storm,Bonnie,15,2004-08-11T21:00:00Z,PTX BASQUES NFLD,0,0,0,2,2
Tropical Storm,Bonnie,15,2004-08-11T21:00:00Z,MYRTLE BEACH SC,0,8,8,0,16
Tropical Storm,Bonnie,15,2004-08-11T21:00:00Z,FT MYERS FL,1,2,0,0,3
Tropical Storm,Bonnie,15,2004-08-11T21:00:00Z,WILMINGTON NC,0,4,10,1,15
Tropical Storm,Bonnie,15,2004-08-11T21:00:00Z,VENICE FL,3,3,0,0,6
Tropical Storm,Bonnie,15,2004-08-11T21:00:00Z,MOREHEAD CITY NC,0,1,10,2,13
Tropical Storm,Bonnie,15,2004-08-11T21:00:00Z,TAMPA FL,5,7,0,0,12
Tropical Storm,Bonnie,15,2004-08-11T21:00:00Z,CAPE HATTERAS NC,0,0,9,2,11
Tropical Storm,Bonnie,15,2004-08-11T21:00:00Z,CEDAR KEY FL,15,7,0,0,22
Tropical Storm,Bonnie,15,2004-08-11T21:00:00Z,NORFOLK VA,0,1,10,2,13
Tropical Storm,Bonnie,15,2004-08-11T21:00:00Z,ST MARKS FL,31,3,0,0,34
Tropical Storm,Bonnie,15,2004-08-11T21:00:00Z,OCEAN CITY MD,0,0,8,5,13
Tropical Storm,Bonnie,15,2004-08-11T21:00:00Z,APALACHICOLA FL,40,0,0,0,40
Tropical Storm,Bonnie,15,2004-08-11T21:00:00Z,ATLANTIC CITY NJ,0,0,6,6,12
Tropical Storm,Bonnie,15,2004-08-11T21:00:00Z,PANAMA CITY FL,42,0,0,0,42
Tropical Storm,Bonnie,15,2004-08-11T21:00:00Z,NEW YORK CITY NY,0,0,4,8,12
Tropical Storm,Bonnie,15,2004-08-11T21:00:00Z,PENSACOLA FL,28,0,0,0,28
Tropical Storm,Bonnie,15,2004-08-11T21:00:00Z,MONTAUK POINT NY,0,0,2,9,11
Tropical Storm,Bonnie,15,2004-08-11T21:00:00Z,MOBILE AL,8,0,0,0,8
Tropical Storm,Bonnie,15,2004-08-11T21:00:00Z,PROVIDENCE RI,0,0,1,10,11
Tropical Storm,Bonnie,15,2004-08-11T21:00:00Z,GULFPORT MS,2,0,0,0,2
Tropical Storm,Bonnie,15,2004-08-11T21:00:00Z,NANTUCKET MA,0,0,1,9,10
Tropical Storm,Bonnie,15,2004-08-11T21:00:00Z,GULF 29N 85W,41,0,0,0,41
Tropical Storm,Bonnie,15,2004-08-11T21:00:00Z,HYANNIS MA,0,0,1,9,10
Tropical Storm,Bonnie,15,2004-08-11T21:00:00Z,GULF 29N 87W,55,1,0,0,56
Tropical Storm,Bonnie,15,2004-08-11T21:00:00Z,BOSTON MA,0,0,1,10,11
Tropical Storm,Bonnie,15,2004-08-11T21:00:00Z,GULF 28N 89W,57,0,0,0,57
Tropical Storm,Bonnie,15,2004-08-11T21:00:00Z,PORTLAND ME,0,0,0,11,11
Tropical Storm,Bonnie,16,2004-08-12T03:00:00Z,31.9N  83.6W,30,5,1,0,36
Tropical Storm,Bonnie,16,2004-08-12T03:00:00Z,EASTPORT ME,0,0,0,10,10
Tropical Storm,Bonnie,16,2004-08-12T03:00:00Z,36.5N  78.5W,0,14,5,0,19
Tropical Storm,Bonnie,16,2004-08-12T03:00:00Z,ST JOHN NB,0,0,0,9,9
Tropical Storm,Bonnie,16,2004-08-12T03:00:00Z,42.0N  73.5W,0,0,10,3,13
Tropical Storm,Bonnie,16,2004-08-12T03:00:00Z,MONCTON NB,0,0,0,9,9
Tropical Storm,Bonnie,16,2004-08-12T03:00:00Z,COCOA BEACH FL,1,2,0,0,3
Tropical Storm,Bonnie,16,2004-08-12T03:00:00Z,YARMOUTH NS,0,0,0,8,8
Tropical Storm,Bonnie,16,2004-08-12T03:00:00Z,DAYTONA BEACH FL,5,5,0,0,10
Tropical Storm,Bonnie,16,2004-08-12T03:00:00Z,HALIFAX NS,0,0,0,6,6
Tropical Storm,Bonnie,16,2004-08-12T03:00:00Z,JACKSONVILLE FL,13,11,0,0,24
Tropical Storm,Bonnie,16,2004-08-12T03:00:00Z,SABLE ISLAND NS,0,0,0,3,3
Tropical Storm,Bonnie,16,2004-08-12T03:00:00Z,SAVANNAH GA,7,19,0,0,26
Tropical Storm,Bonnie,16,2004-08-12T03:00:00Z,SYDNEY NS,0,0,0,4,4
Tropical Storm,Bonnie,16,2004-08-12T03:00:00Z,CHARLESTON SC,1,20,1,0,22
Tropical Storm,Bonnie,16,2004-08-12T03:00:00Z,EDDY POINT NS,0,0,0,5,5
Tropical Storm,Bonnie,16,2004-08-12T03:00:00Z,MYRTLE BEACH SC,0,18,2,0,20
Tropical Storm,Bonnie,16,2004-08-12T03:00:00Z,PTX BASQUES NFLD,0,0,0,5,5
Tropical Storm,Bonnie,16,2004-08-12T03:00:00Z,WILMINGTON NC,0,14,4,0,18
Tropical Storm,Bonnie,16,2004-08-12T03:00:00Z,BURGEO NFLD,0,0,0,3,3
Tropical Storm,Bonnie,16,2004-08-12T03:00:00Z,MOREHEAD CITY NC,0,9,6,1,16
Tropical Storm,Bonnie,16,2004-08-12T03:00:00Z,ILE ST PIERRE,0,0,0,2,2
Tropical Storm,Bonnie,16,2004-08-12T03:00:00Z,CAPE HATTERAS NC,0,5,9,0,14
Tropical Storm,Bonnie,16,2004-08-12T03:00:00Z,VENICE FL,2,0,0,0,2
Tropical Storm,Bonnie,16,2004-08-12T03:00:00Z,NORFOLK VA,0,6,11,0,17
Tropical Storm,Bonnie,16,2004-08-12T03:00:00Z,TAMPA FL,6,2,0,0,8
Tropical Storm,Bonnie,16,2004-08-12T03:00:00Z,OCEAN CITY MD,0,2,13,0,15
Tropical Storm,Bonnie,16,2004-08-12T03:00:00Z,CEDAR KEY FL,21,3,0,0,24
Tropical Storm,Bonnie,16,2004-08-12T03:00:00Z,ATLANTIC CITY NJ,0,1,13,1,15
Tropical Storm,Bonnie,16,2004-08-12T03:00:00Z,ST MARKS FL,43,0,0,0,43
Tropical Storm,Bonnie,16,2004-08-12T03:00:00Z,NEW YORK CITY NY,0,0,12,2,14
Tropical Storm,Bonnie,16,2004-08-12T03:00:00Z,APALACHICOLA FL,51,0,0,0,51
Tropical Storm,Bonnie,16,2004-08-12T03:00:00Z,MONTAUK POINT NY,0,0,8,4,12
Tropical Storm,Bonnie,16,2004-08-12T03:00:00Z,PANAMA CITY FL,54,0,0,0,54
Tropical Storm,Bonnie,16,2004-08-12T03:00:00Z,PROVIDENCE RI,0,0,6,6,12
Tropical Storm,Bonnie,16,2004-08-12T03:00:00Z,PENSACOLA FL,31,0,0,0,31
Tropical Storm,Bonnie,16,2004-08-12T03:00:00Z,NANTUCKET MA,0,0,4,7,11
Tropical Storm,Bonnie,16,2004-08-12T03:00:00Z,MOBILE AL,5,0,0,0,5
Tropical Storm,Bonnie,16,2004-08-12T03:00:00Z,HYANNIS MA,0,0,4,7,11
Tropical Storm,Bonnie,16,2004-08-12T03:00:00Z,GULF 29N 85W,49,0,0,0,49
Tropical Storm,Bonnie,16,2004-08-12T03:00:00Z,BOSTON MA,0,0,5,7,12
Tropical Storm,Bonnie,16,2004-08-12T03:00:00Z,GULF 29N 87W,70,0,0,0,70
Tropical Storm,Bonnie,16,2004-08-12T03:00:00Z,PORTLAND ME,0,0,3,9,12
Tropical Storm,Bonnie,16,2004-08-12T03:00:00Z,GULF 28N 89W,99,0,0,0,99
Tropical Storm,Bonnie,16,2004-08-12T03:00:00Z,BAR HARBOR ME,0,0,1,10,11
Tropical Storm,Bonnie,17,2004-08-12T09:00:00Z,35.1N  81.1W,30,5,0,0,35
Tropical Storm,Bonnie,17,2004-08-12T09:00:00Z,EASTPORT ME,0,0,5,4,9
Tropical Storm,Bonnie,17,2004-08-12T09:00:00Z,40.8N  76.5W,0,17,4,0,21
Tropical Storm,Bonnie,17,2004-08-12T09:00:00Z,ST JOHN NB,0,0,3,5,8
Tropical Storm,Bonnie,17,2004-08-12T09:00:00Z,47.0N  72.0W,0,0,12,2,14
Tropical Storm,Bonnie,17,2004-08-12T09:00:00Z,MONCTON NB,0,0,2,6,8
Tropical Storm,Bonnie,17,2004-08-12T09:00:00Z,JACKSONVILLE FL,13,0,0,0,13
Tropical Storm,Bonnie,17,2004-08-12T09:00:00Z,YARMOUTH NS,0,0,3,3,6
Tropical Storm,Bonnie,17,2004-08-12T09:00:00Z,SAVANNAH GA,26,1,0,0,27
Tropical Storm,Bonnie,17,2004-08-12T09:00:00Z,HALIFAX NS,0,0,1,4,5
Tropical Storm,Bonnie,17,2004-08-12T09:00:00Z,CHARLESTON SC,21,1,0,0,22
Tropical Storm,Bonnie,17,2004-08-12T09:00:00Z,SABLE ISLAND NS,0,0,0,2,2
Tropical Storm,Bonnie,17,2004-08-12T09:00:00Z,MYRTLE BEACH SC,14,6,0,0,20
Tropical Storm,Bonnie,17,2004-08-12T09:00:00Z,SYDNEY NS,0,0,0,4,4
Tropical Storm,Bonnie,17,2004-08-12T09:00:00Z,WILMINGTON NC,8,8,0,0,16
Tropical Storm,Bonnie,17,2004-08-12T09:00:00Z,EDDY POINT NS,0,0,0,4,4
Tropical Storm,Bonnie,17,2004-08-12T09:00:00Z,MOREHEAD CITY NC,2,9,1,0,12
Tropical Storm,Bonnie,17,2004-08-12T09:00:00Z,PTX BASQUES NFLD,0,0,0,5,5
Tropical Storm,Bonnie,17,2004-08-12T09:00:00Z,CAPE HATTERAS NC,1,8,1,0,10
Tropical Storm,Bonnie,17,2004-08-12T09:00:00Z,BURGEO NFLD,0,0,0,4,4
Tropical Storm,Bonnie,17,2004-08-12T09:00:00Z,NORFOLK VA,1,17,1,0,19
Tropical Storm,Bonnie,17,2004-08-12T09:00:00Z,ILE ST PIERRE,0,0,0,2,2
Tropical Storm,Bonnie,17,2004-08-12T09:00:00Z,OCEAN CITY MD,0,16,2,0,18
Tropical Storm,Bonnie,17,2004-08-12T09:00:00Z,CEDAR KEY FL,9,0,0,0,9
Tropical Storm,Bonnie,17,2004-08-12T09:00:00Z,ATLANTIC CITY NJ,0,14,4,0,18
Tropical Storm,Bonnie,17,2004-08-12T09:00:00Z,ST MARKS FL,59,0,0,0,59
Tropical Storm,Bonnie,17,2004-08-12T09:00:00Z,NEW YORK CITY NY,0,11,6,1,18
Tropical Storm,Bonnie,17,2004-08-12T09:00:00Z,APALACHICOLA FL,70,0,0,0,70
Tropical Storm,Bonnie,17,2004-08-12T09:00:00Z,MONTAUK POINT NY,0,4,9,0,13
Tropical Storm,Bonnie,17,2004-08-12T09:00:00Z,PANAMA CITY FL,77,0,0,0,77
Tropical Storm,Bonnie,17,2004-08-12T09:00:00Z,PROVIDENCE RI,0,3,10,0,13
Tropical Storm,Bonnie,17,2004-08-12T09:00:00Z,PENSACOLA FL,39,0,0,0,39
Tropical Storm,Bonnie,17,2004-08-12T09:00:00Z,NANTUCKET MA,0,1,7,1,9
Tropical Storm,Bonnie,17,2004-08-12T09:00:00Z,MOBILE AL,4,0,0,0,4
Tropical Storm,Bonnie,17,2004-08-12T09:00:00Z,HYANNIS MA,0,1,9,0,10
Tropical Storm,Bonnie,17,2004-08-12T09:00:00Z,GULF 29N 85W,59,0,0,0,59
Tropical Storm,Bonnie,17,2004-08-12T09:00:00Z,BOSTON MA,0,2,10,1,13
Tropical Storm,Bonnie,17,2004-08-12T09:00:00Z,GULF 29N 87W,99,0,0,0,99
Tropical Storm,Bonnie,17,2004-08-12T09:00:00Z,PORTLAND ME,0,1,10,2,13
Tropical Storm,Bonnie,17,2004-08-12T09:00:00Z,GULF 28N 89W,99,0,0,0,99
Tropical Storm,Bonnie,17,2004-08-12T09:00:00Z,BAR HARBOR ME,0,0,7,3,10
Tropical Storm,Bonnie,18,2004-08-12T15:00:00Z,37.5N  78.5W,30,5,0,0,35
Tropical Storm,Bonnie,18,2004-08-12T15:00:00Z,NANTUCKET MA,0,5,3,0,8
Tropical Storm,Bonnie,18,2004-08-12T15:00:00Z,44.0N  73.5W,0,16,4,0,20
Tropical Storm,Bonnie,18,2004-08-12T15:00:00Z,HYANNIS MA,0,6,4,0,10
Tropical Storm,Bonnie,18,2004-08-12T15:00:00Z,50.0N  68.5W,0,0,12,0,12
Tropical Storm,Bonnie,18,2004-08-12T15:00:00Z,BOSTON MA,0,9,5,0,14
Tropical Storm,Bonnie,18,2004-08-12T15:00:00Z,JACKSONVILLE FL,17,0,0,0,17
Tropical Storm,Bonnie,18,2004-08-12T15:00:00Z,PORTLAND ME,0,7,8,0,15
Tropical Storm,Bonnie,18,2004-08-12T15:00:00Z,SAVANNAH GA,44,0,0,0,44
Tropical Storm,Bonnie,18,2004-08-12T15:00:00Z,BAR HARBOR ME,0,2,9,0,11
Tropical Storm,Bonnie,18,2004-08-12T15:00:00Z,CHARLESTON SC,30,0,0,0,30
Tropical Storm,Bonnie,18,2004-08-12T15:00:00Z,EASTPORT ME,0,1,7,0,8
Tropical Storm,Bonnie,18,2004-08-12T15:00:00Z,MYRTLE BEACH SC,23,0,0,0,23
Tropical Storm,Bonnie,18,2004-08-12T15:00:00Z,ST JOHN NB,0,0,6,0,6
Tropical Storm,Bonnie,18,2004-08-12T15:00:00Z,WILMINGTON NC,17,0,0,0,17
Tropical Storm,Bonnie,18,2004-08-12T15:00:00Z,MONCTON NB,0,0,5,0,5
Tropical Storm,Bonnie,18,2004-08-12T15:00:00Z,MOREHEAD CITY NC,9,1,0,0,10
Tropical Storm,Bonnie,18,2004-08-12T15:00:00Z,YARMOUTH NS,0,0,5,0,5
Tropical Storm,Bonnie,18,2004-08-12T15:00:00Z,CAPE HATTERAS NC,5,2,0,0,7
Tropical Storm,Bonnie,18,2004-08-12T15:00:00Z,HALIFAX NS,0,0,2,0,2
Tropical Storm,Bonnie,18,2004-08-12T15:00:00Z,NORFOLK VA,13,7,0,0,20
Tropical Storm,Bonnie,18,2004-08-12T15:00:00Z,CEDAR KEY FL,9,0,0,0,9
Tropical Storm,Bonnie,18,2004-08-12T15:00:00Z,OCEAN CITY MD,5,14,0,0,19
Tropical Storm,Bonnie,18,2004-08-12T15:00:00Z,ST MARKS FL,99,0,0,0,99
Tropical Storm,Bonnie,18,2004-08-12T15:00:00Z,ATLANTIC CITY NJ,2,18,0,0,20
Tropical Storm,Bonnie,18,2004-08-12T15:00:00Z,APALACHICOLA FL,99,0,0,0,99
Tropical Storm,Bonnie,18,2004-08-12T15:00:00Z,NEW YORK CITY NY,0,18,1,0,19
Tropical Storm,Bonnie,18,2004-08-12T15:00:00Z,PANAMA CITY FL,99,0,0,0,99
Tropical Storm,Bonnie,18,2004-08-12T15:00:00Z,MONTAUK POINT NY,0,11,3,0,14
Tropical Storm,Bonnie,18,2004-08-12T15:00:00Z,GULF 29N 85W,99,0,0,0,99
Tropical Storm,Bonnie,18,2004-08-12T15:00:00Z,PROVIDENCE RI,0,10,4,0,14
Tropical Storm,Bonnie,18,2004-08-12T15:00:00Z,GULF 29N 87W,99,0,0,0,99
Tropical Depression,Bonnie,19,2004-08-12T21:00:00Z,40.0N  75.5W,30,3,0,0,33
Tropical Depression,Bonnie,19,2004-08-12T21:00:00Z,PROVIDENCE RI,2,18,0,0,20
Tropical Depression,Bonnie,19,2004-08-12T21:00:00Z,46.5N  70.5W,0,16,0,0,16
Tropical Depression,Bonnie,19,2004-08-12T21:00:00Z,NANTUCKET MA,1,11,0,0,12
Tropical Depression,Bonnie,19,2004-08-12T21:00:00Z,JACKSONVILLE FL,23,0,0,0,23
Tropical Depression,Bonnie,19,2004-08-12T21:00:00Z,HYANNIS MA,1,13,0,0,14
Tropical Depression,Bonnie,19,2004-08-12T21:00:00Z,SAVANNAH GA,73,0,0,0,73
Tropical Depression,Bonnie,19,2004-08-12T21:00:00Z,BOSTON MA,1,18,0,0,19
Tropical Depression,Bonnie,19,2004-08-12T21:00:00Z,CHARLESTON SC,44,0,0,0,44
Tropical Depression,Bonnie,19,2004-08-12T21:00:00Z,PORTLAND ME,0,18,0,0,18
Tropical Depression,Bonnie,19,2004-08-12T21:00:00Z,MYRTLE BEACH SC,31,0,0,0,31
Tropical Depression,Bonnie,19,2004-08-12T21:00:00Z,BAR HARBOR ME,0,12,0,0,12
Tropical Depression,Bonnie,19,2004-08-12T21:00:00Z,WILMINGTON NC,23,0,0,0,23
Tropical Depression,Bonnie,19,2004-08-12T21:00:00Z,EASTPORT ME,0,8,0,0,8
Tropical Depression,Bonnie,19,2004-08-12T21:00:00Z,MOREHEAD CITY NC,12,0,0,0,12
Tropical Depression,Bonnie,19,2004-08-12T21:00:00Z,ST JOHN NB,0,5,0,0,5
Tropical Depression,Bonnie,19,2004-08-12T21:00:00Z,CAPE HATTERAS NC,9,0,0,0,9
Tropical Depression,Bonnie,19,2004-08-12T21:00:00Z,MONCTON NB,0,3,0,0,3
Tropical Depression,Bonnie,19,2004-08-12T21:00:00Z,NORFOLK VA,33,0,0,0,33
Tropical Depression,Bonnie,19,2004-08-12T21:00:00Z,YARMOUTH NS,0,5,0,0,5
Tropical Depression,Bonnie,19,2004-08-12T21:00:00Z,OCEAN CITY MD,31,1,0,0,32
Tropical Depression,Bonnie,19,2004-08-12T21:00:00Z,CEDAR KEY FL,9,0,0,0,9
Tropical Depression,Bonnie,19,2004-08-12T21:00:00Z,ATLANTIC CITY NJ,27,4,0,0,31
Tropical Depression,Bonnie,19,2004-08-12T21:00:00Z,ST MARKS FL,99,0,0,0,99
Tropical Depression,Bonnie,19,2004-08-12T21:00:00Z,NEW YORK CITY NY,18,11,0,0,29
Tropical Depression,Bonnie,19,2004-08-12T21:00:00Z,APALACHICOLA FL,99,0,0,0,99
Tropical Depression,Bonnie,19,2004-08-12T21:00:00Z,MONTAUK POINT NY,5,15,0,0,20
Tropical Depression,Three,1,2004-08-09T17:45:00Z,13.0N  66.5W,52,1,0,0,53
Tropical Depression,Three,1,2004-08-09T17:45:00Z,MDSD 185N 697W,0,1,7,1,9
Tropical Depression,Three,1,2004-08-09T17:45:00Z,14.0N  70.0W,0,34,1,0,35
Tropical Depression,Three,1,2004-08-09T17:45:00Z,MDCB 176N 714W,0,2,15,2,19
Tropical Depression,Three,1,2004-08-09T17:45:00Z,15.0N  73.0W,0,4,22,0,26
Tropical Depression,Three,1,2004-08-09T17:45:00Z,MTPP 186N 724W,0,0,9,6,15
Tropical Depression,Three,1,2004-08-09T17:45:00Z,SKPG 125N 717W,0,11,7,0,18
Tropical Depression,Three,1,2004-08-09T17:45:00Z,MTCA 183N 738W,0,0,8,10,18
Tropical Depression,Three,1,2004-08-09T17:45:00Z,TNCC 122N 690W,3,23,0,0,26
Tropical Depression,Three,1,2004-08-09T17:45:00Z,MKJP 179N 768W,0,0,1,19,20
Tropical Depression,Three,1,2004-08-09T17:45:00Z,SVMG 110N 640W,28,0,0,0,28
Tropical Depression,Three,1,2004-08-09T17:45:00Z,MKJS 185N 779W,0,0,0,19,19
Tropical Depression,Three,1,2004-08-09T17:45:00Z,TTPP 106N 614W,27,0,0,0,27
Tropical Depression,Three,1,2004-08-09T17:45:00Z,MWCG 193N 814W,0,0,0,11,11
Tropical Depression,Three,1,2004-08-09T17:45:00Z,TTPT 112N 608W,99,0,0,0,99
Tropical Depression,Three,1,2004-08-09T17:45:00Z,MUGM 200N 751W,0,0,1,12,13
Tropical Depression,Three,1,2004-08-09T17:45:00Z,TGPY 120N 618W,93,0,0,0,93
Tropical Depression,Three,1,2004-08-09T17:45:00Z,MUCM 214N 779W,0,0,0,9,9
Tropical Depression,Three,1,2004-08-09T17:45:00Z,TBPB 131N 595W,48,0,0,0,48
Tropical Depression,Three,1,2004-08-09T17:45:00Z,MUCF 221N 805W,0,0,0,5,5
Tropical Depression,Three,1,2004-08-09T17:45:00Z,TVSV 131N 612W,80,0,0,0,80
Tropical Depression,Three,1,2004-08-09T17:45:00Z,MUSN 216N 826W,0,0,0,3,3
Tropical Depression,Three,1,2004-08-09T17:45:00Z,TLPL 138N 610W,20,0,0,0,20
Tropical Depression,Three,1,2004-08-09T17:45:00Z,MDPP 198N 707W,0,0,2,3,5
Tropical Depression,Three,1,2004-08-09T17:45:00Z,80400 157N 636W,3,0,0,0,3
Tropical Depression,Three,1,2004-08-09T17:45:00Z,PONCE PR,0,1,1,0,2
Tropical Depression,Three,1,2004-08-09T17:45:00Z,TJPS 180N 666W,0,1,1,0,2
Tropical Depression,Three,2,2004-08-09T21:00:00Z,13.4N  68.0W,49,1,0,0,50
Tropical Depression,Three,2,2004-08-09T21:00:00Z,MTPP 186N 724W,0,1,12,2,15
Tropical Depression,Three,2,2004-08-09T21:00:00Z,14.3N  71.1W,1,33,0,0,34
Tropical Depression,Three,2,2004-08-09T21:00:00Z,MTCA 183N 738W,0,0,15,4,19
Tropical Depression,Three,2,2004-08-09T21:00:00Z,15.3N  74.2W,0,4,22,0,26
Tropical Depression,Three,2,2004-08-09T21:00:00Z,MKJP 179N 768W,0,0,6,15,21
Tropical Depression,Three,2,2004-08-09T21:00:00Z,SKPG 125N 717W,0,18,2,0,20
Tropical Depression,Three,2,2004-08-09T21:00:00Z,MKJS 185N 779W,0,0,2,18,20
Tropical Depression,Three,2,2004-08-09T21:00:00Z,TNCC 122N 690W,21,8,0,0,29
Tropical Depression,Three,2,2004-08-09T21:00:00Z,MWCG 193N 814W,0,0,0,14,14
Tropical Depression,Three,2,2004-08-09T21:00:00Z,SVMG 110N 640W,19,0,0,0,19
Tropical Depression,Three,2,2004-08-09T21:00:00Z,MUGM 200N 751W,0,0,3,10,13
Tropical Depression,Three,2,2004-08-09T21:00:00Z,TTPP 106N 614W,32,0,0,0,32
Tropical Depression,Three,2,2004-08-09T21:00:00Z,MUCM 214N 779W,0,0,0,11,11
Tropical Depression,Three,2,2004-08-09T21:00:00Z,TTPT 112N 608W,99,0,0,0,99
Tropical Depression,Three,2,2004-08-09T21:00:00Z,MUCF 221N 805W,0,0,0,8,8
Tropical Depression,Three,2,2004-08-09T21:00:00Z,TGPY 120N 618W,99,0,0,0,99
Tropical Depression,Three,2,2004-08-09T21:00:00Z,MUSN 216N 826W,0,0,0,6,6
Tropical Depression,Three,2,2004-08-09T21:00:00Z,TVSV 131N 612W,83,0,0,0,83
Tropical Depression,Three,2,2004-08-09T21:00:00Z,MUHA 230N 824W,0,0,0,3,3
Tropical Depression,Three,2,2004-08-09T21:00:00Z,TLPL 138N 610W,10,0,0,0,10
Tropical Depression,Three,2,2004-08-09T21:00:00Z,MUAN 219N 850W,0,0,0,2,2
Tropical Depression,Three,2,2004-08-09T21:00:00Z,MDSD 185N 697W,0,4,4,0,8
Tropical Depression,Three,2,2004-08-09T21:00:00Z,MDPP 198N 707W,0,0,3,1,4
Tropical Depression,Three,2,2004-08-09T21:00:00Z,MDCB 176N 714W,0,9,11,0,20
Tropical Depression,Three,3,2004-08-10T03:00:00Z,14.2N  70.1W,50,1,0,0,51
Tropical Depression,Three,3,2004-08-10T03:00:00Z,MWCG 193N 814W,0,0,0,16,16
Tropical Depression,Three,3,2004-08-10T03:00:00Z,15.3N  73.4W,0,34,1,0,35
Tropical Depression,Three,3,2004-08-10T03:00:00Z,MUGM 200N 751W,0,0,10,5,15
Tropical Depression,Three,3,2004-08-10T03:00:00Z,16.4N  76.2W,0,5,20,1,26
Tropical Depression,Three,3,2004-08-10T03:00:00Z,MUCM 214N 779W,0,0,1,13,14
Tropical Depression,Three,3,2004-08-10T03:00:00Z,SKPG 125N 717W,8,9,0,0,17
Tropical Depression,Three,3,2004-08-10T03:00:00Z,MUCF 221N 805W,0,0,0,12,12
Tropical Depression,Three,3,2004-08-10T03:00:00Z,TNCC 122N 690W,23,1,0,0,24
Tropical Depression,Three,3,2004-08-10T03:00:00Z,MUSN 216N 826W,0,0,0,11,11
Tropical Depression,Three,3,2004-08-10T03:00:00Z,SVMG 110N 640W,14,0,0,0,14
Tropical Depression,Three,3,2004-08-10T03:00:00Z,MUHA 230N 824W,0,0,0,7,7
Tropical Depression,Three,3,2004-08-10T03:00:00Z,MDSD 185N 697W,1,3,1,0,5
Tropical Depression,Three,3,2004-08-10T03:00:00Z,MUAN 219N 850W,0,0,0,5,5
Tropical Depression,Three,3,2004-08-10T03:00:00Z,MDCB 176N 714W,1,20,1,0,22
Tropical Depression,Three,3,2004-08-10T03:00:00Z,MDPP 198N 707W,0,1,1,1,3
Tropical Depression,Three,3,2004-08-10T03:00:00Z,MTPP 186N 724W,0,10,6,0,16
Tropical Depression,Three,3,2004-08-10T03:00:00Z,MYEG 235N 758W,0,0,0,3,3
Tropical Depression,Three,3,2004-08-10T03:00:00Z,MTCA 183N 738W,0,10,11,1,22
Tropical Depression,Three,3,2004-08-10T03:00:00Z,MYAK 241N 776W,0,0,0,3,3
Tropical Depression,Three,3,2004-08-10T03:00:00Z,MKJP 179N 768W,0,1,20,3,24
Tropical Depression,Three,3,2004-08-10T03:00:00Z,MARATHON FL,0,0,0,3,3
Tropical Depression,Three,3,2004-08-10T03:00:00Z,MKJS 185N 779W,0,0,13,9,22
Tropical Depression,Three,3,2004-08-10T03:00:00Z,KEY WEST FL,0,0,0,3,3
Tropical Storm,Charley,4,2004-08-10T09:00:00Z,15.0N  72.9W,48,2,0,0,50
Tropical Storm,Charley,4,2004-08-10T09:00:00Z,MUAN 219N 850W,0,0,0,12,12
Tropical Storm,Charley,4,2004-08-10T09:00:00Z,16.3N  76.2W,0,34,1,0,35
Tropical Storm,Charley,4,2004-08-10T09:00:00Z,MMCZ 205N 869W,0,0,0,7,7
Tropical Storm,Charley,4,2004-08-10T09:00:00Z,17.5N  79.0W,0,6,20,1,27
Tropical Storm,Charley,4,2004-08-10T09:00:00Z,MHNJ 165N 859W,0,0,0,5,5
Tropical Storm,Charley,4,2004-08-10T09:00:00Z,SKPG 125N 717W,5,0,0,0,5
Tropical Storm,Charley,4,2004-08-10T09:00:00Z,MNPC 141N 834W,0,0,1,3,4
Tropical Storm,Charley,4,2004-08-10T09:00:00Z,TNCC 122N 690W,4,0,0,0,4
Tropical Storm,Charley,4,2004-08-10T09:00:00Z,SKSP 126N 817W,0,0,1,1,2
Tropical Storm,Charley,4,2004-08-10T09:00:00Z,MDCB 176N 714W,10,4,0,0,14
Tropical Storm,Charley,4,2004-08-10T09:00:00Z,MYEG 235N 758W,0,0,1,1,2
Tropical Storm,Charley,4,2004-08-10T09:00:00Z,MTPP 186N 724W,2,7,0,0,9
Tropical Storm,Charley,4,2004-08-10T09:00:00Z,MYAK 241N 776W,0,0,1,3,4
Tropical Storm,Charley,4,2004-08-10T09:00:00Z,MTCA 183N 738W,1,20,0,1,22
Tropical Storm,Charley,4,2004-08-10T09:00:00Z,MYNN 251N 775W,0,0,0,2,2
Tropical Storm,Charley,4,2004-08-10T09:00:00Z,MKJP 179N 768W,0,24,6,0,30
Tropical Storm,Charley,4,2004-08-10T09:00:00Z,MARATHON FL,0,0,0,7,7
Tropical Storm,Charley,4,2004-08-10T09:00:00Z,MKJS 185N 779W,0,10,17,0,27
Tropical Storm,Charley,4,2004-08-10T09:00:00Z,MIAMI FL,0,0,0,4,4
Tropical Storm,Charley,4,2004-08-10T09:00:00Z,MWCG 193N 814W,0,0,12,9,21
Tropical Storm,Charley,4,2004-08-10T09:00:00Z,W PALM BEACH FL,0,0,0,2,2
Tropical Storm,Charley,4,2004-08-10T09:00:00Z,MUGM 200N 751W,0,6,6,1,13
Tropical Storm,Charley,4,2004-08-10T09:00:00Z,KEY WEST FL,0,0,0,9,9
Tropical Storm,Charley,4,2004-08-10T09:00:00Z,MUCM 214N 779W,0,0,10,5,15
Tropical Storm,Charley,4,2004-08-10T09:00:00Z,MARCO ISLAND FL,0,0,0,4,4
Tropical Storm,Charley,4,2004-08-10T09:00:00Z,MUCF 221N 805W,0,0,4,12,16
Tropical Storm,Charley,4,2004-08-10T09:00:00Z,FT MYERS FL,0,0,0,3,3
Tropical Storm,Charley,4,2004-08-10T09:00:00Z,MUSN 216N 826W,0,0,1,16,17
Tropical Storm,Charley,4,2004-08-10T09:00:00Z,VENICE FL,0,0,0,2,2
Tropical Storm,Charley,4,2004-08-10T09:00:00Z,MUHA 230N 824W,0,0,0,13,13
Tropical Storm,Charley,5,2004-08-10T15:00:00Z,15.7N  75.0W,48,1,0,0,49
Tropical Storm,Charley,5,2004-08-10T15:00:00Z,MUHA 230N 824W,0,0,3,13,16
Tropical Storm,Charley,5,2004-08-10T15:00:00Z,17.0N  78.0W,1,34,0,0,35
Tropical Storm,Charley,5,2004-08-10T15:00:00Z,MUAN 219N 850W,0,0,1,17,18
Tropical Storm,Charley,5,2004-08-10T15:00:00Z,18.3N  80.5W,0,10,17,1,28
Tropical Storm,Charley,5,2004-08-10T15:00:00Z,MMCZ 205N 869W,0,0,0,14,14
Tropical Storm,Charley,5,2004-08-10T15:00:00Z,MDCB 176N 714W,5,0,0,0,5
Tropical Storm,Charley,5,2004-08-10T15:00:00Z,MZBZ 175N 883W,0,0,0,3,3
Tropical Storm,Charley,5,2004-08-10T15:00:00Z,MTPP 186N 724W,2,1,0,0,3
Tropical Storm,Charley,5,2004-08-10T15:00:00Z,MHNJ 165N 859W,0,0,0,6,6
Tropical Storm,Charley,5,2004-08-10T15:00:00Z,MTCA 183N 738W,9,6,0,0,15
Tropical Storm,Charley,5,2004-08-10T15:00:00Z,MNPC 141N 834W,0,0,1,2,3
Tropical Storm,Charley,5,2004-08-10T15:00:00Z,MKJP 179N 768W,2,32,0,0,34
Tropical Storm,Charley,5,2004-08-10T15:00:00Z,MMMD 210N 897W,0,0,0,5,5
Tropical Storm,Charley,5,2004-08-10T15:00:00Z,MKJS 185N 779W,0,28,3,0,31
Tropical Storm,Charley,5,2004-08-10T15:00:00Z,MARATHON FL,0,0,0,7,7
Tropical Storm,Charley,5,2004-08-10T15:00:00Z,MWCG 193N 814W,0,2,21,3,26
Tropical Storm,Charley,5,2004-08-10T15:00:00Z,MIAMI FL,0,0,0,2,2
Tropical Storm,Charley,5,2004-08-10T15:00:00Z,MUGM 200N 751W,0,5,2,0,7
Tropical Storm,Charley,5,2004-08-10T15:00:00Z,KEY WEST FL,0,0,0,9,9
Tropical Storm,Charley,5,2004-08-10T15:00:00Z,MUCM 214N 779W,0,2,8,2,12
Tropical Storm,Charley,5,2004-08-10T15:00:00Z,MARCO ISLAND FL,0,0,0,4,4
Tropical Storm,Charley,5,2004-08-10T15:00:00Z,MUCF 221N 805W,0,0,10,7,17
Tropical Storm,Charley,5,2004-08-10T15:00:00Z,FT MYERS FL,0,0,0,2,2
Tropical Storm,Charley,5,2004-08-10T15:00:00Z,MUSN 216N 826W,0,0,8,13,21
Tropical Storm,Charley,5,2004-08-10T15:00:00Z,VENICE FL,0,0,0,2,2
Tropical Storm,Charley,6,2004-08-10T21:00:00Z,17.7N  77.4W,49,0,0,1,50
Tropical Storm,Charley,6,2004-08-10T21:00:00Z,W PALM BEACH FL,0,0,1,9,10
Tropical Storm,Charley,6,2004-08-10T21:00:00Z,19.4N  80.0W,1,35,0,0,36
Tropical Storm,Charley,6,2004-08-10T21:00:00Z,FT PIERCE FL,0,0,0,9,9
Tropical Storm,Charley,6,2004-08-10T21:00:00Z,21.0N  82.0W,0,13,15,1,29
Tropical Storm,Charley,6,2004-08-10T21:00:00Z,COCOA BEACH FL,0,0,0,8,8
Tropical Storm,Charley,6,2004-08-10T21:00:00Z,MDCB 176N 714W,8,0,0,0,8
Tropical Storm,Charley,6,2004-08-10T21:00:00Z,DAYTONA BEACH FL,0,0,0,6,6
Tropical Storm,Charley,6,2004-08-10T21:00:00Z,MTPP 186N 724W,2,0,0,0,2
Tropical Storm,Charley,6,2004-08-10T21:00:00Z,JACKSONVILLE FL,0,0,0,4,4
Tropical Storm,Charley,6,2004-08-10T21:00:00Z,MTCA 183N 738W,27,0,0,0,27
Tropical Storm,Charley,6,2004-08-10T21:00:00Z,KEY WEST FL,0,0,13,7,20
Tropical Storm,Charley,6,2004-08-10T21:00:00Z,MKJP 179N 768W,52,0,0,0,52
Tropical Storm,Charley,6,2004-08-10T21:00:00Z,MARCO ISLAND FL,0,0,4,12,16
Tropical Storm,Charley,6,2004-08-10T21:00:00Z,MKJS 185N 779W,38,6,0,0,44
Tropical Storm,Charley,6,2004-08-10T21:00:00Z,FT MYERS FL,0,0,2,13,15
Tropical Storm,Charley,6,2004-08-10T21:00:00Z,MWCG 193N 814W,0,25,4,0,29
Tropical Storm,Charley,6,2004-08-10T21:00:00Z,VENICE FL,0,0,1,14,15
Tropical Storm,Charley,6,2004-08-10T21:00:00Z,MUGM 200N 751W,7,1,0,0,8
Tropical Storm,Charley,6,2004-08-10T21:00:00Z,TAMPA FL,0,0,0,12,12
Tropical Storm,Charley,6,2004-08-10T21:00:00Z,MUCM 214N 779W,0,17,1,1,19
Tropical Storm,Charley,6,2004-08-10T21:00:00Z,CEDAR KEY FL,0,0,0,10,10
Tropical Storm,Charley,6,2004-08-10T21:00:00Z,MUCF 221N 805W,0,14,11,1,26
Tropical Storm,Charley,6,2004-08-10T21:00:00Z,ST MARKS FL,0,0,0,7,7
Tropical Storm,Charley,6,2004-08-10T21:00:00Z,MUSN 216N 826W,0,5,21,1,27
Tropical Storm,Charley,6,2004-08-10T21:00:00Z,APALACHICOLA FL,0,0,0,9,9
Tropical Storm,Charley,6,2004-08-10T21:00:00Z,MUHA 230N 824W,0,1,21,3,25
Tropical Storm,Charley,6,2004-08-10T21:00:00Z,PANAMA CITY FL,0,0,0,8,8
Tropical Storm,Charley,6,2004-08-10T21:00:00Z,MUAN 219N 850W,0,0,11,8,19
Tropical Storm,Charley,6,2004-08-10T21:00:00Z,PENSACOLA FL,0,0,0,5,5
Tropical Storm,Charley,6,2004-08-10T21:00:00Z,MMCZ 205N 869W,0,0,1,6,7
Tropical Storm,Charley,6,2004-08-10T21:00:00Z,MOBILE AL,0,0,0,3,3
Tropical Storm,Charley,6,2004-08-10T21:00:00Z,MYAK 241N 776W,0,1,1,3,5
Tropical Storm,Charley,6,2004-08-10T21:00:00Z,GULFPORT MS,0,0,0,2,2
Tropical Storm,Charley,6,2004-08-10T21:00:00Z,MYNN 251N 775W,0,0,1,3,4
Tropical Storm,Charley,6,2004-08-10T21:00:00Z,BURAS LA,0,0,0,3,3
Tropical Storm,Charley,6,2004-08-10T21:00:00Z,MYGF 266N 787W,0,0,0,6,6
Tropical Storm,Charley,6,2004-08-10T21:00:00Z,GULF 29N 85W,0,0,0,11,11
Tropical Storm,Charley,6,2004-08-10T21:00:00Z,MARATHON FL,0,0,11,7,18
Tropical Storm,Charley,6,2004-08-10T21:00:00Z,GULF 29N 87W,0,0,0,9,9
Tropical Storm,Charley,6,2004-08-10T21:00:00Z,MIAMI FL,0,0,4,9,13
Tropical Storm,Charley,6,2004-08-10T21:00:00Z,GULF 28N 89W,0,0,0,5,5
Tropical Storm,Charley,7,2004-08-11T03:00:00Z,18.8N  78.8W,49,0,0,1,50
Tropical Storm,Charley,7,2004-08-11T03:00:00Z,COCOA BEACH FL,0,0,1,11,12
Tropical Storm,Charley,7,2004-08-11T03:00:00Z,20.7N  81.1W,2,34,0,0,36
Tropical Storm,Charley,7,2004-08-11T03:00:00Z,DAYTONA BEACH FL,0,0,0,11,11
Tropical Storm,Charley,7,2004-08-11T03:00:00Z,22.9N  82.3W,0,14,15,0,29
Tropical Storm,Charley,7,2004-08-11T03:00:00Z,JACKSONVILLE FL,0,0,0,9,9
Tropical Storm,Charley,7,2004-08-11T03:00:00Z,MDCB 176N 714W,3,0,0,0,3
Tropical Storm,Charley,7,2004-08-11T03:00:00Z,SAVANNAH GA,0,0,0,4,4
Tropical Storm,Charley,7,2004-08-11T03:00:00Z,MTCA 183N 738W,21,0,0,0,21
Tropical Storm,Charley,7,2004-08-11T03:00:00Z,KEY WEST FL,0,3,19,2,24
Tropical Storm,Charley,7,2004-08-11T03:00:00Z,MKJP 179N 768W,67,0,0,0,67
Tropical Storm,Charley,7,2004-08-11T03:00:00Z,MARCO ISLAND FL,0,0,12,8,20
Tropical Storm,Charley,7,2004-08-11T03:00:00Z,MKJS 185N 779W,57,0,0,0,57
Tropical Storm,Charley,7,2004-08-11T03:00:00Z,FT MYERS FL,0,0,8,11,19
Tropical Storm,Charley,7,2004-08-11T03:00:00Z,MWCG 193N 814W,6,25,0,1,32
Tropical Storm,Charley,7,2004-08-11T03:00:00Z,VENICE FL,0,0,6,13,19
Tropical Storm,Charley,7,2004-08-11T03:00:00Z,MUGM 200N 751W,5,0,0,0,5
Tropical Storm,Charley,7,2004-08-11T03:00:00Z,TAMPA FL,0,0,2,14,16
Tropical Storm,Charley,7,2004-08-11T03:00:00Z,MUCM 214N 779W,7,12,0,0,19
Tropical Storm,Charley,7,2004-08-11T03:00:00Z,CEDAR KEY FL,0,0,0,14,14
Tropical Storm,Charley,7,2004-08-11T03:00:00Z,MUCF 221N 805W,0,28,2,0,30
Tropical Storm,Charley,7,2004-08-11T03:00:00Z,ST MARKS FL,0,0,0,11,11
Tropical Storm,Charley,7,2004-08-11T03:00:00Z,MUSN 216N 826W,0,23,6,1,30
Tropical Storm,Charley,7,2004-08-11T03:00:00Z,APALACHICOLA FL,0,0,0,12,12
Tropical Storm,Charley,7,2004-08-11T03:00:00Z,MUHA 230N 824W,0,12,16,1,29
Tropical Storm,Charley,7,2004-08-11T03:00:00Z,PANAMA CITY FL,0,0,0,11,11
Tropical Storm,Charley,7,2004-08-11T03:00:00Z,MUAN 219N 850W,0,2,12,3,17
Tropical Storm,Charley,7,2004-08-11T03:00:00Z,PENSACOLA FL,0,0,0,7,7
Tropical Storm,Charley,7,2004-08-11T03:00:00Z,MMCZ 205N 869W,0,0,1,3,4
Tropical Storm,Charley,7,2004-08-11T03:00:00Z,MOBILE AL,0,0,0,5,5
Tropical Storm,Charley,7,2004-08-11T03:00:00Z,MYAK 241N 776W,0,1,2,4,7
Tropical Storm,Charley,7,2004-08-11T03:00:00Z,GULFPORT MS,0,0,0,4,4
Tropical Storm,Charley,7,2004-08-11T03:00:00Z,MYNN 251N 775W,0,0,2,4,6
Tropical Storm,Charley,7,2004-08-11T03:00:00Z,BURAS LA,0,0,0,3,3
Tropical Storm,Charley,7,2004-08-11T03:00:00Z,MYGF 266N 787W,0,0,2,7,9
Tropical Storm,Charley,7,2004-08-11T03:00:00Z,NEW ORLEANS LA,0,0,0,2,2
Tropical Storm,Charley,7,2004-08-11T03:00:00Z,MARATHON FL,0,2,17,3,22
Tropical Storm,Charley,7,2004-08-11T03:00:00Z,GULF 29N 85W,0,0,0,14,14
Tropical Storm,Charley,7,2004-08-11T03:00:00Z,MIAMI FL,0,0,10,7,17
Tropical Storm,Charley,7,2004-08-11T03:00:00Z,GULF 29N 87W,0,0,0,10,10
Tropical Storm,Charley,7,2004-08-11T03:00:00Z,W PALM BEACH FL,0,0,4,10,14
Tropical Storm,Charley,7,2004-08-11T03:00:00Z,GULF 28N 89W,0,0,0,5,5
Tropical Storm,Charley,7,2004-08-11T03:00:00Z,FT PIERCE FL,0,0,2,11,13
Tropical Storm,Charley,8,2004-08-11T09:00:00Z,19.9N  80.0W,47,0,0,0,47
Tropical Storm,Charley,8,2004-08-11T09:00:00Z,JACKSONVILLE FL,0,0,1,24,25
Tropical Storm,Charley,8,2004-08-11T09:00:00Z,22.3N  81.8W,2,31,1,0,34
Tropical Storm,Charley,8,2004-08-11T09:00:00Z,SAVANNAH GA,0,0,0,24,24
Tropical Storm,Charley,8,2004-08-11T09:00:00Z,25.0N  82.5W,0,10,17,1,28
Tropical Storm,Charley,8,2004-08-11T09:00:00Z,CHARLESTON SC,0,0,0,23,23
Tropical Storm,Charley,8,2004-08-11T09:00:00Z,MTCA 183N 738W,19,0,0,0,19
Tropical Storm,Charley,8,2004-08-11T09:00:00Z,MYRTLE BEACH SC,0,0,0,20,20
Tropical Storm,Charley,8,2004-08-11T09:00:00Z,MKJP 179N 768W,82,0,0,0,82
Tropical Storm,Charley,8,2004-08-11T09:00:00Z,WILMINGTON NC,0,0,0,16,16
Tropical Storm,Charley,8,2004-08-11T09:00:00Z,MKJS 185N 779W,69,0,0,0,69
Tropical Storm,Charley,8,2004-08-11T09:00:00Z,MOREHEAD CITY NC,0,0,0,12,12
Tropical Storm,Charley,8,2004-08-11T09:00:00Z,MWCG 193N 814W,27,4,1,0,32
Tropical Storm,Charley,8,2004-08-11T09:00:00Z,CAPE HATTERAS NC,0,0,0,7,7
Tropical Storm,Charley,8,2004-08-11T09:00:00Z,MUGM 200N 751W,2,0,0,0,2
Tropical Storm,Charley,8,2004-08-11T09:00:00Z,NORFOLK VA,0,0,0,5,5
Tropical Storm,Charley,8,2004-08-11T09:00:00Z,MUCM 214N 779W,20,2,0,0,22
Tropical Storm,Charley,8,2004-08-11T09:00:00Z,OCEAN CITY MD,0,0,0,2,2
Tropical Storm,Charley,8,2004-08-11T09:00:00Z,MUCF 221N 805W,10,24,0,0,34
Tropical Storm,Charley,8,2004-08-11T09:00:00Z,KEY WEST FL,0,18,9,1,28
Tropical Storm,Charley,8,2004-08-11T09:00:00Z,MUSN 216N 826W,2,28,1,0,31
Tropical Storm,Charley,8,2004-08-11T09:00:00Z,MARCO ISLAND FL,0,4,19,4,27
Tropical Storm,Charley,8,2004-08-11T09:00:00Z,MUHA 230N 824W,0,28,2,0,30
Tropical Storm,Charley,8,2004-08-11T09:00:00Z,FT MYERS FL,0,1,20,6,27
Tropical Storm,Charley,8,2004-08-11T09:00:00Z,MUAN 219N 850W,0,8,7,0,15
Tropical Storm,Charley,8,2004-08-11T09:00:00Z,VENICE FL,0,0,19,8,27
Tropical Storm,Charley,8,2004-08-11T09:00:00Z,MYAK 241N 776W,0,3,2,1,6
Tropical Storm,Charley,8,2004-08-11T09:00:00Z,TAMPA FL,0,0,13,14,27
Tropical Storm,Charley,8,2004-08-11T09:00:00Z,MYNN 251N 775W,0,1,2,3,6
Tropical Storm,Charley,8,2004-08-11T09:00:00Z,CEDAR KEY FL,0,0,5,20,25
Tropical Storm,Charley,8,2004-08-11T09:00:00Z,MYGF 266N 787W,0,1,6,8,15
Tropical Storm,Charley,8,2004-08-11T09:00:00Z,ST MARKS FL,0,0,1,20,21
Tropical Storm,Charley,8,2004-08-11T09:00:00Z,MARATHON FL,0,16,9,1,26
Tropical Storm,Charley,8,2004-08-11T09:00:00Z,APALACHICOLA FL,0,0,1,17,18
Tropical Storm,Charley,8,2004-08-11T09:00:00Z,MIAMI FL,0,5,14,3,22
Tropical Storm,Charley,8,2004-08-11T09:00:00Z,PANAMA CITY FL,0,0,1,14,15
Tropical Storm,Charley,8,2004-08-11T09:00:00Z,W PALM BEACH FL,0,1,14,7,22
Tropical Storm,Charley,8,2004-08-11T09:00:00Z,PENSACOLA FL,0,0,0,6,6
Tropical Storm,Charley,8,2004-08-11T09:00:00Z,FT PIERCE FL,0,0,12,11,23
Tropical Storm,Charley,8,2004-08-11T09:00:00Z,MOBILE AL,0,0,0,2,2
Tropical Storm,Charley,8,2004-08-11T09:00:00Z,COCOA BEACH FL,0,0,9,15,24
Tropical Storm,Charley,8,2004-08-11T09:00:00Z,GULF 29N 85W,0,0,3,16,19
Tropical Storm,Charley,8,2004-08-11T09:00:00Z,DAYTONA BEACH FL,0,0,5,21,26
Tropical Storm,Charley,8,2004-08-11T09:00:00Z,GULF 29N 87W,0,0,0,7,7
Tropical Storm,Charley,9,2004-08-11T15:00:00Z,20.0N  80.9W,48,1,0,0,49
Tropical Storm,Charley,9,2004-08-11T15:00:00Z,SAVANNAH GA,0,0,0,25,25
Tropical Storm,Charley,9,2004-08-11T15:00:00Z,22.7N  82.0W,2,32,1,0,35
Tropical Storm,Charley,9,2004-08-11T15:00:00Z,CHARLESTON SC,0,0,0,24,24
Tropical Storm,Charley,9,2004-08-11T15:00:00Z,25.0N  82.5W,0,15,13,1,29
Tropical Storm,Charley,9,2004-08-11T15:00:00Z,MYRTLE BEACH SC,0,0,0,21,21
Tropical Storm,Charley,9,2004-08-11T15:00:00Z,MKJP 179N 768W,82,0,0,0,82
Tropical Storm,Charley,9,2004-08-11T15:00:00Z,WILMINGTON NC,0,0,0,18,18
Tropical Storm,Charley,9,2004-08-11T15:00:00Z,MKJS 185N 779W,72,0,0,0,72
Tropical Storm,Charley,9,2004-08-11T15:00:00Z,MOREHEAD CITY NC,0,0,0,12,12
Tropical Storm,Charley,9,2004-08-11T15:00:00Z,MWCG 193N 814W,43,0,0,0,43
Tropical Storm,Charley,9,2004-08-11T15:00:00Z,CAPE HATTERAS NC,0,0,0,7,7
Tropical Storm,Charley,9,2004-08-11T15:00:00Z,MUCM 214N 779W,6,2,1,0,9
Tropical Storm,Charley,9,2004-08-11T15:00:00Z,NORFOLK VA,0,0,0,6,6
Tropical Storm,Charley,9,2004-08-11T15:00:00Z,MUCF 221N 805W,14,20,0,0,34
Tropical Storm,Charley,9,2004-08-11T15:00:00Z,OCEAN CITY MD,0,0,0,2,2
Tropical Storm,Charley,9,2004-08-11T15:00:00Z,MUSN 216N 826W,7,28,0,0,35
Tropical Storm,Charley,9,2004-08-11T15:00:00Z,KEY WEST FL,0,22,7,0,29
Tropical Storm,Charley,9,2004-08-11T15:00:00Z,MUHA 230N 824W,0,32,1,0,33
Tropical Storm,Charley,9,2004-08-11T15:00:00Z,MARCO ISLAND FL,0,7,17,4,28
Tropical Storm,Charley,9,2004-08-11T15:00:00Z,MUAN 219N 850W,0,10,4,1,15
Tropical Storm,Charley,9,2004-08-11T15:00:00Z,FT MYERS FL,0,3,19,7,29
Tropical Storm,Charley,9,2004-08-11T15:00:00Z,MYAK 241N 776W,0,2,1,2,5
Tropical Storm,Charley,9,2004-08-11T15:00:00Z,VENICE FL,0,1,19,9,29
Tropical Storm,Charley,9,2004-08-11T15:00:00Z,MYNN 251N 775W,0,1,2,3,6
Tropical Storm,Charley,9,2004-08-11T15:00:00Z,TAMPA FL,0,0,14,14,28
Tropical Storm,Charley,9,2004-08-11T15:00:00Z,MYGF 266N 787W,0,1,6,10,17
Tropical Storm,Charley,9,2004-08-11T15:00:00Z,CEDAR KEY FL,0,0,7,19,26
Tropical Storm,Charley,9,2004-08-11T15:00:00Z,MARATHON FL,0,19,7,1,27
Tropical Storm,Charley,9,2004-08-11T15:00:00Z,ST MARKS FL,0,0,1,20,21
Tropical Storm,Charley,9,2004-08-11T15:00:00Z,MIAMI FL,0,6,13,5,24
Tropical Storm,Charley,9,2004-08-11T15:00:00Z,APALACHICOLA FL,0,0,2,16,18
Tropical Storm,Charley,9,2004-08-11T15:00:00Z,W PALM BEACH FL,0,2,13,8,23
Tropical Storm,Charley,9,2004-08-11T15:00:00Z,PANAMA CITY FL,0,0,1,14,15
Tropical Storm,Charley,9,2004-08-11T15:00:00Z,FT PIERCE FL,0,1,11,13,25
Tropical Storm,Charley,9,2004-08-11T15:00:00Z,PENSACOLA FL,0,0,0,5,5
Tropical Storm,Charley,9,2004-08-11T15:00:00Z,COCOA BEACH FL,0,0,10,16,26
Tropical Storm,Charley,9,2004-08-11T15:00:00Z,MOBILE AL,0,0,0,2,2
Tropical Storm,Charley,9,2004-08-11T15:00:00Z,DAYTONA BEACH FL,0,0,5,22,27
Tropical Storm,Charley,9,2004-08-11T15:00:00Z,GULF 29N 85W,0,0,3,16,19
Tropical Storm,Charley,9,2004-08-11T15:00:00Z,JACKSONVILLE FL,0,0,1,26,27
Tropical Storm,Charley,9,2004-08-11T15:00:00Z,GULF 29N 87W,0,0,1,6,7
Hurricane,Charley,10,2004-08-11T21:00:00Z,20.5N  81.5W,49,0,0,0,49
Hurricane,Charley,10,2004-08-11T21:00:00Z,SAVANNAH GA,0,0,0,26,26
Hurricane,Charley,10,2004-08-11T21:00:00Z,23.2N  82.5W,2,34,0,0,36
Hurricane,Charley,10,2004-08-11T21:00:00Z,CHARLESTON SC,0,0,0,24,24
Hurricane,Charley,10,2004-08-11T21:00:00Z,26.0N  82.5W,0,10,19,1,30
Hurricane,Charley,10,2004-08-11T21:00:00Z,MYRTLE BEACH SC,0,0,0,21,21
Hurricane,Charley,10,2004-08-11T21:00:00Z,MKJP 179N 768W,59,0,0,0,59
Hurricane,Charley,10,2004-08-11T21:00:00Z,WILMINGTON NC,0,0,0,18,18
Hurricane,Charley,10,2004-08-11T21:00:00Z,MKJS 185N 779W,65,0,0,0,65
Hurricane,Charley,10,2004-08-11T21:00:00Z,MOREHEAD CITY NC,0,0,0,12,12
Hurricane,Charley,10,2004-08-11T21:00:00Z,MWCG 193N 814W,51,0,0,0,51
Hurricane,Charley,10,2004-08-11T21:00:00Z,CAPE HATTERAS NC,0,0,0,7,7
Hurricane,Charley,10,2004-08-11T21:00:00Z,MUCM 214N 779W,2,0,0,0,2
Hurricane,Charley,10,2004-08-11T21:00:00Z,NORFOLK VA,0,0,0,7,7
Hurricane,Charley,10,2004-08-11T21:00:00Z,MUCF 221N 805W,23,9,0,0,32
Hurricane,Charley,10,2004-08-11T21:00:00Z,OCEAN CITY MD,0,0,0,3,3
Hurricane,Charley,10,2004-08-11T21:00:00Z,MUSN 216N 826W,26,14,0,0,40
Hurricane,Charley,10,2004-08-11T21:00:00Z,KEY WEST FL,0,26,4,1,31
Hurricane,Charley,10,2004-08-11T21:00:00Z,MUHA 230N 824W,3,34,0,0,37
Hurricane,Charley,10,2004-08-11T21:00:00Z,MARCO ISLAND FL,0,10,17,1,28
Hurricane,Charley,10,2004-08-11T21:00:00Z,MUAN 219N 850W,1,17,1,0,19
Hurricane,Charley,10,2004-08-11T21:00:00Z,FT MYERS FL,0,5,21,3,29
Hurricane,Charley,10,2004-08-11T21:00:00Z,MYAK 241N 776W,0,0,1,1,2
Hurricane,Charley,10,2004-08-11T21:00:00Z,VENICE FL,0,2,23,5,30
Hurricane,Charley,10,2004-08-11T21:00:00Z,MYNN 251N 775W,0,0,1,1,2
Hurricane,Charley,10,2004-08-11T21:00:00Z,TAMPA FL,0,0,21,8,29
Hurricane,Charley,10,2004-08-11T21:00:00Z,MYGF 266N 787W,0,0,6,7,13
Hurricane,Charley,10,2004-08-11T21:00:00Z,CEDAR KEY FL,0,0,12,16,28
Hurricane,Charley,10,2004-08-11T21:00:00Z,MARATHON FL,0,21,5,0,26
Hurricane,Charley,10,2004-08-11T21:00:00Z,ST MARKS FL,0,0,3,20,23
Hurricane,Charley,10,2004-08-11T21:00:00Z,MIAMI FL,0,6,13,2,21
Hurricane,Charley,10,2004-08-11T21:00:00Z,APALACHICOLA FL,0,0,4,16,20
Hurricane,Charley,10,2004-08-11T21:00:00Z,W PALM BEACH FL,0,2,14,5,21
Hurricane,Charley,10,2004-08-11T21:00:00Z,PANAMA CITY FL,0,0,2,15,17
Hurricane,Charley,10,2004-08-11T21:00:00Z,FT PIERCE FL,0,1,13,9,23
Hurricane,Charley,10,2004-08-11T21:00:00Z,PENSACOLA FL,0,0,0,7,7
Hurricane,Charley,10,2004-08-11T21:00:00Z,COCOA BEACH FL,0,0,13,12,25
Hurricane,Charley,10,2004-08-11T21:00:00Z,MOBILE AL,0,0,0,2,2
Hurricane,Charley,10,2004-08-11T21:00:00Z,DAYTONA BEACH FL,0,0,9,18,27
Hurricane,Charley,10,2004-08-11T21:00:00Z,GULF 29N 85W,0,0,8,13,21
Hurricane,Charley,10,2004-08-11T21:00:00Z,JACKSONVILLE FL,0,0,3,24,27
Hurricane,Charley,10,2004-08-11T21:00:00Z,GULF 29N 87W,0,0,1,8,9
Hurricane,Charley,11,2004-08-12T03:00:00Z,22.5N  82.3W,47,1,0,0,48
Hurricane,Charley,11,2004-08-12T03:00:00Z,WILMINGTON NC,0,0,1,21,22
Hurricane,Charley,11,2004-08-12T03:00:00Z,25.5N  82.5W,1,34,2,0,37
Hurricane,Charley,11,2004-08-12T03:00:00Z,MOREHEAD CITY NC,0,0,0,19,19
Hurricane,Charley,11,2004-08-12T03:00:00Z,29.5N  81.5W,0,1,29,2,32
Hurricane,Charley,11,2004-08-12T03:00:00Z,CAPE HATTERAS NC,0,0,0,15,15
Hurricane,Charley,11,2004-08-12T03:00:00Z,MKJP 179N 768W,25,0,0,0,25
Hurricane,Charley,11,2004-08-12T03:00:00Z,NORFOLK VA,0,0,0,18,18
Hurricane,Charley,11,2004-08-12T03:00:00Z,MKJS 185N 779W,99,0,0,0,99
Hurricane,Charley,11,2004-08-12T03:00:00Z,OCEAN CITY MD,0,0,0,14,14
Hurricane,Charley,11,2004-08-12T03:00:00Z,MWCG 193N 814W,65,0,0,0,65
Hurricane,Charley,11,2004-08-12T03:00:00Z,ATLANTIC CITY NJ,0,0,0,10,10
Hurricane,Charley,11,2004-08-12T03:00:00Z,MUCF 221N 805W,35,0,0,0,35
Hurricane,Charley,11,2004-08-12T03:00:00Z,NEW YORK CITY NY,0,0,0,5,5
Hurricane,Charley,11,2004-08-12T03:00:00Z,MUSN 216N 826W,52,0,0,0,52
Hurricane,Charley,11,2004-08-12T03:00:00Z,MONTAUK POINT NY,0,0,0,2,2
Hurricane,Charley,11,2004-08-12T03:00:00Z,MUHA 230N 824W,40,4,0,0,44
Hurricane,Charley,11,2004-08-12T03:00:00Z,KEY WEST FL,10,25,0,0,35
Hurricane,Charley,11,2004-08-12T03:00:00Z,MUAN 219N 850W,11,5,0,0,16
Hurricane,Charley,11,2004-08-12T03:00:00Z,MARCO ISLAND FL,0,30,4,0,34
Hurricane,Charley,11,2004-08-12T03:00:00Z,MYGF 266N 787W,0,3,5,1,9
Hurricane,Charley,11,2004-08-12T03:00:00Z,FT MYERS FL,0,27,8,1,36
Hurricane,Charley,11,2004-08-12T03:00:00Z,MARATHON FL,6,23,1,0,30
Hurricane,Charley,11,2004-08-12T03:00:00Z,VENICE FL,0,23,13,0,36
Hurricane,Charley,11,2004-08-12T03:00:00Z,MIAMI FL,0,18,5,0,23
Hurricane,Charley,11,2004-08-12T03:00:00Z,TAMPA FL,0,12,23,0,35
Hurricane,Charley,11,2004-08-12T03:00:00Z,W PALM BEACH FL,0,12,11,0,23
Hurricane,Charley,11,2004-08-12T03:00:00Z,CEDAR KEY FL,0,2,29,1,32
Hurricane,Charley,11,2004-08-12T03:00:00Z,FT PIERCE FL,0,9,17,0,26
Hurricane,Charley,11,2004-08-12T03:00:00Z,ST MARKS FL,0,0,20,3,23
Hurricane,Charley,11,2004-08-12T03:00:00Z,COCOA BEACH FL,0,6,22,1,29
Hurricane,Charley,11,2004-08-12T03:00:00Z,APALACHICOLA FL,0,0,16,2,18
Hurricane,Charley,11,2004-08-12T03:00:00Z,DAYTONA BEACH FL,0,2,28,1,31
Hurricane,Charley,11,2004-08-12T03:00:00Z,PANAMA CITY FL,0,0,10,4,14
Hurricane,Charley,11,2004-08-12T03:00:00Z,JACKSONVILLE FL,0,0,26,4,30
Hurricane,Charley,11,2004-08-12T03:00:00Z,PENSACOLA FL,0,0,2,1,3
Hurricane,Charley,11,2004-08-12T03:00:00Z,SAVANNAH GA,0,0,14,15,29
Hurricane,Charley,11,2004-08-12T03:00:00Z,GULF 29N 85W,0,1,17,2,20
Hurricane,Charley,11,2004-08-12T03:00:00Z,CHARLESTON SC,0,0,6,21,27
Hurricane,Charley,11,2004-08-12T03:00:00Z,GULF 29N 87W,0,0,3,1,4
Hurricane,Charley,11,2004-08-12T03:00:00Z,MYRTLE BEACH SC,0,0,2,23,25
Hurricane,Charley,12,2004-08-12T09:00:00Z,23.3N  82.5W,48,1,0,0,49
Hurricane,Charley,12,2004-08-12T09:00:00Z,NORFOLK VA,0,0,0,21,21
Hurricane,Charley,12,2004-08-12T09:00:00Z,26.3N  83.0W,1,34,2,0,37
Hurricane,Charley,12,2004-08-12T09:00:00Z,OCEAN CITY MD,0,0,0,18,18
Hurricane,Charley,12,2004-08-12T09:00:00Z,30.5N  82.0W,0,1,28,3,32
Hurricane,Charley,12,2004-08-12T09:00:00Z,ATLANTIC CITY NJ,0,0,0,17,17
Hurricane,Charley,12,2004-08-12T09:00:00Z,MKJS 185N 779W,29,0,0,0,29
Hurricane,Charley,12,2004-08-12T09:00:00Z,NEW YORK CITY NY,0,0,0,13,13
Hurricane,Charley,12,2004-08-12T09:00:00Z,MWCG 193N 814W,69,0,0,0,69
Hurricane,Charley,12,2004-08-12T09:00:00Z,MONTAUK POINT NY,0,0,0,7,7
Hurricane,Charley,12,2004-08-12T09:00:00Z,MUCF 221N 805W,42,0,0,0,42
Hurricane,Charley,12,2004-08-12T09:00:00Z,PROVIDENCE RI,0,0,0,5,5
Hurricane,Charley,12,2004-08-12T09:00:00Z,MUSN 216N 826W,59,0,0,0,59
Hurricane,Charley,12,2004-08-12T09:00:00Z,NANTUCKET MA,0,0,0,2,2
Hurricane,Charley,12,2004-08-12T09:00:00Z,MUHA 230N 824W,51,1,0,0,52
Hurricane,Charley,12,2004-08-12T09:00:00Z,HYANNIS MA,0,0,0,3,3
Hurricane,Charley,12,2004-08-12T09:00:00Z,MUAN 219N 850W,11,4,0,0,15
Hurricane,Charley,12,2004-08-12T09:00:00Z,BOSTON MA,0,0,0,3,3
Hurricane,Charley,12,2004-08-12T09:00:00Z,MYGF 266N 787W,0,3,2,1,6
Hurricane,Charley,12,2004-08-12T09:00:00Z,PORTLAND ME,0,0,0,2,2
Hurricane,Charley,12,2004-08-12T09:00:00Z,MARATHON FL,16,13,0,1,30
Hurricane,Charley,12,2004-08-12T09:00:00Z,KEY WEST FL,26,11,0,0,37
Hurricane,Charley,12,2004-08-12T09:00:00Z,MIAMI FL,2,16,2,1,21
Hurricane,Charley,12,2004-08-12T09:00:00Z,MARCO ISLAND FL,2,29,2,0,33
Hurricane,Charley,12,2004-08-12T09:00:00Z,W PALM BEACH FL,0,13,7,0,20
Hurricane,Charley,12,2004-08-12T09:00:00Z,FT MYERS FL,1,29,4,0,34
Hurricane,Charley,12,2004-08-12T09:00:00Z,FT PIERCE FL,0,12,10,1,23
Hurricane,Charley,12,2004-08-12T09:00:00Z,VENICE FL,0,29,7,0,36
Hurricane,Charley,12,2004-08-12T09:00:00Z,COCOA BEACH FL,0,10,16,0,26
Hurricane,Charley,12,2004-08-12T09:00:00Z,TAMPA FL,0,21,15,0,36
Hurricane,Charley,12,2004-08-12T09:00:00Z,DAYTONA BEACH FL,0,5,24,1,30
Hurricane,Charley,12,2004-08-12T09:00:00Z,CEDAR KEY FL,0,8,26,0,34
Hurricane,Charley,12,2004-08-12T09:00:00Z,JACKSONVILLE FL,0,1,28,2,31
Hurricane,Charley,12,2004-08-12T09:00:00Z,ST MARKS FL,0,1,25,1,27
Hurricane,Charley,12,2004-08-12T09:00:00Z,SAVANNAH GA,0,0,20,9,29
Hurricane,Charley,12,2004-08-12T09:00:00Z,APALACHICOLA FL,0,1,22,1,24
Hurricane,Charley,12,2004-08-12T09:00:00Z,CHARLESTON SC,0,0,11,16,27
Hurricane,Charley,12,2004-08-12T09:00:00Z,PANAMA CITY FL,0,1,16,1,18
Hurricane,Charley,12,2004-08-12T09:00:00Z,MYRTLE BEACH SC,0,0,4,21,25
Hurricane,Charley,12,2004-08-12T09:00:00Z,PENSACOLA FL,0,0,4,2,6
Hurricane,Charley,12,2004-08-12T09:00:00Z,WILMINGTON NC,0,0,1,21,22
Hurricane,Charley,12,2004-08-12T09:00:00Z,MOBILE AL,0,0,1,1,2
Hurricane,Charley,12,2004-08-12T09:00:00Z,MOREHEAD CITY NC,0,0,0,19,19
Hurricane,Charley,12,2004-08-12T09:00:00Z,GULF 29N 85W,0,4,21,0,25
Hurricane,Charley,12,2004-08-12T09:00:00Z,CAPE HATTERAS NC,0,0,0,17,17
Hurricane,Charley,12,2004-08-12T09:00:00Z,GULF 29N 87W,0,0,7,1,8
Hurricane,Charley,13,2004-08-12T15:00:00Z,24.6N  83.1W,51,1,0,0,52
Hurricane,Charley,13,2004-08-12T15:00:00Z,NORFOLK VA,0,0,0,16,16
Hurricane,Charley,13,2004-08-12T15:00:00Z,28.0N  82.8W,0,35,1,1,37
Hurricane,Charley,13,2004-08-12T15:00:00Z,OCEAN CITY MD,0,0,0,15,15
Hurricane,Charley,13,2004-08-12T15:00:00Z,32.2N  81.2W,0,0,23,1,24
Hurricane,Charley,13,2004-08-12T15:00:00Z,ATLANTIC CITY NJ,0,0,0,14,14
Hurricane,Charley,13,2004-08-12T15:00:00Z,MWCG 193N 814W,99,0,0,0,99
Hurricane,Charley,13,2004-08-12T15:00:00Z,NEW YORK CITY NY,0,0,0,11,11
Hurricane,Charley,13,2004-08-12T15:00:00Z,MUCF 221N 805W,34,0,0,0,34
Hurricane,Charley,13,2004-08-12T15:00:00Z,MONTAUK POINT NY,0,0,0,7,7
Hurricane,Charley,13,2004-08-12T15:00:00Z,MUSN 216N 826W,74,0,0,0,74
Hurricane,Charley,13,2004-08-12T15:00:00Z,PROVIDENCE RI,0,0,0,5,5
Hurricane,Charley,13,2004-08-12T15:00:00Z,MUHA 230N 824W,66,0,0,0,66
Hurricane,Charley,13,2004-08-12T15:00:00Z,NANTUCKET MA,0,0,0,4,4
Hurricane,Charley,13,2004-08-12T15:00:00Z,MUAN 219N 850W,11,0,0,0,11
Hurricane,Charley,13,2004-08-12T15:00:00Z,HYANNIS MA,0,0,0,3,3
Hurricane,Charley,13,2004-08-12T15:00:00Z,MYGF 266N 787W,0,3,0,0,3
Hurricane,Charley,13,2004-08-12T15:00:00Z,BOSTON MA,0,0,0,4,4
Hurricane,Charley,13,2004-08-12T15:00:00Z,MARATHON FL,31,2,0,0,33
Hurricane,Charley,13,2004-08-12T15:00:00Z,PORTLAND ME,0,0,0,2,2
Hurricane,Charley,13,2004-08-12T15:00:00Z,MIAMI FL,9,9,0,0,18
Hurricane,Charley,13,2004-08-12T15:00:00Z,KEY WEST FL,45,0,0,0,45
Hurricane,Charley,13,2004-08-12T15:00:00Z,W PALM BEACH FL,3,13,1,0,17
Hurricane,Charley,13,2004-08-12T15:00:00Z,MARCO ISLAND FL,23,14,0,0,37
Hurricane,Charley,13,2004-08-12T15:00:00Z,FT PIERCE FL,1,19,2,0,22
Hurricane,Charley,13,2004-08-12T15:00:00Z,FT MYERS FL,12,25,0,0,37
Hurricane,Charley,13,2004-08-12T15:00:00Z,COCOA BEACH FL,0,21,4,0,25
Hurricane,Charley,13,2004-08-12T15:00:00Z,VENICE FL,5,34,0,0,39
Hurricane,Charley,13,2004-08-12T15:00:00Z,DAYTONA BEACH FL,0,18,11,0,29
Hurricane,Charley,13,2004-08-12T15:00:00Z,TAMPA FL,1,34,1,0,36
Hurricane,Charley,13,2004-08-12T15:00:00Z,JACKSONVILLE FL,0,6,23,0,29
Hurricane,Charley,13,2004-08-12T15:00:00Z,CEDAR KEY FL,0,26,7,0,33
Hurricane,Charley,13,2004-08-12T15:00:00Z,SAVANNAH GA,0,0,23,2,25
Hurricane,Charley,13,2004-08-12T15:00:00Z,ST MARKS FL,0,8,17,0,25
Hurricane,Charley,13,2004-08-12T15:00:00Z,CHARLESTON SC,0,0,17,5,22
Hurricane,Charley,13,2004-08-12T15:00:00Z,APALACHICOLA FL,0,9,12,0,21
Hurricane,Charley,13,2004-08-12T15:00:00Z,MYRTLE BEACH SC,0,0,9,11,20
Hurricane,Charley,13,2004-08-12T15:00:00Z,PANAMA CITY FL,0,4,10,1,15
Hurricane,Charley,13,2004-08-12T15:00:00Z,WILMINGTON NC,0,0,4,14,18
Hurricane,Charley,13,2004-08-12T15:00:00Z,PENSACOLA FL,0,0,4,0,4
Hurricane,Charley,13,2004-08-12T15:00:00Z,MOREHEAD CITY NC,0,0,1,15,16
Hurricane,Charley,13,2004-08-12T15:00:00Z,GULF 29N 85W,0,16,7,0,23
Hurricane,Charley,13,2004-08-12T15:00:00Z,CAPE HATTERAS NC,0,0,0,14,14
Hurricane,Charley,13,2004-08-12T15:00:00Z,GULF 29N 87W,0,3,2,0,5
Hurricane,Charley,14,2004-08-12T21:00:00Z,26.5N  83.0W,47,1,0,0,48
Hurricane,Charley,14,2004-08-12T21:00:00Z,ATLANTIC CITY NJ,0,0,0,17,17
Hurricane,Charley,14,2004-08-12T21:00:00Z,30.5N  82.3W,0,30,1,0,31
Hurricane,Charley,14,2004-08-12T21:00:00Z,NEW YORK CITY NY,0,0,0,16,16
Hurricane,Charley,14,2004-08-12T21:00:00Z,34.2N  80.0W,0,1,20,2,23
Hurricane,Charley,14,2004-08-12T21:00:00Z,MONTAUK POINT NY,0,0,0,12,12
Hurricane,Charley,14,2004-08-12T21:00:00Z,MUCF 221N 805W,31,0,0,0,31
Hurricane,Charley,14,2004-08-12T21:00:00Z,PROVIDENCE RI,0,0,0,10,10
Hurricane,Charley,14,2004-08-12T21:00:00Z,MUSN 216N 826W,99,0,0,0,99
Hurricane,Charley,14,2004-08-12T21:00:00Z,NANTUCKET MA,0,0,0,7,7
Hurricane,Charley,14,2004-08-12T21:00:00Z,MUHA 230N 824W,82,0,0,0,82
Hurricane,Charley,14,2004-08-12T21:00:00Z,HYANNIS MA,0,0,0,8,8
Hurricane,Charley,14,2004-08-12T21:00:00Z,MYGF 266N 787W,1,2,0,0,3
Hurricane,Charley,14,2004-08-12T21:00:00Z,BOSTON MA,0,0,0,9,9
Hurricane,Charley,14,2004-08-12T21:00:00Z,MARATHON FL,40,0,0,0,40
Hurricane,Charley,14,2004-08-12T21:00:00Z,PORTLAND ME,0,0,0,6,6
Hurricane,Charley,14,2004-08-12T21:00:00Z,MIAMI FL,16,2,0,0,18
Hurricane,Charley,14,2004-08-12T21:00:00Z,BAR HARBOR ME,0,0,0,2,2
Hurricane,Charley,14,2004-08-12T21:00:00Z,W PALM BEACH FL,9,7,0,0,16
Hurricane,Charley,14,2004-08-12T21:00:00Z,KEY WEST FL,59,0,0,0,59
Hurricane,Charley,14,2004-08-12T21:00:00Z,FT PIERCE FL,7,14,0,0,21
Hurricane,Charley,14,2004-08-12T21:00:00Z,MARCO ISLAND FL,43,1,0,0,44
Hurricane,Charley,14,2004-08-12T21:00:00Z,COCOA BEACH FL,5,20,0,0,25
Hurricane,Charley,14,2004-08-12T21:00:00Z,FT MYERS FL,40,2,0,0,42
Hurricane,Charley,14,2004-08-12T21:00:00Z,DAYTONA BEACH FL,1,28,0,0,29
Hurricane,Charley,14,2004-08-12T21:00:00Z,VENICE FL,38,5,0,0,43
Hurricane,Charley,14,2004-08-12T21:00:00Z,JACKSONVILLE FL,0,28,2,0,30
Hurricane,Charley,14,2004-08-12T21:00:00Z,TAMPA FL,21,18,0,0,39
Hurricane,Charley,14,2004-08-12T21:00:00Z,SAVANNAH GA,0,14,13,0,27
Hurricane,Charley,14,2004-08-12T21:00:00Z,CEDAR KEY FL,5,30,0,0,35
Hurricane,Charley,14,2004-08-12T21:00:00Z,CHARLESTON SC,0,4,20,0,24
Hurricane,Charley,14,2004-08-12T21:00:00Z,ST MARKS FL,0,26,0,0,26
Hurricane,Charley,14,2004-08-12T21:00:00Z,MYRTLE BEACH SC,0,1,19,1,21
Hurricane,Charley,14,2004-08-12T21:00:00Z,APALACHICOLA FL,1,19,0,0,20
Hurricane,Charley,14,2004-08-12T21:00:00Z,WILMINGTON NC,0,0,15,4,19
Hurricane,Charley,14,2004-08-12T21:00:00Z,PANAMA CITY FL,0,14,0,0,14
Hurricane,Charley,14,2004-08-12T21:00:00Z,MOREHEAD CITY NC,0,0,8,8,16
Hurricane,Charley,14,2004-08-12T21:00:00Z,PENSACOLA FL,0,3,0,0,3
Hurricane,Charley,14,2004-08-12T21:00:00Z,CAPE HATTERAS NC,0,0,4,10,14
Hurricane,Charley,14,2004-08-12T21:00:00Z,GULF 29N 85W,3,19,0,0,22
Hurricane,Charley,14,2004-08-12T21:00:00Z,NORFOLK VA,0,0,2,15,17
Hurricane,Charley,14,2004-08-12T21:00:00Z,GULF 29N 87W,0,3,0,0,3
Hurricane,Charley,14,2004-08-12T21:00:00Z,OCEAN CITY MD,0,0,0,17,17
Hurricane,Charley,15,2004-08-13T03:00:00Z,26.8N  82.8W,47,3,0,0,50
Hurricane,Charley,15,2004-08-13T03:00:00Z,OCEAN CITY MD,0,0,1,13,14
Hurricane,Charley,15,2004-08-13T03:00:00Z,31.0N  81.7W,0,29,2,0,31
Hurricane,Charley,15,2004-08-13T03:00:00Z,ATLANTIC CITY NJ,0,0,0,13,13
Hurricane,Charley,15,2004-08-13T03:00:00Z,35.0N  79.4W,0,0,19,2,21
Hurricane,Charley,15,2004-08-13T03:00:00Z,NEW YORK CITY NY,0,0,0,12,12
Hurricane,Charley,15,2004-08-13T03:00:00Z,MUCF 221N 805W,14,0,0,0,14
Hurricane,Charley,15,2004-08-13T03:00:00Z,MONTAUK POINT NY,0,0,0,9,9
Hurricane,Charley,15,2004-08-13T03:00:00Z,MUSN 216N 826W,99,0,0,0,99
Hurricane,Charley,15,2004-08-13T03:00:00Z,PROVIDENCE RI,0,0,0,8,8
Hurricane,Charley,15,2004-08-13T03:00:00Z,MUHA 230N 824W,99,0,0,0,99
Hurricane,Charley,15,2004-08-13T03:00:00Z,NANTUCKET MA,0,0,0,6,6
Hurricane,Charley,15,2004-08-13T03:00:00Z,MYGF 266N 787W,1,2,1,0,4
Hurricane,Charley,15,2004-08-13T03:00:00Z,HYANNIS MA,0,0,0,6,6
Hurricane,Charley,15,2004-08-13T03:00:00Z,MARATHON FL,46,0,0,0,46
Hurricane,Charley,15,2004-08-13T03:00:00Z,BOSTON MA,0,0,0,7,7
Hurricane,Charley,15,2004-08-13T03:00:00Z,MIAMI FL,18,4,0,0,22
Hurricane,Charley,15,2004-08-13T03:00:00Z,PORTLAND ME,0,0,0,5,5
Hurricane,Charley,15,2004-08-13T03:00:00Z,W PALM BEACH FL,10,10,0,0,20
Hurricane,Charley,15,2004-08-13T03:00:00Z,BAR HARBOR ME,0,0,0,2,2
Hurricane,Charley,15,2004-08-13T03:00:00Z,FT PIERCE FL,8,17,0,0,25
Hurricane,Charley,15,2004-08-13T03:00:00Z,KEY WEST FL,67,0,0,0,67
Hurricane,Charley,15,2004-08-13T03:00:00Z,COCOA BEACH FL,5,24,0,0,29
Hurricane,Charley,15,2004-08-13T03:00:00Z,MARCO ISLAND FL,48,1,0,0,49
Hurricane,Charley,15,2004-08-13T03:00:00Z,DAYTONA BEACH FL,2,31,0,0,33
Hurricane,Charley,15,2004-08-13T03:00:00Z,FT MYERS FL,45,2,0,0,47
Hurricane,Charley,15,2004-08-13T03:00:00Z,JACKSONVILLE FL,0,31,1,0,32
Hurricane,Charley,15,2004-08-13T03:00:00Z,VENICE FL,43,5,0,0,48
Hurricane,Charley,15,2004-08-13T03:00:00Z,SAVANNAH GA,0,20,8,0,28
Hurricane,Charley,15,2004-08-13T03:00:00Z,TAMPA FL,26,17,0,0,43
Hurricane,Charley,15,2004-08-13T03:00:00Z,CHARLESTON SC,0,8,16,0,24
Hurricane,Charley,15,2004-08-13T03:00:00Z,CEDAR KEY FL,6,31,0,0,37
Hurricane,Charley,15,2004-08-13T03:00:00Z,MYRTLE BEACH SC,0,2,19,0,21
Hurricane,Charley,15,2004-08-13T03:00:00Z,ST MARKS FL,0,23,0,0,23
Hurricane,Charley,15,2004-08-13T03:00:00Z,WILMINGTON NC,0,0,16,3,19
Hurricane,Charley,15,2004-08-13T03:00:00Z,APALACHICOLA FL,1,14,0,0,15
Hurricane,Charley,15,2004-08-13T03:00:00Z,MOREHEAD CITY NC,0,0,11,5,16
Hurricane,Charley,15,2004-08-13T03:00:00Z,PANAMA CITY FL,0,8,0,0,8
Hurricane,Charley,15,2004-08-13T03:00:00Z,CAPE HATTERAS NC,0,0,5,9,14
Hurricane,Charley,15,2004-08-13T03:00:00Z,GULF 29N 85W,3,14,0,0,17
Hurricane,Charley,15,2004-08-13T03:00:00Z,NORFOLK VA,0,0,4,12,16
Hurricane,Charley,16,2004-08-13T09:00:00Z,29.8N  82.5W,35,4,0,0,39
Hurricane,Charley,16,2004-08-13T09:00:00Z,NEW YORK CITY NY,0,0,0,10,10
Hurricane,Charley,16,2004-08-13T09:00:00Z,33.0N  81.0W,0,20,6,0,26
Hurricane,Charley,16,2004-08-13T09:00:00Z,MONTAUK POINT NY,0,0,0,8,8
Hurricane,Charley,16,2004-08-13T09:00:00Z,38.0N  78.5W,0,0,11,5,16
Hurricane,Charley,16,2004-08-13T09:00:00Z,PROVIDENCE RI,0,0,0,7,7
Hurricane,Charley,16,2004-08-13T09:00:00Z,MUSN 216N 826W,12,0,0,0,12
Hurricane,Charley,16,2004-08-13T09:00:00Z,NANTUCKET MA,0,0,0,6,6
Hurricane,Charley,16,2004-08-13T09:00:00Z,MUHA 230N 824W,99,0,0,0,99
Hurricane,Charley,16,2004-08-13T09:00:00Z,HYANNIS MA,0,0,0,6,6
Hurricane,Charley,16,2004-08-13T09:00:00Z,MARATHON FL,52,0,0,0,52
Hurricane,Charley,16,2004-08-13T09:00:00Z,BOSTON MA,0,0,0,7,7
Hurricane,Charley,16,2004-08-13T09:00:00Z,MIAMI FL,9,0,0,0,9
Hurricane,Charley,16,2004-08-13T09:00:00Z,PORTLAND ME,0,0,0,6,6
Hurricane,Charley,16,2004-08-13T09:00:00Z,W PALM BEACH FL,7,1,0,0,8
Hurricane,Charley,16,2004-08-13T09:00:00Z,BAR HARBOR ME,0,0,0,3,3
Hurricane,Charley,16,2004-08-13T09:00:00Z,FT PIERCE FL,11,2,0,0,13
Hurricane,Charley,16,2004-08-13T09:00:00Z,EASTPORT ME,0,0,0,2,2
Hurricane,Charley,16,2004-08-13T09:00:00Z,COCOA BEACH FL,16,4,0,0,20
Hurricane,Charley,16,2004-08-13T09:00:00Z,KEY WEST FL,91,0,0,0,91
Hurricane,Charley,16,2004-08-13T09:00:00Z,DAYTONA BEACH FL,21,6,0,0,27
Hurricane,Charley,16,2004-08-13T09:00:00Z,MARCO ISLAND FL,53,0,0,0,53
Hurricane,Charley,16,2004-08-13T09:00:00Z,JACKSONVILLE FL,19,12,0,0,31
Hurricane,Charley,16,2004-08-13T09:00:00Z,FT MYERS FL,50,0,0,0,50
Hurricane,Charley,16,2004-08-13T09:00:00Z,SAVANNAH GA,2,23,2,0,27
Hurricane,Charley,16,2004-08-13T09:00:00Z,VENICE FL,55,0,0,0,55
Hurricane,Charley,16,2004-08-13T09:00:00Z,CHARLESTON SC,0,15,8,0,23
Hurricane,Charley,16,2004-08-13T09:00:00Z,TAMPA FL,47,0,0,0,47
Hurricane,Charley,16,2004-08-13T09:00:00Z,MYRTLE BEACH SC,0,5,13,0,18
Hurricane,Charley,16,2004-08-13T09:00:00Z,CEDAR KEY FL,43,1,0,0,44
Hurricane,Charley,16,2004-08-13T09:00:00Z,WILMINGTON NC,0,1,12,1,14
Hurricane,Charley,16,2004-08-13T09:00:00Z,ST MARKS FL,30,4,0,0,34
Hurricane,Charley,16,2004-08-13T09:00:00Z,MOREHEAD CITY NC,0,0,9,2,11
Hurricane,Charley,16,2004-08-13T09:00:00Z,APALACHICOLA FL,25,3,0,0,28
Hurricane,Charley,16,2004-08-13T09:00:00Z,CAPE HATTERAS NC,0,0,6,4,10
Hurricane,Charley,16,2004-08-13T09:00:00Z,PANAMA CITY FL,15,5,0,0,20
Hurricane,Charley,16,2004-08-13T09:00:00Z,NORFOLK VA,0,0,6,7,13
Hurricane,Charley,16,2004-08-13T09:00:00Z,PENSACOLA FL,1,2,0,0,3
Hurricane,Charley,16,2004-08-13T09:00:00Z,OCEAN CITY MD,0,0,2,10,12
Hurricane,Charley,16,2004-08-13T09:00:00Z,GULF 29N 85W,29,1,0,0,30
Hurricane,Charley,16,2004-08-13T09:00:00Z,ATLANTIC CITY NJ,0,0,1,10,11
Hurricane,Charley,16,2004-08-13T09:00:00Z,GULF 29N 87W,2,1,0,0,3
Hurricane,Charley,17,2004-08-13T15:00:00Z,31.4N  81.5W,48,6,0,0,54
Hurricane,Charley,17,2004-08-13T15:00:00Z,PROVIDENCE RI,0,0,1,9,10
Hurricane,Charley,17,2004-08-13T15:00:00Z,35.8N  79.2W,0,25,6,0,31
Hurricane,Charley,17,2004-08-13T15:00:00Z,NANTUCKET MA,0,0,0,8,8
Hurricane,Charley,17,2004-08-13T15:00:00Z,40.2N  76.8W,0,0,16,3,19
Hurricane,Charley,17,2004-08-13T15:00:00Z,HYANNIS MA,0,0,0,9,9
Hurricane,Charley,17,2004-08-13T15:00:00Z,MARATHON FL,15,0,0,0,15
Hurricane,Charley,17,2004-08-13T15:00:00Z,BOSTON MA,0,0,0,10,10
Hurricane,Charley,17,2004-08-13T15:00:00Z,W PALM BEACH FL,3,0,0,0,3
Hurricane,Charley,17,2004-08-13T15:00:00Z,PORTLAND ME,0,0,0,9,9
Hurricane,Charley,17,2004-08-13T15:00:00Z,FT PIERCE FL,12,0,0,0,12
Hurricane,Charley,17,2004-08-13T15:00:00Z,BAR HARBOR ME,0,0,0,6,6
Hurricane,Charley,17,2004-08-13T15:00:00Z,COCOA BEACH FL,30,0,0,0,30
Hurricane,Charley,17,2004-08-13T15:00:00Z,EASTPORT ME,0,0,0,4,4
Hurricane,Charley,17,2004-08-13T15:00:00Z,DAYTONA BEACH FL,54,0,0,0,54
Hurricane,Charley,17,2004-08-13T15:00:00Z,ST JOHN NB,0,0,0,3,3
Hurricane,Charley,17,2004-08-13T15:00:00Z,JACKSONVILLE FL,58,1,0,0,59
Hurricane,Charley,17,2004-08-13T15:00:00Z,MONCTON NB,0,0,0,2,2
Hurricane,Charley,17,2004-08-13T15:00:00Z,SAVANNAH GA,33,17,0,0,50
Hurricane,Charley,17,2004-08-13T15:00:00Z,YARMOUTH NS,0,0,0,3,3
Hurricane,Charley,17,2004-08-13T15:00:00Z,CHARLESTON SC,6,34,0,0,40
Hurricane,Charley,17,2004-08-13T15:00:00Z,KEY WEST FL,99,0,0,0,99
Hurricane,Charley,17,2004-08-13T15:00:00Z,MYRTLE BEACH SC,0,29,1,1,31
Hurricane,Charley,17,2004-08-13T15:00:00Z,MARCO ISLAND FL,86,0,0,0,86
Hurricane,Charley,17,2004-08-13T15:00:00Z,WILMINGTON NC,0,19,5,0,24
Hurricane,Charley,17,2004-08-13T15:00:00Z,FT MYERS FL,86,0,0,0,86
Hurricane,Charley,17,2004-08-13T15:00:00Z,MOREHEAD CITY NC,0,8,9,0,17
Hurricane,Charley,17,2004-08-13T15:00:00Z,VENICE FL,91,0,0,0,91
Hurricane,Charley,17,2004-08-13T15:00:00Z,CAPE HATTERAS NC,0,3,9,1,13
Hurricane,Charley,17,2004-08-13T15:00:00Z,TAMPA FL,83,0,0,0,83
Hurricane,Charley,17,2004-08-13T15:00:00Z,NORFOLK VA,0,3,15,0,18
Hurricane,Charley,17,2004-08-13T15:00:00Z,CEDAR KEY FL,71,0,0,0,71
Hurricane,Charley,17,2004-08-13T15:00:00Z,OCEAN CITY MD,0,0,13,3,16
Hurricane,Charley,17,2004-08-13T15:00:00Z,ST MARKS FL,35,1,0,0,36
Hurricane,Charley,17,2004-08-13T15:00:00Z,ATLANTIC CITY NJ,0,0,9,6,15
Hurricane,Charley,17,2004-08-13T15:00:00Z,APALACHICOLA FL,14,0,0,0,14
Hurricane,Charley,17,2004-08-13T15:00:00Z,NEW YORK CITY NY,0,0,5,9,14
Hurricane,Charley,17,2004-08-13T15:00:00Z,PANAMA CITY FL,4,0,0,0,4
Hurricane,Charley,17,2004-08-13T15:00:00Z,MONTAUK POINT NY,0,0,1,10,11
Hurricane,Charley,17,2004-08-13T15:00:00Z,GULF 29N 85W,14,0,0,0,14
Hurricane,Charley,18,2004-08-13T18:00:00Z,31.5N  80.0W,46,3,0,0,49
Hurricane,Charley,18,2004-08-13T18:00:00Z,NEW YORK CITY NY,0,0,13,4,17
Hurricane,Charley,18,2004-08-13T18:00:00Z,36.0N  77.5W,0,24,3,0,27
Hurricane,Charley,18,2004-08-13T18:00:00Z,MONTAUK POINT NY,0,0,7,7,14
Hurricane,Charley,18,2004-08-13T18:00:00Z,40.5N  74.5W,0,1,14,2,17
Hurricane,Charley,18,2004-08-13T18:00:00Z,PROVIDENCE RI,0,0,5,8,13
Hurricane,Charley,18,2004-08-13T18:00:00Z,MUHA 230N 824W,5,0,0,0,5
Hurricane,Charley,18,2004-08-13T18:00:00Z,NANTUCKET MA,0,0,3,9,12
Hurricane,Charley,18,2004-08-13T18:00:00Z,MYGF 266N 787W,2,0,0,0,2
Hurricane,Charley,18,2004-08-13T18:00:00Z,HYANNIS MA,0,0,3,9,12
Hurricane,Charley,18,2004-08-13T18:00:00Z,MARATHON FL,29,0,0,0,29
Hurricane,Charley,18,2004-08-13T18:00:00Z,BOSTON MA,0,0,3,10,13
Hurricane,Charley,18,2004-08-13T18:00:00Z,MIAMI FL,20,0,0,0,20
Hurricane,Charley,18,2004-08-13T18:00:00Z,PORTLAND ME,0,0,1,11,12
Hurricane,Charley,18,2004-08-13T18:00:00Z,W PALM BEACH FL,34,0,0,0,34
Hurricane,Charley,18,2004-08-13T18:00:00Z,BAR HARBOR ME,0,0,0,10,10
Hurricane,Charley,18,2004-08-13T18:00:00Z,FT PIERCE FL,55,0,0,0,55
Hurricane,Charley,18,2004-08-13T18:00:00Z,EASTPORT ME,0,0,0,8,8
Hurricane,Charley,18,2004-08-13T18:00:00Z,COCOA BEACH FL,63,0,0,0,63
Hurricane,Charley,18,2004-08-13T18:00:00Z,ST JOHN NB,0,0,0,7,7
Hurricane,Charley,18,2004-08-13T18:00:00Z,DAYTONA BEACH FL,63,0,0,0,63
Hurricane,Charley,18,2004-08-13T18:00:00Z,MONCTON NB,0,0,0,5,5
Hurricane,Charley,18,2004-08-13T18:00:00Z,JACKSONVILLE FL,49,0,0,0,49
Hurricane,Charley,18,2004-08-13T18:00:00Z,YARMOUTH NS,0,0,0,7,7
Hurricane,Charley,18,2004-08-13T18:00:00Z,SAVANNAH GA,35,6,0,0,41
Hurricane,Charley,18,2004-08-13T18:00:00Z,HALIFAX NS,0,0,0,4,4
Hurricane,Charley,18,2004-08-13T18:00:00Z,CHARLESTON SC,27,14,0,0,41
Hurricane,Charley,18,2004-08-13T18:00:00Z,EDDY POINT NS,0,0,0,2,2
Hurricane,Charley,18,2004-08-13T18:00:00Z,MYRTLE BEACH SC,11,26,0,0,37
Hurricane,Charley,18,2004-08-13T18:00:00Z,KEY WEST FL,99,0,0,0,99
Hurricane,Charley,18,2004-08-13T18:00:00Z,WILMINGTON NC,3,29,0,0,32
Hurricane,Charley,18,2004-08-13T18:00:00Z,MARCO ISLAND FL,88,0,0,0,88
Hurricane,Charley,18,2004-08-13T18:00:00Z,MOREHEAD CITY NC,1,23,2,0,26
Hurricane,Charley,18,2004-08-13T18:00:00Z,FT MYERS FL,84,0,0,0,84
Hurricane,Charley,18,2004-08-13T18:00:00Z,CAPE HATTERAS NC,0,15,6,0,21
Hurricane,Charley,18,2004-08-13T18:00:00Z,VENICE FL,77,0,0,0,77
Hurricane,Charley,18,2004-08-13T18:00:00Z,NORFOLK VA,0,15,9,0,24
Hurricane,Charley,18,2004-08-13T18:00:00Z,TAMPA FL,65,0,0,0,65
Hurricane,Charley,18,2004-08-13T18:00:00Z,OCEAN CITY MD,0,5,15,0,20
Hurricane,Charley,18,2004-08-13T18:00:00Z,CEDAR KEY FL,38,1,0,0,39
Hurricane,Charley,18,2004-08-13T18:00:00Z,ATLANTIC CITY NJ,0,2,15,1,18
Hurricane,Charley,18,2004-08-13T18:00:00Z,ST MARKS FL,5,1,0,0,6
Hurricane,Charley,19,2004-08-13T21:00:00Z,33.9N  79.0W,23,7,0,0,30
Hurricane,Charley,19,2004-08-13T21:00:00Z,NANTUCKET MA,0,0,9,4,13
Hurricane,Charley,19,2004-08-13T21:00:00Z,38.5N  76.3W,0,19,6,0,25
Hurricane,Charley,19,2004-08-13T21:00:00Z,HYANNIS MA,0,0,10,4,14
Hurricane,Charley,19,2004-08-13T21:00:00Z,43.5N  72.0W,0,0,14,2,16
Hurricane,Charley,19,2004-08-13T21:00:00Z,BOSTON MA,0,0,12,3,15
Hurricane,Charley,19,2004-08-13T21:00:00Z,W PALM BEACH FL,8,0,0,0,8
Hurricane,Charley,19,2004-08-13T21:00:00Z,PORTLAND ME,0,0,10,5,15
Hurricane,Charley,19,2004-08-13T21:00:00Z,FT PIERCE FL,39,0,0,0,39
Hurricane,Charley,19,2004-08-13T21:00:00Z,BAR HARBOR ME,0,0,4,9,13
Hurricane,Charley,19,2004-08-13T21:00:00Z,COCOA BEACH FL,72,0,0,0,72
Hurricane,Charley,19,2004-08-13T21:00:00Z,EASTPORT ME,0,0,1,10,11
Hurricane,Charley,19,2004-08-13T21:00:00Z,DAYTONA BEACH FL,76,1,0,0,77
Hurricane,Charley,19,2004-08-13T21:00:00Z,ST JOHN NB,0,0,1,9,10
Hurricane,Charley,19,2004-08-13T21:00:00Z,JACKSONVILLE FL,40,0,0,0,40
Hurricane,Charley,19,2004-08-13T21:00:00Z,MONCTON NB,0,0,0,9,9
Hurricane,Charley,19,2004-08-13T21:00:00Z,SAVANNAH GA,32,0,0,0,32
Hurricane,Charley,19,2004-08-13T21:00:00Z,YARMOUTH NS,0,0,1,9,10
Hurricane,Charley,19,2004-08-13T21:00:00Z,CHARLESTON SC,34,1,0,0,35
Hurricane,Charley,19,2004-08-13T21:00:00Z,HALIFAX NS,0,0,0,7,7
Hurricane,Charley,19,2004-08-13T21:00:00Z,MYRTLE BEACH SC,23,7,1,0,31
Hurricane,Charley,19,2004-08-13T21:00:00Z,SABLE ISLAND NS,0,0,0,3,3
Hurricane,Charley,19,2004-08-13T21:00:00Z,WILMINGTON NC,10,18,0,0,28
Hurricane,Charley,19,2004-08-13T21:00:00Z,SYDNEY NS,0,0,0,4,4
Hurricane,Charley,19,2004-08-13T21:00:00Z,MOREHEAD CITY NC,2,21,1,0,24
Hurricane,Charley,19,2004-08-13T21:00:00Z,EDDY POINT NS,0,0,0,5,5
Hurricane,Charley,19,2004-08-13T21:00:00Z,CAPE HATTERAS NC,0,17,3,1,21
Hurricane,Charley,19,2004-08-13T21:00:00Z,PTX BASQUES NFLD,0,0,0,3,3
Hurricane,Charley,19,2004-08-13T21:00:00Z,NORFOLK VA,0,21,4,0,25
Hurricane,Charley,19,2004-08-13T21:00:00Z,BURGEO NFLD,0,0,0,2,2
Hurricane,Charley,19,2004-08-13T21:00:00Z,OCEAN CITY MD,0,13,10,0,23
Hurricane,Charley,19,2004-08-13T21:00:00Z,MARCO ISLAND FL,99,0,0,0,99
Hurricane,Charley,19,2004-08-13T21:00:00Z,ATLANTIC CITY NJ,0,8,14,0,22
Hurricane,Charley,19,2004-08-13T21:00:00Z,FT MYERS FL,99,0,0,0,99
Hurricane,Charley,19,2004-08-13T21:00:00Z,NEW YORK CITY NY,0,3,17,1,21
Hurricane,Charley,19,2004-08-13T21:00:00Z,VENICE FL,99,0,0,0,99
Hurricane,Charley,19,2004-08-13T21:00:00Z,MONTAUK POINT NY,0,0,15,1,16
Hurricane,Charley,19,2004-08-13T21:00:00Z,TAMPA FL,68,0,0,0,68
Hurricane,Charley,19,2004-08-13T21:00:00Z,PROVIDENCE RI,0,0,13,3,16
Hurricane,Charley,19,2004-08-13T21:00:00Z,CEDAR KEY FL,5,0,0,0,5
Hurricane,Charley,20,2004-08-14T03:00:00Z,36.3N  77.6W,29,6,0,0,35
Hurricane,Charley,20,2004-08-14T03:00:00Z,HYANNIS MA,0,2,8,2,12
Hurricane,Charley,20,2004-08-14T03:00:00Z,41.1N  74.1W,0,14,3,0,17
Hurricane,Charley,20,2004-08-14T03:00:00Z,BOSTON MA,0,3,8,2,13
Hurricane,Charley,20,2004-08-14T03:00:00Z,44.6N  70.7W,0,1,9,2,12
Hurricane,Charley,20,2004-08-14T03:00:00Z,PORTLAND ME,0,1,9,2,12
Hurricane,Charley,20,2004-08-14T03:00:00Z,FT PIERCE FL,33,0,0,0,33
Hurricane,Charley,20,2004-08-14T03:00:00Z,BAR HARBOR ME,0,0,6,5,11
Hurricane,Charley,20,2004-08-14T03:00:00Z,COCOA BEACH FL,99,0,0,0,99
Hurricane,Charley,20,2004-08-14T03:00:00Z,EASTPORT ME,0,0,3,7,10
Hurricane,Charley,20,2004-08-14T03:00:00Z,DAYTONA BEACH FL,99,0,0,0,99
Hurricane,Charley,20,2004-08-14T03:00:00Z,ST JOHN NB,0,0,2,7,9
Hurricane,Charley,20,2004-08-14T03:00:00Z,JACKSONVILLE FL,68,0,0,0,68
Hurricane,Charley,20,2004-08-14T03:00:00Z,MONCTON NB,0,0,1,8,9
Hurricane,Charley,20,2004-08-14T03:00:00Z,SAVANNAH GA,54,0,0,0,54
Hurricane,Charley,20,2004-08-14T03:00:00Z,YARMOUTH NS,0,0,2,7,9
Hurricane,Charley,20,2004-08-14T03:00:00Z,CHARLESTON SC,59,0,0,0,59
Hurricane,Charley,20,2004-08-14T03:00:00Z,HALIFAX NS,0,0,0,7,7
Hurricane,Charley,20,2004-08-14T03:00:00Z,MYRTLE BEACH SC,51,0,0,0,51
Hurricane,Charley,20,2004-08-14T03:00:00Z,SABLE ISLAND NS,0,0,0,5,5
Hurricane,Charley,20,2004-08-14T03:00:00Z,WILMINGTON NC,43,0,0,0,43
Hurricane,Charley,20,2004-08-14T03:00:00Z,SYDNEY NS,0,0,0,6,6
Hurricane,Charley,20,2004-08-14T03:00:00Z,MOREHEAD CITY NC,31,2,1,0,34
Hurricane,Charley,20,2004-08-14T03:00:00Z,EDDY POINT NS,0,0,0,6,6
Hurricane,Charley,20,2004-08-14T03:00:00Z,CAPE HATTERAS NC,18,8,0,0,26
Hurricane,Charley,20,2004-08-14T03:00:00Z,PTX BASQUES NFLD,0,0,0,5,5
Hurricane,Charley,20,2004-08-14T03:00:00Z,NORFOLK VA,16,13,0,0,29
Hurricane,Charley,20,2004-08-14T03:00:00Z,BURGEO NFLD,0,0,0,4,4
Hurricane,Charley,20,2004-08-14T03:00:00Z,OCEAN CITY MD,3,20,0,0,23
Hurricane,Charley,20,2004-08-14T03:00:00Z,ILE ST PIERRE,0,0,0,3,3
Hurricane,Charley,20,2004-08-14T03:00:00Z,ATLANTIC CITY NJ,1,18,1,0,20
Hurricane,Charley,20,2004-08-14T03:00:00Z,FT MYERS FL,7,0,0,0,7
Hurricane,Charley,20,2004-08-14T03:00:00Z,NEW YORK CITY NY,0,14,3,1,18
Hurricane,Charley,20,2004-08-14T03:00:00Z,VENICE FL,18,0,0,0,18
Hurricane,Charley,20,2004-08-14T03:00:00Z,MONTAUK POINT NY,0,7,6,1,14
Hurricane,Charley,20,2004-08-14T03:00:00Z,TAMPA FL,99,0,0,0,99
Hurricane,Charley,20,2004-08-14T03:00:00Z,PROVIDENCE RI,0,5,7,1,13
Hurricane,Charley,20,2004-08-14T03:00:00Z,CEDAR KEY FL,10,0,0,0,10
Hurricane,Charley,20,2004-08-14T03:00:00Z,NANTUCKET MA,0,2,8,1,11
Hurricane,Charley,21,2004-08-14T09:00:00Z,39.0N  75.5W,25,7,1,0,33
Hurricane,Charley,21,2004-08-14T09:00:00Z,NEW YORK CITY NY,7,20,0,0,27
Hurricane,Charley,21,2004-08-14T09:00:00Z,43.5N  72.0W,0,18,4,0,22
Hurricane,Charley,21,2004-08-14T09:00:00Z,MONTAUK POINT NY,1,19,2,0,22
Hurricane,Charley,21,2004-08-14T09:00:00Z,47.0N  67.0W,0,0,13,0,13
Hurricane,Charley,21,2004-08-14T09:00:00Z,PROVIDENCE RI,0,18,3,0,21
Hurricane,Charley,21,2004-08-14T09:00:00Z,DAYTONA BEACH FL,99,0,0,0,99
Hurricane,Charley,21,2004-08-14T09:00:00Z,NANTUCKET MA,0,11,5,0,16
Hurricane,Charley,21,2004-08-14T09:00:00Z,JACKSONVILLE FL,99,0,0,0,99
Hurricane,Charley,21,2004-08-14T09:00:00Z,HYANNIS MA,0,13,5,0,18
Hurricane,Charley,21,2004-08-14T09:00:00Z,SAVANNAH GA,52,0,0,0,52
Hurricane,Charley,21,2004-08-14T09:00:00Z,BOSTON MA,0,16,4,0,20
Hurricane,Charley,21,2004-08-14T09:00:00Z,CHARLESTON SC,79,0,0,0,79
Hurricane,Charley,21,2004-08-14T09:00:00Z,PORTLAND ME,0,11,8,0,19
Hurricane,Charley,21,2004-08-14T09:00:00Z,MYRTLE BEACH SC,72,0,0,0,72
Hurricane,Charley,21,2004-08-14T09:00:00Z,BAR HARBOR ME,0,4,12,0,16
Hurricane,Charley,21,2004-08-14T09:00:00Z,WILMINGTON NC,59,0,0,0,59
Hurricane,Charley,21,2004-08-14T09:00:00Z,EASTPORT ME,0,1,13,0,14
Hurricane,Charley,21,2004-08-14T09:00:00Z,MOREHEAD CITY NC,39,0,0,0,39
Hurricane,Charley,21,2004-08-14T09:00:00Z,ST JOHN NB,0,0,11,0,11
Hurricane,Charley,21,2004-08-14T09:00:00Z,CAPE HATTERAS NC,25,1,0,0,26
Hurricane,Charley,21,2004-08-14T09:00:00Z,MONCTON NB,0,0,8,0,8
Hurricane,Charley,21,2004-08-14T09:00:00Z,NORFOLK VA,38,1,0,0,39
Hurricane,Charley,21,2004-08-14T09:00:00Z,YARMOUTH NS,0,1,9,0,10
Hurricane,Charley,21,2004-08-14T09:00:00Z,OCEAN CITY MD,26,6,0,0,32
Hurricane,Charley,21,2004-08-14T09:00:00Z,HALIFAX NS,0,0,5,0,5
Hurricane,Charley,21,2004-08-14T09:00:00Z,ATLANTIC CITY NJ,17,13,0,0,30
Hurricane,Charley,21,2004-08-14T09:00:00Z,EDDY POINT NS,0,0,2,0,2
Hurricane,Charley,22,2004-08-14T15:00:00Z,41.0N  74.0W,25,6,0,0,31
Hurricane,Charley,22,2004-08-14T15:00:00Z,BOSTON MA,3,22,0,0,25
Hurricane,Charley,22,2004-08-14T15:00:00Z,44.6N  69.7W,0,19,4,0,23
Hurricane,Charley,22,2004-08-14T15:00:00Z,PORTLAND ME,1,22,1,0,24
Hurricane,Charley,22,2004-08-14T15:00:00Z,47.0N  65.0W,0,1,14,2,17
Hurricane,Charley,22,2004-08-14T15:00:00Z,BAR HARBOR ME,0,15,6,0,21
Hurricane,Charley,22,2004-08-14T15:00:00Z,SAVANNAH GA,58,0,0,0,58
Hurricane,Charley,22,2004-08-14T15:00:00Z,EASTPORT ME,0,8,11,0,19
Hurricane,Charley,22,2004-08-14T15:00:00Z,CHARLESTON SC,99,0,0,0,99
Hurricane,Charley,22,2004-08-14T15:00:00Z,ST JOHN NB,0,4,13,1,18
Hurricane,Charley,22,2004-08-14T15:00:00Z,MYRTLE BEACH SC,99,0,0,0,99
Hurricane,Charley,22,2004-08-14T15:00:00Z,MONCTON NB,0,1,14,1,16
Hurricane,Charley,22,2004-08-14T15:00:00Z,WILMINGTON NC,89,0,0,0,89
Hurricane,Charley,22,2004-08-14T15:00:00Z,YARMOUTH NS,0,5,11,0,16
Hurricane,Charley,22,2004-08-14T15:00:00Z,MOREHEAD CITY NC,60,0,0,0,60
Hurricane,Charley,22,2004-08-14T15:00:00Z,HALIFAX NS,0,1,10,3,14
Hurricane,Charley,22,2004-08-14T15:00:00Z,CAPE HATTERAS NC,35,0,0,0,35
Hurricane,Charley,22,2004-08-14T15:00:00Z,SABLE ISLAND NS,0,0,3,6,9
Hurricane,Charley,22,2004-08-14T15:00:00Z,NORFOLK VA,56,0,0,0,56
Hurricane,Charley,22,2004-08-14T15:00:00Z,SYDNEY NS,0,0,4,8,12
Hurricane,Charley,22,2004-08-14T15:00:00Z,OCEAN CITY MD,42,0,0,0,42
Hurricane,Charley,22,2004-08-14T15:00:00Z,EDDY POINT NS,0,0,6,6,12
Hurricane,Charley,22,2004-08-14T15:00:00Z,ATLANTIC CITY NJ,35,1,0,0,36
Hurricane,Charley,22,2004-08-14T15:00:00Z,PTX BASQUES NFLD,0,0,2,9,11
Hurricane,Charley,22,2004-08-14T15:00:00Z,NEW YORK CITY NY,26,5,0,0,31
Hurricane,Charley,22,2004-08-14T15:00:00Z,BURGEO NFLD,0,0,1,9,10
Hurricane,Charley,22,2004-08-14T15:00:00Z,MONTAUK POINT NY,10,16,0,0,26
Hurricane,Charley,22,2004-08-14T15:00:00Z,ILE ST PIERRE,0,0,0,9,9
Hurricane,Charley,22,2004-08-14T15:00:00Z,PROVIDENCE RI,6,19,0,1,26
Hurricane,Charley,22,2004-08-14T15:00:00Z,CAPE RACE NFLD,0,0,0,7,7
Hurricane,Charley,22,2004-08-14T15:00:00Z,NANTUCKET MA,2,17,1,0,20
Hurricane,Charley,22,2004-08-14T15:00:00Z,HIBERNIA OILFLD,0,0,0,3,3
Hurricane,Charley,22,2004-08-14T15:00:00Z,HYANNIS MA,2,19,1,0,22
Tropical Storm,Charley,23,2004-08-14T21:00:00Z,42.7N  70.6W,20,2,0,1,23
Tropical Storm,Charley,23,2004-08-14T21:00:00Z,PORTLAND ME,14,6,0,0,20
Tropical Storm,Charley,23,2004-08-14T21:00:00Z,44.9N  66.7W,1,13,1,1,16
Tropical Storm,Charley,23,2004-08-14T21:00:00Z,BAR HARBOR ME,4,13,0,1,18
Tropical Storm,Charley,23,2004-08-14T21:00:00Z,46.5N  62.0W,0,2,8,2,12
Tropical Storm,Charley,23,2004-08-14T21:00:00Z,EASTPORT ME,1,13,2,0,16
Tropical Storm,Charley,23,2004-08-14T21:00:00Z,MYRTLE BEACH SC,99,0,0,0,99
Tropical Storm,Charley,23,2004-08-14T21:00:00Z,ST JOHN NB,0,11,3,1,15
Tropical Storm,Charley,23,2004-08-14T21:00:00Z,WILMINGTON NC,99,0,0,0,99
Tropical Storm,Charley,23,2004-08-14T21:00:00Z,MONCTON NB,0,7,6,1,14
Tropical Storm,Charley,23,2004-08-14T21:00:00Z,MOREHEAD CITY NC,57,0,0,0,57
Tropical Storm,Charley,23,2004-08-14T21:00:00Z,YARMOUTH NS,1,12,2,0,15
Tropical Storm,Charley,23,2004-08-14T21:00:00Z,CAPE HATTERAS NC,21,0,0,0,21
Tropical Storm,Charley,23,2004-08-14T21:00:00Z,HALIFAX NS,0,6,6,1,13
Tropical Storm,Charley,23,2004-08-14T21:00:00Z,NORFOLK VA,75,0,0,0,75
Tropical Storm,Charley,23,2004-08-14T21:00:00Z,SABLE ISLAND NS,0,1,6,3,10
Tropical Storm,Charley,23,2004-08-14T21:00:00Z,OCEAN CITY MD,60,0,0,0,60
Tropical Storm,Charley,23,2004-08-14T21:00:00Z,SYDNEY NS,0,1,6,4,11
Tropical Storm,Charley,23,2004-08-14T21:00:00Z,ATLANTIC CITY NJ,50,0,0,0,50
Tropical Storm,Charley,23,2004-08-14T21:00:00Z,EDDY POINT NS,0,2,7,3,12
Tropical Storm,Charley,23,2004-08-14T21:00:00Z,NEW YORK CITY NY,39,0,0,0,39
Tropical Storm,Charley,23,2004-08-14T21:00:00Z,PTX BASQUES NFLD,0,0,6,5,11
Tropical Storm,Charley,23,2004-08-14T21:00:00Z,MONTAUK POINT NY,29,0,0,0,29
Tropical Storm,Charley,23,2004-08-14T21:00:00Z,BURGEO NFLD,0,0,4,6,10
Tropical Storm,Charley,23,2004-08-14T21:00:00Z,PROVIDENCE RI,26,0,0,0,26
Tropical Storm,Charley,23,2004-08-14T21:00:00Z,ILE ST PIERRE,0,0,3,6,9
Tropical Storm,Charley,23,2004-08-14T21:00:00Z,NANTUCKET MA,19,2,0,1,22
Tropical Storm,Charley,23,2004-08-14T21:00:00Z,CAPE RACE NFLD,0,0,1,7,8
Tropical Storm,Charley,23,2004-08-14T21:00:00Z,HYANNIS MA,20,2,0,0,22
Tropical Storm,Charley,23,2004-08-14T21:00:00Z,HIBERNIA OILFLD,0,0,0,5,5
Tropical Storm,Charley,23,2004-08-14T21:00:00Z,BOSTON MA,22,2,0,0,24
Tropical Storm,Charley,24,2004-08-15T03:00:00Z,44.1N  66.7W,19,4,0,0,23
Tropical Storm,Charley,24,2004-08-15T03:00:00Z,BAR HARBOR ME,23,1,0,1,25
Tropical Storm,Charley,24,2004-08-15T03:00:00Z,46.2N  62.0W,0,14,2,0,16
Tropical Storm,Charley,24,2004-08-15T03:00:00Z,EASTPORT ME,17,5,0,0,22
Tropical Storm,Charley,24,2004-08-15T03:00:00Z,47.3N  57.0W,0,2,8,3,13
Tropical Storm,Charley,24,2004-08-15T03:00:00Z,ST JOHN NB,11,9,0,0,20
Tropical Storm,Charley,24,2004-08-15T03:00:00Z,CAPE HATTERAS NC,8,0,0,0,8
Tropical Storm,Charley,24,2004-08-15T03:00:00Z,MONCTON NB,4,14,0,0,18
Tropical Storm,Charley,24,2004-08-15T03:00:00Z,NORFOLK VA,99,0,0,0,99
Tropical Storm,Charley,24,2004-08-15T03:00:00Z,YARMOUTH NS,17,5,0,0,22
Tropical Storm,Charley,24,2004-08-15T03:00:00Z,OCEAN CITY MD,99,0,0,0,99
Tropical Storm,Charley,24,2004-08-15T03:00:00Z,HALIFAX NS,3,14,1,0,18
Tropical Storm,Charley,24,2004-08-15T03:00:00Z,ATLANTIC CITY NJ,44,0,0,0,44
Tropical Storm,Charley,24,2004-08-15T03:00:00Z,SABLE ISLAND NS,0,8,4,1,13
Tropical Storm,Charley,24,2004-08-15T03:00:00Z,NEW YORK CITY NY,33,0,0,0,33
Tropical Storm,Charley,24,2004-08-15T03:00:00Z,SYDNEY NS,0,9,5,1,15
Tropical Storm,Charley,24,2004-08-15T03:00:00Z,MONTAUK POINT NY,52,0,0,0,52
Tropical Storm,Charley,24,2004-08-15T03:00:00Z,EDDY POINT NS,0,13,2,1,16
Tropical Storm,Charley,24,2004-08-15T03:00:00Z,PROVIDENCE RI,44,0,1,0,45
Tropical Storm,Charley,24,2004-08-15T03:00:00Z,PTX BASQUES NFLD,0,6,6,2,14
Tropical Storm,Charley,24,2004-08-15T03:00:00Z,NANTUCKET MA,42,0,0,0,42
Tropical Storm,Charley,24,2004-08-15T03:00:00Z,BURGEO NFLD,0,3,7,3,13
Tropical Storm,Charley,24,2004-08-15T03:00:00Z,HYANNIS MA,42,0,1,0,43
Tropical Storm,Charley,24,2004-08-15T03:00:00Z,ILE ST PIERRE,0,1,8,3,12
Tropical Storm,Charley,24,2004-08-15T03:00:00Z,BOSTON MA,37,0,0,0,37
Tropical Storm,Charley,24,2004-08-15T03:00:00Z,CAPE RACE NFLD,0,0,5,5,10
Tropical Storm,Charley,24,2004-08-15T03:00:00Z,PORTLAND ME,26,0,0,1,27
Tropical Storm,Charley,24,2004-08-15T03:00:00Z,HIBERNIA OILFLD,0,0,1,7,8
Tropical Storm,Charley,25,2004-08-15T09:00:00Z,45.5N  65.0W,20,3,0,0,23
Tropical Storm,Charley,25,2004-08-15T09:00:00Z,EASTPORT ME,29,0,0,0,29
Tropical Storm,Charley,25,2004-08-15T09:00:00Z,47.3N  59.9W,0,13,2,1,16
Tropical Storm,Charley,25,2004-08-15T09:00:00Z,ST JOHN NB,24,1,0,0,25
Tropical Storm,Charley,25,2004-08-15T09:00:00Z,48.4N  55.1W,0,2,8,2,12
Tropical Storm,Charley,25,2004-08-15T09:00:00Z,MONCTON NB,17,5,0,0,22
Tropical Storm,Charley,25,2004-08-15T09:00:00Z,OCEAN CITY MD,6,0,0,0,6
Tropical Storm,Charley,25,2004-08-15T09:00:00Z,YARMOUTH NS,25,1,0,0,26
Tropical Storm,Charley,25,2004-08-15T09:00:00Z,ATLANTIC CITY NJ,99,0,0,0,99
Tropical Storm,Charley,25,2004-08-15T09:00:00Z,HALIFAX NS,12,7,1,0,20
Tropical Storm,Charley,25,2004-08-15T09:00:00Z,NEW YORK CITY NY,99,0,0,0,99
Tropical Storm,Charley,25,2004-08-15T09:00:00Z,SABLE ISLAND NS,1,10,1,1,13
Tropical Storm,Charley,25,2004-08-15T09:00:00Z,MONTAUK POINT NY,99,0,0,0,99
Tropical Storm,Charley,25,2004-08-15T09:00:00Z,SYDNEY NS,1,13,2,0,16
Tropical Storm,Charley,25,2004-08-15T09:00:00Z,PROVIDENCE RI,77,0,0,0,77
Tropical Storm,Charley,25,2004-08-15T09:00:00Z,EDDY POINT NS,2,14,1,0,17
Tropical Storm,Charley,25,2004-08-15T09:00:00Z,NANTUCKET MA,44,0,0,0,44
Tropical Storm,Charley,25,2004-08-15T09:00:00Z,PTX BASQUES NFLD,0,11,3,1,15
Tropical Storm,Charley,25,2004-08-15T09:00:00Z,HYANNIS MA,58,0,0,0,58
Tropical Storm,Charley,25,2004-08-15T09:00:00Z,BURGEO NFLD,0,8,5,1,14
Tropical Storm,Charley,25,2004-08-15T09:00:00Z,BOSTON MA,68,0,0,0,68
Tropical Storm,Charley,25,2004-08-15T09:00:00Z,ILE ST PIERRE,0,5,6,2,13
Tropical Storm,Charley,25,2004-08-15T09:00:00Z,PORTLAND ME,50,0,0,0,50
Tropical Storm,Charley,25,2004-08-15T09:00:00Z,CAPE RACE NFLD,0,1,6,4,11
Tropical Storm,Charley,25,2004-08-15T09:00:00Z,BAR HARBOR ME,38,0,0,0,38
Tropical Storm,Charley,25,2004-08-15T09:00:00Z,HIBERNIA OILFLD,0,0,2,6,8
Tropical Depression,Four,1,2004-08-13T15:00:00Z,12.8N  27.0W,44,0,0,0,44
Tropical Depression,Four,1,2004-08-13T15:00:00Z,14.0N  32.0W,0,17,7,1,25
Tropical Depression,Four,1,2004-08-13T15:00:00Z,13.3N  29.5W,12,19,0,0,31
Tropical Depression,Four,2,2004-08-13T21:00:00Z,13.3N  28.3W,44,0,0,0,44
Tropical Depression,Four,2,2004-08-13T21:00:00Z,15.2N  34.1W,0,11,15,1,27
Tropical Depression,Four,2,2004-08-13T21:00:00Z,14.0N  30.9W,10,21,0,0,31
Tropical Storm,Danielle,3,2004-08-14T03:00:00Z,13.7N  29.1W,46,0,0,0,46
Tropical Storm,Danielle,3,2004-08-14T03:00:00Z,15.0N  34.0W,0,17,6,2,25
Tropical Storm,Danielle,3,2004-08-14T03:00:00Z,14.3N  31.6W,12,19,0,1,32
Tropical Storm,Danielle,4,2004-08-14T09:00:00Z,14.2N  30.0W,47,0,0,0,47
Tropical Storm,Danielle,4,2004-08-14T09:00:00Z,16.1N  34.4W,0,21,5,1,27
Tropical Storm,Danielle,4,2004-08-14T09:00:00Z,14.9N  32.3W,16,17,1,0,34
Tropical Storm,Danielle,5,2004-08-14T15:00:00Z,14.5N  31.4W,48,0,0,0,48
Tropical Storm,Danielle,5,2004-08-14T15:00:00Z,16.9N  35.8W,0,19,6,1,26
Tropical Storm,Danielle,5,2004-08-14T15:00:00Z,15.6N  33.6W,17,16,0,0,33
Tropical Storm,Danielle,6,2004-08-14T21:00:00Z,15.5N  32.8W,48,0,0,0,48
Tropical Storm,Danielle,6,2004-08-14T21:00:00Z,18.0N  36.5W,0,23,3,1,27
Tropical Storm,Danielle,6,2004-08-14T21:00:00Z,16.8N  34.8W,19,14,1,0,34
Hurricane,Danielle,7,2004-08-15T03:00:00Z,16.2N  33.6W,47,0,0,0,47
Hurricane,Danielle,7,2004-08-15T03:00:00Z,19.1N  37.0W,0,23,3,1,27
Hurricane,Danielle,7,2004-08-15T03:00:00Z,17.7N  35.4W,19,14,0,0,33
Hurricane,Danielle,8,2004-08-15T09:00:00Z,15.9N  35.9W,48,0,0,0,48
Hurricane,Danielle,8,2004-08-15T09:00:00Z,19.6N  39.6W,0,20,8,1,29
Hurricane,Danielle,8,2004-08-15T09:00:00Z,17.4N  37.7W,25,11,0,0,36
Hurricane,Danielle,9,2004-08-15T15:00:00Z,17.6N  36.6W,48,0,0,0,48
Hurricane,Danielle,9,2004-08-15T15:00:00Z,21.7N  40.0W,0,21,4,1,26
Hurricane,Danielle,9,2004-08-15T15:00:00Z,19.6N  38.5W,13,21,0,0,34
Hurricane,Danielle,10,2004-08-15T21:00:00Z,18.7N  37.6W,48,0,0,0,48
Hurricane,Danielle,10,2004-08-15T21:00:00Z,23.1N  40.2W,0,22,5,1,28
Hurricane,Danielle,10,2004-08-15T21:00:00Z,20.8N  39.2W,14,21,0,0,35
Hurricane,Danielle,11,2004-08-16T03:00:00Z,19.9N  38.5W,56,0,0,0,56
Hurricane,Danielle,11,2004-08-16T03:00:00Z,24.0N  40.5W,0,24,4,1,29
Hurricane,Danielle,11,2004-08-16T03:00:00Z,22.0N  39.8W,11,26,0,1,38
Hurricane,Danielle,12,2004-08-16T09:00:00Z,20.7N  39.2W,48,0,0,0,48
Hurricane,Danielle,12,2004-08-16T09:00:00Z,24.9N  40.7W,0,18,6,1,25
Hurricane,Danielle,12,2004-08-16T09:00:00Z,22.8N  40.2W,9,23,0,1,33
Hurricane,Danielle,13,2004-08-16T15:00:00Z,21.8N  40.3W,49,0,0,0,49
Hurricane,Danielle,13,2004-08-16T15:00:00Z,26.6N  41.6W,0,15,12,1,28
Hurricane,Danielle,13,2004-08-16T15:00:00Z,24.1N  41.2W,7,27,0,0,34
Hurricane,Danielle,14,2004-08-16T21:00:00Z,23.7N  40.6W,48,0,0,0,48
Hurricane,Danielle,14,2004-08-16T21:00:00Z,28.5N  41.3W,0,19,4,1,24
Hurricane,Danielle,14,2004-08-16T21:00:00Z,26.3N  41.2W,12,20,0,0,32
Hurricane,Danielle,15,2004-08-17T03:00:00Z,25.1N  41.0W,37,0,0,0,37
Hurricane,Danielle,15,2004-08-17T03:00:00Z,29.5N  41.0W,0,9,5,3,17
Hurricane,Danielle,15,2004-08-17T03:00:00Z,27.5N  41.2W,6,14,1,1,22
Hurricane,Danielle,16,2004-08-17T09:00:00Z,26.4N  41.1W,38,0,0,0,38
Hurricane,Danielle,16,2004-08-17T09:00:00Z,30.5N  40.7W,0,12,4,2,18
Hurricane,Danielle,16,2004-08-17T09:00:00Z,28.6N  41.1W,11,10,1,1,23
Hurricane,Danielle,17,2004-08-17T15:00:00Z,28.0N  41.0W,40,0,0,0,40
Hurricane,Danielle,17,2004-08-17T15:00:00Z,32.0N  38.5W,1,9,6,2,18
Hurricane,Danielle,17,2004-08-17T15:00:00Z,30.0N  40.0W,15,7,1,0,23
Hurricane,Danielle,18,2004-08-17T21:00:00Z,30.0N  40.0W,36,0,0,0,36
Hurricane,Danielle,18,2004-08-17T21:00:00Z,33.5N  37.5W,1,11,4,3,19
Hurricane,Danielle,18,2004-08-17T21:00:00Z,32.0N  39.0W,10,11,1,1,23
Hurricane,Danielle,19,2004-08-18T03:00:00Z,30.2N  39.3W,30,1,0,0,31
Hurricane,Danielle,19,2004-08-18T03:00:00Z,33.0N  37.0W,1,12,4,2,19
Hurricane,Danielle,19,2004-08-18T03:00:00Z,31.8N  38.2W,11,8,2,1,22
Hurricane,Danielle,20,2004-08-18T09:00:00Z,31.3N  39.5W,29,0,1,0,30
Hurricane,Danielle,20,2004-08-18T09:00:00Z,33.8N  37.0W,2,13,3,2,20
Hurricane,Danielle,20,2004-08-18T09:00:00Z,32.7N  38.4W,13,7,1,1,22
Tropical Storm,Danielle,21,2004-08-18T15:00:00Z,31.5N  39.0W,37,0,0,0,37
Tropical Storm,Danielle,21,2004-08-18T15:00:00Z,33.5N  36.0W,4,13,3,1,21
Tropical Storm,Danielle,21,2004-08-18T15:00:00Z,32.5N  37.5W,20,3,1,0,24
Tropical Storm,Danielle,22,2004-08-18T21:00:00Z,32.0N  37.5W,31,0,0,1,32
Tropical Storm,Danielle,22,2004-08-18T21:00:00Z,33.5N  35.0W,10,8,2,1,21
Tropical Storm,Danielle,22,2004-08-18T21:00:00Z,33.0N  36.5W,20,2,1,0,23
Tropical Storm,Danielle,23,2004-08-19T03:00:00Z,31.2N  35.8W,41,0,1,0,42
Tropical Storm,Danielle,23,2004-08-19T03:00:00Z,33.1N  33.9W,8,10,2,2,22
Tropical Storm,Danielle,23,2004-08-19T03:00:00Z,32.3N  35.0W,21,2,2,0,25
Tropical Storm,Danielle,24,2004-08-19T09:00:00Z,31.1N  36.2W,41,0,0,0,41
Tropical Storm,Danielle,24,2004-08-19T09:00:00Z,32.9N  33.6W,2,13,3,2,20
Tropical Storm,Danielle,24,2004-08-19T09:00:00Z,32.0N  35.0W,18,4,1,1,24
Tropical Storm,Danielle,25,2004-08-19T15:00:00Z,31.0N  36.5W,52,0,0,0,52
Tropical Storm,Danielle,25,2004-08-19T15:00:00Z,32.5N  34.5W,14,3,1,1,19
Tropical Storm,Danielle,25,2004-08-19T15:00:00Z,32.0N  35.5W,23,1,0,1,25
Tropical Storm,Danielle,26,2004-08-19T21:00:00Z,30.8N  37.2W,99,0,0,0,99
Tropical Storm,Danielle,26,2004-08-19T21:00:00Z,32.0N  37.3W,22,1,1,0,24
Tropical Storm,Danielle,26,2004-08-19T21:00:00Z,31.5N  37.0W,28,0,1,0,29
Tropical Storm,Danielle,27,2004-08-20T03:00:00Z,30.5N  35.9W,99,0,0,0,99
Tropical Storm,Danielle,27,2004-08-20T03:00:00Z,31.7N  36.1W,17,2,2,1,22
Tropical Storm,Danielle,27,2004-08-20T03:00:00Z,31.1N  35.9W,25,1,1,0,27
Tropical Storm,Danielle,28,2004-08-20T09:00:00Z,30.8N  37.0W,99,0,0,0,99
Tropical Storm,Danielle,28,2004-08-20T09:00:00Z,31.5N  38.0W,23,1,0,1,25
Tropical Storm,Danielle,28,2004-08-20T09:00:00Z,31.1N  37.4W,99,0,0,0,99
Tropical Storm,Danielle,29,2004-08-20T15:00:00Z,31.5N  38.0W,99,0,0,0,99
Tropical Storm,Danielle,29,2004-08-20T15:00:00Z,32.5N  39.0W,23,1,0,1,25
Tropical Storm,Danielle,29,2004-08-20T15:00:00Z,32.0N  38.5W,36,0,0,0,36
Tropical Depression,Danielle,30,2004-08-20T21:00:00Z,31.8N  38.5W,57,0,0,0,57
Tropical Depression,Danielle,30,2004-08-20T21:00:00Z,33.5N  40.0W,15,2,1,2,20
Tropical Depression,Danielle,30,2004-08-20T21:00:00Z,32.5N  39.0W,29,1,0,0,30
Tropical Depression,Danielle,31,2004-08-21T03:00:00Z,31.9N  39.5W,46,0,0,0,46
Tropical Depression,Danielle,31,2004-08-21T03:00:00Z,33.7N  41.5W,12,3,2,1,18
Tropical Depression,Danielle,31,2004-08-21T03:00:00Z,32.5N  40.3W,26,1,0,0,27
Tropical Depression,Danielle,32,2004-08-21T09:00:00Z,31.5N  40.1W,42,0,0,0,42
Tropical Depression,Danielle,32,2004-08-21T09:00:00Z,33.9N  42.3W,9,4,2,2,17
Tropical Depression,Danielle,32,2004-08-21T09:00:00Z,32.3N  40.9W,24,1,0,1,26
Tropical Depression,Danielle,33,2004-08-21T15:00:00Z,31.5N  40.5W,38,0,0,0,38
Tropical Depression,Danielle,33,2004-08-21T15:00:00Z,34.5N  43.0W,4,6,3,2,15
Tropical Depression,Danielle,33,2004-08-21T15:00:00Z,32.5N  41.5W,21,1,1,0,23
Tropical Depression,Danielle,33,2004-08-21T15:00:00Z,HIBERNIA OILFLD,0,0,0,2,2
Tropical Depression,Five,1,2004-08-13T21:00:00Z,10.3N  52.2W,50,2,0,0,52
Tropical Depression,Five,1,2004-08-13T21:00:00Z,TFFR 163N 615W,0,0,2,15,17
Tropical Depression,Five,1,2004-08-13T21:00:00Z,11.1N  55.7W,1,34,2,0,37
Tropical Depression,Five,1,2004-08-13T21:00:00Z,TAPA 171N 618W,0,0,1,12,13
Tropical Depression,Five,1,2004-08-13T21:00:00Z,12.1N  59.1W,0,3,25,0,28
Tropical Depression,Five,1,2004-08-13T21:00:00Z,TKPK 173N 627W,0,0,0,13,13
Tropical Depression,Five,1,2004-08-13T21:00:00Z,TNCC 122N 690W,0,0,0,4,4
Tropical Depression,Five,1,2004-08-13T21:00:00Z,TNCM 181N 631W,0,0,0,10,10
Tropical Depression,Five,1,2004-08-13T21:00:00Z,SVMG 110N 640W,0,0,1,13,14
Tropical Depression,Five,1,2004-08-13T21:00:00Z,TISX 177N 648W,0,0,0,14,14
Tropical Depression,Five,1,2004-08-13T21:00:00Z,TTPP 106N 614W,0,0,10,7,17
Tropical Depression,Five,1,2004-08-13T21:00:00Z,TIST 183N 650W,0,0,0,11,11
Tropical Depression,Five,1,2004-08-13T21:00:00Z,TTPT 112N 608W,0,0,16,5,21
Tropical Depression,Five,1,2004-08-13T21:00:00Z,TJPS 180N 666W,0,0,0,12,12
Tropical Depression,Five,1,2004-08-13T21:00:00Z,TGPY 120N 618W,0,0,11,11,22
Tropical Depression,Five,1,2004-08-13T21:00:00Z,MDSD 185N 697W,0,0,0,5,5
Tropical Depression,Five,1,2004-08-13T21:00:00Z,TBPB 131N 595W,0,1,24,3,28
Tropical Depression,Five,1,2004-08-13T21:00:00Z,MDCB 176N 714W,0,0,0,2,2
Tropical Depression,Five,1,2004-08-13T21:00:00Z,TVSV 131N 612W,0,0,15,10,25
Tropical Depression,Five,1,2004-08-13T21:00:00Z,TJSJ 184N 661W,0,0,0,10,10
Tropical Depression,Five,1,2004-08-13T21:00:00Z,TLPL 138N 610W,0,0,15,10,25
Tropical Depression,Five,1,2004-08-13T21:00:00Z,ST CROIX VI,0,0,0,14,14
Tropical Depression,Five,1,2004-08-13T21:00:00Z,TFFF 146N 610W,0,0,10,13,23
Tropical Depression,Five,1,2004-08-13T21:00:00Z,ST THOMAS VI,0,0,0,11,11
Tropical Depression,Five,1,2004-08-13T21:00:00Z,TDPR 153N 614W,0,0,5,16,21
Tropical Depression,Five,1,2004-08-13T21:00:00Z,SAN JUAN PR,0,0,0,10,10
Tropical Depression,Five,1,2004-08-13T21:00:00Z,80400 157N 636W,0,0,0,21,21
Tropical Depression,Five,1,2004-08-13T21:00:00Z,PONCE PR,0,0,0,12,12
Tropical Depression,Five,2,2004-08-14T03:00:00Z,11.0N  54.5W,49,2,0,0,51
Tropical Depression,Five,2,2004-08-14T03:00:00Z,TAPA 171N 618W,0,0,7,9,16
Tropical Depression,Five,2,2004-08-14T03:00:00Z,12.1N  58.0W,0,34,1,0,35
Tropical Depression,Five,2,2004-08-14T03:00:00Z,TKPK 173N 627W,0,0,4,12,16
Tropical Depression,Five,2,2004-08-14T03:00:00Z,13.2N  61.3W,0,3,23,1,27
Tropical Depression,Five,2,2004-08-14T03:00:00Z,TNCM 181N 631W,0,0,1,12,13
Tropical Depression,Five,2,2004-08-14T03:00:00Z,TNCC 122N 690W,0,0,0,6,6
Tropical Depression,Five,2,2004-08-14T03:00:00Z,TISX 177N 648W,0,0,0,16,16
Tropical Depression,Five,2,2004-08-14T03:00:00Z,SVMG 110N 640W,0,0,5,6,11
Tropical Depression,Five,2,2004-08-14T03:00:00Z,TIST 183N 650W,0,0,0,14,14
Tropical Depression,Five,2,2004-08-14T03:00:00Z,TTPP 106N 614W,0,2,11,1,14
Tropical Depression,Five,2,2004-08-14T03:00:00Z,TJPS 180N 666W,0,0,0,16,16
Tropical Depression,Five,2,2004-08-14T03:00:00Z,TTPT 112N 608W,0,5,14,1,20
Tropical Depression,Five,2,2004-08-14T03:00:00Z,MDSD 185N 697W,0,0,0,10,10
Tropical Depression,Five,2,2004-08-14T03:00:00Z,TGPY 120N 618W,0,1,19,2,22
Tropical Depression,Five,2,2004-08-14T03:00:00Z,MDCB 176N 714W,0,0,0,7,7
Tropical Depression,Five,2,2004-08-14T03:00:00Z,TBPB 131N 595W,0,19,12,0,31
Tropical Depression,Five,2,2004-08-14T03:00:00Z,MTPP 186N 724W,0,0,0,3,3
Tropical Depression,Five,2,2004-08-14T03:00:00Z,TVSV 131N 612W,0,3,23,1,27
Tropical Depression,Five,2,2004-08-14T03:00:00Z,TJSJ 184N 661W,0,0,0,14,14
Tropical Depression,Five,2,2004-08-14T03:00:00Z,TLPL 138N 610W,0,3,24,1,28
Tropical Depression,Five,2,2004-08-14T03:00:00Z,MDPP 198N 707W,0,0,0,4,4
Tropical Depression,Five,2,2004-08-14T03:00:00Z,TFFF 146N 610W,0,1,24,1,26
Tropical Depression,Five,2,2004-08-14T03:00:00Z,ST CROIX VI,0,0,0,16,16
Tropical Depression,Five,2,2004-08-14T03:00:00Z,TDPR 153N 614W,0,0,20,4,24
Tropical Depression,Five,2,2004-08-14T03:00:00Z,ST THOMAS VI,0,0,0,14,14
Tropical Depression,Five,2,2004-08-14T03:00:00Z,80400 157N 636W,0,0,7,15,22
Tropical Depression,Five,2,2004-08-14T03:00:00Z,SAN JUAN PR,0,0,0,14,14
Tropical Depression,Five,2,2004-08-14T03:00:00Z,TFFR 163N 615W,0,0,13,6,19
Tropical Depression,Five,2,2004-08-14T03:00:00Z,PONCE PR,0,0,0,16,16
Tropical Depression,Five,3,2004-08-14T09:00:00Z,12.0N  56.0W,52,2,0,0,54
Tropical Depression,Five,3,2004-08-14T09:00:00Z,TNCM 181N 631W,0,0,12,4,16
Tropical Depression,Five,3,2004-08-14T09:00:00Z,13.6N  59.9W,0,37,2,0,39
Tropical Depression,Five,3,2004-08-14T09:00:00Z,TISX 177N 648W,0,0,12,10,22
Tropical Depression,Five,3,2004-08-14T09:00:00Z,14.8N  63.9W,0,1,27,2,30
Tropical Depression,Five,3,2004-08-14T09:00:00Z,TIST 183N 650W,0,0,7,12,19
Tropical Depression,Five,3,2004-08-14T09:00:00Z,SKPG 125N 717W,0,0,0,4,4
Tropical Depression,Five,3,2004-08-14T09:00:00Z,TJPS 180N 666W,0,0,4,18,22
Tropical Depression,Five,3,2004-08-14T09:00:00Z,TNCC 122N 690W,0,0,0,8,8
Tropical Depression,Five,3,2004-08-14T09:00:00Z,MDSD 185N 697W,0,0,0,21,21
Tropical Depression,Five,3,2004-08-14T09:00:00Z,SVMG 110N 640W,0,0,3,2,5
Tropical Depression,Five,3,2004-08-14T09:00:00Z,MDCB 176N 714W,0,0,0,21,21
Tropical Depression,Five,3,2004-08-14T09:00:00Z,TTPP 106N 614W,0,3,1,0,4
Tropical Depression,Five,3,2004-08-14T09:00:00Z,MTPP 186N 724W,0,0,0,18,18
Tropical Depression,Five,3,2004-08-14T09:00:00Z,TTPT 112N 608W,0,8,3,1,12
Tropical Depression,Five,3,2004-08-14T09:00:00Z,MTCA 183N 738W,0,0,0,13,13
Tropical Depression,Five,3,2004-08-14T09:00:00Z,TGPY 120N 618W,0,9,9,0,18
Tropical Depression,Five,3,2004-08-14T09:00:00Z,MKJP 179N 768W,0,0,0,2,2
Tropical Depression,Five,3,2004-08-14T09:00:00Z,TBPB 131N 595W,1,37,1,0,39
Tropical Depression,Five,3,2004-08-14T09:00:00Z,MUGM 200N 751W,0,0,0,7,7
Tropical Depression,Five,3,2004-08-14T09:00:00Z,TVSV 131N 612W,0,23,8,0,31
Tropical Depression,Five,3,2004-08-14T09:00:00Z,TJSJ 184N 661W,0,0,4,16,20
Tropical Depression,Five,3,2004-08-14T09:00:00Z,TLPL 138N 610W,0,27,8,0,35
Tropical Depression,Five,3,2004-08-14T09:00:00Z,MDPP 198N 707W,0,0,0,17,17
Tropical Depression,Five,3,2004-08-14T09:00:00Z,TFFF 146N 610W,0,25,11,0,36
Tropical Depression,Five,3,2004-08-14T09:00:00Z,MBJT 215N 712W,0,0,0,10,10
Tropical Depression,Five,3,2004-08-14T09:00:00Z,TDPR 153N 614W,0,15,18,0,33
Tropical Depression,Five,3,2004-08-14T09:00:00Z,MYMM 224N 730W,0,0,0,6,6
Tropical Depression,Five,3,2004-08-14T09:00:00Z,80400 157N 636W,0,1,27,2,30
Tropical Depression,Five,3,2004-08-14T09:00:00Z,ST CROIX VI,0,0,12,10,22
Tropical Depression,Five,3,2004-08-14T09:00:00Z,TFFR 163N 615W,0,6,21,0,27
Tropical Depression,Five,3,2004-08-14T09:00:00Z,ST THOMAS VI,0,0,7,12,19
Tropical Depression,Five,3,2004-08-14T09:00:00Z,TAPA 171N 618W,0,2,18,1,21
Tropical Depression,Five,3,2004-08-14T09:00:00Z,SAN JUAN PR,0,0,4,16,20
Tropical Depression,Five,3,2004-08-14T09:00:00Z,TKPK 173N 627W,0,0,19,2,21
Tropical Depression,Five,3,2004-08-14T09:00:00Z,PONCE PR,0,0,4,18,22
Tropical Depression,Five,4,2004-08-14T15:00:00Z,12.9N  58.8W,53,1,0,0,54
Tropical Depression,Five,4,2004-08-14T15:00:00Z,TIST 183N 650W,0,0,14,4,18
Tropical Depression,Five,4,2004-08-14T15:00:00Z,14.2N  62.4W,0,35,1,0,36
Tropical Depression,Five,4,2004-08-14T15:00:00Z,TJPS 180N 666W,0,0,14,8,22
Tropical Depression,Five,4,2004-08-14T15:00:00Z,15.5N  66.0W,0,2,25,1,28
Tropical Depression,Five,4,2004-08-14T15:00:00Z,MDSD 185N 697W,0,0,1,21,22
Tropical Depression,Five,4,2004-08-14T15:00:00Z,SKPG 125N 717W,0,0,0,3,3
Tropical Depression,Five,4,2004-08-14T15:00:00Z,MDCB 176N 714W,0,0,0,23,23
Tropical Depression,Five,4,2004-08-14T15:00:00Z,TNCC 122N 690W,0,0,1,3,4
Tropical Depression,Five,4,2004-08-14T15:00:00Z,MTPP 186N 724W,0,0,0,22,22
Tropical Depression,Five,4,2004-08-14T15:00:00Z,SVMG 110N 640W,0,2,1,0,3
Tropical Depression,Five,4,2004-08-14T15:00:00Z,MTCA 183N 738W,0,0,0,20,20
Tropical Depression,Five,4,2004-08-14T15:00:00Z,TTPP 106N 614W,1,3,0,0,4
Tropical Depression,Five,4,2004-08-14T15:00:00Z,MKJP 179N 768W,0,0,0,8,8
Tropical Depression,Five,4,2004-08-14T15:00:00Z,TTPT 112N 608W,5,7,0,0,12
Tropical Depression,Five,4,2004-08-14T15:00:00Z,MKJS 185N 779W,0,0,0,5,5
Tropical Depression,Five,4,2004-08-14T15:00:00Z,TGPY 120N 618W,2,18,0,0,20
Tropical Depression,Five,4,2004-08-14T15:00:00Z,MUGM 200N 751W,0,0,0,15,15
Tropical Depression,Five,4,2004-08-14T15:00:00Z,TBPB 131N 595W,43,7,0,0,50
Tropical Depression,Five,4,2004-08-14T15:00:00Z,MUCM 214N 779W,0,0,0,4,4
Tropical Depression,Five,4,2004-08-14T15:00:00Z,TVSV 131N 612W,6,31,0,0,37
Tropical Depression,Five,4,2004-08-14T15:00:00Z,TJSJ 184N 661W,0,0,12,8,20
Tropical Depression,Five,4,2004-08-14T15:00:00Z,TLPL 138N 610W,6,36,0,0,42
Tropical Depression,Five,4,2004-08-14T15:00:00Z,MDPP 198N 707W,0,0,0,18,18
Tropical Depression,Five,4,2004-08-14T15:00:00Z,TFFF 146N 610W,2,38,0,0,40
Tropical Depression,Five,4,2004-08-14T15:00:00Z,MBJT 215N 712W,0,0,0,11,11
Tropical Depression,Five,4,2004-08-14T15:00:00Z,TDPR 153N 614W,0,35,0,1,36
Tropical Depression,Five,4,2004-08-14T15:00:00Z,MYMM 224N 730W,0,0,0,7,7
Tropical Depression,Five,4,2004-08-14T15:00:00Z,80400 157N 636W,0,18,14,0,32
Tropical Depression,Five,4,2004-08-14T15:00:00Z,MYSM 241N 745W,0,0,0,2,2
Tropical Depression,Five,4,2004-08-14T15:00:00Z,TFFR 163N 615W,0,23,4,0,27
Tropical Depression,Five,4,2004-08-14T15:00:00Z,MYEG 235N 758W,0,0,0,2,2
Tropical Depression,Five,4,2004-08-14T15:00:00Z,TAPA 171N 618W,0,12,8,0,20
Tropical Depression,Five,4,2004-08-14T15:00:00Z,ST CROIX VI,0,1,19,2,22
Tropical Depression,Five,4,2004-08-14T15:00:00Z,TKPK 173N 627W,0,7,13,1,21
Tropical Depression,Five,4,2004-08-14T15:00:00Z,ST THOMAS VI,0,0,14,4,18
Tropical Depression,Five,4,2004-08-14T15:00:00Z,TNCM 181N 631W,0,2,12,1,15
Tropical Depression,Five,4,2004-08-14T15:00:00Z,SAN JUAN PR,0,0,12,8,20
Tropical Depression,Five,4,2004-08-14T15:00:00Z,TISX 177N 648W,0,1,19,2,22
Tropical Depression,Five,4,2004-08-14T15:00:00Z,PONCE PR,0,0,14,8,22
Tropical Storm,Earl,5,2004-08-14T21:00:00Z,13.4N  61.3W,50,2,0,0,52
Tropical Storm,Earl,5,2004-08-14T21:00:00Z,MDSD 185N 697W,0,0,14,9,23
Tropical Storm,Earl,5,2004-08-14T21:00:00Z,14.7N  65.1W,0,34,2,0,36
Tropical Storm,Earl,5,2004-08-14T21:00:00Z,MDCB 176N 714W,0,0,9,15,24
Tropical Storm,Earl,5,2004-08-14T21:00:00Z,15.9N  68.8W,0,1,26,1,28
Tropical Storm,Earl,5,2004-08-14T21:00:00Z,MTPP 186N 724W,0,0,2,20,22
Tropical Storm,Earl,5,2004-08-14T21:00:00Z,SKPG 125N 717W,0,0,1,4,5
Tropical Storm,Earl,5,2004-08-14T21:00:00Z,MTCA 183N 738W,0,0,1,21,22
Tropical Storm,Earl,5,2004-08-14T21:00:00Z,TNCC 122N 690W,0,0,4,2,6
Tropical Storm,Earl,5,2004-08-14T21:00:00Z,MKJP 179N 768W,0,0,0,15,15
Tropical Storm,Earl,5,2004-08-14T21:00:00Z,SVMG 110N 640W,1,3,0,0,4
Tropical Storm,Earl,5,2004-08-14T21:00:00Z,MKJS 185N 779W,0,0,0,12,12
Tropical Storm,Earl,5,2004-08-14T21:00:00Z,TTPP 106N 614W,3,0,0,0,3
Tropical Storm,Earl,5,2004-08-14T21:00:00Z,MWCG 193N 814W,0,0,0,2,2
Tropical Storm,Earl,5,2004-08-14T21:00:00Z,TTPT 112N 608W,12,1,0,0,13
Tropical Storm,Earl,5,2004-08-14T21:00:00Z,MUGM 200N 751W,0,0,0,19,19
Tropical Storm,Earl,5,2004-08-14T21:00:00Z,TGPY 120N 618W,24,4,0,0,28
Tropical Storm,Earl,5,2004-08-14T21:00:00Z,MUCM 214N 779W,0,0,0,10,10
Tropical Storm,Earl,5,2004-08-14T21:00:00Z,TBPB 131N 595W,65,0,0,0,65
Tropical Storm,Earl,5,2004-08-14T21:00:00Z,MUCF 221N 805W,0,0,0,3,3
Tropical Storm,Earl,5,2004-08-14T21:00:00Z,TVSV 131N 612W,49,2,0,0,51
Tropical Storm,Earl,5,2004-08-14T21:00:00Z,TJSJ 184N 661W,0,3,15,1,19
Tropical Storm,Earl,5,2004-08-14T21:00:00Z,TLPL 138N 610W,53,1,0,0,54
Tropical Storm,Earl,5,2004-08-14T21:00:00Z,MDPP 198N 707W,0,0,3,15,18
Tropical Storm,Earl,5,2004-08-14T21:00:00Z,TFFF 146N 610W,44,4,0,0,48
Tropical Storm,Earl,5,2004-08-14T21:00:00Z,MBJT 215N 712W,0,0,0,10,10
Tropical Storm,Earl,5,2004-08-14T21:00:00Z,TDPR 153N 614W,26,13,0,0,39
Tropical Storm,Earl,5,2004-08-14T21:00:00Z,MYMM 224N 730W,0,0,0,8,8
Tropical Storm,Earl,5,2004-08-14T21:00:00Z,80400 157N 636W,1,36,0,0,37
Tropical Storm,Earl,5,2004-08-14T21:00:00Z,MYSM 241N 745W,0,0,0,3,3
Tropical Storm,Earl,5,2004-08-14T21:00:00Z,TFFR 163N 615W,7,17,0,0,24
Tropical Storm,Earl,5,2004-08-14T21:00:00Z,MYEG 235N 758W,0,0,0,5,5
Tropical Storm,Earl,5,2004-08-14T21:00:00Z,TAPA 171N 618W,1,13,0,0,14
Tropical Storm,Earl,5,2004-08-14T21:00:00Z,MYAK 241N 776W,0,0,0,3,3
Tropical Storm,Earl,5,2004-08-14T21:00:00Z,TKPK 173N 627W,0,15,2,0,17
Tropical Storm,Earl,5,2004-08-14T21:00:00Z,ST CROIX VI,0,12,9,0,21
Tropical Storm,Earl,5,2004-08-14T21:00:00Z,TNCM 181N 631W,0,7,4,0,11
Tropical Storm,Earl,5,2004-08-14T21:00:00Z,ST THOMAS VI,0,5,11,1,17
Tropical Storm,Earl,5,2004-08-14T21:00:00Z,TISX 177N 648W,0,12,9,0,21
Tropical Storm,Earl,5,2004-08-14T21:00:00Z,SAN JUAN PR,0,3,15,1,19
Tropical Storm,Earl,5,2004-08-14T21:00:00Z,TIST 183N 650W,0,5,11,1,17
Tropical Storm,Earl,5,2004-08-14T21:00:00Z,PONCE PR,0,3,19,1,23
Tropical Storm,Earl,5,2004-08-14T21:00:00Z,TJPS 180N 666W,0,3,19,1,23
Tropical Storm,Earl,6,2004-08-15T03:00:00Z,13.6N  63.5W,53,1,0,0,54
Tropical Storm,Earl,6,2004-08-15T03:00:00Z,MDSD 185N 697W,0,0,16,3,19
Tropical Storm,Earl,6,2004-08-15T03:00:00Z,14.8N  67.2W,0,35,1,0,36
Tropical Storm,Earl,6,2004-08-15T03:00:00Z,MDCB 176N 714W,0,0,19,5,24
Tropical Storm,Earl,6,2004-08-15T03:00:00Z,15.8N  70.7W,0,2,24,1,27
Tropical Storm,Earl,6,2004-08-15T03:00:00Z,MTPP 186N 724W,0,0,8,13,21
Tropical Storm,Earl,6,2004-08-15T03:00:00Z,SKPG 125N 717W,0,0,4,2,6
Tropical Storm,Earl,6,2004-08-15T03:00:00Z,MTCA 183N 738W,0,0,4,18,22
Tropical Storm,Earl,6,2004-08-15T03:00:00Z,TNCC 122N 690W,0,4,3,0,7
Tropical Storm,Earl,6,2004-08-15T03:00:00Z,MKJP 179N 768W,0,0,0,20,20
Tropical Storm,Earl,6,2004-08-15T03:00:00Z,SVMG 110N 640W,4,0,0,0,4
Tropical Storm,Earl,6,2004-08-15T03:00:00Z,MKJS 185N 779W,0,0,0,18,18
Tropical Storm,Earl,6,2004-08-15T03:00:00Z,TTPP 106N 614W,3,0,0,0,3
Tropical Storm,Earl,6,2004-08-15T03:00:00Z,MWCG 193N 814W,0,0,0,6,6
Tropical Storm,Earl,6,2004-08-15T03:00:00Z,TTPT 112N 608W,21,0,0,0,21
Tropical Storm,Earl,6,2004-08-15T03:00:00Z,MUGM 200N 751W,0,0,0,17,17
Tropical Storm,Earl,6,2004-08-15T03:00:00Z,TGPY 120N 618W,44,0,0,0,44
Tropical Storm,Earl,6,2004-08-15T03:00:00Z,MUCM 214N 779W,0,0,0,12,12
Tropical Storm,Earl,6,2004-08-15T03:00:00Z,TBPB 131N 595W,83,0,0,0,83
Tropical Storm,Earl,6,2004-08-15T03:00:00Z,MUCF 221N 805W,0,0,0,5,5
Tropical Storm,Earl,6,2004-08-15T03:00:00Z,TVSV 131N 612W,76,0,0,0,76
Tropical Storm,Earl,6,2004-08-15T03:00:00Z,MUSN 216N 826W,0,0,0,2,2
Tropical Storm,Earl,6,2004-08-15T03:00:00Z,TLPL 138N 610W,71,0,0,0,71
Tropical Storm,Earl,6,2004-08-15T03:00:00Z,TJSJ 184N 661W,0,5,6,0,11
Tropical Storm,Earl,6,2004-08-15T03:00:00Z,TFFF 146N 610W,50,0,0,0,50
Tropical Storm,Earl,6,2004-08-15T03:00:00Z,MDPP 198N 707W,0,0,5,8,13
Tropical Storm,Earl,6,2004-08-15T03:00:00Z,TDPR 153N 614W,31,0,0,0,31
Tropical Storm,Earl,6,2004-08-15T03:00:00Z,MBJT 215N 712W,0,0,0,5,5
Tropical Storm,Earl,6,2004-08-15T03:00:00Z,80400 157N 636W,22,15,0,0,37
Tropical Storm,Earl,6,2004-08-15T03:00:00Z,MYMM 224N 730W,0,0,0,4,4
Tropical Storm,Earl,6,2004-08-15T03:00:00Z,TFFR 163N 615W,8,1,0,0,9
Tropical Storm,Earl,6,2004-08-15T03:00:00Z,MYEG 235N 758W,0,0,0,3,3
Tropical Storm,Earl,6,2004-08-15T03:00:00Z,TAPA 171N 618W,2,2,0,0,4
Tropical Storm,Earl,6,2004-08-15T03:00:00Z,MYAK 241N 776W,0,0,0,2,2
Tropical Storm,Earl,6,2004-08-15T03:00:00Z,TKPK 173N 627W,2,4,0,0,6
Tropical Storm,Earl,6,2004-08-15T03:00:00Z,ST CROIX VI,0,11,2,0,13
Tropical Storm,Earl,6,2004-08-15T03:00:00Z,TNCM 181N 631W,0,2,1,0,3
Tropical Storm,Earl,6,2004-08-15T03:00:00Z,ST THOMAS VI,0,5,2,1,8
Tropical Storm,Earl,6,2004-08-15T03:00:00Z,TISX 177N 648W,0,11,2,0,13
Tropical Storm,Earl,6,2004-08-15T03:00:00Z,SAN JUAN PR,0,5,6,0,11
Tropical Storm,Earl,6,2004-08-15T03:00:00Z,TIST 183N 650W,0,5,2,1,8
Tropical Storm,Earl,6,2004-08-15T03:00:00Z,PONCE PR,0,9,8,0,17
Tropical Storm,Earl,6,2004-08-15T03:00:00Z,TJPS 180N 666W,0,9,8,0,17
Tropical Storm,Earl,7,2004-08-15T09:00:00Z,13.9N  66.5W,52,2,0,0,54
Tropical Storm,Earl,7,2004-08-15T09:00:00Z,MTCA 183N 738W,0,0,20,3,23
Tropical Storm,Earl,7,2004-08-15T09:00:00Z,15.0N  70.6W,0,35,1,1,37
Tropical Storm,Earl,7,2004-08-15T09:00:00Z,MKJP 179N 768W,0,0,9,15,24
Tropical Storm,Earl,7,2004-08-15T09:00:00Z,16.1N  74.4W,0,1,26,0,27
Tropical Storm,Earl,7,2004-08-15T09:00:00Z,MKJS 185N 779W,0,0,3,19,22
Tropical Storm,Earl,7,2004-08-15T09:00:00Z,SKPG 125N 717W,0,6,3,0,9
Tropical Storm,Earl,7,2004-08-15T09:00:00Z,MWCG 193N 814W,0,0,0,18,18
Tropical Storm,Earl,7,2004-08-15T09:00:00Z,TNCC 122N 690W,2,9,0,0,11
Tropical Storm,Earl,7,2004-08-15T09:00:00Z,MUGM 200N 751W,0,0,4,11,15
Tropical Storm,Earl,7,2004-08-15T09:00:00Z,SVMG 110N 640W,4,0,0,0,4
Tropical Storm,Earl,7,2004-08-15T09:00:00Z,MUCM 214N 779W,0,0,0,13,13
Tropical Storm,Earl,7,2004-08-15T09:00:00Z,TTPP 106N 614W,2,0,0,0,2
Tropical Storm,Earl,7,2004-08-15T09:00:00Z,MUCF 221N 805W,0,0,0,12,12
Tropical Storm,Earl,7,2004-08-15T09:00:00Z,TTPT 112N 608W,34,0,0,0,34
Tropical Storm,Earl,7,2004-08-15T09:00:00Z,MUSN 216N 826W,0,0,0,11,11
Tropical Storm,Earl,7,2004-08-15T09:00:00Z,TGPY 120N 618W,68,0,0,0,68
Tropical Storm,Earl,7,2004-08-15T09:00:00Z,MUHA 230N 824W,0,0,0,7,7
Tropical Storm,Earl,7,2004-08-15T09:00:00Z,TBPB 131N 595W,85,0,0,0,85
Tropical Storm,Earl,7,2004-08-15T09:00:00Z,MUAN 219N 850W,0,0,0,5,5
Tropical Storm,Earl,7,2004-08-15T09:00:00Z,TVSV 131N 612W,93,0,0,0,93
Tropical Storm,Earl,7,2004-08-15T09:00:00Z,MMCZ 205N 869W,0,0,0,2,2
Tropical Storm,Earl,7,2004-08-15T09:00:00Z,TLPL 138N 610W,70,0,0,0,70
Tropical Storm,Earl,7,2004-08-15T09:00:00Z,TJSJ 184N 661W,0,2,0,0,2
Tropical Storm,Earl,7,2004-08-15T09:00:00Z,TFFF 146N 610W,22,0,0,0,22
Tropical Storm,Earl,7,2004-08-15T09:00:00Z,MDPP 198N 707W,0,0,5,1,6
Tropical Storm,Earl,7,2004-08-15T09:00:00Z,TDPR 153N 614W,5,0,0,0,5
Tropical Storm,Earl,7,2004-08-15T09:00:00Z,MYEG 235N 758W,0,0,0,2,2
Tropical Storm,Earl,7,2004-08-15T09:00:00Z,80400 157N 636W,20,0,0,0,20
Tropical Storm,Earl,7,2004-08-15T09:00:00Z,MYAK 241N 776W,0,0,0,2,2
Tropical Storm,Earl,7,2004-08-15T09:00:00Z,TISX 177N 648W,1,1,0,0,2
Tropical Storm,Earl,7,2004-08-15T09:00:00Z,ST CROIX VI,1,1,0,0,2
Tropical Storm,Earl,7,2004-08-15T09:00:00Z,TJPS 180N 666W,1,4,0,0,5
Tropical Storm,Earl,7,2004-08-15T09:00:00Z,SAN JUAN PR,0,2,0,0,2
Tropical Storm,Earl,7,2004-08-15T09:00:00Z,MDSD 185N 697W,0,6,7,0,13
Tropical Storm,Earl,7,2004-08-15T09:00:00Z,PONCE PR,1,4,0,0,5
Tropical Storm,Earl,7,2004-08-15T09:00:00Z,MDCB 176N 714W,0,10,15,1,26
Tropical Storm,Earl,7,2004-08-15T09:00:00Z,MARATHON FL,0,0,0,2,2
Tropical Storm,Earl,7,2004-08-15T09:00:00Z,MTPP 186N 724W,0,1,17,1,19
Tropical Storm,Earl,7,2004-08-15T09:00:00Z,KEY WEST FL,0,0,0,2,2
Tropical Storm,Earl,8,2004-08-15T15:00:00Z,14.0N  69.5W,52,2,0,0,54
Tropical Storm,Earl,8,2004-08-15T15:00:00Z,MKJS 185N 779W,0,0,16,8,24
Tropical Storm,Earl,8,2004-08-15T15:00:00Z,15.3N  73.4W,0,35,1,0,36
Tropical Storm,Earl,8,2004-08-15T15:00:00Z,MWCG 193N 814W,0,0,1,20,21
Tropical Storm,Earl,8,2004-08-15T15:00:00Z,16.5N  76.9W,0,2,24,1,27
Tropical Storm,Earl,8,2004-08-15T15:00:00Z,MUGM 200N 751W,0,0,9,3,12
Tropical Storm,Earl,8,2004-08-15T15:00:00Z,SKPG 125N 717W,4,11,0,0,15
Tropical Storm,Earl,8,2004-08-15T15:00:00Z,MUCM 214N 779W,0,0,1,10,11
Tropical Storm,Earl,8,2004-08-15T15:00:00Z,TNCC 122N 690W,20,1,0,0,21
Tropical Storm,Earl,8,2004-08-15T15:00:00Z,MUCF 221N 805W,0,0,0,11,11
Tropical Storm,Earl,8,2004-08-15T15:00:00Z,SVMG 110N 640W,6,0,0,0,6
Tropical Storm,Earl,8,2004-08-15T15:00:00Z,MUSN 216N 826W,0,0,0,14,14
Tropical Storm,Earl,8,2004-08-15T15:00:00Z,TTPP 106N 614W,9,0,0,0,9
Tropical Storm,Earl,8,2004-08-15T15:00:00Z,MUHA 230N 824W,0,0,0,8,8
Tropical Storm,Earl,8,2004-08-15T15:00:00Z,TTPT 112N 608W,99,0,0,0,99
Tropical Storm,Earl,8,2004-08-15T15:00:00Z,MUAN 219N 850W,0,0,0,11,11
Tropical Storm,Earl,8,2004-08-15T15:00:00Z,TGPY 120N 618W,99,0,0,0,99
Tropical Storm,Earl,8,2004-08-15T15:00:00Z,MMCZ 205N 869W,0,0,0,8,8
Tropical Storm,Earl,8,2004-08-15T15:00:00Z,TVSV 131N 612W,83,0,0,0,83
Tropical Storm,Earl,8,2004-08-15T15:00:00Z,MZBZ 175N 883W,0,0,0,2,2
Tropical Storm,Earl,8,2004-08-15T15:00:00Z,TLPL 138N 610W,12,0,0,0,12
Tropical Storm,Earl,8,2004-08-15T15:00:00Z,MHNJ 165N 859W,0,0,0,5,5
Tropical Storm,Earl,8,2004-08-15T15:00:00Z,MDSD 185N 697W,0,4,0,0,4
Tropical Storm,Earl,8,2004-08-15T15:00:00Z,MNPC 141N 834W,0,0,0,3,3
Tropical Storm,Earl,8,2004-08-15T15:00:00Z,MDCB 176N 714W,0,20,2,0,22
Tropical Storm,Earl,8,2004-08-15T15:00:00Z,MDPP 198N 707W,0,1,1,0,2
Tropical Storm,Earl,8,2004-08-15T15:00:00Z,MTPP 186N 724W,0,8,7,0,15
Tropical Storm,Earl,8,2004-08-15T15:00:00Z,MARATHON FL,0,0,0,2,2
Tropical Storm,Earl,8,2004-08-15T15:00:00Z,MTCA 183N 738W,0,8,13,1,22
Tropical Storm,Earl,8,2004-08-15T15:00:00Z,KEY WEST FL,0,0,0,2,2
Tropical Storm,Earl,8,2004-08-15T15:00:00Z,MKJP 179N 768W,0,1,22,3,26
Tropical Storm,Earl,9,2004-08-15T21:00:00Z,14.2N  71.2W,50,3,0,0,53
Tropical Storm,Earl,9,2004-08-15T21:00:00Z,MUCM 214N 779W,0,0,2,3,5
Tropical Storm,Earl,9,2004-08-15T21:00:00Z,15.2N  75.4W,0,34,2,0,36
Tropical Storm,Earl,9,2004-08-15T21:00:00Z,MUCF 221N 805W,0,0,0,6,6
Tropical Storm,Earl,9,2004-08-15T21:00:00Z,16.0N  79.0W,0,2,24,1,27
Tropical Storm,Earl,9,2004-08-15T21:00:00Z,MUSN 216N 826W,0,0,0,11,11
Tropical Storm,Earl,9,2004-08-15T21:00:00Z,SKPG 125N 717W,14,4,0,0,18
Tropical Storm,Earl,9,2004-08-15T21:00:00Z,MUHA 230N 824W,0,0,0,5,5
Tropical Storm,Earl,9,2004-08-15T21:00:00Z,TNCC 122N 690W,18,0,0,0,18
Tropical Storm,Earl,9,2004-08-15T21:00:00Z,MUAN 219N 850W,0,0,0,10,10
Tropical Storm,Earl,9,2004-08-15T21:00:00Z,SVMG 110N 640W,7,0,0,0,7
Tropical Storm,Earl,9,2004-08-15T21:00:00Z,MMCZ 205N 869W,0,0,0,12,12
Tropical Storm,Earl,9,2004-08-15T21:00:00Z,TGPY 120N 618W,99,0,0,0,99
Tropical Storm,Earl,9,2004-08-15T21:00:00Z,MZBZ 175N 883W,0,0,0,8,8
Tropical Storm,Earl,9,2004-08-15T21:00:00Z,MDCB 176N 714W,3,9,0,0,12
Tropical Storm,Earl,9,2004-08-15T21:00:00Z,MGPB 157N 886W,0,0,0,3,3
Tropical Storm,Earl,9,2004-08-15T21:00:00Z,MTPP 186N 724W,0,5,1,0,6
Tropical Storm,Earl,9,2004-08-15T21:00:00Z,MHNJ 165N 859W,0,0,0,14,14
Tropical Storm,Earl,9,2004-08-15T21:00:00Z,MTCA 183N 738W,0,12,3,1,16
Tropical Storm,Earl,9,2004-08-15T21:00:00Z,MNPC 141N 834W,0,0,1,10,11
Tropical Storm,Earl,9,2004-08-15T21:00:00Z,MKJP 179N 768W,0,7,18,0,25
Tropical Storm,Earl,9,2004-08-15T21:00:00Z,MNBL 120N 839W,0,0,0,2,2
Tropical Storm,Earl,9,2004-08-15T21:00:00Z,MKJS 185N 779W,0,1,19,2,22
Tropical Storm,Earl,9,2004-08-15T21:00:00Z,SKSP 126N 817W,0,0,2,4,6
Tropical Storm,Earl,9,2004-08-15T21:00:00Z,MWCG 193N 814W,0,0,4,16,20
Tropical Storm,Earl,9,2004-08-15T21:00:00Z,MMMD 210N 897W,0,0,0,4,4
Tropical Storm,Earl,9,2004-08-15T21:00:00Z,MUGM 200N 751W,0,1,4,1,6
Tropical Storm,Earl,10,2004-08-16T03:00:00Z,14.3N  72.9W,47,1,0,0,48
Tropical Storm,Earl,10,2004-08-16T03:00:00Z,MUSN 216N 826W,0,0,1,9,10
Tropical Storm,Earl,10,2004-08-16T03:00:00Z,14.9N  76.5W,0,36,1,0,37
Tropical Storm,Earl,10,2004-08-16T03:00:00Z,MUHA 230N 824W,0,0,0,4,4
Tropical Storm,Earl,10,2004-08-16T03:00:00Z,15.5N  80.0W,0,3,26,0,29
Tropical Storm,Earl,10,2004-08-16T03:00:00Z,MUAN 219N 850W,0,0,0,10,10
Tropical Storm,Earl,10,2004-08-16T03:00:00Z,SKPG 125N 717W,14,0,0,0,14
Tropical Storm,Earl,10,2004-08-16T03:00:00Z,MMCZ 205N 869W,0,0,0,13,13
Tropical Storm,Earl,10,2004-08-16T03:00:00Z,TNCC 122N 690W,13,0,0,0,13
Tropical Storm,Earl,10,2004-08-16T03:00:00Z,MZBZ 175N 883W,0,0,0,11,11
Tropical Storm,Earl,10,2004-08-16T03:00:00Z,MDCB 176N 714W,3,1,0,0,4
Tropical Storm,Earl,10,2004-08-16T03:00:00Z,MGPB 157N 886W,0,0,0,7,7
Tropical Storm,Earl,10,2004-08-16T03:00:00Z,MTCA 183N 738W,0,6,1,0,7
Tropical Storm,Earl,10,2004-08-16T03:00:00Z,MHNJ 165N 859W,0,0,0,16,16
Tropical Storm,Earl,10,2004-08-16T03:00:00Z,MKJP 179N 768W,0,14,8,1,23
Tropical Storm,Earl,10,2004-08-16T03:00:00Z,MNPC 141N 834W,0,0,4,12,16
Tropical Storm,Earl,10,2004-08-16T03:00:00Z,MKJS 185N 779W,0,4,15,0,19
Tropical Storm,Earl,10,2004-08-16T03:00:00Z,MNBL 120N 839W,0,0,0,7,7
Tropical Storm,Earl,10,2004-08-16T03:00:00Z,MWCG 193N 814W,0,0,10,9,19
Tropical Storm,Earl,10,2004-08-16T03:00:00Z,SKSP 126N 817W,0,0,5,7,12
Tropical Storm,Earl,10,2004-08-16T03:00:00Z,MUCM 214N 779W,0,0,1,1,2
Tropical Storm,Earl,10,2004-08-16T03:00:00Z,MRLM 100N 831W,0,0,0,2,2
Tropical Storm,Earl,10,2004-08-16T03:00:00Z,MUCF 221N 805W,0,0,1,3,4
Tropical Storm,Earl,10,2004-08-16T03:00:00Z,MMMD 210N 897W,0,0,0,6,6
Tropical Storm,Earl,11,2004-08-16T09:00:00Z,15.0N  74.6W,48,2,0,0,50
Tropical Storm,Earl,11,2004-08-16T09:00:00Z,MUHA 230N 824W,0,0,0,5,5
Tropical Storm,Earl,11,2004-08-16T09:00:00Z,15.7N  78.1W,1,35,1,0,37
Tropical Storm,Earl,11,2004-08-16T09:00:00Z,MUAN 219N 850W,0,0,0,13,13
Tropical Storm,Earl,11,2004-08-16T09:00:00Z,16.3N  81.2W,0,6,22,1,29
Tropical Storm,Earl,11,2004-08-16T09:00:00Z,MMCZ 205N 869W,0,0,0,16,16
Tropical Storm,Earl,11,2004-08-16T09:00:00Z,SKPG 125N 717W,3,0,0,0,3
Tropical Storm,Earl,11,2004-08-16T09:00:00Z,MZBZ 175N 883W,0,0,0,13,13
Tropical Storm,Earl,11,2004-08-16T09:00:00Z,MDCB 176N 714W,3,0,0,0,3
Tropical Storm,Earl,11,2004-08-16T09:00:00Z,MGPB 157N 886W,0,0,0,8,8
Tropical Storm,Earl,11,2004-08-16T09:00:00Z,MTCA 183N 738W,3,3,0,0,6
Tropical Storm,Earl,11,2004-08-16T09:00:00Z,MHNJ 165N 859W,0,0,2,15,17
Tropical Storm,Earl,11,2004-08-16T09:00:00Z,MKJP 179N 768W,0,24,1,0,25
Tropical Storm,Earl,11,2004-08-16T09:00:00Z,MNPC 141N 834W,0,0,7,7,14
Tropical Storm,Earl,11,2004-08-16T09:00:00Z,MKJS 185N 779W,0,15,6,0,21
Tropical Storm,Earl,11,2004-08-16T09:00:00Z,MNBL 120N 839W,0,0,0,4,4
Tropical Storm,Earl,11,2004-08-16T09:00:00Z,MWCG 193N 814W,0,0,17,4,21
Tropical Storm,Earl,11,2004-08-16T09:00:00Z,SKSP 126N 817W,0,0,4,3,7
Tropical Storm,Earl,11,2004-08-16T09:00:00Z,MUCM 214N 779W,0,0,1,1,2
Tropical Storm,Earl,11,2004-08-16T09:00:00Z,MMFR 185N 926W,0,0,0,2,2
Tropical Storm,Earl,11,2004-08-16T09:00:00Z,MUCF 221N 805W,0,0,1,4,5
Tropical Storm,Earl,11,2004-08-16T09:00:00Z,MMMD 210N 897W,0,0,0,9,9
Tropical Storm,Earl,11,2004-08-16T09:00:00Z,MUSN 216N 826W,0,0,2,9,11
Tropical Depression,Six,1,2004-08-25T03:00:00Z,12.4N  40.7W,46,0,0,0,46
Tropical Depression,Six,1,2004-08-25T03:00:00Z,13.8N  45.1W,0,20,4,2,26
Tropical Depression,Six,1,2004-08-25T03:00:00Z,13.0N  43.0W,16,16,1,0,33
Tropical Depression,Six,2,2004-08-25T09:00:00Z,12.5N  42.3W,46,0,0,0,46
Tropical Depression,Six,2,2004-08-25T09:00:00Z,14.5N  46.0W,1,20,4,1,26
Tropical Depression,Six,2,2004-08-25T09:00:00Z,13.5N  44.0W,28,7,0,0,35
Tropical Depression,Six,3,2004-08-25T15:00:00Z,12.6N  43.7W,47,0,0,0,47
Tropical Depression,Six,3,2004-08-25T15:00:00Z,14.5N  47.2W,1,23,2,1,27
Tropical Depression,Six,3,2004-08-25T15:00:00Z,13.5N  45.6W,24,10,0,1,35
Tropical Storm,Frances,4,2004-08-25T21:00:00Z,13.0N  45.0W,47,0,0,0,47
Tropical Storm,Frances,4,2004-08-25T21:00:00Z,14.9N  48.1W,3,22,1,1,27
Tropical Storm,Frances,4,2004-08-25T21:00:00Z,13.9N  46.6W,29,6,0,0,35
Tropical Storm,Frances,5,2004-08-26T03:00:00Z,13.5N  46.0W,47,0,0,0,47
Tropical Storm,Frances,5,2004-08-26T03:00:00Z,15.5N  49.0W,3,20,2,1,26
Tropical Storm,Frances,5,2004-08-26T03:00:00Z,14.5N  47.5W,29,5,0,0,34
Tropical Storm,Frances,6,2004-08-26T09:00:00Z,14.5N  48.0W,46,0,0,0,46
Tropical Storm,Frances,6,2004-08-26T09:00:00Z,17.0N  51.5W,1,23,2,1,27
Tropical Storm,Frances,6,2004-08-26T09:00:00Z,16.0N  50.0W,16,17,0,0,33
Tropical Storm,Frances,7,2004-08-26T15:00:00Z,15.2N  49.2W,44,1,0,0,45
Tropical Storm,Frances,7,2004-08-26T15:00:00Z,17.5N  52.3W,1,23,1,2,27
Tropical Storm,Frances,7,2004-08-26T15:00:00Z,16.4N  51.1W,18,13,0,0,31
Tropical Storm,Frances,7,2004-08-26T15:00:00Z,TBPB 131N 595W,0,0,0,2,2
Hurricane,Frances,8,2004-08-26T21:00:00Z,15.8N  50.2W,48,0,0,0,48
Hurricane,Frances,8,2004-08-26T21:00:00Z,17.8N  52.8W,0,23,3,1,27
Hurricane,Frances,8,2004-08-26T21:00:00Z,16.9N  51.7W,15,17,1,0,33
Hurricane,Frances,9,2004-08-27T03:00:00Z,16.3N  51.2W,49,0,0,0,49
Hurricane,Frances,9,2004-08-27T03:00:00Z,18.4N  54.0W,1,21,4,1,27
Hurricane,Frances,9,2004-08-27T03:00:00Z,17.5N  52.8W,15,18,0,1,34
Hurricane,Frances,10,2004-08-27T09:00:00Z,16.5N  52.0W,49,0,0,0,49
Hurricane,Frances,10,2004-08-27T09:00:00Z,TFFR 163N 615W,0,0,0,3,3
Hurricane,Frances,10,2004-08-27T09:00:00Z,18.0N  53.5W,15,19,0,1,35
Hurricane,Frances,10,2004-08-27T09:00:00Z,TAPA 171N 618W,0,0,0,4,4
Hurricane,Frances,10,2004-08-27T09:00:00Z,19.0N  55.5W,0,16,11,1,28
Hurricane,Frances,10,2004-08-27T09:00:00Z,TKPK 173N 627W,0,0,0,2,2
Hurricane,Frances,10,2004-08-27T09:00:00Z,TDPR 153N 614W,0,0,0,2,2
Hurricane,Frances,10,2004-08-27T09:00:00Z,TNCM 181N 631W,0,0,0,3,3
Hurricane,Frances,11,2004-08-27T15:00:00Z,17.0N  52.1W,50,0,0,0,50
Hurricane,Frances,11,2004-08-27T15:00:00Z,TFFR 163N 615W,0,0,0,3,3
Hurricane,Frances,11,2004-08-27T15:00:00Z,18.0N  53.6W,24,9,1,0,34
Hurricane,Frances,11,2004-08-27T15:00:00Z,TAPA 171N 618W,0,0,0,4,4
Hurricane,Frances,11,2004-08-27T15:00:00Z,18.9N  55.2W,1,20,5,1,27
Hurricane,Frances,11,2004-08-27T15:00:00Z,TKPK 173N 627W,0,0,0,3,3
Hurricane,Frances,11,2004-08-27T15:00:00Z,TDPR 153N 614W,0,0,0,2,2
Hurricane,Frances,11,2004-08-27T15:00:00Z,TNCM 181N 631W,0,0,0,3,3
Hurricane,Frances,12,2004-08-27T21:00:00Z,17.9N  52.8W,52,0,0,0,52
Hurricane,Frances,12,2004-08-27T21:00:00Z,TFFR 163N 615W,0,0,0,5,5
Hurricane,Frances,12,2004-08-27T21:00:00Z,18.9N  54.5W,15,20,0,0,35
Hurricane,Frances,12,2004-08-27T21:00:00Z,TAPA 171N 618W,0,0,0,6,6
Hurricane,Frances,12,2004-08-27T21:00:00Z,19.7N  56.4W,0,18,9,1,28
Hurricane,Frances,12,2004-08-27T21:00:00Z,TKPK 173N 627W,0,0,0,5,5
Hurricane,Frances,12,2004-08-27T21:00:00Z,TFFF 146N 610W,0,0,0,2,2
Hurricane,Frances,12,2004-08-27T21:00:00Z,TNCM 181N 631W,0,0,0,5,5
Hurricane,Frances,12,2004-08-27T21:00:00Z,TDPR 153N 614W,0,0,0,3,3
Hurricane,Frances,13,2004-08-28T03:00:00Z,18.3N  53.3W,52,0,0,0,52
Hurricane,Frances,13,2004-08-28T03:00:00Z,TKPK 173N 627W,0,0,0,6,6
Hurricane,Frances,13,2004-08-28T03:00:00Z,19.1N  54.9W,19,15,1,0,35
Hurricane,Frances,13,2004-08-28T03:00:00Z,TNCM 181N 631W,0,0,0,7,7
Hurricane,Frances,13,2004-08-28T03:00:00Z,19.8N  56.8W,0,18,9,1,28
Hurricane,Frances,13,2004-08-28T03:00:00Z,TISX 177N 648W,0,0,0,2,2
Hurricane,Frances,13,2004-08-28T03:00:00Z,TFFF 146N 610W,0,0,0,2,2
Hurricane,Frances,13,2004-08-28T03:00:00Z,TIST 183N 650W,0,0,0,2,2
Hurricane,Frances,13,2004-08-28T03:00:00Z,TDPR 153N 614W,0,0,0,3,3
Hurricane,Frances,13,2004-08-28T03:00:00Z,ST CROIX VI,0,0,0,2,2
Hurricane,Frances,13,2004-08-28T03:00:00Z,TFFR 163N 615W,0,0,0,5,5
Hurricane,Frances,13,2004-08-28T03:00:00Z,ST THOMAS VI,0,0,0,2,2
Hurricane,Frances,13,2004-08-28T03:00:00Z,TAPA 171N 618W,0,0,0,7,7
Hurricane,Frances,14,2004-08-28T09:00:00Z,19.0N  54.3W,54,0,0,0,54
Hurricane,Frances,14,2004-08-28T09:00:00Z,TNCM 181N 631W,0,0,1,13,14
Hurricane,Frances,14,2004-08-28T09:00:00Z,20.0N  56.5W,2,39,0,0,41
Hurricane,Frances,14,2004-08-28T09:00:00Z,TISX 177N 648W,0,0,0,9,9
Hurricane,Frances,14,2004-08-28T09:00:00Z,20.5N  58.5W,0,15,15,1,31
Hurricane,Frances,14,2004-08-28T09:00:00Z,TIST 183N 650W,0,0,0,10,10
Hurricane,Frances,14,2004-08-28T09:00:00Z,TFFF 146N 610W,0,0,0,2,2
Hurricane,Frances,14,2004-08-28T09:00:00Z,TJPS 180N 666W,0,0,0,4,4
Hurricane,Frances,14,2004-08-28T09:00:00Z,TDPR 153N 614W,0,0,1,4,5
Hurricane,Frances,14,2004-08-28T09:00:00Z,TJSJ 184N 661W,0,0,0,7,7
Hurricane,Frances,14,2004-08-28T09:00:00Z,80400 157N 636W,0,0,0,4,4
Hurricane,Frances,14,2004-08-28T09:00:00Z,ST CROIX VI,0,0,0,9,9
Hurricane,Frances,14,2004-08-28T09:00:00Z,TFFR 163N 615W,0,0,2,7,9
Hurricane,Frances,14,2004-08-28T09:00:00Z,ST THOMAS VI,0,0,0,10,10
Hurricane,Frances,14,2004-08-28T09:00:00Z,TAPA 171N 618W,0,0,3,9,12
Hurricane,Frances,14,2004-08-28T09:00:00Z,SAN JUAN PR,0,0,0,7,7
Hurricane,Frances,14,2004-08-28T09:00:00Z,TKPK 173N 627W,0,0,1,11,12
Hurricane,Frances,14,2004-08-28T09:00:00Z,PONCE PR,0,0,0,4,4
Hurricane,Frances,15,2004-08-28T15:00:00Z,19.3N  55.3W,52,0,0,0,52
Hurricane,Frances,15,2004-08-28T15:00:00Z,TNCM 181N 631W,0,0,2,12,14
Hurricane,Frances,15,2004-08-28T15:00:00Z,20.1N  57.4W,15,22,0,0,37
Hurricane,Frances,15,2004-08-28T15:00:00Z,TISX 177N 648W,0,0,0,10,10
Hurricane,Frances,15,2004-08-28T15:00:00Z,20.5N  59.7W,0,16,13,0,29
Hurricane,Frances,15,2004-08-28T15:00:00Z,TIST 183N 650W,0,0,0,11,11
Hurricane,Frances,15,2004-08-28T15:00:00Z,TFFF 146N 610W,0,0,0,2,2
Hurricane,Frances,15,2004-08-28T15:00:00Z,TJPS 180N 666W,0,0,0,6,6
Hurricane,Frances,15,2004-08-28T15:00:00Z,TDPR 153N 614W,0,0,1,3,4
Hurricane,Frances,15,2004-08-28T15:00:00Z,TJSJ 184N 661W,0,0,0,9,9
Hurricane,Frances,15,2004-08-28T15:00:00Z,80400 157N 636W,0,0,0,4,4
Hurricane,Frances,15,2004-08-28T15:00:00Z,ST CROIX VI,0,0,0,10,10
Hurricane,Frances,15,2004-08-28T15:00:00Z,TFFR 163N 615W,0,0,2,6,8
Hurricane,Frances,15,2004-08-28T15:00:00Z,ST THOMAS VI,0,0,0,11,11
Hurricane,Frances,15,2004-08-28T15:00:00Z,TAPA 171N 618W,0,0,3,9,12
Hurricane,Frances,15,2004-08-28T15:00:00Z,SAN JUAN PR,0,0,0,9,9
Hurricane,Frances,15,2004-08-28T15:00:00Z,TKPK 173N 627W,0,0,2,10,12
Hurricane,Frances,15,2004-08-28T15:00:00Z,PONCE PR,0,0,0,6,6
Hurricane,Frances,16,2004-08-28T21:00:00Z,19.4N  55.8W,56,0,0,0,56
Hurricane,Frances,16,2004-08-28T21:00:00Z,TIST 183N 650W,0,0,1,11,12
Hurricane,Frances,16,2004-08-28T21:00:00Z,20.0N  58.0W,11,26,0,0,37
Hurricane,Frances,16,2004-08-28T21:00:00Z,TJPS 180N 666W,0,0,0,7,7
Hurricane,Frances,16,2004-08-28T21:00:00Z,20.5N  60.5W,0,13,15,1,29
Hurricane,Frances,16,2004-08-28T21:00:00Z,MDSD 185N 697W,0,0,0,2,2
Hurricane,Frances,16,2004-08-28T21:00:00Z,TDPR 153N 614W,0,0,1,2,3
Hurricane,Frances,16,2004-08-28T21:00:00Z,TJSJ 184N 661W,0,0,0,10,10
Hurricane,Frances,16,2004-08-28T21:00:00Z,80400 157N 636W,0,0,0,4,4
Hurricane,Frances,16,2004-08-28T21:00:00Z,MBJT 215N 712W,0,0,0,2,2
Hurricane,Frances,16,2004-08-28T21:00:00Z,TFFR 163N 615W,0,0,2,4,6
Hurricane,Frances,16,2004-08-28T21:00:00Z,ST CROIX VI,0,0,1,9,10
Hurricane,Frances,16,2004-08-28T21:00:00Z,TAPA 171N 618W,0,0,6,5,11
Hurricane,Frances,16,2004-08-28T21:00:00Z,ST THOMAS VI,0,0,1,11,12
Hurricane,Frances,16,2004-08-28T21:00:00Z,TKPK 173N 627W,0,0,4,7,11
Hurricane,Frances,16,2004-08-28T21:00:00Z,SAN JUAN PR,0,0,0,10,10
Hurricane,Frances,16,2004-08-28T21:00:00Z,TNCM 181N 631W,0,0,5,9,14
Hurricane,Frances,16,2004-08-28T21:00:00Z,PONCE PR,0,0,0,7,7
Hurricane,Frances,16,2004-08-28T21:00:00Z,TISX 177N 648W,0,0,1,9,10
Hurricane,Frances,17,2004-08-29T03:00:00Z,19.4N  56.3W,46,0,0,0,46
Hurricane,Frances,17,2004-08-29T03:00:00Z,TIST 183N 650W,0,0,2,12,14
Hurricane,Frances,17,2004-08-29T03:00:00Z,19.8N  58.6W,10,23,0,0,33
Hurricane,Frances,17,2004-08-29T03:00:00Z,TJPS 180N 666W,0,0,0,10,10
Hurricane,Frances,17,2004-08-29T03:00:00Z,20.1N  61.1W,0,12,14,1,27
Hurricane,Frances,17,2004-08-29T03:00:00Z,MDSD 185N 697W,0,0,0,3,3
Hurricane,Frances,17,2004-08-29T03:00:00Z,TDPR 153N 614W,0,0,1,2,3
Hurricane,Frances,17,2004-08-29T03:00:00Z,TJSJ 184N 661W,0,0,1,11,12
Hurricane,Frances,17,2004-08-29T03:00:00Z,80400 157N 636W,0,0,1,4,5
Hurricane,Frances,17,2004-08-29T03:00:00Z,MDPP 198N 707W,0,0,0,3,3
Hurricane,Frances,17,2004-08-29T03:00:00Z,TFFR 163N 615W,0,1,3,4,8
Hurricane,Frances,17,2004-08-29T03:00:00Z,MBJT 215N 712W,0,0,0,4,4
Hurricane,Frances,17,2004-08-29T03:00:00Z,TAPA 171N 618W,0,2,7,3,12
Hurricane,Frances,17,2004-08-29T03:00:00Z,ST CROIX VI,0,0,2,10,12
Hurricane,Frances,17,2004-08-29T03:00:00Z,TKPK 173N 627W,0,0,7,6,13
Hurricane,Frances,17,2004-08-29T03:00:00Z,ST THOMAS VI,0,0,2,12,14
Hurricane,Frances,17,2004-08-29T03:00:00Z,TNCM 181N 631W,0,0,10,6,16
Hurricane,Frances,17,2004-08-29T03:00:00Z,SAN JUAN PR,0,0,1,11,12
Hurricane,Frances,17,2004-08-29T03:00:00Z,TISX 177N 648W,0,0,2,10,12
Hurricane,Frances,17,2004-08-29T03:00:00Z,PONCE PR,0,0,0,10,10
Hurricane,Frances,18,2004-08-29T09:00:00Z,19.5N  57.4W,49,0,0,0,49
Hurricane,Frances,18,2004-08-29T09:00:00Z,TJPS 180N 666W,0,0,1,11,12
Hurricane,Frances,18,2004-08-29T09:00:00Z,19.9N  59.8W,10,25,0,0,35
Hurricane,Frances,18,2004-08-29T09:00:00Z,MDSD 185N 697W,0,0,0,6,6
Hurricane,Frances,18,2004-08-29T09:00:00Z,20.3N  62.3W,0,13,14,1,28
Hurricane,Frances,18,2004-08-29T09:00:00Z,TJSJ 184N 661W,0,0,3,11,14
Hurricane,Frances,18,2004-08-29T09:00:00Z,TDPR 153N 614W,0,0,2,1,3
Hurricane,Frances,18,2004-08-29T09:00:00Z,MDPP 198N 707W,0,0,0,6,6
Hurricane,Frances,18,2004-08-29T09:00:00Z,80400 157N 636W,0,0,1,4,5
Hurricane,Frances,18,2004-08-29T09:00:00Z,MBJT 215N 712W,0,0,0,8,8
Hurricane,Frances,18,2004-08-29T09:00:00Z,TFFR 163N 615W,0,2,4,2,8
Hurricane,Frances,18,2004-08-29T09:00:00Z,MYMM 224N 730W,0,0,0,3,3
Hurricane,Frances,18,2004-08-29T09:00:00Z,TAPA 171N 618W,0,4,7,2,13
Hurricane,Frances,18,2004-08-29T09:00:00Z,ST CROIX VI,0,0,5,8,13
Hurricane,Frances,18,2004-08-29T09:00:00Z,TKPK 173N 627W,0,2,9,3,14
Hurricane,Frances,18,2004-08-29T09:00:00Z,ST THOMAS VI,0,0,7,9,16
Hurricane,Frances,18,2004-08-29T09:00:00Z,TNCM 181N 631W,0,2,13,3,18
Hurricane,Frances,18,2004-08-29T09:00:00Z,SAN JUAN PR,0,0,3,11,14
Hurricane,Frances,18,2004-08-29T09:00:00Z,TISX 177N 648W,0,0,5,8,13
Hurricane,Frances,18,2004-08-29T09:00:00Z,PONCE PR,0,0,1,11,12
Hurricane,Frances,18,2004-08-29T09:00:00Z,TIST 183N 650W,0,0,7,9,16
Hurricane,Frances,19,2004-08-29T15:00:00Z,19.5N  58.5W,47,0,0,0,47
Hurricane,Frances,19,2004-08-29T15:00:00Z,MDSD 185N 697W,0,0,0,9,9
Hurricane,Frances,19,2004-08-29T15:00:00Z,20.0N  61.0W,3,28,1,0,32
Hurricane,Frances,19,2004-08-29T15:00:00Z,MDCB 176N 714W,0,0,0,3,3
Hurricane,Frances,19,2004-08-29T15:00:00Z,20.5N  63.5W,0,10,14,1,25
Hurricane,Frances,19,2004-08-29T15:00:00Z,MTPP 186N 724W,0,0,0,3,3
Hurricane,Frances,19,2004-08-29T15:00:00Z,TDPR 153N 614W,0,1,1,1,3
Hurricane,Frances,19,2004-08-29T15:00:00Z,TJSJ 184N 661W,0,0,6,9,15
Hurricane,Frances,19,2004-08-29T15:00:00Z,80400 157N 636W,0,0,3,2,5
Hurricane,Frances,19,2004-08-29T15:00:00Z,MDPP 198N 707W,0,0,0,10,10
Hurricane,Frances,19,2004-08-29T15:00:00Z,TFFR 163N 615W,0,4,3,1,8
Hurricane,Frances,19,2004-08-29T15:00:00Z,MBJT 215N 712W,0,0,0,12,12
Hurricane,Frances,19,2004-08-29T15:00:00Z,TAPA 171N 618W,0,8,4,1,13
Hurricane,Frances,19,2004-08-29T15:00:00Z,MYMM 224N 730W,0,0,0,7,7
Hurricane,Frances,19,2004-08-29T15:00:00Z,TKPK 173N 627W,0,5,7,1,13
Hurricane,Frances,19,2004-08-29T15:00:00Z,MYSM 241N 745W,0,0,0,3,3
Hurricane,Frances,19,2004-08-29T15:00:00Z,TNCM 181N 631W,0,7,9,1,17
Hurricane,Frances,19,2004-08-29T15:00:00Z,ST CROIX VI,0,1,8,4,13
Hurricane,Frances,19,2004-08-29T15:00:00Z,TISX 177N 648W,0,1,8,4,13
Hurricane,Frances,19,2004-08-29T15:00:00Z,ST THOMAS VI,0,1,10,5,16
Hurricane,Frances,19,2004-08-29T15:00:00Z,TIST 183N 650W,0,1,10,5,16
Hurricane,Frances,19,2004-08-29T15:00:00Z,SAN JUAN PR,0,0,6,9,15
Hurricane,Frances,19,2004-08-29T15:00:00Z,TJPS 180N 666W,0,0,3,9,12
Hurricane,Frances,19,2004-08-29T15:00:00Z,PONCE PR,0,0,3,9,12
Hurricane,Frances,20,2004-08-29T21:00:00Z,19.5N  59.5W,48,0,0,0,48
Hurricane,Frances,20,2004-08-29T21:00:00Z,MDCB 176N 714W,0,0,0,2,2
Hurricane,Frances,20,2004-08-29T21:00:00Z,20.0N  62.0W,3,29,1,0,33
Hurricane,Frances,20,2004-08-29T21:00:00Z,MTPP 186N 724W,0,0,0,3,3
Hurricane,Frances,20,2004-08-29T21:00:00Z,20.5N  64.5W,0,10,15,1,26
Hurricane,Frances,20,2004-08-29T21:00:00Z,TJSJ 184N 661W,0,1,9,5,15
Hurricane,Frances,20,2004-08-29T21:00:00Z,TDPR 153N 614W,0,1,0,1,2
Hurricane,Frances,20,2004-08-29T21:00:00Z,MDPP 198N 707W,0,0,0,10,10
Hurricane,Frances,20,2004-08-29T21:00:00Z,80400 157N 636W,0,1,1,1,3
Hurricane,Frances,20,2004-08-29T21:00:00Z,MBJT 215N 712W,0,0,0,13,13
Hurricane,Frances,20,2004-08-29T21:00:00Z,TFFR 163N 615W,1,5,1,0,7
Hurricane,Frances,20,2004-08-29T21:00:00Z,MYMM 224N 730W,0,0,0,9,9
Hurricane,Frances,20,2004-08-29T21:00:00Z,TAPA 171N 618W,2,11,0,1,14
Hurricane,Frances,20,2004-08-29T21:00:00Z,MYSM 241N 745W,0,0,0,5,5
Hurricane,Frances,20,2004-08-29T21:00:00Z,TKPK 173N 627W,0,10,3,1,14
Hurricane,Frances,20,2004-08-29T21:00:00Z,MYEG 235N 758W,0,0,0,2,2
Hurricane,Frances,20,2004-08-29T21:00:00Z,TNCM 181N 631W,0,15,3,1,19
Hurricane,Frances,20,2004-08-29T21:00:00Z,ST CROIX VI,0,2,9,2,13
Hurricane,Frances,20,2004-08-29T21:00:00Z,TISX 177N 648W,0,2,9,2,13
Hurricane,Frances,20,2004-08-29T21:00:00Z,ST THOMAS VI,0,3,11,2,16
Hurricane,Frances,20,2004-08-29T21:00:00Z,TIST 183N 650W,0,3,11,2,16
Hurricane,Frances,20,2004-08-29T21:00:00Z,SAN JUAN PR,0,1,9,5,15
Hurricane,Frances,20,2004-08-29T21:00:00Z,TJPS 180N 666W,0,0,6,6,12
Hurricane,Frances,20,2004-08-29T21:00:00Z,PONCE PR,0,0,6,6,12
Hurricane,Frances,20,2004-08-29T21:00:00Z,MDSD 185N 697W,0,0,0,8,8
Hurricane,Frances,21,2004-08-30T03:00:00Z,19.5N  60.8W,49,0,0,0,49
Hurricane,Frances,21,2004-08-30T03:00:00Z,MUGM 200N 751W,0,0,0,3,3
Hurricane,Frances,21,2004-08-30T03:00:00Z,20.0N  63.4W,6,28,0,0,34
Hurricane,Frances,21,2004-08-30T03:00:00Z,TJSJ 184N 661W,0,5,10,1,16
Hurricane,Frances,21,2004-08-30T03:00:00Z,20.8N  66.2W,0,9,18,0,27
Hurricane,Frances,21,2004-08-30T03:00:00Z,MDPP 198N 707W,0,0,2,11,13
Hurricane,Frances,21,2004-08-30T03:00:00Z,TAPA 171N 618W,3,5,1,0,9
Hurricane,Frances,21,2004-08-30T03:00:00Z,MBJT 215N 712W,0,0,1,17,18
Hurricane,Frances,21,2004-08-30T03:00:00Z,TKPK 173N 627W,2,8,1,0,11
Hurricane,Frances,21,2004-08-30T03:00:00Z,MYMM 224N 730W,0,0,0,15,15
Hurricane,Frances,21,2004-08-30T03:00:00Z,TNCM 181N 631W,3,16,1,0,20
Hurricane,Frances,21,2004-08-30T03:00:00Z,MYSM 241N 745W,0,0,0,11,11
Hurricane,Frances,21,2004-08-30T03:00:00Z,TISX 177N 648W,0,7,5,1,13
Hurricane,Frances,21,2004-08-30T03:00:00Z,MYEG 235N 758W,0,0,0,7,7
Hurricane,Frances,21,2004-08-30T03:00:00Z,TIST 183N 650W,0,11,6,1,18
Hurricane,Frances,21,2004-08-30T03:00:00Z,MYAK 241N 776W,0,0,0,2,2
Hurricane,Frances,21,2004-08-30T03:00:00Z,TJPS 180N 666W,0,2,8,2,12
Hurricane,Frances,21,2004-08-30T03:00:00Z,MYNN 251N 775W,0,0,0,2,2
Hurricane,Frances,21,2004-08-30T03:00:00Z,MDSD 185N 697W,0,0,2,8,10
Hurricane,Frances,21,2004-08-30T03:00:00Z,ST CROIX VI,0,7,5,1,13
Hurricane,Frances,21,2004-08-30T03:00:00Z,MDCB 176N 714W,0,0,0,3,3
Hurricane,Frances,21,2004-08-30T03:00:00Z,ST THOMAS VI,0,11,6,1,18
Hurricane,Frances,21,2004-08-30T03:00:00Z,MTPP 186N 724W,0,0,0,5,5
Hurricane,Frances,21,2004-08-30T03:00:00Z,SAN JUAN PR,0,5,10,1,16
Hurricane,Frances,21,2004-08-30T03:00:00Z,MTCA 183N 738W,0,0,0,2,2
Hurricane,Frances,21,2004-08-30T03:00:00Z,PONCE PR,0,2,8,2,12
Hurricane,Frances,22,2004-08-30T09:00:00Z,19.6N  62.0W,49,0,0,0,49
Hurricane,Frances,22,2004-08-30T09:00:00Z,MUCM 214N 779W,0,0,0,2,2
Hurricane,Frances,22,2004-08-30T09:00:00Z,20.2N  64.7W,3,29,0,0,32
Hurricane,Frances,22,2004-08-30T09:00:00Z,TJSJ 184N 661W,0,12,4,0,16
Hurricane,Frances,22,2004-08-30T09:00:00Z,21.0N  67.4W,0,7,17,1,25
Hurricane,Frances,22,2004-08-30T09:00:00Z,MDPP 198N 707W,0,0,6,9,15
Hurricane,Frances,22,2004-08-30T09:00:00Z,TAPA 171N 618W,3,1,0,0,4
Hurricane,Frances,22,2004-08-30T09:00:00Z,MBJT 215N 712W,0,0,5,13,18
Hurricane,Frances,22,2004-08-30T09:00:00Z,TKPK 173N 627W,4,3,1,0,8
Hurricane,Frances,22,2004-08-30T09:00:00Z,MYMM 224N 730W,0,0,0,16,16
Hurricane,Frances,22,2004-08-30T09:00:00Z,TNCM 181N 631W,12,8,0,0,20
Hurricane,Frances,22,2004-08-30T09:00:00Z,MYSM 241N 745W,0,0,0,13,13
Hurricane,Frances,22,2004-08-30T09:00:00Z,TISX 177N 648W,1,10,1,0,12
Hurricane,Frances,22,2004-08-30T09:00:00Z,MYEG 235N 758W,0,0,0,9,9
Hurricane,Frances,22,2004-08-30T09:00:00Z,TIST 183N 650W,1,15,1,1,18
Hurricane,Frances,22,2004-08-30T09:00:00Z,MYAK 241N 776W,0,0,0,4,4
Hurricane,Frances,22,2004-08-30T09:00:00Z,TJPS 180N 666W,0,6,6,0,12
Hurricane,Frances,22,2004-08-30T09:00:00Z,MYNN 251N 775W,0,0,0,4,4
Hurricane,Frances,22,2004-08-30T09:00:00Z,MDSD 185N 697W,0,0,6,5,11
Hurricane,Frances,22,2004-08-30T09:00:00Z,ST CROIX VI,1,10,1,0,12
Hurricane,Frances,22,2004-08-30T09:00:00Z,MDCB 176N 714W,0,0,1,4,5
Hurricane,Frances,22,2004-08-30T09:00:00Z,ST THOMAS VI,1,15,1,1,18
Hurricane,Frances,22,2004-08-30T09:00:00Z,MTPP 186N 724W,0,0,1,6,7
Hurricane,Frances,22,2004-08-30T09:00:00Z,SAN JUAN PR,0,12,4,0,16
Hurricane,Frances,22,2004-08-30T09:00:00Z,MTCA 183N 738W,0,0,0,4,4
Hurricane,Frances,22,2004-08-30T09:00:00Z,PONCE PR,0,6,6,0,12
Hurricane,Frances,22,2004-08-30T09:00:00Z,MUGM 200N 751W,0,0,0,6,6
Hurricane,Frances,23,2004-08-30T15:00:00Z,19.9N  63.5W,50,0,0,0,50
Hurricane,Frances,23,2004-08-30T15:00:00Z,MDPP 198N 707W,0,1,11,4,16
Hurricane,Frances,23,2004-08-30T15:00:00Z,20.6N  66.2W,5,29,0,0,34
Hurricane,Frances,23,2004-08-30T15:00:00Z,MBJT 215N 712W,0,0,14,7,21
Hurricane,Frances,23,2004-08-30T15:00:00Z,21.5N  68.8W,0,10,16,1,27
Hurricane,Frances,23,2004-08-30T15:00:00Z,MYMM 224N 730W,0,0,4,15,19
Hurricane,Frances,23,2004-08-30T15:00:00Z,TKPK 173N 627W,2,1,0,0,3
Hurricane,Frances,23,2004-08-30T15:00:00Z,MYSM 241N 745W,0,0,0,18,18
Hurricane,Frances,23,2004-08-30T15:00:00Z,TNCM 181N 631W,16,2,0,0,18
Hurricane,Frances,23,2004-08-30T15:00:00Z,MYEG 235N 758W,0,0,0,14,14
Hurricane,Frances,23,2004-08-30T15:00:00Z,TISX 177N 648W,3,7,0,0,10
Hurricane,Frances,23,2004-08-30T15:00:00Z,MYAK 241N 776W,0,0,0,10,10
Hurricane,Frances,23,2004-08-30T15:00:00Z,TIST 183N 650W,8,10,0,0,18
Hurricane,Frances,23,2004-08-30T15:00:00Z,MYNN 251N 775W,0,0,0,10,10
Hurricane,Frances,23,2004-08-30T15:00:00Z,TJPS 180N 666W,0,10,2,0,12
Hurricane,Frances,23,2004-08-30T15:00:00Z,MYGF 266N 787W,0,0,0,6,6
Hurricane,Frances,23,2004-08-30T15:00:00Z,MDSD 185N 697W,0,1,8,2,11
Hurricane,Frances,23,2004-08-30T15:00:00Z,ST CROIX VI,3,7,0,0,10
Hurricane,Frances,23,2004-08-30T15:00:00Z,MDCB 176N 714W,0,0,1,3,4
Hurricane,Frances,23,2004-08-30T15:00:00Z,ST THOMAS VI,8,10,0,0,18
Hurricane,Frances,23,2004-08-30T15:00:00Z,MTPP 186N 724W,0,0,2,5,7
Hurricane,Frances,23,2004-08-30T15:00:00Z,SAN JUAN PR,2,14,1,0,17
Hurricane,Frances,23,2004-08-30T15:00:00Z,MTCA 183N 738W,0,0,0,4,4
Hurricane,Frances,23,2004-08-30T15:00:00Z,PONCE PR,0,10,2,0,12
Hurricane,Frances,23,2004-08-30T15:00:00Z,MUGM 200N 751W,0,0,0,7,7
Hurricane,Frances,23,2004-08-30T15:00:00Z,MIAMI FL,0,0,0,3,3
Hurricane,Frances,23,2004-08-30T15:00:00Z,MUCM 214N 779W,0,0,0,4,4
Hurricane,Frances,23,2004-08-30T15:00:00Z,W PALM BEACH FL,0,0,0,3,3
Hurricane,Frances,23,2004-08-30T15:00:00Z,TJSJ 184N 661W,2,14,1,0,17
Hurricane,Frances,23,2004-08-30T15:00:00Z,FT PIERCE FL,0,0,0,2,2
Hurricane,Frances,24,2004-08-30T21:00:00Z,20.2N  64.8W,47,0,0,0,47
Hurricane,Frances,24,2004-08-30T21:00:00Z,MYMM 224N 730W,0,0,9,10,19
Hurricane,Frances,24,2004-08-30T21:00:00Z,21.0N  67.4W,3,29,0,0,32
Hurricane,Frances,24,2004-08-30T21:00:00Z,MYSM 241N 745W,0,0,2,16,18
Hurricane,Frances,24,2004-08-30T21:00:00Z,22.0N  70.0W,0,8,17,1,26
Hurricane,Frances,24,2004-08-30T21:00:00Z,MYEG 235N 758W,0,0,0,15,15
Hurricane,Frances,24,2004-08-30T21:00:00Z,TNCM 181N 631W,9,0,0,0,9
Hurricane,Frances,24,2004-08-30T21:00:00Z,MYAK 241N 776W,0,0,0,10,10
Hurricane,Frances,24,2004-08-30T21:00:00Z,TISX 177N 648W,4,2,0,0,6
Hurricane,Frances,24,2004-08-30T21:00:00Z,MYNN 251N 775W,0,0,0,11,11
Hurricane,Frances,24,2004-08-30T21:00:00Z,TIST 183N 650W,13,3,1,0,17
Hurricane,Frances,24,2004-08-30T21:00:00Z,MYGF 266N 787W,0,0,0,7,7
Hurricane,Frances,24,2004-08-30T21:00:00Z,TJPS 180N 666W,2,7,1,0,10
Hurricane,Frances,24,2004-08-30T21:00:00Z,ST CROIX VI,4,2,0,0,6
Hurricane,Frances,24,2004-08-30T21:00:00Z,MDSD 185N 697W,0,3,6,1,10
Hurricane,Frances,24,2004-08-30T21:00:00Z,ST THOMAS VI,13,3,1,0,17
Hurricane,Frances,24,2004-08-30T21:00:00Z,MDCB 176N 714W,0,0,2,1,3
Hurricane,Frances,24,2004-08-30T21:00:00Z,SAN JUAN PR,8,8,0,1,17
Hurricane,Frances,24,2004-08-30T21:00:00Z,MTPP 186N 724W,0,0,3,3,6
Hurricane,Frances,24,2004-08-30T21:00:00Z,PONCE PR,2,7,1,0,10
Hurricane,Frances,24,2004-08-30T21:00:00Z,MTCA 183N 738W,0,0,1,2,3
Hurricane,Frances,24,2004-08-30T21:00:00Z,MARATHON FL,0,0,0,2,2
Hurricane,Frances,24,2004-08-30T21:00:00Z,MUGM 200N 751W,0,0,1,6,7
Hurricane,Frances,24,2004-08-30T21:00:00Z,MIAMI FL,0,0,0,3,3
Hurricane,Frances,24,2004-08-30T21:00:00Z,MUCM 214N 779W,0,0,0,4,4
Hurricane,Frances,24,2004-08-30T21:00:00Z,W PALM BEACH FL,0,0,0,4,4
Hurricane,Frances,24,2004-08-30T21:00:00Z,TJSJ 184N 661W,8,8,0,1,17
Hurricane,Frances,24,2004-08-30T21:00:00Z,FT PIERCE FL,0,0,0,3,3
Hurricane,Frances,24,2004-08-30T21:00:00Z,MDPP 198N 707W,0,3,11,2,16
Hurricane,Frances,24,2004-08-30T21:00:00Z,COCOA BEACH FL,0,0,0,2,2
Hurricane,Frances,24,2004-08-30T21:00:00Z,MBJT 215N 712W,0,2,17,3,22
Hurricane,Frances,25,2004-08-31T03:00:00Z,20.9N  66.3W,53,1,0,0,54
Hurricane,Frances,25,2004-08-31T03:00:00Z,MYAK 241N 776W,0,0,0,14,14
Hurricane,Frances,25,2004-08-31T03:00:00Z,21.8N  69.1W,1,37,0,0,38
Hurricane,Frances,25,2004-08-31T03:00:00Z,MYNN 251N 775W,0,0,0,15,15
Hurricane,Frances,25,2004-08-31T03:00:00Z,23.0N  71.9W,0,7,23,1,31
Hurricane,Frances,25,2004-08-31T03:00:00Z,MYGF 266N 787W,0,0,0,11,11
Hurricane,Frances,25,2004-08-31T03:00:00Z,TIST 183N 650W,3,0,0,0,3
Hurricane,Frances,25,2004-08-31T03:00:00Z,ST THOMAS VI,3,0,0,0,3
Hurricane,Frances,25,2004-08-31T03:00:00Z,MDSD 185N 697W,0,2,1,0,3
Hurricane,Frances,25,2004-08-31T03:00:00Z,SAN JUAN PR,4,0,0,0,4
Hurricane,Frances,25,2004-08-31T03:00:00Z,MTPP 186N 724W,0,0,1,1,2
Hurricane,Frances,25,2004-08-31T03:00:00Z,MARATHON FL,0,0,0,4,4
Hurricane,Frances,25,2004-08-31T03:00:00Z,MUGM 200N 751W,0,0,1,5,6
Hurricane,Frances,25,2004-08-31T03:00:00Z,MIAMI FL,0,0,0,7,7
Hurricane,Frances,25,2004-08-31T03:00:00Z,MUCM 214N 779W,0,0,0,5,5
Hurricane,Frances,25,2004-08-31T03:00:00Z,W PALM BEACH FL,0,0,0,7,7
Hurricane,Frances,25,2004-08-31T03:00:00Z,MUCF 221N 805W,0,0,0,2,2
Hurricane,Frances,25,2004-08-31T03:00:00Z,FT PIERCE FL,0,0,0,6,6
Hurricane,Frances,25,2004-08-31T03:00:00Z,TJSJ 184N 661W,4,0,0,0,4
Hurricane,Frances,25,2004-08-31T03:00:00Z,COCOA BEACH FL,0,0,0,5,5
Hurricane,Frances,25,2004-08-31T03:00:00Z,MDPP 198N 707W,0,7,5,1,13
Hurricane,Frances,25,2004-08-31T03:00:00Z,DAYTONA BEACH FL,0,0,0,3,3
Hurricane,Frances,25,2004-08-31T03:00:00Z,MBJT 215N 712W,0,15,12,0,27
Hurricane,Frances,25,2004-08-31T03:00:00Z,KEY WEST FL,0,0,0,2,2
Hurricane,Frances,25,2004-08-31T03:00:00Z,MYMM 224N 730W,0,1,20,2,23
Hurricane,Frances,25,2004-08-31T03:00:00Z,MARCO ISLAND FL,0,0,0,3,3
Hurricane,Frances,25,2004-08-31T03:00:00Z,MYSM 241N 745W,0,0,14,9,23
Hurricane,Frances,25,2004-08-31T03:00:00Z,FT MYERS FL,0,0,0,3,3
Hurricane,Frances,25,2004-08-31T03:00:00Z,MYEG 235N 758W,0,0,5,13,18
Hurricane,Frances,25,2004-08-31T03:00:00Z,VENICE FL,0,0,0,2,2
Hurricane,Frances,26,2004-08-31T09:00:00Z,21.3N  67.7W,52,0,0,0,52
Hurricane,Frances,26,2004-08-31T09:00:00Z,MYNN 251N 775W,0,0,1,14,15
Hurricane,Frances,26,2004-08-31T09:00:00Z,22.2N  70.2W,2,34,0,0,36
Hurricane,Frances,26,2004-08-31T09:00:00Z,MYGF 266N 787W,0,0,0,12,12
Hurricane,Frances,26,2004-08-31T09:00:00Z,23.2N  72.3W,0,15,13,0,28
Hurricane,Frances,26,2004-08-31T09:00:00Z,MARATHON FL,0,0,0,4,4
Hurricane,Frances,26,2004-08-31T09:00:00Z,MTPP 186N 724W,0,0,1,1,2
Hurricane,Frances,26,2004-08-31T09:00:00Z,MIAMI FL,0,0,0,7,7
Hurricane,Frances,26,2004-08-31T09:00:00Z,MUGM 200N 751W,0,0,1,4,5
Hurricane,Frances,26,2004-08-31T09:00:00Z,W PALM BEACH FL,0,0,0,8,8
Hurricane,Frances,26,2004-08-31T09:00:00Z,MUCM 214N 779W,0,0,0,5,5
Hurricane,Frances,26,2004-08-31T09:00:00Z,FT PIERCE FL,0,0,0,7,7
Hurricane,Frances,26,2004-08-31T09:00:00Z,MUCF 221N 805W,0,0,0,2,2
Hurricane,Frances,26,2004-08-31T09:00:00Z,COCOA BEACH FL,0,0,0,5,5
Hurricane,Frances,26,2004-08-31T09:00:00Z,MDPP 198N 707W,1,8,1,1,11
Hurricane,Frances,26,2004-08-31T09:00:00Z,DAYTONA BEACH FL,0,0,0,3,3
Hurricane,Frances,26,2004-08-31T09:00:00Z,MBJT 215N 712W,0,24,2,0,26
Hurricane,Frances,26,2004-08-31T09:00:00Z,KEY WEST FL,0,0,0,2,2
Hurricane,Frances,26,2004-08-31T09:00:00Z,MYMM 224N 730W,0,8,13,2,23
Hurricane,Frances,26,2004-08-31T09:00:00Z,MARCO ISLAND FL,0,0,0,3,3
Hurricane,Frances,26,2004-08-31T09:00:00Z,MYSM 241N 745W,0,0,17,6,23
Hurricane,Frances,26,2004-08-31T09:00:00Z,FT MYERS FL,0,0,0,3,3
Hurricane,Frances,26,2004-08-31T09:00:00Z,MYEG 235N 758W,0,0,7,11,18
Hurricane,Frances,26,2004-08-31T09:00:00Z,VENICE FL,0,0,0,2,2
Hurricane,Frances,26,2004-08-31T09:00:00Z,MYAK 241N 776W,0,0,1,13,14
Hurricane,Frances,26,2004-08-31T09:00:00Z,TAMPA FL,0,0,0,2,2
Hurricane,Frances,27,2004-08-31T15:00:00Z,21.5N  68.7W,53,0,1,0,54
Hurricane,Frances,27,2004-08-31T15:00:00Z,MYGF 266N 787W,0,0,0,14,14
Hurricane,Frances,27,2004-08-31T15:00:00Z,22.5N  71.0W,2,32,0,0,34
Hurricane,Frances,27,2004-08-31T15:00:00Z,MARATHON FL,0,0,0,6,6
Hurricane,Frances,27,2004-08-31T15:00:00Z,23.5N  73.0W,0,13,12,1,26
Hurricane,Frances,27,2004-08-31T15:00:00Z,MIAMI FL,0,0,0,10,10
Hurricane,Frances,27,2004-08-31T15:00:00Z,MTPP 186N 724W,0,1,0,1,2
Hurricane,Frances,27,2004-08-31T15:00:00Z,W PALM BEACH FL,0,0,0,10,10
Hurricane,Frances,27,2004-08-31T15:00:00Z,MUGM 200N 751W,0,0,4,2,6
Hurricane,Frances,27,2004-08-31T15:00:00Z,FT PIERCE FL,0,0,0,9,9
Hurricane,Frances,27,2004-08-31T15:00:00Z,MUCM 214N 779W,0,0,1,6,7
Hurricane,Frances,27,2004-08-31T15:00:00Z,COCOA BEACH FL,0,0,0,8,8
Hurricane,Frances,27,2004-08-31T15:00:00Z,MUCF 221N 805W,0,0,0,3,3
Hurricane,Frances,27,2004-08-31T15:00:00Z,DAYTONA BEACH FL,0,0,0,5,5
Hurricane,Frances,27,2004-08-31T15:00:00Z,MDPP 198N 707W,4,9,0,1,14
Hurricane,Frances,27,2004-08-31T15:00:00Z,JACKSONVILLE FL,0,0,0,2,2
Hurricane,Frances,27,2004-08-31T15:00:00Z,MBJT 215N 712W,3,26,0,0,29
Hurricane,Frances,27,2004-08-31T15:00:00Z,KEY WEST FL,0,0,0,4,4
Hurricane,Frances,27,2004-08-31T15:00:00Z,MYMM 224N 730W,0,16,7,1,24
Hurricane,Frances,27,2004-08-31T15:00:00Z,MARCO ISLAND FL,0,0,0,5,5
Hurricane,Frances,27,2004-08-31T15:00:00Z,MYSM 241N 745W,0,1,18,4,23
Hurricane,Frances,27,2004-08-31T15:00:00Z,FT MYERS FL,0,0,0,5,5
Hurricane,Frances,27,2004-08-31T15:00:00Z,MYEG 235N 758W,0,0,11,8,19
Hurricane,Frances,27,2004-08-31T15:00:00Z,VENICE FL,0,0,0,3,3
Hurricane,Frances,27,2004-08-31T15:00:00Z,MYAK 241N 776W,0,0,2,13,15
Hurricane,Frances,27,2004-08-31T15:00:00Z,TAMPA FL,0,0,0,3,3
Hurricane,Frances,27,2004-08-31T15:00:00Z,MYNN 251N 775W,0,0,1,16,17
Hurricane,Frances,27,2004-08-31T15:00:00Z,CEDAR KEY FL,0,0,0,2,2
Hurricane,Frances,28,2004-08-31T21:00:00Z,22.5N  71.0W,47,0,0,0,47
Hurricane,Frances,28,2004-08-31T21:00:00Z,FT PIERCE FL,0,0,1,14,15
Hurricane,Frances,28,2004-08-31T21:00:00Z,23.7N  73.3W,6,26,1,0,33
Hurricane,Frances,28,2004-08-31T21:00:00Z,COCOA BEACH FL,0,0,1,13,14
Hurricane,Frances,28,2004-08-31T21:00:00Z,25.0N  75.5W,0,13,14,1,28
Hurricane,Frances,28,2004-08-31T21:00:00Z,DAYTONA BEACH FL,0,0,0,11,11
Hurricane,Frances,28,2004-08-31T21:00:00Z,MUGM 200N 751W,0,2,1,1,4
Hurricane,Frances,28,2004-08-31T21:00:00Z,JACKSONVILLE FL,0,0,0,8,8
Hurricane,Frances,28,2004-08-31T21:00:00Z,MUCM 214N 779W,0,0,3,4,7
Hurricane,Frances,28,2004-08-31T21:00:00Z,SAVANNAH GA,0,0,0,5,5
Hurricane,Frances,28,2004-08-31T21:00:00Z,MUCF 221N 805W,0,0,0,4,4
Hurricane,Frances,28,2004-08-31T21:00:00Z,CHARLESTON SC,0,0,0,5,5
Hurricane,Frances,28,2004-08-31T21:00:00Z,MUHA 230N 824W,0,0,0,2,2
Hurricane,Frances,28,2004-08-31T21:00:00Z,MYRTLE BEACH SC,0,0,0,3,3
Hurricane,Frances,28,2004-08-31T21:00:00Z,MDPP 198N 707W,7,0,0,0,7
Hurricane,Frances,28,2004-08-31T21:00:00Z,WILMINGTON NC,0,0,0,2,2
Hurricane,Frances,28,2004-08-31T21:00:00Z,MBJT 215N 712W,38,0,0,0,38
Hurricane,Frances,28,2004-08-31T21:00:00Z,KEY WEST FL,0,0,0,7,7
Hurricane,Frances,28,2004-08-31T21:00:00Z,MYMM 224N 730W,17,13,0,0,30
Hurricane,Frances,28,2004-08-31T21:00:00Z,MARCO ISLAND FL,0,0,0,9,9
Hurricane,Frances,28,2004-08-31T21:00:00Z,MYSM 241N 745W,0,25,4,0,29
Hurricane,Frances,28,2004-08-31T21:00:00Z,FT MYERS FL,0,0,0,9,9
Hurricane,Frances,28,2004-08-31T21:00:00Z,MYEG 235N 758W,0,12,10,1,23
Hurricane,Frances,28,2004-08-31T21:00:00Z,VENICE FL,0,0,0,8,8
Hurricane,Frances,28,2004-08-31T21:00:00Z,MYAK 241N 776W,0,1,13,4,18
Hurricane,Frances,28,2004-08-31T21:00:00Z,TAMPA FL,0,0,0,8,8
Hurricane,Frances,28,2004-08-31T21:00:00Z,MYNN 251N 775W,0,1,16,4,21
Hurricane,Frances,28,2004-08-31T21:00:00Z,CEDAR KEY FL,0,0,0,6,6
Hurricane,Frances,28,2004-08-31T21:00:00Z,MYGF 266N 787W,0,0,8,11,19
Hurricane,Frances,28,2004-08-31T21:00:00Z,ST MARKS FL,0,0,0,3,3
Hurricane,Frances,28,2004-08-31T21:00:00Z,MARATHON FL,0,0,1,8,9
Hurricane,Frances,28,2004-08-31T21:00:00Z,APALACHICOLA FL,0,0,0,2,2
Hurricane,Frances,28,2004-08-31T21:00:00Z,MIAMI FL,0,0,2,12,14
Hurricane,Frances,28,2004-08-31T21:00:00Z,GULF 29N 85W,0,0,0,2,2
Hurricane,Frances,28,2004-08-31T21:00:00Z,W PALM BEACH FL,0,0,2,13,15
Hurricane,Frances,29,2004-09-01T03:00:00Z,22.8N  71.4W,46,0,0,0,46
Hurricane,Frances,29,2004-09-01T03:00:00Z,FT PIERCE FL,0,0,1,15,16
Hurricane,Frances,29,2004-09-01T03:00:00Z,24.0N  73.5W,9,24,0,1,34
Hurricane,Frances,29,2004-09-01T03:00:00Z,COCOA BEACH FL,0,0,1,14,15
Hurricane,Frances,29,2004-09-01T03:00:00Z,25.2N  75.5W,0,16,11,1,28
Hurricane,Frances,29,2004-09-01T03:00:00Z,DAYTONA BEACH FL,0,0,0,12,12
Hurricane,Frances,29,2004-09-01T03:00:00Z,MUGM 200N 751W,0,0,1,1,2
Hurricane,Frances,29,2004-09-01T03:00:00Z,JACKSONVILLE FL,0,0,0,9,9
Hurricane,Frances,29,2004-09-01T03:00:00Z,MUCM 214N 779W,0,0,1,4,5
Hurricane,Frances,29,2004-09-01T03:00:00Z,SAVANNAH GA,0,0,0,7,7
Hurricane,Frances,29,2004-09-01T03:00:00Z,MUCF 221N 805W,0,0,0,4,4
Hurricane,Frances,29,2004-09-01T03:00:00Z,CHARLESTON SC,0,0,0,6,6
Hurricane,Frances,29,2004-09-01T03:00:00Z,MUHA 230N 824W,0,0,0,3,3
Hurricane,Frances,29,2004-09-01T03:00:00Z,MYRTLE BEACH SC,0,0,0,4,4
Hurricane,Frances,29,2004-09-01T03:00:00Z,MDPP 198N 707W,2,0,0,0,2
Hurricane,Frances,29,2004-09-01T03:00:00Z,WILMINGTON NC,0,0,0,2,2
Hurricane,Frances,29,2004-09-01T03:00:00Z,MBJT 215N 712W,35,0,0,0,35
Hurricane,Frances,29,2004-09-01T03:00:00Z,KEY WEST FL,0,0,0,7,7
Hurricane,Frances,29,2004-09-01T03:00:00Z,MYMM 224N 730W,25,5,0,0,30
Hurricane,Frances,29,2004-09-01T03:00:00Z,MARCO ISLAND FL,0,0,0,10,10
Hurricane,Frances,29,2004-09-01T03:00:00Z,MYSM 241N 745W,1,27,1,0,29
Hurricane,Frances,29,2004-09-01T03:00:00Z,FT MYERS FL,0,0,0,10,10
Hurricane,Frances,29,2004-09-01T03:00:00Z,MYEG 235N 758W,0,15,6,1,22
Hurricane,Frances,29,2004-09-01T03:00:00Z,VENICE FL,0,0,0,9,9
Hurricane,Frances,29,2004-09-01T03:00:00Z,MYAK 241N 776W,0,2,12,4,18
Hurricane,Frances,29,2004-09-01T03:00:00Z,TAMPA FL,0,0,0,9,9
Hurricane,Frances,29,2004-09-01T03:00:00Z,MYNN 251N 775W,0,2,15,4,21
Hurricane,Frances,29,2004-09-01T03:00:00Z,CEDAR KEY FL,0,0,0,8,8
Hurricane,Frances,29,2004-09-01T03:00:00Z,MYGF 266N 787W,0,0,9,10,19
Hurricane,Frances,29,2004-09-01T03:00:00Z,ST MARKS FL,0,0,0,4,4
Hurricane,Frances,29,2004-09-01T03:00:00Z,MARATHON FL,0,0,1,9,10
Hurricane,Frances,29,2004-09-01T03:00:00Z,APALACHICOLA FL,0,0,0,3,3
Hurricane,Frances,29,2004-09-01T03:00:00Z,MIAMI FL,0,0,3,11,14
Hurricane,Frances,29,2004-09-01T03:00:00Z,PANAMA CITY FL,0,0,0,2,2
Hurricane,Frances,29,2004-09-01T03:00:00Z,W PALM BEACH FL,0,0,3,13,16
Hurricane,Frances,29,2004-09-01T03:00:00Z,GULF 29N 85W,0,0,0,3,3
Hurricane,Frances,30,2004-09-01T09:00:00Z,23.2N  72.9W,46,0,0,0,46
Hurricane,Frances,30,2004-09-01T09:00:00Z,DAYTONA BEACH FL,0,0,1,14,15
Hurricane,Frances,30,2004-09-01T09:00:00Z,24.3N  74.8W,15,18,0,0,33
Hurricane,Frances,30,2004-09-01T09:00:00Z,JACKSONVILLE FL,0,0,0,12,12
Hurricane,Frances,30,2004-09-01T09:00:00Z,25.5N  76.6W,0,20,7,1,28
Hurricane,Frances,30,2004-09-01T09:00:00Z,SAVANNAH GA,0,0,0,8,8
Hurricane,Frances,30,2004-09-01T09:00:00Z,MUCM 214N 779W,0,1,1,3,5
Hurricane,Frances,30,2004-09-01T09:00:00Z,CHARLESTON SC,0,0,0,6,6
Hurricane,Frances,30,2004-09-01T09:00:00Z,MUCF 221N 805W,0,0,1,4,5
Hurricane,Frances,30,2004-09-01T09:00:00Z,MYRTLE BEACH SC,0,0,0,4,4
Hurricane,Frances,30,2004-09-01T09:00:00Z,MUHA 230N 824W,0,0,0,4,4
Hurricane,Frances,30,2004-09-01T09:00:00Z,WILMINGTON NC,0,0,0,2,2
Hurricane,Frances,30,2004-09-01T09:00:00Z,MBJT 215N 712W,49,0,0,0,49
Hurricane,Frances,30,2004-09-01T09:00:00Z,KEY WEST FL,0,0,2,8,10
Hurricane,Frances,30,2004-09-01T09:00:00Z,MYMM 224N 730W,41,0,0,0,41
Hurricane,Frances,30,2004-09-01T09:00:00Z,MARCO ISLAND FL,0,0,3,11,14
Hurricane,Frances,30,2004-09-01T09:00:00Z,MYSM 241N 745W,23,12,0,0,35
Hurricane,Frances,30,2004-09-01T09:00:00Z,FT MYERS FL,0,0,2,12,14
Hurricane,Frances,30,2004-09-01T09:00:00Z,MYEG 235N 758W,7,18,1,0,26
Hurricane,Frances,30,2004-09-01T09:00:00Z,VENICE FL,0,0,1,12,13
Hurricane,Frances,30,2004-09-01T09:00:00Z,MYAK 241N 776W,0,13,7,1,21
Hurricane,Frances,30,2004-09-01T09:00:00Z,TAMPA FL,0,0,0,13,13
Hurricane,Frances,30,2004-09-01T09:00:00Z,MYNN 251N 775W,0,13,10,2,25
Hurricane,Frances,30,2004-09-01T09:00:00Z,CEDAR KEY FL,0,0,0,11,11
Hurricane,Frances,30,2004-09-01T09:00:00Z,MYGF 266N 787W,0,1,17,4,22
Hurricane,Frances,30,2004-09-01T09:00:00Z,ST MARKS FL,0,0,0,7,7
Hurricane,Frances,30,2004-09-01T09:00:00Z,MARATHON FL,0,0,4,8,12
Hurricane,Frances,30,2004-09-01T09:00:00Z,APALACHICOLA FL,0,0,0,5,5
Hurricane,Frances,30,2004-09-01T09:00:00Z,MIAMI FL,0,0,9,8,17
Hurricane,Frances,30,2004-09-01T09:00:00Z,PANAMA CITY FL,0,0,0,4,4
Hurricane,Frances,30,2004-09-01T09:00:00Z,W PALM BEACH FL,0,0,9,10,19
Hurricane,Frances,30,2004-09-01T09:00:00Z,GULF 29N 85W,0,0,0,6,6
Hurricane,Frances,30,2004-09-01T09:00:00Z,FT PIERCE FL,0,0,7,11,18
Hurricane,Frances,30,2004-09-01T09:00:00Z,GULF 29N 87W,0,0,0,2,2
Hurricane,Frances,30,2004-09-01T09:00:00Z,COCOA BEACH FL,0,0,3,14,17
Hurricane,Frances,31,2004-09-01T15:00:00Z,24.0N  74.0W,47,0,0,0,47
Hurricane,Frances,31,2004-09-01T15:00:00Z,DAYTONA BEACH FL,0,0,3,13,16
Hurricane,Frances,31,2004-09-01T15:00:00Z,25.0N  76.0W,15,18,0,0,33
Hurricane,Frances,31,2004-09-01T15:00:00Z,JACKSONVILLE FL,0,0,0,13,13
Hurricane,Frances,31,2004-09-01T15:00:00Z,26.0N  77.5W,0,22,3,1,26
Hurricane,Frances,31,2004-09-01T15:00:00Z,SAVANNAH GA,0,0,0,9,9
Hurricane,Frances,31,2004-09-01T15:00:00Z,MUCM 214N 779W,0,2,1,1,4
Hurricane,Frances,31,2004-09-01T15:00:00Z,CHARLESTON SC,0,0,0,7,7
Hurricane,Frances,31,2004-09-01T15:00:00Z,MUCF 221N 805W,0,0,2,3,5
Hurricane,Frances,31,2004-09-01T15:00:00Z,MYRTLE BEACH SC,0,0,0,5,5
Hurricane,Frances,31,2004-09-01T15:00:00Z,MUHA 230N 824W,0,0,1,4,5
Hurricane,Frances,31,2004-09-01T15:00:00Z,WILMINGTON NC,0,0,0,3,3
Hurricane,Frances,31,2004-09-01T15:00:00Z,MBJT 215N 712W,48,0,0,0,48
Hurricane,Frances,31,2004-09-01T15:00:00Z,KEY WEST FL,0,0,4,7,11
Hurricane,Frances,31,2004-09-01T15:00:00Z,MYMM 224N 730W,48,0,0,0,48
Hurricane,Frances,31,2004-09-01T15:00:00Z,MARCO ISLAND FL,0,0,6,9,15
Hurricane,Frances,31,2004-09-01T15:00:00Z,MYSM 241N 745W,43,0,0,0,43
Hurricane,Frances,31,2004-09-01T15:00:00Z,FT MYERS FL,0,0,5,10,15
Hurricane,Frances,31,2004-09-01T15:00:00Z,MYEG 235N 758W,24,5,0,0,29
Hurricane,Frances,31,2004-09-01T15:00:00Z,VENICE FL,0,0,2,12,14
Hurricane,Frances,31,2004-09-01T15:00:00Z,MYAK 241N 776W,2,19,1,1,23
Hurricane,Frances,31,2004-09-01T15:00:00Z,TAMPA FL,0,0,2,12,14
Hurricane,Frances,31,2004-09-01T15:00:00Z,MYNN 251N 775W,1,23,2,0,26
Hurricane,Frances,31,2004-09-01T15:00:00Z,CEDAR KEY FL,0,0,0,12,12
Hurricane,Frances,31,2004-09-01T15:00:00Z,MYGF 266N 787W,0,8,12,3,23
Hurricane,Frances,31,2004-09-01T15:00:00Z,ST MARKS FL,0,0,0,8,8
Hurricane,Frances,31,2004-09-01T15:00:00Z,MARATHON FL,0,1,7,5,13
Hurricane,Frances,31,2004-09-01T15:00:00Z,APALACHICOLA FL,0,0,0,6,6
Hurricane,Frances,31,2004-09-01T15:00:00Z,MIAMI FL,0,2,11,5,18
Hurricane,Frances,31,2004-09-01T15:00:00Z,PANAMA CITY FL,0,0,0,5,5
Hurricane,Frances,31,2004-09-01T15:00:00Z,W PALM BEACH FL,0,1,13,6,20
Hurricane,Frances,31,2004-09-01T15:00:00Z,PENSACOLA FL,0,0,0,2,2
Hurricane,Frances,31,2004-09-01T15:00:00Z,FT PIERCE FL,0,0,11,8,19
Hurricane,Frances,31,2004-09-01T15:00:00Z,GULF 29N 85W,0,0,0,7,7
Hurricane,Frances,31,2004-09-01T15:00:00Z,COCOA BEACH FL,0,0,8,10,18
Hurricane,Frances,31,2004-09-01T15:00:00Z,GULF 29N 87W,0,0,0,2,2
Hurricane,Frances,32,2004-09-01T21:00:00Z,24.3N  74.9W,46,0,0,0,46
Hurricane,Frances,32,2004-09-01T21:00:00Z,DAYTONA BEACH FL,0,0,10,9,19
Hurricane,Frances,32,2004-09-01T21:00:00Z,25.4N  76.7W,16,16,0,0,32
Hurricane,Frances,32,2004-09-01T21:00:00Z,JACKSONVILLE FL,0,0,3,13,16
Hurricane,Frances,32,2004-09-01T21:00:00Z,26.5N  78.5W,0,20,6,1,27
Hurricane,Frances,32,2004-09-01T21:00:00Z,SAVANNAH GA,0,0,1,11,12
Hurricane,Frances,32,2004-09-01T21:00:00Z,MUCM 214N 779W,0,1,0,1,2
Hurricane,Frances,32,2004-09-01T21:00:00Z,CHARLESTON SC,0,0,0,9,9
Hurricane,Frances,32,2004-09-01T21:00:00Z,MUCF 221N 805W,0,0,1,2,3
Hurricane,Frances,32,2004-09-01T21:00:00Z,MYRTLE BEACH SC,0,0,0,6,6
Hurricane,Frances,32,2004-09-01T21:00:00Z,MUHA 230N 824W,0,0,1,3,4
Hurricane,Frances,32,2004-09-01T21:00:00Z,WILMINGTON NC,0,0,0,3,3
Hurricane,Frances,32,2004-09-01T21:00:00Z,MBJT 215N 712W,99,0,0,0,99
Hurricane,Frances,32,2004-09-01T21:00:00Z,KEY WEST FL,0,1,5,5,11
Hurricane,Frances,32,2004-09-01T21:00:00Z,MYMM 224N 730W,61,0,0,0,61
Hurricane,Frances,32,2004-09-01T21:00:00Z,MARCO ISLAND FL,0,1,10,5,16
Hurricane,Frances,32,2004-09-01T21:00:00Z,MYSM 241N 745W,52,0,0,0,52
Hurricane,Frances,32,2004-09-01T21:00:00Z,FT MYERS FL,0,0,10,7,17
Hurricane,Frances,32,2004-09-01T21:00:00Z,MYEG 235N 758W,32,1,0,0,33
Hurricane,Frances,32,2004-09-01T21:00:00Z,VENICE FL,0,0,7,9,16
Hurricane,Frances,32,2004-09-01T21:00:00Z,MYAK 241N 776W,11,12,0,1,24
Hurricane,Frances,32,2004-09-01T21:00:00Z,TAMPA FL,0,0,7,9,16
Hurricane,Frances,32,2004-09-01T21:00:00Z,MYNN 251N 775W,8,20,0,1,29
Hurricane,Frances,32,2004-09-01T21:00:00Z,CEDAR KEY FL,0,0,3,12,15
Hurricane,Frances,32,2004-09-01T21:00:00Z,MYGF 266N 787W,0,18,8,1,27
Hurricane,Frances,32,2004-09-01T21:00:00Z,ST MARKS FL,0,0,0,11,11
Hurricane,Frances,32,2004-09-01T21:00:00Z,MARATHON FL,0,2,8,4,14
Hurricane,Frances,32,2004-09-01T21:00:00Z,APALACHICOLA FL,0,0,0,9,9
Hurricane,Frances,32,2004-09-01T21:00:00Z,MIAMI FL,0,6,12,3,21
Hurricane,Frances,32,2004-09-01T21:00:00Z,PANAMA CITY FL,0,0,0,7,7
Hurricane,Frances,32,2004-09-01T21:00:00Z,W PALM BEACH FL,0,6,14,3,23
Hurricane,Frances,32,2004-09-01T21:00:00Z,PENSACOLA FL,0,0,0,3,3
Hurricane,Frances,32,2004-09-01T21:00:00Z,FT PIERCE FL,0,3,16,4,23
Hurricane,Frances,32,2004-09-01T21:00:00Z,GULF 29N 85W,0,0,0,9,9
Hurricane,Frances,32,2004-09-01T21:00:00Z,COCOA BEACH FL,0,1,15,5,21
Hurricane,Frances,32,2004-09-01T21:00:00Z,GULF 29N 87W,0,0,0,3,3
Hurricane,Frances,33,2004-09-02T03:00:00Z,24.7N  75.6W,46,0,0,0,46
Hurricane,Frances,33,2004-09-02T03:00:00Z,DAYTONA BEACH FL,0,0,9,10,19
Hurricane,Frances,33,2004-09-02T03:00:00Z,25.8N  77.3W,17,15,0,1,33
Hurricane,Frances,33,2004-09-02T03:00:00Z,JACKSONVILLE FL,0,0,2,14,16
Hurricane,Frances,33,2004-09-02T03:00:00Z,26.6N  78.5W,1,23,2,1,27
Hurricane,Frances,33,2004-09-02T03:00:00Z,SAVANNAH GA,0,0,0,12,12
Hurricane,Frances,33,2004-09-02T03:00:00Z,MUCM 214N 779W,0,0,0,2,2
Hurricane,Frances,33,2004-09-02T03:00:00Z,CHARLESTON SC,0,0,0,9,9
Hurricane,Frances,33,2004-09-02T03:00:00Z,MUCF 221N 805W,0,0,1,3,4
Hurricane,Frances,33,2004-09-02T03:00:00Z,MYRTLE BEACH SC,0,0,0,5,5
Hurricane,Frances,33,2004-09-02T03:00:00Z,MUHA 230N 824W,0,0,1,4,5
Hurricane,Frances,33,2004-09-02T03:00:00Z,WILMINGTON NC,0,0,0,3,3
Hurricane,Frances,33,2004-09-02T03:00:00Z,MBJT 215N 712W,99,0,0,0,99
Hurricane,Frances,33,2004-09-02T03:00:00Z,KEY WEST FL,0,1,5,5,11
Hurricane,Frances,33,2004-09-02T03:00:00Z,MYMM 224N 730W,99,0,0,0,99
Hurricane,Frances,33,2004-09-02T03:00:00Z,MARCO ISLAND FL,0,2,8,6,16
Hurricane,Frances,33,2004-09-02T03:00:00Z,MYSM 241N 745W,60,0,0,0,60
Hurricane,Frances,33,2004-09-02T03:00:00Z,FT MYERS FL,0,1,9,7,17
Hurricane,Frances,33,2004-09-02T03:00:00Z,MYEG 235N 758W,36,0,0,0,36
Hurricane,Frances,33,2004-09-02T03:00:00Z,VENICE FL,0,0,7,9,16
Hurricane,Frances,33,2004-09-02T03:00:00Z,MYAK 241N 776W,20,4,0,1,25
Hurricane,Frances,33,2004-09-02T03:00:00Z,TAMPA FL,0,0,6,11,17
Hurricane,Frances,33,2004-09-02T03:00:00Z,MYNN 251N 775W,22,9,0,0,31
Hurricane,Frances,33,2004-09-02T03:00:00Z,CEDAR KEY FL,0,0,2,13,15
Hurricane,Frances,33,2004-09-02T03:00:00Z,MYGF 266N 787W,1,22,2,2,27
Hurricane,Frances,33,2004-09-02T03:00:00Z,ST MARKS FL,0,0,0,11,11
Hurricane,Frances,33,2004-09-02T03:00:00Z,MARATHON FL,0,4,5,5,14
Hurricane,Frances,33,2004-09-02T03:00:00Z,APALACHICOLA FL,0,0,0,10,10
Hurricane,Frances,33,2004-09-02T03:00:00Z,MIAMI FL,0,11,6,3,20
Hurricane,Frances,33,2004-09-02T03:00:00Z,PANAMA CITY FL,0,0,0,8,8
Hurricane,Frances,33,2004-09-02T03:00:00Z,W PALM BEACH FL,0,11,8,3,22
Hurricane,Frances,33,2004-09-02T03:00:00Z,PENSACOLA FL,0,0,0,3,3
Hurricane,Frances,33,2004-09-02T03:00:00Z,FT PIERCE FL,0,5,12,5,22
Hurricane,Frances,33,2004-09-02T03:00:00Z,GULF 29N 85W,0,0,0,10,10
Hurricane,Frances,33,2004-09-02T03:00:00Z,COCOA BEACH FL,0,2,13,6,21
Hurricane,Frances,33,2004-09-02T03:00:00Z,GULF 29N 87W,0,0,0,4,4
Hurricane,Frances,34,2004-09-02T09:00:00Z,24.6N  76.3W,46,0,0,0,46
Hurricane,Frances,34,2004-09-02T09:00:00Z,SAVANNAH GA,0,0,0,10,10
Hurricane,Frances,34,2004-09-02T09:00:00Z,25.6N  78.0W,15,14,0,1,30
Hurricane,Frances,34,2004-09-02T09:00:00Z,CHARLESTON SC,0,0,0,7,7
Hurricane,Frances,34,2004-09-02T09:00:00Z,26.6N  79.5W,0,17,4,2,23
Hurricane,Frances,34,2004-09-02T09:00:00Z,MYRTLE BEACH SC,0,0,0,4,4
Hurricane,Frances,34,2004-09-02T09:00:00Z,MUCM 214N 779W,1,0,0,1,2
Hurricane,Frances,34,2004-09-02T09:00:00Z,WILMINGTON NC,0,0,0,2,2
Hurricane,Frances,34,2004-09-02T09:00:00Z,MUCF 221N 805W,0,1,0,2,3
Hurricane,Frances,34,2004-09-02T09:00:00Z,KEY WEST FL,0,2,5,4,11
Hurricane,Frances,34,2004-09-02T09:00:00Z,MUHA 230N 824W,0,0,1,3,4
Hurricane,Frances,34,2004-09-02T09:00:00Z,MARCO ISLAND FL,0,3,9,5,17
Hurricane,Frances,34,2004-09-02T09:00:00Z,MYMM 224N 730W,99,0,0,0,99
Hurricane,Frances,34,2004-09-02T09:00:00Z,FT MYERS FL,0,2,10,5,17
Hurricane,Frances,34,2004-09-02T09:00:00Z,MYSM 241N 745W,74,0,0,0,74
Hurricane,Frances,34,2004-09-02T09:00:00Z,VENICE FL,0,1,8,7,16
Hurricane,Frances,34,2004-09-02T09:00:00Z,MYEG 235N 758W,45,0,0,0,45
Hurricane,Frances,34,2004-09-02T09:00:00Z,TAMPA FL,0,0,8,9,17
Hurricane,Frances,34,2004-09-02T09:00:00Z,MYAK 241N 776W,24,3,1,0,28
Hurricane,Frances,34,2004-09-02T09:00:00Z,CEDAR KEY FL,0,0,3,12,15
Hurricane,Frances,34,2004-09-02T09:00:00Z,MYNN 251N 775W,28,5,0,0,33
Hurricane,Frances,34,2004-09-02T09:00:00Z,ST MARKS FL,0,0,0,12,12
Hurricane,Frances,34,2004-09-02T09:00:00Z,MYGF 266N 787W,2,21,1,1,25
Hurricane,Frances,34,2004-09-02T09:00:00Z,APALACHICOLA FL,0,0,0,10,10
Hurricane,Frances,34,2004-09-02T09:00:00Z,MARATHON FL,0,5,6,3,14
Hurricane,Frances,34,2004-09-02T09:00:00Z,PANAMA CITY FL,0,0,0,9,9
Hurricane,Frances,34,2004-09-02T09:00:00Z,MIAMI FL,0,12,6,2,20
Hurricane,Frances,34,2004-09-02T09:00:00Z,PENSACOLA FL,0,0,0,5,5
Hurricane,Frances,34,2004-09-02T09:00:00Z,W PALM BEACH FL,0,12,7,3,22
Hurricane,Frances,34,2004-09-02T09:00:00Z,MOBILE AL,0,0,0,3,3
Hurricane,Frances,34,2004-09-02T09:00:00Z,FT PIERCE FL,0,7,10,4,21
Hurricane,Frances,34,2004-09-02T09:00:00Z,GULFPORT MS,0,0,0,2,2
Hurricane,Frances,34,2004-09-02T09:00:00Z,COCOA BEACH FL,0,3,12,5,20
Hurricane,Frances,34,2004-09-02T09:00:00Z,GULF 29N 85W,0,0,1,10,11
Hurricane,Frances,34,2004-09-02T09:00:00Z,DAYTONA BEACH FL,0,0,9,9,18
Hurricane,Frances,34,2004-09-02T09:00:00Z,GULF 29N 87W,0,0,0,6,6
Hurricane,Frances,34,2004-09-02T09:00:00Z,JACKSONVILLE FL,0,0,2,12,14
Hurricane,Frances,34,2004-09-02T09:00:00Z,GULF 28N 89W,0,0,0,2,2
Hurricane,Frances,35,2004-09-02T15:00:00Z,25.5N  77.2W,50,0,0,0,50
Hurricane,Frances,35,2004-09-02T15:00:00Z,MYRTLE BEACH SC,0,0,0,4,4
Hurricane,Frances,35,2004-09-02T15:00:00Z,26.4N  78.5W,25,7,0,1,33
Hurricane,Frances,35,2004-09-02T15:00:00Z,WILMINGTON NC,0,0,0,2,2
Hurricane,Frances,35,2004-09-02T15:00:00Z,27.0N  79.7W,3,19,1,2,25
Hurricane,Frances,35,2004-09-02T15:00:00Z,KEY WEST FL,0,3,2,3,8
Hurricane,Frances,35,2004-09-02T15:00:00Z,MYMM 224N 730W,99,0,0,0,99
Hurricane,Frances,35,2004-09-02T15:00:00Z,MARCO ISLAND FL,0,7,5,4,16
Hurricane,Frances,35,2004-09-02T15:00:00Z,MYSM 241N 745W,99,0,0,0,99
Hurricane,Frances,35,2004-09-02T15:00:00Z,FT MYERS FL,0,6,7,4,17
Hurricane,Frances,35,2004-09-02T15:00:00Z,MYEG 235N 758W,60,0,0,0,60
Hurricane,Frances,35,2004-09-02T15:00:00Z,VENICE FL,0,3,8,6,17
Hurricane,Frances,35,2004-09-02T15:00:00Z,MYAK 241N 776W,32,0,0,0,32
Hurricane,Frances,35,2004-09-02T15:00:00Z,TAMPA FL,0,1,10,6,17
Hurricane,Frances,35,2004-09-02T15:00:00Z,MYNN 251N 775W,45,0,0,0,45
Hurricane,Frances,35,2004-09-02T15:00:00Z,CEDAR KEY FL,0,0,6,10,16
Hurricane,Frances,35,2004-09-02T15:00:00Z,MYGF 266N 787W,18,12,0,1,31
Hurricane,Frances,35,2004-09-02T15:00:00Z,ST MARKS FL,0,0,1,12,13
Hurricane,Frances,35,2004-09-02T15:00:00Z,MARATHON FL,0,6,2,3,11
Hurricane,Frances,35,2004-09-02T15:00:00Z,APALACHICOLA FL,0,0,1,11,12
Hurricane,Frances,35,2004-09-02T15:00:00Z,MIAMI FL,3,13,2,1,19
Hurricane,Frances,35,2004-09-02T15:00:00Z,PANAMA CITY FL,0,0,0,10,10
Hurricane,Frances,35,2004-09-02T15:00:00Z,W PALM BEACH FL,2,17,2,2,23
Hurricane,Frances,35,2004-09-02T15:00:00Z,PENSACOLA FL,0,0,0,6,6
Hurricane,Frances,35,2004-09-02T15:00:00Z,FT PIERCE FL,0,16,4,2,22
Hurricane,Frances,35,2004-09-02T15:00:00Z,MOBILE AL,0,0,0,4,4
Hurricane,Frances,35,2004-09-02T15:00:00Z,COCOA BEACH FL,0,9,8,4,21
Hurricane,Frances,35,2004-09-02T15:00:00Z,GULFPORT MS,0,0,0,3,3
Hurricane,Frances,35,2004-09-02T15:00:00Z,DAYTONA BEACH FL,0,2,10,6,18
Hurricane,Frances,35,2004-09-02T15:00:00Z,BURAS LA,0,0,0,2,2
Hurricane,Frances,35,2004-09-02T15:00:00Z,JACKSONVILLE FL,0,0,3,12,15
Hurricane,Frances,35,2004-09-02T15:00:00Z,GULF 29N 85W,0,0,1,11,12
Hurricane,Frances,35,2004-09-02T15:00:00Z,SAVANNAH GA,0,0,0,10,10
Hurricane,Frances,35,2004-09-02T15:00:00Z,GULF 29N 87W,0,0,0,7,7
Hurricane,Frances,35,2004-09-02T15:00:00Z,CHARLESTON SC,0,0,0,7,7
Hurricane,Frances,35,2004-09-02T15:00:00Z,GULF 28N 89W,0,0,0,3,3
Hurricane,Frances,36,2004-09-02T21:00:00Z,26.0N  77.8W,49,0,0,0,49
Hurricane,Frances,36,2004-09-02T21:00:00Z,WILMINGTON NC,0,0,0,2,2
Hurricane,Frances,36,2004-09-02T21:00:00Z,27.0N  79.5W,17,12,0,1,30
Hurricane,Frances,36,2004-09-02T21:00:00Z,KEY WEST FL,0,3,1,3,7
Hurricane,Frances,36,2004-09-02T21:00:00Z,27.7N  80.5W,2,19,2,1,24
Hurricane,Frances,36,2004-09-02T21:00:00Z,MARCO ISLAND FL,0,10,3,2,15
Hurricane,Frances,36,2004-09-02T21:00:00Z,MYSM 241N 745W,99,0,0,0,99
Hurricane,Frances,36,2004-09-02T21:00:00Z,FT MYERS FL,0,11,3,3,17
Hurricane,Frances,36,2004-09-02T21:00:00Z,MYEG 235N 758W,51,0,0,0,51
Hurricane,Frances,36,2004-09-02T21:00:00Z,VENICE FL,0,8,5,4,17
Hurricane,Frances,36,2004-09-02T21:00:00Z,MYAK 241N 776W,32,0,0,0,32
Hurricane,Frances,36,2004-09-02T21:00:00Z,TAMPA FL,0,8,6,4,18
Hurricane,Frances,36,2004-09-02T21:00:00Z,MYNN 251N 775W,51,0,0,0,51
Hurricane,Frances,36,2004-09-02T21:00:00Z,CEDAR KEY FL,0,2,9,6,17
Hurricane,Frances,36,2004-09-02T21:00:00Z,MYGF 266N 787W,34,2,0,0,36
Hurricane,Frances,36,2004-09-02T21:00:00Z,ST MARKS FL,0,0,4,11,15
Hurricane,Frances,36,2004-09-02T21:00:00Z,MARATHON FL,1,5,1,2,9
Hurricane,Frances,36,2004-09-02T21:00:00Z,APALACHICOLA FL,0,0,3,11,14
Hurricane,Frances,36,2004-09-02T21:00:00Z,MIAMI FL,8,11,0,1,20
Hurricane,Frances,36,2004-09-02T21:00:00Z,PANAMA CITY FL,0,0,2,11,13
Hurricane,Frances,36,2004-09-02T21:00:00Z,W PALM BEACH FL,9,15,1,1,26
Hurricane,Frances,36,2004-09-02T21:00:00Z,PENSACOLA FL,0,0,0,9,9
Hurricane,Frances,36,2004-09-02T21:00:00Z,FT PIERCE FL,3,20,1,1,25
Hurricane,Frances,36,2004-09-02T21:00:00Z,MOBILE AL,0,0,0,7,7
Hurricane,Frances,36,2004-09-02T21:00:00Z,COCOA BEACH FL,1,18,2,2,23
Hurricane,Frances,36,2004-09-02T21:00:00Z,GULFPORT MS,0,0,0,5,5
Hurricane,Frances,36,2004-09-02T21:00:00Z,DAYTONA BEACH FL,0,10,6,4,20
Hurricane,Frances,36,2004-09-02T21:00:00Z,BURAS LA,0,0,0,4,4
Hurricane,Frances,36,2004-09-02T21:00:00Z,JACKSONVILLE FL,0,1,8,8,17
Hurricane,Frances,36,2004-09-02T21:00:00Z,NEW ORLEANS LA,0,0,0,3,3
Hurricane,Frances,36,2004-09-02T21:00:00Z,SAVANNAH GA,0,0,2,10,12
Hurricane,Frances,36,2004-09-02T21:00:00Z,GULF 29N 85W,0,0,5,9,14
Hurricane,Frances,36,2004-09-02T21:00:00Z,CHARLESTON SC,0,0,1,7,8
Hurricane,Frances,36,2004-09-02T21:00:00Z,GULF 29N 87W,0,0,1,9,10
Hurricane,Frances,36,2004-09-02T21:00:00Z,MYRTLE BEACH SC,0,0,0,4,4
Hurricane,Frances,36,2004-09-02T21:00:00Z,GULF 28N 89W,0,0,0,4,4
Hurricane,Frances,37,2004-09-03T03:00:00Z,26.1N  77.9W,46,0,0,0,46
Hurricane,Frances,37,2004-09-03T03:00:00Z,KEY WEST FL,0,2,1,2,5
Hurricane,Frances,37,2004-09-03T03:00:00Z,26.8N  79.1W,28,2,0,0,30
Hurricane,Frances,37,2004-09-03T03:00:00Z,MARCO ISLAND FL,1,8,2,3,14
Hurricane,Frances,37,2004-09-03T03:00:00Z,27.6N  80.6W,3,14,3,1,21
Hurricane,Frances,37,2004-09-03T03:00:00Z,FT MYERS FL,1,9,3,3,16
Hurricane,Frances,37,2004-09-03T03:00:00Z,MYSM 241N 745W,99,0,0,0,99
Hurricane,Frances,37,2004-09-03T03:00:00Z,VENICE FL,0,7,5,4,16
Hurricane,Frances,37,2004-09-03T03:00:00Z,MYEG 235N 758W,3,0,0,0,3
Hurricane,Frances,37,2004-09-03T03:00:00Z,TAMPA FL,0,6,8,4,18
Hurricane,Frances,37,2004-09-03T03:00:00Z,MYAK 241N 776W,23,1,0,0,24
Hurricane,Frances,37,2004-09-03T03:00:00Z,CEDAR KEY FL,0,1,10,6,17
Hurricane,Frances,37,2004-09-03T03:00:00Z,MYNN 251N 775W,49,0,0,0,49
Hurricane,Frances,37,2004-09-03T03:00:00Z,ST MARKS FL,0,0,4,10,14
Hurricane,Frances,37,2004-09-03T03:00:00Z,MYGF 266N 787W,35,0,0,0,35
Hurricane,Frances,37,2004-09-03T03:00:00Z,APALACHICOLA FL,0,0,4,10,14
Hurricane,Frances,37,2004-09-03T03:00:00Z,MARATHON FL,2,3,1,2,8
Hurricane,Frances,37,2004-09-03T03:00:00Z,PANAMA CITY FL,0,0,2,10,12
Hurricane,Frances,37,2004-09-03T03:00:00Z,MIAMI FL,11,5,1,1,18
Hurricane,Frances,37,2004-09-03T03:00:00Z,PENSACOLA FL,0,0,0,9,9
Hurricane,Frances,37,2004-09-03T03:00:00Z,W PALM BEACH FL,13,8,1,1,23
Hurricane,Frances,37,2004-09-03T03:00:00Z,MOBILE AL,0,0,0,6,6
Hurricane,Frances,37,2004-09-03T03:00:00Z,FT PIERCE FL,5,14,2,1,22
Hurricane,Frances,37,2004-09-03T03:00:00Z,GULFPORT MS,0,0,0,5,5
Hurricane,Frances,37,2004-09-03T03:00:00Z,COCOA BEACH FL,1,14,4,2,21
Hurricane,Frances,37,2004-09-03T03:00:00Z,BURAS LA,0,0,0,4,4
Hurricane,Frances,37,2004-09-03T03:00:00Z,DAYTONA BEACH FL,0,7,9,4,20
Hurricane,Frances,37,2004-09-03T03:00:00Z,NEW ORLEANS LA,0,0,0,3,3
Hurricane,Frances,37,2004-09-03T03:00:00Z,JACKSONVILLE FL,0,1,7,8,16
Hurricane,Frances,37,2004-09-03T03:00:00Z,GULF 29N 85W,0,0,5,9,14
Hurricane,Frances,37,2004-09-03T03:00:00Z,SAVANNAH GA,0,0,2,8,10
Hurricane,Frances,37,2004-09-03T03:00:00Z,GULF 29N 87W,0,0,1,9,10
Hurricane,Frances,37,2004-09-03T03:00:00Z,CHARLESTON SC,0,0,0,7,7
Hurricane,Frances,37,2004-09-03T03:00:00Z,GULF 28N 89W,0,0,0,4,4
Hurricane,Frances,37,2004-09-03T03:00:00Z,MYRTLE BEACH SC,0,0,0,3,3
Hurricane,Frances,38,2004-09-03T09:00:00Z,26.4N  78.3W,53,0,0,0,53
Hurricane,Frances,38,2004-09-03T09:00:00Z,KEY WEST FL,1,2,0,3,6
Hurricane,Frances,38,2004-09-03T09:00:00Z,27.1N  79.5W,32,3,0,0,35
Hurricane,Frances,38,2004-09-03T09:00:00Z,MARCO ISLAND FL,3,9,2,2,16
Hurricane,Frances,38,2004-09-03T09:00:00Z,27.6N  80.7W,7,17,1,1,26
Hurricane,Frances,38,2004-09-03T09:00:00Z,FT MYERS FL,1,13,2,2,18
Hurricane,Frances,38,2004-09-03T09:00:00Z,MYAK 241N 776W,7,0,0,1,8
Hurricane,Frances,38,2004-09-03T09:00:00Z,VENICE FL,0,10,5,3,18
Hurricane,Frances,38,2004-09-03T09:00:00Z,MYNN 251N 775W,55,0,0,0,55
Hurricane,Frances,38,2004-09-03T09:00:00Z,TAMPA FL,0,9,7,4,20
Hurricane,Frances,38,2004-09-03T09:00:00Z,MYGF 266N 787W,45,1,0,0,46
Hurricane,Frances,38,2004-09-03T09:00:00Z,CEDAR KEY FL,0,2,11,5,18
Hurricane,Frances,38,2004-09-03T09:00:00Z,MARATHON FL,3,4,0,2,9
Hurricane,Frances,38,2004-09-03T09:00:00Z,ST MARKS FL,0,0,5,10,15
Hurricane,Frances,38,2004-09-03T09:00:00Z,MIAMI FL,18,3,1,0,22
Hurricane,Frances,38,2004-09-03T09:00:00Z,APALACHICOLA FL,0,0,4,10,14
Hurricane,Frances,38,2004-09-03T09:00:00Z,W PALM BEACH FL,23,5,1,0,29
Hurricane,Frances,38,2004-09-03T09:00:00Z,PANAMA CITY FL,0,0,2,11,13
Hurricane,Frances,38,2004-09-03T09:00:00Z,FT PIERCE FL,14,13,1,1,29
Hurricane,Frances,38,2004-09-03T09:00:00Z,PENSACOLA FL,0,0,0,9,9
Hurricane,Frances,38,2004-09-03T09:00:00Z,COCOA BEACH FL,3,20,2,1,26
Hurricane,Frances,38,2004-09-03T09:00:00Z,MOBILE AL,0,0,0,7,7
Hurricane,Frances,38,2004-09-03T09:00:00Z,DAYTONA BEACH FL,0,11,7,3,21
Hurricane,Frances,38,2004-09-03T09:00:00Z,GULFPORT MS,0,0,0,5,5
Hurricane,Frances,38,2004-09-03T09:00:00Z,JACKSONVILLE FL,0,1,9,7,17
Hurricane,Frances,38,2004-09-03T09:00:00Z,BURAS LA,0,0,0,4,4
Hurricane,Frances,38,2004-09-03T09:00:00Z,SAVANNAH GA,0,0,2,10,12
Hurricane,Frances,38,2004-09-03T09:00:00Z,NEW ORLEANS LA,0,0,0,3,3
Hurricane,Frances,38,2004-09-03T09:00:00Z,CHARLESTON SC,0,0,0,8,8
Hurricane,Frances,38,2004-09-03T09:00:00Z,GULF 29N 85W,0,0,5,9,14
Hurricane,Frances,38,2004-09-03T09:00:00Z,MYRTLE BEACH SC,0,0,0,4,4
Hurricane,Frances,38,2004-09-03T09:00:00Z,GULF 29N 87W,0,0,1,8,9
Hurricane,Frances,38,2004-09-03T09:00:00Z,WILMINGTON NC,0,0,0,2,2
Hurricane,Frances,38,2004-09-03T09:00:00Z,GULF 28N 89W,0,0,0,3,3
Hurricane,Frances,39,2004-09-03T15:00:00Z,27.0N  79.0W,49,0,0,0,49
Hurricane,Frances,39,2004-09-03T15:00:00Z,KEY WEST FL,1,1,1,3,6
Hurricane,Frances,39,2004-09-03T15:00:00Z,27.5N  80.0W,35,1,0,0,36
Hurricane,Frances,39,2004-09-03T15:00:00Z,MARCO ISLAND FL,6,6,2,1,15
Hurricane,Frances,39,2004-09-03T15:00:00Z,28.5N  81.5W,4,15,3,2,24
Hurricane,Frances,39,2004-09-03T15:00:00Z,FT MYERS FL,6,8,2,2,18
Hurricane,Frances,39,2004-09-03T15:00:00Z,MYAK 241N 776W,0,0,1,2,3
Hurricane,Frances,39,2004-09-03T15:00:00Z,VENICE FL,2,10,3,3,18
Hurricane,Frances,39,2004-09-03T15:00:00Z,MYNN 251N 775W,99,0,0,0,99
Hurricane,Frances,39,2004-09-03T15:00:00Z,TAMPA FL,1,12,5,2,20
Hurricane,Frances,39,2004-09-03T15:00:00Z,MYGF 266N 787W,53,0,0,0,53
Hurricane,Frances,39,2004-09-03T15:00:00Z,CEDAR KEY FL,0,8,9,3,20
Hurricane,Frances,39,2004-09-03T15:00:00Z,MARATHON FL,2,3,1,2,8
Hurricane,Frances,39,2004-09-03T15:00:00Z,ST MARKS FL,0,1,10,6,17
Hurricane,Frances,39,2004-09-03T15:00:00Z,MIAMI FL,19,1,1,0,21
Hurricane,Frances,39,2004-09-03T15:00:00Z,APALACHICOLA FL,0,0,8,7,15
Hurricane,Frances,39,2004-09-03T15:00:00Z,W PALM BEACH FL,32,0,0,1,33
Hurricane,Frances,39,2004-09-03T15:00:00Z,PANAMA CITY FL,0,0,6,8,14
Hurricane,Frances,39,2004-09-03T15:00:00Z,FT PIERCE FL,30,2,0,0,32
Hurricane,Frances,39,2004-09-03T15:00:00Z,PENSACOLA FL,0,0,1,9,10
Hurricane,Frances,39,2004-09-03T15:00:00Z,COCOA BEACH FL,19,7,1,1,28
Hurricane,Frances,39,2004-09-03T15:00:00Z,MOBILE AL,0,0,0,7,7
Hurricane,Frances,39,2004-09-03T15:00:00Z,DAYTONA BEACH FL,3,15,4,2,24
Hurricane,Frances,39,2004-09-03T15:00:00Z,GULFPORT MS,0,0,0,5,5
Hurricane,Frances,39,2004-09-03T15:00:00Z,JACKSONVILLE FL,0,6,11,4,21
Hurricane,Frances,39,2004-09-03T15:00:00Z,BURAS LA,0,0,0,3,3
Hurricane,Frances,39,2004-09-03T15:00:00Z,SAVANNAH GA,0,0,8,8,16
Hurricane,Frances,39,2004-09-03T15:00:00Z,NEW ORLEANS LA,0,0,0,2,2
Hurricane,Frances,39,2004-09-03T15:00:00Z,CHARLESTON SC,0,0,3,9,12
Hurricane,Frances,39,2004-09-03T15:00:00Z,GULF 29N 85W,0,1,7,6,14
Hurricane,Frances,39,2004-09-03T15:00:00Z,MYRTLE BEACH SC,0,0,1,6,7
Hurricane,Frances,39,2004-09-03T15:00:00Z,GULF 29N 87W,0,0,2,7,9
Hurricane,Frances,39,2004-09-03T15:00:00Z,WILMINGTON NC,0,0,0,4,4
Hurricane,Frances,39,2004-09-03T15:00:00Z,GULF 28N 89W,0,0,0,2,2
Hurricane,Frances,39,2004-09-03T15:00:00Z,MOREHEAD CITY NC,0,0,0,2,2
Hurricane,Frances,40,2004-09-03T21:00:00Z,27.4N  80.0W,49,0,0,0,49
Hurricane,Frances,40,2004-09-03T21:00:00Z,FT MYERS FL,18,3,0,1,22
Hurricane,Frances,40,2004-09-03T21:00:00Z,28.0N  81.5W,27,5,0,0,32
Hurricane,Frances,40,2004-09-03T21:00:00Z,VENICE FL,11,9,1,1,22
Hurricane,Frances,40,2004-09-03T21:00:00Z,28.5N  82.5W,6,18,1,1,26
Hurricane,Frances,40,2004-09-03T21:00:00Z,TAMPA FL,9,15,1,1,26
Hurricane,Frances,40,2004-09-03T21:00:00Z,MYNN 251N 775W,99,0,0,0,99
Hurricane,Frances,40,2004-09-03T21:00:00Z,CEDAR KEY FL,1,18,2,2,23
Hurricane,Frances,40,2004-09-03T21:00:00Z,MYGF 266N 787W,70,0,0,0,70
Hurricane,Frances,40,2004-09-03T21:00:00Z,ST MARKS FL,0,4,9,5,18
Hurricane,Frances,40,2004-09-03T21:00:00Z,MARATHON FL,2,1,0,1,4
Hurricane,Frances,40,2004-09-03T21:00:00Z,APALACHICOLA FL,0,3,9,5,17
Hurricane,Frances,40,2004-09-03T21:00:00Z,MIAMI FL,26,0,0,1,27
Hurricane,Frances,40,2004-09-03T21:00:00Z,PANAMA CITY FL,0,1,8,7,16
Hurricane,Frances,40,2004-09-03T21:00:00Z,W PALM BEACH FL,44,0,0,0,44
Hurricane,Frances,40,2004-09-03T21:00:00Z,PENSACOLA FL,0,0,3,10,13
Hurricane,Frances,40,2004-09-03T21:00:00Z,FT PIERCE FL,45,1,0,0,46
Hurricane,Frances,40,2004-09-03T21:00:00Z,MOBILE AL,0,0,1,9,10
Hurricane,Frances,40,2004-09-03T21:00:00Z,COCOA BEACH FL,39,0,0,0,39
Hurricane,Frances,40,2004-09-03T21:00:00Z,GULFPORT MS,0,0,1,7,8
Hurricane,Frances,40,2004-09-03T21:00:00Z,DAYTONA BEACH FL,16,12,1,0,29
Hurricane,Frances,40,2004-09-03T21:00:00Z,BURAS LA,0,0,0,6,6
Hurricane,Frances,40,2004-09-03T21:00:00Z,JACKSONVILLE FL,0,13,4,3,20
Hurricane,Frances,40,2004-09-03T21:00:00Z,NEW ORLEANS LA,0,0,0,5,5
Hurricane,Frances,40,2004-09-03T21:00:00Z,SAVANNAH GA,0,1,6,7,14
Hurricane,Frances,40,2004-09-03T21:00:00Z,NEW IBERIA LA,0,0,0,3,3
Hurricane,Frances,40,2004-09-03T21:00:00Z,CHARLESTON SC,0,0,2,8,10
Hurricane,Frances,40,2004-09-03T21:00:00Z,GULF 29N 85W,0,5,8,4,17
Hurricane,Frances,40,2004-09-03T21:00:00Z,MYRTLE BEACH SC,0,0,0,6,6
Hurricane,Frances,40,2004-09-03T21:00:00Z,GULF 29N 87W,0,0,5,6,11
Hurricane,Frances,40,2004-09-03T21:00:00Z,WILMINGTON NC,0,0,0,3,3
Hurricane,Frances,40,2004-09-03T21:00:00Z,GULF 28N 89W,0,0,1,4,5
Hurricane,Frances,40,2004-09-03T21:00:00Z,KEY WEST FL,1,0,0,1,2
Hurricane,Frances,40,2004-09-03T21:00:00Z,GULF 28N 91W,0,0,0,2,2
Hurricane,Frances,40,2004-09-03T21:00:00Z,MARCO ISLAND FL,14,2,0,1,17
Hurricane,Frances,41,2004-09-04T03:00:00Z,27.0N  79.8W,50,0,0,0,50
Hurricane,Frances,41,2004-09-04T03:00:00Z,FT MYERS FL,16,4,1,0,21
Hurricane,Frances,41,2004-09-04T03:00:00Z,27.6N  81.2W,28,2,1,0,31
Hurricane,Frances,41,2004-09-04T03:00:00Z,VENICE FL,8,10,1,1,20
Hurricane,Frances,41,2004-09-04T03:00:00Z,28.7N  83.1W,0,15,5,2,22
Hurricane,Frances,41,2004-09-04T03:00:00Z,TAMPA FL,4,16,1,1,22
Hurricane,Frances,41,2004-09-04T03:00:00Z,MYNN 251N 775W,99,0,0,0,99
Hurricane,Frances,41,2004-09-04T03:00:00Z,CEDAR KEY FL,0,14,6,2,22
Hurricane,Frances,41,2004-09-04T03:00:00Z,MYGF 266N 787W,99,0,0,0,99
Hurricane,Frances,41,2004-09-04T03:00:00Z,ST MARKS FL,0,3,12,4,19
Hurricane,Frances,41,2004-09-04T03:00:00Z,MARATHON FL,5,2,0,1,8
Hurricane,Frances,41,2004-09-04T03:00:00Z,APALACHICOLA FL,0,2,12,4,18
Hurricane,Frances,41,2004-09-04T03:00:00Z,MIAMI FL,26,0,0,0,26
Hurricane,Frances,41,2004-09-04T03:00:00Z,PANAMA CITY FL,0,1,10,6,17
Hurricane,Frances,41,2004-09-04T03:00:00Z,W PALM BEACH FL,42,0,0,0,42
Hurricane,Frances,41,2004-09-04T03:00:00Z,PENSACOLA FL,0,0,5,9,14
Hurricane,Frances,41,2004-09-04T03:00:00Z,FT PIERCE FL,41,0,0,0,41
Hurricane,Frances,41,2004-09-04T03:00:00Z,MOBILE AL,0,0,2,10,12
Hurricane,Frances,41,2004-09-04T03:00:00Z,COCOA BEACH FL,31,2,1,0,34
Hurricane,Frances,41,2004-09-04T03:00:00Z,GULFPORT MS,0,0,1,9,10
Hurricane,Frances,41,2004-09-04T03:00:00Z,DAYTONA BEACH FL,9,13,1,1,24
Hurricane,Frances,41,2004-09-04T03:00:00Z,BURAS LA,0,0,1,7,8
Hurricane,Frances,41,2004-09-04T03:00:00Z,JACKSONVILLE FL,0,10,7,3,20
Hurricane,Frances,41,2004-09-04T03:00:00Z,NEW ORLEANS LA,0,0,0,7,7
Hurricane,Frances,41,2004-09-04T03:00:00Z,SAVANNAH GA,0,1,7,7,15
Hurricane,Frances,41,2004-09-04T03:00:00Z,NEW IBERIA LA,0,0,0,4,4
Hurricane,Frances,41,2004-09-04T03:00:00Z,CHARLESTON SC,0,0,3,7,10
Hurricane,Frances,41,2004-09-04T03:00:00Z,GULF 29N 85W,0,4,10,4,18
Hurricane,Frances,41,2004-09-04T03:00:00Z,MYRTLE BEACH SC,0,0,1,5,6
Hurricane,Frances,41,2004-09-04T03:00:00Z,GULF 29N 87W,0,0,7,6,13
Hurricane,Frances,41,2004-09-04T03:00:00Z,WILMINGTON NC,0,0,0,3,3
Hurricane,Frances,41,2004-09-04T03:00:00Z,GULF 28N 89W,0,0,1,5,6
Hurricane,Frances,41,2004-09-04T03:00:00Z,KEY WEST FL,2,1,1,1,5
Hurricane,Frances,41,2004-09-04T03:00:00Z,GULF 28N 91W,0,0,0,2,2
Hurricane,Frances,41,2004-09-04T03:00:00Z,MARCO ISLAND FL,15,3,0,0,18
Hurricane,Frances,42,2004-09-04T09:00:00Z,27.5N  80.3W,47,0,0,0,47
Hurricane,Frances,42,2004-09-04T09:00:00Z,VENICE FL,17,5,0,0,22
Hurricane,Frances,42,2004-09-04T09:00:00Z,28.2N  82.0W,23,6,1,0,30
Hurricane,Frances,42,2004-09-04T09:00:00Z,TAMPA FL,16,9,1,0,26
Hurricane,Frances,42,2004-09-04T09:00:00Z,29.0N  84.0W,0,16,4,2,22
Hurricane,Frances,42,2004-09-04T09:00:00Z,CEDAR KEY FL,3,19,1,1,24
Hurricane,Frances,42,2004-09-04T09:00:00Z,MYGF 266N 787W,99,0,0,0,99
Hurricane,Frances,42,2004-09-04T09:00:00Z,ST MARKS FL,0,9,10,2,21
Hurricane,Frances,42,2004-09-04T09:00:00Z,MARATHON FL,1,1,0,0,2
Hurricane,Frances,42,2004-09-04T09:00:00Z,APALACHICOLA FL,0,8,10,2,20
Hurricane,Frances,42,2004-09-04T09:00:00Z,MIAMI FL,18,1,0,0,19
Hurricane,Frances,42,2004-09-04T09:00:00Z,PANAMA CITY FL,0,4,11,4,19
Hurricane,Frances,42,2004-09-04T09:00:00Z,W PALM BEACH FL,40,0,0,1,41
Hurricane,Frances,42,2004-09-04T09:00:00Z,PENSACOLA FL,0,0,9,7,16
Hurricane,Frances,42,2004-09-04T09:00:00Z,FT PIERCE FL,47,0,0,0,47
Hurricane,Frances,42,2004-09-04T09:00:00Z,MOBILE AL,0,0,4,10,14
Hurricane,Frances,42,2004-09-04T09:00:00Z,COCOA BEACH FL,42,0,0,0,42
Hurricane,Frances,42,2004-09-04T09:00:00Z,GULFPORT MS,0,0,3,10,13
Hurricane,Frances,42,2004-09-04T09:00:00Z,DAYTONA BEACH FL,22,7,0,0,29
Hurricane,Frances,42,2004-09-04T09:00:00Z,BURAS LA,0,0,2,8,10
Hurricane,Frances,42,2004-09-04T09:00:00Z,JACKSONVILLE FL,1,15,3,2,21
Hurricane,Frances,42,2004-09-04T09:00:00Z,NEW ORLEANS LA,0,0,1,8,9
Hurricane,Frances,42,2004-09-04T09:00:00Z,SAVANNAH GA,0,3,6,5,14
Hurricane,Frances,42,2004-09-04T09:00:00Z,NEW IBERIA LA,0,0,0,6,6
Hurricane,Frances,42,2004-09-04T09:00:00Z,CHARLESTON SC,0,0,3,6,9
Hurricane,Frances,42,2004-09-04T09:00:00Z,PORT ARTHUR TX,0,0,0,2,2
Hurricane,Frances,42,2004-09-04T09:00:00Z,MYRTLE BEACH SC,0,0,1,3,4
Hurricane,Frances,42,2004-09-04T09:00:00Z,GULF 29N 85W,0,10,8,2,20
Hurricane,Frances,42,2004-09-04T09:00:00Z,WILMINGTON NC,0,0,0,2,2
Hurricane,Frances,42,2004-09-04T09:00:00Z,GULF 29N 87W,0,1,9,5,15
Hurricane,Frances,42,2004-09-04T09:00:00Z,MARCO ISLAND FL,14,2,0,0,16
Hurricane,Frances,42,2004-09-04T09:00:00Z,GULF 28N 89W,0,0,2,5,7
Hurricane,Frances,42,2004-09-04T09:00:00Z,FT MYERS FL,20,2,0,0,22
Hurricane,Frances,42,2004-09-04T09:00:00Z,GULF 28N 91W,0,0,0,4,4
Hurricane,Frances,43,2004-09-04T15:00:00Z,28.0N  81.2W,48,0,0,0,48
Hurricane,Frances,43,2004-09-04T15:00:00Z,CEDAR KEY FL,18,10,1,0,29
Hurricane,Frances,43,2004-09-04T15:00:00Z,28.5N  83.0W,23,6,0,1,30
Hurricane,Frances,43,2004-09-04T15:00:00Z,ST MARKS FL,1,16,4,2,23
Hurricane,Frances,43,2004-09-04T15:00:00Z,29.5N  85.0W,0,16,4,2,22
Hurricane,Frances,43,2004-09-04T15:00:00Z,APALACHICOLA FL,0,15,5,2,22
Hurricane,Frances,43,2004-09-04T15:00:00Z,MYGF 266N 787W,99,0,0,0,99
Hurricane,Frances,43,2004-09-04T15:00:00Z,PANAMA CITY FL,0,10,9,2,21
Hurricane,Frances,43,2004-09-04T15:00:00Z,MIAMI FL,10,0,0,1,11
Hurricane,Frances,43,2004-09-04T15:00:00Z,PENSACOLA FL,0,2,11,5,18
Hurricane,Frances,43,2004-09-04T15:00:00Z,W PALM BEACH FL,43,0,0,0,43
Hurricane,Frances,43,2004-09-04T15:00:00Z,MOBILE AL,0,0,9,7,16
Hurricane,Frances,43,2004-09-04T15:00:00Z,FT PIERCE FL,57,0,0,0,57
Hurricane,Frances,43,2004-09-04T15:00:00Z,GULFPORT MS,0,0,6,8,14
Hurricane,Frances,43,2004-09-04T15:00:00Z,COCOA BEACH FL,55,0,0,0,55
Hurricane,Frances,43,2004-09-04T15:00:00Z,BURAS LA,0,0,4,7,11
Hurricane,Frances,43,2004-09-04T15:00:00Z,DAYTONA BEACH FL,41,0,0,0,41
Hurricane,Frances,43,2004-09-04T15:00:00Z,NEW ORLEANS LA,0,0,3,8,11
Hurricane,Frances,43,2004-09-04T15:00:00Z,JACKSONVILLE FL,11,10,1,1,23
Hurricane,Frances,43,2004-09-04T15:00:00Z,NEW IBERIA LA,0,0,1,7,8
Hurricane,Frances,43,2004-09-04T15:00:00Z,SAVANNAH GA,0,5,5,3,13
Hurricane,Frances,43,2004-09-04T15:00:00Z,PORT ARTHUR TX,0,0,0,4,4
Hurricane,Frances,43,2004-09-04T15:00:00Z,CHARLESTON SC,0,1,3,3,7
Hurricane,Frances,43,2004-09-04T15:00:00Z,GALVESTON TX,0,0,0,2,2
Hurricane,Frances,43,2004-09-04T15:00:00Z,MYRTLE BEACH SC,0,0,1,2,3
Hurricane,Frances,43,2004-09-04T15:00:00Z,GULF 29N 85W,0,16,4,1,21
Hurricane,Frances,43,2004-09-04T15:00:00Z,MARCO ISLAND FL,10,1,0,1,12
Hurricane,Frances,43,2004-09-04T15:00:00Z,GULF 29N 87W,0,4,9,3,16
Hurricane,Frances,43,2004-09-04T15:00:00Z,FT MYERS FL,20,1,0,0,21
Hurricane,Frances,43,2004-09-04T15:00:00Z,GULF 28N 89W,0,0,4,4,8
Hurricane,Frances,43,2004-09-04T15:00:00Z,VENICE FL,22,1,1,0,24
Hurricane,Frances,43,2004-09-04T15:00:00Z,GULF 28N 91W,0,0,1,4,5
Hurricane,Frances,43,2004-09-04T15:00:00Z,TAMPA FL,31,1,1,0,33
Hurricane,Frances,43,2004-09-04T15:00:00Z,GULF 28N 93W,0,0,0,2,2
Hurricane,Frances,44,2004-09-04T21:00:00Z,27.8N  81.9W,45,0,0,0,45
Hurricane,Frances,44,2004-09-04T21:00:00Z,CEDAR KEY FL,25,9,0,0,34
Hurricane,Frances,44,2004-09-04T21:00:00Z,29.0N  84.0W,9,20,0,0,29
Hurricane,Frances,44,2004-09-04T21:00:00Z,ST MARKS FL,1,23,2,0,26
Hurricane,Frances,44,2004-09-04T21:00:00Z,30.5N  86.0W,0,11,10,1,22
Hurricane,Frances,44,2004-09-04T21:00:00Z,APALACHICOLA FL,1,21,2,1,25
Hurricane,Frances,44,2004-09-04T21:00:00Z,MYGF 266N 787W,99,0,0,0,99
Hurricane,Frances,44,2004-09-04T21:00:00Z,PANAMA CITY FL,0,17,5,1,23
Hurricane,Frances,44,2004-09-04T21:00:00Z,MIAMI FL,16,0,0,0,16
Hurricane,Frances,44,2004-09-04T21:00:00Z,PENSACOLA FL,0,4,13,2,19
Hurricane,Frances,44,2004-09-04T21:00:00Z,W PALM BEACH FL,99,0,0,0,99
Hurricane,Frances,44,2004-09-04T21:00:00Z,MOBILE AL,0,1,12,4,17
Hurricane,Frances,44,2004-09-04T21:00:00Z,FT PIERCE FL,99,0,0,0,99
Hurricane,Frances,44,2004-09-04T21:00:00Z,GULFPORT MS,0,0,9,6,15
Hurricane,Frances,44,2004-09-04T21:00:00Z,COCOA BEACH FL,62,0,0,0,62
Hurricane,Frances,44,2004-09-04T21:00:00Z,BURAS LA,0,0,6,5,11
Hurricane,Frances,44,2004-09-04T21:00:00Z,DAYTONA BEACH FL,38,0,0,0,38
Hurricane,Frances,44,2004-09-04T21:00:00Z,NEW ORLEANS LA,0,0,4,8,12
Hurricane,Frances,44,2004-09-04T21:00:00Z,JACKSONVILLE FL,14,11,1,0,26
Hurricane,Frances,44,2004-09-04T21:00:00Z,NEW IBERIA LA,0,0,1,8,9
Hurricane,Frances,44,2004-09-04T21:00:00Z,SAVANNAH GA,0,9,4,1,14
Hurricane,Frances,44,2004-09-04T21:00:00Z,PORT ARTHUR TX,0,0,0,4,4
Hurricane,Frances,44,2004-09-04T21:00:00Z,CHARLESTON SC,0,2,3,2,7
Hurricane,Frances,44,2004-09-04T21:00:00Z,GALVESTON TX,0,0,0,2,2
Hurricane,Frances,44,2004-09-04T21:00:00Z,MYRTLE BEACH SC,0,0,1,2,3
Hurricane,Frances,44,2004-09-04T21:00:00Z,GULF 29N 85W,1,22,0,1,24
Hurricane,Frances,44,2004-09-04T21:00:00Z,MARCO ISLAND FL,20,0,0,0,20
Hurricane,Frances,44,2004-09-04T21:00:00Z,GULF 29N 87W,0,8,7,1,16
Hurricane,Frances,44,2004-09-04T21:00:00Z,FT MYERS FL,30,0,0,0,30
Hurricane,Frances,44,2004-09-04T21:00:00Z,GULF 28N 89W,0,1,3,3,7
Hurricane,Frances,44,2004-09-04T21:00:00Z,VENICE FL,32,0,0,0,32
Hurricane,Frances,44,2004-09-04T21:00:00Z,GULF 28N 91W,0,0,1,3,4
Hurricane,Frances,44,2004-09-04T21:00:00Z,TAMPA FL,39,0,0,1,40
Hurricane,Frances,44,2004-09-04T21:00:00Z,GULF 28N 93W,0,0,0,2,2
Hurricane,Frances,45,2004-09-05T03:00:00Z,28.3N  82.3W,48,0,0,0,48
Hurricane,Frances,45,2004-09-05T03:00:00Z,VENICE FL,35,0,0,1,36
Hurricane,Frances,45,2004-09-05T03:00:00Z,29.5N  84.1W,12,19,1,0,32
Hurricane,Frances,45,2004-09-05T03:00:00Z,TAMPA FL,44,0,0,0,44
Hurricane,Frances,45,2004-09-05T03:00:00Z,30.7N  85.8W,0,14,7,1,22
Hurricane,Frances,45,2004-09-05T03:00:00Z,CEDAR KEY FL,37,3,0,0,40
Hurricane,Frances,45,2004-09-05T03:00:00Z,MYGF 266N 787W,99,0,0,0,99
Hurricane,Frances,45,2004-09-05T03:00:00Z,ST MARKS FL,4,25,0,1,30
Hurricane,Frances,45,2004-09-05T03:00:00Z,MIAMI FL,9,0,0,0,9
Hurricane,Frances,45,2004-09-05T03:00:00Z,APALACHICOLA FL,2,23,1,0,26
Hurricane,Frances,45,2004-09-05T03:00:00Z,W PALM BEACH FL,99,0,0,0,99
Hurricane,Frances,45,2004-09-05T03:00:00Z,PANAMA CITY FL,0,19,3,1,23
Hurricane,Frances,45,2004-09-05T03:00:00Z,FT PIERCE FL,99,0,0,0,99
Hurricane,Frances,45,2004-09-05T03:00:00Z,PENSACOLA FL,0,4,12,2,18
Hurricane,Frances,45,2004-09-05T03:00:00Z,COCOA BEACH FL,69,0,0,0,69
Hurricane,Frances,45,2004-09-05T03:00:00Z,MOBILE AL,0,1,10,4,15
Hurricane,Frances,45,2004-09-05T03:00:00Z,DAYTONA BEACH FL,47,0,0,0,47
Hurricane,Frances,45,2004-09-05T03:00:00Z,GULFPORT MS,0,0,8,5,13
Hurricane,Frances,45,2004-09-05T03:00:00Z,JACKSONVILLE FL,25,5,0,0,30
Hurricane,Frances,45,2004-09-05T03:00:00Z,BURAS LA,0,0,5,4,9
Hurricane,Frances,45,2004-09-05T03:00:00Z,SAVANNAH GA,2,11,2,1,16
Hurricane,Frances,45,2004-09-05T03:00:00Z,NEW ORLEANS LA,0,0,3,6,9
Hurricane,Frances,45,2004-09-05T03:00:00Z,CHARLESTON SC,0,3,3,3,9
Hurricane,Frances,45,2004-09-05T03:00:00Z,NEW IBERIA LA,0,0,1,5,6
Hurricane,Frances,45,2004-09-05T03:00:00Z,MYRTLE BEACH SC,0,0,1,5,6
Hurricane,Frances,45,2004-09-05T03:00:00Z,PORT ARTHUR TX,0,0,0,2,2
Hurricane,Frances,45,2004-09-05T03:00:00Z,WILMINGTON NC,0,0,0,3,3
Hurricane,Frances,45,2004-09-05T03:00:00Z,GULF 29N 85W,3,21,0,1,25
Hurricane,Frances,45,2004-09-05T03:00:00Z,MOREHEAD CITY NC,0,0,0,2,2
Hurricane,Frances,45,2004-09-05T03:00:00Z,GULF 29N 87W,0,7,7,1,15
Hurricane,Frances,45,2004-09-05T03:00:00Z,MARCO ISLAND FL,21,0,0,0,21
Hurricane,Frances,45,2004-09-05T03:00:00Z,GULF 28N 89W,0,0,3,2,5
Hurricane,Frances,45,2004-09-05T03:00:00Z,FT MYERS FL,34,0,0,0,34
Hurricane,Frances,45,2004-09-05T03:00:00Z,GULF 28N 91W,0,0,1,2,3
Hurricane,Frances,46,2004-09-05T09:00:00Z,28.8N  83.6W,46,0,0,0,46
Hurricane,Frances,46,2004-09-05T09:00:00Z,VENICE FL,46,0,0,0,46
Hurricane,Frances,46,2004-09-05T09:00:00Z,29.9N  84.8W,23,6,0,1,30
Hurricane,Frances,46,2004-09-05T09:00:00Z,TAMPA FL,65,0,0,0,65
Hurricane,Frances,46,2004-09-05T09:00:00Z,31.5N  85.9W,0,16,5,1,22
Hurricane,Frances,46,2004-09-05T09:00:00Z,CEDAR KEY FL,51,0,0,0,51
Hurricane,Frances,46,2004-09-05T09:00:00Z,W PALM BEACH FL,99,0,0,0,99
Hurricane,Frances,46,2004-09-05T09:00:00Z,ST MARKS FL,27,4,0,0,31
Hurricane,Frances,46,2004-09-05T09:00:00Z,FT PIERCE FL,99,0,0,0,99
Hurricane,Frances,46,2004-09-05T09:00:00Z,APALACHICOLA FL,22,6,1,0,29
Hurricane,Frances,46,2004-09-05T09:00:00Z,COCOA BEACH FL,99,0,0,0,99
Hurricane,Frances,46,2004-09-05T09:00:00Z,PANAMA CITY FL,9,14,1,0,24
Hurricane,Frances,46,2004-09-05T09:00:00Z,DAYTONA BEACH FL,49,0,0,0,49
Hurricane,Frances,46,2004-09-05T09:00:00Z,PENSACOLA FL,0,13,4,1,18
Hurricane,Frances,46,2004-09-05T09:00:00Z,JACKSONVILLE FL,25,0,0,1,26
Hurricane,Frances,46,2004-09-05T09:00:00Z,MOBILE AL,0,5,8,2,15
Hurricane,Frances,46,2004-09-05T09:00:00Z,SAVANNAH GA,3,7,3,2,15
Hurricane,Frances,46,2004-09-05T09:00:00Z,GULFPORT MS,0,2,7,3,12
Hurricane,Frances,46,2004-09-05T09:00:00Z,CHARLESTON SC,0,2,4,5,11
Hurricane,Frances,46,2004-09-05T09:00:00Z,BURAS LA,0,1,4,2,7
Hurricane,Frances,46,2004-09-05T09:00:00Z,MYRTLE BEACH SC,0,0,2,5,7
Hurricane,Frances,46,2004-09-05T09:00:00Z,NEW ORLEANS LA,0,0,4,3,7
Hurricane,Frances,46,2004-09-05T09:00:00Z,WILMINGTON NC,0,0,1,4,5
Hurricane,Frances,46,2004-09-05T09:00:00Z,NEW IBERIA LA,0,0,1,2,3
Hurricane,Frances,46,2004-09-05T09:00:00Z,MOREHEAD CITY NC,0,0,0,3,3
Hurricane,Frances,46,2004-09-05T09:00:00Z,GULF 29N 85W,27,2,0,0,29
Hurricane,Frances,46,2004-09-05T09:00:00Z,MARCO ISLAND FL,1,0,0,1,2
Hurricane,Frances,46,2004-09-05T09:00:00Z,GULF 29N 87W,2,11,1,1,15
Hurricane,Frances,46,2004-09-05T09:00:00Z,FT MYERS FL,32,0,0,0,32
Hurricane,Frances,46,2004-09-05T09:00:00Z,GULF 28N 89W,0,2,1,0,3
Hurricane,Frances,47,2004-09-05T15:00:00Z,29.0N  83.9W,49,0,0,0,49
Hurricane,Frances,47,2004-09-05T15:00:00Z,TAMPA FL,64,0,0,0,64
Hurricane,Frances,47,2004-09-05T15:00:00Z,30.3N  85.2W,22,10,0,1,33
Hurricane,Frances,47,2004-09-05T15:00:00Z,CEDAR KEY FL,61,0,0,0,61
Hurricane,Frances,47,2004-09-05T15:00:00Z,32.0N  86.0W,0,19,4,1,24
Hurricane,Frances,47,2004-09-05T15:00:00Z,ST MARKS FL,37,2,0,0,39
Hurricane,Frances,47,2004-09-05T15:00:00Z,W PALM BEACH FL,99,0,0,0,99
Hurricane,Frances,47,2004-09-05T15:00:00Z,APALACHICOLA FL,33,3,0,0,36
Hurricane,Frances,47,2004-09-05T15:00:00Z,FT PIERCE FL,99,0,0,0,99
Hurricane,Frances,47,2004-09-05T15:00:00Z,PANAMA CITY FL,19,11,0,1,31
Hurricane,Frances,47,2004-09-05T15:00:00Z,COCOA BEACH FL,99,0,0,0,99
Hurricane,Frances,47,2004-09-05T15:00:00Z,PENSACOLA FL,1,17,2,1,21
Hurricane,Frances,47,2004-09-05T15:00:00Z,DAYTONA BEACH FL,53,0,0,0,53
Hurricane,Frances,47,2004-09-05T15:00:00Z,MOBILE AL,0,9,6,1,16
Hurricane,Frances,47,2004-09-05T15:00:00Z,JACKSONVILLE FL,25,0,0,1,26
Hurricane,Frances,47,2004-09-05T15:00:00Z,GULFPORT MS,0,4,6,2,12
Hurricane,Frances,47,2004-09-05T15:00:00Z,SAVANNAH GA,1,6,4,3,14
Hurricane,Frances,47,2004-09-05T15:00:00Z,BURAS LA,0,2,3,1,6
Hurricane,Frances,47,2004-09-05T15:00:00Z,CHARLESTON SC,0,1,3,6,10
Hurricane,Frances,47,2004-09-05T15:00:00Z,NEW ORLEANS LA,0,1,3,1,5
Hurricane,Frances,47,2004-09-05T15:00:00Z,MYRTLE BEACH SC,0,0,1,6,7
Hurricane,Frances,47,2004-09-05T15:00:00Z,NEW IBERIA LA,0,0,1,1,2
Hurricane,Frances,47,2004-09-05T15:00:00Z,WILMINGTON NC,0,0,0,5,5
Hurricane,Frances,47,2004-09-05T15:00:00Z,GULF 29N 85W,35,0,0,0,35
Hurricane,Frances,47,2004-09-05T15:00:00Z,MOREHEAD CITY NC,0,0,0,3,3
Hurricane,Frances,47,2004-09-05T15:00:00Z,GULF 29N 87W,3,13,1,0,17
Hurricane,Frances,47,2004-09-05T15:00:00Z,FT MYERS FL,4,0,0,0,4
Hurricane,Frances,47,2004-09-05T15:00:00Z,GULF 28N 89W,0,1,1,1,3
Hurricane,Frances,47,2004-09-05T15:00:00Z,VENICE FL,32,0,1,0,33
Tropical Storm,Frances,48,2004-09-05T21:00:00Z,29.7N  85.0W,50,0,0,0,50
Tropical Storm,Frances,48,2004-09-05T21:00:00Z,TAMPA FL,99,0,0,0,99
Tropical Storm,Frances,48,2004-09-05T21:00:00Z,31.5N  86.0W,17,17,1,0,35
Tropical Storm,Frances,48,2004-09-05T21:00:00Z,CEDAR KEY FL,77,0,0,0,77
Tropical Storm,Frances,48,2004-09-05T21:00:00Z,32.5N  86.0W,3,24,1,0,28
Tropical Storm,Frances,48,2004-09-05T21:00:00Z,ST MARKS FL,50,0,0,0,50
Tropical Storm,Frances,48,2004-09-05T21:00:00Z,COCOA BEACH FL,63,0,0,0,63
Tropical Storm,Frances,48,2004-09-05T21:00:00Z,APALACHICOLA FL,50,0,0,0,50
Tropical Storm,Frances,48,2004-09-05T21:00:00Z,DAYTONA BEACH FL,37,0,0,0,37
Tropical Storm,Frances,48,2004-09-05T21:00:00Z,PANAMA CITY FL,43,0,0,0,43
Tropical Storm,Frances,48,2004-09-05T21:00:00Z,JACKSONVILLE FL,13,1,0,1,15
Tropical Storm,Frances,48,2004-09-05T21:00:00Z,PENSACOLA FL,11,16,0,0,27
Tropical Storm,Frances,48,2004-09-05T21:00:00Z,SAVANNAH GA,0,3,4,5,12
Tropical Storm,Frances,48,2004-09-05T21:00:00Z,MOBILE AL,1,15,1,1,18
Tropical Storm,Frances,48,2004-09-05T21:00:00Z,CHARLESTON SC,0,0,3,7,10
Tropical Storm,Frances,48,2004-09-05T21:00:00Z,GULFPORT MS,0,8,2,1,11
Tropical Storm,Frances,48,2004-09-05T21:00:00Z,MYRTLE BEACH SC,0,0,1,7,8
Tropical Storm,Frances,48,2004-09-05T21:00:00Z,BURAS LA,0,3,1,1,5
Tropical Storm,Frances,48,2004-09-05T21:00:00Z,WILMINGTON NC,0,0,0,6,6
Tropical Storm,Frances,48,2004-09-05T21:00:00Z,NEW ORLEANS LA,0,2,2,1,5
Tropical Storm,Frances,48,2004-09-05T21:00:00Z,MOREHEAD CITY NC,0,0,0,4,4
Tropical Storm,Frances,48,2004-09-05T21:00:00Z,GULF 29N 85W,48,0,0,0,48
Tropical Storm,Frances,48,2004-09-05T21:00:00Z,CAPE HATTERAS NC,0,0,0,2,2
Tropical Storm,Frances,48,2004-09-05T21:00:00Z,GULF 29N 87W,16,5,0,0,21
Tropical Storm,Frances,48,2004-09-05T21:00:00Z,NORFOLK VA,0,0,0,2,2
Tropical Storm,Frances,48,2004-09-05T21:00:00Z,GULF 28N 89W,0,1,0,1,2
Tropical Storm,Frances,48,2004-09-05T21:00:00Z,VENICE FL,99,0,0,0,99
Tropical Storm,Frances,49,2004-09-06T03:00:00Z,30.0N  85.0W,44,0,0,0,44
Tropical Storm,Frances,49,2004-09-06T03:00:00Z,TAMPA FL,99,0,0,0,99
Tropical Storm,Frances,49,2004-09-06T03:00:00Z,31.6N  85.6W,21,6,1,0,28
Tropical Storm,Frances,49,2004-09-06T03:00:00Z,CEDAR KEY FL,99,0,0,0,99
Tropical Storm,Frances,49,2004-09-06T03:00:00Z,33.0N  85.7W,2,17,2,2,23
Tropical Storm,Frances,49,2004-09-06T03:00:00Z,ST MARKS FL,48,0,0,0,48
Tropical Storm,Frances,49,2004-09-06T03:00:00Z,COCOA BEACH FL,2,0,0,0,2
Tropical Storm,Frances,49,2004-09-06T03:00:00Z,APALACHICOLA FL,45,0,0,0,45
Tropical Storm,Frances,49,2004-09-06T03:00:00Z,DAYTONA BEACH FL,28,0,0,1,29
Tropical Storm,Frances,49,2004-09-06T03:00:00Z,PANAMA CITY FL,37,0,0,0,37
Tropical Storm,Frances,49,2004-09-06T03:00:00Z,JACKSONVILLE FL,15,1,0,0,16
Tropical Storm,Frances,49,2004-09-06T03:00:00Z,PENSACOLA FL,15,6,0,1,22
Tropical Storm,Frances,49,2004-09-06T03:00:00Z,SAVANNAH GA,2,5,2,2,11
Tropical Storm,Frances,49,2004-09-06T03:00:00Z,MOBILE AL,3,11,1,1,16
Tropical Storm,Frances,49,2004-09-06T03:00:00Z,CHARLESTON SC,0,2,2,4,8
Tropical Storm,Frances,49,2004-09-06T03:00:00Z,GULFPORT MS,1,7,2,1,11
Tropical Storm,Frances,49,2004-09-06T03:00:00Z,MYRTLE BEACH SC,0,0,2,4,6
Tropical Storm,Frances,49,2004-09-06T03:00:00Z,BURAS LA,0,4,1,0,5
Tropical Storm,Frances,49,2004-09-06T03:00:00Z,WILMINGTON NC,0,0,1,4,5
Tropical Storm,Frances,49,2004-09-06T03:00:00Z,NEW ORLEANS LA,0,3,1,1,5
Tropical Storm,Frances,49,2004-09-06T03:00:00Z,MOREHEAD CITY NC,0,0,0,3,3
Tropical Storm,Frances,49,2004-09-06T03:00:00Z,GULF 29N 85W,43,0,0,0,43
Tropical Storm,Frances,49,2004-09-06T03:00:00Z,CAPE HATTERAS NC,0,0,0,2,2
Tropical Storm,Frances,49,2004-09-06T03:00:00Z,GULF 29N 87W,15,1,0,1,17
Tropical Storm,Frances,49,2004-09-06T03:00:00Z,NORFOLK VA,0,0,0,3,3
Tropical Storm,Frances,49,2004-09-06T03:00:00Z,GULF 28N 89W,0,1,0,1,2
Tropical Storm,Frances,49,2004-09-06T03:00:00Z,VENICE FL,99,0,0,0,99
Tropical Storm,Frances,50,2004-09-06T09:00:00Z,31.2N  85.5W,51,0,0,0,51
Tropical Storm,Frances,50,2004-09-06T09:00:00Z,OCEAN CITY MD,0,0,0,3,3
Tropical Storm,Frances,50,2004-09-06T09:00:00Z,32.4N  85.8W,32,1,0,0,33
Tropical Storm,Frances,50,2004-09-06T09:00:00Z,ATLANTIC CITY NJ,0,0,0,2,2
Tropical Storm,Frances,50,2004-09-06T09:00:00Z,33.9N  85.6W,10,11,3,1,25
Tropical Storm,Frances,50,2004-09-06T09:00:00Z,VENICE FL,0,1,0,1,2
Tropical Storm,Frances,50,2004-09-06T09:00:00Z,COCOA BEACH FL,0,1,0,1,2
Tropical Storm,Frances,50,2004-09-06T09:00:00Z,TAMPA FL,99,0,0,0,99
Tropical Storm,Frances,50,2004-09-06T09:00:00Z,DAYTONA BEACH FL,1,2,2,1,6
Tropical Storm,Frances,50,2004-09-06T09:00:00Z,CEDAR KEY FL,99,0,0,0,99
Tropical Storm,Frances,50,2004-09-06T09:00:00Z,JACKSONVILLE FL,4,4,2,2,12
Tropical Storm,Frances,50,2004-09-06T09:00:00Z,ST MARKS FL,83,0,0,0,83
Tropical Storm,Frances,50,2004-09-06T09:00:00Z,SAVANNAH GA,0,3,5,4,12
Tropical Storm,Frances,50,2004-09-06T09:00:00Z,APALACHICOLA FL,84,0,0,0,84
Tropical Storm,Frances,50,2004-09-06T09:00:00Z,CHARLESTON SC,0,0,3,6,9
Tropical Storm,Frances,50,2004-09-06T09:00:00Z,PANAMA CITY FL,62,0,0,0,62
Tropical Storm,Frances,50,2004-09-06T09:00:00Z,MYRTLE BEACH SC,0,0,1,6,7
Tropical Storm,Frances,50,2004-09-06T09:00:00Z,PENSACOLA FL,22,1,1,0,24
Tropical Storm,Frances,50,2004-09-06T09:00:00Z,WILMINGTON NC,0,0,0,6,6
Tropical Storm,Frances,50,2004-09-06T09:00:00Z,MOBILE AL,9,3,1,0,13
Tropical Storm,Frances,50,2004-09-06T09:00:00Z,MOREHEAD CITY NC,0,0,0,4,4
Tropical Storm,Frances,50,2004-09-06T09:00:00Z,GULFPORT MS,2,2,1,1,6
Tropical Storm,Frances,50,2004-09-06T09:00:00Z,CAPE HATTERAS NC,0,0,0,3,3
Tropical Storm,Frances,50,2004-09-06T09:00:00Z,GULF 29N 85W,74,0,0,0,74
Tropical Storm,Frances,50,2004-09-06T09:00:00Z,NORFOLK VA,0,0,0,4,4
Tropical Storm,Frances,50,2004-09-06T09:00:00Z,GULF 29N 87W,10,1,0,1,12
Tropical Storm,Frances,51,2004-09-06T15:00:00Z,32.0N  85.5W,51,0,0,0,51
Tropical Storm,Frances,51,2004-09-06T15:00:00Z,ATLANTIC CITY NJ,0,0,0,5,5
Tropical Storm,Frances,51,2004-09-06T15:00:00Z,33.5N  85.5W,32,2,0,0,34
Tropical Storm,Frances,51,2004-09-06T15:00:00Z,NEW YORK CITY NY,0,0,0,3,3
Tropical Storm,Frances,51,2004-09-06T15:00:00Z,35.0N  85.0W,8,15,2,1,26
Tropical Storm,Frances,51,2004-09-06T15:00:00Z,MONTAUK POINT NY,0,0,0,2,2
Tropical Storm,Frances,51,2004-09-06T15:00:00Z,DAYTONA BEACH FL,0,1,0,1,2
Tropical Storm,Frances,51,2004-09-06T15:00:00Z,TAMPA FL,0,1,0,1,2
Tropical Storm,Frances,51,2004-09-06T15:00:00Z,JACKSONVILLE FL,2,3,2,1,8
Tropical Storm,Frances,51,2004-09-06T15:00:00Z,CEDAR KEY FL,99,0,0,0,99
Tropical Storm,Frances,51,2004-09-06T15:00:00Z,SAVANNAH GA,0,3,4,3,10
Tropical Storm,Frances,51,2004-09-06T15:00:00Z,ST MARKS FL,99,0,0,0,99
Tropical Storm,Frances,51,2004-09-06T15:00:00Z,CHARLESTON SC,0,0,3,5,8
Tropical Storm,Frances,51,2004-09-06T15:00:00Z,APALACHICOLA FL,99,0,0,0,99
Tropical Storm,Frances,51,2004-09-06T15:00:00Z,MYRTLE BEACH SC,0,0,1,6,7
Tropical Storm,Frances,51,2004-09-06T15:00:00Z,PANAMA CITY FL,56,0,0,0,56
Tropical Storm,Frances,51,2004-09-06T15:00:00Z,WILMINGTON NC,0,0,0,6,6
Tropical Storm,Frances,51,2004-09-06T15:00:00Z,PENSACOLA FL,16,1,0,1,18
Tropical Storm,Frances,51,2004-09-06T15:00:00Z,MOREHEAD CITY NC,0,0,0,5,5
Tropical Storm,Frances,51,2004-09-06T15:00:00Z,MOBILE AL,3,3,0,1,7
Tropical Storm,Frances,51,2004-09-06T15:00:00Z,CAPE HATTERAS NC,0,0,0,4,4
Tropical Storm,Frances,51,2004-09-06T15:00:00Z,GULFPORT MS,0,1,0,1,2
Tropical Storm,Frances,51,2004-09-06T15:00:00Z,NORFOLK VA,0,0,0,6,6
Tropical Storm,Frances,51,2004-09-06T15:00:00Z,GULF 29N 85W,99,0,0,0,99
Tropical Storm,Frances,51,2004-09-06T15:00:00Z,OCEAN CITY MD,0,0,0,5,5
Tropical Storm,Frances,51,2004-09-06T15:00:00Z,GULF 29N 87W,3,1,0,1,5
Tropical Storm,Frances,52,2004-09-06T21:00:00Z,33.0N  85.5W,40,0,0,0,40
Tropical Storm,Frances,52,2004-09-06T21:00:00Z,ATLANTIC CITY NJ,0,0,0,6,6
Tropical Storm,Frances,52,2004-09-06T21:00:00Z,34.5N  85.0W,19,3,1,0,23
Tropical Storm,Frances,52,2004-09-06T21:00:00Z,NEW YORK CITY NY,0,0,0,5,5
Tropical Storm,Frances,52,2004-09-06T21:00:00Z,36.0N  84.0W,2,10,4,2,18
Tropical Storm,Frances,52,2004-09-06T21:00:00Z,MONTAUK POINT NY,0,0,0,3,3
Tropical Storm,Frances,52,2004-09-06T21:00:00Z,DAYTONA BEACH FL,0,1,0,1,2
Tropical Storm,Frances,52,2004-09-06T21:00:00Z,PROVIDENCE RI,0,0,0,2,2
Tropical Storm,Frances,52,2004-09-06T21:00:00Z,JACKSONVILLE FL,3,3,0,1,7
Tropical Storm,Frances,52,2004-09-06T21:00:00Z,BOSTON MA,0,0,0,2,2
Tropical Storm,Frances,52,2004-09-06T21:00:00Z,SAVANNAH GA,3,5,1,1,10
Tropical Storm,Frances,52,2004-09-06T21:00:00Z,CEDAR KEY FL,2,1,0,0,3
Tropical Storm,Frances,52,2004-09-06T21:00:00Z,CHARLESTON SC,0,3,4,2,9
Tropical Storm,Frances,52,2004-09-06T21:00:00Z,ST MARKS FL,99,0,0,0,99
Tropical Storm,Frances,52,2004-09-06T21:00:00Z,MYRTLE BEACH SC,0,1,4,3,8
Tropical Storm,Frances,52,2004-09-06T21:00:00Z,APALACHICOLA FL,99,0,0,0,99
Tropical Storm,Frances,52,2004-09-06T21:00:00Z,WILMINGTON NC,0,0,3,4,7
Tropical Storm,Frances,52,2004-09-06T21:00:00Z,PANAMA CITY FL,24,0,1,0,25
Tropical Storm,Frances,52,2004-09-06T21:00:00Z,MOREHEAD CITY NC,0,0,1,5,6
Tropical Storm,Frances,52,2004-09-06T21:00:00Z,PENSACOLA FL,6,1,0,0,7
Tropical Storm,Frances,52,2004-09-06T21:00:00Z,CAPE HATTERAS NC,0,0,0,5,5
Tropical Storm,Frances,52,2004-09-06T21:00:00Z,MOBILE AL,1,1,0,0,2
Tropical Storm,Frances,52,2004-09-06T21:00:00Z,NORFOLK VA,0,0,0,7,7
Tropical Storm,Frances,52,2004-09-06T21:00:00Z,GULF 29N 85W,1,1,0,0,2
Tropical Storm,Frances,52,2004-09-06T21:00:00Z,OCEAN CITY MD,0,0,0,7,7
Tropical Depression,Frances,53,2004-09-07T03:00:00Z,33.7N  85.3W,41,0,0,0,41
Tropical Depression,Frances,53,2004-09-07T03:00:00Z,ATLANTIC CITY NJ,0,0,0,6,6
Tropical Depression,Frances,53,2004-09-07T03:00:00Z,35.0N  85.0W,21,2,1,0,24
Tropical Depression,Frances,53,2004-09-07T03:00:00Z,NEW YORK CITY NY,0,0,0,5,5
Tropical Depression,Frances,53,2004-09-07T03:00:00Z,37.0N  84.0W,1,8,5,2,16
Tropical Depression,Frances,53,2004-09-07T03:00:00Z,MONTAUK POINT NY,0,0,0,3,3
Tropical Depression,Frances,53,2004-09-07T03:00:00Z,JACKSONVILLE FL,1,1,1,0,3
Tropical Depression,Frances,53,2004-09-07T03:00:00Z,PROVIDENCE RI,0,0,0,2,2
Tropical Depression,Frances,53,2004-09-07T03:00:00Z,SAVANNAH GA,2,3,2,0,7
Tropical Depression,Frances,53,2004-09-07T03:00:00Z,NANTUCKET MA,0,0,0,2,2
Tropical Depression,Frances,53,2004-09-07T03:00:00Z,CHARLESTON SC,0,3,3,1,7
Tropical Depression,Frances,53,2004-09-07T03:00:00Z,HYANNIS MA,0,0,0,2,2
Tropical Depression,Frances,53,2004-09-07T03:00:00Z,MYRTLE BEACH SC,0,1,3,2,6
Tropical Depression,Frances,53,2004-09-07T03:00:00Z,BOSTON MA,0,0,0,2,2
Tropical Depression,Frances,53,2004-09-07T03:00:00Z,WILMINGTON NC,0,0,3,3,6
Tropical Depression,Frances,53,2004-09-07T03:00:00Z,ST MARKS FL,99,0,0,0,99
Tropical Depression,Frances,53,2004-09-07T03:00:00Z,MOREHEAD CITY NC,0,0,1,4,5
Tropical Depression,Frances,53,2004-09-07T03:00:00Z,APALACHICOLA FL,1,1,0,0,2
Tropical Depression,Frances,53,2004-09-07T03:00:00Z,CAPE HATTERAS NC,0,0,1,4,5
Tropical Depression,Frances,53,2004-09-07T03:00:00Z,PANAMA CITY FL,3,0,1,0,4
Tropical Depression,Frances,53,2004-09-07T03:00:00Z,NORFOLK VA,0,0,1,6,7
Tropical Depression,Frances,53,2004-09-07T03:00:00Z,PENSACOLA FL,1,1,1,0,3
Tropical Depression,Frances,53,2004-09-07T03:00:00Z,OCEAN CITY MD,0,0,0,7,7
Tropical Depression,Frances,53,2004-09-07T03:00:00Z,MOBILE AL,0,1,1,0,2
Tropical Depression,Seven,1,2004-08-27T21:00:00Z,32.0N  79.5W,64,0,0,0,64
Tropical Depression,Seven,1,2004-08-27T21:00:00Z,OCEAN CITY MD,0,0,3,7,10
Tropical Depression,Seven,1,2004-08-27T21:00:00Z,32.8N  80.0W,37,0,0,1,38
Tropical Depression,Seven,1,2004-08-27T21:00:00Z,ATLANTIC CITY NJ,0,0,1,6,7
Tropical Depression,Seven,1,2004-08-27T21:00:00Z,33.7N  79.4W,25,1,1,1,28
Tropical Depression,Seven,1,2004-08-27T21:00:00Z,NEW YORK CITY NY,0,0,0,5,5
Tropical Depression,Seven,1,2004-08-27T21:00:00Z,COCOA BEACH FL,0,1,0,2,3
Tropical Depression,Seven,1,2004-08-27T21:00:00Z,MONTAUK POINT NY,0,0,0,3,3
Tropical Depression,Seven,1,2004-08-27T21:00:00Z,DAYTONA BEACH FL,2,2,1,2,7
Tropical Depression,Seven,1,2004-08-27T21:00:00Z,PROVIDENCE RI,0,0,0,2,2
Tropical Depression,Seven,1,2004-08-27T21:00:00Z,JACKSONVILLE FL,8,3,2,1,14
Tropical Depression,Seven,1,2004-08-27T21:00:00Z,TAMPA FL,0,0,1,1,2
Tropical Depression,Seven,1,2004-08-27T21:00:00Z,SAVANNAH GA,22,2,0,1,25
Tropical Depression,Seven,1,2004-08-27T21:00:00Z,CEDAR KEY FL,0,1,2,2,5
Tropical Depression,Seven,1,2004-08-27T21:00:00Z,CHARLESTON SC,36,0,0,0,36
Tropical Depression,Seven,1,2004-08-27T21:00:00Z,ST MARKS FL,0,2,2,3,7
Tropical Depression,Seven,1,2004-08-27T21:00:00Z,MYRTLE BEACH SC,24,2,1,0,27
Tropical Depression,Seven,1,2004-08-27T21:00:00Z,APALACHICOLA FL,0,0,2,2,4
Tropical Depression,Seven,1,2004-08-27T21:00:00Z,WILMINGTON NC,12,5,2,2,21
Tropical Depression,Seven,1,2004-08-27T21:00:00Z,PANAMA CITY FL,0,0,1,3,4
Tropical Depression,Seven,1,2004-08-27T21:00:00Z,MOREHEAD CITY NC,2,7,4,4,17
Tropical Depression,Seven,1,2004-08-27T21:00:00Z,PENSACOLA FL,0,0,0,2,2
Tropical Depression,Seven,1,2004-08-27T21:00:00Z,CAPE HATTERAS NC,0,3,5,6,14
Tropical Depression,Seven,1,2004-08-27T21:00:00Z,GULF 29N 85W,0,0,1,2,3
Tropical Depression,Seven,1,2004-08-27T21:00:00Z,NORFOLK VA,0,2,6,6,14
Tropical Depression,Seven,2,2004-08-28T03:00:00Z,31.6N  78.9W,99,0,0,0,99
Tropical Depression,Seven,2,2004-08-28T03:00:00Z,NORFOLK VA,0,2,5,6,13
Tropical Depression,Seven,2,2004-08-28T03:00:00Z,32.7N  79.3W,83,0,0,0,83
Tropical Depression,Seven,2,2004-08-28T03:00:00Z,OCEAN CITY MD,0,0,2,7,9
Tropical Depression,Seven,2,2004-08-28T03:00:00Z,33.8N  78.9W,18,5,1,1,25
Tropical Depression,Seven,2,2004-08-28T03:00:00Z,ATLANTIC CITY NJ,0,0,1,6,7
Tropical Depression,Seven,2,2004-08-28T03:00:00Z,W PALM BEACH FL,0,0,0,2,2
Tropical Depression,Seven,2,2004-08-28T03:00:00Z,NEW YORK CITY NY,0,0,0,5,5
Tropical Depression,Seven,2,2004-08-28T03:00:00Z,FT PIERCE FL,0,1,1,2,4
Tropical Depression,Seven,2,2004-08-28T03:00:00Z,MONTAUK POINT NY,0,0,0,2,2
Tropical Depression,Seven,2,2004-08-28T03:00:00Z,COCOA BEACH FL,1,1,2,2,6
Tropical Depression,Seven,2,2004-08-28T03:00:00Z,PROVIDENCE RI,0,0,0,2,2
Tropical Depression,Seven,2,2004-08-28T03:00:00Z,DAYTONA BEACH FL,3,4,1,2,10
Tropical Depression,Seven,2,2004-08-28T03:00:00Z,FT MYERS FL,0,0,0,2,2
Tropical Depression,Seven,2,2004-08-28T03:00:00Z,JACKSONVILLE FL,6,5,2,1,14
Tropical Depression,Seven,2,2004-08-28T03:00:00Z,VENICE FL,0,0,1,1,2
Tropical Depression,Seven,2,2004-08-28T03:00:00Z,SAVANNAH GA,13,5,1,1,20
Tropical Depression,Seven,2,2004-08-28T03:00:00Z,TAMPA FL,0,1,1,2,4
Tropical Depression,Seven,2,2004-08-28T03:00:00Z,CHARLESTON SC,23,2,1,0,26
Tropical Depression,Seven,2,2004-08-28T03:00:00Z,CEDAR KEY FL,0,1,2,2,5
Tropical Depression,Seven,2,2004-08-28T03:00:00Z,MYRTLE BEACH SC,19,5,1,0,25
Tropical Depression,Seven,2,2004-08-28T03:00:00Z,ST MARKS FL,0,0,2,2,4
Tropical Depression,Seven,2,2004-08-28T03:00:00Z,WILMINGTON NC,10,8,2,1,21
Tropical Depression,Seven,2,2004-08-28T03:00:00Z,APALACHICOLA FL,0,0,0,2,2
Tropical Depression,Seven,2,2004-08-28T03:00:00Z,MOREHEAD CITY NC,3,7,3,3,16
Tropical Depression,Seven,2,2004-08-28T03:00:00Z,PANAMA CITY FL,0,0,0,2,2
Tropical Depression,Seven,2,2004-08-28T03:00:00Z,CAPE HATTERAS NC,0,3,4,5,12
Tropical Depression,Seven,2,2004-08-28T03:00:00Z,GULF 29N 85W,0,0,0,2,2
Tropical Depression,Seven,3,2004-08-28T09:00:00Z,31.5N  79.5W,99,0,0,0,99
Tropical Depression,Seven,3,2004-08-28T09:00:00Z,OCEAN CITY MD,0,0,1,7,8
Tropical Depression,Seven,3,2004-08-28T09:00:00Z,32.2N  79.9W,50,0,0,0,50
Tropical Depression,Seven,3,2004-08-28T09:00:00Z,ATLANTIC CITY NJ,0,0,0,5,5
Tropical Depression,Seven,3,2004-08-28T09:00:00Z,33.0N  80.0W,28,1,0,1,30
Tropical Depression,Seven,3,2004-08-28T09:00:00Z,NEW YORK CITY NY,0,0,0,3,3
Tropical Depression,Seven,3,2004-08-28T09:00:00Z,FT PIERCE FL,0,0,0,2,2
Tropical Depression,Seven,3,2004-08-28T09:00:00Z,MONTAUK POINT NY,0,0,0,2,2
Tropical Depression,Seven,3,2004-08-28T09:00:00Z,COCOA BEACH FL,0,1,1,2,4
Tropical Depression,Seven,3,2004-08-28T09:00:00Z,TAMPA FL,0,0,1,2,3
Tropical Depression,Seven,3,2004-08-28T09:00:00Z,DAYTONA BEACH FL,4,2,1,2,9
Tropical Depression,Seven,3,2004-08-28T09:00:00Z,CEDAR KEY FL,0,2,2,3,7
Tropical Depression,Seven,3,2004-08-28T09:00:00Z,JACKSONVILLE FL,11,4,1,1,17
Tropical Depression,Seven,3,2004-08-28T09:00:00Z,ST MARKS FL,0,2,3,3,8
Tropical Depression,Seven,3,2004-08-28T09:00:00Z,SAVANNAH GA,22,2,1,0,25
Tropical Depression,Seven,3,2004-08-28T09:00:00Z,APALACHICOLA FL,0,1,1,3,5
Tropical Depression,Seven,3,2004-08-28T09:00:00Z,CHARLESTON SC,30,1,0,1,32
Tropical Depression,Seven,3,2004-08-28T09:00:00Z,PANAMA CITY FL,0,0,2,3,5
Tropical Depression,Seven,3,2004-08-28T09:00:00Z,MYRTLE BEACH SC,17,3,2,1,23
Tropical Depression,Seven,3,2004-08-28T09:00:00Z,PENSACOLA FL,0,0,1,2,3
Tropical Depression,Seven,3,2004-08-28T09:00:00Z,WILMINGTON NC,7,7,3,3,20
Tropical Depression,Seven,3,2004-08-28T09:00:00Z,MOBILE AL,0,0,0,2,2
Tropical Depression,Seven,3,2004-08-28T09:00:00Z,MOREHEAD CITY NC,1,7,4,4,16
Tropical Depression,Seven,3,2004-08-28T09:00:00Z,GULF 29N 85W,0,0,1,3,4
Tropical Depression,Seven,3,2004-08-28T09:00:00Z,CAPE HATTERAS NC,0,3,4,6,13
Tropical Depression,Seven,3,2004-08-28T09:00:00Z,GULF 29N 87W,0,0,0,2,2
Tropical Depression,Seven,3,2004-08-28T09:00:00Z,NORFOLK VA,0,1,4,7,12
Tropical Storm,Gaston,4,2004-08-28T15:00:00Z,32.1N  79.5W,76,0,0,0,76
Tropical Storm,Gaston,4,2004-08-28T15:00:00Z,ATLANTIC CITY NJ,0,0,1,6,7
Tropical Storm,Gaston,4,2004-08-28T15:00:00Z,32.8N  79.8W,43,0,0,0,43
Tropical Storm,Gaston,4,2004-08-28T15:00:00Z,NEW YORK CITY NY,0,0,0,5,5
Tropical Storm,Gaston,4,2004-08-28T15:00:00Z,33.9N  79.2W,20,2,2,1,25
Tropical Storm,Gaston,4,2004-08-28T15:00:00Z,MONTAUK POINT NY,0,0,0,3,3
Tropical Storm,Gaston,4,2004-08-28T15:00:00Z,DAYTONA BEACH FL,0,2,0,2,4
Tropical Storm,Gaston,4,2004-08-28T15:00:00Z,PROVIDENCE RI,0,0,0,2,2
Tropical Storm,Gaston,4,2004-08-28T15:00:00Z,JACKSONVILLE FL,6,4,1,1,12
Tropical Storm,Gaston,4,2004-08-28T15:00:00Z,NANTUCKET MA,0,0,0,2,2
Tropical Storm,Gaston,4,2004-08-28T15:00:00Z,SAVANNAH GA,26,1,0,0,27
Tropical Storm,Gaston,4,2004-08-28T15:00:00Z,HYANNIS MA,0,0,0,2,2
Tropical Storm,Gaston,4,2004-08-28T15:00:00Z,CHARLESTON SC,38,1,0,0,39
Tropical Storm,Gaston,4,2004-08-28T15:00:00Z,CEDAR KEY FL,0,1,0,2,3
Tropical Storm,Gaston,4,2004-08-28T15:00:00Z,MYRTLE BEACH SC,22,2,1,1,26
Tropical Storm,Gaston,4,2004-08-28T15:00:00Z,ST MARKS FL,0,2,1,2,5
Tropical Storm,Gaston,4,2004-08-28T15:00:00Z,WILMINGTON NC,9,7,2,2,20
Tropical Storm,Gaston,4,2004-08-28T15:00:00Z,APALACHICOLA FL,0,0,1,2,3
Tropical Storm,Gaston,4,2004-08-28T15:00:00Z,MOREHEAD CITY NC,2,8,3,4,17
Tropical Storm,Gaston,4,2004-08-28T15:00:00Z,PANAMA CITY FL,0,0,1,2,3
Tropical Storm,Gaston,4,2004-08-28T15:00:00Z,CAPE HATTERAS NC,0,4,5,5,14
Tropical Storm,Gaston,4,2004-08-28T15:00:00Z,PENSACOLA FL,0,0,1,1,2
Tropical Storm,Gaston,4,2004-08-28T15:00:00Z,NORFOLK VA,0,1,6,7,14
Tropical Storm,Gaston,4,2004-08-28T15:00:00Z,GULF 29N 85W,0,0,1,1,2
Tropical Storm,Gaston,4,2004-08-28T15:00:00Z,OCEAN CITY MD,0,0,2,8,10
Tropical Storm,Gaston,5,2004-08-28T21:00:00Z,32.7N  79.7W,59,0,0,0,59
Tropical Storm,Gaston,5,2004-08-28T21:00:00Z,NORFOLK VA,0,1,7,6,14
Tropical Storm,Gaston,5,2004-08-28T21:00:00Z,33.7N  79.6W,30,1,0,0,31
Tropical Storm,Gaston,5,2004-08-28T21:00:00Z,OCEAN CITY MD,0,0,2,9,11
Tropical Storm,Gaston,5,2004-08-28T21:00:00Z,34.9N  78.4W,10,6,3,1,20
Tropical Storm,Gaston,5,2004-08-28T21:00:00Z,ATLANTIC CITY NJ,0,0,0,9,9
Tropical Storm,Gaston,5,2004-08-28T21:00:00Z,JACKSONVILLE FL,6,1,0,0,7
Tropical Storm,Gaston,5,2004-08-28T21:00:00Z,NEW YORK CITY NY,0,0,0,6,6
Tropical Storm,Gaston,5,2004-08-28T21:00:00Z,SAVANNAH GA,27,1,0,0,28
Tropical Storm,Gaston,5,2004-08-28T21:00:00Z,MONTAUK POINT NY,0,0,0,5,5
Tropical Storm,Gaston,5,2004-08-28T21:00:00Z,CHARLESTON SC,47,0,0,0,47
Tropical Storm,Gaston,5,2004-08-28T21:00:00Z,PROVIDENCE RI,0,0,0,3,3
Tropical Storm,Gaston,5,2004-08-28T21:00:00Z,MYRTLE BEACH SC,28,1,0,0,29
Tropical Storm,Gaston,5,2004-08-28T21:00:00Z,NANTUCKET MA,0,0,0,3,3
Tropical Storm,Gaston,5,2004-08-28T21:00:00Z,WILMINGTON NC,14,4,2,1,21
Tropical Storm,Gaston,5,2004-08-28T21:00:00Z,HYANNIS MA,0,0,0,3,3
Tropical Storm,Gaston,5,2004-08-28T21:00:00Z,MOREHEAD CITY NC,3,8,4,2,17
Tropical Storm,Gaston,5,2004-08-28T21:00:00Z,BOSTON MA,0,0,0,2,2
Tropical Storm,Gaston,5,2004-08-28T21:00:00Z,CAPE HATTERAS NC,0,5,6,4,15
Tropical Storm,Gaston,6,2004-08-29T03:00:00Z,33.6N  79.7W,41,0,0,0,41
Tropical Storm,Gaston,6,2004-08-29T03:00:00Z,ATLANTIC CITY NJ,0,0,2,11,13
Tropical Storm,Gaston,6,2004-08-29T03:00:00Z,35.1N  79.0W,11,10,1,0,22
Tropical Storm,Gaston,6,2004-08-29T03:00:00Z,NEW YORK CITY NY,0,0,0,12,12
Tropical Storm,Gaston,6,2004-08-29T03:00:00Z,36.7N  77.0W,0,5,10,2,17
Tropical Storm,Gaston,6,2004-08-29T03:00:00Z,MONTAUK POINT NY,0,0,0,10,10
Tropical Storm,Gaston,6,2004-08-29T03:00:00Z,SAVANNAH GA,26,0,0,0,26
Tropical Storm,Gaston,6,2004-08-29T03:00:00Z,PROVIDENCE RI,0,0,0,9,9
Tropical Storm,Gaston,6,2004-08-29T03:00:00Z,CHARLESTON SC,57,0,0,0,57
Tropical Storm,Gaston,6,2004-08-29T03:00:00Z,NANTUCKET MA,0,0,0,8,8
Tropical Storm,Gaston,6,2004-08-29T03:00:00Z,MYRTLE BEACH SC,32,0,0,0,32
Tropical Storm,Gaston,6,2004-08-29T03:00:00Z,HYANNIS MA,0,0,0,8,8
Tropical Storm,Gaston,6,2004-08-29T03:00:00Z,WILMINGTON NC,12,7,1,1,21
Tropical Storm,Gaston,6,2004-08-29T03:00:00Z,BOSTON MA,0,0,0,8,8
Tropical Storm,Gaston,6,2004-08-29T03:00:00Z,MOREHEAD CITY NC,1,11,4,1,17
Tropical Storm,Gaston,6,2004-08-29T03:00:00Z,PORTLAND ME,0,0,0,5,5
Tropical Storm,Gaston,6,2004-08-29T03:00:00Z,CAPE HATTERAS NC,0,5,8,2,15
Tropical Storm,Gaston,6,2004-08-29T03:00:00Z,BAR HARBOR ME,0,0,0,3,3
Tropical Storm,Gaston,6,2004-08-29T03:00:00Z,NORFOLK VA,0,2,11,3,16
Tropical Storm,Gaston,6,2004-08-29T03:00:00Z,YARMOUTH NS,0,0,0,2,2
Tropical Storm,Gaston,6,2004-08-29T03:00:00Z,OCEAN CITY MD,0,0,6,8,14
Tropical Storm,Gaston,7,2004-08-29T09:00:00Z,35.0N  79.4W,35,1,0,0,36
Tropical Storm,Gaston,7,2004-08-29T09:00:00Z,MONTAUK POINT NY,0,0,0,15,15
Tropical Storm,Gaston,7,2004-08-29T09:00:00Z,36.7N  78.0W,2,19,3,0,24
Tropical Storm,Gaston,7,2004-08-29T09:00:00Z,PROVIDENCE RI,0,0,0,14,14
Tropical Storm,Gaston,7,2004-08-29T09:00:00Z,38.5N  75.5W,0,1,14,5,20
Tropical Storm,Gaston,7,2004-08-29T09:00:00Z,NANTUCKET MA,0,0,0,14,14
Tropical Storm,Gaston,7,2004-08-29T09:00:00Z,SAVANNAH GA,10,1,0,0,11
Tropical Storm,Gaston,7,2004-08-29T09:00:00Z,HYANNIS MA,0,0,0,14,14
Tropical Storm,Gaston,7,2004-08-29T09:00:00Z,CHARLESTON SC,99,0,0,0,99
Tropical Storm,Gaston,7,2004-08-29T09:00:00Z,BOSTON MA,0,0,0,13,13
Tropical Storm,Gaston,7,2004-08-29T09:00:00Z,MYRTLE BEACH SC,62,0,0,0,62
Tropical Storm,Gaston,7,2004-08-29T09:00:00Z,PORTLAND ME,0,0,0,11,11
Tropical Storm,Gaston,7,2004-08-29T09:00:00Z,WILMINGTON NC,25,1,0,0,26
Tropical Storm,Gaston,7,2004-08-29T09:00:00Z,BAR HARBOR ME,0,0,0,9,9
Tropical Storm,Gaston,7,2004-08-29T09:00:00Z,MOREHEAD CITY NC,6,10,3,0,19
Tropical Storm,Gaston,7,2004-08-29T09:00:00Z,EASTPORT ME,0,0,0,6,6
Tropical Storm,Gaston,7,2004-08-29T09:00:00Z,CAPE HATTERAS NC,0,6,10,1,17
Tropical Storm,Gaston,7,2004-08-29T09:00:00Z,ST JOHN NB,0,0,0,4,4
Tropical Storm,Gaston,7,2004-08-29T09:00:00Z,NORFOLK VA,0,7,13,1,21
Tropical Storm,Gaston,7,2004-08-29T09:00:00Z,MONCTON NB,0,0,0,2,2
Tropical Storm,Gaston,7,2004-08-29T09:00:00Z,OCEAN CITY MD,0,1,13,5,19
Tropical Storm,Gaston,7,2004-08-29T09:00:00Z,YARMOUTH NS,0,0,0,7,7
Tropical Storm,Gaston,7,2004-08-29T09:00:00Z,ATLANTIC CITY NJ,0,0,8,10,18
Tropical Storm,Gaston,7,2004-08-29T09:00:00Z,HALIFAX NS,0,0,0,3,3
Tropical Storm,Gaston,7,2004-08-29T09:00:00Z,NEW YORK CITY NY,0,0,3,14,17
Tropical Storm,Gaston,8,2004-08-29T15:00:00Z,35.9N  78.8W,30,1,1,0,32
Tropical Storm,Gaston,8,2004-08-29T15:00:00Z,NANTUCKET MA,0,0,1,9,10
Tropical Storm,Gaston,8,2004-08-29T15:00:00Z,37.7N  77.2W,2,16,3,0,21
Tropical Storm,Gaston,8,2004-08-29T15:00:00Z,HYANNIS MA,0,0,1,9,10
Tropical Storm,Gaston,8,2004-08-29T15:00:00Z,39.8N  74.0W,0,0,12,2,14
Tropical Storm,Gaston,8,2004-08-29T15:00:00Z,BOSTON MA,0,0,1,9,10
Tropical Storm,Gaston,8,2004-08-29T15:00:00Z,CHARLESTON SC,99,0,0,0,99
Tropical Storm,Gaston,8,2004-08-29T15:00:00Z,PORTLAND ME,0,0,0,9,9
Tropical Storm,Gaston,8,2004-08-29T15:00:00Z,MYRTLE BEACH SC,99,0,0,0,99
Tropical Storm,Gaston,8,2004-08-29T15:00:00Z,BAR HARBOR ME,0,0,0,8,8
Tropical Storm,Gaston,8,2004-08-29T15:00:00Z,WILMINGTON NC,33,0,0,1,34
Tropical Storm,Gaston,8,2004-08-29T15:00:00Z,EASTPORT ME,0,0,0,7,7
Tropical Storm,Gaston,8,2004-08-29T15:00:00Z,MOREHEAD CITY NC,15,4,1,0,20
Tropical Storm,Gaston,8,2004-08-29T15:00:00Z,ST JOHN NB,0,0,0,7,7
Tropical Storm,Gaston,8,2004-08-29T15:00:00Z,CAPE HATTERAS NC,4,10,2,0,16
Tropical Storm,Gaston,8,2004-08-29T15:00:00Z,MONCTON NB,0,0,0,6,6
Tropical Storm,Gaston,8,2004-08-29T15:00:00Z,NORFOLK VA,2,14,4,0,20
Tropical Storm,Gaston,8,2004-08-29T15:00:00Z,YARMOUTH NS,0,0,0,7,7
Tropical Storm,Gaston,8,2004-08-29T15:00:00Z,OCEAN CITY MD,0,5,11,1,17
Tropical Storm,Gaston,8,2004-08-29T15:00:00Z,HALIFAX NS,0,0,0,6,6
Tropical Storm,Gaston,8,2004-08-29T15:00:00Z,ATLANTIC CITY NJ,0,1,13,1,15
Tropical Storm,Gaston,8,2004-08-29T15:00:00Z,SABLE ISLAND NS,0,0,0,4,4
Tropical Storm,Gaston,8,2004-08-29T15:00:00Z,NEW YORK CITY NY,0,0,9,4,13
Tropical Storm,Gaston,8,2004-08-29T15:00:00Z,SYDNEY NS,0,0,0,3,3
Tropical Storm,Gaston,8,2004-08-29T15:00:00Z,MONTAUK POINT NY,0,0,4,7,11
Tropical Storm,Gaston,8,2004-08-29T15:00:00Z,EDDY POINT NS,0,0,0,4,4
Tropical Storm,Gaston,8,2004-08-29T15:00:00Z,PROVIDENCE RI,0,0,2,9,11
Tropical Storm,Gaston,8,2004-08-29T15:00:00Z,PTX BASQUES NFLD,0,0,0,2,2
Tropical Storm,Gaston,9,2004-08-29T21:00:00Z,37.0N  78.0W,27,4,0,0,31
Tropical Storm,Gaston,9,2004-08-29T21:00:00Z,HYANNIS MA,0,0,7,4,11
Tropical Storm,Gaston,9,2004-08-29T21:00:00Z,39.5N  75.0W,0,13,5,0,18
Tropical Storm,Gaston,9,2004-08-29T21:00:00Z,BOSTON MA,0,0,7,4,11
Tropical Storm,Gaston,9,2004-08-29T21:00:00Z,41.5N  71.0W,0,0,9,3,12
Tropical Storm,Gaston,9,2004-08-29T21:00:00Z,PORTLAND ME,0,0,4,6,10
Tropical Storm,Gaston,9,2004-08-29T21:00:00Z,BERMUDA,0,0,0,2,2
Tropical Storm,Gaston,9,2004-08-29T21:00:00Z,BAR HARBOR ME,0,0,1,8,9
Tropical Storm,Gaston,9,2004-08-29T21:00:00Z,CHARLESTON SC,99,0,0,0,99
Tropical Storm,Gaston,9,2004-08-29T21:00:00Z,EASTPORT ME,0,0,0,8,8
Tropical Storm,Gaston,9,2004-08-29T21:00:00Z,MYRTLE BEACH SC,99,0,0,0,99
Tropical Storm,Gaston,9,2004-08-29T21:00:00Z,ST JOHN NB,0,0,0,8,8
Tropical Storm,Gaston,9,2004-08-29T21:00:00Z,WILMINGTON NC,44,0,0,0,44
Tropical Storm,Gaston,9,2004-08-29T21:00:00Z,MONCTON NB,0,0,0,7,7
Tropical Storm,Gaston,9,2004-08-29T21:00:00Z,MOREHEAD CITY NC,21,3,0,0,24
Tropical Storm,Gaston,9,2004-08-29T21:00:00Z,YARMOUTH NS,0,0,0,9,9
Tropical Storm,Gaston,9,2004-08-29T21:00:00Z,CAPE HATTERAS NC,11,9,0,0,20
Tropical Storm,Gaston,9,2004-08-29T21:00:00Z,HALIFAX NS,0,0,0,8,8
Tropical Storm,Gaston,9,2004-08-29T21:00:00Z,NORFOLK VA,12,13,1,0,26
Tropical Storm,Gaston,9,2004-08-29T21:00:00Z,SABLE ISLAND NS,0,0,0,6,6
Tropical Storm,Gaston,9,2004-08-29T21:00:00Z,OCEAN CITY MD,1,17,2,0,20
Tropical Storm,Gaston,9,2004-08-29T21:00:00Z,SYDNEY NS,0,0,0,6,6
Tropical Storm,Gaston,9,2004-08-29T21:00:00Z,ATLANTIC CITY NJ,0,11,6,0,17
Tropical Storm,Gaston,9,2004-08-29T21:00:00Z,EDDY POINT NS,0,0,0,6,6
Tropical Storm,Gaston,9,2004-08-29T21:00:00Z,NEW YORK CITY NY,0,4,10,1,15
Tropical Storm,Gaston,9,2004-08-29T21:00:00Z,PTX BASQUES NFLD,0,0,0,5,5
Tropical Storm,Gaston,9,2004-08-29T21:00:00Z,MONTAUK POINT NY,0,1,10,2,13
Tropical Storm,Gaston,9,2004-08-29T21:00:00Z,BURGEO NFLD,0,0,0,4,4
Tropical Storm,Gaston,9,2004-08-29T21:00:00Z,PROVIDENCE RI,0,0,9,3,12
Tropical Storm,Gaston,9,2004-08-29T21:00:00Z,ILE ST PIERRE,0,0,0,4,4
Tropical Storm,Gaston,9,2004-08-29T21:00:00Z,NANTUCKET MA,0,0,7,4,11
Tropical Storm,Gaston,9,2004-08-29T21:00:00Z,CAPE RACE NFLD,0,0,0,2,2
Tropical Storm,Gaston,14,2004-08-31T03:00:00Z,41.6N  66.9W,20,8,0,0,28
Tropical Storm,Gaston,14,2004-08-31T03:00:00Z,EASTPORT ME,4,8,0,0,12
Tropical Storm,Gaston,14,2004-08-31T03:00:00Z,44.3N  59.4W,0,11,6,0,17
Tropical Storm,Gaston,14,2004-08-31T03:00:00Z,ST JOHN NB,1,12,0,0,13
Tropical Storm,Gaston,14,2004-08-31T03:00:00Z,48.0N  49.0W,0,0,6,0,6
Tropical Storm,Gaston,14,2004-08-31T03:00:00Z,MONCTON NB,0,11,1,0,12
Tropical Storm,Gaston,14,2004-08-31T03:00:00Z,NORFOLK VA,99,0,0,0,99
Tropical Storm,Gaston,14,2004-08-31T03:00:00Z,YARMOUTH NS,6,15,0,0,21
Tropical Storm,Gaston,14,2004-08-31T03:00:00Z,OCEAN CITY MD,99,0,0,0,99
Tropical Storm,Gaston,14,2004-08-31T03:00:00Z,HALIFAX NS,0,19,1,0,20
Tropical Storm,Gaston,14,2004-08-31T03:00:00Z,ATLANTIC CITY NJ,58,0,0,0,58
Tropical Storm,Gaston,14,2004-08-31T03:00:00Z,SABLE ISLAND NS,0,13,5,0,18
Tropical Storm,Gaston,14,2004-08-31T03:00:00Z,NEW YORK CITY NY,30,0,0,0,30
Tropical Storm,Gaston,14,2004-08-31T03:00:00Z,SYDNEY NS,0,10,6,0,16
Tropical Storm,Gaston,14,2004-08-31T03:00:00Z,MONTAUK POINT NY,34,0,0,0,34
Tropical Storm,Gaston,14,2004-08-31T03:00:00Z,EDDY POINT NS,0,14,4,0,18
Tropical Storm,Gaston,14,2004-08-31T03:00:00Z,PROVIDENCE RI,24,0,0,0,24
Tropical Storm,Gaston,14,2004-08-31T03:00:00Z,PTX BASQUES NFLD,0,5,8,0,13
Tropical Storm,Gaston,14,2004-08-31T03:00:00Z,NANTUCKET MA,33,0,0,0,33
Tropical Storm,Gaston,14,2004-08-31T03:00:00Z,BURGEO NFLD,0,3,10,0,13
Tropical Storm,Gaston,14,2004-08-31T03:00:00Z,HYANNIS MA,28,0,0,0,28
Tropical Storm,Gaston,14,2004-08-31T03:00:00Z,ILE ST PIERRE,0,2,12,0,14
Tropical Storm,Gaston,14,2004-08-31T03:00:00Z,BOSTON MA,16,0,0,0,16
Tropical Storm,Gaston,14,2004-08-31T03:00:00Z,CAPE RACE NFLD,0,0,11,0,11
Tropical Storm,Gaston,14,2004-08-31T03:00:00Z,PORTLAND ME,6,1,0,0,7
Tropical Storm,Gaston,14,2004-08-31T03:00:00Z,HIBERNIA OILFLD,0,0,5,0,5
Tropical Storm,Gaston,14,2004-08-31T03:00:00Z,BAR HARBOR ME,6,4,0,0,10
Tropical Storm,Gaston,15,2004-08-31T09:00:00Z,42.3N  64.0W,20,11,0,0,31
Tropical Storm,Gaston,15,2004-08-31T09:00:00Z,EASTPORT ME,8,1,0,0,9
Tropical Storm,Gaston,15,2004-08-31T09:00:00Z,45.1N  56.2W,0,11,9,0,20
Tropical Storm,Gaston,15,2004-08-31T09:00:00Z,ST JOHN NB,7,4,0,0,11
Tropical Storm,Gaston,15,2004-08-31T09:00:00Z,48.5N  46.7W,0,0,8,0,8
Tropical Storm,Gaston,15,2004-08-31T09:00:00Z,MONCTON NB,3,7,0,0,10
Tropical Storm,Gaston,15,2004-08-31T09:00:00Z,NORFOLK VA,2,0,0,0,2
Tropical Storm,Gaston,15,2004-08-31T09:00:00Z,YARMOUTH NS,19,4,0,0,23
Tropical Storm,Gaston,15,2004-08-31T09:00:00Z,OCEAN CITY MD,99,0,0,0,99
Tropical Storm,Gaston,15,2004-08-31T09:00:00Z,HALIFAX NS,6,17,0,0,23
Tropical Storm,Gaston,15,2004-08-31T09:00:00Z,ATLANTIC CITY NJ,10,0,0,0,10
Tropical Storm,Gaston,15,2004-08-31T09:00:00Z,SABLE ISLAND NS,0,22,2,0,24
Tropical Storm,Gaston,15,2004-08-31T09:00:00Z,NEW YORK CITY NY,3,0,0,0,3
Tropical Storm,Gaston,15,2004-08-31T09:00:00Z,SYDNEY NS,0,17,2,0,19
Tropical Storm,Gaston,15,2004-08-31T09:00:00Z,MONTAUK POINT NY,17,0,0,0,17
Tropical Storm,Gaston,15,2004-08-31T09:00:00Z,EDDY POINT NS,0,20,1,0,21
Tropical Storm,Gaston,15,2004-08-31T09:00:00Z,PROVIDENCE RI,12,0,0,0,12
Tropical Storm,Gaston,15,2004-08-31T09:00:00Z,PTX BASQUES NFLD,0,10,4,0,14
Tropical Storm,Gaston,15,2004-08-31T09:00:00Z,NANTUCKET MA,37,0,0,0,37
Tropical Storm,Gaston,15,2004-08-31T09:00:00Z,BURGEO NFLD,0,9,7,0,16
Tropical Storm,Gaston,15,2004-08-31T09:00:00Z,HYANNIS MA,25,0,0,0,25
Tropical Storm,Gaston,15,2004-08-31T09:00:00Z,ILE ST PIERRE,0,9,9,0,18
Tropical Storm,Gaston,15,2004-08-31T09:00:00Z,BOSTON MA,7,0,0,0,7
Tropical Storm,Gaston,15,2004-08-31T09:00:00Z,CAPE RACE NFLD,0,3,14,0,17
Tropical Storm,Gaston,15,2004-08-31T09:00:00Z,PORTLAND ME,2,0,0,0,2
Tropical Storm,Gaston,15,2004-08-31T09:00:00Z,HIBERNIA OILFLD,0,0,10,0,10
Tropical Storm,Gaston,15,2004-08-31T09:00:00Z,BAR HARBOR ME,6,0,0,0,6
Tropical Storm,Gaston,16,2004-08-31T15:00:00Z,43.0N  62.0W,17,8,0,0,25
Tropical Storm,Gaston,16,2004-08-31T15:00:00Z,YARMOUTH NS,19,1,0,0,20
Tropical Storm,Gaston,16,2004-08-31T15:00:00Z,46.0N  53.0W,0,11,7,0,18
Tropical Storm,Gaston,16,2004-08-31T15:00:00Z,HALIFAX NS,17,4,0,0,21
Tropical Storm,Gaston,16,2004-08-31T15:00:00Z,49.5N  44.0W,0,0,8,0,8
Tropical Storm,Gaston,16,2004-08-31T15:00:00Z,SABLE ISLAND NS,6,17,0,0,23
Tropical Storm,Gaston,16,2004-08-31T15:00:00Z,MONTAUK POINT NY,6,0,0,0,6
Tropical Storm,Gaston,16,2004-08-31T15:00:00Z,SYDNEY NS,3,14,0,0,17
Tropical Storm,Gaston,16,2004-08-31T15:00:00Z,PROVIDENCE RI,3,0,0,0,3
Tropical Storm,Gaston,16,2004-08-31T15:00:00Z,EDDY POINT NS,7,12,0,0,19
Tropical Storm,Gaston,16,2004-08-31T15:00:00Z,NANTUCKET MA,36,0,0,0,36
Tropical Storm,Gaston,16,2004-08-31T15:00:00Z,PTX BASQUES NFLD,1,10,1,0,12
Tropical Storm,Gaston,16,2004-08-31T15:00:00Z,HYANNIS MA,17,0,0,0,17
Tropical Storm,Gaston,16,2004-08-31T15:00:00Z,BURGEO NFLD,0,13,2,0,15
Tropical Storm,Gaston,16,2004-08-31T15:00:00Z,BAR HARBOR ME,2,0,0,0,2
Tropical Storm,Gaston,16,2004-08-31T15:00:00Z,ILE ST PIERRE,0,16,2,0,18
Tropical Storm,Gaston,16,2004-08-31T15:00:00Z,EASTPORT ME,4,0,0,0,4
Tropical Storm,Gaston,16,2004-08-31T15:00:00Z,CAPE RACE NFLD,0,11,7,0,18
Tropical Storm,Gaston,16,2004-08-31T15:00:00Z,ST JOHN NB,6,1,0,0,7
Tropical Storm,Gaston,16,2004-08-31T15:00:00Z,HIBERNIA OILFLD,0,1,13,0,14
Tropical Storm,Gaston,16,2004-08-31T15:00:00Z,MONCTON NB,5,1,0,0,6
Tropical Storm,Gaston,17,2004-08-31T21:00:00Z,45.0N  57.0W,19,9,0,0,28
Tropical Storm,Gaston,17,2004-08-31T21:00:00Z,SYDNEY NS,17,2,0,0,19
Tropical Storm,Gaston,17,2004-08-31T21:00:00Z,47.5N  48.0W,0,11,6,0,17
Tropical Storm,Gaston,17,2004-08-31T21:00:00Z,EDDY POINT NS,21,1,0,0,22
Tropical Storm,Gaston,17,2004-08-31T21:00:00Z,50.0N  38.0W,0,0,8,0,8
Tropical Storm,Gaston,17,2004-08-31T21:00:00Z,PTX BASQUES NFLD,7,2,0,0,9
Tropical Storm,Gaston,17,2004-08-31T21:00:00Z,NANTUCKET MA,14,0,0,0,14
Tropical Storm,Gaston,17,2004-08-31T21:00:00Z,BURGEO NFLD,7,7,0,0,14
Tropical Storm,Gaston,17,2004-08-31T21:00:00Z,HYANNIS MA,2,0,0,0,2
Tropical Storm,Gaston,17,2004-08-31T21:00:00Z,ILE ST PIERRE,9,13,0,0,22
Tropical Storm,Gaston,17,2004-08-31T21:00:00Z,YARMOUTH NS,12,0,0,0,12
Tropical Storm,Gaston,17,2004-08-31T21:00:00Z,CAPE RACE NFLD,1,20,0,0,21
Tropical Storm,Gaston,17,2004-08-31T21:00:00Z,HALIFAX NS,21,0,0,0,21
Tropical Storm,Gaston,17,2004-08-31T21:00:00Z,HIBERNIA OILFLD,0,12,5,0,17
Tropical Storm,Gaston,17,2004-08-31T21:00:00Z,SABLE ISLAND NS,36,0,0,0,36
Tropical Storm,Gaston,18,2004-09-01T03:00:00Z,46.5N  51.0W,17,8,0,0,25
Tropical Storm,Gaston,18,2004-09-01T03:00:00Z,EDDY POINT NS,13,0,0,0,13
Tropical Storm,Gaston,18,2004-09-01T03:00:00Z,49.0N  41.0W,0,13,6,0,19
Tropical Storm,Gaston,18,2004-09-01T03:00:00Z,PTX BASQUES NFLD,3,0,0,0,3
Tropical Storm,Gaston,18,2004-09-01T03:00:00Z,51.5N  31.0W,0,0,10,0,10
Tropical Storm,Gaston,18,2004-09-01T03:00:00Z,BURGEO NFLD,6,0,0,0,6
Tropical Storm,Gaston,18,2004-09-01T03:00:00Z,YARMOUTH NS,3,0,0,0,3
Tropical Storm,Gaston,18,2004-09-01T03:00:00Z,ILE ST PIERRE,18,0,0,0,18
Tropical Storm,Gaston,18,2004-09-01T03:00:00Z,HALIFAX NS,12,0,0,0,12
Tropical Storm,Gaston,18,2004-09-01T03:00:00Z,CAPE RACE NFLD,22,3,0,0,25
Tropical Storm,Gaston,18,2004-09-01T03:00:00Z,SABLE ISLAND NS,44,0,0,0,44
Tropical Storm,Gaston,18,2004-09-01T03:00:00Z,HIBERNIA OILFLD,5,18,0,0,23
Tropical Storm,Gaston,18,2004-09-01T03:00:00Z,SYDNEY NS,10,0,0,0,10
Tropical Storm,Gaston,19,2004-09-01T09:00:00Z,48.0N  44.6W,27,5,0,0,32
Tropical Storm,Gaston,19,2004-09-01T09:00:00Z,ILE ST PIERRE,9,0,0,0,9
Tropical Storm,Gaston,19,2004-09-01T09:00:00Z,50.9N  34.3W,0,13,2,0,15
Tropical Storm,Gaston,19,2004-09-01T09:00:00Z,CAPE RACE NFLD,24,0,0,0,24
Tropical Storm,Gaston,19,2004-09-01T09:00:00Z,51.8N  25.3W,0,1,8,0,9
Tropical Storm,Gaston,19,2004-09-01T09:00:00Z,HIBERNIA OILFLD,28,1,0,0,29
Tropical Storm,Gaston,19,2004-09-01T09:00:00Z,SABLE ISLAND NS,33,0,0,0,33
Tropical Storm,Hermine,1,2004-08-29T21:00:00Z,35.6N  73.1W,42,0,0,0,42
Tropical Storm,Hermine,1,2004-08-29T21:00:00Z,ATLANTIC CITY NJ,0,16,0,0,16
Tropical Storm,Hermine,1,2004-08-29T21:00:00Z,39.0N  72.0W,1,22,0,0,23
Tropical Storm,Hermine,1,2004-08-29T21:00:00Z,NEW YORK CITY NY,0,9,0,0,9
Tropical Storm,Hermine,1,2004-08-29T21:00:00Z,WILMINGTON NC,2,2,0,0,4
Tropical Storm,Hermine,1,2004-08-29T21:00:00Z,MONTAUK POINT NY,0,6,0,0,6
Tropical Storm,Hermine,1,2004-08-29T21:00:00Z,MOREHEAD CITY NC,10,6,0,0,16
Tropical Storm,Hermine,1,2004-08-29T21:00:00Z,PROVIDENCE RI,0,3,0,0,3
Tropical Storm,Hermine,1,2004-08-29T21:00:00Z,CAPE HATTERAS NC,23,5,0,0,28
Tropical Storm,Hermine,1,2004-08-29T21:00:00Z,NANTUCKET MA,0,3,0,0,3
Tropical Storm,Hermine,1,2004-08-29T21:00:00Z,NORFOLK VA,5,16,0,0,21
Tropical Storm,Hermine,1,2004-08-29T21:00:00Z,HYANNIS MA,0,2,0,0,2
Tropical Storm,Hermine,1,2004-08-29T21:00:00Z,OCEAN CITY MD,1,22,0,0,23
Tropical Storm,Hermine,2,2004-08-30T03:00:00Z,37.9N  71.9W,29,4,0,0,33
Tropical Storm,Hermine,2,2004-08-30T03:00:00Z,MONTAUK POINT NY,0,20,0,0,20
Tropical Storm,Hermine,2,2004-08-30T03:00:00Z,41.2N  70.4W,0,17,0,0,17
Tropical Storm,Hermine,2,2004-08-30T03:00:00Z,PROVIDENCE RI,0,16,0,0,16
Tropical Storm,Hermine,2,2004-08-30T03:00:00Z,CAPE HATTERAS NC,3,0,0,0,3
Tropical Storm,Hermine,2,2004-08-30T03:00:00Z,NANTUCKET MA,0,15,0,0,15
Tropical Storm,Hermine,2,2004-08-30T03:00:00Z,NORFOLK VA,4,2,0,0,6
Tropical Storm,Hermine,2,2004-08-30T03:00:00Z,HYANNIS MA,0,14,0,0,14
Tropical Storm,Hermine,2,2004-08-30T03:00:00Z,OCEAN CITY MD,12,7,0,0,19
Tropical Storm,Hermine,2,2004-08-30T03:00:00Z,BOSTON MA,0,12,0,0,12
Tropical Storm,Hermine,2,2004-08-30T03:00:00Z,ATLANTIC CITY NJ,5,15,0,0,20
Tropical Storm,Hermine,2,2004-08-30T03:00:00Z,PORTLAND ME,0,4,0,0,4
Tropical Storm,Hermine,2,2004-08-30T03:00:00Z,NEW YORK CITY NY,1,18,0,0,19
Tropical Storm,Hermine,3,2004-08-30T09:00:00Z,41.5N  69.5W,36,4,0,0,40
Tropical Storm,Hermine,3,2004-08-30T09:00:00Z,PORTLAND ME,7,16,0,0,23
Tropical Storm,Hermine,3,2004-08-30T09:00:00Z,45.7N  65.1W,0,14,0,0,14
Tropical Storm,Hermine,3,2004-08-30T09:00:00Z,BAR HARBOR ME,2,21,0,0,23
Tropical Storm,Hermine,3,2004-08-30T09:00:00Z,ATLANTIC CITY NJ,3,0,0,0,3
Tropical Storm,Hermine,3,2004-08-30T09:00:00Z,EASTPORT ME,0,20,0,0,20
Tropical Storm,Hermine,3,2004-08-30T09:00:00Z,NEW YORK CITY NY,8,0,0,0,8
Tropical Storm,Hermine,3,2004-08-30T09:00:00Z,ST JOHN NB,0,17,0,0,17
Tropical Storm,Hermine,3,2004-08-30T09:00:00Z,MONTAUK POINT NY,31,2,0,0,33
Tropical Storm,Hermine,3,2004-08-30T09:00:00Z,MONCTON NB,0,12,0,0,12
Tropical Storm,Hermine,3,2004-08-30T09:00:00Z,PROVIDENCE RI,29,3,0,0,32
Tropical Storm,Hermine,3,2004-08-30T09:00:00Z,YARMOUTH NS,1,19,0,0,20
Tropical Storm,Hermine,3,2004-08-30T09:00:00Z,NANTUCKET MA,40,2,0,0,42
Tropical Storm,Hermine,3,2004-08-30T09:00:00Z,HALIFAX NS,0,11,0,0,11
Tropical Storm,Hermine,3,2004-08-30T09:00:00Z,HYANNIS MA,35,3,0,0,38
Tropical Storm,Hermine,3,2004-08-30T09:00:00Z,SABLE ISLAND NS,0,2,0,0,2
Tropical Storm,Hermine,3,2004-08-30T09:00:00Z,BOSTON MA,22,7,0,0,29
Tropical Storm,Hermine,3,2004-08-30T09:00:00Z,EDDY POINT NS,0,4,0,0,4
Tropical Storm,Hermine,4,2004-08-30T15:00:00Z,44.0N  67.0W,18,6,0,0,24
Tropical Storm,Hermine,4,2004-08-30T15:00:00Z,EASTPORT ME,11,10,0,0,21
Tropical Storm,Hermine,4,2004-08-30T15:00:00Z,48.0N  61.0W,0,11,0,0,11
Tropical Storm,Hermine,4,2004-08-30T15:00:00Z,ST JOHN NB,4,16,0,0,20
Tropical Storm,Hermine,4,2004-08-30T15:00:00Z,ATLANTIC CITY NJ,5,0,0,0,5
Tropical Storm,Hermine,4,2004-08-30T15:00:00Z,MONCTON NB,1,17,0,0,18
Tropical Storm,Hermine,4,2004-08-30T15:00:00Z,NEW YORK CITY NY,15,0,0,0,15
Tropical Storm,Hermine,4,2004-08-30T15:00:00Z,YARMOUTH NS,15,8,0,0,23
Tropical Storm,Hermine,4,2004-08-30T15:00:00Z,MONTAUK POINT NY,48,0,0,0,48
Tropical Storm,Hermine,4,2004-08-30T15:00:00Z,HALIFAX NS,2,15,0,0,17
Tropical Storm,Hermine,4,2004-08-30T15:00:00Z,PROVIDENCE RI,43,0,0,0,43
Tropical Storm,Hermine,4,2004-08-30T15:00:00Z,SABLE ISLAND NS,0,8,0,0,8
Tropical Storm,Hermine,4,2004-08-30T15:00:00Z,NANTUCKET MA,48,0,0,0,48
Tropical Storm,Hermine,4,2004-08-30T15:00:00Z,SYDNEY NS,0,11,0,0,11
Tropical Storm,Hermine,4,2004-08-30T15:00:00Z,HYANNIS MA,45,0,0,0,45
Tropical Storm,Hermine,4,2004-08-30T15:00:00Z,EDDY POINT NS,0,13,0,0,13
Tropical Storm,Hermine,4,2004-08-30T15:00:00Z,BOSTON MA,36,0,0,0,36
Tropical Storm,Hermine,4,2004-08-30T15:00:00Z,PTX BASQUES NFLD,0,7,0,0,7
Tropical Storm,Hermine,4,2004-08-30T15:00:00Z,PORTLAND ME,23,1,0,0,24
Tropical Storm,Hermine,4,2004-08-30T15:00:00Z,BURGEO NFLD,0,4,0,0,4
Tropical Storm,Hermine,4,2004-08-30T15:00:00Z,BAR HARBOR ME,19,4,0,0,23
Tropical Storm,Hermine,4,2004-08-30T15:00:00Z,ILE ST PIERRE,0,3,0,0,3
Tropical Storm,Hermine,5,2004-08-30T21:00:00Z,46.0N  65.0W,14,0,0,0,14
Tropical Storm,Hermine,5,2004-08-30T21:00:00Z,BAR HARBOR ME,24,0,0,0,24
Tropical Storm,Hermine,5,2004-08-30T21:00:00Z,NEW YORK CITY NY,2,0,0,0,2
Tropical Storm,Hermine,5,2004-08-30T21:00:00Z,EASTPORT ME,21,0,0,0,21
Tropical Storm,Hermine,5,2004-08-30T21:00:00Z,MONTAUK POINT NY,39,0,0,0,39
Tropical Storm,Hermine,5,2004-08-30T21:00:00Z,ST JOHN NB,18,0,0,0,18
Tropical Storm,Hermine,5,2004-08-30T21:00:00Z,PROVIDENCE RI,38,0,0,0,38
Tropical Storm,Hermine,5,2004-08-30T21:00:00Z,MONCTON NB,13,0,0,0,13
Tropical Storm,Hermine,5,2004-08-30T21:00:00Z,NANTUCKET MA,53,0,0,0,53
Tropical Storm,Hermine,5,2004-08-30T21:00:00Z,YARMOUTH NS,20,0,0,0,20
Tropical Storm,Hermine,5,2004-08-30T21:00:00Z,HYANNIS MA,49,0,0,0,49
Tropical Storm,Hermine,5,2004-08-30T21:00:00Z,HALIFAX NS,10,0,0,0,10
Tropical Storm,Hermine,5,2004-08-30T21:00:00Z,BOSTON MA,32,0,0,0,32
Tropical Storm,Hermine,5,2004-08-30T21:00:00Z,EDDY POINT NS,2,0,0,0,2
Tropical Storm,Hermine,5,2004-08-30T21:00:00Z,PORTLAND ME,22,0,0,0,22
Tropical Storm,Hermine,6,2004-08-31T03:00:00Z,47.9N  61.8W,17,8,0,0,25
Tropical Storm,Hermine,6,2004-08-31T03:00:00Z,MONCTON NB,29,1,0,0,30
Tropical Storm,Hermine,6,2004-08-31T03:00:00Z,51.9N  54.4W,0,13,0,0,13
Tropical Storm,Hermine,6,2004-08-31T03:00:00Z,YARMOUTH NS,27,0,0,0,27
Tropical Storm,Hermine,6,2004-08-31T03:00:00Z,MONTAUK POINT NY,99,0,0,0,99
Tropical Storm,Hermine,6,2004-08-31T03:00:00Z,HALIFAX NS,17,1,0,0,18
Tropical Storm,Hermine,6,2004-08-31T03:00:00Z,PROVIDENCE RI,99,0,0,0,99
Tropical Storm,Hermine,6,2004-08-31T03:00:00Z,SABLE ISLAND NS,4,1,0,0,5
Tropical Storm,Hermine,6,2004-08-31T03:00:00Z,NANTUCKET MA,99,0,0,0,99
Tropical Storm,Hermine,6,2004-08-31T03:00:00Z,SYDNEY NS,10,8,0,0,18
Tropical Storm,Hermine,6,2004-08-31T03:00:00Z,HYANNIS MA,99,0,0,0,99
Tropical Storm,Hermine,6,2004-08-31T03:00:00Z,EDDY POINT NS,14,3,0,0,17
Tropical Storm,Hermine,6,2004-08-31T03:00:00Z,BOSTON MA,67,0,0,0,67
Tropical Storm,Hermine,6,2004-08-31T03:00:00Z,PTX BASQUES NFLD,6,14,0,0,20
Tropical Storm,Hermine,6,2004-08-31T03:00:00Z,PORTLAND ME,51,0,0,0,51
Tropical Storm,Hermine,6,2004-08-31T03:00:00Z,BURGEO NFLD,2,15,0,0,17
Tropical Storm,Hermine,6,2004-08-31T03:00:00Z,BAR HARBOR ME,48,0,0,0,48
Tropical Storm,Hermine,6,2004-08-31T03:00:00Z,ILE ST PIERRE,1,10,0,0,11
Tropical Storm,Hermine,6,2004-08-31T03:00:00Z,EASTPORT ME,40,0,0,0,40
Tropical Storm,Hermine,6,2004-08-31T03:00:00Z,CAPE RACE NFLD,0,5,0,0,5
Tropical Storm,Hermine,6,2004-08-31T03:00:00Z,ST JOHN NB,34,0,0,0,34
Tropical Depression,Nine,1,2004-09-02T21:00:00Z,10.0N  35.0W,48,0,0,0,48
Tropical Depression,Nine,1,2004-09-02T21:00:00Z,10.8N  41.5W,0,9,16,1,26
Tropical Depression,Nine,1,2004-09-02T21:00:00Z,10.3N  38.2W,3,30,1,0,34
Tropical Depression,Nine,2,2004-09-03T03:00:00Z,10.1N  34.7W,48,0,0,0,48
Tropical Depression,Nine,2,2004-09-03T03:00:00Z,10.8N  41.0W,0,11,13,1,25
Tropical Depression,Nine,2,2004-09-03T03:00:00Z,10.4N  38.0W,3,30,0,0,33
Tropical Storm,Ivan,3,2004-09-03T09:00:00Z,10.3N  36.3W,49,0,0,0,49
Tropical Storm,Ivan,3,2004-09-03T09:00:00Z,10.9N  42.7W,0,10,14,1,25
Tropical Storm,Ivan,3,2004-09-03T09:00:00Z,10.6N  39.5W,3,30,1,0,34
Tropical Storm,Ivan,4,2004-09-03T15:00:00Z,10.0N  38.7W,47,0,0,0,47
Tropical Storm,Ivan,4,2004-09-03T15:00:00Z,10.5N  45.0W,0,11,14,1,26
Tropical Storm,Ivan,4,2004-09-03T15:00:00Z,10.3N  42.0W,3,30,1,0,34
Tropical Storm,Ivan,5,2004-09-03T21:00:00Z,8.7N  40.3W,47,0,0,0,47
Tropical Storm,Ivan,5,2004-09-03T21:00:00Z,TLPL 138N 610W,0,0,0,2,2
Tropical Storm,Ivan,5,2004-09-03T21:00:00Z,9.0N  43.4W,4,29,0,0,33
Tropical Storm,Ivan,5,2004-09-03T21:00:00Z,TFFF 146N 610W,0,0,0,2,2
Tropical Storm,Ivan,5,2004-09-03T21:00:00Z,9.8N  46.6W,0,11,14,1,26
Tropical Storm,Ivan,5,2004-09-03T21:00:00Z,TDPR 153N 614W,0,0,0,2,2
Tropical Storm,Ivan,5,2004-09-03T21:00:00Z,TBPB 131N 595W,0,0,0,4,4
Tropical Storm,Ivan,5,2004-09-03T21:00:00Z,TFFR 163N 615W,0,0,0,2,2
Tropical Storm,Ivan,5,2004-09-03T21:00:00Z,TVSV 131N 612W,0,0,0,2,2
Tropical Storm,Ivan,6,2004-09-04T03:00:00Z,9.4N  41.0W,47,0,0,0,47
Tropical Storm,Ivan,6,2004-09-04T03:00:00Z,TFFF 146N 610W,0,0,0,2,2
Tropical Storm,Ivan,6,2004-09-04T03:00:00Z,10.2N  44.0W,6,28,0,1,35
Tropical Storm,Ivan,6,2004-09-04T03:00:00Z,TDPR 153N 614W,0,0,0,2,2
Tropical Storm,Ivan,6,2004-09-04T03:00:00Z,11.0N  47.0W,0,13,12,1,26
Tropical Storm,Ivan,6,2004-09-04T03:00:00Z,TFFR 163N 615W,0,0,0,2,2
Tropical Storm,Ivan,6,2004-09-04T03:00:00Z,TBPB 131N 595W,0,0,0,4,4
Tropical Storm,Ivan,6,2004-09-04T03:00:00Z,TAPA 171N 618W,0,0,0,2,2
Tropical Storm,Ivan,6,2004-09-04T03:00:00Z,TLPL 138N 610W,0,0,0,2,2
Tropical Storm,Ivan,7,2004-09-04T09:00:00Z,9.7N  43.0W,49,0,0,0,49
Tropical Storm,Ivan,7,2004-09-04T09:00:00Z,TLPL 138N 610W,0,0,0,6,6
Tropical Storm,Ivan,7,2004-09-04T09:00:00Z,10.5N  46.2W,3,31,1,0,35
Tropical Storm,Ivan,7,2004-09-04T09:00:00Z,TFFF 146N 610W,0,0,0,6,6
Tropical Storm,Ivan,7,2004-09-04T09:00:00Z,11.4N  49.4W,0,11,15,0,26
Tropical Storm,Ivan,7,2004-09-04T09:00:00Z,TDPR 153N 614W,0,0,0,6,6
Tropical Storm,Ivan,7,2004-09-04T09:00:00Z,TTPP 106N 614W,0,0,0,2,2
Tropical Storm,Ivan,7,2004-09-04T09:00:00Z,80400 157N 636W,0,0,0,2,2
Tropical Storm,Ivan,7,2004-09-04T09:00:00Z,TTPT 112N 608W,0,0,0,3,3
Tropical Storm,Ivan,7,2004-09-04T09:00:00Z,TFFR 163N 615W,0,0,0,6,6
Tropical Storm,Ivan,7,2004-09-04T09:00:00Z,TGPY 120N 618W,0,0,0,2,2
Tropical Storm,Ivan,7,2004-09-04T09:00:00Z,TAPA 171N 618W,0,0,0,5,5
Tropical Storm,Ivan,7,2004-09-04T09:00:00Z,TBPB 131N 595W,0,0,0,9,9
Tropical Storm,Ivan,7,2004-09-04T09:00:00Z,TKPK 173N 627W,0,0,0,3,3
Tropical Storm,Ivan,7,2004-09-04T09:00:00Z,TVSV 131N 612W,0,0,0,5,5
Tropical Storm,Ivan,7,2004-09-04T09:00:00Z,TNCM 181N 631W,0,0,0,3,3
Tropical Storm,Ivan,8,2004-09-04T15:00:00Z,9.9N  44.5W,49,0,0,0,49
Tropical Storm,Ivan,8,2004-09-04T15:00:00Z,TDPR 153N 614W,0,0,0,10,10
Tropical Storm,Ivan,8,2004-09-04T15:00:00Z,10.6N  47.8W,3,31,1,0,35
Tropical Storm,Ivan,8,2004-09-04T15:00:00Z,80400 157N 636W,0,0,0,5,5
Tropical Storm,Ivan,8,2004-09-04T15:00:00Z,11.4N  51.0W,0,10,15,1,26
Tropical Storm,Ivan,8,2004-09-04T15:00:00Z,TFFR 163N 615W,0,0,0,10,10
Tropical Storm,Ivan,8,2004-09-04T15:00:00Z,TTPP 106N 614W,0,0,0,5,5
Tropical Storm,Ivan,8,2004-09-04T15:00:00Z,TAPA 171N 618W,0,0,0,9,9
Tropical Storm,Ivan,8,2004-09-04T15:00:00Z,TTPT 112N 608W,0,0,0,8,8
Tropical Storm,Ivan,8,2004-09-04T15:00:00Z,TKPK 173N 627W,0,0,0,7,7
Tropical Storm,Ivan,8,2004-09-04T15:00:00Z,TGPY 120N 618W,0,0,0,6,6
Tropical Storm,Ivan,8,2004-09-04T15:00:00Z,TNCM 181N 631W,0,0,0,5,5
Tropical Storm,Ivan,8,2004-09-04T15:00:00Z,TBPB 131N 595W,0,0,0,13,13
Tropical Storm,Ivan,8,2004-09-04T15:00:00Z,TISX 177N 648W,0,0,0,2,2
Tropical Storm,Ivan,8,2004-09-04T15:00:00Z,TVSV 131N 612W,0,0,0,9,9
Tropical Storm,Ivan,8,2004-09-04T15:00:00Z,TIST 183N 650W,0,0,0,2,2
Tropical Storm,Ivan,8,2004-09-04T15:00:00Z,TLPL 138N 610W,0,0,0,10,10
Tropical Storm,Ivan,8,2004-09-04T15:00:00Z,ST CROIX VI,0,0,0,2,2
Tropical Storm,Ivan,8,2004-09-04T15:00:00Z,TFFF 146N 610W,0,0,0,11,11
Tropical Storm,Ivan,8,2004-09-04T15:00:00Z,ST THOMAS VI,0,0,0,2,2
Tropical Storm,Ivan,9,2004-09-04T21:00:00Z,10.4N  46.6W,49,0,0,0,49
Tropical Storm,Ivan,9,2004-09-04T21:00:00Z,TFFR 163N 615W,0,0,0,13,13
Tropical Storm,Ivan,9,2004-09-04T21:00:00Z,11.4N  49.8W,3,32,0,0,35
Tropical Storm,Ivan,9,2004-09-04T21:00:00Z,TAPA 171N 618W,0,0,0,13,13
Tropical Storm,Ivan,9,2004-09-04T21:00:00Z,12.3N  53.0W,0,10,15,1,26
Tropical Storm,Ivan,9,2004-09-04T21:00:00Z,TKPK 173N 627W,0,0,0,11,11
Tropical Storm,Ivan,9,2004-09-04T21:00:00Z,SVMG 110N 640W,0,0,0,3,3
Tropical Storm,Ivan,9,2004-09-04T21:00:00Z,TNCM 181N 631W,0,0,0,10,10
Tropical Storm,Ivan,9,2004-09-04T21:00:00Z,TTPP 106N 614W,0,0,0,8,8
Tropical Storm,Ivan,9,2004-09-04T21:00:00Z,TISX 177N 648W,0,0,0,6,6
Tropical Storm,Ivan,9,2004-09-04T21:00:00Z,TTPT 112N 608W,0,0,0,11,11
Tropical Storm,Ivan,9,2004-09-04T21:00:00Z,TIST 183N 650W,0,0,0,5,5
Tropical Storm,Ivan,9,2004-09-04T21:00:00Z,TGPY 120N 618W,0,0,0,10,10
Tropical Storm,Ivan,9,2004-09-04T21:00:00Z,TJPS 180N 666W,0,0,0,2,2
Tropical Storm,Ivan,9,2004-09-04T21:00:00Z,TBPB 131N 595W,0,0,1,15,16
Tropical Storm,Ivan,9,2004-09-04T21:00:00Z,TJSJ 184N 661W,0,0,0,3,3
Tropical Storm,Ivan,9,2004-09-04T21:00:00Z,TVSV 131N 612W,0,0,0,13,13
Tropical Storm,Ivan,9,2004-09-04T21:00:00Z,ST CROIX VI,0,0,0,6,6
Tropical Storm,Ivan,9,2004-09-04T21:00:00Z,TLPL 138N 610W,0,0,0,14,14
Tropical Storm,Ivan,9,2004-09-04T21:00:00Z,ST THOMAS VI,0,0,0,5,5
Tropical Storm,Ivan,9,2004-09-04T21:00:00Z,TFFF 146N 610W,0,0,0,14,14
Tropical Storm,Ivan,9,2004-09-04T21:00:00Z,SAN JUAN PR,0,0,0,3,3
Tropical Storm,Ivan,9,2004-09-04T21:00:00Z,TDPR 153N 614W,0,0,0,14,14
Tropical Storm,Ivan,9,2004-09-04T21:00:00Z,PONCE PR,0,0,0,2,2
Tropical Storm,Ivan,9,2004-09-04T21:00:00Z,80400 157N 636W,0,0,0,9,9
Tropical Storm,Ivan,10,2004-09-05T03:00:00Z,10.7N  48.2W,50,0,0,0,50
Tropical Storm,Ivan,10,2004-09-05T03:00:00Z,TFFR 163N 615W,0,0,1,16,17
Tropical Storm,Ivan,10,2004-09-05T03:00:00Z,11.8N  51.5W,3,32,0,0,35
Tropical Storm,Ivan,10,2004-09-05T03:00:00Z,TAPA 171N 618W,0,0,1,15,16
Tropical Storm,Ivan,10,2004-09-05T03:00:00Z,12.7N  55.1W,0,7,19,1,27
Tropical Storm,Ivan,10,2004-09-05T03:00:00Z,TKPK 173N 627W,0,0,0,15,15
Tropical Storm,Ivan,10,2004-09-05T03:00:00Z,SVMG 110N 640W,0,0,0,7,7
Tropical Storm,Ivan,10,2004-09-05T03:00:00Z,TNCM 181N 631W,0,0,0,13,13
Tropical Storm,Ivan,10,2004-09-05T03:00:00Z,TTPP 106N 614W,0,0,0,11,11
Tropical Storm,Ivan,10,2004-09-05T03:00:00Z,TISX 177N 648W,0,0,0,11,11
Tropical Storm,Ivan,10,2004-09-05T03:00:00Z,TTPT 112N 608W,0,0,1,12,13
Tropical Storm,Ivan,10,2004-09-05T03:00:00Z,TIST 183N 650W,0,0,0,10,10
Tropical Storm,Ivan,10,2004-09-05T03:00:00Z,TGPY 120N 618W,0,0,0,13,13
Tropical Storm,Ivan,10,2004-09-05T03:00:00Z,TJPS 180N 666W,0,0,0,7,7
Tropical Storm,Ivan,10,2004-09-05T03:00:00Z,TBPB 131N 595W,0,0,5,14,19
Tropical Storm,Ivan,10,2004-09-05T03:00:00Z,TJSJ 184N 661W,0,0,0,8,8
Tropical Storm,Ivan,10,2004-09-05T03:00:00Z,TVSV 131N 612W,0,0,1,15,16
Tropical Storm,Ivan,10,2004-09-05T03:00:00Z,ST CROIX VI,0,0,0,11,11
Tropical Storm,Ivan,10,2004-09-05T03:00:00Z,TLPL 138N 610W,0,0,1,16,17
Tropical Storm,Ivan,10,2004-09-05T03:00:00Z,ST THOMAS VI,0,0,0,10,10
Tropical Storm,Ivan,10,2004-09-05T03:00:00Z,TFFF 146N 610W,0,0,1,17,18
Tropical Storm,Ivan,10,2004-09-05T03:00:00Z,SAN JUAN PR,0,0,0,8,8
Tropical Storm,Ivan,10,2004-09-05T03:00:00Z,TDPR 153N 614W,0,0,1,16,17
Tropical Storm,Ivan,10,2004-09-05T03:00:00Z,PONCE PR,0,0,0,7,7
Tropical Storm,Ivan,10,2004-09-05T03:00:00Z,80400 157N 636W,0,0,0,14,14
Hurricane,Ivan,11,2004-09-05T09:00:00Z,11.3N  50.6W,49,1,0,0,50
Hurricane,Ivan,11,2004-09-05T09:00:00Z,TFFR 163N 615W,0,0,8,12,20
Hurricane,Ivan,11,2004-09-05T09:00:00Z,12.2N  54.1W,2,33,0,0,35
Hurricane,Ivan,11,2004-09-05T09:00:00Z,TAPA 171N 618W,0,0,6,12,18
Hurricane,Ivan,11,2004-09-05T09:00:00Z,13.1N  57.5W,0,8,18,1,27
Hurricane,Ivan,11,2004-09-05T09:00:00Z,TKPK 173N 627W,0,0,3,14,17
Hurricane,Ivan,11,2004-09-05T09:00:00Z,TNCC 122N 690W,0,0,0,2,2
Hurricane,Ivan,11,2004-09-05T09:00:00Z,TNCM 181N 631W,0,0,1,15,16
Hurricane,Ivan,11,2004-09-05T09:00:00Z,SVMG 110N 640W,0,0,0,11,11
Hurricane,Ivan,11,2004-09-05T09:00:00Z,TISX 177N 648W,0,0,0,15,15
Hurricane,Ivan,11,2004-09-05T09:00:00Z,TTPP 106N 614W,0,0,2,12,14
Hurricane,Ivan,11,2004-09-05T09:00:00Z,TIST 183N 650W,0,0,0,14,14
Hurricane,Ivan,11,2004-09-05T09:00:00Z,TTPT 112N 608W,0,0,5,11,16
Hurricane,Ivan,11,2004-09-05T09:00:00Z,TJPS 180N 666W,0,0,0,11,11
Hurricane,Ivan,11,2004-09-05T09:00:00Z,TGPY 120N 618W,0,0,3,14,17
Hurricane,Ivan,11,2004-09-05T09:00:00Z,MDSD 185N 697W,0,0,0,4,4
Hurricane,Ivan,11,2004-09-05T09:00:00Z,TBPB 131N 595W,0,0,18,5,23
Hurricane,Ivan,11,2004-09-05T09:00:00Z,TJSJ 184N 661W,0,0,0,12,12
Hurricane,Ivan,11,2004-09-05T09:00:00Z,TVSV 131N 612W,0,0,8,12,20
Hurricane,Ivan,11,2004-09-05T09:00:00Z,MDPP 198N 707W,0,0,0,2,2
Hurricane,Ivan,11,2004-09-05T09:00:00Z,TLPL 138N 610W,0,0,10,11,21
Hurricane,Ivan,11,2004-09-05T09:00:00Z,ST CROIX VI,0,0,0,15,15
Hurricane,Ivan,11,2004-09-05T09:00:00Z,TFFF 146N 610W,0,0,11,10,21
Hurricane,Ivan,11,2004-09-05T09:00:00Z,ST THOMAS VI,0,0,0,14,14
Hurricane,Ivan,11,2004-09-05T09:00:00Z,TDPR 153N 614W,0,0,9,11,20
Hurricane,Ivan,11,2004-09-05T09:00:00Z,SAN JUAN PR,0,0,0,12,12
Hurricane,Ivan,11,2004-09-05T09:00:00Z,80400 157N 636W,0,0,1,16,17
Hurricane,Ivan,11,2004-09-05T09:00:00Z,PONCE PR,0,0,0,11,11
Hurricane,Ivan,12,2004-09-05T15:00:00Z,11.5N  52.3W,50,2,0,0,52
Hurricane,Ivan,12,2004-09-05T15:00:00Z,TAPA 171N 618W,0,0,3,15,18
Hurricane,Ivan,12,2004-09-05T15:00:00Z,12.4N  55.9W,1,34,2,0,37
Hurricane,Ivan,12,2004-09-05T15:00:00Z,TKPK 173N 627W,0,0,1,17,18
Hurricane,Ivan,12,2004-09-05T15:00:00Z,13.3N  59.4W,0,3,24,1,28
Hurricane,Ivan,12,2004-09-05T15:00:00Z,TNCM 181N 631W,0,0,0,15,15
Hurricane,Ivan,12,2004-09-05T15:00:00Z,TNCC 122N 690W,0,0,0,2,2
Hurricane,Ivan,12,2004-09-05T15:00:00Z,TISX 177N 648W,0,0,0,17,17
Hurricane,Ivan,12,2004-09-05T15:00:00Z,SVMG 110N 640W,0,0,1,8,9
Hurricane,Ivan,12,2004-09-05T15:00:00Z,TIST 183N 650W,0,0,0,15,15
Hurricane,Ivan,12,2004-09-05T15:00:00Z,TTPP 106N 614W,0,0,5,5,10
Hurricane,Ivan,12,2004-09-05T15:00:00Z,TJPS 180N 666W,0,0,0,15,15
Hurricane,Ivan,12,2004-09-05T15:00:00Z,TTPT 112N 608W,0,0,11,4,15
Hurricane,Ivan,12,2004-09-05T15:00:00Z,MDSD 185N 697W,0,0,0,6,6
Hurricane,Ivan,12,2004-09-05T15:00:00Z,TGPY 120N 618W,0,0,10,8,18
Hurricane,Ivan,12,2004-09-05T15:00:00Z,MDCB 176N 714W,0,0,0,3,3
Hurricane,Ivan,12,2004-09-05T15:00:00Z,TBPB 131N 595W,0,3,24,1,28
Hurricane,Ivan,12,2004-09-05T15:00:00Z,TJSJ 184N 661W,0,0,0,14,14
Hurricane,Ivan,12,2004-09-05T15:00:00Z,TVSV 131N 612W,0,0,17,7,24
Hurricane,Ivan,12,2004-09-05T15:00:00Z,MDPP 198N 707W,0,0,0,2,2
Hurricane,Ivan,12,2004-09-05T15:00:00Z,TLPL 138N 610W,0,0,19,7,26
Hurricane,Ivan,12,2004-09-05T15:00:00Z,ST CROIX VI,0,0,0,17,17
Hurricane,Ivan,12,2004-09-05T15:00:00Z,TFFF 146N 610W,0,0,18,8,26
Hurricane,Ivan,12,2004-09-05T15:00:00Z,ST THOMAS VI,0,0,0,15,15
Hurricane,Ivan,12,2004-09-05T15:00:00Z,TDPR 153N 614W,0,0,13,11,24
Hurricane,Ivan,12,2004-09-05T15:00:00Z,SAN JUAN PR,0,0,0,14,14
Hurricane,Ivan,12,2004-09-05T15:00:00Z,80400 157N 636W,0,0,2,20,22
Hurricane,Ivan,12,2004-09-05T15:00:00Z,PONCE PR,0,0,0,15,15
Hurricane,Ivan,12,2004-09-05T15:00:00Z,TFFR 163N 615W,0,0,7,14,21
Hurricane,Ivan,13,2004-09-05T17:00:00Z,11.5N  52.3W,50,2,0,0,52
Hurricane,Ivan,13,2004-09-05T17:00:00Z,TAPA 171N 618W,0,0,2,15,17
Hurricane,Ivan,13,2004-09-05T17:00:00Z,12.4N  55.9W,0,34,2,0,36
Hurricane,Ivan,13,2004-09-05T17:00:00Z,TKPK 173N 627W,0,0,1,16,17
Hurricane,Ivan,13,2004-09-05T17:00:00Z,13.3N  59.4W,0,2,24,1,27
Hurricane,Ivan,13,2004-09-05T17:00:00Z,TNCM 181N 631W,0,0,0,14,14
Hurricane,Ivan,13,2004-09-05T17:00:00Z,TNCC 122N 690W,0,0,0,3,3
Hurricane,Ivan,13,2004-09-05T17:00:00Z,TISX 177N 648W,0,0,0,16,16
Hurricane,Ivan,13,2004-09-05T17:00:00Z,SVMG 110N 640W,0,0,1,7,8
Hurricane,Ivan,13,2004-09-05T17:00:00Z,TIST 183N 650W,0,0,0,14,14
Hurricane,Ivan,13,2004-09-05T17:00:00Z,TTPP 106N 614W,0,0,5,4,9
Hurricane,Ivan,13,2004-09-05T17:00:00Z,TJPS 180N 666W,0,0,0,14,14
Hurricane,Ivan,13,2004-09-05T17:00:00Z,TTPT 112N 608W,0,0,10,4,14
Hurricane,Ivan,13,2004-09-05T17:00:00Z,MDSD 185N 697W,0,0,0,6,6
Hurricane,Ivan,13,2004-09-05T17:00:00Z,TGPY 120N 618W,0,0,9,8,17
Hurricane,Ivan,13,2004-09-05T17:00:00Z,MDCB 176N 714W,0,0,0,3,3
Hurricane,Ivan,13,2004-09-05T17:00:00Z,TBPB 131N 595W,0,2,24,0,26
Hurricane,Ivan,13,2004-09-05T17:00:00Z,TJSJ 184N 661W,0,0,0,13,13
Hurricane,Ivan,13,2004-09-05T17:00:00Z,TVSV 131N 612W,0,0,17,6,23
Hurricane,Ivan,13,2004-09-05T17:00:00Z,MDPP 198N 707W,0,0,0,2,2
Hurricane,Ivan,13,2004-09-05T17:00:00Z,TLPL 138N 610W,0,0,18,7,25
Hurricane,Ivan,13,2004-09-05T17:00:00Z,ST CROIX VI,0,0,0,16,16
Hurricane,Ivan,13,2004-09-05T17:00:00Z,TFFF 146N 610W,0,0,16,9,25
Hurricane,Ivan,13,2004-09-05T17:00:00Z,ST THOMAS VI,0,0,0,14,14
Hurricane,Ivan,13,2004-09-05T17:00:00Z,TDPR 153N 614W,0,0,11,12,23
Hurricane,Ivan,13,2004-09-05T17:00:00Z,SAN JUAN PR,0,0,0,13,13
Hurricane,Ivan,13,2004-09-05T17:00:00Z,80400 157N 636W,0,0,1,20,21
Hurricane,Ivan,13,2004-09-05T17:00:00Z,PONCE PR,0,0,0,14,14
Hurricane,Ivan,13,2004-09-05T17:00:00Z,TFFR 163N 615W,0,0,5,15,20
Hurricane,Ivan,14,2004-09-05T21:00:00Z,11.9N  54.0W,50,2,0,0,52
Hurricane,Ivan,14,2004-09-05T21:00:00Z,TAPA 171N 618W,0,0,7,10,17
Hurricane,Ivan,14,2004-09-05T21:00:00Z,12.8N  57.5W,0,34,1,1,36
Hurricane,Ivan,14,2004-09-05T21:00:00Z,TKPK 173N 627W,0,0,3,14,17
Hurricane,Ivan,14,2004-09-05T21:00:00Z,13.6N  61.0W,0,2,24,1,27
Hurricane,Ivan,14,2004-09-05T21:00:00Z,TNCM 181N 631W,0,0,1,13,14
Hurricane,Ivan,14,2004-09-05T21:00:00Z,TNCC 122N 690W,0,0,0,4,4
Hurricane,Ivan,14,2004-09-05T21:00:00Z,TISX 177N 648W,0,0,0,17,17
Hurricane,Ivan,14,2004-09-05T21:00:00Z,SVMG 110N 640W,0,0,3,5,8
Hurricane,Ivan,14,2004-09-05T21:00:00Z,TIST 183N 650W,0,0,0,15,15
Hurricane,Ivan,14,2004-09-05T21:00:00Z,TTPP 106N 614W,0,1,6,2,9
Hurricane,Ivan,14,2004-09-05T21:00:00Z,TJPS 180N 666W,0,0,0,16,16
Hurricane,Ivan,14,2004-09-05T21:00:00Z,TTPT 112N 608W,0,2,11,1,14
Hurricane,Ivan,14,2004-09-05T21:00:00Z,MDSD 185N 697W,0,0,0,10,10
Hurricane,Ivan,14,2004-09-05T21:00:00Z,TGPY 120N 618W,0,1,15,2,18
Hurricane,Ivan,14,2004-09-05T21:00:00Z,MDCB 176N 714W,0,0,0,6,6
Hurricane,Ivan,14,2004-09-05T21:00:00Z,TBPB 131N 595W,0,15,15,0,30
Hurricane,Ivan,14,2004-09-05T21:00:00Z,MTPP 186N 724W,0,0,0,3,3
Hurricane,Ivan,14,2004-09-05T21:00:00Z,TVSV 131N 612W,0,2,22,1,25
Hurricane,Ivan,14,2004-09-05T21:00:00Z,TJSJ 184N 661W,0,0,0,15,15
Hurricane,Ivan,14,2004-09-05T21:00:00Z,TLPL 138N 610W,0,2,24,1,27
Hurricane,Ivan,14,2004-09-05T21:00:00Z,MDPP 198N 707W,0,0,0,4,4
Hurricane,Ivan,14,2004-09-05T21:00:00Z,TFFF 146N 610W,0,1,24,2,27
Hurricane,Ivan,14,2004-09-05T21:00:00Z,ST CROIX VI,0,0,0,17,17
Hurricane,Ivan,14,2004-09-05T21:00:00Z,TDPR 153N 614W,0,0,21,3,24
Hurricane,Ivan,14,2004-09-05T21:00:00Z,ST THOMAS VI,0,0,0,15,15
Hurricane,Ivan,14,2004-09-05T21:00:00Z,80400 157N 636W,0,0,7,15,22
Hurricane,Ivan,14,2004-09-05T21:00:00Z,SAN JUAN PR,0,0,0,15,15
Hurricane,Ivan,14,2004-09-05T21:00:00Z,TFFR 163N 615W,0,0,14,6,20
Hurricane,Ivan,14,2004-09-05T21:00:00Z,PONCE PR,0,0,0,16,16
Hurricane,Ivan,15,2004-09-06T03:00:00Z,12.2N  55.6W,52,1,0,0,53
Hurricane,Ivan,15,2004-09-06T03:00:00Z,TKPK 173N 627W,0,0,7,11,18
Hurricane,Ivan,15,2004-09-06T03:00:00Z,13.0N  58.9W,0,34,0,0,34
Hurricane,Ivan,15,2004-09-06T03:00:00Z,TNCM 181N 631W,0,0,2,13,15
Hurricane,Ivan,15,2004-09-06T03:00:00Z,13.8N  61.7W,0,6,19,1,26
Hurricane,Ivan,15,2004-09-06T03:00:00Z,TISX 177N 648W,0,0,1,17,18
Hurricane,Ivan,15,2004-09-06T03:00:00Z,TNCC 122N 690W,0,0,0,4,4
Hurricane,Ivan,15,2004-09-06T03:00:00Z,TIST 183N 650W,0,0,0,17,17
Hurricane,Ivan,15,2004-09-06T03:00:00Z,SVMG 110N 640W,0,0,4,4,8
Hurricane,Ivan,15,2004-09-06T03:00:00Z,TJPS 180N 666W,0,0,0,19,19
Hurricane,Ivan,15,2004-09-06T03:00:00Z,TTPP 106N 614W,0,3,5,1,9
Hurricane,Ivan,15,2004-09-06T03:00:00Z,MDSD 185N 697W,0,0,0,13,13
Hurricane,Ivan,15,2004-09-06T03:00:00Z,TTPT 112N 608W,0,9,6,0,15
Hurricane,Ivan,15,2004-09-06T03:00:00Z,MDCB 176N 714W,0,0,0,8,8
Hurricane,Ivan,15,2004-09-06T03:00:00Z,TGPY 120N 618W,0,5,13,0,18
Hurricane,Ivan,15,2004-09-06T03:00:00Z,MTPP 186N 724W,0,0,0,4,4
Hurricane,Ivan,15,2004-09-06T03:00:00Z,TBPB 131N 595W,0,30,2,0,32
Hurricane,Ivan,15,2004-09-06T03:00:00Z,MTCA 183N 738W,0,0,0,2,2
Hurricane,Ivan,15,2004-09-06T03:00:00Z,TVSV 131N 612W,0,12,13,0,25
Hurricane,Ivan,15,2004-09-06T03:00:00Z,TJSJ 184N 661W,0,0,0,17,17
Hurricane,Ivan,15,2004-09-06T03:00:00Z,TLPL 138N 610W,0,13,14,0,27
Hurricane,Ivan,15,2004-09-06T03:00:00Z,MDPP 198N 707W,0,0,0,7,7
Hurricane,Ivan,15,2004-09-06T03:00:00Z,TFFF 146N 610W,0,9,17,1,27
Hurricane,Ivan,15,2004-09-06T03:00:00Z,MBJT 215N 712W,0,0,0,2,2
Hurricane,Ivan,15,2004-09-06T03:00:00Z,TDPR 153N 614W,0,3,20,2,25
Hurricane,Ivan,15,2004-09-06T03:00:00Z,ST CROIX VI,0,0,1,17,18
Hurricane,Ivan,15,2004-09-06T03:00:00Z,80400 157N 636W,0,0,12,11,23
Hurricane,Ivan,15,2004-09-06T03:00:00Z,ST THOMAS VI,0,0,0,17,17
Hurricane,Ivan,15,2004-09-06T03:00:00Z,TFFR 163N 615W,0,1,16,4,21
Hurricane,Ivan,15,2004-09-06T03:00:00Z,SAN JUAN PR,0,0,0,17,17
Hurricane,Ivan,15,2004-09-06T03:00:00Z,TAPA 171N 618W,0,0,10,8,18
Hurricane,Ivan,15,2004-09-06T03:00:00Z,PONCE PR,0,0,0,19,19
Hurricane,Ivan,16,2004-09-06T09:00:00Z,12.3N  57.5W,49,1,0,0,50
Hurricane,Ivan,16,2004-09-06T09:00:00Z,TNCM 181N 631W,0,0,7,7,14
Hurricane,Ivan,16,2004-09-06T09:00:00Z,13.2N  60.7W,1,33,0,1,35
Hurricane,Ivan,16,2004-09-06T09:00:00Z,TISX 177N 648W,0,0,6,13,19
Hurricane,Ivan,16,2004-09-06T09:00:00Z,14.3N  63.5W,0,5,21,0,26
Hurricane,Ivan,16,2004-09-06T09:00:00Z,TIST 183N 650W,0,0,3,14,17
Hurricane,Ivan,16,2004-09-06T09:00:00Z,SKPG 125N 717W,0,0,0,2,2
Hurricane,Ivan,16,2004-09-06T09:00:00Z,TJPS 180N 666W,0,0,1,18,19
Hurricane,Ivan,16,2004-09-06T09:00:00Z,TNCC 122N 690W,0,0,0,5,5
Hurricane,Ivan,16,2004-09-06T09:00:00Z,MDSD 185N 697W,0,0,0,18,18
Hurricane,Ivan,16,2004-09-06T09:00:00Z,SVMG 110N 640W,0,1,6,1,8
Hurricane,Ivan,16,2004-09-06T09:00:00Z,MDCB 176N 714W,0,0,0,15,15
Hurricane,Ivan,16,2004-09-06T09:00:00Z,TTPP 106N 614W,0,8,2,0,10
Hurricane,Ivan,16,2004-09-06T09:00:00Z,MTPP 186N 724W,0,0,0,12,12
Hurricane,Ivan,16,2004-09-06T09:00:00Z,TTPT 112N 608W,1,17,1,0,19
Hurricane,Ivan,16,2004-09-06T09:00:00Z,MTCA 183N 738W,0,0,0,7,7
Hurricane,Ivan,16,2004-09-06T09:00:00Z,TGPY 120N 618W,0,19,3,0,22
Hurricane,Ivan,16,2004-09-06T09:00:00Z,MUGM 200N 751W,0,0,0,3,3
Hurricane,Ivan,16,2004-09-06T09:00:00Z,TBPB 131N 595W,10,30,0,0,40
Hurricane,Ivan,16,2004-09-06T09:00:00Z,TJSJ 184N 661W,0,0,1,17,18
Hurricane,Ivan,16,2004-09-06T09:00:00Z,TVSV 131N 612W,0,30,2,0,32
Hurricane,Ivan,16,2004-09-06T09:00:00Z,MDPP 198N 707W,0,0,0,13,13
Hurricane,Ivan,16,2004-09-06T09:00:00Z,TLPL 138N 610W,0,32,1,0,33
Hurricane,Ivan,16,2004-09-06T09:00:00Z,MBJT 215N 712W,0,0,0,6,6
Hurricane,Ivan,16,2004-09-06T09:00:00Z,TFFF 146N 610W,0,27,4,0,31
Hurricane,Ivan,16,2004-09-06T09:00:00Z,MYMM 224N 730W,0,0,0,2,2
Hurricane,Ivan,16,2004-09-06T09:00:00Z,TDPR 153N 614W,0,17,10,0,27
Hurricane,Ivan,16,2004-09-06T09:00:00Z,ST CROIX VI,0,0,6,13,19
Hurricane,Ivan,16,2004-09-06T09:00:00Z,80400 157N 636W,0,1,21,3,25
Hurricane,Ivan,16,2004-09-06T09:00:00Z,ST THOMAS VI,0,0,3,14,17
Hurricane,Ivan,16,2004-09-06T09:00:00Z,TFFR 163N 615W,0,6,14,1,21
Hurricane,Ivan,16,2004-09-06T09:00:00Z,SAN JUAN PR,0,0,1,17,18
Hurricane,Ivan,16,2004-09-06T09:00:00Z,TAPA 171N 618W,0,2,13,2,17
Hurricane,Ivan,16,2004-09-06T09:00:00Z,PONCE PR,0,0,1,18,19
Hurricane,Ivan,16,2004-09-06T09:00:00Z,TKPK 173N 627W,0,0,13,5,18
Hurricane,Ivan,17,2004-09-06T15:00:00Z,12.7N  59.5W,50,1,0,0,51
Hurricane,Ivan,17,2004-09-06T15:00:00Z,TISX 177N 648W,0,0,15,4,19
Hurricane,Ivan,17,2004-09-06T15:00:00Z,13.7N  62.7W,1,33,0,1,35
Hurricane,Ivan,17,2004-09-06T15:00:00Z,TIST 183N 650W,0,0,10,7,17
Hurricane,Ivan,17,2004-09-06T15:00:00Z,15.0N  65.5W,0,5,21,0,26
Hurricane,Ivan,17,2004-09-06T15:00:00Z,TJPS 180N 666W,0,0,9,11,20
Hurricane,Ivan,17,2004-09-06T15:00:00Z,SKPG 125N 717W,0,0,0,3,3
Hurricane,Ivan,17,2004-09-06T15:00:00Z,MDSD 185N 697W,0,0,0,20,20
Hurricane,Ivan,17,2004-09-06T15:00:00Z,TNCC 122N 690W,0,0,2,4,6
Hurricane,Ivan,17,2004-09-06T15:00:00Z,MDCB 176N 714W,0,0,0,19,19
Hurricane,Ivan,17,2004-09-06T15:00:00Z,SVMG 110N 640W,0,5,3,0,8
Hurricane,Ivan,17,2004-09-06T15:00:00Z,MTPP 186N 724W,0,0,0,17,17
Hurricane,Ivan,17,2004-09-06T15:00:00Z,TTPP 106N 614W,3,6,0,0,9
Hurricane,Ivan,17,2004-09-06T15:00:00Z,MTCA 183N 738W,0,0,0,14,14
Hurricane,Ivan,17,2004-09-06T15:00:00Z,TTPT 112N 608W,12,9,0,0,21
Hurricane,Ivan,17,2004-09-06T15:00:00Z,MKJP 179N 768W,0,0,0,3,3
Hurricane,Ivan,17,2004-09-06T15:00:00Z,TGPY 120N 618W,6,21,0,1,28
Hurricane,Ivan,17,2004-09-06T15:00:00Z,MKJS 185N 779W,0,0,0,2,2
Hurricane,Ivan,17,2004-09-06T15:00:00Z,TBPB 131N 595W,50,2,0,0,52
Hurricane,Ivan,17,2004-09-06T15:00:00Z,MUGM 200N 751W,0,0,0,8,8
Hurricane,Ivan,17,2004-09-06T15:00:00Z,TVSV 131N 612W,17,23,0,0,40
Hurricane,Ivan,17,2004-09-06T15:00:00Z,TJSJ 184N 661W,0,0,8,10,18
Hurricane,Ivan,17,2004-09-06T15:00:00Z,TLPL 138N 610W,17,25,0,0,42
Hurricane,Ivan,17,2004-09-06T15:00:00Z,MDPP 198N 707W,0,0,0,17,17
Hurricane,Ivan,17,2004-09-06T15:00:00Z,TFFF 146N 610W,8,29,0,0,37
Hurricane,Ivan,17,2004-09-06T15:00:00Z,MBJT 215N 712W,0,0,0,10,10
Hurricane,Ivan,17,2004-09-06T15:00:00Z,TDPR 153N 614W,2,28,1,0,31
Hurricane,Ivan,17,2004-09-06T15:00:00Z,MYMM 224N 730W,0,0,0,5,5
Hurricane,Ivan,17,2004-09-06T15:00:00Z,80400 157N 636W,0,17,11,0,28
Hurricane,Ivan,17,2004-09-06T15:00:00Z,ST CROIX VI,0,0,15,4,19
Hurricane,Ivan,17,2004-09-06T15:00:00Z,TFFR 163N 615W,0,18,3,0,21
Hurricane,Ivan,17,2004-09-06T15:00:00Z,ST THOMAS VI,0,0,10,7,17
Hurricane,Ivan,17,2004-09-06T15:00:00Z,TAPA 171N 618W,0,8,7,1,16
Hurricane,Ivan,17,2004-09-06T15:00:00Z,SAN JUAN PR,0,0,8,10,18
Hurricane,Ivan,17,2004-09-06T15:00:00Z,TKPK 173N 627W,0,5,11,1,17
Hurricane,Ivan,17,2004-09-06T15:00:00Z,PONCE PR,0,0,9,11,20
Hurricane,Ivan,17,2004-09-06T15:00:00Z,TNCM 181N 631W,0,1,10,2,13
Hurricane,Ivan,18,2004-09-06T21:00:00Z,13.2N  61.5W,49,1,0,0,50
Hurricane,Ivan,18,2004-09-06T21:00:00Z,TIST 183N 650W,0,2,10,2,14
Hurricane,Ivan,18,2004-09-06T21:00:00Z,14.0N  64.4W,2,31,1,0,34
Hurricane,Ivan,18,2004-09-06T21:00:00Z,TJPS 180N 666W,0,1,15,3,19
Hurricane,Ivan,18,2004-09-06T21:00:00Z,15.0N  67.4W,0,5,21,1,27
Hurricane,Ivan,18,2004-09-06T21:00:00Z,MDSD 185N 697W,0,0,4,16,20
Hurricane,Ivan,18,2004-09-06T21:00:00Z,SKPG 125N 717W,0,0,1,5,6
Hurricane,Ivan,18,2004-09-06T21:00:00Z,MDCB 176N 714W,0,0,2,19,21
Hurricane,Ivan,18,2004-09-06T21:00:00Z,TNCC 122N 690W,0,0,7,3,10
Hurricane,Ivan,18,2004-09-06T21:00:00Z,MTPP 186N 724W,0,0,0,20,20
Hurricane,Ivan,18,2004-09-06T21:00:00Z,SVMG 110N 640W,1,7,1,0,9
Hurricane,Ivan,18,2004-09-06T21:00:00Z,MTCA 183N 738W,0,0,0,17,17
Hurricane,Ivan,18,2004-09-06T21:00:00Z,TTPP 106N 614W,5,1,0,0,6
Hurricane,Ivan,18,2004-09-06T21:00:00Z,MKJP 179N 768W,0,0,0,7,7
Hurricane,Ivan,18,2004-09-06T21:00:00Z,TTPT 112N 608W,17,1,0,0,18
Hurricane,Ivan,18,2004-09-06T21:00:00Z,MKJS 185N 779W,0,0,0,4,4
Hurricane,Ivan,18,2004-09-06T21:00:00Z,TGPY 120N 618W,30,3,0,0,33
Hurricane,Ivan,18,2004-09-06T21:00:00Z,MUGM 200N 751W,0,0,0,12,12
Hurricane,Ivan,18,2004-09-06T21:00:00Z,TBPB 131N 595W,68,0,0,0,68
Hurricane,Ivan,18,2004-09-06T21:00:00Z,MUCM 214N 779W,0,0,0,3,3
Hurricane,Ivan,18,2004-09-06T21:00:00Z,TVSV 131N 612W,52,0,0,0,52
Hurricane,Ivan,18,2004-09-06T21:00:00Z,TJSJ 184N 661W,0,1,12,3,16
Hurricane,Ivan,18,2004-09-06T21:00:00Z,TLPL 138N 610W,53,0,0,0,53
Hurricane,Ivan,18,2004-09-06T21:00:00Z,MDPP 198N 707W,0,0,0,17,17
Hurricane,Ivan,18,2004-09-06T21:00:00Z,TFFF 146N 610W,43,1,1,0,45
Hurricane,Ivan,18,2004-09-06T21:00:00Z,MBJT 215N 712W,0,0,0,11,11
Hurricane,Ivan,18,2004-09-06T21:00:00Z,TDPR 153N 614W,26,7,0,0,33
Hurricane,Ivan,18,2004-09-06T21:00:00Z,MYMM 224N 730W,0,0,0,7,7
Hurricane,Ivan,18,2004-09-06T21:00:00Z,80400 157N 636W,2,27,1,0,30
Hurricane,Ivan,18,2004-09-06T21:00:00Z,MYSM 241N 745W,0,0,0,2,2
Hurricane,Ivan,18,2004-09-06T21:00:00Z,TFFR 163N 615W,6,13,0,0,19
Hurricane,Ivan,18,2004-09-06T21:00:00Z,MYEG 235N 758W,0,0,0,2,2
Hurricane,Ivan,18,2004-09-06T21:00:00Z,TAPA 171N 618W,1,10,1,0,12
Hurricane,Ivan,18,2004-09-06T21:00:00Z,ST CROIX VI,0,5,12,0,17
Hurricane,Ivan,18,2004-09-06T21:00:00Z,TKPK 173N 627W,0,11,3,0,14
Hurricane,Ivan,18,2004-09-06T21:00:00Z,ST THOMAS VI,0,2,10,2,14
Hurricane,Ivan,18,2004-09-06T21:00:00Z,TNCM 181N 631W,0,4,5,0,9
Hurricane,Ivan,18,2004-09-06T21:00:00Z,SAN JUAN PR,0,1,12,3,16
Hurricane,Ivan,18,2004-09-06T21:00:00Z,TISX 177N 648W,0,5,12,0,17
Hurricane,Ivan,18,2004-09-06T21:00:00Z,PONCE PR,0,1,15,3,19
Hurricane,Ivan,19,2004-09-07T03:00:00Z,12.7N  62.9W,48,1,0,0,49
Hurricane,Ivan,19,2004-09-07T03:00:00Z,TIST 183N 650W,0,2,4,1,7
Hurricane,Ivan,19,2004-09-07T03:00:00Z,13.7N  66.1W,1,32,1,0,34
Hurricane,Ivan,19,2004-09-07T03:00:00Z,TJPS 180N 666W,0,2,10,2,14
Hurricane,Ivan,19,2004-09-07T03:00:00Z,14.7N  69.1W,0,4,22,0,26
Hurricane,Ivan,19,2004-09-07T03:00:00Z,MDSD 185N 697W,0,0,7,10,17
Hurricane,Ivan,19,2004-09-07T03:00:00Z,SKPG 125N 717W,0,0,5,6,11
Hurricane,Ivan,19,2004-09-07T03:00:00Z,MDCB 176N 714W,0,0,6,16,22
Hurricane,Ivan,19,2004-09-07T03:00:00Z,TNCC 122N 690W,0,4,11,0,15
Hurricane,Ivan,19,2004-09-07T03:00:00Z,MTPP 186N 724W,0,0,1,18,19
Hurricane,Ivan,19,2004-09-07T03:00:00Z,SVMG 110N 640W,11,8,0,0,19
Hurricane,Ivan,19,2004-09-07T03:00:00Z,MTCA 183N 738W,0,0,0,20,20
Hurricane,Ivan,19,2004-09-07T03:00:00Z,TTPP 106N 614W,19,0,0,0,19
Hurricane,Ivan,19,2004-09-07T03:00:00Z,MKJP 179N 768W,0,0,0,14,14
Hurricane,Ivan,19,2004-09-07T03:00:00Z,TTPT 112N 608W,48,0,0,0,48
Hurricane,Ivan,19,2004-09-07T03:00:00Z,MKJS 185N 779W,0,0,0,11,11
Hurricane,Ivan,19,2004-09-07T03:00:00Z,TGPY 120N 618W,54,0,0,0,54
Hurricane,Ivan,19,2004-09-07T03:00:00Z,MUGM 200N 751W,0,0,0,15,15
Hurricane,Ivan,19,2004-09-07T03:00:00Z,TBPB 131N 595W,71,0,0,0,71
Hurricane,Ivan,19,2004-09-07T03:00:00Z,MUCM 214N 779W,0,0,0,6,6
Hurricane,Ivan,19,2004-09-07T03:00:00Z,TVSV 131N 612W,62,0,0,0,62
Hurricane,Ivan,19,2004-09-07T03:00:00Z,TJSJ 184N 661W,0,2,7,1,10
Hurricane,Ivan,19,2004-09-07T03:00:00Z,TLPL 138N 610W,51,0,0,0,51
Hurricane,Ivan,19,2004-09-07T03:00:00Z,MDPP 198N 707W,0,0,1,12,13
Hurricane,Ivan,19,2004-09-07T03:00:00Z,TFFF 146N 610W,30,0,0,0,30
Hurricane,Ivan,19,2004-09-07T03:00:00Z,MBJT 215N 712W,0,0,0,6,6
Hurricane,Ivan,19,2004-09-07T03:00:00Z,TDPR 153N 614W,15,3,0,0,18
Hurricane,Ivan,19,2004-09-07T03:00:00Z,MYMM 224N 730W,0,0,0,4,4
Hurricane,Ivan,19,2004-09-07T03:00:00Z,80400 157N 636W,6,19,0,0,25
Hurricane,Ivan,19,2004-09-07T03:00:00Z,MYEG 235N 758W,0,0,0,2,2
Hurricane,Ivan,19,2004-09-07T03:00:00Z,TFFR 163N 615W,3,2,0,0,5
Hurricane,Ivan,19,2004-09-07T03:00:00Z,ST CROIX VI,0,5,5,0,10
Hurricane,Ivan,19,2004-09-07T03:00:00Z,TAPA 171N 618W,1,1,0,0,2
Hurricane,Ivan,19,2004-09-07T03:00:00Z,ST THOMAS VI,0,2,4,1,7
Hurricane,Ivan,19,2004-09-07T03:00:00Z,TKPK 173N 627W,0,3,1,0,4
Hurricane,Ivan,19,2004-09-07T03:00:00Z,SAN JUAN PR,0,2,7,1,10
Hurricane,Ivan,19,2004-09-07T03:00:00Z,TNCM 181N 631W,0,1,1,0,2
Hurricane,Ivan,19,2004-09-07T03:00:00Z,PONCE PR,0,2,10,2,14
Hurricane,Ivan,19,2004-09-07T03:00:00Z,TISX 177N 648W,0,5,5,0,10
Hurricane,Ivan,20,2004-09-07T09:00:00Z,13.0N  64.5W,50,1,0,0,51
Hurricane,Ivan,20,2004-09-07T09:00:00Z,MTPP 186N 724W,0,0,7,14,21
Hurricane,Ivan,20,2004-09-07T09:00:00Z,14.2N  67.6W,1,34,1,0,36
Hurricane,Ivan,20,2004-09-07T09:00:00Z,MTCA 183N 738W,0,0,3,19,22
Hurricane,Ivan,20,2004-09-07T09:00:00Z,15.5N  70.5W,0,6,21,1,28
Hurricane,Ivan,20,2004-09-07T09:00:00Z,MKJP 179N 768W,0,0,0,17,17
Hurricane,Ivan,20,2004-09-07T09:00:00Z,SKPG 125N 717W,0,1,7,2,10
Hurricane,Ivan,20,2004-09-07T09:00:00Z,MKJS 185N 779W,0,0,0,14,14
Hurricane,Ivan,20,2004-09-07T09:00:00Z,TNCC 122N 690W,0,11,4,1,16
Hurricane,Ivan,20,2004-09-07T09:00:00Z,MWCG 193N 814W,0,0,0,3,3
Hurricane,Ivan,20,2004-09-07T09:00:00Z,SVMG 110N 640W,19,1,0,0,20
Hurricane,Ivan,20,2004-09-07T09:00:00Z,MUGM 200N 751W,0,0,0,18,18
Hurricane,Ivan,20,2004-09-07T09:00:00Z,TTPP 106N 614W,17,0,0,0,17
Hurricane,Ivan,20,2004-09-07T09:00:00Z,MUCM 214N 779W,0,0,0,11,11
Hurricane,Ivan,20,2004-09-07T09:00:00Z,TTPT 112N 608W,61,0,0,0,61
Hurricane,Ivan,20,2004-09-07T09:00:00Z,MUCF 221N 805W,0,0,0,4,4
Hurricane,Ivan,20,2004-09-07T09:00:00Z,TGPY 120N 618W,73,0,0,0,73
Hurricane,Ivan,20,2004-09-07T09:00:00Z,TJSJ 184N 661W,0,2,4,0,6
Hurricane,Ivan,20,2004-09-07T09:00:00Z,TBPB 131N 595W,70,0,0,0,70
Hurricane,Ivan,20,2004-09-07T09:00:00Z,MDPP 198N 707W,0,0,4,10,14
Hurricane,Ivan,20,2004-09-07T09:00:00Z,TVSV 131N 612W,74,0,0,0,74
Hurricane,Ivan,20,2004-09-07T09:00:00Z,MBJT 215N 712W,0,0,0,7,7
Hurricane,Ivan,20,2004-09-07T09:00:00Z,TLPL 138N 610W,48,0,0,0,48
Hurricane,Ivan,20,2004-09-07T09:00:00Z,MYMM 224N 730W,0,0,0,7,7
Hurricane,Ivan,20,2004-09-07T09:00:00Z,TFFF 146N 610W,13,0,0,0,13
Hurricane,Ivan,20,2004-09-07T09:00:00Z,MYSM 241N 745W,0,0,0,2,2
Hurricane,Ivan,20,2004-09-07T09:00:00Z,TDPR 153N 614W,4,1,0,0,5
Hurricane,Ivan,20,2004-09-07T09:00:00Z,MYEG 235N 758W,0,0,0,5,5
Hurricane,Ivan,20,2004-09-07T09:00:00Z,80400 157N 636W,12,7,0,0,19
Hurricane,Ivan,20,2004-09-07T09:00:00Z,MYAK 241N 776W,0,0,0,3,3
Hurricane,Ivan,20,2004-09-07T09:00:00Z,TISX 177N 648W,0,3,2,0,5
Hurricane,Ivan,20,2004-09-07T09:00:00Z,ST CROIX VI,0,3,2,0,5
Hurricane,Ivan,20,2004-09-07T09:00:00Z,TIST 183N 650W,0,1,1,1,3
Hurricane,Ivan,20,2004-09-07T09:00:00Z,ST THOMAS VI,0,1,1,1,3
Hurricane,Ivan,20,2004-09-07T09:00:00Z,TJPS 180N 666W,0,4,7,0,11
Hurricane,Ivan,20,2004-09-07T09:00:00Z,SAN JUAN PR,0,2,4,0,6
Hurricane,Ivan,20,2004-09-07T09:00:00Z,MDSD 185N 697W,0,0,14,4,18
Hurricane,Ivan,20,2004-09-07T09:00:00Z,PONCE PR,0,4,7,0,11
Hurricane,Ivan,20,2004-09-07T09:00:00Z,MDCB 176N 714W,0,0,17,7,24
Hurricane,Ivan,21,2004-09-07T15:00:00Z,13.0N  65.6W,48,1,0,0,49
Hurricane,Ivan,21,2004-09-07T15:00:00Z,MDCB 176N 714W,0,0,17,4,21
Hurricane,Ivan,21,2004-09-07T15:00:00Z,14.0N  68.5W,1,32,1,0,34
Hurricane,Ivan,21,2004-09-07T15:00:00Z,MTPP 186N 724W,0,0,8,10,18
Hurricane,Ivan,21,2004-09-07T15:00:00Z,15.0N  71.5W,0,4,22,0,26
Hurricane,Ivan,21,2004-09-07T15:00:00Z,MTCA 183N 738W,0,0,5,15,20
Hurricane,Ivan,21,2004-09-07T15:00:00Z,SKPG 125N 717W,0,3,11,1,15
Hurricane,Ivan,21,2004-09-07T15:00:00Z,MKJP 179N 768W,0,0,0,18,18
Hurricane,Ivan,21,2004-09-07T15:00:00Z,TNCC 122N 690W,1,18,2,0,21
Hurricane,Ivan,21,2004-09-07T15:00:00Z,MKJS 185N 779W,0,0,0,16,16
Hurricane,Ivan,21,2004-09-07T15:00:00Z,SVMG 110N 640W,20,0,0,0,20
Hurricane,Ivan,21,2004-09-07T15:00:00Z,MWCG 193N 814W,0,0,0,5,5
Hurricane,Ivan,21,2004-09-07T15:00:00Z,TTPP 106N 614W,14,0,0,0,14
Hurricane,Ivan,21,2004-09-07T15:00:00Z,MUGM 200N 751W,0,0,0,16,16
Hurricane,Ivan,21,2004-09-07T15:00:00Z,TTPT 112N 608W,99,0,0,0,99
Hurricane,Ivan,21,2004-09-07T15:00:00Z,MUCM 214N 779W,0,0,0,10,10
Hurricane,Ivan,21,2004-09-07T15:00:00Z,TGPY 120N 618W,81,0,0,0,81
Hurricane,Ivan,21,2004-09-07T15:00:00Z,MUCF 221N 805W,0,0,0,3,3
Hurricane,Ivan,21,2004-09-07T15:00:00Z,TBPB 131N 595W,82,0,0,0,82
Hurricane,Ivan,21,2004-09-07T15:00:00Z,TJSJ 184N 661W,0,2,1,1,4
Hurricane,Ivan,21,2004-09-07T15:00:00Z,TVSV 131N 612W,86,0,0,0,86
Hurricane,Ivan,21,2004-09-07T15:00:00Z,MDPP 198N 707W,0,0,3,7,10
Hurricane,Ivan,21,2004-09-07T15:00:00Z,TLPL 138N 610W,55,0,0,0,55
Hurricane,Ivan,21,2004-09-07T15:00:00Z,MBJT 215N 712W,0,0,0,4,4
Hurricane,Ivan,21,2004-09-07T15:00:00Z,TFFF 146N 610W,10,0,0,0,10
Hurricane,Ivan,21,2004-09-07T15:00:00Z,MYMM 224N 730W,0,0,0,4,4
Hurricane,Ivan,21,2004-09-07T15:00:00Z,TDPR 153N 614W,3,0,0,0,3
Hurricane,Ivan,21,2004-09-07T15:00:00Z,MYEG 235N 758W,0,0,0,2,2
Hurricane,Ivan,21,2004-09-07T15:00:00Z,80400 157N 636W,11,2,0,0,13
Hurricane,Ivan,21,2004-09-07T15:00:00Z,ST CROIX VI,0,2,0,0,2
Hurricane,Ivan,21,2004-09-07T15:00:00Z,TISX 177N 648W,0,2,0,0,2
Hurricane,Ivan,21,2004-09-07T15:00:00Z,SAN JUAN PR,0,2,1,1,4
Hurricane,Ivan,21,2004-09-07T15:00:00Z,TJPS 180N 666W,0,4,3,1,8
Hurricane,Ivan,21,2004-09-07T15:00:00Z,PONCE PR,0,4,3,1,8
Hurricane,Ivan,21,2004-09-07T15:00:00Z,MDSD 185N 697W,0,1,11,2,14
Hurricane,Ivan,22,2004-09-07T21:00:00Z,13.5N  67.7W,52,1,0,0,53
Hurricane,Ivan,22,2004-09-07T21:00:00Z,MTCA 183N 738W,0,0,16,5,21
Hurricane,Ivan,22,2004-09-07T21:00:00Z,14.7N  70.7W,1,33,0,0,34
Hurricane,Ivan,22,2004-09-07T21:00:00Z,MKJP 179N 768W,0,0,5,15,20
Hurricane,Ivan,22,2004-09-07T21:00:00Z,16.0N  73.5W,0,4,22,0,26
Hurricane,Ivan,22,2004-09-07T21:00:00Z,MKJS 185N 779W,0,0,1,18,19
Hurricane,Ivan,22,2004-09-07T21:00:00Z,SKPG 125N 717W,0,12,2,0,14
Hurricane,Ivan,22,2004-09-07T21:00:00Z,MWCG 193N 814W,0,0,0,10,10
Hurricane,Ivan,22,2004-09-07T21:00:00Z,TNCC 122N 690W,16,9,0,0,25
Hurricane,Ivan,22,2004-09-07T21:00:00Z,MUGM 200N 751W,0,0,3,13,16
Hurricane,Ivan,22,2004-09-07T21:00:00Z,SVMG 110N 640W,19,0,0,0,19
Hurricane,Ivan,22,2004-09-07T21:00:00Z,MUCM 214N 779W,0,0,0,12,12
Hurricane,Ivan,22,2004-09-07T21:00:00Z,TTPP 106N 614W,15,0,0,0,15
Hurricane,Ivan,22,2004-09-07T21:00:00Z,MUCF 221N 805W,0,0,0,7,7
Hurricane,Ivan,22,2004-09-07T21:00:00Z,TTPT 112N 608W,99,0,0,0,99
Hurricane,Ivan,22,2004-09-07T21:00:00Z,MUSN 216N 826W,0,0,0,4,4
Hurricane,Ivan,22,2004-09-07T21:00:00Z,TGPY 120N 618W,99,0,0,0,99
Hurricane,Ivan,22,2004-09-07T21:00:00Z,MUHA 230N 824W,0,0,0,2,2
Hurricane,Ivan,22,2004-09-07T21:00:00Z,TVSV 131N 612W,93,0,0,0,93
Hurricane,Ivan,22,2004-09-07T21:00:00Z,MDPP 198N 707W,0,0,5,3,8
Hurricane,Ivan,22,2004-09-07T21:00:00Z,TLPL 138N 610W,12,0,0,0,12
Hurricane,Ivan,22,2004-09-07T21:00:00Z,MBJT 215N 712W,0,0,1,2,3
Hurricane,Ivan,22,2004-09-07T21:00:00Z,TJPS 180N 666W,0,2,0,0,2
Hurricane,Ivan,22,2004-09-07T21:00:00Z,MYMM 224N 730W,0,0,0,3,3
Hurricane,Ivan,22,2004-09-07T21:00:00Z,MDSD 185N 697W,0,5,6,1,12
Hurricane,Ivan,22,2004-09-07T21:00:00Z,MYEG 235N 758W,0,0,0,3,3
Hurricane,Ivan,22,2004-09-07T21:00:00Z,MDCB 176N 714W,0,9,13,1,23
Hurricane,Ivan,22,2004-09-07T21:00:00Z,MYAK 241N 776W,0,0,0,2,2
Hurricane,Ivan,22,2004-09-07T21:00:00Z,MTPP 186N 724W,0,1,15,3,19
Hurricane,Ivan,22,2004-09-07T21:00:00Z,PONCE PR,0,2,0,0,2
Hurricane,Ivan,23,2004-09-08T03:00:00Z,13.8N  68.8W,49,1,0,0,50
Hurricane,Ivan,23,2004-09-08T03:00:00Z,MUCM 214N 779W,0,0,0,16,16
Hurricane,Ivan,23,2004-09-08T03:00:00Z,14.9N  71.6W,2,31,1,0,34
Hurricane,Ivan,23,2004-09-08T03:00:00Z,MUCF 221N 805W,0,0,0,12,12
Hurricane,Ivan,23,2004-09-08T03:00:00Z,16.3N  74.2W,0,6,20,0,26
Hurricane,Ivan,23,2004-09-08T03:00:00Z,MUSN 216N 826W,0,0,0,8,8
Hurricane,Ivan,23,2004-09-08T03:00:00Z,SKPG 125N 717W,1,15,0,0,16
Hurricane,Ivan,23,2004-09-08T03:00:00Z,MUHA 230N 824W,0,0,0,6,6
Hurricane,Ivan,23,2004-09-08T03:00:00Z,TNCC 122N 690W,24,2,0,0,26
Hurricane,Ivan,23,2004-09-08T03:00:00Z,MUAN 219N 850W,0,0,0,2,2
Hurricane,Ivan,23,2004-09-08T03:00:00Z,SVMG 110N 640W,18,0,0,0,18
Hurricane,Ivan,23,2004-09-08T03:00:00Z,MDPP 198N 707W,0,1,5,2,8
Hurricane,Ivan,23,2004-09-08T03:00:00Z,TGPY 120N 618W,99,0,0,0,99
Hurricane,Ivan,23,2004-09-08T03:00:00Z,MBJT 215N 712W,0,0,1,2,3
Hurricane,Ivan,23,2004-09-08T03:00:00Z,MDSD 185N 697W,0,7,4,0,11
Hurricane,Ivan,23,2004-09-08T03:00:00Z,MYMM 224N 730W,0,0,1,4,5
Hurricane,Ivan,23,2004-09-08T03:00:00Z,MDCB 176N 714W,0,17,7,0,24
Hurricane,Ivan,23,2004-09-08T03:00:00Z,MYSM 241N 745W,0,0,0,2,2
Hurricane,Ivan,23,2004-09-08T03:00:00Z,MTPP 186N 724W,0,4,15,1,20
Hurricane,Ivan,23,2004-09-08T03:00:00Z,MYEG 235N 758W,0,0,0,6,6
Hurricane,Ivan,23,2004-09-08T03:00:00Z,MTCA 183N 738W,0,2,19,2,23
Hurricane,Ivan,23,2004-09-08T03:00:00Z,MYAK 241N 776W,0,0,0,5,5
Hurricane,Ivan,23,2004-09-08T03:00:00Z,MKJP 179N 768W,0,0,9,13,22
Hurricane,Ivan,23,2004-09-08T03:00:00Z,MYNN 251N 775W,0,0,0,2,2
Hurricane,Ivan,23,2004-09-08T03:00:00Z,MKJS 185N 779W,0,0,3,17,20
Hurricane,Ivan,23,2004-09-08T03:00:00Z,MARATHON FL,0,0,0,3,3
Hurricane,Ivan,23,2004-09-08T03:00:00Z,MWCG 193N 814W,0,0,0,12,12
Hurricane,Ivan,23,2004-09-08T03:00:00Z,KEY WEST FL,0,0,0,3,3
Hurricane,Ivan,23,2004-09-08T03:00:00Z,MUGM 200N 751W,0,0,7,11,18
Hurricane,Ivan,24,2004-09-08T09:00:00Z,14.2N  70.1W,47,1,0,0,48
Hurricane,Ivan,24,2004-09-08T09:00:00Z,MUHA 230N 824W,0,0,0,8,8
Hurricane,Ivan,24,2004-09-08T09:00:00Z,15.5N  72.5W,3,32,0,0,35
Hurricane,Ivan,24,2004-09-08T09:00:00Z,MUAN 219N 850W,0,0,0,3,3
Hurricane,Ivan,24,2004-09-08T09:00:00Z,16.8N  75.0W,0,10,19,0,29
Hurricane,Ivan,24,2004-09-08T09:00:00Z,MDPP 198N 707W,0,2,3,0,5
Hurricane,Ivan,24,2004-09-08T09:00:00Z,SKPG 125N 717W,10,6,0,0,16
Hurricane,Ivan,24,2004-09-08T09:00:00Z,MBJT 215N 712W,0,0,1,1,2
Hurricane,Ivan,24,2004-09-08T09:00:00Z,TNCC 122N 690W,21,0,0,0,21
Hurricane,Ivan,24,2004-09-08T09:00:00Z,MYMM 224N 730W,0,0,1,3,4
Hurricane,Ivan,24,2004-09-08T09:00:00Z,MDSD 185N 697W,0,5,2,0,7
Hurricane,Ivan,24,2004-09-08T09:00:00Z,MYSM 241N 745W,0,0,0,3,3
Hurricane,Ivan,24,2004-09-08T09:00:00Z,MDCB 176N 714W,0,22,2,0,24
Hurricane,Ivan,24,2004-09-08T09:00:00Z,MYEG 235N 758W,0,0,0,8,8
Hurricane,Ivan,24,2004-09-08T09:00:00Z,MTPP 186N 724W,0,12,9,0,21
Hurricane,Ivan,24,2004-09-08T09:00:00Z,MYAK 241N 776W,0,0,0,9,9
Hurricane,Ivan,24,2004-09-08T09:00:00Z,MTCA 183N 738W,0,10,16,1,27
Hurricane,Ivan,24,2004-09-08T09:00:00Z,MYNN 251N 775W,0,0,0,5,5
Hurricane,Ivan,24,2004-09-08T09:00:00Z,MKJP 179N 768W,0,0,19,5,24
Hurricane,Ivan,24,2004-09-08T09:00:00Z,MYGF 266N 787W,0,0,0,2,2
Hurricane,Ivan,24,2004-09-08T09:00:00Z,MKJS 185N 779W,0,0,10,12,22
Hurricane,Ivan,24,2004-09-08T09:00:00Z,MARATHON FL,0,0,0,6,6
Hurricane,Ivan,24,2004-09-08T09:00:00Z,MWCG 193N 814W,0,0,0,13,13
Hurricane,Ivan,24,2004-09-08T09:00:00Z,MIAMI FL,0,0,0,4,4
Hurricane,Ivan,24,2004-09-08T09:00:00Z,MUGM 200N 751W,0,0,16,5,21
Hurricane,Ivan,24,2004-09-08T09:00:00Z,W PALM BEACH FL,0,0,0,2,2
Hurricane,Ivan,24,2004-09-08T09:00:00Z,MUCM 214N 779W,0,0,2,16,18
Hurricane,Ivan,24,2004-09-08T09:00:00Z,KEY WEST FL,0,0,0,6,6
Hurricane,Ivan,24,2004-09-08T09:00:00Z,MUCF 221N 805W,0,0,0,13,13
Hurricane,Ivan,24,2004-09-08T09:00:00Z,MARCO ISLAND FL,0,0,0,3,3
Hurricane,Ivan,24,2004-09-08T09:00:00Z,MUSN 216N 826W,0,0,0,9,9
Hurricane,Ivan,24,2004-09-08T09:00:00Z,FT MYERS FL,0,0,0,2,2
Hurricane,Ivan,25,2004-09-08T15:00:00Z,14.5N  71.0W,47,0,0,0,47
Hurricane,Ivan,25,2004-09-08T15:00:00Z,MUAN 219N 850W,0,0,0,4,4
Hurricane,Ivan,25,2004-09-08T15:00:00Z,16.0N  73.5W,2,31,0,0,33
Hurricane,Ivan,25,2004-09-08T15:00:00Z,MDPP 198N 707W,0,2,2,1,5
Hurricane,Ivan,25,2004-09-08T15:00:00Z,17.5N  76.0W,0,7,19,1,27
Hurricane,Ivan,25,2004-09-08T15:00:00Z,MBJT 215N 712W,0,0,1,1,2
Hurricane,Ivan,25,2004-09-08T15:00:00Z,SKPG 125N 717W,14,2,0,0,16
Hurricane,Ivan,25,2004-09-08T15:00:00Z,MYMM 224N 730W,0,0,2,2,4
Hurricane,Ivan,25,2004-09-08T15:00:00Z,TNCC 122N 690W,25,0,0,0,25
Hurricane,Ivan,25,2004-09-08T15:00:00Z,MYSM 241N 745W,0,0,0,3,3
Hurricane,Ivan,25,2004-09-08T15:00:00Z,MDSD 185N 697W,1,4,0,0,5
Hurricane,Ivan,25,2004-09-08T15:00:00Z,MYEG 235N 758W,0,0,1,7,8
Hurricane,Ivan,25,2004-09-08T15:00:00Z,MDCB 176N 714W,3,19,1,0,23
Hurricane,Ivan,25,2004-09-08T15:00:00Z,MYAK 241N 776W,0,0,0,9,9
Hurricane,Ivan,25,2004-09-08T15:00:00Z,MTPP 186N 724W,0,16,4,0,20
Hurricane,Ivan,25,2004-09-08T15:00:00Z,MYNN 251N 775W,0,0,0,5,5
Hurricane,Ivan,25,2004-09-08T15:00:00Z,MTCA 183N 738W,0,18,8,0,26
Hurricane,Ivan,25,2004-09-08T15:00:00Z,MYGF 266N 787W,0,0,0,2,2
Hurricane,Ivan,25,2004-09-08T15:00:00Z,MKJP 179N 768W,0,2,21,2,25
Hurricane,Ivan,25,2004-09-08T15:00:00Z,MARATHON FL,0,0,0,8,8
Hurricane,Ivan,25,2004-09-08T15:00:00Z,MKJS 185N 779W,0,0,17,5,22
Hurricane,Ivan,25,2004-09-08T15:00:00Z,MIAMI FL,0,0,0,5,5
Hurricane,Ivan,25,2004-09-08T15:00:00Z,MWCG 193N 814W,0,0,1,13,14
Hurricane,Ivan,25,2004-09-08T15:00:00Z,W PALM BEACH FL,0,0,0,3,3
Hurricane,Ivan,25,2004-09-08T15:00:00Z,MUGM 200N 751W,0,1,17,2,20
Hurricane,Ivan,25,2004-09-08T15:00:00Z,KEY WEST FL,0,0,0,8,8
Hurricane,Ivan,25,2004-09-08T15:00:00Z,MUCM 214N 779W,0,0,6,12,18
Hurricane,Ivan,25,2004-09-08T15:00:00Z,MARCO ISLAND FL,0,0,0,4,4
Hurricane,Ivan,25,2004-09-08T15:00:00Z,MUCF 221N 805W,0,0,0,15,15
Hurricane,Ivan,25,2004-09-08T15:00:00Z,FT MYERS FL,0,0,0,3,3
Hurricane,Ivan,25,2004-09-08T15:00:00Z,MUSN 216N 826W,0,0,0,11,11
Hurricane,Ivan,25,2004-09-08T15:00:00Z,VENICE FL,0,0,0,2,2
Hurricane,Ivan,25,2004-09-08T15:00:00Z,MUHA 230N 824W,0,0,0,10,10
Hurricane,Ivan,26,2004-09-08T21:00:00Z,15.5N  72.5W,46,0,0,0,46
Hurricane,Ivan,26,2004-09-08T21:00:00Z,MDPP 198N 707W,0,2,0,0,2
Hurricane,Ivan,26,2004-09-08T21:00:00Z,17.0N  74.7W,4,29,0,0,33
Hurricane,Ivan,26,2004-09-08T21:00:00Z,MYMM 224N 730W,0,0,2,2,4
Hurricane,Ivan,26,2004-09-08T21:00:00Z,18.5N  77.0W,0,11,17,0,28
Hurricane,Ivan,26,2004-09-08T21:00:00Z,MYSM 241N 745W,0,0,1,3,4
Hurricane,Ivan,26,2004-09-08T21:00:00Z,SKPG 125N 717W,2,0,0,0,2
Hurricane,Ivan,26,2004-09-08T21:00:00Z,MYEG 235N 758W,0,0,3,7,10
Hurricane,Ivan,26,2004-09-08T21:00:00Z,TNCC 122N 690W,2,0,0,0,2
Hurricane,Ivan,26,2004-09-08T21:00:00Z,MYAK 241N 776W,0,0,2,10,12
Hurricane,Ivan,26,2004-09-08T21:00:00Z,MDSD 185N 697W,1,1,0,0,2
Hurricane,Ivan,26,2004-09-08T21:00:00Z,MYNN 251N 775W,0,0,0,8,8
Hurricane,Ivan,26,2004-09-08T21:00:00Z,MDCB 176N 714W,16,6,0,1,23
Hurricane,Ivan,26,2004-09-08T21:00:00Z,MYGF 266N 787W,0,0,0,5,5
Hurricane,Ivan,26,2004-09-08T21:00:00Z,MTPP 186N 724W,2,17,1,0,20
Hurricane,Ivan,26,2004-09-08T21:00:00Z,MARATHON FL,0,0,0,11,11
Hurricane,Ivan,26,2004-09-08T21:00:00Z,MTCA 183N 738W,1,27,1,0,29
Hurricane,Ivan,26,2004-09-08T21:00:00Z,MIAMI FL,0,0,0,8,8
Hurricane,Ivan,26,2004-09-08T21:00:00Z,MKJP 179N 768W,0,16,12,1,29
Hurricane,Ivan,26,2004-09-08T21:00:00Z,W PALM BEACH FL,0,0,0,6,6
Hurricane,Ivan,26,2004-09-08T21:00:00Z,MKJS 185N 779W,0,4,20,1,25
Hurricane,Ivan,26,2004-09-08T21:00:00Z,FT PIERCE FL,0,0,0,4,4
Hurricane,Ivan,26,2004-09-08T21:00:00Z,MWCG 193N 814W,0,0,3,13,16
Hurricane,Ivan,26,2004-09-08T21:00:00Z,COCOA BEACH FL,0,0,0,2,2
Hurricane,Ivan,26,2004-09-08T21:00:00Z,MUGM 200N 751W,0,10,13,1,24
Hurricane,Ivan,26,2004-09-08T21:00:00Z,KEY WEST FL,0,0,0,11,11
Hurricane,Ivan,26,2004-09-08T21:00:00Z,MUCM 214N 779W,0,0,15,6,21
Hurricane,Ivan,26,2004-09-08T21:00:00Z,MARCO ISLAND FL,0,0,0,7,7
Hurricane,Ivan,26,2004-09-08T21:00:00Z,MUCF 221N 805W,0,0,3,15,18
Hurricane,Ivan,26,2004-09-08T21:00:00Z,FT MYERS FL,0,0,0,6,6
Hurricane,Ivan,26,2004-09-08T21:00:00Z,MUSN 216N 826W,0,0,0,13,13
Hurricane,Ivan,26,2004-09-08T21:00:00Z,VENICE FL,0,0,0,4,4
Hurricane,Ivan,26,2004-09-08T21:00:00Z,MUHA 230N 824W,0,0,0,13,13
Hurricane,Ivan,26,2004-09-08T21:00:00Z,TAMPA FL,0,0,0,2,2
Hurricane,Ivan,26,2004-09-08T21:00:00Z,MUAN 219N 850W,0,0,0,6,6
Hurricane,Ivan,27,2004-09-09T03:00:00Z,15.9N  73.4W,47,0,0,0,47
Hurricane,Ivan,27,2004-09-09T03:00:00Z,MYSM 241N 745W,0,0,1,3,4
Hurricane,Ivan,27,2004-09-09T03:00:00Z,17.4N  75.6W,4,29,0,0,33
Hurricane,Ivan,27,2004-09-09T03:00:00Z,MYEG 235N 758W,0,0,3,7,10
Hurricane,Ivan,27,2004-09-09T03:00:00Z,18.6N  77.5W,0,17,8,1,26
Hurricane,Ivan,27,2004-09-09T03:00:00Z,MYAK 241N 776W,0,0,2,10,12
Hurricane,Ivan,27,2004-09-09T03:00:00Z,MDCB 176N 714W,20,1,0,0,21
Hurricane,Ivan,27,2004-09-09T03:00:00Z,MYNN 251N 775W,0,0,1,8,9
Hurricane,Ivan,27,2004-09-09T03:00:00Z,MTPP 186N 724W,8,10,0,1,19
Hurricane,Ivan,27,2004-09-09T03:00:00Z,MYGF 266N 787W,0,0,0,6,6
Hurricane,Ivan,27,2004-09-09T03:00:00Z,MTCA 183N 738W,9,20,0,0,29
Hurricane,Ivan,27,2004-09-09T03:00:00Z,MARATHON FL,0,0,0,12,12
Hurricane,Ivan,27,2004-09-09T03:00:00Z,MKJP 179N 768W,0,25,3,0,28
Hurricane,Ivan,27,2004-09-09T03:00:00Z,MIAMI FL,0,0,0,9,9
Hurricane,Ivan,27,2004-09-09T03:00:00Z,MKJS 185N 779W,0,13,11,1,25
Hurricane,Ivan,27,2004-09-09T03:00:00Z,W PALM BEACH FL,0,0,0,6,6
Hurricane,Ivan,27,2004-09-09T03:00:00Z,MWCG 193N 814W,0,0,6,10,16
Hurricane,Ivan,27,2004-09-09T03:00:00Z,FT PIERCE FL,0,0,0,4,4
Hurricane,Ivan,27,2004-09-09T03:00:00Z,MUGM 200N 751W,0,16,5,1,22
Hurricane,Ivan,27,2004-09-09T03:00:00Z,COCOA BEACH FL,0,0,0,3,3
Hurricane,Ivan,27,2004-09-09T03:00:00Z,MUCM 214N 779W,0,1,15,5,21
Hurricane,Ivan,27,2004-09-09T03:00:00Z,KEY WEST FL,0,0,0,12,12
Hurricane,Ivan,27,2004-09-09T03:00:00Z,MUCF 221N 805W,0,0,5,13,18
Hurricane,Ivan,27,2004-09-09T03:00:00Z,MARCO ISLAND FL,0,0,0,8,8
Hurricane,Ivan,27,2004-09-09T03:00:00Z,MUSN 216N 826W,0,0,1,13,14
Hurricane,Ivan,27,2004-09-09T03:00:00Z,FT MYERS FL,0,0,0,6,6
Hurricane,Ivan,27,2004-09-09T03:00:00Z,MUHA 230N 824W,0,0,0,13,13
Hurricane,Ivan,27,2004-09-09T03:00:00Z,VENICE FL,0,0,0,4,4
Hurricane,Ivan,27,2004-09-09T03:00:00Z,MUAN 219N 850W,0,0,0,6,6
Hurricane,Ivan,27,2004-09-09T03:00:00Z,TAMPA FL,0,0,0,3,3
Hurricane,Ivan,27,2004-09-09T03:00:00Z,MYMM 224N 730W,0,0,2,2,4
Hurricane,Ivan,28,2004-09-09T09:00:00Z,16.2N  74.3W,46,0,0,0,46
Hurricane,Ivan,28,2004-09-09T09:00:00Z,MYSM 241N 745W,0,0,1,2,3
Hurricane,Ivan,28,2004-09-09T09:00:00Z,17.6N  76.4W,5,27,1,0,33
Hurricane,Ivan,28,2004-09-09T09:00:00Z,MYEG 235N 758W,0,0,4,5,9
Hurricane,Ivan,28,2004-09-09T09:00:00Z,19.1N  78.3W,0,15,12,1,28
Hurricane,Ivan,28,2004-09-09T09:00:00Z,MYAK 241N 776W,0,0,4,8,12
Hurricane,Ivan,28,2004-09-09T09:00:00Z,MDCB 176N 714W,12,1,0,0,13
Hurricane,Ivan,28,2004-09-09T09:00:00Z,MYNN 251N 775W,0,0,1,8,9
Hurricane,Ivan,28,2004-09-09T09:00:00Z,MTPP 186N 724W,9,4,1,0,14
Hurricane,Ivan,28,2004-09-09T09:00:00Z,MYGF 266N 787W,0,0,0,6,6
Hurricane,Ivan,28,2004-09-09T09:00:00Z,MTCA 183N 738W,19,8,1,0,28
Hurricane,Ivan,28,2004-09-09T09:00:00Z,MARATHON FL,0,0,1,12,13
Hurricane,Ivan,28,2004-09-09T09:00:00Z,MKJP 179N 768W,1,30,0,0,31
Hurricane,Ivan,28,2004-09-09T09:00:00Z,MIAMI FL,0,0,0,10,10
Hurricane,Ivan,28,2004-09-09T09:00:00Z,MKJS 185N 779W,0,22,6,0,28
Hurricane,Ivan,28,2004-09-09T09:00:00Z,W PALM BEACH FL,0,0,0,7,7
Hurricane,Ivan,28,2004-09-09T09:00:00Z,MWCG 193N 814W,0,0,10,7,17
Hurricane,Ivan,28,2004-09-09T09:00:00Z,FT PIERCE FL,0,0,0,5,5
Hurricane,Ivan,28,2004-09-09T09:00:00Z,MUGM 200N 751W,0,17,3,1,21
Hurricane,Ivan,28,2004-09-09T09:00:00Z,COCOA BEACH FL,0,0,0,3,3
Hurricane,Ivan,28,2004-09-09T09:00:00Z,MUCM 214N 779W,0,2,17,3,22
Hurricane,Ivan,28,2004-09-09T09:00:00Z,DAYTONA BEACH FL,0,0,0,2,2
Hurricane,Ivan,28,2004-09-09T09:00:00Z,MUCF 221N 805W,0,0,10,10,20
Hurricane,Ivan,28,2004-09-09T09:00:00Z,KEY WEST FL,0,0,1,12,13
Hurricane,Ivan,28,2004-09-09T09:00:00Z,MUSN 216N 826W,0,0,3,12,15
Hurricane,Ivan,28,2004-09-09T09:00:00Z,MARCO ISLAND FL,0,0,0,9,9
Hurricane,Ivan,28,2004-09-09T09:00:00Z,MUHA 230N 824W,0,0,1,14,15
Hurricane,Ivan,28,2004-09-09T09:00:00Z,FT MYERS FL,0,0,0,7,7
Hurricane,Ivan,28,2004-09-09T09:00:00Z,MUAN 219N 850W,0,0,0,7,7
Hurricane,Ivan,28,2004-09-09T09:00:00Z,VENICE FL,0,0,0,5,5
Hurricane,Ivan,28,2004-09-09T09:00:00Z,MMCZ 205N 869W,0,0,0,2,2
Hurricane,Ivan,28,2004-09-09T09:00:00Z,TAMPA FL,0,0,0,3,3
Hurricane,Ivan,28,2004-09-09T09:00:00Z,MYMM 224N 730W,0,0,1,1,2
Hurricane,Ivan,29,2004-09-09T15:00:00Z,17.0N  75.2W,46,0,0,0,46
Hurricane,Ivan,29,2004-09-09T15:00:00Z,MYSM 241N 745W,0,0,1,2,3
Hurricane,Ivan,29,2004-09-09T15:00:00Z,18.5N  77.3W,5,28,0,0,33
Hurricane,Ivan,29,2004-09-09T15:00:00Z,MYEG 235N 758W,0,0,3,5,8
Hurricane,Ivan,29,2004-09-09T15:00:00Z,19.5N  79.0W,0,19,6,2,27
Hurricane,Ivan,29,2004-09-09T15:00:00Z,MYAK 241N 776W,0,0,4,7,11
Hurricane,Ivan,29,2004-09-09T15:00:00Z,MDCB 176N 714W,3,0,0,0,3
Hurricane,Ivan,29,2004-09-09T15:00:00Z,MYNN 251N 775W,0,0,1,7,8
Hurricane,Ivan,29,2004-09-09T15:00:00Z,MTPP 186N 724W,7,2,0,0,9
Hurricane,Ivan,29,2004-09-09T15:00:00Z,MYGF 266N 787W,0,0,0,5,5
Hurricane,Ivan,29,2004-09-09T15:00:00Z,MTCA 183N 738W,29,1,0,0,30
Hurricane,Ivan,29,2004-09-09T15:00:00Z,MARATHON FL,0,0,1,12,13
Hurricane,Ivan,29,2004-09-09T15:00:00Z,MKJP 179N 768W,18,17,0,1,36
Hurricane,Ivan,29,2004-09-09T15:00:00Z,MIAMI FL,0,0,0,10,10
Hurricane,Ivan,29,2004-09-09T15:00:00Z,MKJS 185N 779W,2,28,0,0,30
Hurricane,Ivan,29,2004-09-09T15:00:00Z,W PALM BEACH FL,0,0,0,7,7
Hurricane,Ivan,29,2004-09-09T15:00:00Z,MWCG 193N 814W,0,2,12,5,19
Hurricane,Ivan,29,2004-09-09T15:00:00Z,FT PIERCE FL,0,0,0,5,5
Hurricane,Ivan,29,2004-09-09T15:00:00Z,MUGM 200N 751W,3,18,0,1,22
Hurricane,Ivan,29,2004-09-09T15:00:00Z,COCOA BEACH FL,0,0,0,3,3
Hurricane,Ivan,29,2004-09-09T15:00:00Z,MUCM 214N 779W,0,10,10,2,22
Hurricane,Ivan,29,2004-09-09T15:00:00Z,DAYTONA BEACH FL,0,0,0,2,2
Hurricane,Ivan,29,2004-09-09T15:00:00Z,MUCF 221N 805W,0,0,13,7,20
Hurricane,Ivan,29,2004-09-09T15:00:00Z,KEY WEST FL,0,0,1,12,13
Hurricane,Ivan,29,2004-09-09T15:00:00Z,MUSN 216N 826W,0,0,6,11,17
Hurricane,Ivan,29,2004-09-09T15:00:00Z,MARCO ISLAND FL,0,0,0,9,9
Hurricane,Ivan,29,2004-09-09T15:00:00Z,MUHA 230N 824W,0,0,3,13,16
Hurricane,Ivan,29,2004-09-09T15:00:00Z,FT MYERS FL,0,0,0,7,7
Hurricane,Ivan,29,2004-09-09T15:00:00Z,MUAN 219N 850W,0,0,0,9,9
Hurricane,Ivan,29,2004-09-09T15:00:00Z,VENICE FL,0,0,0,6,6
Hurricane,Ivan,29,2004-09-09T15:00:00Z,MMCZ 205N 869W,0,0,0,3,3
Hurricane,Ivan,29,2004-09-09T15:00:00Z,TAMPA FL,0,0,0,4,4
Hurricane,Ivan,29,2004-09-09T15:00:00Z,MYMM 224N 730W,0,0,1,1,2
Hurricane,Ivan,29,2004-09-09T15:00:00Z,CEDAR KEY FL,0,0,0,2,2
Hurricane,Ivan,30,2004-09-09T21:00:00Z,17.5N  76.2W,47,0,0,0,47
Hurricane,Ivan,30,2004-09-09T21:00:00Z,MYAK 241N 776W,0,0,5,6,11
Hurricane,Ivan,30,2004-09-09T21:00:00Z,18.8N  78.0W,11,22,0,1,34
Hurricane,Ivan,30,2004-09-09T21:00:00Z,MYNN 251N 775W,0,0,1,7,8
Hurricane,Ivan,30,2004-09-09T21:00:00Z,19.7N  79.3W,0,23,3,1,27
Hurricane,Ivan,30,2004-09-09T21:00:00Z,MYGF 266N 787W,0,0,0,6,6
Hurricane,Ivan,30,2004-09-09T21:00:00Z,MTPP 186N 724W,3,0,0,0,3
Hurricane,Ivan,30,2004-09-09T21:00:00Z,MARATHON FL,0,0,2,13,15
Hurricane,Ivan,30,2004-09-09T21:00:00Z,MTCA 183N 738W,28,0,0,1,29
Hurricane,Ivan,30,2004-09-09T21:00:00Z,MIAMI FL,0,0,0,11,11
Hurricane,Ivan,30,2004-09-09T21:00:00Z,MKJP 179N 768W,39,2,0,0,41
Hurricane,Ivan,30,2004-09-09T21:00:00Z,W PALM BEACH FL,0,0,0,8,8
Hurricane,Ivan,30,2004-09-09T21:00:00Z,MKJS 185N 779W,16,18,0,0,34
Hurricane,Ivan,30,2004-09-09T21:00:00Z,FT PIERCE FL,0,0,0,6,6
Hurricane,Ivan,30,2004-09-09T21:00:00Z,MWCG 193N 814W,0,5,10,5,20
Hurricane,Ivan,30,2004-09-09T21:00:00Z,COCOA BEACH FL,0,0,0,4,4
Hurricane,Ivan,30,2004-09-09T21:00:00Z,MUGM 200N 751W,8,11,0,1,20
Hurricane,Ivan,30,2004-09-09T21:00:00Z,DAYTONA BEACH FL,0,0,0,2,2
Hurricane,Ivan,30,2004-09-09T21:00:00Z,MUCM 214N 779W,0,14,6,2,22
Hurricane,Ivan,30,2004-09-09T21:00:00Z,KEY WEST FL,0,0,1,14,15
Hurricane,Ivan,30,2004-09-09T21:00:00Z,MUCF 221N 805W,0,1,14,6,21
Hurricane,Ivan,30,2004-09-09T21:00:00Z,MARCO ISLAND FL,0,0,0,11,11
Hurricane,Ivan,30,2004-09-09T21:00:00Z,MUSN 216N 826W,0,0,7,11,18
Hurricane,Ivan,30,2004-09-09T21:00:00Z,FT MYERS FL,0,0,0,9,9
Hurricane,Ivan,30,2004-09-09T21:00:00Z,MUHA 230N 824W,0,0,4,13,17
Hurricane,Ivan,30,2004-09-09T21:00:00Z,VENICE FL,0,0,0,8,8
Hurricane,Ivan,30,2004-09-09T21:00:00Z,MUAN 219N 850W,0,0,0,11,11
Hurricane,Ivan,30,2004-09-09T21:00:00Z,TAMPA FL,0,0,0,5,5
Hurricane,Ivan,30,2004-09-09T21:00:00Z,MMCZ 205N 869W,0,0,0,4,4
Hurricane,Ivan,30,2004-09-09T21:00:00Z,CEDAR KEY FL,0,0,0,3,3
Hurricane,Ivan,30,2004-09-09T21:00:00Z,MYSM 241N 745W,0,0,1,1,2
Hurricane,Ivan,30,2004-09-09T21:00:00Z,GULF 29N 85W,0,0,0,2,2
Hurricane,Ivan,30,2004-09-09T21:00:00Z,MYEG 235N 758W,0,0,4,3,7
Hurricane,Ivan,31,2004-09-10T03:00:00Z,17.7N  76.6W,46,0,0,0,46
Hurricane,Ivan,31,2004-09-10T03:00:00Z,MYNN 251N 775W,0,0,1,7,8
Hurricane,Ivan,31,2004-09-10T03:00:00Z,18.9N  78.3W,14,19,0,0,33
Hurricane,Ivan,31,2004-09-10T03:00:00Z,MYGF 266N 787W,0,0,0,7,7
Hurricane,Ivan,31,2004-09-10T03:00:00Z,19.9N  79.6W,0,22,4,1,27
Hurricane,Ivan,31,2004-09-10T03:00:00Z,MARATHON FL,0,0,2,14,16
Hurricane,Ivan,31,2004-09-10T03:00:00Z,MTCA 183N 738W,26,0,0,0,26
Hurricane,Ivan,31,2004-09-10T03:00:00Z,MIAMI FL,0,0,1,11,12
Hurricane,Ivan,31,2004-09-10T03:00:00Z,MKJP 179N 768W,43,0,0,0,43
Hurricane,Ivan,31,2004-09-10T03:00:00Z,W PALM BEACH FL,0,0,0,9,9
Hurricane,Ivan,31,2004-09-10T03:00:00Z,MKJS 185N 779W,26,9,0,0,35
Hurricane,Ivan,31,2004-09-10T03:00:00Z,FT PIERCE FL,0,0,0,7,7
Hurricane,Ivan,31,2004-09-10T03:00:00Z,MWCG 193N 814W,0,7,10,3,20
Hurricane,Ivan,31,2004-09-10T03:00:00Z,COCOA BEACH FL,0,0,0,5,5
Hurricane,Ivan,31,2004-09-10T03:00:00Z,MUGM 200N 751W,10,7,1,0,18
Hurricane,Ivan,31,2004-09-10T03:00:00Z,DAYTONA BEACH FL,0,0,0,3,3
Hurricane,Ivan,31,2004-09-10T03:00:00Z,MUCM 214N 779W,0,15,5,2,22
Hurricane,Ivan,31,2004-09-10T03:00:00Z,KEY WEST FL,0,0,2,14,16
Hurricane,Ivan,31,2004-09-10T03:00:00Z,MUCF 221N 805W,0,2,14,6,22
Hurricane,Ivan,31,2004-09-10T03:00:00Z,MARCO ISLAND FL,0,0,0,12,12
Hurricane,Ivan,31,2004-09-10T03:00:00Z,MUSN 216N 826W,0,0,9,10,19
Hurricane,Ivan,31,2004-09-10T03:00:00Z,FT MYERS FL,0,0,0,10,10
Hurricane,Ivan,31,2004-09-10T03:00:00Z,MUHA 230N 824W,0,0,5,13,18
Hurricane,Ivan,31,2004-09-10T03:00:00Z,VENICE FL,0,0,0,9,9
Hurricane,Ivan,31,2004-09-10T03:00:00Z,MUAN 219N 850W,0,0,1,10,11
Hurricane,Ivan,31,2004-09-10T03:00:00Z,TAMPA FL,0,0,0,6,6
Hurricane,Ivan,31,2004-09-10T03:00:00Z,MMCZ 205N 869W,0,0,0,3,3
Hurricane,Ivan,31,2004-09-10T03:00:00Z,CEDAR KEY FL,0,0,0,4,4
Hurricane,Ivan,31,2004-09-10T03:00:00Z,MYSM 241N 745W,0,0,0,2,2
Hurricane,Ivan,31,2004-09-10T03:00:00Z,ST MARKS FL,0,0,0,2,2
Hurricane,Ivan,31,2004-09-10T03:00:00Z,MYEG 235N 758W,0,0,3,3,6
Hurricane,Ivan,31,2004-09-10T03:00:00Z,APALACHICOLA FL,0,0,0,2,2
Hurricane,Ivan,31,2004-09-10T03:00:00Z,MYAK 241N 776W,0,0,5,6,11
Hurricane,Ivan,31,2004-09-10T03:00:00Z,GULF 29N 85W,0,0,0,3,3
Hurricane,Ivan,32,2004-09-10T09:00:00Z,18.0N  77.4W,47,0,0,0,47
Hurricane,Ivan,32,2004-09-10T09:00:00Z,MARATHON FL,0,0,3,14,17
Hurricane,Ivan,32,2004-09-10T09:00:00Z,19.1N  78.9W,22,11,0,0,33
Hurricane,Ivan,32,2004-09-10T09:00:00Z,MIAMI FL,0,0,1,12,13
Hurricane,Ivan,32,2004-09-10T09:00:00Z,20.4N  80.2W,0,21,5,1,27
Hurricane,Ivan,32,2004-09-10T09:00:00Z,W PALM BEACH FL,0,0,0,11,11
Hurricane,Ivan,32,2004-09-10T09:00:00Z,MTCA 183N 738W,13,0,0,0,13
Hurricane,Ivan,32,2004-09-10T09:00:00Z,FT PIERCE FL,0,0,0,9,9
Hurricane,Ivan,32,2004-09-10T09:00:00Z,MKJP 179N 768W,53,0,0,0,53
Hurricane,Ivan,32,2004-09-10T09:00:00Z,COCOA BEACH FL,0,0,0,7,7
Hurricane,Ivan,32,2004-09-10T09:00:00Z,MKJS 185N 779W,41,0,0,0,41
Hurricane,Ivan,32,2004-09-10T09:00:00Z,DAYTONA BEACH FL,0,0,0,5,5
Hurricane,Ivan,32,2004-09-10T09:00:00Z,MWCG 193N 814W,0,15,5,2,22
Hurricane,Ivan,32,2004-09-10T09:00:00Z,JACKSONVILLE FL,0,0,0,3,3
Hurricane,Ivan,32,2004-09-10T09:00:00Z,MUGM 200N 751W,9,3,0,0,12
Hurricane,Ivan,32,2004-09-10T09:00:00Z,KEY WEST FL,0,0,3,15,18
Hurricane,Ivan,32,2004-09-10T09:00:00Z,MUCM 214N 779W,1,15,4,1,21
Hurricane,Ivan,32,2004-09-10T09:00:00Z,MARCO ISLAND FL,0,0,0,14,14
Hurricane,Ivan,32,2004-09-10T09:00:00Z,MUCF 221N 805W,0,4,16,3,23
Hurricane,Ivan,32,2004-09-10T09:00:00Z,FT MYERS FL,0,0,0,13,13
Hurricane,Ivan,32,2004-09-10T09:00:00Z,MUSN 216N 826W,0,1,13,6,20
Hurricane,Ivan,32,2004-09-10T09:00:00Z,VENICE FL,0,0,0,12,12
Hurricane,Ivan,32,2004-09-10T09:00:00Z,MUHA 230N 824W,0,0,9,11,20
Hurricane,Ivan,32,2004-09-10T09:00:00Z,TAMPA FL,0,0,0,9,9
Hurricane,Ivan,32,2004-09-10T09:00:00Z,MUAN 219N 850W,0,0,2,10,12
Hurricane,Ivan,32,2004-09-10T09:00:00Z,CEDAR KEY FL,0,0,0,6,6
Hurricane,Ivan,32,2004-09-10T09:00:00Z,MMCZ 205N 869W,0,0,0,4,4
Hurricane,Ivan,32,2004-09-10T09:00:00Z,ST MARKS FL,0,0,0,3,3
Hurricane,Ivan,32,2004-09-10T09:00:00Z,MYEG 235N 758W,0,0,2,3,5
Hurricane,Ivan,32,2004-09-10T09:00:00Z,APALACHICOLA FL,0,0,0,4,4
Hurricane,Ivan,32,2004-09-10T09:00:00Z,MYAK 241N 776W,0,0,4,7,11
Hurricane,Ivan,32,2004-09-10T09:00:00Z,PANAMA CITY FL,0,0,0,3,3
Hurricane,Ivan,32,2004-09-10T09:00:00Z,MYNN 251N 775W,0,0,1,7,8
Hurricane,Ivan,32,2004-09-10T09:00:00Z,GULF 29N 85W,0,0,0,5,5
Hurricane,Ivan,32,2004-09-10T09:00:00Z,MYGF 266N 787W,0,0,0,8,8
Hurricane,Ivan,32,2004-09-10T09:00:00Z,GULF 29N 87W,0,0,0,2,2
Hurricane,Ivan,33,2004-09-10T15:00:00Z,18.3N  78.0W,47,0,0,0,47
Hurricane,Ivan,33,2004-09-10T15:00:00Z,MARATHON FL,0,0,7,11,18
Hurricane,Ivan,33,2004-09-10T15:00:00Z,19.2N  79.0W,28,4,1,0,33
Hurricane,Ivan,33,2004-09-10T15:00:00Z,MIAMI FL,0,0,3,12,15
Hurricane,Ivan,33,2004-09-10T15:00:00Z,20.5N  80.2W,1,20,5,1,27
Hurricane,Ivan,33,2004-09-10T15:00:00Z,W PALM BEACH FL,0,0,1,11,12
Hurricane,Ivan,33,2004-09-10T15:00:00Z,MTCA 183N 738W,3,0,0,0,3
Hurricane,Ivan,33,2004-09-10T15:00:00Z,FT PIERCE FL,0,0,0,10,10
Hurricane,Ivan,33,2004-09-10T15:00:00Z,MKJP 179N 768W,64,0,0,0,64
Hurricane,Ivan,33,2004-09-10T15:00:00Z,COCOA BEACH FL,0,0,0,8,8
Hurricane,Ivan,33,2004-09-10T15:00:00Z,MKJS 185N 779W,47,0,0,0,47
Hurricane,Ivan,33,2004-09-10T15:00:00Z,DAYTONA BEACH FL,0,0,0,6,6
Hurricane,Ivan,33,2004-09-10T15:00:00Z,MWCG 193N 814W,1,14,5,2,22
Hurricane,Ivan,33,2004-09-10T15:00:00Z,JACKSONVILLE FL,0,0,0,3,3
Hurricane,Ivan,33,2004-09-10T15:00:00Z,MUGM 200N 751W,6,2,0,0,8
Hurricane,Ivan,33,2004-09-10T15:00:00Z,KEY WEST FL,0,0,7,12,19
Hurricane,Ivan,33,2004-09-10T15:00:00Z,MUCM 214N 779W,1,16,3,1,21
Hurricane,Ivan,33,2004-09-10T15:00:00Z,MARCO ISLAND FL,0,0,2,13,15
Hurricane,Ivan,33,2004-09-10T15:00:00Z,MUCF 221N 805W,0,7,15,2,24
Hurricane,Ivan,33,2004-09-10T15:00:00Z,FT MYERS FL,0,0,1,13,14
Hurricane,Ivan,33,2004-09-10T15:00:00Z,MUSN 216N 826W,0,1,14,5,20
Hurricane,Ivan,33,2004-09-10T15:00:00Z,VENICE FL,0,0,0,13,13
Hurricane,Ivan,33,2004-09-10T15:00:00Z,MUHA 230N 824W,0,0,12,8,20
Hurricane,Ivan,33,2004-09-10T15:00:00Z,TAMPA FL,0,0,0,10,10
Hurricane,Ivan,33,2004-09-10T15:00:00Z,MUAN 219N 850W,0,0,2,10,12
Hurricane,Ivan,33,2004-09-10T15:00:00Z,CEDAR KEY FL,0,0,0,7,7
Hurricane,Ivan,33,2004-09-10T15:00:00Z,MMCZ 205N 869W,0,0,0,4,4
Hurricane,Ivan,33,2004-09-10T15:00:00Z,ST MARKS FL,0,0,0,3,3
Hurricane,Ivan,33,2004-09-10T15:00:00Z,MYEG 235N 758W,0,1,2,2,5
Hurricane,Ivan,33,2004-09-10T15:00:00Z,APALACHICOLA FL,0,0,0,4,4
Hurricane,Ivan,33,2004-09-10T15:00:00Z,MYAK 241N 776W,0,1,6,5,12
Hurricane,Ivan,33,2004-09-10T15:00:00Z,PANAMA CITY FL,0,0,0,3,3
Hurricane,Ivan,33,2004-09-10T15:00:00Z,MYNN 251N 775W,0,0,3,6,9
Hurricane,Ivan,33,2004-09-10T15:00:00Z,GULF 29N 85W,0,0,0,5,5
Hurricane,Ivan,33,2004-09-10T15:00:00Z,MYGF 266N 787W,0,0,1,8,9
Hurricane,Ivan,33,2004-09-10T15:00:00Z,GULF 29N 87W,0,0,0,3,3
Hurricane,Ivan,34,2004-09-10T21:00:00Z,18.8N  78.7W,48,0,0,0,48
Hurricane,Ivan,34,2004-09-10T21:00:00Z,W PALM BEACH FL,0,0,1,11,12
Hurricane,Ivan,34,2004-09-10T21:00:00Z,19.9N  79.8W,26,7,0,0,33
Hurricane,Ivan,34,2004-09-10T21:00:00Z,FT PIERCE FL,0,0,0,11,11
Hurricane,Ivan,34,2004-09-10T21:00:00Z,21.3N  81.1W,1,19,7,0,27
Hurricane,Ivan,34,2004-09-10T21:00:00Z,COCOA BEACH FL,0,0,0,9,9
Hurricane,Ivan,34,2004-09-10T21:00:00Z,MKJP 179N 768W,99,0,0,0,99
Hurricane,Ivan,34,2004-09-10T21:00:00Z,DAYTONA BEACH FL,0,0,0,8,8
Hurricane,Ivan,34,2004-09-10T21:00:00Z,MKJS 185N 779W,58,0,0,0,58
Hurricane,Ivan,34,2004-09-10T21:00:00Z,JACKSONVILLE FL,0,0,0,5,5
Hurricane,Ivan,34,2004-09-10T21:00:00Z,MWCG 193N 814W,8,13,2,0,23
Hurricane,Ivan,34,2004-09-10T21:00:00Z,KEY WEST FL,0,0,10,10,20
Hurricane,Ivan,34,2004-09-10T21:00:00Z,MUGM 200N 751W,1,1,0,0,2
Hurricane,Ivan,34,2004-09-10T21:00:00Z,MARCO ISLAND FL,0,0,2,15,17
Hurricane,Ivan,34,2004-09-10T21:00:00Z,MUCM 214N 779W,9,10,1,0,20
Hurricane,Ivan,34,2004-09-10T21:00:00Z,FT MYERS FL,0,0,1,14,15
Hurricane,Ivan,34,2004-09-10T21:00:00Z,MUCF 221N 805W,0,15,10,1,26
Hurricane,Ivan,34,2004-09-10T21:00:00Z,VENICE FL,0,0,0,15,15
Hurricane,Ivan,34,2004-09-10T21:00:00Z,MUSN 216N 826W,0,6,15,2,23
Hurricane,Ivan,34,2004-09-10T21:00:00Z,TAMPA FL,0,0,0,13,13
Hurricane,Ivan,34,2004-09-10T21:00:00Z,MUHA 230N 824W,0,1,17,4,22
Hurricane,Ivan,34,2004-09-10T21:00:00Z,CEDAR KEY FL,0,0,0,10,10
Hurricane,Ivan,34,2004-09-10T21:00:00Z,MUAN 219N 850W,0,0,6,8,14
Hurricane,Ivan,34,2004-09-10T21:00:00Z,ST MARKS FL,0,0,0,7,7
Hurricane,Ivan,34,2004-09-10T21:00:00Z,MMCZ 205N 869W,0,0,1,3,4
Hurricane,Ivan,34,2004-09-10T21:00:00Z,APALACHICOLA FL,0,0,0,8,8
Hurricane,Ivan,34,2004-09-10T21:00:00Z,MYEG 235N 758W,0,0,1,3,4
Hurricane,Ivan,34,2004-09-10T21:00:00Z,PANAMA CITY FL,0,0,0,6,6
Hurricane,Ivan,34,2004-09-10T21:00:00Z,MYAK 241N 776W,0,1,4,5,10
Hurricane,Ivan,34,2004-09-10T21:00:00Z,PENSACOLA FL,0,0,0,3,3
Hurricane,Ivan,34,2004-09-10T21:00:00Z,MYNN 251N 775W,0,0,2,6,8
Hurricane,Ivan,34,2004-09-10T21:00:00Z,MOBILE AL,0,0,0,2,2
Hurricane,Ivan,34,2004-09-10T21:00:00Z,MYGF 266N 787W,0,0,1,8,9
Hurricane,Ivan,34,2004-09-10T21:00:00Z,GULF 29N 85W,0,0,0,9,9
Hurricane,Ivan,34,2004-09-10T21:00:00Z,MARATHON FL,0,0,9,10,19
Hurricane,Ivan,34,2004-09-10T21:00:00Z,GULF 29N 87W,0,0,0,6,6
Hurricane,Ivan,34,2004-09-10T21:00:00Z,MIAMI FL,0,0,3,12,15
Hurricane,Ivan,34,2004-09-10T21:00:00Z,GULF 28N 89W,0,0,0,3,3
Hurricane,Ivan,35,2004-09-11T03:00:00Z,19.3N  79.1W,47,0,0,0,47
Hurricane,Ivan,35,2004-09-11T03:00:00Z,FT PIERCE FL,0,0,1,10,11
Hurricane,Ivan,35,2004-09-11T03:00:00Z,20.4N  80.4W,23,8,1,0,32
Hurricane,Ivan,35,2004-09-11T03:00:00Z,COCOA BEACH FL,0,0,0,10,10
Hurricane,Ivan,35,2004-09-11T03:00:00Z,21.8N  81.5W,1,20,4,1,26
Hurricane,Ivan,35,2004-09-11T03:00:00Z,DAYTONA BEACH FL,0,0,0,8,8
Hurricane,Ivan,35,2004-09-11T03:00:00Z,MKJP 179N 768W,99,0,0,0,99
Hurricane,Ivan,35,2004-09-11T03:00:00Z,JACKSONVILLE FL,0,0,0,5,5
Hurricane,Ivan,35,2004-09-11T03:00:00Z,MKJS 185N 779W,73,0,0,0,73
Hurricane,Ivan,35,2004-09-11T03:00:00Z,SAVANNAH GA,0,0,0,2,2
Hurricane,Ivan,35,2004-09-11T03:00:00Z,MWCG 193N 814W,17,7,1,0,25
Hurricane,Ivan,35,2004-09-11T03:00:00Z,KEY WEST FL,0,1,13,7,21
Hurricane,Ivan,35,2004-09-11T03:00:00Z,MUCM 214N 779W,15,5,0,0,20
Hurricane,Ivan,35,2004-09-11T03:00:00Z,MARCO ISLAND FL,0,0,5,12,17
Hurricane,Ivan,35,2004-09-11T03:00:00Z,MUCF 221N 805W,1,21,2,1,25
Hurricane,Ivan,35,2004-09-11T03:00:00Z,FT MYERS FL,0,0,2,14,16
Hurricane,Ivan,35,2004-09-11T03:00:00Z,MUSN 216N 826W,0,15,7,2,24
Hurricane,Ivan,35,2004-09-11T03:00:00Z,VENICE FL,0,0,1,15,16
Hurricane,Ivan,35,2004-09-11T03:00:00Z,MUHA 230N 824W,0,6,14,3,23
Hurricane,Ivan,35,2004-09-11T03:00:00Z,TAMPA FL,0,0,0,13,13
Hurricane,Ivan,35,2004-09-11T03:00:00Z,MUAN 219N 850W,0,1,9,6,16
Hurricane,Ivan,35,2004-09-11T03:00:00Z,CEDAR KEY FL,0,0,0,11,11
Hurricane,Ivan,35,2004-09-11T03:00:00Z,MMCZ 205N 869W,0,0,2,3,5
Hurricane,Ivan,35,2004-09-11T03:00:00Z,ST MARKS FL,0,0,0,8,8
Hurricane,Ivan,35,2004-09-11T03:00:00Z,MYEG 235N 758W,0,1,0,2,3
Hurricane,Ivan,35,2004-09-11T03:00:00Z,APALACHICOLA FL,0,0,0,9,9
Hurricane,Ivan,35,2004-09-11T03:00:00Z,MYAK 241N 776W,0,2,4,3,9
Hurricane,Ivan,35,2004-09-11T03:00:00Z,PANAMA CITY FL,0,0,0,7,7
Hurricane,Ivan,35,2004-09-11T03:00:00Z,MYNN 251N 775W,0,0,3,4,7
Hurricane,Ivan,35,2004-09-11T03:00:00Z,PENSACOLA FL,0,0,0,3,3
Hurricane,Ivan,35,2004-09-11T03:00:00Z,MYGF 266N 787W,0,0,1,7,8
Hurricane,Ivan,35,2004-09-11T03:00:00Z,MOBILE AL,0,0,0,2,2
Hurricane,Ivan,35,2004-09-11T03:00:00Z,MARATHON FL,0,1,12,6,19
Hurricane,Ivan,35,2004-09-11T03:00:00Z,GULF 29N 85W,0,0,0,10,10
Hurricane,Ivan,35,2004-09-11T03:00:00Z,MIAMI FL,0,0,6,9,15
Hurricane,Ivan,35,2004-09-11T03:00:00Z,GULF 29N 87W,0,0,0,7,7
Hurricane,Ivan,35,2004-09-11T03:00:00Z,W PALM BEACH FL,0,0,2,10,12
Hurricane,Ivan,35,2004-09-11T03:00:00Z,GULF 28N 89W,0,0,0,3,3
Hurricane,Ivan,36,2004-09-11T09:00:00Z,19.3N  80.1W,48,0,0,0,48
Hurricane,Ivan,36,2004-09-11T09:00:00Z,JACKSONVILLE FL,0,0,0,7,7
Hurricane,Ivan,36,2004-09-11T09:00:00Z,20.6N  81.4W,21,12,0,0,33
Hurricane,Ivan,36,2004-09-11T09:00:00Z,SAVANNAH GA,0,0,0,2,2
Hurricane,Ivan,36,2004-09-11T09:00:00Z,22.0N  82.5W,0,23,4,1,28
Hurricane,Ivan,36,2004-09-11T09:00:00Z,KEY WEST FL,0,2,14,5,21
Hurricane,Ivan,36,2004-09-11T09:00:00Z,MKJP 179N 768W,99,0,0,0,99
Hurricane,Ivan,36,2004-09-11T09:00:00Z,MARCO ISLAND FL,0,0,7,10,17
Hurricane,Ivan,36,2004-09-11T09:00:00Z,MKJS 185N 779W,99,0,0,0,99
Hurricane,Ivan,36,2004-09-11T09:00:00Z,FT MYERS FL,0,0,4,12,16
Hurricane,Ivan,36,2004-09-11T09:00:00Z,MWCG 193N 814W,31,1,1,0,33
Hurricane,Ivan,36,2004-09-11T09:00:00Z,VENICE FL,0,0,2,14,16
Hurricane,Ivan,36,2004-09-11T09:00:00Z,MUCM 214N 779W,7,5,0,1,13
Hurricane,Ivan,36,2004-09-11T09:00:00Z,TAMPA FL,0,0,1,13,14
Hurricane,Ivan,36,2004-09-11T09:00:00Z,MUCF 221N 805W,4,20,1,1,26
Hurricane,Ivan,36,2004-09-11T09:00:00Z,CEDAR KEY FL,0,0,0,12,12
Hurricane,Ivan,36,2004-09-11T09:00:00Z,MUSN 216N 826W,1,24,2,1,28
Hurricane,Ivan,36,2004-09-11T09:00:00Z,ST MARKS FL,0,0,0,10,10
Hurricane,Ivan,36,2004-09-11T09:00:00Z,MUHA 230N 824W,0,14,9,2,25
Hurricane,Ivan,36,2004-09-11T09:00:00Z,APALACHICOLA FL,0,0,0,11,11
Hurricane,Ivan,36,2004-09-11T09:00:00Z,MUAN 219N 850W,0,4,12,3,19
Hurricane,Ivan,36,2004-09-11T09:00:00Z,PANAMA CITY FL,0,0,0,10,10
Hurricane,Ivan,36,2004-09-11T09:00:00Z,MMCZ 205N 869W,0,0,3,4,7
Hurricane,Ivan,36,2004-09-11T09:00:00Z,PENSACOLA FL,0,0,0,7,7
Hurricane,Ivan,36,2004-09-11T09:00:00Z,MYAK 241N 776W,0,1,1,3,5
Hurricane,Ivan,36,2004-09-11T09:00:00Z,MOBILE AL,0,0,0,4,4
Hurricane,Ivan,36,2004-09-11T09:00:00Z,MYNN 251N 775W,0,0,1,3,4
Hurricane,Ivan,36,2004-09-11T09:00:00Z,GULFPORT MS,0,0,0,3,3
Hurricane,Ivan,36,2004-09-11T09:00:00Z,MYGF 266N 787W,0,0,1,6,7
Hurricane,Ivan,36,2004-09-11T09:00:00Z,BURAS LA,0,0,0,3,3
Hurricane,Ivan,36,2004-09-11T09:00:00Z,MARATHON FL,0,2,12,5,19
Hurricane,Ivan,36,2004-09-11T09:00:00Z,NEW ORLEANS LA,0,0,0,2,2
Hurricane,Ivan,36,2004-09-11T09:00:00Z,MIAMI FL,0,0,5,9,14
Hurricane,Ivan,36,2004-09-11T09:00:00Z,GULF 29N 85W,0,0,0,13,13
Hurricane,Ivan,36,2004-09-11T09:00:00Z,W PALM BEACH FL,0,0,2,9,11
Hurricane,Ivan,36,2004-09-11T09:00:00Z,GULF 29N 87W,0,0,0,10,10
Hurricane,Ivan,36,2004-09-11T09:00:00Z,FT PIERCE FL,0,0,1,9,10
Hurricane,Ivan,36,2004-09-11T09:00:00Z,GULF 28N 89W,0,0,0,6,6
Hurricane,Ivan,36,2004-09-11T09:00:00Z,COCOA BEACH FL,0,0,0,10,10
Hurricane,Ivan,36,2004-09-11T09:00:00Z,GULF 28N 91W,0,0,0,2,2
Hurricane,Ivan,36,2004-09-11T09:00:00Z,DAYTONA BEACH FL,0,0,0,9,9
Hurricane,Ivan,37,2004-09-11T15:00:00Z,19.6N  81.0W,47,0,0,0,47
Hurricane,Ivan,37,2004-09-11T15:00:00Z,JACKSONVILLE FL,0,0,0,8,8
Hurricane,Ivan,37,2004-09-11T15:00:00Z,21.0N  82.0W,23,9,1,0,33
Hurricane,Ivan,37,2004-09-11T15:00:00Z,SAVANNAH GA,0,0,0,3,3
Hurricane,Ivan,37,2004-09-11T15:00:00Z,22.8N  83.0W,0,20,7,1,28
Hurricane,Ivan,37,2004-09-11T15:00:00Z,KEY WEST FL,0,5,15,2,22
Hurricane,Ivan,37,2004-09-11T15:00:00Z,MKJS 185N 779W,99,0,0,0,99
Hurricane,Ivan,37,2004-09-11T15:00:00Z,MARCO ISLAND FL,0,0,11,7,18
Hurricane,Ivan,37,2004-09-11T15:00:00Z,MWCG 193N 814W,42,0,0,0,42
Hurricane,Ivan,37,2004-09-11T15:00:00Z,FT MYERS FL,0,0,7,10,17
Hurricane,Ivan,37,2004-09-11T15:00:00Z,MUCM 214N 779W,3,2,0,1,6
Hurricane,Ivan,37,2004-09-11T15:00:00Z,VENICE FL,0,0,5,13,18
Hurricane,Ivan,37,2004-09-11T15:00:00Z,MUCF 221N 805W,9,14,0,1,24
Hurricane,Ivan,37,2004-09-11T15:00:00Z,TAMPA FL,0,0,2,14,16
Hurricane,Ivan,37,2004-09-11T15:00:00Z,MUSN 216N 826W,7,22,1,0,30
Hurricane,Ivan,37,2004-09-11T15:00:00Z,CEDAR KEY FL,0,0,0,14,14
Hurricane,Ivan,37,2004-09-11T15:00:00Z,MUHA 230N 824W,0,20,7,1,28
Hurricane,Ivan,37,2004-09-11T15:00:00Z,ST MARKS FL,0,0,0,13,13
Hurricane,Ivan,37,2004-09-11T15:00:00Z,MUAN 219N 850W,0,10,9,2,21
Hurricane,Ivan,37,2004-09-11T15:00:00Z,APALACHICOLA FL,0,0,0,14,14
Hurricane,Ivan,37,2004-09-11T15:00:00Z,MMCZ 205N 869W,0,1,3,3,7
Hurricane,Ivan,37,2004-09-11T15:00:00Z,PANAMA CITY FL,0,0,0,14,14
Hurricane,Ivan,37,2004-09-11T15:00:00Z,MYAK 241N 776W,0,0,1,2,3
Hurricane,Ivan,37,2004-09-11T15:00:00Z,PENSACOLA FL,0,0,0,11,11
Hurricane,Ivan,37,2004-09-11T15:00:00Z,MYNN 251N 775W,0,0,1,2,3
Hurricane,Ivan,37,2004-09-11T15:00:00Z,MOBILE AL,0,0,0,8,8
Hurricane,Ivan,37,2004-09-11T15:00:00Z,MYGF 266N 787W,0,0,1,5,6
Hurricane,Ivan,37,2004-09-11T15:00:00Z,GULFPORT MS,0,0,0,7,7
Hurricane,Ivan,37,2004-09-11T15:00:00Z,MARATHON FL,0,4,12,3,19
Hurricane,Ivan,37,2004-09-11T15:00:00Z,BURAS LA,0,0,0,6,6
Hurricane,Ivan,37,2004-09-11T15:00:00Z,MIAMI FL,0,0,7,6,13
Hurricane,Ivan,37,2004-09-11T15:00:00Z,NEW ORLEANS LA,0,0,0,4,4
Hurricane,Ivan,37,2004-09-11T15:00:00Z,W PALM BEACH FL,0,0,3,8,11
Hurricane,Ivan,37,2004-09-11T15:00:00Z,GULF 29N 85W,0,0,0,16,16
Hurricane,Ivan,37,2004-09-11T15:00:00Z,FT PIERCE FL,0,0,1,9,10
Hurricane,Ivan,37,2004-09-11T15:00:00Z,GULF 29N 87W,0,0,0,14,14
Hurricane,Ivan,37,2004-09-11T15:00:00Z,COCOA BEACH FL,0,0,1,9,10
Hurricane,Ivan,37,2004-09-11T15:00:00Z,GULF 28N 89W,0,0,0,9,9
Hurricane,Ivan,37,2004-09-11T15:00:00Z,DAYTONA BEACH FL,0,0,0,10,10
Hurricane,Ivan,37,2004-09-11T15:00:00Z,GULF 28N 91W,0,0,0,3,3
Hurricane,Ivan,38,2004-09-11T21:00:00Z,20.0N  82.0W,48,0,0,0,48
Hurricane,Ivan,38,2004-09-11T21:00:00Z,KEY WEST FL,0,8,8,3,19
Hurricane,Ivan,38,2004-09-11T21:00:00Z,21.5N  83.1W,16,16,0,0,32
Hurricane,Ivan,38,2004-09-11T21:00:00Z,MARCO ISLAND FL,0,1,8,6,15
Hurricane,Ivan,38,2004-09-11T21:00:00Z,23.1N  84.0W,0,20,6,1,27
Hurricane,Ivan,38,2004-09-11T21:00:00Z,FT MYERS FL,0,0,7,8,15
Hurricane,Ivan,38,2004-09-11T21:00:00Z,MKJS 185N 779W,37,0,0,0,37
Hurricane,Ivan,38,2004-09-11T21:00:00Z,VENICE FL,0,0,5,10,15
Hurricane,Ivan,38,2004-09-11T21:00:00Z,MWCG 193N 814W,58,0,0,0,58
Hurricane,Ivan,38,2004-09-11T21:00:00Z,TAMPA FL,0,0,2,11,13
Hurricane,Ivan,38,2004-09-11T21:00:00Z,MUCF 221N 805W,12,6,1,1,20
Hurricane,Ivan,38,2004-09-11T21:00:00Z,CEDAR KEY FL,0,0,1,11,12
Hurricane,Ivan,38,2004-09-11T21:00:00Z,MUSN 216N 826W,20,12,0,0,32
Hurricane,Ivan,38,2004-09-11T21:00:00Z,ST MARKS FL,0,0,0,11,11
Hurricane,Ivan,38,2004-09-11T21:00:00Z,MUHA 230N 824W,2,21,2,1,26
Hurricane,Ivan,38,2004-09-11T21:00:00Z,APALACHICOLA FL,0,0,0,13,13
Hurricane,Ivan,38,2004-09-11T21:00:00Z,MUAN 219N 850W,0,20,3,1,24
Hurricane,Ivan,38,2004-09-11T21:00:00Z,PANAMA CITY FL,0,0,0,12,12
Hurricane,Ivan,38,2004-09-11T21:00:00Z,MMCZ 205N 869W,0,4,4,2,10
Hurricane,Ivan,38,2004-09-11T21:00:00Z,PENSACOLA FL,0,0,0,10,10
Hurricane,Ivan,38,2004-09-11T21:00:00Z,MYGF 266N 787W,0,0,0,4,4
Hurricane,Ivan,38,2004-09-11T21:00:00Z,MOBILE AL,0,0,0,8,8
Hurricane,Ivan,38,2004-09-11T21:00:00Z,MMMD 210N 897W,0,0,0,2,2
Hurricane,Ivan,38,2004-09-11T21:00:00Z,GULFPORT MS,0,0,0,7,7
Hurricane,Ivan,38,2004-09-11T21:00:00Z,MARATHON FL,0,5,7,4,16
Hurricane,Ivan,38,2004-09-11T21:00:00Z,BURAS LA,0,0,0,8,8
Hurricane,Ivan,38,2004-09-11T21:00:00Z,MIAMI FL,0,0,5,5,10
Hurricane,Ivan,38,2004-09-11T21:00:00Z,NEW ORLEANS LA,0,0,0,5,5
Hurricane,Ivan,38,2004-09-11T21:00:00Z,W PALM BEACH FL,0,0,2,6,8
Hurricane,Ivan,38,2004-09-11T21:00:00Z,NEW IBERIA LA,0,0,0,2,2
Hurricane,Ivan,38,2004-09-11T21:00:00Z,FT PIERCE FL,0,0,1,7,8
Hurricane,Ivan,38,2004-09-11T21:00:00Z,GULF 29N 85W,0,0,1,13,14
Hurricane,Ivan,38,2004-09-11T21:00:00Z,COCOA BEACH FL,0,0,1,6,7
Hurricane,Ivan,38,2004-09-11T21:00:00Z,GULF 29N 87W,0,0,0,13,13
Hurricane,Ivan,38,2004-09-11T21:00:00Z,DAYTONA BEACH FL,0,0,0,7,7
Hurricane,Ivan,38,2004-09-11T21:00:00Z,GULF 28N 89W,0,0,0,11,11
Hurricane,Ivan,38,2004-09-11T21:00:00Z,JACKSONVILLE FL,0,0,0,6,6
Hurricane,Ivan,38,2004-09-11T21:00:00Z,GULF 28N 91W,0,0,0,5,5
Hurricane,Ivan,38,2004-09-11T21:00:00Z,SAVANNAH GA,0,0,0,2,2
Hurricane,Ivan,39,2004-09-12T03:00:00Z,20.3N  82.4W,47,0,0,0,47
Hurricane,Ivan,39,2004-09-12T03:00:00Z,MARCO ISLAND FL,0,0,7,7,14
Hurricane,Ivan,39,2004-09-12T03:00:00Z,21.6N  83.7W,20,12,0,0,32
Hurricane,Ivan,39,2004-09-12T03:00:00Z,FT MYERS FL,0,0,5,8,13
Hurricane,Ivan,39,2004-09-12T03:00:00Z,23.3N  84.5W,0,21,5,1,27
Hurricane,Ivan,39,2004-09-12T03:00:00Z,VENICE FL,0,0,4,10,14
Hurricane,Ivan,39,2004-09-12T03:00:00Z,MWCG 193N 814W,64,0,0,0,64
Hurricane,Ivan,39,2004-09-12T03:00:00Z,TAMPA FL,0,0,1,11,12
Hurricane,Ivan,39,2004-09-12T03:00:00Z,MUCF 221N 805W,13,3,0,1,17
Hurricane,Ivan,39,2004-09-12T03:00:00Z,CEDAR KEY FL,0,0,0,11,11
Hurricane,Ivan,39,2004-09-12T03:00:00Z,MUSN 216N 826W,30,3,1,0,34
Hurricane,Ivan,39,2004-09-12T03:00:00Z,ST MARKS FL,0,0,0,11,11
Hurricane,Ivan,39,2004-09-12T03:00:00Z,MUHA 230N 824W,5,17,1,1,24
Hurricane,Ivan,39,2004-09-12T03:00:00Z,APALACHICOLA FL,0,0,0,14,14
Hurricane,Ivan,39,2004-09-12T03:00:00Z,MUAN 219N 850W,3,23,1,0,27
Hurricane,Ivan,39,2004-09-12T03:00:00Z,PANAMA CITY FL,0,0,0,13,13
Hurricane,Ivan,39,2004-09-12T03:00:00Z,MMCZ 205N 869W,0,8,3,1,12
Hurricane,Ivan,39,2004-09-12T03:00:00Z,PENSACOLA FL,0,0,0,12,12
Hurricane,Ivan,39,2004-09-12T03:00:00Z,MYGF 266N 787W,0,0,0,2,2
Hurricane,Ivan,39,2004-09-12T03:00:00Z,MOBILE AL,0,0,0,10,10
Hurricane,Ivan,39,2004-09-12T03:00:00Z,MMMD 210N 897W,0,0,1,1,2
Hurricane,Ivan,39,2004-09-12T03:00:00Z,GULFPORT MS,0,0,0,9,9
Hurricane,Ivan,39,2004-09-12T03:00:00Z,MARATHON FL,0,3,6,4,13
Hurricane,Ivan,39,2004-09-12T03:00:00Z,BURAS LA,0,0,0,10,10
Hurricane,Ivan,39,2004-09-12T03:00:00Z,MIAMI FL,0,0,3,5,8
Hurricane,Ivan,39,2004-09-12T03:00:00Z,NEW ORLEANS LA,0,0,0,7,7
Hurricane,Ivan,39,2004-09-12T03:00:00Z,W PALM BEACH FL,0,0,1,5,6
Hurricane,Ivan,39,2004-09-12T03:00:00Z,NEW IBERIA LA,0,0,0,3,3
Hurricane,Ivan,39,2004-09-12T03:00:00Z,FT PIERCE FL,0,0,0,6,6
Hurricane,Ivan,39,2004-09-12T03:00:00Z,GULF 29N 85W,0,0,0,15,15
Hurricane,Ivan,39,2004-09-12T03:00:00Z,COCOA BEACH FL,0,0,0,6,6
Hurricane,Ivan,39,2004-09-12T03:00:00Z,GULF 29N 87W,0,0,0,15,15
Hurricane,Ivan,39,2004-09-12T03:00:00Z,DAYTONA BEACH FL,0,0,0,6,6
Hurricane,Ivan,39,2004-09-12T03:00:00Z,GULF 28N 89W,0,0,0,13,13
Hurricane,Ivan,39,2004-09-12T03:00:00Z,JACKSONVILLE FL,0,0,0,5,5
Hurricane,Ivan,39,2004-09-12T03:00:00Z,GULF 28N 91W,0,0,0,6,6
Hurricane,Ivan,39,2004-09-12T03:00:00Z,KEY WEST FL,0,6,8,3,17
Hurricane,Ivan,40,2004-09-12T09:00:00Z,20.6N  83.0W,46,0,0,0,46
Hurricane,Ivan,40,2004-09-12T09:00:00Z,MARCO ISLAND FL,0,2,7,5,14
Hurricane,Ivan,40,2004-09-12T09:00:00Z,22.2N  84.1W,16,16,0,0,32
Hurricane,Ivan,40,2004-09-12T09:00:00Z,FT MYERS FL,0,1,7,6,14
Hurricane,Ivan,40,2004-09-12T09:00:00Z,23.9N  84.8W,0,20,5,1,26
Hurricane,Ivan,40,2004-09-12T09:00:00Z,VENICE FL,0,0,7,8,15
Hurricane,Ivan,40,2004-09-12T09:00:00Z,MWCG 193N 814W,99,0,0,0,99
Hurricane,Ivan,40,2004-09-12T09:00:00Z,TAMPA FL,0,0,4,10,14
Hurricane,Ivan,40,2004-09-12T09:00:00Z,MUCF 221N 805W,10,2,0,1,13
Hurricane,Ivan,40,2004-09-12T09:00:00Z,CEDAR KEY FL,0,0,1,12,13
Hurricane,Ivan,40,2004-09-12T09:00:00Z,MUSN 216N 826W,35,1,0,0,36
Hurricane,Ivan,40,2004-09-12T09:00:00Z,ST MARKS FL,0,0,0,13,13
Hurricane,Ivan,40,2004-09-12T09:00:00Z,MUHA 230N 824W,10,13,1,0,24
Hurricane,Ivan,40,2004-09-12T09:00:00Z,APALACHICOLA FL,0,0,1,14,15
Hurricane,Ivan,40,2004-09-12T09:00:00Z,MUAN 219N 850W,9,19,1,0,29
Hurricane,Ivan,40,2004-09-12T09:00:00Z,PANAMA CITY FL,0,0,0,15,15
Hurricane,Ivan,40,2004-09-12T09:00:00Z,MMCZ 205N 869W,1,10,1,1,13
Hurricane,Ivan,40,2004-09-12T09:00:00Z,PENSACOLA FL,0,0,0,14,14
Hurricane,Ivan,40,2004-09-12T09:00:00Z,MYGF 266N 787W,0,0,0,2,2
Hurricane,Ivan,40,2004-09-12T09:00:00Z,MOBILE AL,0,0,0,12,12
Hurricane,Ivan,40,2004-09-12T09:00:00Z,MMMD 210N 897W,0,0,2,1,3
Hurricane,Ivan,40,2004-09-12T09:00:00Z,GULFPORT MS,0,0,0,11,11
Hurricane,Ivan,40,2004-09-12T09:00:00Z,MARATHON FL,0,6,4,2,12
Hurricane,Ivan,40,2004-09-12T09:00:00Z,BURAS LA,0,0,0,11,11
Hurricane,Ivan,40,2004-09-12T09:00:00Z,MIAMI FL,0,1,3,4,8
Hurricane,Ivan,40,2004-09-12T09:00:00Z,NEW ORLEANS LA,0,0,0,8,8
Hurricane,Ivan,40,2004-09-12T09:00:00Z,W PALM BEACH FL,0,0,2,4,6
Hurricane,Ivan,40,2004-09-12T09:00:00Z,NEW IBERIA LA,0,0,0,3,3
Hurricane,Ivan,40,2004-09-12T09:00:00Z,FT PIERCE FL,0,0,1,6,7
Hurricane,Ivan,40,2004-09-12T09:00:00Z,GULF 29N 85W,0,0,2,15,17
Hurricane,Ivan,40,2004-09-12T09:00:00Z,COCOA BEACH FL,0,0,1,6,7
Hurricane,Ivan,40,2004-09-12T09:00:00Z,GULF 29N 87W,0,0,1,16,17
Hurricane,Ivan,40,2004-09-12T09:00:00Z,DAYTONA BEACH FL,0,0,0,7,7
Hurricane,Ivan,40,2004-09-12T09:00:00Z,GULF 28N 89W,0,0,1,12,13
Hurricane,Ivan,40,2004-09-12T09:00:00Z,JACKSONVILLE FL,0,0,0,6,6
Hurricane,Ivan,40,2004-09-12T09:00:00Z,GULF 28N 91W,0,0,0,6,6
Hurricane,Ivan,40,2004-09-12T09:00:00Z,SAVANNAH GA,0,0,0,2,2
Hurricane,Ivan,40,2004-09-12T09:00:00Z,GULF 28N 93W,0,0,0,2,2
Hurricane,Ivan,40,2004-09-12T09:00:00Z,KEY WEST FL,0,10,4,2,16
Hurricane,Ivan,41,2004-09-12T15:00:00Z,21.3N  83.5W,50,0,0,0,50
Hurricane,Ivan,41,2004-09-12T15:00:00Z,KEY WEST FL,2,14,2,1,19
Hurricane,Ivan,41,2004-09-12T15:00:00Z,22.9N  84.4W,19,12,1,0,32
Hurricane,Ivan,41,2004-09-12T15:00:00Z,MARCO ISLAND FL,0,4,9,3,16
Hurricane,Ivan,41,2004-09-12T15:00:00Z,24.7N  85.0W,0,18,5,1,24
Hurricane,Ivan,41,2004-09-12T15:00:00Z,FT MYERS FL,0,2,9,5,16
Hurricane,Ivan,41,2004-09-12T15:00:00Z,MWCG 193N 814W,99,0,0,0,99
Hurricane,Ivan,41,2004-09-12T15:00:00Z,VENICE FL,0,1,9,6,16
Hurricane,Ivan,41,2004-09-12T15:00:00Z,MUCF 221N 805W,14,1,1,0,16
Hurricane,Ivan,41,2004-09-12T15:00:00Z,TAMPA FL,0,0,5,10,15
Hurricane,Ivan,41,2004-09-12T15:00:00Z,MUSN 216N 826W,51,0,0,0,51
Hurricane,Ivan,41,2004-09-12T15:00:00Z,CEDAR KEY FL,0,0,2,12,14
Hurricane,Ivan,41,2004-09-12T15:00:00Z,MUHA 230N 824W,26,4,0,0,30
Hurricane,Ivan,41,2004-09-12T15:00:00Z,ST MARKS FL,0,0,0,13,13
Hurricane,Ivan,41,2004-09-12T15:00:00Z,MUAN 219N 850W,22,7,0,0,29
Hurricane,Ivan,41,2004-09-12T15:00:00Z,APALACHICOLA FL,0,0,1,13,14
Hurricane,Ivan,41,2004-09-12T15:00:00Z,MMCZ 205N 869W,1,4,1,0,6
Hurricane,Ivan,41,2004-09-12T15:00:00Z,PANAMA CITY FL,0,0,0,14,14
Hurricane,Ivan,41,2004-09-12T15:00:00Z,MYNN 251N 775W,0,0,0,2,2
Hurricane,Ivan,41,2004-09-12T15:00:00Z,PENSACOLA FL,0,0,0,12,12
Hurricane,Ivan,41,2004-09-12T15:00:00Z,MYGF 266N 787W,0,0,1,4,5
Hurricane,Ivan,41,2004-09-12T15:00:00Z,MOBILE AL,0,0,0,10,10
Hurricane,Ivan,41,2004-09-12T15:00:00Z,MARATHON FL,1,9,4,1,15
Hurricane,Ivan,41,2004-09-12T15:00:00Z,GULFPORT MS,0,0,0,9,9
Hurricane,Ivan,41,2004-09-12T15:00:00Z,MIAMI FL,0,2,5,4,11
Hurricane,Ivan,41,2004-09-12T15:00:00Z,BURAS LA,0,0,0,10,10
Hurricane,Ivan,41,2004-09-12T15:00:00Z,W PALM BEACH FL,0,0,4,6,10
Hurricane,Ivan,41,2004-09-12T15:00:00Z,NEW ORLEANS LA,0,0,0,7,7
Hurricane,Ivan,41,2004-09-12T15:00:00Z,FT PIERCE FL,0,0,3,7,10
Hurricane,Ivan,41,2004-09-12T15:00:00Z,NEW IBERIA LA,0,0,0,4,4
Hurricane,Ivan,41,2004-09-12T15:00:00Z,COCOA BEACH FL,0,0,2,8,10
Hurricane,Ivan,41,2004-09-12T15:00:00Z,GULF 29N 85W,0,0,2,14,16
Hurricane,Ivan,41,2004-09-12T15:00:00Z,DAYTONA BEACH FL,0,0,1,9,10
Hurricane,Ivan,41,2004-09-12T15:00:00Z,GULF 29N 87W,0,0,1,14,15
Hurricane,Ivan,41,2004-09-12T15:00:00Z,JACKSONVILLE FL,0,0,0,9,9
Hurricane,Ivan,41,2004-09-12T15:00:00Z,GULF 28N 89W,0,0,1,11,12
Hurricane,Ivan,41,2004-09-12T15:00:00Z,SAVANNAH GA,0,0,0,5,5
Hurricane,Ivan,41,2004-09-12T15:00:00Z,GULF 28N 91W,0,0,0,7,7
Hurricane,Ivan,41,2004-09-12T15:00:00Z,CHARLESTON SC,0,0,0,2,2
Hurricane,Ivan,41,2004-09-12T15:00:00Z,GULF 28N 93W,0,0,0,2,2
Hurricane,Ivan,42,2004-09-12T21:00:00Z,21.3N  84.7W,40,0,0,0,40
Hurricane,Ivan,42,2004-09-12T21:00:00Z,VENICE FL,0,0,5,7,12
Hurricane,Ivan,42,2004-09-12T21:00:00Z,23.1N  85.5W,3,24,0,1,28
Hurricane,Ivan,42,2004-09-12T21:00:00Z,TAMPA FL,0,0,3,8,11
Hurricane,Ivan,42,2004-09-12T21:00:00Z,25.4N  86.0W,0,8,14,2,24
Hurricane,Ivan,42,2004-09-12T21:00:00Z,CEDAR KEY FL,0,0,1,9,10
Hurricane,Ivan,42,2004-09-12T21:00:00Z,MWCG 193N 814W,99,0,0,0,99
Hurricane,Ivan,42,2004-09-12T21:00:00Z,ST MARKS FL,0,0,1,9,10
Hurricane,Ivan,42,2004-09-12T21:00:00Z,MUCF 221N 805W,1,1,1,2,5
Hurricane,Ivan,42,2004-09-12T21:00:00Z,APALACHICOLA FL,0,0,2,10,12
Hurricane,Ivan,42,2004-09-12T21:00:00Z,MUSN 216N 826W,26,1,0,0,27
Hurricane,Ivan,42,2004-09-12T21:00:00Z,PANAMA CITY FL,0,0,2,10,12
Hurricane,Ivan,42,2004-09-12T21:00:00Z,MUHA 230N 824W,5,9,1,1,16
Hurricane,Ivan,42,2004-09-12T21:00:00Z,PENSACOLA FL,0,0,1,11,12
Hurricane,Ivan,42,2004-09-12T21:00:00Z,MUAN 219N 850W,30,2,0,1,33
Hurricane,Ivan,42,2004-09-12T21:00:00Z,MOBILE AL,0,0,1,10,11
Hurricane,Ivan,42,2004-09-12T21:00:00Z,MMCZ 205N 869W,18,3,0,0,21
Hurricane,Ivan,42,2004-09-12T21:00:00Z,GULFPORT MS,0,0,1,10,11
Hurricane,Ivan,42,2004-09-12T21:00:00Z,MYGF 266N 787W,0,0,0,3,3
Hurricane,Ivan,42,2004-09-12T21:00:00Z,BURAS LA,0,0,2,10,12
Hurricane,Ivan,42,2004-09-12T21:00:00Z,MMMD 210N 897W,0,3,1,1,5
Hurricane,Ivan,42,2004-09-12T21:00:00Z,NEW ORLEANS LA,0,0,1,9,10
Hurricane,Ivan,42,2004-09-12T21:00:00Z,MARATHON FL,0,1,4,4,9
Hurricane,Ivan,42,2004-09-12T21:00:00Z,NEW IBERIA LA,0,0,0,8,8
Hurricane,Ivan,42,2004-09-12T21:00:00Z,MIAMI FL,0,0,2,5,7
Hurricane,Ivan,42,2004-09-12T21:00:00Z,PORT ARTHUR TX,0,0,0,4,4
Hurricane,Ivan,42,2004-09-12T21:00:00Z,W PALM BEACH FL,0,0,1,5,6
Hurricane,Ivan,42,2004-09-12T21:00:00Z,GALVESTON TX,0,0,0,3,3
Hurricane,Ivan,42,2004-09-12T21:00:00Z,FT PIERCE FL,0,0,1,5,6
Hurricane,Ivan,42,2004-09-12T21:00:00Z,FREEPORT TX,0,0,0,2,2
Hurricane,Ivan,42,2004-09-12T21:00:00Z,COCOA BEACH FL,0,0,0,6,6
Hurricane,Ivan,42,2004-09-12T21:00:00Z,GULF 29N 85W,0,0,4,10,14
Hurricane,Ivan,42,2004-09-12T21:00:00Z,DAYTONA BEACH FL,0,0,0,6,6
Hurricane,Ivan,42,2004-09-12T21:00:00Z,GULF 29N 87W,0,0,5,10,15
Hurricane,Ivan,42,2004-09-12T21:00:00Z,JACKSONVILLE FL,0,0,0,6,6
Hurricane,Ivan,42,2004-09-12T21:00:00Z,GULF 28N 89W,0,0,7,8,15
Hurricane,Ivan,42,2004-09-12T21:00:00Z,SAVANNAH GA,0,0,0,3,3
Hurricane,Ivan,42,2004-09-12T21:00:00Z,GULF 28N 91W,0,0,3,8,11
Hurricane,Ivan,42,2004-09-12T21:00:00Z,KEY WEST FL,0,3,6,3,12
Hurricane,Ivan,42,2004-09-12T21:00:00Z,GULF 28N 93W,0,0,1,6,7
Hurricane,Ivan,42,2004-09-12T21:00:00Z,MARCO ISLAND FL,0,0,5,6,11
Hurricane,Ivan,42,2004-09-12T21:00:00Z,GULF 28N 95W,0,0,0,3,3
Hurricane,Ivan,42,2004-09-12T21:00:00Z,FT MYERS FL,0,0,5,6,11
Hurricane,Ivan,42,2004-09-12T21:00:00Z,GULF 27N 96W,0,0,0,2,2
Hurricane,Ivan,43,2004-09-13T03:00:00Z,22.3N  85.0W,40,0,0,0,40
Hurricane,Ivan,43,2004-09-13T03:00:00Z,TAMPA FL,0,0,2,8,10
Hurricane,Ivan,43,2004-09-13T03:00:00Z,23.9N  85.9W,6,21,1,0,28
Hurricane,Ivan,43,2004-09-13T03:00:00Z,CEDAR KEY FL,0,0,1,9,10
Hurricane,Ivan,43,2004-09-13T03:00:00Z,25.8N  86.5W,0,12,9,2,23
Hurricane,Ivan,43,2004-09-13T03:00:00Z,ST MARKS FL,0,0,1,10,11
Hurricane,Ivan,43,2004-09-13T03:00:00Z,MWCG 193N 814W,13,0,0,1,14
Hurricane,Ivan,43,2004-09-13T03:00:00Z,APALACHICOLA FL,0,0,2,11,13
Hurricane,Ivan,43,2004-09-13T03:00:00Z,MUCF 221N 805W,0,1,0,1,2
Hurricane,Ivan,43,2004-09-13T03:00:00Z,PANAMA CITY FL,0,0,2,11,13
Hurricane,Ivan,43,2004-09-13T03:00:00Z,MUSN 216N 826W,39,0,0,0,39
Hurricane,Ivan,43,2004-09-13T03:00:00Z,PENSACOLA FL,0,0,1,12,13
Hurricane,Ivan,43,2004-09-13T03:00:00Z,MUHA 230N 824W,11,3,1,0,15
Hurricane,Ivan,43,2004-09-13T03:00:00Z,MOBILE AL,0,0,1,12,13
Hurricane,Ivan,43,2004-09-13T03:00:00Z,MUAN 219N 850W,46,0,0,0,46
Hurricane,Ivan,43,2004-09-13T03:00:00Z,GULFPORT MS,0,0,2,11,13
Hurricane,Ivan,43,2004-09-13T03:00:00Z,MMCZ 205N 869W,15,0,0,0,15
Hurricane,Ivan,43,2004-09-13T03:00:00Z,BURAS LA,0,0,4,10,14
Hurricane,Ivan,43,2004-09-13T03:00:00Z,MYGF 266N 787W,0,0,0,2,2
Hurricane,Ivan,43,2004-09-13T03:00:00Z,NEW ORLEANS LA,0,0,2,11,13
Hurricane,Ivan,43,2004-09-13T03:00:00Z,MARATHON FL,0,1,2,3,6
Hurricane,Ivan,43,2004-09-13T03:00:00Z,NEW IBERIA LA,0,0,1,9,10
Hurricane,Ivan,43,2004-09-13T03:00:00Z,MIAMI FL,0,0,1,3,4
Hurricane,Ivan,43,2004-09-13T03:00:00Z,PORT ARTHUR TX,0,0,0,6,6
Hurricane,Ivan,43,2004-09-13T03:00:00Z,W PALM BEACH FL,0,0,0,4,4
Hurricane,Ivan,43,2004-09-13T03:00:00Z,GALVESTON TX,0,0,0,4,4
Hurricane,Ivan,43,2004-09-13T03:00:00Z,FT PIERCE FL,0,0,0,5,5
Hurricane,Ivan,43,2004-09-13T03:00:00Z,FREEPORT TX,0,0,0,3,3
Hurricane,Ivan,43,2004-09-13T03:00:00Z,COCOA BEACH FL,0,0,0,5,5
Hurricane,Ivan,43,2004-09-13T03:00:00Z,PORT O CONNOR TX,0,0,0,2,2
Hurricane,Ivan,43,2004-09-13T03:00:00Z,DAYTONA BEACH FL,0,0,0,6,6
Hurricane,Ivan,43,2004-09-13T03:00:00Z,GULF 29N 85W,0,0,3,11,14
Hurricane,Ivan,43,2004-09-13T03:00:00Z,JACKSONVILLE FL,0,0,0,6,6
Hurricane,Ivan,43,2004-09-13T03:00:00Z,GULF 29N 87W,0,0,6,10,16
Hurricane,Ivan,43,2004-09-13T03:00:00Z,SAVANNAH GA,0,0,0,4,4
Hurricane,Ivan,43,2004-09-13T03:00:00Z,GULF 28N 89W,0,0,11,6,17
Hurricane,Ivan,43,2004-09-13T03:00:00Z,CHARLESTON SC,0,0,0,2,2
Hurricane,Ivan,43,2004-09-13T03:00:00Z,GULF 28N 91W,0,0,6,7,13
Hurricane,Ivan,43,2004-09-13T03:00:00Z,KEY WEST FL,0,2,4,3,9
Hurricane,Ivan,43,2004-09-13T03:00:00Z,GULF 28N 93W,0,0,1,7,8
Hurricane,Ivan,43,2004-09-13T03:00:00Z,MARCO ISLAND FL,0,0,3,5,8
Hurricane,Ivan,43,2004-09-13T03:00:00Z,GULF 28N 95W,0,0,0,3,3
Hurricane,Ivan,43,2004-09-13T03:00:00Z,FT MYERS FL,0,0,3,6,9
Hurricane,Ivan,43,2004-09-13T03:00:00Z,GULF 27N 96W,0,0,0,2,2
Hurricane,Ivan,43,2004-09-13T03:00:00Z,VENICE FL,0,0,3,7,10
Hurricane,Ivan,44,2004-09-13T09:00:00Z,22.5N  86.0W,40,0,0,0,40
Hurricane,Ivan,44,2004-09-13T09:00:00Z,CEDAR KEY FL,0,0,1,7,8
Hurricane,Ivan,44,2004-09-13T09:00:00Z,24.2N  87.1W,7,21,0,1,29
Hurricane,Ivan,44,2004-09-13T09:00:00Z,ST MARKS FL,0,0,1,9,10
Hurricane,Ivan,44,2004-09-13T09:00:00Z,26.0N  87.5W,0,15,7,1,23
Hurricane,Ivan,44,2004-09-13T09:00:00Z,APALACHICOLA FL,0,0,2,10,12
Hurricane,Ivan,44,2004-09-13T09:00:00Z,MUSN 216N 826W,33,0,0,0,33
Hurricane,Ivan,44,2004-09-13T09:00:00Z,PANAMA CITY FL,0,0,2,11,13
Hurricane,Ivan,44,2004-09-13T09:00:00Z,MUHA 230N 824W,4,3,1,1,9
Hurricane,Ivan,44,2004-09-13T09:00:00Z,PENSACOLA FL,0,0,2,12,14
Hurricane,Ivan,44,2004-09-13T09:00:00Z,MUAN 219N 850W,56,0,0,0,56
Hurricane,Ivan,44,2004-09-13T09:00:00Z,MOBILE AL,0,0,2,12,14
Hurricane,Ivan,44,2004-09-13T09:00:00Z,MMCZ 205N 869W,21,0,0,0,21
Hurricane,Ivan,44,2004-09-13T09:00:00Z,GULFPORT MS,0,0,3,11,14
Hurricane,Ivan,44,2004-09-13T09:00:00Z,MMMD 210N 897W,1,2,0,1,4
Hurricane,Ivan,44,2004-09-13T09:00:00Z,BURAS LA,0,0,7,9,16
Hurricane,Ivan,44,2004-09-13T09:00:00Z,MARATHON FL,0,0,1,3,4
Hurricane,Ivan,44,2004-09-13T09:00:00Z,NEW ORLEANS LA,0,0,4,10,14
Hurricane,Ivan,44,2004-09-13T09:00:00Z,MIAMI FL,0,0,0,3,3
Hurricane,Ivan,44,2004-09-13T09:00:00Z,NEW IBERIA LA,0,0,2,10,12
Hurricane,Ivan,44,2004-09-13T09:00:00Z,W PALM BEACH FL,0,0,0,3,3
Hurricane,Ivan,44,2004-09-13T09:00:00Z,PORT ARTHUR TX,0,0,0,7,7
Hurricane,Ivan,44,2004-09-13T09:00:00Z,FT PIERCE FL,0,0,0,3,3
Hurricane,Ivan,44,2004-09-13T09:00:00Z,GALVESTON TX,0,0,0,6,6
Hurricane,Ivan,44,2004-09-13T09:00:00Z,COCOA BEACH FL,0,0,0,3,3
Hurricane,Ivan,44,2004-09-13T09:00:00Z,FREEPORT TX,0,0,0,5,5
Hurricane,Ivan,44,2004-09-13T09:00:00Z,DAYTONA BEACH FL,0,0,0,4,4
Hurricane,Ivan,44,2004-09-13T09:00:00Z,PORT O CONNOR TX,0,0,0,3,3
Hurricane,Ivan,44,2004-09-13T09:00:00Z,JACKSONVILLE FL,0,0,0,5,5
Hurricane,Ivan,44,2004-09-13T09:00:00Z,GULF 29N 85W,0,0,3,10,13
Hurricane,Ivan,44,2004-09-13T09:00:00Z,SAVANNAH GA,0,0,0,3,3
Hurricane,Ivan,44,2004-09-13T09:00:00Z,GULF 29N 87W,0,0,8,8,16
Hurricane,Ivan,44,2004-09-13T09:00:00Z,KEY WEST FL,0,1,2,2,5
Hurricane,Ivan,44,2004-09-13T09:00:00Z,GULF 28N 89W,0,1,13,5,19
Hurricane,Ivan,44,2004-09-13T09:00:00Z,MARCO ISLAND FL,0,0,1,5,6
Hurricane,Ivan,44,2004-09-13T09:00:00Z,GULF 28N 91W,0,0,9,6,15
Hurricane,Ivan,44,2004-09-13T09:00:00Z,FT MYERS FL,0,0,1,5,6
Hurricane,Ivan,44,2004-09-13T09:00:00Z,GULF 28N 93W,0,0,3,7,10
Hurricane,Ivan,44,2004-09-13T09:00:00Z,VENICE FL,0,0,2,6,8
Hurricane,Ivan,44,2004-09-13T09:00:00Z,GULF 28N 95W,0,0,0,5,5
Hurricane,Ivan,44,2004-09-13T09:00:00Z,TAMPA FL,0,0,1,7,8
Hurricane,Ivan,44,2004-09-13T09:00:00Z,GULF 27N 96W,0,0,0,3,3
Hurricane,Ivan,45,2004-09-13T15:00:00Z,23.2N  86.5W,40,0,0,0,40
Hurricane,Ivan,45,2004-09-13T15:00:00Z,CEDAR KEY FL,0,0,1,8,9
Hurricane,Ivan,45,2004-09-13T15:00:00Z,25.2N  87.4W,2,25,1,0,28
Hurricane,Ivan,45,2004-09-13T15:00:00Z,ST MARKS FL,0,0,1,10,11
Hurricane,Ivan,45,2004-09-13T15:00:00Z,27.2N  87.7W,0,10,11,1,22
Hurricane,Ivan,45,2004-09-13T15:00:00Z,APALACHICOLA FL,0,0,3,10,13
Hurricane,Ivan,45,2004-09-13T15:00:00Z,MUSN 216N 826W,14,0,0,1,15
Hurricane,Ivan,45,2004-09-13T15:00:00Z,PANAMA CITY FL,0,0,4,10,14
Hurricane,Ivan,45,2004-09-13T15:00:00Z,MUHA 230N 824W,1,1,1,1,4
Hurricane,Ivan,45,2004-09-13T15:00:00Z,PENSACOLA FL,0,0,4,11,15
Hurricane,Ivan,45,2004-09-13T15:00:00Z,MUAN 219N 850W,66,0,0,0,66
Hurricane,Ivan,45,2004-09-13T15:00:00Z,MOBILE AL,0,0,5,10,15
Hurricane,Ivan,45,2004-09-13T15:00:00Z,MMCZ 205N 869W,26,0,0,1,27
Hurricane,Ivan,45,2004-09-13T15:00:00Z,GULFPORT MS,0,0,6,10,16
Hurricane,Ivan,45,2004-09-13T15:00:00Z,MMMD 210N 897W,1,0,0,1,2
Hurricane,Ivan,45,2004-09-13T15:00:00Z,BURAS LA,0,0,12,5,17
Hurricane,Ivan,45,2004-09-13T15:00:00Z,MARATHON FL,0,0,1,2,3
Hurricane,Ivan,45,2004-09-13T15:00:00Z,NEW ORLEANS LA,0,0,8,8,16
Hurricane,Ivan,45,2004-09-13T15:00:00Z,MIAMI FL,0,0,0,2,2
Hurricane,Ivan,45,2004-09-13T15:00:00Z,NEW IBERIA LA,0,0,5,8,13
Hurricane,Ivan,45,2004-09-13T15:00:00Z,W PALM BEACH FL,0,0,0,3,3
Hurricane,Ivan,45,2004-09-13T15:00:00Z,PORT ARTHUR TX,0,0,1,7,8
Hurricane,Ivan,45,2004-09-13T15:00:00Z,FT PIERCE FL,0,0,0,3,3
Hurricane,Ivan,45,2004-09-13T15:00:00Z,GALVESTON TX,0,0,1,5,6
Hurricane,Ivan,45,2004-09-13T15:00:00Z,COCOA BEACH FL,0,0,0,4,4
Hurricane,Ivan,45,2004-09-13T15:00:00Z,FREEPORT TX,0,0,1,3,4
Hurricane,Ivan,45,2004-09-13T15:00:00Z,DAYTONA BEACH FL,0,0,0,5,5
Hurricane,Ivan,45,2004-09-13T15:00:00Z,PORT O CONNOR TX,0,0,0,2,2
Hurricane,Ivan,45,2004-09-13T15:00:00Z,JACKSONVILLE FL,0,0,0,6,6
Hurricane,Ivan,45,2004-09-13T15:00:00Z,GULF 29N 85W,0,0,6,8,14
Hurricane,Ivan,45,2004-09-13T15:00:00Z,SAVANNAH GA,0,0,0,4,4
Hurricane,Ivan,45,2004-09-13T15:00:00Z,GULF 29N 87W,0,0,12,6,18
Hurricane,Ivan,45,2004-09-13T15:00:00Z,CHARLESTON SC,0,0,0,3,3
Hurricane,Ivan,45,2004-09-13T15:00:00Z,GULF 28N 89W,0,4,14,3,21
Hurricane,Ivan,45,2004-09-13T15:00:00Z,KEY WEST FL,0,1,1,2,4
Hurricane,Ivan,45,2004-09-13T15:00:00Z,GULF 28N 91W,0,2,11,4,17
Hurricane,Ivan,45,2004-09-13T15:00:00Z,MARCO ISLAND FL,0,0,1,4,5
Hurricane,Ivan,45,2004-09-13T15:00:00Z,GULF 28N 93W,0,0,6,4,10
Hurricane,Ivan,45,2004-09-13T15:00:00Z,FT MYERS FL,0,0,2,4,6
Hurricane,Ivan,45,2004-09-13T15:00:00Z,GULF 28N 95W,0,0,1,3,4
Hurricane,Ivan,45,2004-09-13T15:00:00Z,VENICE FL,0,0,2,6,8
Hurricane,Ivan,45,2004-09-13T15:00:00Z,GULF 27N 96W,0,0,0,2,2
Hurricane,Ivan,45,2004-09-13T15:00:00Z,TAMPA FL,0,0,2,6,8
Hurricane,Ivan,46,2004-09-13T21:00:00Z,24.2N  86.7W,39,0,0,0,39
Hurricane,Ivan,46,2004-09-13T21:00:00Z,ST MARKS FL,0,0,5,8,13
Hurricane,Ivan,46,2004-09-13T21:00:00Z,26.1N  87.6W,9,20,1,0,30
Hurricane,Ivan,46,2004-09-13T21:00:00Z,APALACHICOLA FL,0,1,8,6,15
Hurricane,Ivan,46,2004-09-13T21:00:00Z,28.2N  87.7W,0,16,7,2,25
Hurricane,Ivan,46,2004-09-13T21:00:00Z,PANAMA CITY FL,0,1,10,6,17
Hurricane,Ivan,46,2004-09-13T21:00:00Z,MUHA 230N 824W,1,1,0,0,2
Hurricane,Ivan,46,2004-09-13T21:00:00Z,PENSACOLA FL,0,1,13,5,19
Hurricane,Ivan,46,2004-09-13T21:00:00Z,MUAN 219N 850W,99,0,0,0,99
Hurricane,Ivan,46,2004-09-13T21:00:00Z,MOBILE AL,0,1,14,4,19
Hurricane,Ivan,46,2004-09-13T21:00:00Z,FT PIERCE FL,0,0,0,2,2
Hurricane,Ivan,46,2004-09-13T21:00:00Z,GULFPORT MS,0,2,13,5,20
Hurricane,Ivan,46,2004-09-13T21:00:00Z,COCOA BEACH FL,0,0,0,3,3
Hurricane,Ivan,46,2004-09-13T21:00:00Z,BURAS LA,0,6,12,3,21
Hurricane,Ivan,46,2004-09-13T21:00:00Z,DAYTONA BEACH FL,0,0,0,5,5
Hurricane,Ivan,46,2004-09-13T21:00:00Z,NEW ORLEANS LA,0,2,12,4,18
Hurricane,Ivan,46,2004-09-13T21:00:00Z,JACKSONVILLE FL,0,0,0,6,6
Hurricane,Ivan,46,2004-09-13T21:00:00Z,NEW IBERIA LA,0,1,7,5,13
Hurricane,Ivan,46,2004-09-13T21:00:00Z,SAVANNAH GA,0,0,0,5,5
Hurricane,Ivan,46,2004-09-13T21:00:00Z,PORT ARTHUR TX,0,0,1,6,7
Hurricane,Ivan,46,2004-09-13T21:00:00Z,CHARLESTON SC,0,0,0,3,3
Hurricane,Ivan,46,2004-09-13T21:00:00Z,GALVESTON TX,0,0,0,4,4
Hurricane,Ivan,46,2004-09-13T21:00:00Z,MYRTLE BEACH SC,0,0,0,2,2
Hurricane,Ivan,46,2004-09-13T21:00:00Z,FREEPORT TX,0,0,0,3,3
Hurricane,Ivan,46,2004-09-13T21:00:00Z,KEY WEST FL,0,0,1,1,2
Hurricane,Ivan,46,2004-09-13T21:00:00Z,GULF 29N 85W,0,2,9,5,16
Hurricane,Ivan,46,2004-09-13T21:00:00Z,MARCO ISLAND FL,0,0,1,2,3
Hurricane,Ivan,46,2004-09-13T21:00:00Z,GULF 29N 87W,0,7,13,2,22
Hurricane,Ivan,46,2004-09-13T21:00:00Z,FT MYERS FL,0,0,1,3,4
Hurricane,Ivan,46,2004-09-13T21:00:00Z,GULF 28N 89W,0,17,6,1,24
Hurricane,Ivan,46,2004-09-13T21:00:00Z,VENICE FL,0,0,2,4,6
Hurricane,Ivan,46,2004-09-13T21:00:00Z,GULF 28N 91W,0,7,7,3,17
Hurricane,Ivan,46,2004-09-13T21:00:00Z,TAMPA FL,0,0,2,5,7
Hurricane,Ivan,46,2004-09-13T21:00:00Z,GULF 28N 93W,0,1,3,4,8
Hurricane,Ivan,46,2004-09-13T21:00:00Z,CEDAR KEY FL,0,0,3,6,9
Hurricane,Ivan,46,2004-09-13T21:00:00Z,GULF 28N 95W,0,0,0,3,3
Hurricane,Ivan,47,2004-09-14T03:00:00Z,24.8N  87.3W,40,0,0,0,40
Hurricane,Ivan,47,2004-09-14T03:00:00Z,PENSACOLA FL,0,0,9,7,16
Hurricane,Ivan,47,2004-09-14T03:00:00Z,26.6N  88.2W,10,18,0,1,29
Hurricane,Ivan,47,2004-09-14T03:00:00Z,MOBILE AL,0,1,10,6,17
Hurricane,Ivan,47,2004-09-14T03:00:00Z,28.5N  88.5W,0,15,6,1,22
Hurricane,Ivan,47,2004-09-14T03:00:00Z,GULFPORT MS,0,1,12,5,18
Hurricane,Ivan,47,2004-09-14T03:00:00Z,MUAN 219N 850W,99,0,0,0,99
Hurricane,Ivan,47,2004-09-14T03:00:00Z,BURAS LA,0,7,11,2,20
Hurricane,Ivan,47,2004-09-14T03:00:00Z,FT PIERCE FL,0,0,0,2,2
Hurricane,Ivan,47,2004-09-14T03:00:00Z,NEW ORLEANS LA,0,3,12,3,18
Hurricane,Ivan,47,2004-09-14T03:00:00Z,COCOA BEACH FL,0,0,0,3,3
Hurricane,Ivan,47,2004-09-14T03:00:00Z,NEW IBERIA LA,0,1,10,5,16
Hurricane,Ivan,47,2004-09-14T03:00:00Z,DAYTONA BEACH FL,0,0,0,4,4
Hurricane,Ivan,47,2004-09-14T03:00:00Z,PORT ARTHUR TX,0,0,4,6,10
Hurricane,Ivan,47,2004-09-14T03:00:00Z,JACKSONVILLE FL,0,0,0,5,5
Hurricane,Ivan,47,2004-09-14T03:00:00Z,GALVESTON TX,0,0,2,5,7
Hurricane,Ivan,47,2004-09-14T03:00:00Z,SAVANNAH GA,0,0,0,4,4
Hurricane,Ivan,47,2004-09-14T03:00:00Z,FREEPORT TX,0,0,1,4,5
Hurricane,Ivan,47,2004-09-14T03:00:00Z,CHARLESTON SC,0,0,0,2,2
Hurricane,Ivan,47,2004-09-14T03:00:00Z,PORT O CONNOR TX,0,0,0,2,2
Hurricane,Ivan,47,2004-09-14T03:00:00Z,MARCO ISLAND FL,0,0,1,2,3
Hurricane,Ivan,47,2004-09-14T03:00:00Z,GULF 29N 85W,0,1,7,5,13
Hurricane,Ivan,47,2004-09-14T03:00:00Z,FT MYERS FL,0,0,1,2,3
Hurricane,Ivan,47,2004-09-14T03:00:00Z,GULF 29N 87W,0,6,9,3,18
Hurricane,Ivan,47,2004-09-14T03:00:00Z,VENICE FL,0,0,2,3,5
Hurricane,Ivan,47,2004-09-14T03:00:00Z,GULF 28N 89W,0,19,4,1,24
Hurricane,Ivan,47,2004-09-14T03:00:00Z,TAMPA FL,0,0,1,5,6
Hurricane,Ivan,47,2004-09-14T03:00:00Z,GULF 28N 91W,0,11,6,2,19
Hurricane,Ivan,47,2004-09-14T03:00:00Z,CEDAR KEY FL,0,0,1,6,7
Hurricane,Ivan,47,2004-09-14T03:00:00Z,GULF 28N 93W,0,2,5,4,11
Hurricane,Ivan,47,2004-09-14T03:00:00Z,ST MARKS FL,0,0,2,8,10
Hurricane,Ivan,47,2004-09-14T03:00:00Z,GULF 28N 95W,0,0,1,3,4
Hurricane,Ivan,47,2004-09-14T03:00:00Z,APALACHICOLA FL,0,0,5,7,12
Hurricane,Ivan,47,2004-09-14T03:00:00Z,GULF 27N 96W,0,0,0,2,2
Hurricane,Ivan,47,2004-09-14T03:00:00Z,PANAMA CITY FL,0,0,6,8,14
Hurricane,Ivan,48,2004-09-14T09:00:00Z,26.0N  87.7W,40,1,0,0,41
Hurricane,Ivan,48,2004-09-14T09:00:00Z,PANAMA CITY FL,0,3,10,3,16
Hurricane,Ivan,48,2004-09-14T09:00:00Z,28.0N  88.3W,5,24,0,0,29
Hurricane,Ivan,48,2004-09-14T09:00:00Z,PENSACOLA FL,0,7,12,2,21
Hurricane,Ivan,48,2004-09-14T09:00:00Z,30.0N  88.0W,0,14,8,2,24
Hurricane,Ivan,48,2004-09-14T09:00:00Z,MOBILE AL,0,9,12,2,23
Hurricane,Ivan,48,2004-09-14T09:00:00Z,MUAN 219N 850W,99,0,0,0,99
Hurricane,Ivan,48,2004-09-14T09:00:00Z,GULFPORT MS,0,13,9,1,23
Hurricane,Ivan,48,2004-09-14T09:00:00Z,COCOA BEACH FL,0,0,0,2,2
Hurricane,Ivan,48,2004-09-14T09:00:00Z,BURAS LA,0,21,3,1,25
Hurricane,Ivan,48,2004-09-14T09:00:00Z,DAYTONA BEACH FL,0,0,0,3,3
Hurricane,Ivan,48,2004-09-14T09:00:00Z,NEW ORLEANS LA,0,14,6,2,22
Hurricane,Ivan,48,2004-09-14T09:00:00Z,JACKSONVILLE FL,0,0,0,6,6
Hurricane,Ivan,48,2004-09-14T09:00:00Z,NEW IBERIA LA,0,6,7,3,16
Hurricane,Ivan,48,2004-09-14T09:00:00Z,SAVANNAH GA,0,0,0,5,5
Hurricane,Ivan,48,2004-09-14T09:00:00Z,PORT ARTHUR TX,0,0,3,4,7
Hurricane,Ivan,48,2004-09-14T09:00:00Z,CHARLESTON SC,0,0,0,4,4
Hurricane,Ivan,48,2004-09-14T09:00:00Z,GALVESTON TX,0,0,1,3,4
Hurricane,Ivan,48,2004-09-14T09:00:00Z,MYRTLE BEACH SC,0,0,0,2,2
Hurricane,Ivan,48,2004-09-14T09:00:00Z,FREEPORT TX,0,0,0,2,2
Hurricane,Ivan,48,2004-09-14T09:00:00Z,FT MYERS FL,0,0,0,2,2
Hurricane,Ivan,48,2004-09-14T09:00:00Z,GULF 29N 85W,0,4,7,3,14
Hurricane,Ivan,48,2004-09-14T09:00:00Z,VENICE FL,0,0,1,2,3
Hurricane,Ivan,48,2004-09-14T09:00:00Z,GULF 29N 87W,0,17,4,1,22
Hurricane,Ivan,48,2004-09-14T09:00:00Z,TAMPA FL,0,0,1,4,5
Hurricane,Ivan,48,2004-09-14T09:00:00Z,GULF 28N 89W,5,23,1,0,29
Hurricane,Ivan,48,2004-09-14T09:00:00Z,CEDAR KEY FL,0,0,2,5,7
Hurricane,Ivan,48,2004-09-14T09:00:00Z,GULF 28N 91W,1,15,2,1,19
Hurricane,Ivan,48,2004-09-14T09:00:00Z,ST MARKS FL,0,0,6,6,12
Hurricane,Ivan,48,2004-09-14T09:00:00Z,GULF 28N 93W,0,2,3,2,7
Hurricane,Ivan,48,2004-09-14T09:00:00Z,APALACHICOLA FL,0,2,8,4,14
Hurricane,Ivan,48,2004-09-14T09:00:00Z,GULF 28N 95W,0,0,0,2,2
Hurricane,Ivan,49,2004-09-14T15:00:00Z,26.3N  88.0W,43,0,0,0,43
Hurricane,Ivan,49,2004-09-14T15:00:00Z,PENSACOLA FL,0,13,7,1,21
Hurricane,Ivan,49,2004-09-14T15:00:00Z,28.5N  88.5W,7,24,0,0,31
Hurricane,Ivan,49,2004-09-14T15:00:00Z,MOBILE AL,0,15,7,2,24
Hurricane,Ivan,49,2004-09-14T15:00:00Z,30.5N  88.5W,0,18,5,2,25
Hurricane,Ivan,49,2004-09-14T15:00:00Z,GULFPORT MS,0,19,5,1,25
Hurricane,Ivan,49,2004-09-14T15:00:00Z,DAYTONA BEACH FL,0,0,0,2,2
Hurricane,Ivan,49,2004-09-14T15:00:00Z,BURAS LA,1,24,1,1,27
Hurricane,Ivan,49,2004-09-14T15:00:00Z,JACKSONVILLE FL,0,0,0,5,5
Hurricane,Ivan,49,2004-09-14T15:00:00Z,NEW ORLEANS LA,0,18,4,1,23
Hurricane,Ivan,49,2004-09-14T15:00:00Z,SAVANNAH GA,0,0,0,5,5
Hurricane,Ivan,49,2004-09-14T15:00:00Z,NEW IBERIA LA,0,8,6,2,16
Hurricane,Ivan,49,2004-09-14T15:00:00Z,CHARLESTON SC,0,0,0,4,4
Hurricane,Ivan,49,2004-09-14T15:00:00Z,PORT ARTHUR TX,0,0,4,3,7
Hurricane,Ivan,49,2004-09-14T15:00:00Z,MYRTLE BEACH SC,0,0,0,2,2
Hurricane,Ivan,49,2004-09-14T15:00:00Z,GALVESTON TX,0,0,1,3,4
Hurricane,Ivan,49,2004-09-14T15:00:00Z,WILMINGTON NC,0,0,0,2,2
Hurricane,Ivan,49,2004-09-14T15:00:00Z,FREEPORT TX,0,0,0,2,2
Hurricane,Ivan,49,2004-09-14T15:00:00Z,VENICE FL,0,0,0,2,2
Hurricane,Ivan,49,2004-09-14T15:00:00Z,GULF 29N 85W,0,6,4,3,13
Hurricane,Ivan,49,2004-09-14T15:00:00Z,TAMPA FL,0,0,1,2,3
Hurricane,Ivan,49,2004-09-14T15:00:00Z,GULF 29N 87W,2,20,1,1,24
Hurricane,Ivan,49,2004-09-14T15:00:00Z,CEDAR KEY FL,0,0,2,4,6
Hurricane,Ivan,49,2004-09-14T15:00:00Z,GULF 28N 89W,13,19,1,0,33
Hurricane,Ivan,49,2004-09-14T15:00:00Z,ST MARKS FL,0,1,5,5,11
Hurricane,Ivan,49,2004-09-14T15:00:00Z,GULF 28N 91W,2,16,1,1,20
Hurricane,Ivan,49,2004-09-14T15:00:00Z,APALACHICOLA FL,0,4,6,3,13
Hurricane,Ivan,49,2004-09-14T15:00:00Z,GULF 28N 93W,0,3,3,1,7
Hurricane,Ivan,49,2004-09-14T15:00:00Z,PANAMA CITY FL,0,6,7,3,16
Hurricane,Ivan,49,2004-09-14T15:00:00Z,GULF 28N 95W,0,0,0,2,2
Hurricane,Ivan,50,2004-09-14T21:00:00Z,27.2N  88.0W,40,0,0,0,40
Hurricane,Ivan,50,2004-09-14T21:00:00Z,PANAMA CITY FL,0,11,5,2,18
Hurricane,Ivan,50,2004-09-14T21:00:00Z,29.3N  88.3W,8,22,0,0,30
Hurricane,Ivan,50,2004-09-14T21:00:00Z,PENSACOLA FL,0,20,3,1,24
Hurricane,Ivan,50,2004-09-14T21:00:00Z,31.5N  88.0W,0,15,8,1,24
Hurricane,Ivan,50,2004-09-14T21:00:00Z,MOBILE AL,0,22,3,1,26
Hurricane,Ivan,50,2004-09-14T21:00:00Z,COCOA BEACH FL,0,0,0,2,2
Hurricane,Ivan,50,2004-09-14T21:00:00Z,GULFPORT MS,1,23,2,0,26
Hurricane,Ivan,50,2004-09-14T21:00:00Z,DAYTONA BEACH FL,0,0,0,3,3
Hurricane,Ivan,50,2004-09-14T21:00:00Z,BURAS LA,4,22,0,1,27
Hurricane,Ivan,50,2004-09-14T21:00:00Z,JACKSONVILLE FL,0,0,1,5,6
Hurricane,Ivan,50,2004-09-14T21:00:00Z,NEW ORLEANS LA,1,19,2,0,22
Hurricane,Ivan,50,2004-09-14T21:00:00Z,SAVANNAH GA,0,0,0,6,6
Hurricane,Ivan,50,2004-09-14T21:00:00Z,NEW IBERIA LA,0,7,5,1,13
Hurricane,Ivan,50,2004-09-14T21:00:00Z,CHARLESTON SC,0,0,0,4,4
Hurricane,Ivan,50,2004-09-14T21:00:00Z,PORT ARTHUR TX,0,0,1,3,4
Hurricane,Ivan,50,2004-09-14T21:00:00Z,MYRTLE BEACH SC,0,0,0,3,3
Hurricane,Ivan,50,2004-09-14T21:00:00Z,GALVESTON TX,0,0,0,2,2
Hurricane,Ivan,50,2004-09-14T21:00:00Z,WILMINGTON NC,0,0,0,2,2
Hurricane,Ivan,50,2004-09-14T21:00:00Z,GULF 29N 85W,1,9,3,2,15
Hurricane,Ivan,50,2004-09-14T21:00:00Z,VENICE FL,0,0,1,1,2
Hurricane,Ivan,50,2004-09-14T21:00:00Z,GULF 29N 87W,9,17,1,0,27
Hurricane,Ivan,50,2004-09-14T21:00:00Z,TAMPA FL,0,0,1,3,4
Hurricane,Ivan,50,2004-09-14T21:00:00Z,GULF 28N 89W,26,6,0,0,32
Hurricane,Ivan,50,2004-09-14T21:00:00Z,CEDAR KEY FL,0,0,2,4,6
Hurricane,Ivan,50,2004-09-14T21:00:00Z,GULF 28N 91W,5,10,1,0,16
Hurricane,Ivan,50,2004-09-14T21:00:00Z,ST MARKS FL,0,2,6,4,12
Hurricane,Ivan,50,2004-09-14T21:00:00Z,GULF 28N 93W,0,1,1,1,3
Hurricane,Ivan,50,2004-09-14T21:00:00Z,APALACHICOLA FL,0,7,6,2,15
Hurricane,Ivan,51,2004-09-15T03:00:00Z,28.6N  88.2W,43,0,0,0,43
Hurricane,Ivan,51,2004-09-15T03:00:00Z,APALACHICOLA FL,3,6,3,3,15
Hurricane,Ivan,51,2004-09-15T03:00:00Z,30.6N  88.2W,18,12,0,1,31
Hurricane,Ivan,51,2004-09-15T03:00:00Z,PANAMA CITY FL,7,7,2,2,18
Hurricane,Ivan,51,2004-09-15T03:00:00Z,32.6N  87.6W,1,16,6,1,24
Hurricane,Ivan,51,2004-09-15T03:00:00Z,PENSACOLA FL,16,9,1,1,27
Hurricane,Ivan,51,2004-09-15T03:00:00Z,COCOA BEACH FL,0,0,0,2,2
Hurricane,Ivan,51,2004-09-15T03:00:00Z,MOBILE AL,16,14,0,1,31
Hurricane,Ivan,51,2004-09-15T03:00:00Z,DAYTONA BEACH FL,0,0,0,3,3
Hurricane,Ivan,51,2004-09-15T03:00:00Z,GULFPORT MS,19,12,0,0,31
Hurricane,Ivan,51,2004-09-15T03:00:00Z,JACKSONVILLE FL,0,0,0,6,6
Hurricane,Ivan,51,2004-09-15T03:00:00Z,BURAS LA,27,4,1,0,32
Hurricane,Ivan,51,2004-09-15T03:00:00Z,SAVANNAH GA,0,0,0,6,6
Hurricane,Ivan,51,2004-09-15T03:00:00Z,NEW ORLEANS LA,13,12,0,1,26
Hurricane,Ivan,51,2004-09-15T03:00:00Z,CHARLESTON SC,0,0,0,5,5
Hurricane,Ivan,51,2004-09-15T03:00:00Z,NEW IBERIA LA,2,9,1,1,13
Hurricane,Ivan,51,2004-09-15T03:00:00Z,MYRTLE BEACH SC,0,0,0,3,3
Hurricane,Ivan,51,2004-09-15T03:00:00Z,PORT ARTHUR TX,0,0,1,2,3
Hurricane,Ivan,51,2004-09-15T03:00:00Z,WILMINGTON NC,0,0,0,2,2
Hurricane,Ivan,51,2004-09-15T03:00:00Z,GULF 29N 85W,5,4,3,2,14
Hurricane,Ivan,51,2004-09-15T03:00:00Z,VENICE FL,0,0,0,2,2
Hurricane,Ivan,51,2004-09-15T03:00:00Z,GULF 29N 87W,30,1,0,0,31
Hurricane,Ivan,51,2004-09-15T03:00:00Z,TAMPA FL,0,0,0,3,3
Hurricane,Ivan,51,2004-09-15T03:00:00Z,GULF 28N 89W,44,0,0,0,44
Hurricane,Ivan,51,2004-09-15T03:00:00Z,CEDAR KEY FL,0,0,2,4,6
Hurricane,Ivan,51,2004-09-15T03:00:00Z,GULF 28N 91W,14,4,0,0,18
Hurricane,Ivan,51,2004-09-15T03:00:00Z,ST MARKS FL,1,2,4,5,12
Hurricane,Ivan,51,2004-09-15T03:00:00Z,GULF 28N 93W,1,1,0,1,3
Hurricane,Ivan,52,2004-09-15T09:00:00Z,29.6N  88.2W,36,0,0,0,36
Hurricane,Ivan,52,2004-09-15T09:00:00Z,CEDAR KEY FL,0,1,4,3,8
Hurricane,Ivan,52,2004-09-15T09:00:00Z,32.0N  87.7W,8,19,1,0,28
Hurricane,Ivan,52,2004-09-15T09:00:00Z,ST MARKS FL,1,6,4,3,14
Hurricane,Ivan,52,2004-09-15T09:00:00Z,33.5N  87.0W,0,17,4,1,22
Hurricane,Ivan,52,2004-09-15T09:00:00Z,APALACHICOLA FL,5,9,2,1,17
Hurricane,Ivan,52,2004-09-15T09:00:00Z,COCOA BEACH FL,0,0,0,2,2
Hurricane,Ivan,52,2004-09-15T09:00:00Z,PANAMA CITY FL,10,9,1,1,21
Hurricane,Ivan,52,2004-09-15T09:00:00Z,DAYTONA BEACH FL,0,0,1,3,4
Hurricane,Ivan,52,2004-09-15T09:00:00Z,PENSACOLA FL,22,8,0,0,30
Hurricane,Ivan,52,2004-09-15T09:00:00Z,JACKSONVILLE FL,0,0,2,5,7
Hurricane,Ivan,52,2004-09-15T09:00:00Z,MOBILE AL,26,5,1,0,32
Hurricane,Ivan,52,2004-09-15T09:00:00Z,SAVANNAH GA,0,0,1,7,8
Hurricane,Ivan,52,2004-09-15T09:00:00Z,GULFPORT MS,27,3,0,0,30
Hurricane,Ivan,52,2004-09-15T09:00:00Z,CHARLESTON SC,0,0,0,6,6
Hurricane,Ivan,52,2004-09-15T09:00:00Z,BURAS LA,29,0,0,0,29
Hurricane,Ivan,52,2004-09-15T09:00:00Z,MYRTLE BEACH SC,0,0,0,4,4
Hurricane,Ivan,52,2004-09-15T09:00:00Z,NEW ORLEANS LA,19,2,0,0,21
Hurricane,Ivan,52,2004-09-15T09:00:00Z,WILMINGTON NC,0,0,0,3,3
Hurricane,Ivan,52,2004-09-15T09:00:00Z,NEW IBERIA LA,3,2,0,1,6
Hurricane,Ivan,52,2004-09-15T09:00:00Z,MOREHEAD CITY NC,0,0,0,2,2
Hurricane,Ivan,52,2004-09-15T09:00:00Z,GULF 29N 85W,7,7,1,1,16
Hurricane,Ivan,52,2004-09-15T09:00:00Z,FT MYERS FL,0,0,0,2,2
Hurricane,Ivan,52,2004-09-15T09:00:00Z,GULF 29N 87W,34,0,0,0,34
Hurricane,Ivan,52,2004-09-15T09:00:00Z,VENICE FL,0,0,1,2,3
Hurricane,Ivan,52,2004-09-15T09:00:00Z,GULF 28N 89W,50,0,0,0,50
Hurricane,Ivan,52,2004-09-15T09:00:00Z,TAMPA FL,0,1,1,2,4
Hurricane,Ivan,52,2004-09-15T09:00:00Z,GULF 28N 91W,7,1,0,1,9
Hurricane,Ivan,53,2004-09-15T15:00:00Z,31.0N  87.9W,39,0,0,0,39
Hurricane,Ivan,53,2004-09-15T15:00:00Z,TAMPA FL,0,0,1,2,3
Hurricane,Ivan,53,2004-09-15T15:00:00Z,32.8N  87.4W,20,5,1,0,26
Hurricane,Ivan,53,2004-09-15T15:00:00Z,CEDAR KEY FL,0,1,2,3,6
Hurricane,Ivan,53,2004-09-15T15:00:00Z,34.0N  86.5W,5,11,3,1,20
Hurricane,Ivan,53,2004-09-15T15:00:00Z,ST MARKS FL,2,4,3,2,11
Hurricane,Ivan,53,2004-09-15T15:00:00Z,FT PIERCE FL,0,0,0,2,2
Hurricane,Ivan,53,2004-09-15T15:00:00Z,APALACHICOLA FL,7,4,2,1,14
Hurricane,Ivan,53,2004-09-15T15:00:00Z,COCOA BEACH FL,0,0,0,2,2
Hurricane,Ivan,53,2004-09-15T15:00:00Z,PANAMA CITY FL,15,2,1,1,19
Hurricane,Ivan,53,2004-09-15T15:00:00Z,DAYTONA BEACH FL,0,0,1,3,4
Hurricane,Ivan,53,2004-09-15T15:00:00Z,PENSACOLA FL,38,0,0,0,38
Hurricane,Ivan,53,2004-09-15T15:00:00Z,JACKSONVILLE FL,0,0,2,4,6
Hurricane,Ivan,53,2004-09-15T15:00:00Z,MOBILE AL,43,0,0,0,43
Hurricane,Ivan,53,2004-09-15T15:00:00Z,SAVANNAH GA,0,0,1,6,7
Hurricane,Ivan,53,2004-09-15T15:00:00Z,GULFPORT MS,39,0,0,0,39
Hurricane,Ivan,53,2004-09-15T15:00:00Z,CHARLESTON SC,0,0,0,6,6
Hurricane,Ivan,53,2004-09-15T15:00:00Z,BURAS LA,38,0,0,0,38
Hurricane,Ivan,53,2004-09-15T15:00:00Z,MYRTLE BEACH SC,0,0,0,5,5
Hurricane,Ivan,53,2004-09-15T15:00:00Z,NEW ORLEANS LA,19,0,1,0,20
Hurricane,Ivan,53,2004-09-15T15:00:00Z,WILMINGTON NC,0,0,0,4,4
Hurricane,Ivan,53,2004-09-15T15:00:00Z,NEW IBERIA LA,1,1,0,1,3
Hurricane,Ivan,53,2004-09-15T15:00:00Z,MOREHEAD CITY NC,0,0,0,2,2
Hurricane,Ivan,53,2004-09-15T15:00:00Z,GULF 29N 85W,6,4,1,1,12
Hurricane,Ivan,53,2004-09-15T15:00:00Z,CAPE HATTERAS NC,0,0,0,2,2
Hurricane,Ivan,53,2004-09-15T15:00:00Z,GULF 29N 87W,49,0,0,0,49
Hurricane,Ivan,53,2004-09-15T15:00:00Z,NORFOLK VA,0,0,0,2,2
Hurricane,Ivan,53,2004-09-15T15:00:00Z,GULF 28N 89W,74,0,0,0,74
Hurricane,Ivan,53,2004-09-15T15:00:00Z,VENICE FL,0,0,1,1,2
Hurricane,Ivan,53,2004-09-15T15:00:00Z,GULF 28N 91W,1,1,0,0,2
Hurricane,Ivan,54,2004-09-15T21:00:00Z,32.2N  88.0W,38,0,0,0,38
Hurricane,Ivan,54,2004-09-15T21:00:00Z,VENICE FL,0,0,1,1,2
Hurricane,Ivan,54,2004-09-15T21:00:00Z,33.8N  87.2W,21,2,1,0,24
Hurricane,Ivan,54,2004-09-15T21:00:00Z,TAMPA FL,0,0,1,2,3
Hurricane,Ivan,54,2004-09-15T21:00:00Z,35.0N  86.0W,5,8,3,2,18
Hurricane,Ivan,54,2004-09-15T21:00:00Z,CEDAR KEY FL,0,1,3,2,6
Hurricane,Ivan,54,2004-09-15T21:00:00Z,FT PIERCE FL,0,0,0,2,2
Hurricane,Ivan,54,2004-09-15T21:00:00Z,ST MARKS FL,2,5,2,2,11
Hurricane,Ivan,54,2004-09-15T21:00:00Z,COCOA BEACH FL,0,0,1,2,3
Hurricane,Ivan,54,2004-09-15T21:00:00Z,APALACHICOLA FL,5,3,2,1,11
Hurricane,Ivan,54,2004-09-15T21:00:00Z,DAYTONA BEACH FL,0,0,2,2,4
Hurricane,Ivan,54,2004-09-15T21:00:00Z,PANAMA CITY FL,12,2,1,0,15
Hurricane,Ivan,54,2004-09-15T21:00:00Z,JACKSONVILLE FL,0,1,3,3,7
Hurricane,Ivan,54,2004-09-15T21:00:00Z,PENSACOLA FL,45,0,0,0,45
Hurricane,Ivan,54,2004-09-15T21:00:00Z,SAVANNAH GA,0,1,3,5,9
Hurricane,Ivan,54,2004-09-15T21:00:00Z,MOBILE AL,59,0,0,0,59
Hurricane,Ivan,54,2004-09-15T21:00:00Z,CHARLESTON SC,0,0,2,5,7
Hurricane,Ivan,54,2004-09-15T21:00:00Z,GULFPORT MS,52,0,0,0,52
Hurricane,Ivan,54,2004-09-15T21:00:00Z,MYRTLE BEACH SC,0,0,1,5,6
Hurricane,Ivan,54,2004-09-15T21:00:00Z,BURAS LA,39,0,0,1,40
Hurricane,Ivan,54,2004-09-15T21:00:00Z,WILMINGTON NC,0,0,0,4,4
Hurricane,Ivan,54,2004-09-15T21:00:00Z,NEW ORLEANS LA,16,0,0,0,16
Hurricane,Ivan,54,2004-09-15T21:00:00Z,MOREHEAD CITY NC,0,0,0,3,3
Hurricane,Ivan,54,2004-09-15T21:00:00Z,GULF 29N 85W,3,2,2,1,8
Hurricane,Ivan,54,2004-09-15T21:00:00Z,CAPE HATTERAS NC,0,0,0,2,2
Hurricane,Ivan,54,2004-09-15T21:00:00Z,GULF 29N 87W,50,0,0,0,50
Hurricane,Ivan,54,2004-09-15T21:00:00Z,NORFOLK VA,0,0,0,2,2
Hurricane,Ivan,54,2004-09-15T21:00:00Z,GULF 28N 89W,99,0,0,0,99
Hurricane,Ivan,55,2004-09-16T03:00:00Z,33.0N  87.2W,44,1,0,0,45
Hurricane,Ivan,55,2004-09-16T03:00:00Z,TAMPA FL,0,0,0,2,2
Hurricane,Ivan,55,2004-09-16T03:00:00Z,34.5N  86.5W,22,4,1,0,27
Hurricane,Ivan,55,2004-09-16T03:00:00Z,CEDAR KEY FL,0,0,1,4,5
Hurricane,Ivan,55,2004-09-16T03:00:00Z,35.5N  85.5W,4,12,3,1,20
Hurricane,Ivan,55,2004-09-16T03:00:00Z,ST MARKS FL,1,2,2,3,8
Hurricane,Ivan,55,2004-09-16T03:00:00Z,FT PIERCE FL,0,0,0,2,2
Hurricane,Ivan,55,2004-09-16T03:00:00Z,APALACHICOLA FL,1,2,2,2,7
Hurricane,Ivan,55,2004-09-16T03:00:00Z,COCOA BEACH FL,0,0,0,2,2
Hurricane,Ivan,55,2004-09-16T03:00:00Z,PANAMA CITY FL,6,2,1,1,10
Hurricane,Ivan,55,2004-09-16T03:00:00Z,DAYTONA BEACH FL,0,0,1,3,4
Hurricane,Ivan,55,2004-09-16T03:00:00Z,PENSACOLA FL,73,0,0,0,73
Hurricane,Ivan,55,2004-09-16T03:00:00Z,JACKSONVILLE FL,0,0,3,4,7
Hurricane,Ivan,55,2004-09-16T03:00:00Z,MOBILE AL,82,0,0,0,82
Hurricane,Ivan,55,2004-09-16T03:00:00Z,SAVANNAH GA,0,1,4,4,9
Hurricane,Ivan,55,2004-09-16T03:00:00Z,GULFPORT MS,60,0,0,0,60
Hurricane,Ivan,55,2004-09-16T03:00:00Z,CHARLESTON SC,0,0,3,6,9
Hurricane,Ivan,55,2004-09-16T03:00:00Z,BURAS LA,27,0,0,0,27
Hurricane,Ivan,55,2004-09-16T03:00:00Z,MYRTLE BEACH SC,0,0,2,5,7
Hurricane,Ivan,55,2004-09-16T03:00:00Z,NEW ORLEANS LA,4,1,0,1,6
Hurricane,Ivan,55,2004-09-16T03:00:00Z,WILMINGTON NC,0,0,1,5,6
Hurricane,Ivan,55,2004-09-16T03:00:00Z,GULF 29N 85W,0,1,1,3,5
Hurricane,Ivan,55,2004-09-16T03:00:00Z,MOREHEAD CITY NC,0,0,0,4,4
Hurricane,Ivan,55,2004-09-16T03:00:00Z,GULF 29N 87W,93,0,0,0,93
Hurricane,Ivan,55,2004-09-16T03:00:00Z,CAPE HATTERAS NC,0,0,0,2,2
Hurricane,Ivan,55,2004-09-16T03:00:00Z,GULF 28N 89W,37,0,0,1,38
Hurricane,Ivan,55,2004-09-16T03:00:00Z,NORFOLK VA,0,0,0,2,2
Hurricane,Ivan,56,2004-09-16T09:00:00Z,34.7N  86.2W,52,0,0,0,52
Hurricane,Ivan,56,2004-09-16T09:00:00Z,OCEAN CITY MD,0,0,0,3,3
Hurricane,Ivan,56,2004-09-16T09:00:00Z,36.0N  85.0W,25,3,0,0,28
Hurricane,Ivan,56,2004-09-16T09:00:00Z,ATLANTIC CITY NJ,0,0,0,2,2
Hurricane,Ivan,56,2004-09-16T09:00:00Z,37.5N  83.0W,1,9,6,2,18
Hurricane,Ivan,56,2004-09-16T09:00:00Z,CEDAR KEY FL,0,0,1,2,3
Hurricane,Ivan,56,2004-09-16T09:00:00Z,DAYTONA BEACH FL,0,0,1,2,3
Hurricane,Ivan,56,2004-09-16T09:00:00Z,ST MARKS FL,0,1,1,2,4
Hurricane,Ivan,56,2004-09-16T09:00:00Z,JACKSONVILLE FL,0,0,2,3,5
Hurricane,Ivan,56,2004-09-16T09:00:00Z,APALACHICOLA FL,0,0,1,2,3
Hurricane,Ivan,56,2004-09-16T09:00:00Z,SAVANNAH GA,0,1,4,3,8
Hurricane,Ivan,56,2004-09-16T09:00:00Z,PANAMA CITY FL,0,1,1,2,4
Hurricane,Ivan,56,2004-09-16T09:00:00Z,CHARLESTON SC,0,1,3,4,8
Hurricane,Ivan,56,2004-09-16T09:00:00Z,PENSACOLA FL,99,0,0,0,99
Hurricane,Ivan,56,2004-09-16T09:00:00Z,MYRTLE BEACH SC,0,0,3,5,8
Hurricane,Ivan,56,2004-09-16T09:00:00Z,MOBILE AL,99,0,0,0,99
Hurricane,Ivan,56,2004-09-16T09:00:00Z,WILMINGTON NC,0,0,2,5,7
Hurricane,Ivan,56,2004-09-16T09:00:00Z,GULFPORT MS,27,0,0,1,28
Hurricane,Ivan,56,2004-09-16T09:00:00Z,MOREHEAD CITY NC,0,0,1,4,5
Hurricane,Ivan,56,2004-09-16T09:00:00Z,GULF 29N 85W,0,0,1,1,2
Hurricane,Ivan,56,2004-09-16T09:00:00Z,CAPE HATTERAS NC,0,0,1,3,4
Hurricane,Ivan,56,2004-09-16T09:00:00Z,GULF 29N 87W,19,0,1,0,20
Hurricane,Ivan,56,2004-09-16T09:00:00Z,NORFOLK VA,0,0,1,4,5
Hurricane,Ivan,57,2004-09-16T15:00:00Z,35.2N  85.7W,36,0,0,0,36
Hurricane,Ivan,57,2004-09-16T15:00:00Z,MOREHEAD CITY NC,0,1,3,5,9
Hurricane,Ivan,57,2004-09-16T15:00:00Z,36.5N  84.0W,13,6,1,1,21
Hurricane,Ivan,57,2004-09-16T15:00:00Z,CAPE HATTERAS NC,0,0,3,5,8
Hurricane,Ivan,57,2004-09-16T15:00:00Z,37.0N  82.5W,2,12,2,2,18
Hurricane,Ivan,57,2004-09-16T15:00:00Z,NORFOLK VA,0,0,3,6,9
Hurricane,Ivan,57,2004-09-16T15:00:00Z,COCOA BEACH FL,0,0,0,2,2
Hurricane,Ivan,57,2004-09-16T15:00:00Z,OCEAN CITY MD,0,0,1,5,6
Hurricane,Ivan,57,2004-09-16T15:00:00Z,DAYTONA BEACH FL,0,0,1,2,3
Hurricane,Ivan,57,2004-09-16T15:00:00Z,ATLANTIC CITY NJ,0,0,0,5,5
Hurricane,Ivan,57,2004-09-16T15:00:00Z,JACKSONVILLE FL,0,1,2,2,5
Hurricane,Ivan,57,2004-09-16T15:00:00Z,NEW YORK CITY NY,0,0,0,3,3
Hurricane,Ivan,57,2004-09-16T15:00:00Z,SAVANNAH GA,1,4,2,3,10
Hurricane,Ivan,57,2004-09-16T15:00:00Z,CEDAR KEY FL,0,0,0,2,2
Hurricane,Ivan,57,2004-09-16T15:00:00Z,CHARLESTON SC,0,5,3,3,11
Hurricane,Ivan,57,2004-09-16T15:00:00Z,ST MARKS FL,0,0,1,1,2
Hurricane,Ivan,57,2004-09-16T15:00:00Z,MYRTLE BEACH SC,0,4,4,4,12
Hurricane,Ivan,57,2004-09-16T15:00:00Z,PENSACOLA FL,99,0,0,0,99
Hurricane,Ivan,57,2004-09-16T15:00:00Z,WILMINGTON NC,0,2,5,4,11
Hurricane,Ivan,57,2004-09-16T15:00:00Z,MOBILE AL,99,0,0,0,99
Tropical Storm,Ivan,58,2004-09-16T21:00:00Z,35.6N  84.3W,41,0,0,0,41
Tropical Storm,Ivan,58,2004-09-16T21:00:00Z,MOREHEAD CITY NC,0,2,6,4,12
Tropical Storm,Ivan,58,2004-09-16T21:00:00Z,36.3N  82.2W,15,7,1,1,24
Tropical Storm,Ivan,58,2004-09-16T21:00:00Z,CAPE HATTERAS NC,0,1,4,5,10
Tropical Storm,Ivan,58,2004-09-16T21:00:00Z,36.3N  80.5W,2,14,2,1,19
Tropical Storm,Ivan,58,2004-09-16T21:00:00Z,NORFOLK VA,0,1,6,4,11
Tropical Storm,Ivan,58,2004-09-16T21:00:00Z,FT PIERCE FL,0,0,0,2,2
Tropical Storm,Ivan,58,2004-09-16T21:00:00Z,OCEAN CITY MD,0,0,4,4,8
Tropical Storm,Ivan,58,2004-09-16T21:00:00Z,COCOA BEACH FL,0,0,0,3,3
Tropical Storm,Ivan,58,2004-09-16T21:00:00Z,ATLANTIC CITY NJ,0,0,2,4,6
Tropical Storm,Ivan,58,2004-09-16T21:00:00Z,DAYTONA BEACH FL,0,0,1,3,4
Tropical Storm,Ivan,58,2004-09-16T21:00:00Z,NEW YORK CITY NY,0,0,1,3,4
Tropical Storm,Ivan,58,2004-09-16T21:00:00Z,JACKSONVILLE FL,0,0,2,3,5
Tropical Storm,Ivan,58,2004-09-16T21:00:00Z,MONTAUK POINT NY,0,0,0,2,2
Tropical Storm,Ivan,58,2004-09-16T21:00:00Z,SAVANNAH GA,1,3,3,3,10
Tropical Storm,Ivan,58,2004-09-16T21:00:00Z,TAMPA FL,0,0,0,2,2
Tropical Storm,Ivan,58,2004-09-16T21:00:00Z,CHARLESTON SC,1,6,3,3,13
Tropical Storm,Ivan,58,2004-09-16T21:00:00Z,CEDAR KEY FL,0,0,0,2,2
Tropical Storm,Ivan,58,2004-09-16T21:00:00Z,MYRTLE BEACH SC,0,7,3,4,14
Tropical Storm,Ivan,58,2004-09-16T21:00:00Z,ST MARKS FL,0,0,0,3,3
Tropical Storm,Ivan,58,2004-09-16T21:00:00Z,WILMINGTON NC,0,5,5,3,13
Tropical Storm,Ivan,58,2004-09-16T21:00:00Z,APALACHICOLA FL,0,0,0,2,2
Tropical Depression,Ivan,59,2004-09-17T03:00:00Z,35.9N  83.1W,43,0,0,0,43
Tropical Depression,Ivan,59,2004-09-17T03:00:00Z,OCEAN CITY MD,0,0,2,2,4
Tropical Depression,Ivan,59,2004-09-17T03:00:00Z,36.0N  81.4W,23,1,1,1,26
Tropical Depression,Ivan,59,2004-09-17T03:00:00Z,ATLANTIC CITY NJ,0,0,1,2,3
Tropical Depression,Ivan,59,2004-09-17T03:00:00Z,35.3N  81.0W,17,3,1,1,22
Tropical Depression,Ivan,59,2004-09-17T03:00:00Z,NEW YORK CITY NY,0,0,0,2,2
Tropical Depression,Ivan,59,2004-09-17T03:00:00Z,MYGF 266N 787W,0,0,0,2,2
Tropical Depression,Ivan,59,2004-09-17T03:00:00Z,MARCO ISLAND FL,0,0,0,2,2
Tropical Depression,Ivan,59,2004-09-17T03:00:00Z,MIAMI FL,0,0,0,2,2
Tropical Depression,Ivan,59,2004-09-17T03:00:00Z,FT MYERS FL,0,0,0,3,3
Tropical Depression,Ivan,59,2004-09-17T03:00:00Z,W PALM BEACH FL,0,0,0,3,3
Tropical Depression,Ivan,59,2004-09-17T03:00:00Z,VENICE FL,0,0,0,3,3
Tropical Depression,Ivan,59,2004-09-17T03:00:00Z,FT PIERCE FL,0,0,1,3,4
Tropical Depression,Ivan,59,2004-09-17T03:00:00Z,TAMPA FL,0,0,1,3,4
Tropical Depression,Ivan,59,2004-09-17T03:00:00Z,COCOA BEACH FL,0,0,1,4,5
Tropical Depression,Ivan,59,2004-09-17T03:00:00Z,CEDAR KEY FL,0,0,2,4,6
Tropical Depression,Ivan,59,2004-09-17T03:00:00Z,DAYTONA BEACH FL,0,0,2,5,7
Tropical Depression,Ivan,59,2004-09-17T03:00:00Z,ST MARKS FL,0,1,1,5,7
Tropical Depression,Ivan,59,2004-09-17T03:00:00Z,JACKSONVILLE FL,0,1,4,4,9
Tropical Depression,Ivan,59,2004-09-17T03:00:00Z,APALACHICOLA FL,0,0,1,4,5
Tropical Depression,Ivan,59,2004-09-17T03:00:00Z,SAVANNAH GA,1,5,4,3,13
Tropical Depression,Ivan,59,2004-09-17T03:00:00Z,PANAMA CITY FL,0,0,1,4,5
Tropical Depression,Ivan,59,2004-09-17T03:00:00Z,CHARLESTON SC,1,6,4,3,14
Tropical Depression,Ivan,59,2004-09-17T03:00:00Z,PENSACOLA FL,0,0,0,4,4
Tropical Depression,Ivan,59,2004-09-17T03:00:00Z,MYRTLE BEACH SC,0,6,4,3,13
Tropical Depression,Ivan,59,2004-09-17T03:00:00Z,MOBILE AL,0,0,0,3,3
Tropical Depression,Ivan,59,2004-09-17T03:00:00Z,WILMINGTON NC,0,4,4,4,12
Tropical Depression,Ivan,59,2004-09-17T03:00:00Z,GULFPORT MS,0,0,0,2,2
Tropical Depression,Ivan,59,2004-09-17T03:00:00Z,MOREHEAD CITY NC,0,2,3,4,9
Tropical Depression,Ivan,59,2004-09-17T03:00:00Z,GULF 29N 85W,0,0,1,3,4
Tropical Depression,Ivan,59,2004-09-17T03:00:00Z,CAPE HATTERAS NC,0,1,2,3,6
Tropical Depression,Ivan,59,2004-09-17T03:00:00Z,GULF 29N 87W,0,0,0,3,3
Tropical Depression,Ivan,59,2004-09-17T03:00:00Z,NORFOLK VA,0,1,3,4,8
Tropical Depression,Ivan,67,2004-09-22T23:00:00Z,28.5N  93.0W,44,0,0,0,44
Tropical Depression,Ivan,67,2004-09-22T23:00:00Z,FREEPORT TX,18,12,1,0,31
Tropical Depression,Ivan,67,2004-09-22T23:00:00Z,30.0N  95.0W,14,19,1,0,34
Tropical Depression,Ivan,67,2004-09-22T23:00:00Z,PORT O CONNOR TX,7,13,1,1,22
Tropical Depression,Ivan,67,2004-09-22T23:00:00Z,30.5N  95.5W,7,23,1,0,31
Tropical Depression,Ivan,67,2004-09-22T23:00:00Z,CORPUSCHRISTI TX,1,6,3,3,13
Tropical Depression,Ivan,67,2004-09-22T23:00:00Z,MMSO 238N 982W,0,0,0,2,2
Tropical Depression,Ivan,67,2004-09-22T23:00:00Z,BROWNSVILLE TX,0,0,2,4,6
Tropical Depression,Ivan,67,2004-09-22T23:00:00Z,PENSACOLA FL,0,0,0,2,2
Tropical Depression,Ivan,67,2004-09-22T23:00:00Z,GULF 29N 87W,0,0,0,2,2
Tropical Depression,Ivan,67,2004-09-22T23:00:00Z,MOBILE AL,0,0,1,3,4
Tropical Depression,Ivan,67,2004-09-22T23:00:00Z,GULF 28N 89W,44,0,0,0,44
Tropical Depression,Ivan,67,2004-09-22T23:00:00Z,GULFPORT MS,1,1,1,3,6
Tropical Depression,Ivan,67,2004-09-22T23:00:00Z,GULF 28N 91W,67,0,0,0,67
Tropical Depression,Ivan,67,2004-09-22T23:00:00Z,BURAS LA,8,2,1,1,12
Tropical Depression,Ivan,67,2004-09-22T23:00:00Z,GULF 28N 93W,47,0,0,0,47
Tropical Depression,Ivan,67,2004-09-22T23:00:00Z,NEW ORLEANS LA,8,4,1,1,14
Tropical Depression,Ivan,67,2004-09-22T23:00:00Z,GULF 28N 95W,21,6,0,1,28
Tropical Depression,Ivan,67,2004-09-22T23:00:00Z,NEW IBERIA LA,19,5,1,0,25
Tropical Depression,Ivan,67,2004-09-22T23:00:00Z,GULF 27N 96W,5,6,1,2,14
Tropical Depression,Ivan,67,2004-09-22T23:00:00Z,PORT ARTHUR TX,20,13,1,0,34
Tropical Depression,Ivan,67,2004-09-22T23:00:00Z,GULF 25N 96W,0,0,1,3,4
Tropical Depression,Ivan,67,2004-09-22T23:00:00Z,GALVESTON TX,22,12,0,0,34
Tropical Storm,Ivan,68,2004-09-23T03:00:00Z,29.5N  94.0W,46,0,0,0,46
Tropical Storm,Ivan,68,2004-09-23T03:00:00Z,FREEPORT TX,29,3,0,0,32
Tropical Storm,Ivan,68,2004-09-23T03:00:00Z,31.5N  95.5W,20,15,0,0,35
Tropical Storm,Ivan,68,2004-09-23T03:00:00Z,PORT O CONNOR TX,10,7,1,1,19
Tropical Storm,Ivan,68,2004-09-23T03:00:00Z,32.0N  96.0W,12,20,0,1,33
Tropical Storm,Ivan,68,2004-09-23T03:00:00Z,CORPUSCHRISTI TX,1,2,1,5,9
Tropical Storm,Ivan,68,2004-09-23T03:00:00Z,PENSACOLA FL,0,0,0,2,2
Tropical Storm,Ivan,68,2004-09-23T03:00:00Z,BROWNSVILLE TX,0,0,0,3,3
Tropical Storm,Ivan,68,2004-09-23T03:00:00Z,MOBILE AL,0,0,0,3,3
Tropical Storm,Ivan,68,2004-09-23T03:00:00Z,GULF 28N 89W,99,0,0,0,99
Tropical Storm,Ivan,68,2004-09-23T03:00:00Z,GULFPORT MS,0,1,0,4,5
Tropical Storm,Ivan,68,2004-09-23T03:00:00Z,GULF 28N 91W,87,0,0,0,87
Tropical Storm,Ivan,68,2004-09-23T03:00:00Z,BURAS LA,19,0,0,0,19
Tropical Storm,Ivan,68,2004-09-23T03:00:00Z,GULF 28N 93W,48,0,0,0,48
Tropical Storm,Ivan,68,2004-09-23T03:00:00Z,NEW ORLEANS LA,16,1,0,1,18
Tropical Storm,Ivan,68,2004-09-23T03:00:00Z,GULF 28N 95W,22,2,1,0,25
Tropical Storm,Ivan,68,2004-09-23T03:00:00Z,NEW IBERIA LA,39,0,0,0,39
Tropical Storm,Ivan,68,2004-09-23T03:00:00Z,GULF 27N 96W,3,2,1,2,8
Tropical Storm,Ivan,68,2004-09-23T03:00:00Z,PORT ARTHUR TX,42,0,0,0,42
Tropical Storm,Ivan,68,2004-09-23T03:00:00Z,GULF 25N 96W,0,0,0,2,2
Tropical Storm,Ivan,68,2004-09-23T03:00:00Z,GALVESTON TX,38,1,0,0,39
Tropical Storm,Ivan,69,2004-09-23T09:00:00Z,30.1N  95.0W,42,0,0,0,42
Tropical Storm,Ivan,69,2004-09-23T09:00:00Z,FREEPORT TX,33,1,0,0,34
Tropical Storm,Ivan,69,2004-09-23T09:00:00Z,30.7N  96.1W,29,1,0,1,31
Tropical Storm,Ivan,69,2004-09-23T09:00:00Z,PORT O CONNOR TX,14,2,2,1,19
Tropical Storm,Ivan,69,2004-09-23T09:00:00Z,31.0N  97.0W,21,5,1,1,28
Tropical Storm,Ivan,69,2004-09-23T09:00:00Z,CORPUSCHRISTI TX,3,3,2,4,12
Tropical Storm,Ivan,69,2004-09-23T09:00:00Z,MOBILE AL,0,0,0,2,2
Tropical Storm,Ivan,69,2004-09-23T09:00:00Z,BROWNSVILLE TX,0,0,1,4,5
Tropical Storm,Ivan,69,2004-09-23T09:00:00Z,GULFPORT MS,0,0,1,2,3
Tropical Storm,Ivan,69,2004-09-23T09:00:00Z,GULF 28N 89W,0,1,0,1,2
Tropical Storm,Ivan,69,2004-09-23T09:00:00Z,BURAS LA,1,1,0,2,4
Tropical Storm,Ivan,69,2004-09-23T09:00:00Z,GULF 28N 91W,99,0,0,0,99
Tropical Storm,Ivan,69,2004-09-23T09:00:00Z,NEW ORLEANS LA,5,1,0,2,8
Tropical Storm,Ivan,69,2004-09-23T09:00:00Z,GULF 28N 93W,71,0,0,0,71
Tropical Storm,Ivan,69,2004-09-23T09:00:00Z,NEW IBERIA LA,44,0,0,0,44
Tropical Storm,Ivan,69,2004-09-23T09:00:00Z,GULF 28N 95W,25,0,1,0,26
Tropical Storm,Ivan,69,2004-09-23T09:00:00Z,PORT ARTHUR TX,51,0,0,0,51
Tropical Storm,Ivan,69,2004-09-23T09:00:00Z,GULF 27N 96W,4,1,2,3,10
Tropical Storm,Ivan,69,2004-09-23T09:00:00Z,GALVESTON TX,46,0,0,0,46
Tropical Storm,Ivan,69,2004-09-23T09:00:00Z,GULF 25N 96W,0,0,0,3,3
Tropical Storm,Ivan,70,2004-09-23T15:00:00Z,30.5N  95.3W,51,0,0,0,51
Tropical Storm,Ivan,70,2004-09-23T15:00:00Z,FREEPORT TX,36,0,0,1,37
Tropical Storm,Ivan,70,2004-09-23T15:00:00Z,30.6N  96.3W,33,1,0,1,35
Tropical Storm,Ivan,70,2004-09-23T15:00:00Z,PORT O CONNOR TX,12,3,3,2,20
Tropical Storm,Ivan,70,2004-09-23T15:00:00Z,30.4N  97.0W,24,2,1,1,28
Tropical Storm,Ivan,70,2004-09-23T15:00:00Z,CORPUSCHRISTI TX,2,4,5,4,15
Tropical Storm,Ivan,70,2004-09-23T15:00:00Z,MMSO 238N 982W,0,0,0,3,3
Tropical Storm,Ivan,70,2004-09-23T15:00:00Z,BROWNSVILLE TX,0,0,2,7,9
Tropical Storm,Ivan,70,2004-09-23T15:00:00Z,GULFPORT MS,0,0,0,2,2
Tropical Storm,Ivan,70,2004-09-23T15:00:00Z,GULF 28N 89W,0,0,0,2,2
Tropical Storm,Ivan,70,2004-09-23T15:00:00Z,BURAS LA,0,0,0,3,3
Tropical Storm,Ivan,70,2004-09-23T15:00:00Z,GULF 28N 91W,3,1,1,2,7
Tropical Storm,Ivan,70,2004-09-23T15:00:00Z,NEW ORLEANS LA,0,1,0,3,4
Tropical Storm,Ivan,70,2004-09-23T15:00:00Z,GULF 28N 93W,40,0,0,0,40
Tropical Storm,Ivan,70,2004-09-23T15:00:00Z,NEW IBERIA LA,99,0,0,0,99
Tropical Storm,Ivan,70,2004-09-23T15:00:00Z,GULF 28N 95W,21,0,1,1,23
Tropical Storm,Ivan,70,2004-09-23T15:00:00Z,PORT ARTHUR TX,87,0,0,0,87
Tropical Storm,Ivan,70,2004-09-23T15:00:00Z,GULF 27N 96W,2,2,4,5,13
Tropical Storm,Ivan,70,2004-09-23T15:00:00Z,GALVESTON TX,60,0,0,0,60
Tropical Storm,Ivan,70,2004-09-23T15:00:00Z,GULF 25N 96W,0,0,1,5,6
Tropical Storm,Ivan,71,2004-09-23T21:00:00Z,30.4N  95.0W,59,0,0,0,59
Tropical Storm,Ivan,71,2004-09-23T21:00:00Z,FREEPORT TX,29,1,0,1,31
Tropical Storm,Ivan,71,2004-09-23T21:00:00Z,30.2N  95.7W,40,1,0,0,41
Tropical Storm,Ivan,71,2004-09-23T21:00:00Z,PORT O CONNOR TX,9,4,4,3,20
Tropical Storm,Ivan,71,2004-09-23T21:00:00Z,29.6N  96.4W,21,2,2,1,26
Tropical Storm,Ivan,71,2004-09-23T21:00:00Z,CORPUSCHRISTI TX,1,5,6,5,17
Tropical Storm,Ivan,71,2004-09-23T21:00:00Z,MMSO 238N 982W,0,0,0,5,5
Tropical Storm,Ivan,71,2004-09-23T21:00:00Z,BROWNSVILLE TX,0,0,4,7,11
Tropical Storm,Ivan,71,2004-09-23T21:00:00Z,MMTM 222N 979W,0,0,0,2,2
Tropical Storm,Ivan,71,2004-09-23T21:00:00Z,GULF 28N 89W,0,0,0,2,2
Tropical Storm,Ivan,71,2004-09-23T21:00:00Z,GULFPORT MS,0,0,0,2,2
Tropical Storm,Ivan,71,2004-09-23T21:00:00Z,GULF 28N 91W,1,1,1,4,7
Tropical Storm,Ivan,71,2004-09-23T21:00:00Z,BURAS LA,0,1,0,2,3
Tropical Storm,Ivan,71,2004-09-23T21:00:00Z,GULF 28N 93W,10,2,2,2,16
Tropical Storm,Ivan,71,2004-09-23T21:00:00Z,NEW ORLEANS LA,1,1,0,3,5
Tropical Storm,Ivan,71,2004-09-23T21:00:00Z,GULF 28N 95W,13,3,2,2,20
Tropical Storm,Ivan,71,2004-09-23T21:00:00Z,NEW IBERIA LA,86,0,0,0,86
Tropical Storm,Ivan,71,2004-09-23T21:00:00Z,GULF 27N 96W,1,3,6,5,15
Tropical Storm,Ivan,71,2004-09-23T21:00:00Z,PORT ARTHUR TX,99,0,0,0,99
Tropical Storm,Ivan,71,2004-09-23T21:00:00Z,GULF 25N 96W,0,0,2,6,8
Tropical Storm,Ivan,71,2004-09-23T21:00:00Z,GALVESTON TX,54,0,0,0,54
Tropical Depression,Ivan,72,2004-09-24T03:00:00Z,30.5N  95.5W,61,0,0,0,61
Tropical Depression,Ivan,72,2004-09-24T03:00:00Z,CORPUSCHRISTI TX,1,9,5,0,15
Tropical Depression,Ivan,72,2004-09-24T03:00:00Z,29.5N  96.5W,22,6,1,0,29
Tropical Depression,Ivan,72,2004-09-24T03:00:00Z,BROWNSVILLE TX,0,1,3,0,4
Tropical Depression,Ivan,72,2004-09-24T03:00:00Z,29.0N  97.5W,9,12,2,0,23
Tropical Depression,Ivan,72,2004-09-24T03:00:00Z,GULF 28N 91W,0,1,1,0,2
Tropical Depression,Ivan,72,2004-09-24T03:00:00Z,NEW IBERIA LA,48,0,0,0,48
Tropical Depression,Ivan,72,2004-09-24T03:00:00Z,GULF 28N 93W,0,6,3,0,9
Tropical Depression,Ivan,72,2004-09-24T03:00:00Z,PORT ARTHUR TX,99,0,0,0,99
Tropical Depression,Ivan,72,2004-09-24T03:00:00Z,GULF 28N 95W,3,11,3,0,17
Tropical Depression,Ivan,72,2004-09-24T03:00:00Z,GALVESTON TX,39,0,0,0,39
Tropical Depression,Ivan,72,2004-09-24T03:00:00Z,GULF 27N 96W,0,6,5,0,11
Tropical Depression,Ivan,72,2004-09-24T03:00:00Z,FREEPORT TX,17,6,1,0,24
Tropical Depression,Ivan,72,2004-09-24T03:00:00Z,GULF 25N 96W,0,0,2,0,2
Tropical Depression,Ivan,72,2004-09-24T03:00:00Z,PORT O CONNOR TX,7,11,3,0,21
Tropical Depression,Ten,1,2004-09-09T09:00:00Z,37.2N  31.0W,29,0,0,0,29
Tropical Depression,Ten,1,2004-09-09T09:00:00Z,38.3N  26.6W,5,9,2,2,18
Tropical Depression,Ten,1,2004-09-09T09:00:00Z,37.8N  28.9W,16,3,1,1,21
Tropical Depression,Ten,2,2004-09-09T15:00:00Z,37.0N  31.4W,43,0,0,0,43
Tropical Depression,Ten,2,2004-09-09T15:00:00Z,36.0N  31.0W,30,0,0,0,30
Tropical Depression,Ten,2,2004-09-09T15:00:00Z,36.5N  31.0W,34,0,1,0,35
Tropical Depression,Ten,3,2004-09-09T21:00:00Z,34.5N  32.0W,33,1,0,0,34
Tropical Depression,Ten,3,2004-09-09T21:00:00Z,33.5N  30.5W,17,2,1,0,20
Tropical Depression,Ten,3,2004-09-09T21:00:00Z,34.0N  31.0W,21,2,0,0,23
Tropical Depression,Eleven,1,2004-09-13T21:00:00Z,17.5N  64.2W,53,0,0,0,53
Tropical Depression,Eleven,1,2004-09-13T21:00:00Z,MTCA 183N 738W,0,0,0,6,6
Tropical Depression,Eleven,1,2004-09-13T21:00:00Z,18.4N  66.1W,12,24,0,0,36
Tropical Depression,Eleven,1,2004-09-13T21:00:00Z,MUGM 200N 751W,0,0,0,7,7
Tropical Depression,Eleven,1,2004-09-13T21:00:00Z,19.4N  68.0W,0,17,11,1,29
Tropical Depression,Eleven,1,2004-09-13T21:00:00Z,MUCM 214N 779W,0,0,0,2,2
Tropical Depression,Eleven,1,2004-09-13T21:00:00Z,TFFF 146N 610W,14,0,0,0,14
Tropical Depression,Eleven,1,2004-09-13T21:00:00Z,TJSJ 184N 661W,12,24,0,0,36
Tropical Depression,Eleven,1,2004-09-13T21:00:00Z,TDPR 153N 614W,65,0,0,0,65
Tropical Depression,Eleven,1,2004-09-13T21:00:00Z,MDPP 198N 707W,0,0,12,8,20
Tropical Depression,Eleven,1,2004-09-13T21:00:00Z,80400 157N 636W,35,0,0,0,35
Tropical Depression,Eleven,1,2004-09-13T21:00:00Z,MBJT 215N 712W,0,0,7,13,20
Tropical Depression,Eleven,1,2004-09-13T21:00:00Z,TFFR 163N 615W,99,0,0,0,99
Tropical Depression,Eleven,1,2004-09-13T21:00:00Z,MYMM 224N 730W,0,0,1,15,16
Tropical Depression,Eleven,1,2004-09-13T21:00:00Z,TAPA 171N 618W,94,0,0,0,94
Tropical Depression,Eleven,1,2004-09-13T21:00:00Z,MYSM 241N 745W,0,0,0,11,11
Tropical Depression,Eleven,1,2004-09-13T21:00:00Z,TKPK 173N 627W,76,0,0,0,76
Tropical Depression,Eleven,1,2004-09-13T21:00:00Z,MYEG 235N 758W,0,0,0,8,8
Tropical Depression,Eleven,1,2004-09-13T21:00:00Z,TNCM 181N 631W,60,0,0,0,60
Tropical Depression,Eleven,1,2004-09-13T21:00:00Z,MYAK 241N 776W,0,0,0,3,3
Tropical Depression,Eleven,1,2004-09-13T21:00:00Z,TISX 177N 648W,46,0,0,0,46
Tropical Depression,Eleven,1,2004-09-13T21:00:00Z,MYNN 251N 775W,0,0,0,3,3
Tropical Depression,Eleven,1,2004-09-13T21:00:00Z,TIST 183N 650W,39,4,0,0,43
Tropical Depression,Eleven,1,2004-09-13T21:00:00Z,ST CROIX VI,46,0,0,0,46
Tropical Depression,Eleven,1,2004-09-13T21:00:00Z,TJPS 180N 666W,5,27,0,0,32
Tropical Depression,Eleven,1,2004-09-13T21:00:00Z,ST THOMAS VI,39,4,0,0,43
Tropical Depression,Eleven,1,2004-09-13T21:00:00Z,MDSD 185N 697W,0,2,15,3,20
Tropical Depression,Eleven,1,2004-09-13T21:00:00Z,SAN JUAN PR,12,24,0,0,36
Tropical Depression,Eleven,1,2004-09-13T21:00:00Z,MDCB 176N 714W,0,0,4,7,11
Tropical Depression,Eleven,1,2004-09-13T21:00:00Z,PONCE PR,5,27,0,0,32
Tropical Depression,Eleven,1,2004-09-13T21:00:00Z,MTPP 186N 724W,0,0,2,10,12
Tropical Depression,Eleven,2,2004-09-14T03:00:00Z,17.5N  64.6W,53,0,0,0,53
Tropical Depression,Eleven,2,2004-09-14T03:00:00Z,MDCB 176N 714W,0,0,1,8,9
Tropical Depression,Eleven,2,2004-09-14T03:00:00Z,18.4N  66.3W,8,31,0,0,39
Tropical Depression,Eleven,2,2004-09-14T03:00:00Z,MTPP 186N 724W,0,0,0,8,8
Tropical Depression,Eleven,2,2004-09-14T03:00:00Z,19.3N  67.5W,0,24,7,0,31
Tropical Depression,Eleven,2,2004-09-14T03:00:00Z,MTCA 183N 738W,0,0,0,3,3
Tropical Depression,Eleven,2,2004-09-14T03:00:00Z,TFFF 146N 610W,2,0,0,0,2
Tropical Depression,Eleven,2,2004-09-14T03:00:00Z,MUGM 200N 751W,0,0,0,2,2
Tropical Depression,Eleven,2,2004-09-14T03:00:00Z,TDPR 153N 614W,99,0,0,0,99
Tropical Depression,Eleven,2,2004-09-14T03:00:00Z,TJSJ 184N 661W,12,28,0,1,41
Tropical Depression,Eleven,2,2004-09-14T03:00:00Z,80400 157N 636W,40,0,0,1,41
Tropical Depression,Eleven,2,2004-09-14T03:00:00Z,MDPP 198N 707W,0,0,5,13,18
Tropical Depression,Eleven,2,2004-09-14T03:00:00Z,TFFR 163N 615W,99,0,0,0,99
Tropical Depression,Eleven,2,2004-09-14T03:00:00Z,MBJT 215N 712W,0,0,2,15,17
Tropical Depression,Eleven,2,2004-09-14T03:00:00Z,TAPA 171N 618W,90,0,0,0,90
Tropical Depression,Eleven,2,2004-09-14T03:00:00Z,MYMM 224N 730W,0,0,0,10,10
Tropical Depression,Eleven,2,2004-09-14T03:00:00Z,TKPK 173N 627W,83,0,0,0,83
Tropical Depression,Eleven,2,2004-09-14T03:00:00Z,MYSM 241N 745W,0,0,0,4,4
Tropical Depression,Eleven,2,2004-09-14T03:00:00Z,TNCM 181N 631W,57,1,0,0,58
Tropical Depression,Eleven,2,2004-09-14T03:00:00Z,MYEG 235N 758W,0,0,0,2,2
Tropical Depression,Eleven,2,2004-09-14T03:00:00Z,TISX 177N 648W,51,0,0,0,51
Tropical Depression,Eleven,2,2004-09-14T03:00:00Z,ST CROIX VI,51,0,0,0,51
Tropical Depression,Eleven,2,2004-09-14T03:00:00Z,TIST 183N 650W,42,4,0,0,46
Tropical Depression,Eleven,2,2004-09-14T03:00:00Z,ST THOMAS VI,42,4,0,0,46
Tropical Depression,Eleven,2,2004-09-14T03:00:00Z,TJPS 180N 666W,6,30,1,0,37
Tropical Depression,Eleven,2,2004-09-14T03:00:00Z,SAN JUAN PR,12,28,0,1,41
Tropical Depression,Eleven,2,2004-09-14T03:00:00Z,MDSD 185N 697W,0,1,12,6,19
Tropical Depression,Eleven,2,2004-09-14T03:00:00Z,PONCE PR,6,30,1,0,37
Tropical Depression,Eleven,3,2004-09-14T09:00:00Z,18.5N  65.3W,51,0,0,0,51
Tropical Depression,Eleven,3,2004-09-14T09:00:00Z,MTCA 183N 738W,0,0,0,6,6
Tropical Depression,Eleven,3,2004-09-14T09:00:00Z,19.5N  67.1W,16,19,0,0,35
Tropical Depression,Eleven,3,2004-09-14T09:00:00Z,MUGM 200N 751W,0,0,0,6,6
Tropical Depression,Eleven,3,2004-09-14T09:00:00Z,20.4N  68.8W,0,20,7,1,28
Tropical Depression,Eleven,3,2004-09-14T09:00:00Z,TJSJ 184N 661W,40,1,0,0,41
Tropical Depression,Eleven,3,2004-09-14T09:00:00Z,TDPR 153N 614W,75,0,0,0,75
Tropical Depression,Eleven,3,2004-09-14T09:00:00Z,MDPP 198N 707W,0,3,14,4,21
Tropical Depression,Eleven,3,2004-09-14T09:00:00Z,80400 157N 636W,20,1,0,0,21
Tropical Depression,Eleven,3,2004-09-14T09:00:00Z,MBJT 215N 712W,0,1,14,6,21
Tropical Depression,Eleven,3,2004-09-14T09:00:00Z,TFFR 163N 615W,99,0,0,0,99
Tropical Depression,Eleven,3,2004-09-14T09:00:00Z,MYMM 224N 730W,0,0,3,13,16
Tropical Depression,Eleven,3,2004-09-14T09:00:00Z,TAPA 171N 618W,99,0,0,0,99
Tropical Depression,Eleven,3,2004-09-14T09:00:00Z,MYSM 241N 745W,0,0,0,10,10
Tropical Depression,Eleven,3,2004-09-14T09:00:00Z,TKPK 173N 627W,99,0,0,0,99
Tropical Depression,Eleven,3,2004-09-14T09:00:00Z,MYEG 235N 758W,0,0,0,7,7
Tropical Depression,Eleven,3,2004-09-14T09:00:00Z,TNCM 181N 631W,73,0,0,0,73
Tropical Depression,Eleven,3,2004-09-14T09:00:00Z,MYAK 241N 776W,0,0,0,2,2
Tropical Depression,Eleven,3,2004-09-14T09:00:00Z,TISX 177N 648W,58,0,0,0,58
Tropical Depression,Eleven,3,2004-09-14T09:00:00Z,MYNN 251N 775W,0,0,0,2,2
Tropical Depression,Eleven,3,2004-09-14T09:00:00Z,TIST 183N 650W,55,0,0,0,55
Tropical Depression,Eleven,3,2004-09-14T09:00:00Z,ST CROIX VI,58,0,0,0,58
Tropical Depression,Eleven,3,2004-09-14T09:00:00Z,TJPS 180N 666W,29,5,0,0,34
Tropical Depression,Eleven,3,2004-09-14T09:00:00Z,ST THOMAS VI,55,0,0,0,55
Tropical Depression,Eleven,3,2004-09-14T09:00:00Z,MDSD 185N 697W,0,9,9,2,20
Tropical Depression,Eleven,3,2004-09-14T09:00:00Z,SAN JUAN PR,40,1,0,0,41
Tropical Depression,Eleven,3,2004-09-14T09:00:00Z,MDCB 176N 714W,0,0,5,6,11
Tropical Depression,Eleven,3,2004-09-14T09:00:00Z,PONCE PR,29,5,0,0,34
Tropical Depression,Eleven,3,2004-09-14T09:00:00Z,MTPP 186N 724W,0,0,4,8,12
Tropical Storm,Jeanne,4,2004-09-14T15:00:00Z,18.3N  66.3W,57,0,0,0,57
Tropical Storm,Jeanne,4,2004-09-14T15:00:00Z,MTPP 186N 724W,0,0,7,9,16
Tropical Storm,Jeanne,4,2004-09-14T15:00:00Z,19.2N  68.0W,6,35,0,1,42
Tropical Storm,Jeanne,4,2004-09-14T15:00:00Z,MTCA 183N 738W,0,0,1,8,9
Tropical Storm,Jeanne,4,2004-09-14T15:00:00Z,20.0N  69.5W,0,21,11,0,32
Tropical Storm,Jeanne,4,2004-09-14T15:00:00Z,MUGM 200N 751W,0,0,0,8,8
Tropical Storm,Jeanne,4,2004-09-14T15:00:00Z,80400 157N 636W,99,0,0,0,99
Tropical Storm,Jeanne,4,2004-09-14T15:00:00Z,TJSJ 184N 661W,61,0,0,0,61
Tropical Storm,Jeanne,4,2004-09-14T15:00:00Z,TFFR 163N 615W,15,0,0,0,15
Tropical Storm,Jeanne,4,2004-09-14T15:00:00Z,MDPP 198N 707W,0,4,20,2,26
Tropical Storm,Jeanne,4,2004-09-14T15:00:00Z,TAPA 171N 618W,88,0,0,0,88
Tropical Storm,Jeanne,4,2004-09-14T15:00:00Z,MBJT 215N 712W,0,0,17,7,24
Tropical Storm,Jeanne,4,2004-09-14T15:00:00Z,TKPK 173N 627W,99,0,0,0,99
Tropical Storm,Jeanne,4,2004-09-14T15:00:00Z,MYMM 224N 730W,0,0,2,15,17
Tropical Storm,Jeanne,4,2004-09-14T15:00:00Z,TNCM 181N 631W,73,0,0,0,73
Tropical Storm,Jeanne,4,2004-09-14T15:00:00Z,MYSM 241N 745W,0,0,0,9,9
Tropical Storm,Jeanne,4,2004-09-14T15:00:00Z,TISX 177N 648W,85,0,0,0,85
Tropical Storm,Jeanne,4,2004-09-14T15:00:00Z,MYEG 235N 758W,0,0,0,6,6
Tropical Storm,Jeanne,4,2004-09-14T15:00:00Z,TIST 183N 650W,72,0,0,0,72
Tropical Storm,Jeanne,4,2004-09-14T15:00:00Z,ST CROIX VI,85,0,0,0,85
Tropical Storm,Jeanne,4,2004-09-14T15:00:00Z,TJPS 180N 666W,54,0,0,0,54
Tropical Storm,Jeanne,4,2004-09-14T15:00:00Z,ST THOMAS VI,72,0,0,0,72
Tropical Storm,Jeanne,4,2004-09-14T15:00:00Z,MDSD 185N 697W,0,20,7,1,28
Tropical Storm,Jeanne,4,2004-09-14T15:00:00Z,SAN JUAN PR,61,0,0,0,61
Tropical Storm,Jeanne,4,2004-09-14T15:00:00Z,MDCB 176N 714W,0,1,10,5,16
Tropical Storm,Jeanne,4,2004-09-14T15:00:00Z,PONCE PR,54,0,0,0,54
Tropical Storm,Jeanne,5,2004-09-14T21:00:00Z,18.1N  67.0W,46,0,0,0,46
Tropical Storm,Jeanne,5,2004-09-14T21:00:00Z,MUGM 200N 751W,0,0,2,9,11
Tropical Storm,Jeanne,5,2004-09-14T21:00:00Z,18.9N  68.6W,21,11,0,0,32
Tropical Storm,Jeanne,5,2004-09-14T21:00:00Z,MUCM 214N 779W,0,0,0,4,4
Tropical Storm,Jeanne,5,2004-09-14T21:00:00Z,19.7N  70.0W,1,23,2,1,27
Tropical Storm,Jeanne,5,2004-09-14T21:00:00Z,TJSJ 184N 661W,52,0,0,0,52
Tropical Storm,Jeanne,5,2004-09-14T21:00:00Z,80400 157N 636W,99,0,0,0,99
Tropical Storm,Jeanne,5,2004-09-14T21:00:00Z,MDPP 198N 707W,0,17,6,2,25
Tropical Storm,Jeanne,5,2004-09-14T21:00:00Z,TKPK 173N 627W,99,0,0,0,99
Tropical Storm,Jeanne,5,2004-09-14T21:00:00Z,MBJT 215N 712W,0,5,14,4,23
Tropical Storm,Jeanne,5,2004-09-14T21:00:00Z,TNCM 181N 631W,44,0,0,0,44
Tropical Storm,Jeanne,5,2004-09-14T21:00:00Z,MYMM 224N 730W,0,0,9,10,19
Tropical Storm,Jeanne,5,2004-09-14T21:00:00Z,TISX 177N 648W,80,0,0,0,80
Tropical Storm,Jeanne,5,2004-09-14T21:00:00Z,MYSM 241N 745W,0,0,1,12,13
Tropical Storm,Jeanne,5,2004-09-14T21:00:00Z,TIST 183N 650W,59,0,0,0,59
Tropical Storm,Jeanne,5,2004-09-14T21:00:00Z,MYEG 235N 758W,0,0,0,10,10
Tropical Storm,Jeanne,5,2004-09-14T21:00:00Z,TJPS 180N 666W,51,0,0,0,51
Tropical Storm,Jeanne,5,2004-09-14T21:00:00Z,MYAK 241N 776W,0,0,0,5,5
Tropical Storm,Jeanne,5,2004-09-14T21:00:00Z,MDSD 185N 697W,7,18,1,1,27
Tropical Storm,Jeanne,5,2004-09-14T21:00:00Z,MYNN 251N 775W,0,0,0,4,4
Tropical Storm,Jeanne,5,2004-09-14T21:00:00Z,MDCB 176N 714W,0,9,4,4,17
Tropical Storm,Jeanne,5,2004-09-14T21:00:00Z,ST CROIX VI,80,0,0,0,80
Tropical Storm,Jeanne,5,2004-09-14T21:00:00Z,MTPP 186N 724W,0,4,8,5,17
Tropical Storm,Jeanne,5,2004-09-14T21:00:00Z,ST THOMAS VI,59,0,0,0,59
Tropical Storm,Jeanne,5,2004-09-14T21:00:00Z,MTCA 183N 738W,0,0,5,7,12
Tropical Storm,Jeanne,5,2004-09-14T21:00:00Z,SAN JUAN PR,52,0,0,0,52
Tropical Storm,Jeanne,5,2004-09-14T21:00:00Z,MKJP 179N 768W,0,0,0,2,2
Tropical Storm,Jeanne,5,2004-09-14T21:00:00Z,PONCE PR,51,0,0,0,51
Tropical Storm,Jeanne,6,2004-09-15T03:00:00Z,18.6N  67.1W,44,0,0,0,44
Tropical Storm,Jeanne,6,2004-09-15T03:00:00Z,TJSJ 184N 661W,56,0,0,0,56
Tropical Storm,Jeanne,6,2004-09-15T03:00:00Z,19.6N  68.8W,18,13,0,1,32
Tropical Storm,Jeanne,6,2004-09-15T03:00:00Z,MDPP 198N 707W,1,18,3,2,24
Tropical Storm,Jeanne,6,2004-09-15T03:00:00Z,20.5N  70.3W,1,21,3,2,27
Tropical Storm,Jeanne,6,2004-09-15T03:00:00Z,MBJT 215N 712W,0,11,11,3,25
Tropical Storm,Jeanne,6,2004-09-15T03:00:00Z,TKPK 173N 627W,4,0,0,0,4
Tropical Storm,Jeanne,6,2004-09-15T03:00:00Z,MYMM 224N 730W,0,1,12,7,20
Tropical Storm,Jeanne,6,2004-09-15T03:00:00Z,TNCM 181N 631W,33,0,0,1,34
Tropical Storm,Jeanne,6,2004-09-15T03:00:00Z,MYSM 241N 745W,0,0,3,12,15
Tropical Storm,Jeanne,6,2004-09-15T03:00:00Z,TISX 177N 648W,99,0,0,0,99
Tropical Storm,Jeanne,6,2004-09-15T03:00:00Z,MYEG 235N 758W,0,0,1,10,11
Tropical Storm,Jeanne,6,2004-09-15T03:00:00Z,TIST 183N 650W,69,0,0,0,69
Tropical Storm,Jeanne,6,2004-09-15T03:00:00Z,MYAK 241N 776W,0,0,0,5,5
Tropical Storm,Jeanne,6,2004-09-15T03:00:00Z,TJPS 180N 666W,49,0,0,0,49
Tropical Storm,Jeanne,6,2004-09-15T03:00:00Z,MYNN 251N 775W,0,0,0,5,5
Tropical Storm,Jeanne,6,2004-09-15T03:00:00Z,MDSD 185N 697W,10,11,1,1,23
Tropical Storm,Jeanne,6,2004-09-15T03:00:00Z,MYGF 266N 787W,0,0,0,2,2
Tropical Storm,Jeanne,6,2004-09-15T03:00:00Z,MDCB 176N 714W,0,5,3,4,12
Tropical Storm,Jeanne,6,2004-09-15T03:00:00Z,ST CROIX VI,99,0,0,0,99
Tropical Storm,Jeanne,6,2004-09-15T03:00:00Z,MTPP 186N 724W,0,3,6,5,14
Tropical Storm,Jeanne,6,2004-09-15T03:00:00Z,ST THOMAS VI,69,0,0,0,69
Tropical Storm,Jeanne,6,2004-09-15T03:00:00Z,MTCA 183N 738W,0,0,2,7,9
Tropical Storm,Jeanne,6,2004-09-15T03:00:00Z,SAN JUAN PR,56,0,0,0,56
Tropical Storm,Jeanne,6,2004-09-15T03:00:00Z,MUGM 200N 751W,0,0,2,8,10
Tropical Storm,Jeanne,6,2004-09-15T03:00:00Z,PONCE PR,49,0,0,0,49
Tropical Storm,Jeanne,6,2004-09-15T03:00:00Z,MUCM 214N 779W,0,0,0,3,3
Tropical Storm,Jeanne,7,2004-09-15T09:00:00Z,19.1N  68.2W,45,0,0,0,45
Tropical Storm,Jeanne,7,2004-09-15T09:00:00Z,MBJT 215N 712W,0,22,4,2,28
Tropical Storm,Jeanne,7,2004-09-15T09:00:00Z,20.0N  69.9W,19,14,0,0,33
Tropical Storm,Jeanne,7,2004-09-15T09:00:00Z,MYMM 224N 730W,0,4,14,5,23
Tropical Storm,Jeanne,7,2004-09-15T09:00:00Z,20.8N  71.3W,1,22,3,1,27
Tropical Storm,Jeanne,7,2004-09-15T09:00:00Z,MYSM 241N 745W,0,0,6,12,18
Tropical Storm,Jeanne,7,2004-09-15T09:00:00Z,TISX 177N 648W,99,0,0,0,99
Tropical Storm,Jeanne,7,2004-09-15T09:00:00Z,MYEG 235N 758W,0,0,2,13,15
Tropical Storm,Jeanne,7,2004-09-15T09:00:00Z,TIST 183N 650W,99,0,0,0,99
Tropical Storm,Jeanne,7,2004-09-15T09:00:00Z,MYAK 241N 776W,0,0,0,10,10
Tropical Storm,Jeanne,7,2004-09-15T09:00:00Z,TJPS 180N 666W,69,0,0,0,69
Tropical Storm,Jeanne,7,2004-09-15T09:00:00Z,MYNN 251N 775W,0,0,0,10,10
Tropical Storm,Jeanne,7,2004-09-15T09:00:00Z,MDSD 185N 697W,24,4,0,1,29
Tropical Storm,Jeanne,7,2004-09-15T09:00:00Z,MYGF 266N 787W,0,0,0,6,6
Tropical Storm,Jeanne,7,2004-09-15T09:00:00Z,MDCB 176N 714W,2,7,3,2,14
Tropical Storm,Jeanne,7,2004-09-15T09:00:00Z,ST CROIX VI,99,0,0,0,99
Tropical Storm,Jeanne,7,2004-09-15T09:00:00Z,MTPP 186N 724W,0,8,5,3,16
Tropical Storm,Jeanne,7,2004-09-15T09:00:00Z,ST THOMAS VI,99,0,0,0,99
Tropical Storm,Jeanne,7,2004-09-15T09:00:00Z,MTCA 183N 738W,0,1,4,6,11
Tropical Storm,Jeanne,7,2004-09-15T09:00:00Z,SAN JUAN PR,79,0,0,0,79
Tropical Storm,Jeanne,7,2004-09-15T09:00:00Z,MKJP 179N 768W,0,0,0,2,2
Tropical Storm,Jeanne,7,2004-09-15T09:00:00Z,PONCE PR,69,0,0,0,69
Tropical Storm,Jeanne,7,2004-09-15T09:00:00Z,MKJS 185N 779W,0,0,0,2,2
Tropical Storm,Jeanne,7,2004-09-15T09:00:00Z,MIAMI FL,0,0,0,3,3
Tropical Storm,Jeanne,7,2004-09-15T09:00:00Z,MUGM 200N 751W,0,0,4,8,12
Tropical Storm,Jeanne,7,2004-09-15T09:00:00Z,W PALM BEACH FL,0,0,0,3,3
Tropical Storm,Jeanne,7,2004-09-15T09:00:00Z,MUCM 214N 779W,0,0,0,6,6
Tropical Storm,Jeanne,7,2004-09-15T09:00:00Z,FT PIERCE FL,0,0,0,3,3
Tropical Storm,Jeanne,7,2004-09-15T09:00:00Z,TJSJ 184N 661W,79,0,0,0,79
Tropical Storm,Jeanne,7,2004-09-15T09:00:00Z,COCOA BEACH FL,0,0,0,2,2
Tropical Storm,Jeanne,7,2004-09-15T09:00:00Z,MDPP 198N 707W,8,19,1,1,29
Tropical Storm,Jeanne,8,2004-09-15T15:00:00Z,19.2N  68.6W,45,0,0,0,45
Tropical Storm,Jeanne,8,2004-09-15T15:00:00Z,MYMM 224N 730W,0,7,14,3,24
Tropical Storm,Jeanne,8,2004-09-15T15:00:00Z,20.2N  70.4W,16,17,0,1,34
Tropical Storm,Jeanne,8,2004-09-15T15:00:00Z,MYSM 241N 745W,0,0,10,10,20
Tropical Storm,Jeanne,8,2004-09-15T15:00:00Z,21.1N  71.9W,1,21,4,1,27
Tropical Storm,Jeanne,8,2004-09-15T15:00:00Z,MYEG 235N 758W,0,0,5,12,17
Tropical Storm,Jeanne,8,2004-09-15T15:00:00Z,TISX 177N 648W,99,0,0,0,99
Tropical Storm,Jeanne,8,2004-09-15T15:00:00Z,MYAK 241N 776W,0,0,0,12,12
Tropical Storm,Jeanne,8,2004-09-15T15:00:00Z,TIST 183N 650W,99,0,0,0,99
Tropical Storm,Jeanne,8,2004-09-15T15:00:00Z,MYNN 251N 775W,0,0,0,12,12
Tropical Storm,Jeanne,8,2004-09-15T15:00:00Z,TJPS 180N 666W,99,0,0,0,99
Tropical Storm,Jeanne,8,2004-09-15T15:00:00Z,MYGF 266N 787W,0,0,0,8,8
Tropical Storm,Jeanne,8,2004-09-15T15:00:00Z,MDSD 185N 697W,29,2,0,0,31
Tropical Storm,Jeanne,8,2004-09-15T15:00:00Z,ST CROIX VI,99,0,0,0,99
Tropical Storm,Jeanne,8,2004-09-15T15:00:00Z,MDCB 176N 714W,3,8,1,2,14
Tropical Storm,Jeanne,8,2004-09-15T15:00:00Z,ST THOMAS VI,99,0,0,0,99
Tropical Storm,Jeanne,8,2004-09-15T15:00:00Z,MTPP 186N 724W,1,10,3,2,16
Tropical Storm,Jeanne,8,2004-09-15T15:00:00Z,SAN JUAN PR,99,0,0,0,99
Tropical Storm,Jeanne,8,2004-09-15T15:00:00Z,MTCA 183N 738W,0,2,4,5,11
Tropical Storm,Jeanne,8,2004-09-15T15:00:00Z,PONCE PR,99,0,0,0,99
Tropical Storm,Jeanne,8,2004-09-15T15:00:00Z,MKJP 179N 768W,0,0,0,3,3
Tropical Storm,Jeanne,8,2004-09-15T15:00:00Z,MARATHON FL,0,0,0,2,2
Tropical Storm,Jeanne,8,2004-09-15T15:00:00Z,MKJS 185N 779W,0,0,0,2,2
Tropical Storm,Jeanne,8,2004-09-15T15:00:00Z,MIAMI FL,0,0,0,4,4
Tropical Storm,Jeanne,8,2004-09-15T15:00:00Z,MUGM 200N 751W,0,0,6,7,13
Tropical Storm,Jeanne,8,2004-09-15T15:00:00Z,W PALM BEACH FL,0,0,0,5,5
Tropical Storm,Jeanne,8,2004-09-15T15:00:00Z,MUCM 214N 779W,0,0,0,7,7
Tropical Storm,Jeanne,8,2004-09-15T15:00:00Z,FT PIERCE FL,0,0,0,4,4
Tropical Storm,Jeanne,8,2004-09-15T15:00:00Z,MUCF 221N 805W,0,0,0,2,2
Tropical Storm,Jeanne,8,2004-09-15T15:00:00Z,COCOA BEACH FL,0,0,0,3,3
Tropical Storm,Jeanne,8,2004-09-15T15:00:00Z,TJSJ 184N 661W,99,0,0,0,99
Tropical Storm,Jeanne,8,2004-09-15T15:00:00Z,DAYTONA BEACH FL,0,0,0,2,2
Tropical Storm,Jeanne,8,2004-09-15T15:00:00Z,MDPP 198N 707W,14,16,1,0,31
Tropical Storm,Jeanne,8,2004-09-15T15:00:00Z,MARCO ISLAND FL,0,0,0,2,2
Tropical Storm,Jeanne,8,2004-09-15T15:00:00Z,MBJT 215N 712W,1,25,3,0,29
Tropical Storm,Jeanne,9,2004-09-15T21:00:00Z,19.7N  69.2W,45,0,0,0,45
Tropical Storm,Jeanne,9,2004-09-15T21:00:00Z,MYMM 224N 730W,0,13,9,3,25
Tropical Storm,Jeanne,9,2004-09-15T21:00:00Z,20.6N  70.9W,19,12,1,0,32
Tropical Storm,Jeanne,9,2004-09-15T21:00:00Z,MYSM 241N 745W,0,1,12,7,20
Tropical Storm,Jeanne,9,2004-09-15T21:00:00Z,21.6N  72.4W,1,21,3,1,26
Tropical Storm,Jeanne,9,2004-09-15T21:00:00Z,MYEG 235N 758W,0,0,8,9,17
Tropical Storm,Jeanne,9,2004-09-15T21:00:00Z,TIST 183N 650W,16,0,0,0,16
Tropical Storm,Jeanne,9,2004-09-15T21:00:00Z,MYAK 241N 776W,0,0,1,11,12
Tropical Storm,Jeanne,9,2004-09-15T21:00:00Z,TJPS 180N 666W,99,0,0,0,99
Tropical Storm,Jeanne,9,2004-09-15T21:00:00Z,MYNN 251N 775W,0,0,1,11,12
Tropical Storm,Jeanne,9,2004-09-15T21:00:00Z,MDSD 185N 697W,30,0,1,0,31
Tropical Storm,Jeanne,9,2004-09-15T21:00:00Z,MYGF 266N 787W,0,0,0,8,8
Tropical Storm,Jeanne,9,2004-09-15T21:00:00Z,MDCB 176N 714W,5,5,1,1,12
Tropical Storm,Jeanne,9,2004-09-15T21:00:00Z,ST THOMAS VI,16,0,0,0,16
Tropical Storm,Jeanne,9,2004-09-15T21:00:00Z,MTPP 186N 724W,3,10,1,2,16
Tropical Storm,Jeanne,9,2004-09-15T21:00:00Z,SAN JUAN PR,99,0,0,0,99
Tropical Storm,Jeanne,9,2004-09-15T21:00:00Z,MTCA 183N 738W,0,3,4,3,10
Tropical Storm,Jeanne,9,2004-09-15T21:00:00Z,PONCE PR,99,0,0,0,99
Tropical Storm,Jeanne,9,2004-09-15T21:00:00Z,MKJP 179N 768W,0,0,0,2,2
Tropical Storm,Jeanne,9,2004-09-15T21:00:00Z,MARATHON FL,0,0,0,2,2
Tropical Storm,Jeanne,9,2004-09-15T21:00:00Z,MKJS 185N 779W,0,0,0,2,2
Tropical Storm,Jeanne,9,2004-09-15T21:00:00Z,MIAMI FL,0,0,0,4,4
Tropical Storm,Jeanne,9,2004-09-15T21:00:00Z,MUGM 200N 751W,0,2,7,4,13
Tropical Storm,Jeanne,9,2004-09-15T21:00:00Z,W PALM BEACH FL,0,0,0,4,4
Tropical Storm,Jeanne,9,2004-09-15T21:00:00Z,MUCM 214N 779W,0,0,1,6,7
Tropical Storm,Jeanne,9,2004-09-15T21:00:00Z,FT PIERCE FL,0,0,0,4,4
Tropical Storm,Jeanne,9,2004-09-15T21:00:00Z,MUCF 221N 805W,0,0,0,2,2
Tropical Storm,Jeanne,9,2004-09-15T21:00:00Z,COCOA BEACH FL,0,0,0,3,3
Tropical Storm,Jeanne,9,2004-09-15T21:00:00Z,TJSJ 184N 661W,99,0,0,0,99
Tropical Storm,Jeanne,9,2004-09-15T21:00:00Z,DAYTONA BEACH FL,0,0,0,2,2
Tropical Storm,Jeanne,9,2004-09-15T21:00:00Z,MDPP 198N 707W,26,5,0,0,31
Tropical Storm,Jeanne,9,2004-09-15T21:00:00Z,MARCO ISLAND FL,0,0,0,2,2
Tropical Storm,Jeanne,9,2004-09-15T21:00:00Z,MBJT 215N 712W,7,21,1,1,30
Tropical Storm,Jeanne,10,2004-09-16T03:00:00Z,20.0N  70.4W,47,0,0,0,47
Tropical Storm,Jeanne,10,2004-09-16T03:00:00Z,MYAK 241N 776W,0,0,4,12,16
Tropical Storm,Jeanne,10,2004-09-16T03:00:00Z,20.9N  72.0W,19,13,1,0,33
Tropical Storm,Jeanne,10,2004-09-16T03:00:00Z,MYNN 251N 775W,0,0,4,12,16
Tropical Storm,Jeanne,10,2004-09-16T03:00:00Z,22.0N  73.6W,0,20,7,1,28
Tropical Storm,Jeanne,10,2004-09-16T03:00:00Z,MYGF 266N 787W,0,0,0,12,12
Tropical Storm,Jeanne,10,2004-09-16T03:00:00Z,TJPS 180N 666W,99,0,0,0,99
Tropical Storm,Jeanne,10,2004-09-16T03:00:00Z,SAN JUAN PR,99,0,0,0,99
Tropical Storm,Jeanne,10,2004-09-16T03:00:00Z,MDSD 185N 697W,44,0,0,0,44
Tropical Storm,Jeanne,10,2004-09-16T03:00:00Z,PONCE PR,99,0,0,0,99
Tropical Storm,Jeanne,10,2004-09-16T03:00:00Z,MDCB 176N 714W,8,2,1,1,12
Tropical Storm,Jeanne,10,2004-09-16T03:00:00Z,MARATHON FL,0,0,0,5,5
Tropical Storm,Jeanne,10,2004-09-16T03:00:00Z,MTPP 186N 724W,10,7,1,1,19
Tropical Storm,Jeanne,10,2004-09-16T03:00:00Z,MIAMI FL,0,0,0,8,8
Tropical Storm,Jeanne,10,2004-09-16T03:00:00Z,MTCA 183N 738W,1,6,4,2,13
Tropical Storm,Jeanne,10,2004-09-16T03:00:00Z,W PALM BEACH FL,0,0,0,8,8
Tropical Storm,Jeanne,10,2004-09-16T03:00:00Z,MKJP 179N 768W,0,0,1,2,3
Tropical Storm,Jeanne,10,2004-09-16T03:00:00Z,FT PIERCE FL,0,0,0,7,7
Tropical Storm,Jeanne,10,2004-09-16T03:00:00Z,MKJS 185N 779W,0,0,0,3,3
Tropical Storm,Jeanne,10,2004-09-16T03:00:00Z,COCOA BEACH FL,0,0,0,6,6
Tropical Storm,Jeanne,10,2004-09-16T03:00:00Z,MUGM 200N 751W,0,5,9,3,17
Tropical Storm,Jeanne,10,2004-09-16T03:00:00Z,DAYTONA BEACH FL,0,0,0,4,4
Tropical Storm,Jeanne,10,2004-09-16T03:00:00Z,MUCM 214N 779W,0,0,3,7,10
Tropical Storm,Jeanne,10,2004-09-16T03:00:00Z,JACKSONVILLE FL,0,0,0,2,2
Tropical Storm,Jeanne,10,2004-09-16T03:00:00Z,MUCF 221N 805W,0,0,0,3,3
Tropical Storm,Jeanne,10,2004-09-16T03:00:00Z,KEY WEST FL,0,0,0,3,3
Tropical Storm,Jeanne,10,2004-09-16T03:00:00Z,TJSJ 184N 661W,99,0,0,0,99
Tropical Storm,Jeanne,10,2004-09-16T03:00:00Z,MARCO ISLAND FL,0,0,0,4,4
Tropical Storm,Jeanne,10,2004-09-16T03:00:00Z,MDPP 198N 707W,44,0,0,0,44
Tropical Storm,Jeanne,10,2004-09-16T03:00:00Z,FT MYERS FL,0,0,0,4,4
Tropical Storm,Jeanne,10,2004-09-16T03:00:00Z,MBJT 215N 712W,23,10,0,1,34
Tropical Storm,Jeanne,10,2004-09-16T03:00:00Z,VENICE FL,0,0,0,3,3
Tropical Storm,Jeanne,10,2004-09-16T03:00:00Z,MYMM 224N 730W,1,22,5,1,29
Tropical Storm,Jeanne,10,2004-09-16T03:00:00Z,TAMPA FL,0,0,0,3,3
Tropical Storm,Jeanne,10,2004-09-16T03:00:00Z,MYSM 241N 745W,0,3,17,3,23
Tropical Storm,Jeanne,10,2004-09-16T03:00:00Z,CEDAR KEY FL,0,0,0,2,2
Tropical Storm,Jeanne,10,2004-09-16T03:00:00Z,MYEG 235N 758W,0,1,14,6,21
Tropical Storm,Jeanne,11,2004-09-16T09:00:00Z,20.4N  70.9W,44,0,0,0,44
Tropical Storm,Jeanne,11,2004-09-16T09:00:00Z,MYAK 241N 776W,0,0,8,10,18
Tropical Storm,Jeanne,11,2004-09-16T09:00:00Z,21.2N  72.6W,18,12,1,0,31
Tropical Storm,Jeanne,11,2004-09-16T09:00:00Z,MYNN 251N 775W,0,0,7,11,18
Tropical Storm,Jeanne,11,2004-09-16T09:00:00Z,22.3N  74.2W,0,20,5,1,26
Tropical Storm,Jeanne,11,2004-09-16T09:00:00Z,MYGF 266N 787W,0,0,1,14,15
Tropical Storm,Jeanne,11,2004-09-16T09:00:00Z,MDSD 185N 697W,36,0,0,1,37
Tropical Storm,Jeanne,11,2004-09-16T09:00:00Z,MARATHON FL,0,0,0,8,8
Tropical Storm,Jeanne,11,2004-09-16T09:00:00Z,MDCB 176N 714W,2,1,0,1,4
Tropical Storm,Jeanne,11,2004-09-16T09:00:00Z,MIAMI FL,0,0,0,11,11
Tropical Storm,Jeanne,11,2004-09-16T09:00:00Z,MTPP 186N 724W,9,3,1,1,14
Tropical Storm,Jeanne,11,2004-09-16T09:00:00Z,W PALM BEACH FL,0,0,0,11,11
Tropical Storm,Jeanne,11,2004-09-16T09:00:00Z,MTCA 183N 738W,1,4,2,1,8
Tropical Storm,Jeanne,11,2004-09-16T09:00:00Z,FT PIERCE FL,0,0,0,10,10
Tropical Storm,Jeanne,11,2004-09-16T09:00:00Z,MKJP 179N 768W,0,0,0,3,3
Tropical Storm,Jeanne,11,2004-09-16T09:00:00Z,COCOA BEACH FL,0,0,0,9,9
Tropical Storm,Jeanne,11,2004-09-16T09:00:00Z,MKJS 185N 779W,0,0,0,3,3
Tropical Storm,Jeanne,11,2004-09-16T09:00:00Z,DAYTONA BEACH FL,0,0,0,6,6
Tropical Storm,Jeanne,11,2004-09-16T09:00:00Z,MUGM 200N 751W,0,9,5,2,16
Tropical Storm,Jeanne,11,2004-09-16T09:00:00Z,JACKSONVILLE FL,0,0,0,3,3
Tropical Storm,Jeanne,11,2004-09-16T09:00:00Z,MUCM 214N 779W,0,0,5,8,13
Tropical Storm,Jeanne,11,2004-09-16T09:00:00Z,SAVANNAH GA,0,0,0,2,2
Tropical Storm,Jeanne,11,2004-09-16T09:00:00Z,MUCF 221N 805W,0,0,0,7,7
Tropical Storm,Jeanne,11,2004-09-16T09:00:00Z,KEY WEST FL,0,0,0,6,6
Tropical Storm,Jeanne,11,2004-09-16T09:00:00Z,MUHA 230N 824W,0,0,0,3,3
Tropical Storm,Jeanne,11,2004-09-16T09:00:00Z,MARCO ISLAND FL,0,0,0,7,7
Tropical Storm,Jeanne,11,2004-09-16T09:00:00Z,MDPP 198N 707W,45,0,0,0,45
Tropical Storm,Jeanne,11,2004-09-16T09:00:00Z,FT MYERS FL,0,0,0,7,7
Tropical Storm,Jeanne,11,2004-09-16T09:00:00Z,MBJT 215N 712W,32,2,1,0,35
Tropical Storm,Jeanne,11,2004-09-16T09:00:00Z,VENICE FL,0,0,0,5,5
Tropical Storm,Jeanne,11,2004-09-16T09:00:00Z,MYMM 224N 730W,3,24,1,1,29
Tropical Storm,Jeanne,11,2004-09-16T09:00:00Z,TAMPA FL,0,0,0,4,4
Tropical Storm,Jeanne,11,2004-09-16T09:00:00Z,MYSM 241N 745W,0,6,15,3,24
Tropical Storm,Jeanne,11,2004-09-16T09:00:00Z,CEDAR KEY FL,0,0,0,3,3
Tropical Storm,Jeanne,11,2004-09-16T09:00:00Z,MYEG 235N 758W,0,4,15,4,23
Hurricane,Jeanne,12,2004-09-16T15:00:00Z,20.2N  71.7W,48,0,0,0,48
Hurricane,Jeanne,12,2004-09-16T15:00:00Z,MYEG 235N 758W,0,7,15,3,25
Hurricane,Jeanne,12,2004-09-16T15:00:00Z,21.1N  73.4W,19,15,0,0,34
Hurricane,Jeanne,12,2004-09-16T15:00:00Z,MYAK 241N 776W,0,0,12,8,20
Hurricane,Jeanne,12,2004-09-16T15:00:00Z,22.0N  75.0W,0,22,5,1,28
Hurricane,Jeanne,12,2004-09-16T15:00:00Z,MYNN 251N 775W,0,0,10,9,19
Hurricane,Jeanne,12,2004-09-16T15:00:00Z,MDSD 185N 697W,99,0,0,0,99
Hurricane,Jeanne,12,2004-09-16T15:00:00Z,MYGF 266N 787W,0,0,2,12,14
Hurricane,Jeanne,12,2004-09-16T15:00:00Z,MDCB 176N 714W,4,1,1,1,7
Hurricane,Jeanne,12,2004-09-16T15:00:00Z,MARATHON FL,0,0,0,9,9
Hurricane,Jeanne,12,2004-09-16T15:00:00Z,MTPP 186N 724W,22,1,0,0,23
Hurricane,Jeanne,12,2004-09-16T15:00:00Z,MIAMI FL,0,0,0,11,11
Hurricane,Jeanne,12,2004-09-16T15:00:00Z,MTCA 183N 738W,6,7,1,1,15
Hurricane,Jeanne,12,2004-09-16T15:00:00Z,W PALM BEACH FL,0,0,0,11,11
Hurricane,Jeanne,12,2004-09-16T15:00:00Z,MKJP 179N 768W,0,1,2,4,7
Hurricane,Jeanne,12,2004-09-16T15:00:00Z,FT PIERCE FL,0,0,0,10,10
Hurricane,Jeanne,12,2004-09-16T15:00:00Z,MKJS 185N 779W,0,0,2,5,7
Hurricane,Jeanne,12,2004-09-16T15:00:00Z,COCOA BEACH FL,0,0,0,8,8
Hurricane,Jeanne,12,2004-09-16T15:00:00Z,MUGM 200N 751W,2,16,3,1,22
Hurricane,Jeanne,12,2004-09-16T15:00:00Z,DAYTONA BEACH FL,0,0,0,5,5
Hurricane,Jeanne,12,2004-09-16T15:00:00Z,MUCM 214N 779W,0,1,9,6,16
Hurricane,Jeanne,12,2004-09-16T15:00:00Z,JACKSONVILLE FL,0,0,0,3,3
Hurricane,Jeanne,12,2004-09-16T15:00:00Z,MUCF 221N 805W,0,0,1,7,8
Hurricane,Jeanne,12,2004-09-16T15:00:00Z,KEY WEST FL,0,0,0,6,6
Hurricane,Jeanne,12,2004-09-16T15:00:00Z,MUSN 216N 826W,0,0,0,2,2
Hurricane,Jeanne,12,2004-09-16T15:00:00Z,MARCO ISLAND FL,0,0,0,7,7
Hurricane,Jeanne,12,2004-09-16T15:00:00Z,MUHA 230N 824W,0,0,0,3,3
Hurricane,Jeanne,12,2004-09-16T15:00:00Z,FT MYERS FL,0,0,0,6,6
Hurricane,Jeanne,12,2004-09-16T15:00:00Z,MDPP 198N 707W,61,0,0,0,61
Hurricane,Jeanne,12,2004-09-16T15:00:00Z,VENICE FL,0,0,0,4,4
Hurricane,Jeanne,12,2004-09-16T15:00:00Z,MBJT 215N 712W,33,1,0,0,34
Hurricane,Jeanne,12,2004-09-16T15:00:00Z,TAMPA FL,0,0,0,4,4
Hurricane,Jeanne,12,2004-09-16T15:00:00Z,MYMM 224N 730W,6,23,1,0,30
Hurricane,Jeanne,12,2004-09-16T15:00:00Z,CEDAR KEY FL,0,0,0,2,2
Hurricane,Jeanne,12,2004-09-16T15:00:00Z,MYSM 241N 745W,0,11,11,2,24
Tropical Storm,Jeanne,13,2004-09-16T21:00:00Z,20.4N  72.3W,45,0,0,0,45
Tropical Storm,Jeanne,13,2004-09-16T21:00:00Z,MYNN 251N 775W,0,1,11,8,20
Tropical Storm,Jeanne,13,2004-09-16T21:00:00Z,21.4N  73.9W,20,13,0,1,34
Tropical Storm,Jeanne,13,2004-09-16T21:00:00Z,MYGF 266N 787W,0,0,3,13,16
Tropical Storm,Jeanne,13,2004-09-16T21:00:00Z,22.5N  75.0W,2,24,2,1,29
Tropical Storm,Jeanne,13,2004-09-16T21:00:00Z,MARATHON FL,0,0,0,9,9
Tropical Storm,Jeanne,13,2004-09-16T21:00:00Z,MDSD 185N 697W,99,0,0,0,99
Tropical Storm,Jeanne,13,2004-09-16T21:00:00Z,MIAMI FL,0,0,1,11,12
Tropical Storm,Jeanne,13,2004-09-16T21:00:00Z,MDCB 176N 714W,4,0,1,0,5
Tropical Storm,Jeanne,13,2004-09-16T21:00:00Z,W PALM BEACH FL,0,0,1,12,13
Tropical Storm,Jeanne,13,2004-09-16T21:00:00Z,MTPP 186N 724W,23,0,1,0,24
Tropical Storm,Jeanne,13,2004-09-16T21:00:00Z,FT PIERCE FL,0,0,0,12,12
Tropical Storm,Jeanne,13,2004-09-16T21:00:00Z,MTCA 183N 738W,9,3,1,1,14
Tropical Storm,Jeanne,13,2004-09-16T21:00:00Z,COCOA BEACH FL,0,0,0,10,10
Tropical Storm,Jeanne,13,2004-09-16T21:00:00Z,MKJP 179N 768W,0,0,1,2,3
Tropical Storm,Jeanne,13,2004-09-16T21:00:00Z,DAYTONA BEACH FL,0,0,0,8,8
Tropical Storm,Jeanne,13,2004-09-16T21:00:00Z,MKJS 185N 779W,0,0,1,2,3
Tropical Storm,Jeanne,13,2004-09-16T21:00:00Z,JACKSONVILLE FL,0,0,0,5,5
Tropical Storm,Jeanne,13,2004-09-16T21:00:00Z,MUGM 200N 751W,7,12,1,1,21
Tropical Storm,Jeanne,13,2004-09-16T21:00:00Z,SAVANNAH GA,0,0,0,3,3
Tropical Storm,Jeanne,13,2004-09-16T21:00:00Z,MUCM 214N 779W,0,2,7,5,14
Tropical Storm,Jeanne,13,2004-09-16T21:00:00Z,CHARLESTON SC,0,0,0,3,3
Tropical Storm,Jeanne,13,2004-09-16T21:00:00Z,MUCF 221N 805W,0,0,1,5,6
Tropical Storm,Jeanne,13,2004-09-16T21:00:00Z,MYRTLE BEACH SC,0,0,0,2,2
Tropical Storm,Jeanne,13,2004-09-16T21:00:00Z,MUHA 230N 824W,0,0,0,2,2
Tropical Storm,Jeanne,13,2004-09-16T21:00:00Z,KEY WEST FL,0,0,0,6,6
Tropical Storm,Jeanne,13,2004-09-16T21:00:00Z,MDPP 198N 707W,72,0,0,0,72
Tropical Storm,Jeanne,13,2004-09-16T21:00:00Z,MARCO ISLAND FL,0,0,0,8,8
Tropical Storm,Jeanne,13,2004-09-16T21:00:00Z,MBJT 215N 712W,34,0,0,0,34
Tropical Storm,Jeanne,13,2004-09-16T21:00:00Z,FT MYERS FL,0,0,0,7,7
Tropical Storm,Jeanne,13,2004-09-16T21:00:00Z,MYMM 224N 730W,18,13,0,0,31
Tropical Storm,Jeanne,13,2004-09-16T21:00:00Z,VENICE FL,0,0,0,6,6
Tropical Storm,Jeanne,13,2004-09-16T21:00:00Z,MYSM 241N 745W,0,17,6,2,25
Tropical Storm,Jeanne,13,2004-09-16T21:00:00Z,TAMPA FL,0,0,0,6,6
Tropical Storm,Jeanne,13,2004-09-16T21:00:00Z,MYEG 235N 758W,0,14,9,2,25
Tropical Storm,Jeanne,13,2004-09-16T21:00:00Z,CEDAR KEY FL,0,0,0,4,4
Tropical Storm,Jeanne,13,2004-09-16T21:00:00Z,MYAK 241N 776W,0,2,12,6,20
Tropical Storm,Jeanne,13,2004-09-16T21:00:00Z,ST MARKS FL,0,0,0,2,2
Tropical Storm,Jeanne,14,2004-09-17T03:00:00Z,21.1N  72.4W,43,1,0,0,44
Tropical Storm,Jeanne,14,2004-09-17T03:00:00Z,MARATHON FL,0,0,1,6,7
Tropical Storm,Jeanne,14,2004-09-17T03:00:00Z,22.3N  73.7W,18,11,1,0,30
Tropical Storm,Jeanne,14,2004-09-17T03:00:00Z,MIAMI FL,0,0,1,10,11
Tropical Storm,Jeanne,14,2004-09-17T03:00:00Z,23.6N  74.9W,0,20,4,1,25
Tropical Storm,Jeanne,14,2004-09-17T03:00:00Z,W PALM BEACH FL,0,0,1,11,12
Tropical Storm,Jeanne,14,2004-09-17T03:00:00Z,MDSD 185N 697W,99,0,0,0,99
Tropical Storm,Jeanne,14,2004-09-17T03:00:00Z,FT PIERCE FL,0,0,0,12,12
Tropical Storm,Jeanne,14,2004-09-17T03:00:00Z,MTPP 186N 724W,8,1,0,0,9
Tropical Storm,Jeanne,14,2004-09-17T03:00:00Z,COCOA BEACH FL,0,0,0,11,11
Tropical Storm,Jeanne,14,2004-09-17T03:00:00Z,MTCA 183N 738W,2,1,0,1,4
Tropical Storm,Jeanne,14,2004-09-17T03:00:00Z,DAYTONA BEACH FL,0,0,0,9,9
Tropical Storm,Jeanne,14,2004-09-17T03:00:00Z,MUGM 200N 751W,7,6,1,1,15
Tropical Storm,Jeanne,14,2004-09-17T03:00:00Z,JACKSONVILLE FL,0,0,0,6,6
Tropical Storm,Jeanne,14,2004-09-17T03:00:00Z,MUCM 214N 779W,0,2,5,3,10
Tropical Storm,Jeanne,14,2004-09-17T03:00:00Z,SAVANNAH GA,0,0,0,5,5
Tropical Storm,Jeanne,14,2004-09-17T03:00:00Z,MUCF 221N 805W,0,0,1,3,4
Tropical Storm,Jeanne,14,2004-09-17T03:00:00Z,CHARLESTON SC,0,0,0,5,5
Tropical Storm,Jeanne,14,2004-09-17T03:00:00Z,MDPP 198N 707W,71,0,0,0,71
Tropical Storm,Jeanne,14,2004-09-17T03:00:00Z,MYRTLE BEACH SC,0,0,0,3,3
Tropical Storm,Jeanne,14,2004-09-17T03:00:00Z,MBJT 215N 712W,44,0,0,0,44
Tropical Storm,Jeanne,14,2004-09-17T03:00:00Z,WILMINGTON NC,0,0,0,2,2
Tropical Storm,Jeanne,14,2004-09-17T03:00:00Z,MYMM 224N 730W,25,6,1,0,32
Tropical Storm,Jeanne,14,2004-09-17T03:00:00Z,KEY WEST FL,0,0,0,4,4
Tropical Storm,Jeanne,14,2004-09-17T03:00:00Z,MYSM 241N 745W,0,18,6,1,25
Tropical Storm,Jeanne,14,2004-09-17T03:00:00Z,MARCO ISLAND FL,0,0,0,6,6
Tropical Storm,Jeanne,14,2004-09-17T03:00:00Z,MYEG 235N 758W,0,14,7,2,23
Tropical Storm,Jeanne,14,2004-09-17T03:00:00Z,FT MYERS FL,0,0,0,6,6
Tropical Storm,Jeanne,14,2004-09-17T03:00:00Z,MYAK 241N 776W,0,2,11,5,18
Tropical Storm,Jeanne,14,2004-09-17T03:00:00Z,VENICE FL,0,0,0,5,5
Tropical Storm,Jeanne,14,2004-09-17T03:00:00Z,MYNN 251N 775W,0,1,11,7,19
Tropical Storm,Jeanne,14,2004-09-17T03:00:00Z,TAMPA FL,0,0,0,5,5
Tropical Storm,Jeanne,14,2004-09-17T03:00:00Z,MYGF 266N 787W,0,0,3,13,16
Tropical Storm,Jeanne,14,2004-09-17T03:00:00Z,CEDAR KEY FL,0,0,0,4,4
Tropical Storm,Jeanne,15,2004-09-17T09:00:00Z,21.3N  72.5W,52,0,0,0,52
Tropical Storm,Jeanne,15,2004-09-17T09:00:00Z,MIAMI FL,0,0,1,9,10
Tropical Storm,Jeanne,15,2004-09-17T09:00:00Z,23.0N  74.0W,12,27,0,0,39
Tropical Storm,Jeanne,15,2004-09-17T09:00:00Z,W PALM BEACH FL,0,0,1,10,11
Tropical Storm,Jeanne,15,2004-09-17T09:00:00Z,25.0N  75.0W,0,21,11,0,32
Tropical Storm,Jeanne,15,2004-09-17T09:00:00Z,FT PIERCE FL,0,0,1,10,11
Tropical Storm,Jeanne,15,2004-09-17T09:00:00Z,MDSD 185N 697W,99,0,0,0,99
Tropical Storm,Jeanne,15,2004-09-17T09:00:00Z,COCOA BEACH FL,0,0,0,9,9
Tropical Storm,Jeanne,15,2004-09-17T09:00:00Z,MTPP 186N 724W,11,0,0,0,11
Tropical Storm,Jeanne,15,2004-09-17T09:00:00Z,DAYTONA BEACH FL,0,0,0,7,7
Tropical Storm,Jeanne,15,2004-09-17T09:00:00Z,MTCA 183N 738W,1,0,0,1,2
Tropical Storm,Jeanne,15,2004-09-17T09:00:00Z,JACKSONVILLE FL,0,0,0,4,4
Tropical Storm,Jeanne,15,2004-09-17T09:00:00Z,MUGM 200N 751W,5,7,0,1,13
Tropical Storm,Jeanne,15,2004-09-17T09:00:00Z,SAVANNAH GA,0,0,0,3,3
Tropical Storm,Jeanne,15,2004-09-17T09:00:00Z,MUCM 214N 779W,0,1,3,2,6
Tropical Storm,Jeanne,15,2004-09-17T09:00:00Z,CHARLESTON SC,0,0,0,4,4
Tropical Storm,Jeanne,15,2004-09-17T09:00:00Z,MUCF 221N 805W,0,0,0,2,2
Tropical Storm,Jeanne,15,2004-09-17T09:00:00Z,MYRTLE BEACH SC,0,0,0,3,3
Tropical Storm,Jeanne,15,2004-09-17T09:00:00Z,MDPP 198N 707W,99,0,0,0,99
Tropical Storm,Jeanne,15,2004-09-17T09:00:00Z,WILMINGTON NC,0,0,0,3,3
Tropical Storm,Jeanne,15,2004-09-17T09:00:00Z,MBJT 215N 712W,53,0,0,0,53
Tropical Storm,Jeanne,15,2004-09-17T09:00:00Z,MOREHEAD CITY NC,0,0,0,2,2
Tropical Storm,Jeanne,15,2004-09-17T09:00:00Z,MYMM 224N 730W,37,5,0,0,42
Tropical Storm,Jeanne,15,2004-09-17T09:00:00Z,KEY WEST FL,0,0,0,3,3
Tropical Storm,Jeanne,15,2004-09-17T09:00:00Z,MYSM 241N 745W,1,31,2,0,34
Tropical Storm,Jeanne,15,2004-09-17T09:00:00Z,MARCO ISLAND FL,0,0,0,5,5
Tropical Storm,Jeanne,15,2004-09-17T09:00:00Z,MYEG 235N 758W,0,25,4,0,29
Tropical Storm,Jeanne,15,2004-09-17T09:00:00Z,FT MYERS FL,0,0,0,5,5
Tropical Storm,Jeanne,15,2004-09-17T09:00:00Z,MYAK 241N 776W,0,4,12,3,19
Tropical Storm,Jeanne,15,2004-09-17T09:00:00Z,VENICE FL,0,0,0,3,3
Tropical Storm,Jeanne,15,2004-09-17T09:00:00Z,MYNN 251N 775W,0,2,16,3,21
Tropical Storm,Jeanne,15,2004-09-17T09:00:00Z,TAMPA FL,0,0,0,3,3
Tropical Storm,Jeanne,15,2004-09-17T09:00:00Z,MYGF 266N 787W,0,0,7,10,17
Tropical Storm,Jeanne,15,2004-09-17T09:00:00Z,CEDAR KEY FL,0,0,0,2,2
Tropical Storm,Jeanne,15,2004-09-17T09:00:00Z,MARATHON FL,0,0,0,5,5
Tropical Storm,Jeanne,16,2004-09-17T15:00:00Z,22.2N  73.3W,53,0,0,0,53
Tropical Storm,Jeanne,16,2004-09-17T15:00:00Z,W PALM BEACH FL,0,0,1,8,9
Tropical Storm,Jeanne,16,2004-09-17T15:00:00Z,23.8N  74.0W,22,14,1,0,37
Tropical Storm,Jeanne,16,2004-09-17T15:00:00Z,FT PIERCE FL,0,0,1,7,8
Tropical Storm,Jeanne,16,2004-09-17T15:00:00Z,25.0N  74.6W,2,27,1,1,31
Tropical Storm,Jeanne,16,2004-09-17T15:00:00Z,COCOA BEACH FL,0,0,0,7,7
Tropical Storm,Jeanne,16,2004-09-17T15:00:00Z,MTPP 186N 724W,15,0,0,0,15
Tropical Storm,Jeanne,16,2004-09-17T15:00:00Z,DAYTONA BEACH FL,0,0,0,6,6
Tropical Storm,Jeanne,16,2004-09-17T15:00:00Z,MUGM 200N 751W,9,2,0,0,11
Tropical Storm,Jeanne,16,2004-09-17T15:00:00Z,JACKSONVILLE FL,0,0,0,3,3
Tropical Storm,Jeanne,16,2004-09-17T15:00:00Z,MUCM 214N 779W,0,1,2,2,5
Tropical Storm,Jeanne,16,2004-09-17T15:00:00Z,SAVANNAH GA,0,0,0,3,3
Tropical Storm,Jeanne,16,2004-09-17T15:00:00Z,MDPP 198N 707W,99,0,0,0,99
Tropical Storm,Jeanne,16,2004-09-17T15:00:00Z,CHARLESTON SC,0,0,0,5,5
Tropical Storm,Jeanne,16,2004-09-17T15:00:00Z,MBJT 215N 712W,46,0,0,0,46
Tropical Storm,Jeanne,16,2004-09-17T15:00:00Z,MYRTLE BEACH SC,0,0,0,5,5
Tropical Storm,Jeanne,16,2004-09-17T15:00:00Z,MYMM 224N 730W,52,0,0,0,52
Tropical Storm,Jeanne,16,2004-09-17T15:00:00Z,WILMINGTON NC,0,0,0,5,5
Tropical Storm,Jeanne,16,2004-09-17T15:00:00Z,MYSM 241N 745W,10,23,1,0,34
Tropical Storm,Jeanne,16,2004-09-17T15:00:00Z,MOREHEAD CITY NC,0,0,0,4,4
Tropical Storm,Jeanne,16,2004-09-17T15:00:00Z,MYEG 235N 758W,3,20,2,0,25
Tropical Storm,Jeanne,16,2004-09-17T15:00:00Z,CAPE HATTERAS NC,0,0,0,3,3
Tropical Storm,Jeanne,16,2004-09-17T15:00:00Z,MYAK 241N 776W,0,5,7,4,16
Tropical Storm,Jeanne,16,2004-09-17T15:00:00Z,MARCO ISLAND FL,0,0,0,2,2
Tropical Storm,Jeanne,16,2004-09-17T15:00:00Z,MYNN 251N 775W,0,5,9,4,18
Tropical Storm,Jeanne,16,2004-09-17T15:00:00Z,FT MYERS FL,0,0,0,2,2
Tropical Storm,Jeanne,16,2004-09-17T15:00:00Z,MYGF 266N 787W,0,0,6,8,14
Tropical Storm,Jeanne,16,2004-09-17T15:00:00Z,VENICE FL,0,0,0,2,2
Tropical Storm,Jeanne,16,2004-09-17T15:00:00Z,MARATHON FL,0,0,0,3,3
Tropical Storm,Jeanne,16,2004-09-17T15:00:00Z,TAMPA FL,0,0,0,2,2
Tropical Storm,Jeanne,16,2004-09-17T15:00:00Z,MIAMI FL,0,0,1,6,7
Tropical Depression,Jeanne,17,2004-09-17T21:00:00Z,22.0N  74.0W,57,0,0,0,57
Tropical Depression,Jeanne,17,2004-09-17T21:00:00Z,W PALM BEACH FL,0,0,2,5,7
Tropical Depression,Jeanne,17,2004-09-17T21:00:00Z,23.7N  74.7W,23,15,0,0,38
Tropical Depression,Jeanne,17,2004-09-17T21:00:00Z,FT PIERCE FL,0,0,1,6,7
Tropical Depression,Jeanne,17,2004-09-17T21:00:00Z,25.8N  74.7W,0,21,10,0,31
Tropical Depression,Jeanne,17,2004-09-17T21:00:00Z,COCOA BEACH FL,0,0,1,5,6
Tropical Depression,Jeanne,17,2004-09-17T21:00:00Z,MUGM 200N 751W,13,1,0,1,15
Tropical Depression,Jeanne,17,2004-09-17T21:00:00Z,DAYTONA BEACH FL,0,0,0,5,5
Tropical Depression,Jeanne,17,2004-09-17T21:00:00Z,MUCM 214N 779W,0,3,1,1,5
Tropical Depression,Jeanne,17,2004-09-17T21:00:00Z,JACKSONVILLE FL,0,0,0,4,4
Tropical Depression,Jeanne,17,2004-09-17T21:00:00Z,MDPP 198N 707W,99,0,0,0,99
Tropical Depression,Jeanne,17,2004-09-17T21:00:00Z,SAVANNAH GA,0,0,0,4,4
Tropical Depression,Jeanne,17,2004-09-17T21:00:00Z,MBJT 215N 712W,54,0,0,0,54
Tropical Depression,Jeanne,17,2004-09-17T21:00:00Z,CHARLESTON SC,0,0,0,6,6
Tropical Depression,Jeanne,17,2004-09-17T21:00:00Z,MYMM 224N 730W,50,0,0,0,50
Tropical Depression,Jeanne,17,2004-09-17T21:00:00Z,MYRTLE BEACH SC,0,0,0,7,7
Tropical Depression,Jeanne,17,2004-09-17T21:00:00Z,MYSM 241N 745W,16,19,0,1,36
Tropical Depression,Jeanne,17,2004-09-17T21:00:00Z,WILMINGTON NC,0,0,0,7,7
Tropical Depression,Jeanne,17,2004-09-17T21:00:00Z,MYEG 235N 758W,13,20,0,0,33
Tropical Depression,Jeanne,17,2004-09-17T21:00:00Z,MOREHEAD CITY NC,0,0,0,7,7
Tropical Depression,Jeanne,17,2004-09-17T21:00:00Z,MYAK 241N 776W,0,13,5,0,18
Tropical Depression,Jeanne,17,2004-09-17T21:00:00Z,CAPE HATTERAS NC,0,0,0,5,5
Tropical Depression,Jeanne,17,2004-09-17T21:00:00Z,MYNN 251N 775W,0,11,9,1,21
Tropical Depression,Jeanne,17,2004-09-17T21:00:00Z,NORFOLK VA,0,0,0,2,2
Tropical Depression,Jeanne,17,2004-09-17T21:00:00Z,MYGF 266N 787W,0,1,8,5,14
Tropical Depression,Jeanne,17,2004-09-17T21:00:00Z,FT MYERS FL,0,0,0,2,2
Tropical Depression,Jeanne,17,2004-09-17T21:00:00Z,MIAMI FL,0,0,1,4,5
Tropical Storm,Jeanne,18,2004-09-18T03:00:00Z,22.2N  73.5W,56,0,0,0,56
Tropical Storm,Jeanne,18,2004-09-18T03:00:00Z,MIAMI FL,0,0,1,2,3
Tropical Storm,Jeanne,18,2004-09-18T03:00:00Z,24.3N  73.9W,20,18,0,0,38
Tropical Storm,Jeanne,18,2004-09-18T03:00:00Z,W PALM BEACH FL,0,0,1,4,5
Tropical Storm,Jeanne,18,2004-09-18T03:00:00Z,26.3N  74.0W,0,22,6,1,29
Tropical Storm,Jeanne,18,2004-09-18T03:00:00Z,FT PIERCE FL,0,0,1,4,5
Tropical Storm,Jeanne,18,2004-09-18T03:00:00Z,MUGM 200N 751W,12,1,0,0,13
Tropical Storm,Jeanne,18,2004-09-18T03:00:00Z,COCOA BEACH FL,0,0,0,4,4
Tropical Storm,Jeanne,18,2004-09-18T03:00:00Z,MDPP 198N 707W,1,1,0,0,2
Tropical Storm,Jeanne,18,2004-09-18T03:00:00Z,DAYTONA BEACH FL,0,0,0,3,3
Tropical Storm,Jeanne,18,2004-09-18T03:00:00Z,MBJT 215N 712W,38,0,0,0,38
Tropical Storm,Jeanne,18,2004-09-18T03:00:00Z,JACKSONVILLE FL,0,0,0,2,2
Tropical Storm,Jeanne,18,2004-09-18T03:00:00Z,MYMM 224N 730W,52,0,0,0,52
Tropical Storm,Jeanne,18,2004-09-18T03:00:00Z,SAVANNAH GA,0,0,0,2,2
Tropical Storm,Jeanne,18,2004-09-18T03:00:00Z,MYSM 241N 745W,20,18,0,0,38
Tropical Storm,Jeanne,18,2004-09-18T03:00:00Z,CHARLESTON SC,0,0,0,3,3
Tropical Storm,Jeanne,18,2004-09-18T03:00:00Z,MYEG 235N 758W,10,16,1,0,27
Tropical Storm,Jeanne,18,2004-09-18T03:00:00Z,MYRTLE BEACH SC,0,0,0,4,4
Tropical Storm,Jeanne,18,2004-09-18T03:00:00Z,MYAK 241N 776W,0,6,4,1,11
Tropical Storm,Jeanne,18,2004-09-18T03:00:00Z,WILMINGTON NC,0,0,0,4,4
Tropical Storm,Jeanne,18,2004-09-18T03:00:00Z,MYNN 251N 775W,0,6,6,2,14
Tropical Storm,Jeanne,18,2004-09-18T03:00:00Z,MOREHEAD CITY NC,0,0,0,4,4
Tropical Storm,Jeanne,18,2004-09-18T03:00:00Z,MYGF 266N 787W,0,0,5,5,10
Tropical Storm,Jeanne,18,2004-09-18T03:00:00Z,CAPE HATTERAS NC,0,0,0,4,4
Tropical Storm,Jeanne,19,2004-09-18T09:00:00Z,22.4N  73.4W,66,0,0,0,66
Tropical Storm,Jeanne,19,2004-09-18T09:00:00Z,MYGF 266N 787W,0,0,3,7,10
Tropical Storm,Jeanne,19,2004-09-18T09:00:00Z,23.8N  73.7W,29,5,0,1,35
Tropical Storm,Jeanne,19,2004-09-18T09:00:00Z,MIAMI FL,0,0,0,4,4
Tropical Storm,Jeanne,19,2004-09-18T09:00:00Z,25.5N  73.7W,3,17,4,2,26
Tropical Storm,Jeanne,19,2004-09-18T09:00:00Z,W PALM BEACH FL,0,0,1,4,5
Tropical Storm,Jeanne,19,2004-09-18T09:00:00Z,MTPP 186N 724W,1,0,0,1,2
Tropical Storm,Jeanne,19,2004-09-18T09:00:00Z,FT PIERCE FL,0,0,0,5,5
Tropical Storm,Jeanne,19,2004-09-18T09:00:00Z,MUGM 200N 751W,11,1,0,0,12
Tropical Storm,Jeanne,19,2004-09-18T09:00:00Z,COCOA BEACH FL,0,0,0,4,4
Tropical Storm,Jeanne,19,2004-09-18T09:00:00Z,MUCM 214N 779W,0,0,1,1,2
Tropical Storm,Jeanne,19,2004-09-18T09:00:00Z,DAYTONA BEACH FL,0,0,0,3,3
Tropical Storm,Jeanne,19,2004-09-18T09:00:00Z,MDPP 198N 707W,0,1,1,1,3
Tropical Storm,Jeanne,19,2004-09-18T09:00:00Z,JACKSONVILLE FL,0,0,0,2,2
Tropical Storm,Jeanne,19,2004-09-18T09:00:00Z,MBJT 215N 712W,37,0,0,0,37
Tropical Storm,Jeanne,19,2004-09-18T09:00:00Z,SAVANNAH GA,0,0,0,2,2
Tropical Storm,Jeanne,19,2004-09-18T09:00:00Z,MYMM 224N 730W,69,0,0,0,69
Tropical Storm,Jeanne,19,2004-09-18T09:00:00Z,CHARLESTON SC,0,0,0,2,2
Tropical Storm,Jeanne,19,2004-09-18T09:00:00Z,MYSM 241N 745W,18,11,1,0,30
Tropical Storm,Jeanne,19,2004-09-18T09:00:00Z,MYRTLE BEACH SC,0,0,0,2,2
Tropical Storm,Jeanne,19,2004-09-18T09:00:00Z,MYEG 235N 758W,7,13,1,1,22
Tropical Storm,Jeanne,19,2004-09-18T09:00:00Z,WILMINGTON NC,0,0,0,2,2
Tropical Storm,Jeanne,19,2004-09-18T09:00:00Z,MYAK 241N 776W,0,3,5,3,11
Tropical Storm,Jeanne,19,2004-09-18T09:00:00Z,MOREHEAD CITY NC,0,0,0,2,2
Tropical Storm,Jeanne,19,2004-09-18T09:00:00Z,MYNN 251N 775W,0,3,7,3,13
Tropical Storm,Jeanne,20,2004-09-18T15:00:00Z,23.5N  73.5W,52,0,0,0,52
Tropical Storm,Jeanne,20,2004-09-18T15:00:00Z,W PALM BEACH FL,0,0,1,4,5
Tropical Storm,Jeanne,20,2004-09-18T15:00:00Z,25.0N  73.5W,25,6,1,0,32
Tropical Storm,Jeanne,20,2004-09-18T15:00:00Z,FT PIERCE FL,0,0,1,4,5
Tropical Storm,Jeanne,20,2004-09-18T15:00:00Z,26.5N  73.5W,3,18,3,1,25
Tropical Storm,Jeanne,20,2004-09-18T15:00:00Z,COCOA BEACH FL,0,0,0,4,4
Tropical Storm,Jeanne,20,2004-09-18T15:00:00Z,MBJT 215N 712W,37,0,0,0,37
Tropical Storm,Jeanne,20,2004-09-18T15:00:00Z,DAYTONA BEACH FL,0,0,0,3,3
Tropical Storm,Jeanne,20,2004-09-18T15:00:00Z,MYMM 224N 730W,85,0,0,0,85
Tropical Storm,Jeanne,20,2004-09-18T15:00:00Z,JACKSONVILLE FL,0,0,0,2,2
Tropical Storm,Jeanne,20,2004-09-18T15:00:00Z,MYSM 241N 745W,36,0,0,1,37
Tropical Storm,Jeanne,20,2004-09-18T15:00:00Z,SAVANNAH GA,0,0,0,2,2
Tropical Storm,Jeanne,20,2004-09-18T15:00:00Z,MYEG 235N 758W,16,3,1,1,21
Tropical Storm,Jeanne,20,2004-09-18T15:00:00Z,CHARLESTON SC,0,0,0,3,3
Tropical Storm,Jeanne,20,2004-09-18T15:00:00Z,MYAK 241N 776W,0,4,3,2,9
Tropical Storm,Jeanne,20,2004-09-18T15:00:00Z,MYRTLE BEACH SC,0,0,0,3,3
Tropical Storm,Jeanne,20,2004-09-18T15:00:00Z,MYNN 251N 775W,0,6,3,3,12
Tropical Storm,Jeanne,20,2004-09-18T15:00:00Z,WILMINGTON NC,0,0,0,3,3
Tropical Storm,Jeanne,20,2004-09-18T15:00:00Z,MYGF 266N 787W,0,1,3,5,9
Tropical Storm,Jeanne,20,2004-09-18T15:00:00Z,MOREHEAD CITY NC,0,0,0,2,2
Tropical Storm,Jeanne,20,2004-09-18T15:00:00Z,MIAMI FL,0,0,0,3,3
Tropical Storm,Jeanne,20,2004-09-18T15:00:00Z,CAPE HATTERAS NC,0,0,0,2,2
Tropical Storm,Jeanne,21,2004-09-18T21:00:00Z,24.1N  72.6W,68,0,0,0,68
Tropical Storm,Jeanne,21,2004-09-18T21:00:00Z,W PALM BEACH FL,0,0,0,2,2
Tropical Storm,Jeanne,21,2004-09-18T21:00:00Z,25.7N  72.5W,30,5,0,0,35
Tropical Storm,Jeanne,21,2004-09-18T21:00:00Z,FT PIERCE FL,0,0,0,2,2
Tropical Storm,Jeanne,21,2004-09-18T21:00:00Z,27.0N  72.5W,7,16,2,1,26
Tropical Storm,Jeanne,21,2004-09-18T21:00:00Z,COCOA BEACH FL,0,0,0,2,2
Tropical Storm,Jeanne,21,2004-09-18T21:00:00Z,MDPP 198N 707W,0,0,0,2,2
Tropical Storm,Jeanne,21,2004-09-18T21:00:00Z,DAYTONA BEACH FL,0,0,0,2,2
Tropical Storm,Jeanne,21,2004-09-18T21:00:00Z,MBJT 215N 712W,99,0,0,0,99
Tropical Storm,Jeanne,21,2004-09-18T21:00:00Z,SAVANNAH GA,0,0,0,2,2
Tropical Storm,Jeanne,21,2004-09-18T21:00:00Z,MYMM 224N 730W,99,0,0,0,99
Tropical Storm,Jeanne,21,2004-09-18T21:00:00Z,CHARLESTON SC,0,0,0,3,3
Tropical Storm,Jeanne,21,2004-09-18T21:00:00Z,MYSM 241N 745W,26,2,1,0,29
Tropical Storm,Jeanne,21,2004-09-18T21:00:00Z,MYRTLE BEACH SC,0,0,0,4,4
Tropical Storm,Jeanne,21,2004-09-18T21:00:00Z,MYEG 235N 758W,2,6,2,1,11
Tropical Storm,Jeanne,21,2004-09-18T21:00:00Z,WILMINGTON NC,0,0,0,4,4
Tropical Storm,Jeanne,21,2004-09-18T21:00:00Z,MYAK 241N 776W,0,0,2,2,4
Tropical Storm,Jeanne,21,2004-09-18T21:00:00Z,MOREHEAD CITY NC,0,0,0,4,4
Tropical Storm,Jeanne,21,2004-09-18T21:00:00Z,MYNN 251N 775W,0,1,3,2,6
Tropical Storm,Jeanne,21,2004-09-18T21:00:00Z,CAPE HATTERAS NC,0,0,0,3,3
Tropical Storm,Jeanne,21,2004-09-18T21:00:00Z,MYGF 266N 787W,0,0,1,4,5
Tropical Storm,Jeanne,22,2004-09-19T03:00:00Z,24.8N  72.5W,59,0,0,0,59
Tropical Storm,Jeanne,22,2004-09-19T03:00:00Z,MYAK 241N 776W,0,0,0,2,2
Tropical Storm,Jeanne,22,2004-09-19T03:00:00Z,26.3N  72.2W,26,10,0,0,36
Tropical Storm,Jeanne,22,2004-09-19T03:00:00Z,MYNN 251N 775W,0,0,1,3,4
Tropical Storm,Jeanne,22,2004-09-19T03:00:00Z,27.4N  71.8W,5,18,1,1,25
Tropical Storm,Jeanne,22,2004-09-19T03:00:00Z,MYGF 266N 787W,0,0,0,3,3
Tropical Storm,Jeanne,22,2004-09-19T03:00:00Z,MDPP 198N 707W,0,0,0,2,2
Tropical Storm,Jeanne,22,2004-09-19T03:00:00Z,CHARLESTON SC,0,0,0,2,2
Tropical Storm,Jeanne,22,2004-09-19T03:00:00Z,MBJT 215N 712W,40,0,0,0,40
Tropical Storm,Jeanne,22,2004-09-19T03:00:00Z,MYRTLE BEACH SC,0,0,0,3,3
Tropical Storm,Jeanne,22,2004-09-19T03:00:00Z,MYMM 224N 730W,99,0,0,0,99
Tropical Storm,Jeanne,22,2004-09-19T03:00:00Z,WILMINGTON NC,0,0,0,3,3
Tropical Storm,Jeanne,22,2004-09-19T03:00:00Z,MYSM 241N 745W,22,2,0,0,24
Tropical Storm,Jeanne,22,2004-09-19T03:00:00Z,MOREHEAD CITY NC,0,0,0,3,3
Tropical Storm,Jeanne,22,2004-09-19T03:00:00Z,MYEG 235N 758W,1,2,1,2,6
Tropical Storm,Jeanne,22,2004-09-19T03:00:00Z,CAPE HATTERAS NC,0,0,0,3,3
Tropical Storm,Jeanne,23,2004-09-19T09:00:00Z,25.5N  72.2W,43,0,0,0,43
Tropical Storm,Jeanne,23,2004-09-19T09:00:00Z,MYNN 251N 775W,0,0,0,2,2
Tropical Storm,Jeanne,23,2004-09-19T09:00:00Z,27.0N  71.7W,14,10,1,1,26
Tropical Storm,Jeanne,23,2004-09-19T09:00:00Z,MYGF 266N 787W,0,0,0,2,2
Tropical Storm,Jeanne,23,2004-09-19T09:00:00Z,28.0N  70.5W,0,13,4,2,19
Tropical Storm,Jeanne,23,2004-09-19T09:00:00Z,CHARLESTON SC,0,0,0,2,2
Tropical Storm,Jeanne,23,2004-09-19T09:00:00Z,MDPP 198N 707W,0,0,0,2,2
Tropical Storm,Jeanne,23,2004-09-19T09:00:00Z,MYRTLE BEACH SC,0,0,0,2,2
Tropical Storm,Jeanne,23,2004-09-19T09:00:00Z,MBJT 215N 712W,1,0,0,4,5
Tropical Storm,Jeanne,23,2004-09-19T09:00:00Z,WILMINGTON NC,0,0,0,3,3
Tropical Storm,Jeanne,23,2004-09-19T09:00:00Z,MYMM 224N 730W,99,0,0,0,99
Tropical Storm,Jeanne,23,2004-09-19T09:00:00Z,MOREHEAD CITY NC,0,0,1,3,4
Tropical Storm,Jeanne,23,2004-09-19T09:00:00Z,MYSM 241N 745W,15,0,0,1,16
Tropical Storm,Jeanne,23,2004-09-19T09:00:00Z,CAPE HATTERAS NC,0,0,1,3,4
Tropical Storm,Jeanne,23,2004-09-19T09:00:00Z,MYEG 235N 758W,0,0,0,3,3
Tropical Storm,Jeanne,23,2004-09-19T09:00:00Z,NORFOLK VA,0,0,0,2,2
Tropical Storm,Jeanne,24,2004-09-19T15:00:00Z,26.5N  71.5W,34,0,1,0,35
Tropical Storm,Jeanne,24,2004-09-19T15:00:00Z,MYEG 235N 758W,0,0,1,2,3
Tropical Storm,Jeanne,24,2004-09-19T15:00:00Z,27.5N  70.5W,16,6,1,1,24
Tropical Storm,Jeanne,24,2004-09-19T15:00:00Z,MYAK 241N 776W,0,0,0,2,2
Tropical Storm,Jeanne,24,2004-09-19T15:00:00Z,27.5N  70.0W,11,8,2,1,22
Tropical Storm,Jeanne,24,2004-09-19T15:00:00Z,MYNN 251N 775W,0,0,0,3,3
Tropical Storm,Jeanne,24,2004-09-19T15:00:00Z,MDSD 185N 697W,0,0,0,2,2
Tropical Storm,Jeanne,24,2004-09-19T15:00:00Z,MYGF 266N 787W,0,0,0,2,2
Tropical Storm,Jeanne,24,2004-09-19T15:00:00Z,MDPP 198N 707W,0,0,0,3,3
Tropical Storm,Jeanne,24,2004-09-19T15:00:00Z,MYRTLE BEACH SC,0,0,0,2,2
Tropical Storm,Jeanne,24,2004-09-19T15:00:00Z,MBJT 215N 712W,0,0,1,5,6
Tropical Storm,Jeanne,24,2004-09-19T15:00:00Z,WILMINGTON NC,0,0,0,2,2
Tropical Storm,Jeanne,24,2004-09-19T15:00:00Z,MYMM 224N 730W,79,0,0,0,79
Tropical Storm,Jeanne,24,2004-09-19T15:00:00Z,MOREHEAD CITY NC,0,0,0,3,3
Tropical Storm,Jeanne,24,2004-09-19T15:00:00Z,MYSM 241N 745W,22,0,0,1,23
Tropical Storm,Jeanne,24,2004-09-19T15:00:00Z,CAPE HATTERAS NC,0,0,0,2,2
Tropical Storm,Jeanne,25,2004-09-19T21:00:00Z,26.7N  71.2W,33,0,1,0,34
Tropical Storm,Jeanne,25,2004-09-19T21:00:00Z,MDPP 198N 707W,0,0,1,5,6
Tropical Storm,Jeanne,25,2004-09-19T21:00:00Z,27.3N  70.2W,11,8,2,2,23
Tropical Storm,Jeanne,25,2004-09-19T21:00:00Z,MBJT 215N 712W,0,1,4,5,10
Tropical Storm,Jeanne,25,2004-09-19T21:00:00Z,27.2N  69.1W,2,8,5,4,19
Tropical Storm,Jeanne,25,2004-09-19T21:00:00Z,MYMM 224N 730W,0,1,2,4,7
Tropical Storm,Jeanne,25,2004-09-19T21:00:00Z,TJPS 180N 666W,0,0,0,2,2
Tropical Storm,Jeanne,25,2004-09-19T21:00:00Z,MYSM 241N 745W,0,0,1,4,5
Tropical Storm,Jeanne,25,2004-09-19T21:00:00Z,MDSD 185N 697W,0,0,0,4,4
Tropical Storm,Jeanne,25,2004-09-19T21:00:00Z,MYEG 235N 758W,0,0,0,2,2
Tropical Storm,Jeanne,25,2004-09-19T21:00:00Z,MDCB 176N 714W,0,0,0,2,2
Tropical Storm,Jeanne,25,2004-09-19T21:00:00Z,SAN JUAN PR,0,0,0,2,2
Tropical Storm,Jeanne,25,2004-09-19T21:00:00Z,MTPP 186N 724W,0,0,0,2,2
Tropical Storm,Jeanne,25,2004-09-19T21:00:00Z,PONCE PR,0,0,0,2,2
Tropical Storm,Jeanne,25,2004-09-19T21:00:00Z,TJSJ 184N 661W,0,0,0,2,2
Tropical Storm,Jeanne,26,2004-09-20T03:00:00Z,27.0N  71.0W,41,1,0,0,42
Tropical Storm,Jeanne,26,2004-09-20T03:00:00Z,MDPP 198N 707W,0,0,2,4,6
Tropical Storm,Jeanne,26,2004-09-20T03:00:00Z,27.3N  70.0W,13,7,3,1,24
Tropical Storm,Jeanne,26,2004-09-20T03:00:00Z,MBJT 215N 712W,0,2,5,3,10
Tropical Storm,Jeanne,26,2004-09-20T03:00:00Z,27.0N  69.0W,1,8,7,3,19
Tropical Storm,Jeanne,26,2004-09-20T03:00:00Z,MYMM 224N 730W,0,1,3,3,7
Tropical Storm,Jeanne,26,2004-09-20T03:00:00Z,TJPS 180N 666W,0,0,0,2,2
Tropical Storm,Jeanne,26,2004-09-20T03:00:00Z,MYSM 241N 745W,0,0,1,2,3
Tropical Storm,Jeanne,26,2004-09-20T03:00:00Z,MDSD 185N 697W,0,0,1,3,4
Tropical Storm,Jeanne,26,2004-09-20T03:00:00Z,SAN JUAN PR,0,0,0,2,2
Tropical Storm,Jeanne,26,2004-09-20T03:00:00Z,TJSJ 184N 661W,0,0,0,2,2
Tropical Storm,Jeanne,26,2004-09-20T03:00:00Z,PONCE PR,0,0,0,2,2
Tropical Storm,Jeanne,27,2004-09-20T09:00:00Z,27.3N  70.5W,37,0,1,0,38
Tropical Storm,Jeanne,27,2004-09-20T09:00:00Z,MDPP 198N 707W,0,0,1,4,5
Tropical Storm,Jeanne,27,2004-09-20T09:00:00Z,27.3N  69.5W,14,6,2,1,23
Tropical Storm,Jeanne,27,2004-09-20T09:00:00Z,MBJT 215N 712W,0,1,4,4,9
Tropical Storm,Jeanne,27,2004-09-20T09:00:00Z,27.0N  68.7W,3,9,4,3,19
Tropical Storm,Jeanne,27,2004-09-20T09:00:00Z,MYMM 224N 730W,0,1,3,3,7
Tropical Storm,Jeanne,27,2004-09-20T09:00:00Z,TJPS 180N 666W,0,0,0,2,2
Tropical Storm,Jeanne,27,2004-09-20T09:00:00Z,MYSM 241N 745W,0,0,1,3,4
Tropical Storm,Jeanne,27,2004-09-20T09:00:00Z,MDSD 185N 697W,0,0,0,3,3
Tropical Storm,Jeanne,27,2004-09-20T09:00:00Z,SAN JUAN PR,0,0,0,2,2
Tropical Storm,Jeanne,27,2004-09-20T09:00:00Z,MTPP 186N 724W,0,0,0,2,2
Tropical Storm,Jeanne,27,2004-09-20T09:00:00Z,PONCE PR,0,0,0,2,2
Tropical Storm,Jeanne,27,2004-09-20T09:00:00Z,TJSJ 184N 661W,0,0,0,2,2
Tropical Storm,Jeanne,28,2004-09-20T15:00:00Z,27.6N  70.3W,36,1,0,0,37
Tropical Storm,Jeanne,28,2004-09-20T15:00:00Z,MUGM 200N 751W,0,0,0,3,3
Tropical Storm,Jeanne,28,2004-09-20T15:00:00Z,27.5N  69.4W,16,3,2,2,23
Tropical Storm,Jeanne,28,2004-09-20T15:00:00Z,MDPP 198N 707W,0,0,1,5,6
Tropical Storm,Jeanne,28,2004-09-20T15:00:00Z,27.0N  69.0W,11,5,3,2,21
Tropical Storm,Jeanne,28,2004-09-20T15:00:00Z,MBJT 215N 712W,0,1,3,6,10
Tropical Storm,Jeanne,28,2004-09-20T15:00:00Z,MDSD 185N 697W,0,0,0,3,3
Tropical Storm,Jeanne,28,2004-09-20T15:00:00Z,MYMM 224N 730W,0,1,3,6,10
Tropical Storm,Jeanne,28,2004-09-20T15:00:00Z,MDCB 176N 714W,0,0,0,2,2
Tropical Storm,Jeanne,28,2004-09-20T15:00:00Z,MYSM 241N 745W,0,0,3,5,8
Tropical Storm,Jeanne,28,2004-09-20T15:00:00Z,MTPP 186N 724W,0,0,0,4,4
Tropical Storm,Jeanne,28,2004-09-20T15:00:00Z,MYEG 235N 758W,0,0,0,4,4
Tropical Storm,Jeanne,28,2004-09-20T15:00:00Z,MTCA 183N 738W,0,0,0,2,2
Tropical Storm,Jeanne,28,2004-09-20T15:00:00Z,BERMUDA,0,0,0,3,3
Hurricane,Jeanne,29,2004-09-20T21:00:00Z,27.7N  69.9W,30,1,0,0,31
Hurricane,Jeanne,29,2004-09-20T21:00:00Z,MDPP 198N 707W,0,0,0,4,4
Hurricane,Jeanne,29,2004-09-20T21:00:00Z,27.6N  69.2W,22,2,1,1,26
Hurricane,Jeanne,29,2004-09-20T21:00:00Z,MBJT 215N 712W,0,0,2,6,8
Hurricane,Jeanne,29,2004-09-20T21:00:00Z,27.2N  68.8W,17,3,1,2,23
Hurricane,Jeanne,29,2004-09-20T21:00:00Z,MYMM 224N 730W,0,0,3,6,9
Hurricane,Jeanne,29,2004-09-20T21:00:00Z,MDSD 185N 697W,0,0,0,2,2
Hurricane,Jeanne,29,2004-09-20T21:00:00Z,MYSM 241N 745W,0,1,2,5,8
Hurricane,Jeanne,29,2004-09-20T21:00:00Z,MTPP 186N 724W,0,0,0,2,2
Hurricane,Jeanne,29,2004-09-20T21:00:00Z,MYEG 235N 758W,0,0,1,4,5
Hurricane,Jeanne,29,2004-09-20T21:00:00Z,MTCA 183N 738W,0,0,0,2,2
Hurricane,Jeanne,29,2004-09-20T21:00:00Z,MYAK 241N 776W,0,0,0,2,2
Hurricane,Jeanne,29,2004-09-20T21:00:00Z,MUGM 200N 751W,0,0,0,3,3
Hurricane,Jeanne,29,2004-09-20T21:00:00Z,MYNN 251N 775W,0,0,0,3,3
Hurricane,Jeanne,29,2004-09-20T21:00:00Z,MUCM 214N 779W,0,0,0,2,2
Hurricane,Jeanne,29,2004-09-20T21:00:00Z,BERMUDA,0,0,1,4,5
Hurricane,Jeanne,30,2004-09-21T03:00:00Z,27.3N  69.5W,99,0,0,0,99
Hurricane,Jeanne,30,2004-09-21T03:00:00Z,MYEG 235N 758W,0,0,2,5,7
Hurricane,Jeanne,30,2004-09-21T03:00:00Z,26.7N  69.4W,50,0,0,0,50
Hurricane,Jeanne,30,2004-09-21T03:00:00Z,MYAK 241N 776W,0,0,1,4,5
Hurricane,Jeanne,30,2004-09-21T03:00:00Z,26.3N  69.7W,38,1,0,0,39
Hurricane,Jeanne,30,2004-09-21T03:00:00Z,MYNN 251N 775W,0,0,1,5,6
Hurricane,Jeanne,30,2004-09-21T03:00:00Z,MUGM 200N 751W,0,0,0,2,2
Hurricane,Jeanne,30,2004-09-21T03:00:00Z,MYGF 266N 787W,0,0,0,3,3
Hurricane,Jeanne,30,2004-09-21T03:00:00Z,MUCM 214N 779W,0,0,0,2,2
Hurricane,Jeanne,30,2004-09-21T03:00:00Z,BERMUDA,0,0,1,3,4
Hurricane,Jeanne,30,2004-09-21T03:00:00Z,MBJT 215N 712W,0,0,1,3,4
Hurricane,Jeanne,30,2004-09-21T03:00:00Z,MIAMI FL,0,0,0,2,2
Hurricane,Jeanne,30,2004-09-21T03:00:00Z,MYMM 224N 730W,0,0,2,5,7
Hurricane,Jeanne,30,2004-09-21T03:00:00Z,W PALM BEACH FL,0,0,0,2,2
Hurricane,Jeanne,30,2004-09-21T03:00:00Z,MYSM 241N 745W,0,1,4,6,11
Hurricane,Jeanne,31,2004-09-21T09:00:00Z,27.1N  69.3W,99,0,0,0,99
Hurricane,Jeanne,31,2004-09-21T09:00:00Z,MYAK 241N 776W,0,0,1,5,6
Hurricane,Jeanne,31,2004-09-21T09:00:00Z,26.5N  69.5W,49,0,0,0,49
Hurricane,Jeanne,31,2004-09-21T09:00:00Z,MYNN 251N 775W,0,0,1,5,6
Hurricane,Jeanne,31,2004-09-21T09:00:00Z,26.3N  70.0W,55,0,0,0,55
Hurricane,Jeanne,31,2004-09-21T09:00:00Z,MYGF 266N 787W,0,0,0,4,4
Hurricane,Jeanne,31,2004-09-21T09:00:00Z,MUGM 200N 751W,0,0,0,2,2
Hurricane,Jeanne,31,2004-09-21T09:00:00Z,BERMUDA,0,0,1,2,3
Hurricane,Jeanne,31,2004-09-21T09:00:00Z,MUCM 214N 779W,0,0,0,2,2
Hurricane,Jeanne,31,2004-09-21T09:00:00Z,MARATHON FL,0,0,0,2,2
Hurricane,Jeanne,31,2004-09-21T09:00:00Z,MBJT 215N 712W,0,0,0,4,4
Hurricane,Jeanne,31,2004-09-21T09:00:00Z,MIAMI FL,0,0,0,2,2
Hurricane,Jeanne,31,2004-09-21T09:00:00Z,MYMM 224N 730W,0,0,2,5,7
Hurricane,Jeanne,31,2004-09-21T09:00:00Z,W PALM BEACH FL,0,0,0,2,2
Hurricane,Jeanne,31,2004-09-21T09:00:00Z,MYSM 241N 745W,0,1,4,6,11
Hurricane,Jeanne,31,2004-09-21T09:00:00Z,FT PIERCE FL,0,0,0,2,2
Hurricane,Jeanne,31,2004-09-21T09:00:00Z,MYEG 235N 758W,0,0,2,6,8
Hurricane,Jeanne,31,2004-09-21T09:00:00Z,COCOA BEACH FL,0,0,0,2,2
Hurricane,Jeanne,32,2004-09-21T15:00:00Z,26.6N  69.4W,99,0,0,0,99
Hurricane,Jeanne,32,2004-09-21T15:00:00Z,MYGF 266N 787W,0,0,0,5,5
Hurricane,Jeanne,32,2004-09-21T15:00:00Z,26.4N  69.9W,79,0,0,0,79
Hurricane,Jeanne,32,2004-09-21T15:00:00Z,MIAMI FL,0,0,0,2,2
Hurricane,Jeanne,32,2004-09-21T15:00:00Z,26.4N  70.7W,64,0,0,0,64
Hurricane,Jeanne,32,2004-09-21T15:00:00Z,W PALM BEACH FL,0,0,0,3,3
Hurricane,Jeanne,32,2004-09-21T15:00:00Z,MDPP 198N 707W,0,0,0,3,3
Hurricane,Jeanne,32,2004-09-21T15:00:00Z,FT PIERCE FL,0,0,0,3,3
Hurricane,Jeanne,32,2004-09-21T15:00:00Z,MBJT 215N 712W,0,0,2,5,7
Hurricane,Jeanne,32,2004-09-21T15:00:00Z,COCOA BEACH FL,0,0,0,3,3
Hurricane,Jeanne,32,2004-09-21T15:00:00Z,MYMM 224N 730W,0,1,2,5,8
Hurricane,Jeanne,32,2004-09-21T15:00:00Z,DAYTONA BEACH FL,0,0,0,2,2
Hurricane,Jeanne,32,2004-09-21T15:00:00Z,MYSM 241N 745W,0,1,4,6,11
Hurricane,Jeanne,32,2004-09-21T15:00:00Z,JACKSONVILLE FL,0,0,0,2,2
Hurricane,Jeanne,32,2004-09-21T15:00:00Z,MYEG 235N 758W,0,0,1,5,6
Hurricane,Jeanne,32,2004-09-21T15:00:00Z,CHARLESTON SC,0,0,0,2,2
Hurricane,Jeanne,32,2004-09-21T15:00:00Z,MYAK 241N 776W,0,0,0,4,4
Hurricane,Jeanne,32,2004-09-21T15:00:00Z,MYRTLE BEACH SC,0,0,0,2,2
Hurricane,Jeanne,32,2004-09-21T15:00:00Z,MYNN 251N 775W,0,0,1,5,6
Hurricane,Jeanne,33,2004-09-21T21:00:00Z,26.5N  68.7W,99,0,0,0,99
Hurricane,Jeanne,33,2004-09-21T21:00:00Z,MYNN 251N 775W,0,0,0,4,4
Hurricane,Jeanne,33,2004-09-21T21:00:00Z,26.2N  69.0W,69,0,0,0,69
Hurricane,Jeanne,33,2004-09-21T21:00:00Z,MYGF 266N 787W,0,0,0,3,3
Hurricane,Jeanne,33,2004-09-21T21:00:00Z,26.4N  69.6W,85,0,0,0,85
Hurricane,Jeanne,33,2004-09-21T21:00:00Z,W PALM BEACH FL,0,0,0,2,2
Hurricane,Jeanne,33,2004-09-21T21:00:00Z,MDPP 198N 707W,0,0,0,2,2
Hurricane,Jeanne,33,2004-09-21T21:00:00Z,FT PIERCE FL,0,0,0,2,2
Hurricane,Jeanne,33,2004-09-21T21:00:00Z,MBJT 215N 712W,0,0,2,4,6
Hurricane,Jeanne,33,2004-09-21T21:00:00Z,COCOA BEACH FL,0,0,0,2,2
Hurricane,Jeanne,33,2004-09-21T21:00:00Z,MYMM 224N 730W,0,0,2,4,6
Hurricane,Jeanne,33,2004-09-21T21:00:00Z,CHARLESTON SC,0,0,0,2,2
Hurricane,Jeanne,33,2004-09-21T21:00:00Z,MYSM 241N 745W,0,0,3,5,8
Hurricane,Jeanne,33,2004-09-21T21:00:00Z,MYRTLE BEACH SC,0,0,0,2,2
Hurricane,Jeanne,33,2004-09-21T21:00:00Z,MYEG 235N 758W,0,0,0,4,4
Hurricane,Jeanne,33,2004-09-21T21:00:00Z,WILMINGTON NC,0,0,0,2,2
Hurricane,Jeanne,33,2004-09-21T21:00:00Z,MYAK 241N 776W,0,0,0,2,2
Hurricane,Jeanne,33,2004-09-21T21:00:00Z,MOREHEAD CITY NC,0,0,0,2,2
Hurricane,Jeanne,34,2004-09-22T03:00:00Z,26.5N  69.0W,99,0,0,0,99
Hurricane,Jeanne,34,2004-09-22T03:00:00Z,MYAK 241N 776W,0,0,0,3,3
Hurricane,Jeanne,34,2004-09-22T03:00:00Z,26.5N  69.5W,99,0,0,0,99
Hurricane,Jeanne,34,2004-09-22T03:00:00Z,MYNN 251N 775W,0,0,0,4,4
Hurricane,Jeanne,34,2004-09-22T03:00:00Z,26.6N  70.5W,58,0,0,0,58
Hurricane,Jeanne,34,2004-09-22T03:00:00Z,MYGF 266N 787W,0,0,0,3,3
Hurricane,Jeanne,34,2004-09-22T03:00:00Z,MDSD 185N 697W,0,0,0,2,2
Hurricane,Jeanne,34,2004-09-22T03:00:00Z,W PALM BEACH FL,0,0,0,2,2
Hurricane,Jeanne,34,2004-09-22T03:00:00Z,MTPP 186N 724W,0,0,0,2,2
Hurricane,Jeanne,34,2004-09-22T03:00:00Z,FT PIERCE FL,0,0,0,2,2
Hurricane,Jeanne,34,2004-09-22T03:00:00Z,MUGM 200N 751W,0,0,0,2,2
Hurricane,Jeanne,34,2004-09-22T03:00:00Z,CHARLESTON SC,0,0,0,2,2
Hurricane,Jeanne,34,2004-09-22T03:00:00Z,MDPP 198N 707W,0,0,0,4,4
Hurricane,Jeanne,34,2004-09-22T03:00:00Z,MYRTLE BEACH SC,0,0,0,2,2
Hurricane,Jeanne,34,2004-09-22T03:00:00Z,MBJT 215N 712W,0,0,3,5,8
Hurricane,Jeanne,34,2004-09-22T03:00:00Z,WILMINGTON NC,0,0,0,2,2
Hurricane,Jeanne,34,2004-09-22T03:00:00Z,MYMM 224N 730W,0,0,3,6,9
Hurricane,Jeanne,34,2004-09-22T03:00:00Z,MOREHEAD CITY NC,0,0,0,3,3
Hurricane,Jeanne,34,2004-09-22T03:00:00Z,MYSM 241N 745W,0,0,3,7,10
Hurricane,Jeanne,34,2004-09-22T03:00:00Z,CAPE HATTERAS NC,0,0,0,3,3
Hurricane,Jeanne,34,2004-09-22T03:00:00Z,MYEG 235N 758W,0,0,1,5,6
Hurricane,Jeanne,35,2004-09-22T09:00:00Z,26.1N  69.5W,99,0,0,0,99
Hurricane,Jeanne,35,2004-09-22T09:00:00Z,MYGF 266N 787W,0,0,0,6,6
Hurricane,Jeanne,35,2004-09-22T09:00:00Z,26.1N  70.5W,56,0,0,0,56
Hurricane,Jeanne,35,2004-09-22T09:00:00Z,MARATHON FL,0,0,0,2,2
Hurricane,Jeanne,35,2004-09-22T09:00:00Z,26.3N  71.8W,25,3,0,1,29
Hurricane,Jeanne,35,2004-09-22T09:00:00Z,MIAMI FL,0,0,0,3,3
Hurricane,Jeanne,35,2004-09-22T09:00:00Z,MDSD 185N 697W,0,0,0,2,2
Hurricane,Jeanne,35,2004-09-22T09:00:00Z,W PALM BEACH FL,0,0,0,3,3
Hurricane,Jeanne,35,2004-09-22T09:00:00Z,MTPP 186N 724W,0,0,0,3,3
Hurricane,Jeanne,35,2004-09-22T09:00:00Z,FT PIERCE FL,0,0,0,3,3
Hurricane,Jeanne,35,2004-09-22T09:00:00Z,MTCA 183N 738W,0,0,0,2,2
Hurricane,Jeanne,35,2004-09-22T09:00:00Z,COCOA BEACH FL,0,0,0,3,3
Hurricane,Jeanne,35,2004-09-22T09:00:00Z,MUGM 200N 751W,0,0,0,4,4
Hurricane,Jeanne,35,2004-09-22T09:00:00Z,DAYTONA BEACH FL,0,0,0,2,2
Hurricane,Jeanne,35,2004-09-22T09:00:00Z,MUCM 214N 779W,0,0,0,3,3
Hurricane,Jeanne,35,2004-09-22T09:00:00Z,JACKSONVILLE FL,0,0,0,2,2
Hurricane,Jeanne,35,2004-09-22T09:00:00Z,MDPP 198N 707W,0,0,1,3,4
Hurricane,Jeanne,35,2004-09-22T09:00:00Z,SAVANNAH GA,0,0,0,2,2
Hurricane,Jeanne,35,2004-09-22T09:00:00Z,MBJT 215N 712W,0,0,4,4,8
Hurricane,Jeanne,35,2004-09-22T09:00:00Z,CHARLESTON SC,0,0,0,2,2
Hurricane,Jeanne,35,2004-09-22T09:00:00Z,MYMM 224N 730W,0,1,5,5,11
Hurricane,Jeanne,35,2004-09-22T09:00:00Z,MYRTLE BEACH SC,0,0,0,3,3
Hurricane,Jeanne,35,2004-09-22T09:00:00Z,MYSM 241N 745W,0,2,6,5,13
Hurricane,Jeanne,35,2004-09-22T09:00:00Z,WILMINGTON NC,0,0,0,3,3
Hurricane,Jeanne,35,2004-09-22T09:00:00Z,MYEG 235N 758W,0,0,3,6,9
Hurricane,Jeanne,35,2004-09-22T09:00:00Z,MOREHEAD CITY NC,0,0,0,3,3
Hurricane,Jeanne,35,2004-09-22T09:00:00Z,MYAK 241N 776W,0,0,1,5,6
Hurricane,Jeanne,35,2004-09-22T09:00:00Z,CAPE HATTERAS NC,0,0,0,2,2
Hurricane,Jeanne,35,2004-09-22T09:00:00Z,MYNN 251N 775W,0,0,1,7,8
Hurricane,Jeanne,36,2004-09-22T15:00:00Z,26.0N  69.8W,84,0,0,0,84
Hurricane,Jeanne,36,2004-09-22T15:00:00Z,MYGF 266N 787W,0,0,1,6,7
Hurricane,Jeanne,36,2004-09-22T15:00:00Z,26.0N  70.9W,45,1,0,0,46
Hurricane,Jeanne,36,2004-09-22T15:00:00Z,MARATHON FL,0,0,0,3,3
Hurricane,Jeanne,36,2004-09-22T15:00:00Z,26.3N  72.3W,17,9,1,0,27
Hurricane,Jeanne,36,2004-09-22T15:00:00Z,MIAMI FL,0,0,0,4,4
Hurricane,Jeanne,36,2004-09-22T15:00:00Z,MTPP 186N 724W,0,0,0,2,2
Hurricane,Jeanne,36,2004-09-22T15:00:00Z,W PALM BEACH FL,0,0,0,4,4
Hurricane,Jeanne,36,2004-09-22T15:00:00Z,MTCA 183N 738W,0,0,0,2,2
Hurricane,Jeanne,36,2004-09-22T15:00:00Z,FT PIERCE FL,0,0,0,4,4
Hurricane,Jeanne,36,2004-09-22T15:00:00Z,MKJP 179N 768W,0,0,0,2,2
Hurricane,Jeanne,36,2004-09-22T15:00:00Z,COCOA BEACH FL,0,0,0,3,3
Hurricane,Jeanne,36,2004-09-22T15:00:00Z,MKJS 185N 779W,0,0,0,2,2
Hurricane,Jeanne,36,2004-09-22T15:00:00Z,DAYTONA BEACH FL,0,0,0,3,3
Hurricane,Jeanne,36,2004-09-22T15:00:00Z,MUGM 200N 751W,0,0,1,4,5
Hurricane,Jeanne,36,2004-09-22T15:00:00Z,JACKSONVILLE FL,0,0,0,2,2
Hurricane,Jeanne,36,2004-09-22T15:00:00Z,MUCM 214N 779W,0,0,0,5,5
Hurricane,Jeanne,36,2004-09-22T15:00:00Z,CHARLESTON SC,0,0,0,2,2
Hurricane,Jeanne,36,2004-09-22T15:00:00Z,MUCF 221N 805W,0,0,0,2,2
Hurricane,Jeanne,36,2004-09-22T15:00:00Z,MYRTLE BEACH SC,0,0,0,2,2
Hurricane,Jeanne,36,2004-09-22T15:00:00Z,MDPP 198N 707W,0,0,1,1,2
Hurricane,Jeanne,36,2004-09-22T15:00:00Z,WILMINGTON NC,0,0,0,3,3
Hurricane,Jeanne,36,2004-09-22T15:00:00Z,MBJT 215N 712W,0,1,3,3,7
Hurricane,Jeanne,36,2004-09-22T15:00:00Z,MOREHEAD CITY NC,0,0,0,3,3
Hurricane,Jeanne,36,2004-09-22T15:00:00Z,MYMM 224N 730W,0,2,5,4,11
Hurricane,Jeanne,36,2004-09-22T15:00:00Z,CAPE HATTERAS NC,0,0,0,3,3
Hurricane,Jeanne,36,2004-09-22T15:00:00Z,MYSM 241N 745W,0,3,7,5,15
Hurricane,Jeanne,36,2004-09-22T15:00:00Z,KEY WEST FL,0,0,0,2,2
Hurricane,Jeanne,36,2004-09-22T15:00:00Z,MYEG 235N 758W,0,0,5,6,11
Hurricane,Jeanne,36,2004-09-22T15:00:00Z,MARCO ISLAND FL,0,0,0,2,2
Hurricane,Jeanne,36,2004-09-22T15:00:00Z,MYAK 241N 776W,0,0,1,7,8
Hurricane,Jeanne,36,2004-09-22T15:00:00Z,FT MYERS FL,0,0,0,2,2
Hurricane,Jeanne,36,2004-09-22T15:00:00Z,MYNN 251N 775W,0,0,2,7,9
Hurricane,Jeanne,37,2004-09-22T21:00:00Z,25.9N  70.8W,74,0,0,0,74
Hurricane,Jeanne,37,2004-09-22T21:00:00Z,FT PIERCE FL,0,0,1,8,9
Hurricane,Jeanne,37,2004-09-22T21:00:00Z,26.1N  72.2W,37,4,0,0,41
Hurricane,Jeanne,37,2004-09-22T21:00:00Z,COCOA BEACH FL,0,0,0,8,8
Hurricane,Jeanne,37,2004-09-22T21:00:00Z,26.5N  74.1W,1,19,2,1,23
Hurricane,Jeanne,37,2004-09-22T21:00:00Z,DAYTONA BEACH FL,0,0,0,6,6
Hurricane,Jeanne,37,2004-09-22T21:00:00Z,MWCG 193N 814W,0,0,0,2,2
Hurricane,Jeanne,37,2004-09-22T21:00:00Z,JACKSONVILLE FL,0,0,0,4,4
Hurricane,Jeanne,37,2004-09-22T21:00:00Z,MUGM 200N 751W,0,0,0,2,2
Hurricane,Jeanne,37,2004-09-22T21:00:00Z,SAVANNAH GA,0,0,0,3,3
Hurricane,Jeanne,37,2004-09-22T21:00:00Z,MUCM 214N 779W,0,0,2,4,6
Hurricane,Jeanne,37,2004-09-22T21:00:00Z,CHARLESTON SC,0,0,0,3,3
Hurricane,Jeanne,37,2004-09-22T21:00:00Z,MUCF 221N 805W,0,0,0,6,6
Hurricane,Jeanne,37,2004-09-22T21:00:00Z,MYRTLE BEACH SC,0,0,0,3,3
Hurricane,Jeanne,37,2004-09-22T21:00:00Z,MUSN 216N 826W,0,0,0,3,3
Hurricane,Jeanne,37,2004-09-22T21:00:00Z,WILMINGTON NC,0,0,0,3,3
Hurricane,Jeanne,37,2004-09-22T21:00:00Z,MUHA 230N 824W,0,0,0,5,5
Hurricane,Jeanne,37,2004-09-22T21:00:00Z,MOREHEAD CITY NC,0,0,0,3,3
Hurricane,Jeanne,37,2004-09-22T21:00:00Z,MUAN 219N 850W,0,0,0,2,2
Hurricane,Jeanne,37,2004-09-22T21:00:00Z,CAPE HATTERAS NC,0,0,0,2,2
Hurricane,Jeanne,37,2004-09-22T21:00:00Z,MYMM 224N 730W,0,3,3,1,7
Hurricane,Jeanne,37,2004-09-22T21:00:00Z,KEY WEST FL,0,0,0,7,7
Hurricane,Jeanne,37,2004-09-22T21:00:00Z,MYSM 241N 745W,0,10,5,1,16
Hurricane,Jeanne,37,2004-09-22T21:00:00Z,MARCO ISLAND FL,0,0,0,7,7
Hurricane,Jeanne,37,2004-09-22T21:00:00Z,MYEG 235N 758W,0,2,8,3,13
Hurricane,Jeanne,37,2004-09-22T21:00:00Z,FT MYERS FL,0,0,0,7,7
Hurricane,Jeanne,37,2004-09-22T21:00:00Z,MYAK 241N 776W,0,0,7,5,12
Hurricane,Jeanne,37,2004-09-22T21:00:00Z,VENICE FL,0,0,0,6,6
Hurricane,Jeanne,37,2004-09-22T21:00:00Z,MYNN 251N 775W,0,0,9,5,14
Hurricane,Jeanne,37,2004-09-22T21:00:00Z,TAMPA FL,0,0,0,5,5
Hurricane,Jeanne,37,2004-09-22T21:00:00Z,MYGF 266N 787W,0,0,4,8,12
Hurricane,Jeanne,37,2004-09-22T21:00:00Z,CEDAR KEY FL,0,0,0,4,4
Hurricane,Jeanne,37,2004-09-22T21:00:00Z,MARATHON FL,0,0,0,8,8
Hurricane,Jeanne,37,2004-09-22T21:00:00Z,ST MARKS FL,0,0,0,2,2
Hurricane,Jeanne,37,2004-09-22T21:00:00Z,MIAMI FL,0,0,1,9,10
Hurricane,Jeanne,37,2004-09-22T21:00:00Z,GULF 29N 85W,0,0,0,2,2
Hurricane,Jeanne,37,2004-09-22T21:00:00Z,W PALM BEACH FL,0,0,1,9,10
Hurricane,Jeanne,38,2004-09-23T03:00:00Z,25.5N  71.5W,45,0,0,0,45
Hurricane,Jeanne,38,2004-09-23T03:00:00Z,JACKSONVILLE FL,0,0,0,8,8
Hurricane,Jeanne,38,2004-09-23T03:00:00Z,25.5N  73.0W,22,6,1,0,29
Hurricane,Jeanne,38,2004-09-23T03:00:00Z,SAVANNAH GA,0,0,0,5,5
Hurricane,Jeanne,38,2004-09-23T03:00:00Z,26.0N  75.0W,0,15,6,2,23
Hurricane,Jeanne,38,2004-09-23T03:00:00Z,CHARLESTON SC,0,0,0,4,4
Hurricane,Jeanne,38,2004-09-23T03:00:00Z,MUCM 214N 779W,0,0,0,2,2
Hurricane,Jeanne,38,2004-09-23T03:00:00Z,MYRTLE BEACH SC,0,0,0,3,3
Hurricane,Jeanne,38,2004-09-23T03:00:00Z,MUCF 221N 805W,0,0,0,2,2
Hurricane,Jeanne,38,2004-09-23T03:00:00Z,WILMINGTON NC,0,0,0,2,2
Hurricane,Jeanne,38,2004-09-23T03:00:00Z,MUHA 230N 824W,0,0,0,3,3
Hurricane,Jeanne,38,2004-09-23T03:00:00Z,MOREHEAD CITY NC,0,0,0,2,2
Hurricane,Jeanne,38,2004-09-23T03:00:00Z,MYMM 224N 730W,0,4,2,1,7
Hurricane,Jeanne,38,2004-09-23T03:00:00Z,KEY WEST FL,0,0,0,7,7
Hurricane,Jeanne,38,2004-09-23T03:00:00Z,MYSM 241N 745W,0,12,4,1,17
Hurricane,Jeanne,38,2004-09-23T03:00:00Z,MARCO ISLAND FL,0,0,0,10,10
Hurricane,Jeanne,38,2004-09-23T03:00:00Z,MYEG 235N 758W,0,3,7,2,12
Hurricane,Jeanne,38,2004-09-23T03:00:00Z,FT MYERS FL,0,0,0,10,10
Hurricane,Jeanne,38,2004-09-23T03:00:00Z,MYAK 241N 776W,0,0,7,5,12
Hurricane,Jeanne,38,2004-09-23T03:00:00Z,VENICE FL,0,0,0,9,9
Hurricane,Jeanne,38,2004-09-23T03:00:00Z,MYNN 251N 775W,0,1,9,5,15
Hurricane,Jeanne,38,2004-09-23T03:00:00Z,TAMPA FL,0,0,0,10,10
Hurricane,Jeanne,38,2004-09-23T03:00:00Z,MYGF 266N 787W,0,0,5,11,16
Hurricane,Jeanne,38,2004-09-23T03:00:00Z,CEDAR KEY FL,0,0,0,8,8
Hurricane,Jeanne,38,2004-09-23T03:00:00Z,MARATHON FL,0,0,0,8,8
Hurricane,Jeanne,38,2004-09-23T03:00:00Z,ST MARKS FL,0,0,0,5,5
Hurricane,Jeanne,38,2004-09-23T03:00:00Z,MIAMI FL,0,0,1,11,12
Hurricane,Jeanne,38,2004-09-23T03:00:00Z,APALACHICOLA FL,0,0,0,4,4
Hurricane,Jeanne,38,2004-09-23T03:00:00Z,W PALM BEACH FL,0,0,2,11,13
Hurricane,Jeanne,38,2004-09-23T03:00:00Z,PANAMA CITY FL,0,0,0,3,3
Hurricane,Jeanne,38,2004-09-23T03:00:00Z,FT PIERCE FL,0,0,1,13,14
Hurricane,Jeanne,38,2004-09-23T03:00:00Z,GULF 29N 85W,0,0,0,5,5
Hurricane,Jeanne,38,2004-09-23T03:00:00Z,COCOA BEACH FL,0,0,0,13,13
Hurricane,Jeanne,38,2004-09-23T03:00:00Z,GULF 29N 87W,0,0,0,2,2
Hurricane,Jeanne,38,2004-09-23T03:00:00Z,DAYTONA BEACH FL,0,0,0,11,11
Hurricane,Jeanne,39,2004-09-23T09:00:00Z,25.4N  72.1W,45,0,0,0,45
Hurricane,Jeanne,39,2004-09-23T09:00:00Z,DAYTONA BEACH FL,0,0,0,11,11
Hurricane,Jeanne,39,2004-09-23T09:00:00Z,25.6N  74.0W,15,16,0,0,31
Hurricane,Jeanne,39,2004-09-23T09:00:00Z,JACKSONVILLE FL,0,0,0,8,8
Hurricane,Jeanne,39,2004-09-23T09:00:00Z,26.0N  75.9W,0,15,7,1,23
Hurricane,Jeanne,39,2004-09-23T09:00:00Z,SAVANNAH GA,0,0,0,4,4
Hurricane,Jeanne,39,2004-09-23T09:00:00Z,MUCM 214N 779W,0,0,1,1,2
Hurricane,Jeanne,39,2004-09-23T09:00:00Z,CHARLESTON SC,0,0,0,3,3
Hurricane,Jeanne,39,2004-09-23T09:00:00Z,MUCF 221N 805W,0,0,0,3,3
Hurricane,Jeanne,39,2004-09-23T09:00:00Z,MYRTLE BEACH SC,0,0,0,2,2
Hurricane,Jeanne,39,2004-09-23T09:00:00Z,MUHA 230N 824W,0,0,0,4,4
Hurricane,Jeanne,39,2004-09-23T09:00:00Z,KEY WEST FL,0,0,0,8,8
Hurricane,Jeanne,39,2004-09-23T09:00:00Z,MYMM 224N 730W,1,2,1,0,4
Hurricane,Jeanne,39,2004-09-23T09:00:00Z,MARCO ISLAND FL,0,0,0,11,11
Hurricane,Jeanne,39,2004-09-23T09:00:00Z,MYSM 241N 745W,2,15,1,0,18
Hurricane,Jeanne,39,2004-09-23T09:00:00Z,FT MYERS FL,0,0,0,11,11
Hurricane,Jeanne,39,2004-09-23T09:00:00Z,MYEG 235N 758W,0,5,5,2,12
Hurricane,Jeanne,39,2004-09-23T09:00:00Z,VENICE FL,0,0,0,11,11
Hurricane,Jeanne,39,2004-09-23T09:00:00Z,MYAK 241N 776W,0,1,8,4,13
Hurricane,Jeanne,39,2004-09-23T09:00:00Z,TAMPA FL,0,0,0,10,10
Hurricane,Jeanne,39,2004-09-23T09:00:00Z,MYNN 251N 775W,0,2,11,4,17
Hurricane,Jeanne,39,2004-09-23T09:00:00Z,CEDAR KEY FL,0,0,0,8,8
Hurricane,Jeanne,39,2004-09-23T09:00:00Z,MYGF 266N 787W,0,0,9,8,17
Hurricane,Jeanne,39,2004-09-23T09:00:00Z,ST MARKS FL,0,0,0,5,5
Hurricane,Jeanne,39,2004-09-23T09:00:00Z,MARATHON FL,0,0,1,9,10
Hurricane,Jeanne,39,2004-09-23T09:00:00Z,APALACHICOLA FL,0,0,0,5,5
Hurricane,Jeanne,39,2004-09-23T09:00:00Z,MIAMI FL,0,0,2,11,13
Hurricane,Jeanne,39,2004-09-23T09:00:00Z,PANAMA CITY FL,0,0,0,4,4
Hurricane,Jeanne,39,2004-09-23T09:00:00Z,W PALM BEACH FL,0,0,2,13,15
Hurricane,Jeanne,39,2004-09-23T09:00:00Z,PENSACOLA FL,0,0,0,2,2
Hurricane,Jeanne,39,2004-09-23T09:00:00Z,FT PIERCE FL,0,0,2,12,14
Hurricane,Jeanne,39,2004-09-23T09:00:00Z,GULF 29N 85W,0,0,0,6,6
Hurricane,Jeanne,39,2004-09-23T09:00:00Z,COCOA BEACH FL,0,0,1,12,13
Hurricane,Jeanne,39,2004-09-23T09:00:00Z,GULF 29N 87W,0,0,0,3,3
Hurricane,Jeanne,40,2004-09-23T15:00:00Z,25.6N  72.6W,43,0,0,0,43
Hurricane,Jeanne,40,2004-09-23T15:00:00Z,SAVANNAH GA,0,0,0,5,5
Hurricane,Jeanne,40,2004-09-23T15:00:00Z,25.7N  74.6W,12,16,1,0,29
Hurricane,Jeanne,40,2004-09-23T15:00:00Z,CHARLESTON SC,0,0,0,4,4
Hurricane,Jeanne,40,2004-09-23T15:00:00Z,26.0N  76.8W,0,11,10,1,22
Hurricane,Jeanne,40,2004-09-23T15:00:00Z,MYRTLE BEACH SC,0,0,0,2,2
Hurricane,Jeanne,40,2004-09-23T15:00:00Z,MUCF 221N 805W,0,0,1,2,3
Hurricane,Jeanne,40,2004-09-23T15:00:00Z,KEY WEST FL,0,0,1,8,9
Hurricane,Jeanne,40,2004-09-23T15:00:00Z,MUHA 230N 824W,0,0,0,4,4
Hurricane,Jeanne,40,2004-09-23T15:00:00Z,MARCO ISLAND FL,0,0,2,11,13
Hurricane,Jeanne,40,2004-09-23T15:00:00Z,MYMM 224N 730W,1,1,0,0,2
Hurricane,Jeanne,40,2004-09-23T15:00:00Z,FT MYERS FL,0,0,1,12,13
Hurricane,Jeanne,40,2004-09-23T15:00:00Z,MYSM 241N 745W,6,11,0,1,18
Hurricane,Jeanne,40,2004-09-23T15:00:00Z,VENICE FL,0,0,0,12,12
Hurricane,Jeanne,40,2004-09-23T15:00:00Z,MYEG 235N 758W,0,8,3,0,11
Hurricane,Jeanne,40,2004-09-23T15:00:00Z,TAMPA FL,0,0,0,12,12
Hurricane,Jeanne,40,2004-09-23T15:00:00Z,MYAK 241N 776W,0,3,8,2,13
Hurricane,Jeanne,40,2004-09-23T15:00:00Z,CEDAR KEY FL,0,0,0,10,10
Hurricane,Jeanne,40,2004-09-23T15:00:00Z,MYNN 251N 775W,0,5,11,2,18
Hurricane,Jeanne,40,2004-09-23T15:00:00Z,ST MARKS FL,0,0,0,7,7
Hurricane,Jeanne,40,2004-09-23T15:00:00Z,MYGF 266N 787W,0,0,13,5,18
Hurricane,Jeanne,40,2004-09-23T15:00:00Z,APALACHICOLA FL,0,0,0,6,6
Hurricane,Jeanne,40,2004-09-23T15:00:00Z,MARATHON FL,0,0,2,9,11
Hurricane,Jeanne,40,2004-09-23T15:00:00Z,PANAMA CITY FL,0,0,0,5,5
Hurricane,Jeanne,40,2004-09-23T15:00:00Z,MIAMI FL,0,0,6,9,15
Hurricane,Jeanne,40,2004-09-23T15:00:00Z,PENSACOLA FL,0,0,0,3,3
Hurricane,Jeanne,40,2004-09-23T15:00:00Z,W PALM BEACH FL,0,0,6,10,16
Hurricane,Jeanne,40,2004-09-23T15:00:00Z,MOBILE AL,0,0,0,2,2
Hurricane,Jeanne,40,2004-09-23T15:00:00Z,FT PIERCE FL,0,0,4,12,16
Hurricane,Jeanne,40,2004-09-23T15:00:00Z,GULF 29N 85W,0,0,0,7,7
Hurricane,Jeanne,40,2004-09-23T15:00:00Z,COCOA BEACH FL,0,0,2,13,15
Hurricane,Jeanne,40,2004-09-23T15:00:00Z,GULF 29N 87W,0,0,0,4,4
Hurricane,Jeanne,40,2004-09-23T15:00:00Z,DAYTONA BEACH FL,0,0,0,13,13
Hurricane,Jeanne,40,2004-09-23T15:00:00Z,GULF 28N 89W,0,0,0,2,2
Hurricane,Jeanne,40,2004-09-23T15:00:00Z,JACKSONVILLE FL,0,0,0,9,9
Hurricane,Jeanne,41,2004-09-23T21:00:00Z,25.8N  73.4W,44,0,0,0,44
Hurricane,Jeanne,41,2004-09-23T21:00:00Z,MYRTLE BEACH SC,0,0,0,3,3
Hurricane,Jeanne,41,2004-09-23T21:00:00Z,25.8N  75.5W,12,18,0,0,30
Hurricane,Jeanne,41,2004-09-23T21:00:00Z,WILMINGTON NC,0,0,0,2,2
Hurricane,Jeanne,41,2004-09-23T21:00:00Z,26.1N  77.8W,0,12,10,1,23
Hurricane,Jeanne,41,2004-09-23T21:00:00Z,KEY WEST FL,0,0,3,7,10
Hurricane,Jeanne,41,2004-09-23T21:00:00Z,MUCF 221N 805W,0,0,1,1,2
Hurricane,Jeanne,41,2004-09-23T21:00:00Z,MARCO ISLAND FL,0,0,5,9,14
Hurricane,Jeanne,41,2004-09-23T21:00:00Z,MUHA 230N 824W,0,0,1,3,4
Hurricane,Jeanne,41,2004-09-23T21:00:00Z,FT MYERS FL,0,0,4,10,14
Hurricane,Jeanne,41,2004-09-23T21:00:00Z,MYSM 241N 745W,12,5,0,0,17
Hurricane,Jeanne,41,2004-09-23T21:00:00Z,VENICE FL,0,0,2,12,14
Hurricane,Jeanne,41,2004-09-23T21:00:00Z,MYEG 235N 758W,1,8,1,0,10
Hurricane,Jeanne,41,2004-09-23T21:00:00Z,TAMPA FL,0,0,1,13,14
Hurricane,Jeanne,41,2004-09-23T21:00:00Z,MYAK 241N 776W,0,8,5,1,14
Hurricane,Jeanne,41,2004-09-23T21:00:00Z,CEDAR KEY FL,0,0,0,12,12
Hurricane,Jeanne,41,2004-09-23T21:00:00Z,MYNN 251N 775W,0,14,5,1,20
Hurricane,Jeanne,41,2004-09-23T21:00:00Z,ST MARKS FL,0,0,0,9,9
Hurricane,Jeanne,41,2004-09-23T21:00:00Z,MYGF 266N 787W,0,3,15,3,21
Hurricane,Jeanne,41,2004-09-23T21:00:00Z,APALACHICOLA FL,0,0,0,9,9
Hurricane,Jeanne,41,2004-09-23T21:00:00Z,MARATHON FL,0,0,6,6,12
Hurricane,Jeanne,41,2004-09-23T21:00:00Z,PANAMA CITY FL,0,0,0,8,8
Hurricane,Jeanne,41,2004-09-23T21:00:00Z,MIAMI FL,0,0,11,5,16
Hurricane,Jeanne,41,2004-09-23T21:00:00Z,PENSACOLA FL,0,0,0,5,5
Hurricane,Jeanne,41,2004-09-23T21:00:00Z,W PALM BEACH FL,0,0,12,6,18
Hurricane,Jeanne,41,2004-09-23T21:00:00Z,MOBILE AL,0,0,0,3,3
Hurricane,Jeanne,41,2004-09-23T21:00:00Z,FT PIERCE FL,0,0,9,8,17
Hurricane,Jeanne,41,2004-09-23T21:00:00Z,GULFPORT MS,0,0,0,3,3
Hurricane,Jeanne,41,2004-09-23T21:00:00Z,COCOA BEACH FL,0,0,5,11,16
Hurricane,Jeanne,41,2004-09-23T21:00:00Z,BURAS LA,0,0,0,3,3
Hurricane,Jeanne,41,2004-09-23T21:00:00Z,DAYTONA BEACH FL,0,0,2,12,14
Hurricane,Jeanne,41,2004-09-23T21:00:00Z,NEW ORLEANS LA,0,0,0,2,2
Hurricane,Jeanne,41,2004-09-23T21:00:00Z,JACKSONVILLE FL,0,0,0,11,11
Hurricane,Jeanne,41,2004-09-23T21:00:00Z,GULF 29N 85W,0,0,0,9,9
Hurricane,Jeanne,41,2004-09-23T21:00:00Z,SAVANNAH GA,0,0,0,7,7
Hurricane,Jeanne,41,2004-09-23T21:00:00Z,GULF 29N 87W,0,0,0,6,6
Hurricane,Jeanne,41,2004-09-23T21:00:00Z,CHARLESTON SC,0,0,0,5,5
Hurricane,Jeanne,41,2004-09-23T21:00:00Z,GULF 28N 89W,0,0,0,4,4
Hurricane,Jeanne,42,2004-09-24T03:00:00Z,26.1N  74.5W,42,0,0,0,42
Hurricane,Jeanne,42,2004-09-24T03:00:00Z,WILMINGTON NC,0,0,0,4,4
Hurricane,Jeanne,42,2004-09-24T03:00:00Z,26.2N  77.0W,5,21,1,0,27
Hurricane,Jeanne,42,2004-09-24T03:00:00Z,MOREHEAD CITY NC,0,0,0,2,2
Hurricane,Jeanne,42,2004-09-24T03:00:00Z,26.5N  79.0W,0,12,7,1,20
Hurricane,Jeanne,42,2004-09-24T03:00:00Z,KEY WEST FL,0,0,5,4,9
Hurricane,Jeanne,42,2004-09-24T03:00:00Z,MUHA 230N 824W,0,0,1,2,3
Hurricane,Jeanne,42,2004-09-24T03:00:00Z,MARCO ISLAND FL,0,0,9,5,14
Hurricane,Jeanne,42,2004-09-24T03:00:00Z,MYSM 241N 745W,10,2,0,0,12
Hurricane,Jeanne,42,2004-09-24T03:00:00Z,FT MYERS FL,0,0,8,6,14
Hurricane,Jeanne,42,2004-09-24T03:00:00Z,MYEG 235N 758W,2,3,0,1,6
Hurricane,Jeanne,42,2004-09-24T03:00:00Z,VENICE FL,0,0,6,8,14
Hurricane,Jeanne,42,2004-09-24T03:00:00Z,MYAK 241N 776W,1,8,1,0,10
Hurricane,Jeanne,42,2004-09-24T03:00:00Z,TAMPA FL,0,0,4,10,14
Hurricane,Jeanne,42,2004-09-24T03:00:00Z,MYNN 251N 775W,1,16,1,1,19
Hurricane,Jeanne,42,2004-09-24T03:00:00Z,CEDAR KEY FL,0,0,1,12,13
Hurricane,Jeanne,42,2004-09-24T03:00:00Z,MYGF 266N 787W,0,15,5,1,21
Hurricane,Jeanne,42,2004-09-24T03:00:00Z,ST MARKS FL,0,0,0,10,10
Hurricane,Jeanne,42,2004-09-24T03:00:00Z,MARATHON FL,0,1,7,2,10
Hurricane,Jeanne,42,2004-09-24T03:00:00Z,APALACHICOLA FL,0,0,0,10,10
Hurricane,Jeanne,42,2004-09-24T03:00:00Z,MIAMI FL,0,3,10,3,16
Hurricane,Jeanne,42,2004-09-24T03:00:00Z,PANAMA CITY FL,0,0,0,8,8
Hurricane,Jeanne,42,2004-09-24T03:00:00Z,W PALM BEACH FL,0,4,11,3,18
Hurricane,Jeanne,42,2004-09-24T03:00:00Z,PENSACOLA FL,0,0,0,6,6
Hurricane,Jeanne,42,2004-09-24T03:00:00Z,FT PIERCE FL,0,2,12,4,18
Hurricane,Jeanne,42,2004-09-24T03:00:00Z,MOBILE AL,0,0,0,4,4
Hurricane,Jeanne,42,2004-09-24T03:00:00Z,COCOA BEACH FL,0,1,10,6,17
Hurricane,Jeanne,42,2004-09-24T03:00:00Z,GULFPORT MS,0,0,0,3,3
Hurricane,Jeanne,42,2004-09-24T03:00:00Z,DAYTONA BEACH FL,0,0,5,10,15
Hurricane,Jeanne,42,2004-09-24T03:00:00Z,BURAS LA,0,0,0,3,3
Hurricane,Jeanne,42,2004-09-24T03:00:00Z,JACKSONVILLE FL,0,0,1,12,13
Hurricane,Jeanne,42,2004-09-24T03:00:00Z,NEW ORLEANS LA,0,0,0,2,2
Hurricane,Jeanne,42,2004-09-24T03:00:00Z,SAVANNAH GA,0,0,0,9,9
Hurricane,Jeanne,42,2004-09-24T03:00:00Z,GULF 29N 85W,0,0,0,10,10
Hurricane,Jeanne,42,2004-09-24T03:00:00Z,CHARLESTON SC,0,0,0,7,7
Hurricane,Jeanne,42,2004-09-24T03:00:00Z,GULF 29N 87W,0,0,0,7,7
Hurricane,Jeanne,42,2004-09-24T03:00:00Z,MYRTLE BEACH SC,0,0,0,5,5
Hurricane,Jeanne,42,2004-09-24T03:00:00Z,GULF 28N 89W,0,0,0,3,3
Hurricane,Jeanne,43,2004-09-24T09:00:00Z,26.2N  75.4W,43,0,0,0,43
Hurricane,Jeanne,43,2004-09-24T09:00:00Z,CAPE HATTERAS NC,0,0,0,3,3
Hurricane,Jeanne,43,2004-09-24T09:00:00Z,26.6N  77.6W,9,18,0,1,28
Hurricane,Jeanne,43,2004-09-24T09:00:00Z,KEY WEST FL,0,0,5,2,7
Hurricane,Jeanne,43,2004-09-24T09:00:00Z,27.1N  79.5W,0,13,6,1,20
Hurricane,Jeanne,43,2004-09-24T09:00:00Z,MARCO ISLAND FL,0,1,9,3,13
Hurricane,Jeanne,43,2004-09-24T09:00:00Z,MUHA 230N 824W,0,0,1,1,2
Hurricane,Jeanne,43,2004-09-24T09:00:00Z,FT MYERS FL,0,1,9,4,14
Hurricane,Jeanne,43,2004-09-24T09:00:00Z,MYSM 241N 745W,11,1,0,0,12
Hurricane,Jeanne,43,2004-09-24T09:00:00Z,VENICE FL,0,0,8,6,14
Hurricane,Jeanne,43,2004-09-24T09:00:00Z,MYEG 235N 758W,2,3,0,0,5
Hurricane,Jeanne,43,2004-09-24T09:00:00Z,TAMPA FL,0,0,7,8,15
Hurricane,Jeanne,43,2004-09-24T09:00:00Z,MYAK 241N 776W,1,8,0,1,10
Hurricane,Jeanne,43,2004-09-24T09:00:00Z,CEDAR KEY FL,0,0,3,11,14
Hurricane,Jeanne,43,2004-09-24T09:00:00Z,MYNN 251N 775W,5,13,1,0,19
Hurricane,Jeanne,43,2004-09-24T09:00:00Z,ST MARKS FL,0,0,0,12,12
Hurricane,Jeanne,43,2004-09-24T09:00:00Z,MYGF 266N 787W,1,18,2,1,22
Hurricane,Jeanne,43,2004-09-24T09:00:00Z,APALACHICOLA FL,0,0,0,11,11
Hurricane,Jeanne,43,2004-09-24T09:00:00Z,MARATHON FL,0,1,6,2,9
Hurricane,Jeanne,43,2004-09-24T09:00:00Z,PANAMA CITY FL,0,0,0,10,10
Hurricane,Jeanne,43,2004-09-24T09:00:00Z,MIAMI FL,0,6,7,2,15
Hurricane,Jeanne,43,2004-09-24T09:00:00Z,PENSACOLA FL,0,0,0,7,7
Hurricane,Jeanne,43,2004-09-24T09:00:00Z,W PALM BEACH FL,0,8,8,2,18
Hurricane,Jeanne,43,2004-09-24T09:00:00Z,MOBILE AL,0,0,0,5,5
Hurricane,Jeanne,43,2004-09-24T09:00:00Z,FT PIERCE FL,0,5,11,3,19
Hurricane,Jeanne,43,2004-09-24T09:00:00Z,GULFPORT MS,0,0,0,4,4
Hurricane,Jeanne,43,2004-09-24T09:00:00Z,COCOA BEACH FL,0,3,11,4,18
Hurricane,Jeanne,43,2004-09-24T09:00:00Z,BURAS LA,0,0,0,4,4
Hurricane,Jeanne,43,2004-09-24T09:00:00Z,DAYTONA BEACH FL,0,0,9,8,17
Hurricane,Jeanne,43,2004-09-24T09:00:00Z,NEW ORLEANS LA,0,0,0,3,3
Hurricane,Jeanne,43,2004-09-24T09:00:00Z,JACKSONVILLE FL,0,0,3,11,14
Hurricane,Jeanne,43,2004-09-24T09:00:00Z,NEW IBERIA LA,0,0,0,2,2
Hurricane,Jeanne,43,2004-09-24T09:00:00Z,SAVANNAH GA,0,0,1,11,12
Hurricane,Jeanne,43,2004-09-24T09:00:00Z,GULF 29N 85W,0,0,0,11,11
Hurricane,Jeanne,43,2004-09-24T09:00:00Z,CHARLESTON SC,0,0,0,10,10
Hurricane,Jeanne,43,2004-09-24T09:00:00Z,GULF 29N 87W,0,0,0,7,7
Hurricane,Jeanne,43,2004-09-24T09:00:00Z,MYRTLE BEACH SC,0,0,0,8,8
Hurricane,Jeanne,43,2004-09-24T09:00:00Z,GULF 28N 89W,0,0,0,4,4
Hurricane,Jeanne,43,2004-09-24T09:00:00Z,WILMINGTON NC,0,0,0,6,6
Hurricane,Jeanne,43,2004-09-24T09:00:00Z,GULF 28N 91W,0,0,0,2,2
Hurricane,Jeanne,43,2004-09-24T09:00:00Z,MOREHEAD CITY NC,0,0,0,5,5
Hurricane,Jeanne,44,2004-09-24T15:00:00Z,26.4N  76.6W,46,0,0,0,46
Hurricane,Jeanne,44,2004-09-24T15:00:00Z,CAPE HATTERAS NC,0,0,0,4,4
Hurricane,Jeanne,44,2004-09-24T15:00:00Z,26.8N  78.9W,8,23,0,0,31
Hurricane,Jeanne,44,2004-09-24T15:00:00Z,KEY WEST FL,0,2,4,1,7
Hurricane,Jeanne,44,2004-09-24T15:00:00Z,27.9N  80.7W,0,14,9,1,24
Hurricane,Jeanne,44,2004-09-24T15:00:00Z,MARCO ISLAND FL,0,5,9,1,15
Hurricane,Jeanne,44,2004-09-24T15:00:00Z,MYSM 241N 745W,5,0,0,0,5
Hurricane,Jeanne,44,2004-09-24T15:00:00Z,FT MYERS FL,0,4,11,2,17
Hurricane,Jeanne,44,2004-09-24T15:00:00Z,MYEG 235N 758W,2,0,0,0,2
Hurricane,Jeanne,44,2004-09-24T15:00:00Z,VENICE FL,0,1,12,3,16
Hurricane,Jeanne,44,2004-09-24T15:00:00Z,MYAK 241N 776W,4,6,0,0,10
Hurricane,Jeanne,44,2004-09-24T15:00:00Z,TAMPA FL,0,1,13,4,18
Hurricane,Jeanne,44,2004-09-24T15:00:00Z,MYNN 251N 775W,17,6,0,0,23
Hurricane,Jeanne,44,2004-09-24T15:00:00Z,CEDAR KEY FL,0,0,10,7,17
Hurricane,Jeanne,44,2004-09-24T15:00:00Z,MYGF 266N 787W,10,21,1,0,32
Hurricane,Jeanne,44,2004-09-24T15:00:00Z,ST MARKS FL,0,0,2,12,14
Hurricane,Jeanne,44,2004-09-24T15:00:00Z,MARATHON FL,0,4,5,1,10
Hurricane,Jeanne,44,2004-09-24T15:00:00Z,APALACHICOLA FL,0,0,2,11,13
Hurricane,Jeanne,44,2004-09-24T15:00:00Z,MIAMI FL,0,16,2,1,19
Hurricane,Jeanne,44,2004-09-24T15:00:00Z,PANAMA CITY FL,0,0,1,11,12
Hurricane,Jeanne,44,2004-09-24T15:00:00Z,W PALM BEACH FL,1,20,3,0,24
Hurricane,Jeanne,44,2004-09-24T15:00:00Z,PENSACOLA FL,0,0,0,9,9
Hurricane,Jeanne,44,2004-09-24T15:00:00Z,FT PIERCE FL,0,20,4,1,25
Hurricane,Jeanne,44,2004-09-24T15:00:00Z,MOBILE AL,0,0,0,7,7
Hurricane,Jeanne,44,2004-09-24T15:00:00Z,COCOA BEACH FL,0,14,9,1,24
Hurricane,Jeanne,44,2004-09-24T15:00:00Z,GULFPORT MS,0,0,0,5,5
Hurricane,Jeanne,44,2004-09-24T15:00:00Z,DAYTONA BEACH FL,0,4,14,3,21
Hurricane,Jeanne,44,2004-09-24T15:00:00Z,BURAS LA,0,0,0,4,4
Hurricane,Jeanne,44,2004-09-24T15:00:00Z,JACKSONVILLE FL,0,0,10,8,18
Hurricane,Jeanne,44,2004-09-24T15:00:00Z,NEW ORLEANS LA,0,0,0,4,4
Hurricane,Jeanne,44,2004-09-24T15:00:00Z,SAVANNAH GA,0,0,4,11,15
Hurricane,Jeanne,44,2004-09-24T15:00:00Z,NEW IBERIA LA,0,0,0,2,2
Hurricane,Jeanne,44,2004-09-24T15:00:00Z,CHARLESTON SC,0,0,2,11,13
Hurricane,Jeanne,44,2004-09-24T15:00:00Z,GULF 29N 85W,0,0,2,11,13
Hurricane,Jeanne,44,2004-09-24T15:00:00Z,MYRTLE BEACH SC,0,0,1,9,10
Hurricane,Jeanne,44,2004-09-24T15:00:00Z,GULF 29N 87W,0,0,0,8,8
Hurricane,Jeanne,44,2004-09-24T15:00:00Z,WILMINGTON NC,0,0,0,8,8
Hurricane,Jeanne,44,2004-09-24T15:00:00Z,GULF 28N 89W,0,0,0,4,4
Hurricane,Jeanne,44,2004-09-24T15:00:00Z,MOREHEAD CITY NC,0,0,0,6,6
Hurricane,Jeanne,44,2004-09-24T15:00:00Z,GULF 28N 91W,0,0,0,2,2
Hurricane,Jeanne,45,2004-09-24T21:00:00Z,26.6N  77.9W,46,0,0,0,46
Hurricane,Jeanne,45,2004-09-24T21:00:00Z,NORFOLK VA,0,0,0,4,4
Hurricane,Jeanne,45,2004-09-24T21:00:00Z,27.4N  80.2W,7,25,0,0,32
Hurricane,Jeanne,45,2004-09-24T21:00:00Z,KEY WEST FL,0,3,2,0,5
Hurricane,Jeanne,45,2004-09-24T21:00:00Z,29.0N  81.4W,0,17,7,1,25
Hurricane,Jeanne,45,2004-09-24T21:00:00Z,MARCO ISLAND FL,0,14,2,0,16
Hurricane,Jeanne,45,2004-09-24T21:00:00Z,MYAK 241N 776W,4,1,0,0,5
Hurricane,Jeanne,45,2004-09-24T21:00:00Z,FT MYERS FL,0,15,3,0,18
Hurricane,Jeanne,45,2004-09-24T21:00:00Z,MYNN 251N 775W,24,0,0,1,25
Hurricane,Jeanne,45,2004-09-24T21:00:00Z,VENICE FL,0,10,7,0,17
Hurricane,Jeanne,45,2004-09-24T21:00:00Z,MYGF 266N 787W,36,3,0,0,39
Hurricane,Jeanne,45,2004-09-24T21:00:00Z,TAMPA FL,0,10,9,1,20
Hurricane,Jeanne,45,2004-09-24T21:00:00Z,MARATHON FL,0,7,1,0,8
Hurricane,Jeanne,45,2004-09-24T21:00:00Z,CEDAR KEY FL,0,3,13,3,19
Hurricane,Jeanne,45,2004-09-24T21:00:00Z,MIAMI FL,5,17,0,0,22
Hurricane,Jeanne,45,2004-09-24T21:00:00Z,ST MARKS FL,0,0,8,7,15
Hurricane,Jeanne,45,2004-09-24T21:00:00Z,W PALM BEACH FL,9,21,1,0,31
Hurricane,Jeanne,45,2004-09-24T21:00:00Z,APALACHICOLA FL,0,0,5,8,13
Hurricane,Jeanne,45,2004-09-24T21:00:00Z,FT PIERCE FL,6,25,1,0,32
Hurricane,Jeanne,45,2004-09-24T21:00:00Z,PANAMA CITY FL,0,0,3,8,11
Hurricane,Jeanne,45,2004-09-24T21:00:00Z,COCOA BEACH FL,2,27,0,0,29
Hurricane,Jeanne,45,2004-09-24T21:00:00Z,PENSACOLA FL,0,0,0,8,8
Hurricane,Jeanne,45,2004-09-24T21:00:00Z,DAYTONA BEACH FL,0,18,6,1,25
Hurricane,Jeanne,45,2004-09-24T21:00:00Z,MOBILE AL,0,0,0,6,6
Hurricane,Jeanne,45,2004-09-24T21:00:00Z,JACKSONVILLE FL,0,4,14,3,21
Hurricane,Jeanne,45,2004-09-24T21:00:00Z,GULFPORT MS,0,0,0,4,4
Hurricane,Jeanne,45,2004-09-24T21:00:00Z,SAVANNAH GA,0,0,10,7,17
Hurricane,Jeanne,45,2004-09-24T21:00:00Z,BURAS LA,0,0,0,3,3
Hurricane,Jeanne,45,2004-09-24T21:00:00Z,CHARLESTON SC,0,0,6,10,16
Hurricane,Jeanne,45,2004-09-24T21:00:00Z,NEW ORLEANS LA,0,0,0,2,2
Hurricane,Jeanne,45,2004-09-24T21:00:00Z,MYRTLE BEACH SC,0,0,3,10,13
Hurricane,Jeanne,45,2004-09-24T21:00:00Z,GULF 29N 85W,0,0,6,6,12
Hurricane,Jeanne,45,2004-09-24T21:00:00Z,WILMINGTON NC,0,0,1,10,11
Hurricane,Jeanne,45,2004-09-24T21:00:00Z,GULF 29N 87W,0,0,1,6,7
Hurricane,Jeanne,45,2004-09-24T21:00:00Z,MOREHEAD CITY NC,0,0,0,9,9
Hurricane,Jeanne,45,2004-09-24T21:00:00Z,GULF 28N 89W,0,0,0,2,2
Hurricane,Jeanne,45,2004-09-24T21:00:00Z,CAPE HATTERAS NC,0,0,0,7,7
Hurricane,Jeanne,46,2004-09-25T03:00:00Z,27.2N  79.1W,46,0,0,0,46
Hurricane,Jeanne,46,2004-09-25T03:00:00Z,CAPE HATTERAS NC,0,0,0,7,7
Hurricane,Jeanne,46,2004-09-25T03:00:00Z,28.0N  81.0W,13,17,1,0,31
Hurricane,Jeanne,46,2004-09-25T03:00:00Z,NORFOLK VA,0,0,0,5,5
Hurricane,Jeanne,46,2004-09-25T03:00:00Z,29.5N  81.8W,1,19,3,1,24
Hurricane,Jeanne,46,2004-09-25T03:00:00Z,OCEAN CITY MD,0,0,0,2,2
Hurricane,Jeanne,46,2004-09-25T03:00:00Z,MYNN 251N 775W,21,0,0,0,21
Hurricane,Jeanne,46,2004-09-25T03:00:00Z,KEY WEST FL,0,2,1,0,3
Hurricane,Jeanne,46,2004-09-25T03:00:00Z,MYGF 266N 787W,47,0,0,0,47
Hurricane,Jeanne,46,2004-09-25T03:00:00Z,MARCO ISLAND FL,3,11,0,1,15
Hurricane,Jeanne,46,2004-09-25T03:00:00Z,MARATHON FL,1,3,1,0,5
Hurricane,Jeanne,46,2004-09-25T03:00:00Z,FT MYERS FL,2,15,1,0,18
Hurricane,Jeanne,46,2004-09-25T03:00:00Z,MIAMI FL,15,4,0,0,19
Hurricane,Jeanne,46,2004-09-25T03:00:00Z,VENICE FL,1,15,2,0,18
Hurricane,Jeanne,46,2004-09-25T03:00:00Z,W PALM BEACH FL,29,2,0,1,32
Hurricane,Jeanne,46,2004-09-25T03:00:00Z,TAMPA FL,0,19,2,0,21
Hurricane,Jeanne,46,2004-09-25T03:00:00Z,FT PIERCE FL,30,4,0,1,35
Hurricane,Jeanne,46,2004-09-25T03:00:00Z,CEDAR KEY FL,0,12,7,1,20
Hurricane,Jeanne,46,2004-09-25T03:00:00Z,COCOA BEACH FL,20,13,0,0,33
Hurricane,Jeanne,46,2004-09-25T03:00:00Z,ST MARKS FL,0,1,10,5,16
Hurricane,Jeanne,46,2004-09-25T03:00:00Z,DAYTONA BEACH FL,4,22,1,0,27
Hurricane,Jeanne,46,2004-09-25T03:00:00Z,APALACHICOLA FL,0,0,8,5,13
Hurricane,Jeanne,46,2004-09-25T03:00:00Z,JACKSONVILLE FL,0,12,8,2,22
Hurricane,Jeanne,46,2004-09-25T03:00:00Z,PANAMA CITY FL,0,0,5,6,11
Hurricane,Jeanne,46,2004-09-25T03:00:00Z,SAVANNAH GA,0,2,11,6,19
Hurricane,Jeanne,46,2004-09-25T03:00:00Z,PENSACOLA FL,0,0,1,5,6
Hurricane,Jeanne,46,2004-09-25T03:00:00Z,CHARLESTON SC,0,1,8,8,17
Hurricane,Jeanne,46,2004-09-25T03:00:00Z,MOBILE AL,0,0,0,4,4
Hurricane,Jeanne,46,2004-09-25T03:00:00Z,MYRTLE BEACH SC,0,0,4,11,15
Hurricane,Jeanne,46,2004-09-25T03:00:00Z,GULFPORT MS,0,0,0,2,2
Hurricane,Jeanne,46,2004-09-25T03:00:00Z,WILMINGTON NC,0,0,1,12,13
Hurricane,Jeanne,46,2004-09-25T03:00:00Z,GULF 29N 85W,0,1,8,3,12
Hurricane,Jeanne,46,2004-09-25T03:00:00Z,MOREHEAD CITY NC,0,0,0,10,10
Hurricane,Jeanne,46,2004-09-25T03:00:00Z,GULF 29N 87W,0,0,1,5,6
Hurricane,Jeanne,47,2004-09-25T09:00:00Z,27.3N  80.3W,45,0,0,0,45
Hurricane,Jeanne,47,2004-09-25T09:00:00Z,CAPE HATTERAS NC,0,0,0,7,7
Hurricane,Jeanne,47,2004-09-25T09:00:00Z,28.6N  81.9W,16,14,0,0,30
Hurricane,Jeanne,47,2004-09-25T09:00:00Z,NORFOLK VA,0,0,0,7,7
Hurricane,Jeanne,47,2004-09-25T09:00:00Z,30.4N  82.5W,1,17,5,1,24
Hurricane,Jeanne,47,2004-09-25T09:00:00Z,OCEAN CITY MD,0,0,0,3,3
Hurricane,Jeanne,47,2004-09-25T09:00:00Z,MYNN 251N 775W,18,0,0,0,18
Hurricane,Jeanne,47,2004-09-25T09:00:00Z,KEY WEST FL,1,2,1,0,4
Hurricane,Jeanne,47,2004-09-25T09:00:00Z,MYGF 266N 787W,62,0,0,0,62
Hurricane,Jeanne,47,2004-09-25T09:00:00Z,MARCO ISLAND FL,13,5,1,0,19
Hurricane,Jeanne,47,2004-09-25T09:00:00Z,MARATHON FL,4,3,0,0,7
Hurricane,Jeanne,47,2004-09-25T09:00:00Z,FT MYERS FL,16,7,0,0,23
Hurricane,Jeanne,47,2004-09-25T09:00:00Z,MIAMI FL,26,0,1,0,27
Hurricane,Jeanne,47,2004-09-25T09:00:00Z,VENICE FL,9,13,0,0,22
Hurricane,Jeanne,47,2004-09-25T09:00:00Z,W PALM BEACH FL,43,0,0,0,43
Hurricane,Jeanne,47,2004-09-25T09:00:00Z,TAMPA FL,9,16,1,0,26
Hurricane,Jeanne,47,2004-09-25T09:00:00Z,FT PIERCE FL,45,0,0,0,45
Hurricane,Jeanne,47,2004-09-25T09:00:00Z,CEDAR KEY FL,2,19,2,1,24
Hurricane,Jeanne,47,2004-09-25T09:00:00Z,COCOA BEACH FL,40,0,0,0,40
Hurricane,Jeanne,47,2004-09-25T09:00:00Z,ST MARKS FL,0,7,10,2,19
Hurricane,Jeanne,47,2004-09-25T09:00:00Z,DAYTONA BEACH FL,21,11,0,0,32
Hurricane,Jeanne,47,2004-09-25T09:00:00Z,APALACHICOLA FL,0,4,9,2,15
Hurricane,Jeanne,47,2004-09-25T09:00:00Z,JACKSONVILLE FL,2,19,3,1,25
Hurricane,Jeanne,47,2004-09-25T09:00:00Z,PANAMA CITY FL,0,1,9,3,13
Hurricane,Jeanne,47,2004-09-25T09:00:00Z,SAVANNAH GA,0,8,10,3,21
Hurricane,Jeanne,47,2004-09-25T09:00:00Z,PENSACOLA FL,0,0,3,4,7
Hurricane,Jeanne,47,2004-09-25T09:00:00Z,CHARLESTON SC,0,3,9,6,18
Hurricane,Jeanne,47,2004-09-25T09:00:00Z,MOBILE AL,0,0,1,3,4
Hurricane,Jeanne,47,2004-09-25T09:00:00Z,MYRTLE BEACH SC,0,0,6,9,15
Hurricane,Jeanne,47,2004-09-25T09:00:00Z,GULFPORT MS,0,0,0,2,2
Hurricane,Jeanne,47,2004-09-25T09:00:00Z,WILMINGTON NC,0,0,2,11,13
Hurricane,Jeanne,47,2004-09-25T09:00:00Z,GULF 29N 85W,0,5,8,1,14
Hurricane,Jeanne,47,2004-09-25T09:00:00Z,MOREHEAD CITY NC,0,0,1,9,10
Hurricane,Jeanne,47,2004-09-25T09:00:00Z,GULF 29N 87W,0,0,3,3,6
Hurricane,Jeanne,48,2004-09-25T15:00:00Z,28.0N  81.5W,49,0,0,0,49
Hurricane,Jeanne,48,2004-09-25T15:00:00Z,NORFOLK VA,0,0,0,12,12
Hurricane,Jeanne,48,2004-09-25T15:00:00Z,29.5N  82.5W,22,10,0,0,32
Hurricane,Jeanne,48,2004-09-25T15:00:00Z,OCEAN CITY MD,0,0,0,6,6
Hurricane,Jeanne,48,2004-09-25T15:00:00Z,31.0N  83.0W,1,20,3,0,24
Hurricane,Jeanne,48,2004-09-25T15:00:00Z,ATLANTIC CITY NJ,0,0,0,3,3
Hurricane,Jeanne,48,2004-09-25T15:00:00Z,MYGF 266N 787W,99,0,0,0,99
Hurricane,Jeanne,48,2004-09-25T15:00:00Z,MARCO ISLAND FL,20,0,0,0,20
Hurricane,Jeanne,48,2004-09-25T15:00:00Z,MARATHON FL,2,0,0,0,2
Hurricane,Jeanne,48,2004-09-25T15:00:00Z,FT MYERS FL,28,1,0,0,29
Hurricane,Jeanne,48,2004-09-25T15:00:00Z,MIAMI FL,30,0,0,0,30
Hurricane,Jeanne,48,2004-09-25T15:00:00Z,VENICE FL,27,0,0,1,28
Hurricane,Jeanne,48,2004-09-25T15:00:00Z,W PALM BEACH FL,58,0,0,0,58
Hurricane,Jeanne,48,2004-09-25T15:00:00Z,TAMPA FL,33,1,0,0,34
Hurricane,Jeanne,48,2004-09-25T15:00:00Z,FT PIERCE FL,66,0,0,0,66
Hurricane,Jeanne,48,2004-09-25T15:00:00Z,CEDAR KEY FL,18,11,1,0,30
Hurricane,Jeanne,48,2004-09-25T15:00:00Z,COCOA BEACH FL,57,0,0,0,57
Hurricane,Jeanne,48,2004-09-25T15:00:00Z,ST MARKS FL,1,15,4,1,21
Hurricane,Jeanne,48,2004-09-25T15:00:00Z,DAYTONA BEACH FL,42,0,0,0,42
Hurricane,Jeanne,48,2004-09-25T15:00:00Z,APALACHICOLA FL,0,11,4,1,16
Hurricane,Jeanne,48,2004-09-25T15:00:00Z,JACKSONVILLE FL,15,13,1,0,29
Hurricane,Jeanne,48,2004-09-25T15:00:00Z,PANAMA CITY FL,0,5,8,1,14
Hurricane,Jeanne,48,2004-09-25T15:00:00Z,SAVANNAH GA,1,14,5,2,22
Hurricane,Jeanne,48,2004-09-25T15:00:00Z,PENSACOLA FL,0,0,5,3,8
Hurricane,Jeanne,48,2004-09-25T15:00:00Z,CHARLESTON SC,0,6,7,6,19
Hurricane,Jeanne,48,2004-09-25T15:00:00Z,MOBILE AL,0,0,2,2,4
Hurricane,Jeanne,48,2004-09-25T15:00:00Z,MYRTLE BEACH SC,0,1,6,11,18
Hurricane,Jeanne,48,2004-09-25T15:00:00Z,GULFPORT MS,0,0,1,1,2
Hurricane,Jeanne,48,2004-09-25T15:00:00Z,WILMINGTON NC,0,0,3,14,17
Hurricane,Jeanne,48,2004-09-25T15:00:00Z,GULF 29N 85W,0,11,3,1,15
Hurricane,Jeanne,48,2004-09-25T15:00:00Z,MOREHEAD CITY NC,0,0,1,14,15
Hurricane,Jeanne,48,2004-09-25T15:00:00Z,GULF 29N 87W,0,1,4,1,6
Hurricane,Jeanne,48,2004-09-25T15:00:00Z,CAPE HATTERAS NC,0,0,0,12,12
Hurricane,Jeanne,49,2004-09-25T21:00:00Z,28.7N  82.3W,47,0,0,0,47
Hurricane,Jeanne,49,2004-09-25T21:00:00Z,NEW YORK CITY NY,0,0,0,7,7
Hurricane,Jeanne,49,2004-09-25T21:00:00Z,30.2N  83.3W,22,9,0,0,31
Hurricane,Jeanne,49,2004-09-25T21:00:00Z,MONTAUK POINT NY,0,0,0,4,4
Hurricane,Jeanne,49,2004-09-25T21:00:00Z,32.5N  83.0W,1,15,7,0,23
Hurricane,Jeanne,49,2004-09-25T21:00:00Z,PROVIDENCE RI,0,0,0,2,2
Hurricane,Jeanne,49,2004-09-25T21:00:00Z,MYGF 266N 787W,99,0,0,0,99
Hurricane,Jeanne,49,2004-09-25T21:00:00Z,NANTUCKET MA,0,0,0,2,2
Hurricane,Jeanne,49,2004-09-25T21:00:00Z,MIAMI FL,2,0,0,0,2
Hurricane,Jeanne,49,2004-09-25T21:00:00Z,HYANNIS MA,0,0,0,2,2
Hurricane,Jeanne,49,2004-09-25T21:00:00Z,W PALM BEACH FL,63,0,0,0,63
Hurricane,Jeanne,49,2004-09-25T21:00:00Z,MARCO ISLAND FL,7,0,0,0,7
Hurricane,Jeanne,49,2004-09-25T21:00:00Z,FT PIERCE FL,78,0,0,0,78
Hurricane,Jeanne,49,2004-09-25T21:00:00Z,FT MYERS FL,23,0,0,0,23
Hurricane,Jeanne,49,2004-09-25T21:00:00Z,COCOA BEACH FL,77,0,0,0,77
Hurricane,Jeanne,49,2004-09-25T21:00:00Z,VENICE FL,27,0,0,0,27
Hurricane,Jeanne,49,2004-09-25T21:00:00Z,DAYTONA BEACH FL,52,0,0,1,53
Hurricane,Jeanne,49,2004-09-25T21:00:00Z,TAMPA FL,40,0,0,0,40
Hurricane,Jeanne,49,2004-09-25T21:00:00Z,JACKSONVILLE FL,30,3,0,0,33
Hurricane,Jeanne,49,2004-09-25T21:00:00Z,CEDAR KEY FL,38,0,0,0,38
Hurricane,Jeanne,49,2004-09-25T21:00:00Z,SAVANNAH GA,4,15,3,0,22
Hurricane,Jeanne,49,2004-09-25T21:00:00Z,ST MARKS FL,8,17,0,0,25
Hurricane,Jeanne,49,2004-09-25T21:00:00Z,CHARLESTON SC,0,8,8,2,18
Hurricane,Jeanne,49,2004-09-25T21:00:00Z,APALACHICOLA FL,3,16,1,0,20
Hurricane,Jeanne,49,2004-09-25T21:00:00Z,MYRTLE BEACH SC,0,2,8,6,16
Hurricane,Jeanne,49,2004-09-25T21:00:00Z,PANAMA CITY FL,1,13,2,0,16
Hurricane,Jeanne,49,2004-09-25T21:00:00Z,WILMINGTON NC,0,0,6,10,16
Hurricane,Jeanne,49,2004-09-25T21:00:00Z,PENSACOLA FL,0,2,6,0,8
Hurricane,Jeanne,49,2004-09-25T21:00:00Z,MOREHEAD CITY NC,0,0,2,13,15
Hurricane,Jeanne,49,2004-09-25T21:00:00Z,MOBILE AL,0,0,3,1,4
Hurricane,Jeanne,49,2004-09-25T21:00:00Z,CAPE HATTERAS NC,0,0,1,14,15
Hurricane,Jeanne,49,2004-09-25T21:00:00Z,GULFPORT MS,0,0,1,1,2
Hurricane,Jeanne,49,2004-09-25T21:00:00Z,NORFOLK VA,0,0,0,17,17
Hurricane,Jeanne,49,2004-09-25T21:00:00Z,GULF 29N 85W,5,12,1,0,18
Hurricane,Jeanne,49,2004-09-25T21:00:00Z,OCEAN CITY MD,0,0,0,14,14
Hurricane,Jeanne,49,2004-09-25T21:00:00Z,GULF 29N 87W,0,3,3,0,6
Hurricane,Jeanne,49,2004-09-25T21:00:00Z,ATLANTIC CITY NJ,0,0,0,11,11
Hurricane,Jeanne,50,2004-09-26T03:00:00Z,29.2N  82.9W,46,0,0,0,46
Hurricane,Jeanne,50,2004-09-26T03:00:00Z,MONTAUK POINT NY,0,0,0,5,5
Hurricane,Jeanne,50,2004-09-26T03:00:00Z,31.0N  83.5W,18,10,0,1,29
Hurricane,Jeanne,50,2004-09-26T03:00:00Z,PROVIDENCE RI,0,0,0,3,3
Hurricane,Jeanne,50,2004-09-26T03:00:00Z,33.0N  83.0W,0,15,5,1,21
Hurricane,Jeanne,50,2004-09-26T03:00:00Z,NANTUCKET MA,0,0,0,2,2
Hurricane,Jeanne,50,2004-09-26T03:00:00Z,MYGF 266N 787W,99,0,0,0,99
Hurricane,Jeanne,50,2004-09-26T03:00:00Z,HYANNIS MA,0,0,0,2,2
Hurricane,Jeanne,50,2004-09-26T03:00:00Z,W PALM BEACH FL,99,0,0,0,99
Hurricane,Jeanne,50,2004-09-26T03:00:00Z,BOSTON MA,0,0,0,2,2
Hurricane,Jeanne,50,2004-09-26T03:00:00Z,FT PIERCE FL,99,0,0,0,99
Hurricane,Jeanne,50,2004-09-26T03:00:00Z,MARCO ISLAND FL,2,0,0,0,2
Hurricane,Jeanne,50,2004-09-26T03:00:00Z,COCOA BEACH FL,81,0,0,0,81
Hurricane,Jeanne,50,2004-09-26T03:00:00Z,FT MYERS FL,22,0,0,0,22
Hurricane,Jeanne,50,2004-09-26T03:00:00Z,DAYTONA BEACH FL,56,0,0,0,56
Hurricane,Jeanne,50,2004-09-26T03:00:00Z,VENICE FL,33,0,0,0,33
Hurricane,Jeanne,50,2004-09-26T03:00:00Z,JACKSONVILLE FL,32,1,0,0,33
Hurricane,Jeanne,50,2004-09-26T03:00:00Z,TAMPA FL,52,0,0,0,52
Hurricane,Jeanne,50,2004-09-26T03:00:00Z,SAVANNAH GA,7,12,1,1,21
Hurricane,Jeanne,50,2004-09-26T03:00:00Z,CEDAR KEY FL,45,0,0,0,45
Hurricane,Jeanne,50,2004-09-26T03:00:00Z,CHARLESTON SC,1,9,5,2,17
Hurricane,Jeanne,50,2004-09-26T03:00:00Z,ST MARKS FL,22,6,0,0,28
Hurricane,Jeanne,50,2004-09-26T03:00:00Z,MYRTLE BEACH SC,0,3,7,6,16
Hurricane,Jeanne,50,2004-09-26T03:00:00Z,APALACHICOLA FL,14,7,0,1,22
Hurricane,Jeanne,50,2004-09-26T03:00:00Z,WILMINGTON NC,0,1,5,10,16
Hurricane,Jeanne,50,2004-09-26T03:00:00Z,PANAMA CITY FL,5,12,1,0,18
Hurricane,Jeanne,50,2004-09-26T03:00:00Z,MOREHEAD CITY NC,0,0,3,12,15
Hurricane,Jeanne,50,2004-09-26T03:00:00Z,PENSACOLA FL,0,7,2,0,9
Hurricane,Jeanne,50,2004-09-26T03:00:00Z,CAPE HATTERAS NC,0,0,1,14,15
Hurricane,Jeanne,50,2004-09-26T03:00:00Z,MOBILE AL,0,2,3,1,6
Hurricane,Jeanne,50,2004-09-26T03:00:00Z,NORFOLK VA,0,0,0,18,18
Hurricane,Jeanne,50,2004-09-26T03:00:00Z,GULFPORT MS,0,1,1,1,3
Hurricane,Jeanne,50,2004-09-26T03:00:00Z,OCEAN CITY MD,0,0,0,16,16
Hurricane,Jeanne,50,2004-09-26T03:00:00Z,GULF 29N 85W,16,4,0,0,20
Hurricane,Jeanne,50,2004-09-26T03:00:00Z,ATLANTIC CITY NJ,0,0,0,14,14
Hurricane,Jeanne,50,2004-09-26T03:00:00Z,GULF 29N 87W,0,5,1,0,6
Hurricane,Jeanne,50,2004-09-26T03:00:00Z,NEW YORK CITY NY,0,0,0,9,9
Hurricane,Jeanne,51,2004-09-26T09:00:00Z,29.7N  83.6W,50,0,0,0,50
Hurricane,Jeanne,51,2004-09-26T09:00:00Z,MONTAUK POINT NY,0,0,0,11,11
Hurricane,Jeanne,51,2004-09-26T09:00:00Z,31.8N  83.9W,18,13,1,0,32
Hurricane,Jeanne,51,2004-09-26T09:00:00Z,PROVIDENCE RI,0,0,0,9,9
Hurricane,Jeanne,51,2004-09-26T09:00:00Z,34.0N  82.5W,0,14,8,0,22
Hurricane,Jeanne,51,2004-09-26T09:00:00Z,NANTUCKET MA,0,0,0,7,7
Hurricane,Jeanne,51,2004-09-26T09:00:00Z,W PALM BEACH FL,99,0,0,0,99
Hurricane,Jeanne,51,2004-09-26T09:00:00Z,HYANNIS MA,0,0,0,7,7
Hurricane,Jeanne,51,2004-09-26T09:00:00Z,FT PIERCE FL,99,0,0,0,99
Hurricane,Jeanne,51,2004-09-26T09:00:00Z,BOSTON MA,0,0,0,6,6
Hurricane,Jeanne,51,2004-09-26T09:00:00Z,COCOA BEACH FL,99,0,0,0,99
Hurricane,Jeanne,51,2004-09-26T09:00:00Z,PORTLAND ME,0,0,0,3,3
Hurricane,Jeanne,51,2004-09-26T09:00:00Z,DAYTONA BEACH FL,51,0,0,0,51
Hurricane,Jeanne,51,2004-09-26T09:00:00Z,FT MYERS FL,22,0,0,0,22
Hurricane,Jeanne,51,2004-09-26T09:00:00Z,JACKSONVILLE FL,33,0,0,0,33
Hurricane,Jeanne,51,2004-09-26T09:00:00Z,VENICE FL,52,0,0,0,52
Hurricane,Jeanne,51,2004-09-26T09:00:00Z,SAVANNAH GA,7,12,1,1,21
Hurricane,Jeanne,51,2004-09-26T09:00:00Z,TAMPA FL,74,0,0,0,74
Hurricane,Jeanne,51,2004-09-26T09:00:00Z,CHARLESTON SC,0,9,7,1,17
Hurricane,Jeanne,51,2004-09-26T09:00:00Z,CEDAR KEY FL,63,0,0,0,63
Hurricane,Jeanne,51,2004-09-26T09:00:00Z,MYRTLE BEACH SC,0,2,10,5,17
Hurricane,Jeanne,51,2004-09-26T09:00:00Z,ST MARKS FL,41,0,0,0,41
Hurricane,Jeanne,51,2004-09-26T09:00:00Z,WILMINGTON NC,0,0,8,9,17
Hurricane,Jeanne,51,2004-09-26T09:00:00Z,APALACHICOLA FL,30,1,0,1,32
Hurricane,Jeanne,51,2004-09-26T09:00:00Z,MOREHEAD CITY NC,0,0,4,12,16
Hurricane,Jeanne,51,2004-09-26T09:00:00Z,PANAMA CITY FL,17,6,1,0,24
Hurricane,Jeanne,51,2004-09-26T09:00:00Z,CAPE HATTERAS NC,0,0,2,14,16
Hurricane,Jeanne,51,2004-09-26T09:00:00Z,PENSACOLA FL,1,8,1,0,10
Hurricane,Jeanne,51,2004-09-26T09:00:00Z,NORFOLK VA,0,0,1,18,19
Hurricane,Jeanne,51,2004-09-26T09:00:00Z,MOBILE AL,0,3,1,0,4
Hurricane,Jeanne,51,2004-09-26T09:00:00Z,OCEAN CITY MD,0,0,0,19,19
Hurricane,Jeanne,51,2004-09-26T09:00:00Z,GULF 29N 85W,29,0,1,0,30
Hurricane,Jeanne,51,2004-09-26T09:00:00Z,ATLANTIC CITY NJ,0,0,0,18,18
Hurricane,Jeanne,51,2004-09-26T09:00:00Z,GULF 29N 87W,2,4,0,0,6
Hurricane,Jeanne,51,2004-09-26T09:00:00Z,NEW YORK CITY NY,0,0,0,15,15
Hurricane,Jeanne,52,2004-09-26T15:00:00Z,30.8N  83.8W,46,0,0,0,46
Hurricane,Jeanne,52,2004-09-26T15:00:00Z,NANTUCKET MA,0,0,0,9,9
Hurricane,Jeanne,52,2004-09-26T15:00:00Z,33.1N  83.2W,6,21,0,0,27
Hurricane,Jeanne,52,2004-09-26T15:00:00Z,HYANNIS MA,0,0,0,9,9
Hurricane,Jeanne,52,2004-09-26T15:00:00Z,35.6N  80.4W,0,3,17,1,21
Hurricane,Jeanne,52,2004-09-26T15:00:00Z,BOSTON MA,0,0,0,9,9
Hurricane,Jeanne,52,2004-09-26T15:00:00Z,FT PIERCE FL,17,0,0,0,17
Hurricane,Jeanne,52,2004-09-26T15:00:00Z,PORTLAND ME,0,0,0,6,6
Hurricane,Jeanne,52,2004-09-26T15:00:00Z,COCOA BEACH FL,99,0,0,0,99
Hurricane,Jeanne,52,2004-09-26T15:00:00Z,BAR HARBOR ME,0,0,0,3,3
Hurricane,Jeanne,52,2004-09-26T15:00:00Z,DAYTONA BEACH FL,64,0,0,0,64
Hurricane,Jeanne,52,2004-09-26T15:00:00Z,EASTPORT ME,0,0,0,2,2
Hurricane,Jeanne,52,2004-09-26T15:00:00Z,JACKSONVILLE FL,36,0,0,0,36
Hurricane,Jeanne,52,2004-09-26T15:00:00Z,YARMOUTH NS,0,0,0,2,2
Hurricane,Jeanne,52,2004-09-26T15:00:00Z,SAVANNAH GA,8,13,1,0,22
Hurricane,Jeanne,52,2004-09-26T15:00:00Z,FT MYERS FL,9,0,0,0,9
Hurricane,Jeanne,52,2004-09-26T15:00:00Z,CHARLESTON SC,0,13,5,0,18
Hurricane,Jeanne,52,2004-09-26T15:00:00Z,VENICE FL,99,0,0,0,99
Hurricane,Jeanne,52,2004-09-26T15:00:00Z,MYRTLE BEACH SC,0,5,11,1,17
Hurricane,Jeanne,52,2004-09-26T15:00:00Z,TAMPA FL,99,0,0,0,99
Hurricane,Jeanne,52,2004-09-26T15:00:00Z,WILMINGTON NC,0,1,12,2,15
Hurricane,Jeanne,52,2004-09-26T15:00:00Z,CEDAR KEY FL,82,0,0,0,82
Hurricane,Jeanne,52,2004-09-26T15:00:00Z,MOREHEAD CITY NC,0,0,9,5,14
Hurricane,Jeanne,52,2004-09-26T15:00:00Z,ST MARKS FL,48,0,0,0,48
Hurricane,Jeanne,52,2004-09-26T15:00:00Z,CAPE HATTERAS NC,0,0,5,9,14
Hurricane,Jeanne,52,2004-09-26T15:00:00Z,APALACHICOLA FL,33,0,0,0,33
Hurricane,Jeanne,52,2004-09-26T15:00:00Z,NORFOLK VA,0,0,5,11,16
Hurricane,Jeanne,52,2004-09-26T15:00:00Z,PANAMA CITY FL,24,0,0,0,24
Hurricane,Jeanne,52,2004-09-26T15:00:00Z,OCEAN CITY MD,0,0,1,14,15
Hurricane,Jeanne,52,2004-09-26T15:00:00Z,PENSACOLA FL,4,3,0,0,7
Hurricane,Jeanne,52,2004-09-26T15:00:00Z,ATLANTIC CITY NJ,0,0,0,15,15
Hurricane,Jeanne,52,2004-09-26T15:00:00Z,MOBILE AL,1,1,0,0,2
Hurricane,Jeanne,52,2004-09-26T15:00:00Z,NEW YORK CITY NY,0,0,0,13,13
Hurricane,Jeanne,52,2004-09-26T15:00:00Z,GULF 29N 85W,27,1,0,0,28
Hurricane,Jeanne,52,2004-09-26T15:00:00Z,MONTAUK POINT NY,0,0,0,11,11
Hurricane,Jeanne,52,2004-09-26T15:00:00Z,GULF 29N 87W,1,1,0,0,2
Hurricane,Jeanne,52,2004-09-26T15:00:00Z,PROVIDENCE RI,0,0,0,10,10
Tropical Storm,Jeanne,53,2004-09-26T21:00:00Z,31.9N  83.5W,37,0,0,0,37
Tropical Storm,Jeanne,53,2004-09-26T21:00:00Z,PROVIDENCE RI,0,0,0,8,8
Tropical Storm,Jeanne,53,2004-09-26T21:00:00Z,34.2N  82.0W,3,20,3,0,26
Tropical Storm,Jeanne,53,2004-09-26T21:00:00Z,NANTUCKET MA,0,0,0,8,8
Tropical Storm,Jeanne,53,2004-09-26T21:00:00Z,36.5N  78.0W,0,1,13,3,17
Tropical Storm,Jeanne,53,2004-09-26T21:00:00Z,HYANNIS MA,0,0,0,8,8
Tropical Storm,Jeanne,53,2004-09-26T21:00:00Z,BERMUDA,0,0,0,2,2
Tropical Storm,Jeanne,53,2004-09-26T21:00:00Z,BOSTON MA,0,0,0,7,7
Tropical Storm,Jeanne,53,2004-09-26T21:00:00Z,COCOA BEACH FL,2,0,0,0,2
Tropical Storm,Jeanne,53,2004-09-26T21:00:00Z,PORTLAND ME,0,0,0,5,5
Tropical Storm,Jeanne,53,2004-09-26T21:00:00Z,DAYTONA BEACH FL,99,0,0,0,99
Tropical Storm,Jeanne,53,2004-09-26T21:00:00Z,BAR HARBOR ME,0,0,0,3,3
Tropical Storm,Jeanne,53,2004-09-26T21:00:00Z,JACKSONVILLE FL,34,0,0,0,34
Tropical Storm,Jeanne,53,2004-09-26T21:00:00Z,EASTPORT ME,0,0,0,2,2
Tropical Storm,Jeanne,53,2004-09-26T21:00:00Z,SAVANNAH GA,12,9,0,0,21
Tropical Storm,Jeanne,53,2004-09-26T21:00:00Z,YARMOUTH NS,0,0,0,2,2
Tropical Storm,Jeanne,53,2004-09-26T21:00:00Z,CHARLESTON SC,1,13,4,0,18
Tropical Storm,Jeanne,53,2004-09-26T21:00:00Z,VENICE FL,86,0,0,0,86
Tropical Storm,Jeanne,53,2004-09-26T21:00:00Z,MYRTLE BEACH SC,0,7,10,0,17
Tropical Storm,Jeanne,53,2004-09-26T21:00:00Z,TAMPA FL,99,0,0,0,99
Tropical Storm,Jeanne,53,2004-09-26T21:00:00Z,WILMINGTON NC,0,3,12,1,16
Tropical Storm,Jeanne,53,2004-09-26T21:00:00Z,CEDAR KEY FL,99,0,0,0,99
Tropical Storm,Jeanne,53,2004-09-26T21:00:00Z,MOREHEAD CITY NC,0,1,11,2,14
Tropical Storm,Jeanne,53,2004-09-26T21:00:00Z,ST MARKS FL,50,0,0,0,50
Tropical Storm,Jeanne,53,2004-09-26T21:00:00Z,CAPE HATTERAS NC,0,0,9,4,13
Tropical Storm,Jeanne,53,2004-09-26T21:00:00Z,APALACHICOLA FL,35,0,0,0,35
Tropical Storm,Jeanne,53,2004-09-26T21:00:00Z,NORFOLK VA,0,0,8,7,15
Tropical Storm,Jeanne,53,2004-09-26T21:00:00Z,PANAMA CITY FL,26,0,0,0,26
Tropical Storm,Jeanne,53,2004-09-26T21:00:00Z,OCEAN CITY MD,0,0,3,11,14
Tropical Storm,Jeanne,53,2004-09-26T21:00:00Z,PENSACOLA FL,9,2,0,0,11
Tropical Storm,Jeanne,53,2004-09-26T21:00:00Z,ATLANTIC CITY NJ,0,0,1,11,12
Tropical Storm,Jeanne,53,2004-09-26T21:00:00Z,MOBILE AL,2,0,0,0,2
Tropical Storm,Jeanne,53,2004-09-26T21:00:00Z,NEW YORK CITY NY,0,0,0,11,11
Tropical Storm,Jeanne,53,2004-09-26T21:00:00Z,GULF 29N 85W,24,0,0,0,24
Tropical Storm,Jeanne,53,2004-09-26T21:00:00Z,MONTAUK POINT NY,0,0,0,9,9
Tropical Storm,Jeanne,53,2004-09-26T21:00:00Z,GULF 29N 87W,2,0,0,0,2
Tropical Storm,Jeanne,54,2004-09-27T03:00:00Z,34.0N  82.5W,33,0,0,0,33
Tropical Storm,Jeanne,54,2004-09-27T03:00:00Z,PROVIDENCE RI,0,0,1,10,11
Tropical Storm,Jeanne,54,2004-09-27T03:00:00Z,35.5N  80.2W,5,15,1,1,22
Tropical Storm,Jeanne,54,2004-09-27T03:00:00Z,NANTUCKET MA,0,0,1,10,11
Tropical Storm,Jeanne,54,2004-09-27T03:00:00Z,37.7N  75.8W,0,1,14,1,16
Tropical Storm,Jeanne,54,2004-09-27T03:00:00Z,HYANNIS MA,0,0,0,11,11
Tropical Storm,Jeanne,54,2004-09-27T03:00:00Z,BERMUDA,0,0,0,2,2
Tropical Storm,Jeanne,54,2004-09-27T03:00:00Z,BOSTON MA,0,0,0,10,10
Tropical Storm,Jeanne,54,2004-09-27T03:00:00Z,DAYTONA BEACH FL,50,0,0,0,50
Tropical Storm,Jeanne,54,2004-09-27T03:00:00Z,PORTLAND ME,0,0,0,8,8
Tropical Storm,Jeanne,54,2004-09-27T03:00:00Z,JACKSONVILLE FL,88,0,0,0,88
Tropical Storm,Jeanne,54,2004-09-27T03:00:00Z,BAR HARBOR ME,0,0,0,7,7
Tropical Storm,Jeanne,54,2004-09-27T03:00:00Z,SAVANNAH GA,39,0,0,0,39
Tropical Storm,Jeanne,54,2004-09-27T03:00:00Z,EASTPORT ME,0,0,0,6,6
Tropical Storm,Jeanne,54,2004-09-27T03:00:00Z,CHARLESTON SC,17,3,0,0,20
Tropical Storm,Jeanne,54,2004-09-27T03:00:00Z,ST JOHN NB,0,0,0,4,4
Tropical Storm,Jeanne,54,2004-09-27T03:00:00Z,MYRTLE BEACH SC,5,12,2,0,19
Tropical Storm,Jeanne,54,2004-09-27T03:00:00Z,MONCTON NB,0,0,0,3,3
Tropical Storm,Jeanne,54,2004-09-27T03:00:00Z,WILMINGTON NC,1,13,5,0,19
Tropical Storm,Jeanne,54,2004-09-27T03:00:00Z,YARMOUTH NS,0,0,0,6,6
Tropical Storm,Jeanne,54,2004-09-27T03:00:00Z,MOREHEAD CITY NC,0,9,9,0,18
Tropical Storm,Jeanne,54,2004-09-27T03:00:00Z,HALIFAX NS,0,0,0,4,4
Tropical Storm,Jeanne,54,2004-09-27T03:00:00Z,CAPE HATTERAS NC,0,4,12,1,17
Tropical Storm,Jeanne,54,2004-09-27T03:00:00Z,SABLE ISLAND NS,0,0,0,2,2
Tropical Storm,Jeanne,54,2004-09-27T03:00:00Z,NORFOLK VA,0,3,14,1,18
Tropical Storm,Jeanne,54,2004-09-27T03:00:00Z,EDDY POINT NS,0,0,0,2,2
Tropical Storm,Jeanne,54,2004-09-27T03:00:00Z,OCEAN CITY MD,0,0,12,3,15
Tropical Storm,Jeanne,54,2004-09-27T03:00:00Z,TAMPA FL,2,0,0,0,2
Tropical Storm,Jeanne,54,2004-09-27T03:00:00Z,ATLANTIC CITY NJ,0,0,8,6,14
Tropical Storm,Jeanne,54,2004-09-27T03:00:00Z,CEDAR KEY FL,99,0,0,0,99
Tropical Storm,Jeanne,54,2004-09-27T03:00:00Z,NEW YORK CITY NY,0,0,4,9,13
Tropical Storm,Jeanne,54,2004-09-27T03:00:00Z,ST MARKS FL,35,0,0,0,35
Tropical Storm,Jeanne,54,2004-09-27T03:00:00Z,MONTAUK POINT NY,0,0,2,10,12
Tropical Storm,Jeanne,55,2004-09-27T09:00:00Z,33.7N  82.9W,46,1,0,0,47
Tropical Storm,Jeanne,55,2004-09-27T09:00:00Z,NEW YORK CITY NY,0,0,1,8,9
Tropical Storm,Jeanne,55,2004-09-27T09:00:00Z,35.5N  80.0W,4,19,1,0,24
Tropical Storm,Jeanne,55,2004-09-27T09:00:00Z,MONTAUK POINT NY,0,0,0,8,8
Tropical Storm,Jeanne,55,2004-09-27T09:00:00Z,36.5N  76.0W,0,3,11,2,16
Tropical Storm,Jeanne,55,2004-09-27T09:00:00Z,PROVIDENCE RI,0,0,0,7,7
Tropical Storm,Jeanne,55,2004-09-27T09:00:00Z,BERMUDA,0,0,0,4,4
Tropical Storm,Jeanne,55,2004-09-27T09:00:00Z,NANTUCKET MA,0,0,0,7,7
Tropical Storm,Jeanne,55,2004-09-27T09:00:00Z,JACKSONVILLE FL,12,1,1,0,14
Tropical Storm,Jeanne,55,2004-09-27T09:00:00Z,HYANNIS MA,0,0,0,6,6
Tropical Storm,Jeanne,55,2004-09-27T09:00:00Z,SAVANNAH GA,14,6,0,0,20
Tropical Storm,Jeanne,55,2004-09-27T09:00:00Z,BOSTON MA,0,0,0,5,5
Tropical Storm,Jeanne,55,2004-09-27T09:00:00Z,CHARLESTON SC,4,14,0,0,18
Tropical Storm,Jeanne,55,2004-09-27T09:00:00Z,PORTLAND ME,0,0,0,3,3
Tropical Storm,Jeanne,55,2004-09-27T09:00:00Z,MYRTLE BEACH SC,1,15,2,0,18
Tropical Storm,Jeanne,55,2004-09-27T09:00:00Z,BAR HARBOR ME,0,0,0,2,2
Tropical Storm,Jeanne,55,2004-09-27T09:00:00Z,WILMINGTON NC,0,12,5,1,18
Tropical Storm,Jeanne,55,2004-09-27T09:00:00Z,CEDAR KEY FL,99,0,0,0,99
Tropical Storm,Jeanne,55,2004-09-27T09:00:00Z,MOREHEAD CITY NC,0,7,9,0,16
Tropical Storm,Jeanne,55,2004-09-27T09:00:00Z,ST MARKS FL,99,0,0,0,99
Tropical Storm,Jeanne,55,2004-09-27T09:00:00Z,CAPE HATTERAS NC,0,3,11,1,15
Tropical Storm,Jeanne,55,2004-09-27T09:00:00Z,APALACHICOLA FL,22,0,0,0,22
Tropical Storm,Jeanne,55,2004-09-27T09:00:00Z,NORFOLK VA,0,3,11,2,16
Tropical Storm,Jeanne,55,2004-09-27T09:00:00Z,PANAMA CITY FL,17,0,0,0,17
Tropical Storm,Jeanne,55,2004-09-27T09:00:00Z,OCEAN CITY MD,0,0,8,5,13
Tropical Storm,Jeanne,55,2004-09-27T09:00:00Z,PENSACOLA FL,2,0,0,0,2
Tropical Storm,Jeanne,55,2004-09-27T09:00:00Z,ATLANTIC CITY NJ,0,0,4,7,11
Tropical Storm,Jeanne,55,2004-09-27T09:00:00Z,GULF 29N 85W,4,0,0,0,4
Tropical Storm,Jeanne,56,2004-09-27T15:00:00Z,34.8N  81.7W,32,0,0,0,32
Tropical Storm,Jeanne,56,2004-09-27T15:00:00Z,NEW YORK CITY NY,0,0,5,5,10
Tropical Storm,Jeanne,56,2004-09-27T15:00:00Z,36.3N  78.2W,1,15,1,0,17
Tropical Storm,Jeanne,56,2004-09-27T15:00:00Z,MONTAUK POINT NY,0,0,2,7,9
Tropical Storm,Jeanne,56,2004-09-27T15:00:00Z,37.0N  74.4W,0,4,8,2,14
Tropical Storm,Jeanne,56,2004-09-27T15:00:00Z,PROVIDENCE RI,0,0,1,8,9
Tropical Storm,Jeanne,56,2004-09-27T15:00:00Z,BERMUDA,0,0,0,5,5
Tropical Storm,Jeanne,56,2004-09-27T15:00:00Z,NANTUCKET MA,0,0,1,8,9
Tropical Storm,Jeanne,56,2004-09-27T15:00:00Z,JACKSONVILLE FL,3,0,0,0,3
Tropical Storm,Jeanne,56,2004-09-27T15:00:00Z,HYANNIS MA,0,0,1,7,8
Tropical Storm,Jeanne,56,2004-09-27T15:00:00Z,SAVANNAH GA,27,0,0,0,27
Tropical Storm,Jeanne,56,2004-09-27T15:00:00Z,BOSTON MA,0,0,1,7,8
Tropical Storm,Jeanne,56,2004-09-27T15:00:00Z,CHARLESTON SC,20,1,0,0,21
Tropical Storm,Jeanne,56,2004-09-27T15:00:00Z,PORTLAND ME,0,0,0,6,6
Tropical Storm,Jeanne,56,2004-09-27T15:00:00Z,MYRTLE BEACH SC,11,7,0,1,19
Tropical Storm,Jeanne,56,2004-09-27T15:00:00Z,BAR HARBOR ME,0,0,0,5,5
Tropical Storm,Jeanne,56,2004-09-27T15:00:00Z,WILMINGTON NC,3,13,1,0,17
Tropical Storm,Jeanne,56,2004-09-27T15:00:00Z,EASTPORT ME,0,0,0,3,3
Tropical Storm,Jeanne,56,2004-09-27T15:00:00Z,MOREHEAD CITY NC,0,13,2,0,15
Tropical Storm,Jeanne,56,2004-09-27T15:00:00Z,ST JOHN NB,0,0,0,3,3
Tropical Storm,Jeanne,56,2004-09-27T15:00:00Z,CAPE HATTERAS NC,0,10,4,0,14
Tropical Storm,Jeanne,56,2004-09-27T15:00:00Z,YARMOUTH NS,0,0,0,4,4
Tropical Storm,Jeanne,56,2004-09-27T15:00:00Z,NORFOLK VA,0,10,4,1,15
Tropical Storm,Jeanne,56,2004-09-27T15:00:00Z,HALIFAX NS,0,0,0,2,2
Tropical Storm,Jeanne,56,2004-09-27T15:00:00Z,OCEAN CITY MD,0,3,8,2,13
Tropical Storm,Jeanne,56,2004-09-27T15:00:00Z,ST MARKS FL,99,0,0,0,99
Tropical Storm,Jeanne,56,2004-09-27T15:00:00Z,ATLANTIC CITY NJ,0,1,8,2,11
Tropical Depression,Twelve,1,2004-09-16T21:00:00Z,12.1N  36.8W,45,0,0,0,45
Tropical Depression,Twelve,1,2004-09-16T21:00:00Z,12.8N  40.3W,2,20,2,1,25
Tropical Depression,Twelve,1,2004-09-16T21:00:00Z,12.5N  38.7W,21,9,0,1,31
Tropical Storm,Karl,2,2004-09-17T03:00:00Z,12.1N  37.4W,46,0,0,0,46
Tropical Storm,Karl,2,2004-09-17T03:00:00Z,13.2N  41.1W,1,22,2,1,26
Tropical Storm,Karl,2,2004-09-17T03:00:00Z,12.5N  39.3W,23,9,1,0,33
Tropical Storm,Karl,3,2004-09-17T09:00:00Z,12.2N  38.8W,47,0,0,0,47
Tropical Storm,Karl,3,2004-09-17T09:00:00Z,13.7N  42.2W,2,22,2,1,27
Tropical Storm,Karl,3,2004-09-17T09:00:00Z,12.8N  40.6W,26,8,0,0,34
Tropical Storm,Karl,4,2004-09-17T15:00:00Z,13.7N  38.6W,52,0,0,0,52
Tropical Storm,Karl,4,2004-09-17T15:00:00Z,15.5N  41.5W,5,23,1,1,30
Tropical Storm,Karl,4,2004-09-17T15:00:00Z,14.6N  40.3W,27,9,0,0,36
Tropical Storm,Karl,5,2004-09-17T21:00:00Z,15.3N  39.0W,48,0,0,0,48
Tropical Storm,Karl,5,2004-09-17T21:00:00Z,17.2N  41.8W,1,21,4,1,27
Tropical Storm,Karl,5,2004-09-17T21:00:00Z,16.3N  40.4W,22,11,1,0,34
Tropical Storm,Karl,6,2004-09-18T03:00:00Z,15.9N  40.2W,57,0,0,0,57
Tropical Storm,Karl,6,2004-09-18T03:00:00Z,18.0N  43.5W,0,24,4,1,29
Tropical Storm,Karl,6,2004-09-18T03:00:00Z,16.9N  42.0W,16,22,0,0,38
Hurricane,Karl,7,2004-09-18T09:00:00Z,16.8N  42.4W,49,0,0,0,49
Hurricane,Karl,7,2004-09-18T09:00:00Z,19.7N  45.3W,1,24,2,1,28
Hurricane,Karl,7,2004-09-18T09:00:00Z,18.1N  44.1W,21,13,0,0,34
Hurricane,Karl,8,2004-09-18T15:00:00Z,17.1N  42.9W,49,0,0,0,49
Hurricane,Karl,8,2004-09-18T15:00:00Z,19.0N  46.5W,0,22,4,1,27
Hurricane,Karl,8,2004-09-18T15:00:00Z,17.9N  44.7W,22,12,1,0,35
Hurricane,Karl,9,2004-09-18T21:00:00Z,17.6N  43.8W,48,0,0,0,48
Hurricane,Karl,9,2004-09-18T21:00:00Z,19.5N  47.0W,2,21,2,1,26
Hurricane,Karl,9,2004-09-18T21:00:00Z,18.4N  45.5W,25,8,0,1,34
Hurricane,Karl,10,2004-09-19T03:00:00Z,17.4N  44.8W,47,0,0,0,47
Hurricane,Karl,10,2004-09-19T03:00:00Z,19.3N  48.1W,2,24,1,1,28
Hurricane,Karl,10,2004-09-19T03:00:00Z,18.2N  46.7W,24,10,0,0,34
Hurricane,Karl,11,2004-09-19T09:00:00Z,17.7N  45.7W,50,0,0,0,50
Hurricane,Karl,11,2004-09-19T09:00:00Z,20.0N  48.5W,7,21,1,0,29
Hurricane,Karl,11,2004-09-19T09:00:00Z,18.7N  47.4W,30,6,0,1,37
Hurricane,Karl,12,2004-09-19T15:00:00Z,17.7N  46.1W,48,0,0,0,48
Hurricane,Karl,12,2004-09-19T15:00:00Z,20.6N  48.4W,7,17,2,1,27
Hurricane,Karl,12,2004-09-19T15:00:00Z,18.9N  47.3W,33,3,0,0,36
Hurricane,Karl,13,2004-09-19T21:00:00Z,18.5N  47.2W,55,0,0,0,55
Hurricane,Karl,13,2004-09-19T21:00:00Z,21.7N  49.1W,10,17,1,1,29
Hurricane,Karl,13,2004-09-19T21:00:00Z,19.9N  48.3W,36,3,0,0,39
Hurricane,Karl,14,2004-09-20T03:00:00Z,19.2N  48.2W,48,0,0,0,48
Hurricane,Karl,14,2004-09-20T03:00:00Z,22.8N  50.3W,2,22,3,1,28
Hurricane,Karl,14,2004-09-20T03:00:00Z,20.7N  49.5W,27,8,0,0,35
Hurricane,Karl,15,2004-09-20T09:00:00Z,19.3N  48.4W,53,0,0,0,53
Hurricane,Karl,15,2004-09-20T09:00:00Z,23.5N  50.0W,0,18,16,1,35
Hurricane,Karl,15,2004-09-20T09:00:00Z,21.1N  49.6W,5,36,0,1,42
Hurricane,Karl,16,2004-09-20T15:00:00Z,20.4N  48.8W,49,1,0,0,50
Hurricane,Karl,16,2004-09-20T15:00:00Z,25.0N  49.8W,0,13,17,1,31
Hurricane,Karl,16,2004-09-20T15:00:00Z,22.5N  49.7W,9,27,0,0,36
Hurricane,Karl,17,2004-09-20T21:00:00Z,21.8N  49.6W,46,0,0,0,46
Hurricane,Karl,17,2004-09-20T21:00:00Z,27.0N  49.5W,0,8,13,1,22
Hurricane,Karl,17,2004-09-20T21:00:00Z,24.1N  50.1W,12,16,1,0,29
Hurricane,Karl,18,2004-09-21T03:00:00Z,22.3N  49.8W,49,0,0,0,49
Hurricane,Karl,18,2004-09-21T03:00:00Z,28.5N  49.0W,0,7,15,1,23
Hurricane,Karl,18,2004-09-21T03:00:00Z,25.4N  50.1W,7,25,0,0,32
Hurricane,Karl,19,2004-09-21T09:00:00Z,23.9N  49.5W,34,0,0,0,34
Hurricane,Karl,19,2004-09-21T09:00:00Z,29.2N  47.8W,0,4,14,3,21
Hurricane,Karl,19,2004-09-21T09:00:00Z,26.5N  49.5W,2,20,2,0,24
Hurricane,Karl,20,2004-09-21T15:00:00Z,25.5N  49.6W,37,0,0,1,38
Hurricane,Karl,20,2004-09-21T15:00:00Z,30.9N  46.9W,0,1,17,3,21
Hurricane,Karl,20,2004-09-21T15:00:00Z,28.0N  48.6W,1,23,3,0,27
Hurricane,Karl,21,2004-09-21T21:00:00Z,27.6N  49.1W,38,1,0,1,40
Hurricane,Karl,21,2004-09-21T21:00:00Z,34.1N  45.0W,0,1,19,3,23
Hurricane,Karl,21,2004-09-21T21:00:00Z,30.4N  47.4W,0,25,4,0,29
Hurricane,Karl,21,2004-09-21T21:00:00Z,HIBERNIA OILFLD,0,0,0,4,4
Hurricane,Karl,22,2004-09-22T03:00:00Z,29.1N  48.3W,37,1,0,0,38
Hurricane,Karl,22,2004-09-22T03:00:00Z,CAPE RACE NFLD,0,0,0,2,2
Hurricane,Karl,22,2004-09-22T03:00:00Z,31.7N  46.2W,1,21,3,0,25
Hurricane,Karl,22,2004-09-22T03:00:00Z,HIBERNIA OILFLD,0,0,0,6,6
Hurricane,Karl,22,2004-09-22T03:00:00Z,35.5N  44.0W,0,1,15,2,18
Hurricane,Karl,23,2004-09-22T09:00:00Z,30.4N  47.4W,33,3,0,0,36
Hurricane,Karl,23,2004-09-22T09:00:00Z,38.5N  43.0W,0,1,15,2,18
Hurricane,Karl,23,2004-09-22T09:00:00Z,34.0N  45.0W,0,21,4,0,25
Hurricane,Karl,23,2004-09-22T09:00:00Z,HIBERNIA OILFLD,0,0,0,5,5
Hurricane,Karl,24,2004-09-22T15:00:00Z,32.0N  46.0W,27,3,0,0,30
Hurricane,Karl,24,2004-09-22T15:00:00Z,CAPE RACE NFLD,0,0,1,2,3
Hurricane,Karl,24,2004-09-22T15:00:00Z,36.5N  43.5W,0,14,3,1,18
Hurricane,Karl,24,2004-09-22T15:00:00Z,HIBERNIA OILFLD,0,0,2,6,8
Hurricane,Karl,24,2004-09-22T15:00:00Z,42.0N  42.5W,0,1,9,3,13
Hurricane,Karl,25,2004-09-22T21:00:00Z,33.7N  44.6W,26,3,0,1,30
Hurricane,Karl,25,2004-09-22T21:00:00Z,44.0N  42.0W,0,2,8,3,13
Hurricane,Karl,25,2004-09-22T21:00:00Z,38.7N  42.9W,0,15,2,1,18
Hurricane,Karl,25,2004-09-22T21:00:00Z,HIBERNIA OILFLD,0,0,2,3,5
Hurricane,Karl,26,2004-09-23T03:00:00Z,36.4N  43.6W,19,4,0,1,24
Hurricane,Karl,26,2004-09-23T03:00:00Z,47.0N  41.0W,0,3,9,2,14
Hurricane,Karl,26,2004-09-23T03:00:00Z,41.6N  42.3W,0,15,3,0,18
Hurricane,Karl,26,2004-09-23T03:00:00Z,HIBERNIA OILFLD,0,0,1,1,2
Hurricane,Karl,27,2004-09-23T09:00:00Z,39.5N  42.5W,18,4,0,0,22
Hurricane,Karl,27,2004-09-23T09:00:00Z,49.5N  38.5W,0,3,10,1,14
Hurricane,Karl,27,2004-09-23T09:00:00Z,44.5N  41.5W,1,14,2,0,17
Hurricane,Karl,28,2004-09-23T15:00:00Z,42.9N  41.8W,27,1,0,0,28
Hurricane,Karl,28,2004-09-23T15:00:00Z,52.0N  37.0W,0,2,8,2,12
Hurricane,Karl,28,2004-09-23T15:00:00Z,47.4N  40.7W,2,13,1,0,16
Hurricane,Karl,28,2004-09-23T15:00:00Z,HIBERNIA OILFLD,0,4,2,0,6
Hurricane,Karl,29,2004-09-23T21:00:00Z,44.7N  42.0W,27,2,0,0,29
Hurricane,Karl,29,2004-09-23T21:00:00Z,54.0N  34.0W,0,2,8,3,13
Hurricane,Karl,29,2004-09-23T21:00:00Z,49.2N  40.0W,2,14,2,0,18
Hurricane,Karl,29,2004-09-23T21:00:00Z,HIBERNIA OILFLD,0,4,1,0,5
Hurricane,Karl,30,2004-09-24T03:00:00Z,47.5N  39.4W,31,2,0,0,33
Hurricane,Karl,30,2004-09-24T03:00:00Z,57.0N  27.0W,0,0,9,0,9
Hurricane,Karl,30,2004-09-24T03:00:00Z,52.2N  35.4W,1,16,2,0,19
Hurricane,Karl,31,2004-09-24T09:00:00Z,49.4N  37.7W,31,3,0,0,34
Hurricane,Karl,31,2004-09-24T09:00:00Z,59.2N  19.0W,0,0,8,0,8
Hurricane,Karl,31,2004-09-24T09:00:00Z,54.5N  32.0W,0,16,4,0,20
Hurricane,Karl,32,2004-09-24T15:00:00Z,53.7N  36.1W,30,4,0,0,34
Hurricane,Karl,32,2004-09-24T15:00:00Z,62.0N  14.0W,0,0,8,0,8
Hurricane,Karl,32,2004-09-24T15:00:00Z,58.7N  28.0W,0,14,4,0,18
Hurricane,Karl,33,2004-09-24T21:00:00Z,56.0N  32.2W,29,5,0,0,34
Hurricane,Karl,33,2004-09-24T21:00:00Z,64.0N   6.0W,0,0,8,0,8
Hurricane,Karl,33,2004-09-24T21:00:00Z,60.5N  21.0W,0,13,4,0,17
Tropical Depression,Thirteen,1,2004-09-19T21:00:00Z,14.6N  37.2W,53,0,0,0,53
Tropical Depression,Thirteen,1,2004-09-19T21:00:00Z,17.1N  41.5W,0,23,6,0,29
Tropical Depression,Thirteen,1,2004-09-19T21:00:00Z,15.8N  39.3W,23,14,1,0,38
Tropical Depression,Thirteen,2,2004-09-20T03:00:00Z,13.7N  37.0W,55,0,0,0,55
Tropical Depression,Thirteen,2,2004-09-20T03:00:00Z,14.1N  39.9W,9,18,1,1,29
Tropical Depression,Thirteen,2,2004-09-20T03:00:00Z,13.9N  38.4W,35,2,0,0,37
Tropical Depression,Thirteen,3,2004-09-20T09:00:00Z,14.1N  38.2W,55,0,0,0,55
Tropical Depression,Thirteen,3,2004-09-20T09:00:00Z,15.0N  41.5W,5,21,2,1,29
Tropical Depression,Thirteen,3,2004-09-20T09:00:00Z,14.5N  39.7W,35,4,0,0,39
Tropical Storm,Lisa,4,2004-09-20T12:00:00Z,14.1N  38.2W,55,0,0,0,55
Tropical Storm,Lisa,4,2004-09-20T12:00:00Z,15.0N  41.5W,5,20,2,1,28
Tropical Storm,Lisa,4,2004-09-20T12:00:00Z,14.5N  39.7W,36,3,0,0,39
Tropical Storm,Lisa,5,2004-09-20T15:00:00Z,14.3N  39.1W,56,0,0,0,56
Tropical Storm,Lisa,5,2004-09-20T15:00:00Z,15.5N  42.4W,5,21,2,0,28
Tropical Storm,Lisa,5,2004-09-20T15:00:00Z,14.8N  40.6W,36,3,0,0,39
Tropical Storm,Lisa,6,2004-09-20T21:00:00Z,14.6N  39.9W,56,0,0,0,56
Tropical Storm,Lisa,6,2004-09-20T21:00:00Z,15.9N  43.2W,4,24,1,1,30
Tropical Storm,Lisa,6,2004-09-20T21:00:00Z,15.2N  41.6W,32,6,1,0,39
Tropical Storm,Lisa,7,2004-09-21T03:00:00Z,14.5N  41.5W,48,0,0,0,48
Tropical Storm,Lisa,7,2004-09-21T03:00:00Z,15.4N  44.3W,9,16,2,1,28
Tropical Storm,Lisa,7,2004-09-21T03:00:00Z,15.1N  43.0W,32,4,0,0,36
Tropical Storm,Lisa,8,2004-09-21T09:00:00Z,14.9N  42.0W,55,0,0,0,55
Tropical Storm,Lisa,8,2004-09-21T09:00:00Z,15.8N  45.2W,5,21,2,0,28
Tropical Storm,Lisa,8,2004-09-21T09:00:00Z,15.4N  43.6W,33,5,0,0,38
Tropical Storm,Lisa,9,2004-09-21T15:00:00Z,15.2N  42.7W,57,0,0,0,57
Tropical Storm,Lisa,9,2004-09-21T15:00:00Z,15.9N  45.6W,8,21,1,0,30
Tropical Storm,Lisa,9,2004-09-21T15:00:00Z,15.7N  44.3W,33,5,1,0,39
Tropical Storm,Lisa,10,2004-09-21T21:00:00Z,15.2N  43.0W,54,0,0,0,54
Tropical Storm,Lisa,10,2004-09-21T21:00:00Z,15.0N  45.7W,9,19,1,1,30
Tropical Storm,Lisa,10,2004-09-21T21:00:00Z,15.2N  44.5W,31,4,1,0,36
Tropical Storm,Lisa,11,2004-09-22T03:00:00Z,15.4N  43.0W,58,0,0,0,58
Tropical Storm,Lisa,11,2004-09-22T03:00:00Z,16.3N  45.2W,16,15,1,1,33
Tropical Storm,Lisa,11,2004-09-22T03:00:00Z,16.0N  44.2W,37,3,0,0,40
Tropical Storm,Lisa,12,2004-09-22T09:00:00Z,15.2N  43.2W,65,0,0,0,65
Tropical Storm,Lisa,12,2004-09-22T09:00:00Z,15.8N  45.0W,20,16,0,0,36
Tropical Storm,Lisa,12,2004-09-22T09:00:00Z,15.6N  44.3W,39,4,0,1,44
Tropical Storm,Lisa,13,2004-09-22T15:00:00Z,13.2N  42.3W,69,0,0,0,69
Tropical Storm,Lisa,13,2004-09-22T15:00:00Z,13.0N  43.0W,57,0,0,0,57
Tropical Storm,Lisa,13,2004-09-22T15:00:00Z,13.0N  42.5W,62,0,0,0,62
Tropical Storm,Lisa,14,2004-09-22T21:00:00Z,13.0N  42.8W,66,0,0,0,66
Tropical Storm,Lisa,14,2004-09-22T21:00:00Z,12.5N  44.5W,28,2,1,1,32
Tropical Storm,Lisa,14,2004-09-22T21:00:00Z,12.7N  43.5W,44,0,1,0,45
Tropical Storm,Lisa,15,2004-09-23T03:00:00Z,13.3N  42.4W,99,0,0,0,99
Tropical Storm,Lisa,15,2004-09-23T03:00:00Z,14.0N  44.2W,24,7,1,1,33
Tropical Storm,Lisa,15,2004-09-23T03:00:00Z,13.5N  43.2W,51,0,0,0,51
Tropical Storm,Lisa,16,2004-09-23T09:00:00Z,13.4N  42.6W,70,0,0,0,70
Tropical Storm,Lisa,16,2004-09-23T09:00:00Z,14.2N  44.0W,29,5,0,1,35
Tropical Storm,Lisa,16,2004-09-23T09:00:00Z,13.6N  43.2W,52,0,0,0,52
Tropical Storm,Lisa,17,2004-09-23T15:00:00Z,12.3N  42.7W,80,0,0,0,80
Tropical Storm,Lisa,17,2004-09-23T15:00:00Z,14.5N  43.8W,19,7,2,1,29
Tropical Storm,Lisa,17,2004-09-23T15:00:00Z,13.2N  43.2W,55,0,0,0,55
Tropical Depression,Lisa,18,2004-09-23T21:00:00Z,14.9N  41.9W,67,0,0,0,67
Tropical Depression,Lisa,18,2004-09-23T21:00:00Z,17.3N  44.1W,13,16,1,0,30
Tropical Depression,Lisa,18,2004-09-23T21:00:00Z,16.0N  43.1W,37,3,0,0,40
Tropical Depression,Lisa,19,2004-09-24T03:00:00Z,15.9N  44.1W,48,0,0,0,48
Tropical Depression,Lisa,19,2004-09-24T03:00:00Z,18.5N  46.0W,2,20,4,1,27
Tropical Depression,Lisa,19,2004-09-24T03:00:00Z,16.9N  45.1W,28,6,0,0,34
Tropical Depression,Lisa,20,2004-09-24T09:00:00Z,16.5N  45.7W,57,0,0,0,57
Tropical Depression,Lisa,20,2004-09-24T09:00:00Z,19.5N  47.2W,3,24,3,0,30
Tropical Depression,Lisa,20,2004-09-24T09:00:00Z,18.0N  46.5W,29,10,0,0,39
Tropical Depression,Lisa,21,2004-09-24T15:00:00Z,16.3N  45.5W,55,0,0,0,55
Tropical Depression,Lisa,21,2004-09-24T15:00:00Z,19.8N  46.7W,2,21,4,1,28
Tropical Depression,Lisa,21,2004-09-24T15:00:00Z,17.8N  46.2W,31,7,0,0,38
Tropical Depression,Lisa,22,2004-09-24T21:00:00Z,16.2N  46.6W,55,0,0,0,55
Tropical Depression,Lisa,22,2004-09-24T21:00:00Z,19.7N  47.6W,2,21,3,2,28
Tropical Depression,Lisa,22,2004-09-24T21:00:00Z,17.8N  47.2W,29,7,0,1,37
Tropical Depression,Lisa,23,2004-09-25T03:00:00Z,16.5N  46.7W,46,1,0,0,47
Tropical Depression,Lisa,23,2004-09-25T03:00:00Z,20.0N  47.7W,1,20,4,1,26
Tropical Depression,Lisa,23,2004-09-25T03:00:00Z,18.2N  47.3W,20,12,0,0,32
Tropical Storm,Lisa,25,2004-09-25T15:00:00Z,18.0N  47.2W,43,0,0,0,43
Tropical Storm,Lisa,25,2004-09-25T15:00:00Z,21.0N  48.5W,3,12,4,2,21
Tropical Storm,Lisa,25,2004-09-25T15:00:00Z,19.4N  47.9W,21,3,1,1,26
Tropical Storm,Lisa,26,2004-09-25T21:00:00Z,19.8N  47.1W,35,0,0,0,35
Tropical Storm,Lisa,26,2004-09-25T21:00:00Z,23.2N  48.7W,0,14,5,3,22
Tropical Storm,Lisa,26,2004-09-25T21:00:00Z,21.4N  47.9W,12,11,1,1,25
Tropical Storm,Lisa,28,2004-09-26T09:00:00Z,21.4N  47.0W,37,0,1,0,38
Tropical Storm,Lisa,28,2004-09-26T09:00:00Z,24.5N  48.5W,1,15,3,3,22
Tropical Storm,Lisa,28,2004-09-26T09:00:00Z,23.0N  47.7W,17,7,1,1,26
Tropical Storm,Lisa,29,2004-09-26T15:00:00Z,21.8N  47.3W,30,0,1,0,31
Tropical Storm,Lisa,29,2004-09-26T15:00:00Z,24.5N  49.2W,1,14,5,2,22
Tropical Storm,Lisa,29,2004-09-26T15:00:00Z,23.1N  48.1W,12,10,1,1,24
Tropical Storm,Lisa,30,2004-09-26T21:00:00Z,22.5N  47.5W,38,1,0,0,39
Tropical Storm,Lisa,30,2004-09-26T21:00:00Z,25.2N  48.9W,3,14,3,2,22
Tropical Storm,Lisa,30,2004-09-26T21:00:00Z,23.8N  48.4W,21,4,1,0,26
Tropical Storm,Lisa,31,2004-09-27T03:00:00Z,22.4N  47.4W,31,1,0,0,32
Tropical Storm,Lisa,31,2004-09-27T03:00:00Z,25.4N  49.1W,1,15,3,2,21
Tropical Storm,Lisa,31,2004-09-27T03:00:00Z,24.0N  48.4W,10,12,1,1,24
Tropical Storm,Lisa,32,2004-09-27T09:00:00Z,22.8N  47.3W,41,0,0,0,41
Tropical Storm,Lisa,32,2004-09-27T09:00:00Z,25.6N  48.9W,2,15,3,2,22
Tropical Storm,Lisa,32,2004-09-27T09:00:00Z,24.2N  48.1W,20,5,1,0,26
Tropical Storm,Lisa,33,2004-09-27T15:00:00Z,23.2N  47.7W,30,1,0,0,31
Tropical Storm,Lisa,33,2004-09-27T15:00:00Z,26.0N  48.9W,1,14,4,2,21
Tropical Storm,Lisa,33,2004-09-27T15:00:00Z,24.6N  48.5W,12,10,1,1,24
Tropical Storm,Lisa,34,2004-09-27T21:00:00Z,24.0N  47.9W,39,0,0,0,39
Tropical Storm,Lisa,34,2004-09-27T21:00:00Z,27.0N  48.5W,1,14,4,2,21
Tropical Storm,Lisa,34,2004-09-27T21:00:00Z,25.5N  48.3W,16,8,1,1,26
Tropical Storm,Lisa,35,2004-09-28T03:00:00Z,24.9N  46.9W,39,0,0,0,39
Tropical Storm,Lisa,35,2004-09-28T03:00:00Z,29.0N  47.3W,2,15,4,1,22
Tropical Storm,Lisa,35,2004-09-28T03:00:00Z,27.0N  47.2W,18,9,0,1,28
Tropical Storm,Lisa,36,2004-09-28T09:00:00Z,26.3N  46.4W,49,0,0,0,49
Tropical Storm,Lisa,36,2004-09-28T09:00:00Z,31.0N  46.0W,0,14,5,1,20
Tropical Storm,Lisa,36,2004-09-28T09:00:00Z,28.7N  46.2W,12,17,0,0,29
Tropical Storm,Lisa,37,2004-09-28T15:00:00Z,29.0N  47.5W,35,1,0,0,36
Tropical Storm,Lisa,37,2004-09-28T15:00:00Z,33.0N  47.5W,1,10,5,2,18
Tropical Storm,Lisa,37,2004-09-28T15:00:00Z,31.0N  47.5W,13,9,1,1,24
Tropical Storm,Lisa,38,2004-09-28T21:00:00Z,30.0N  46.8W,31,0,0,1,32
Tropical Storm,Lisa,38,2004-09-28T21:00:00Z,34.0N  48.0W,1,11,4,2,18
Tropical Storm,Lisa,38,2004-09-28T21:00:00Z,32.0N  47.3W,11,10,1,1,23
Tropical Storm,Lisa,38,2004-09-28T21:00:00Z,CAPE RACE NFLD,0,0,0,2,2
Tropical Storm,Lisa,39,2004-09-29T03:00:00Z,30.5N  47.3W,29,0,0,1,30
Tropical Storm,Lisa,39,2004-09-29T03:00:00Z,34.0N  48.7W,1,12,3,2,18
Tropical Storm,Lisa,39,2004-09-29T03:00:00Z,32.3N  48.2W,11,9,1,1,22
Tropical Storm,Lisa,39,2004-09-29T03:00:00Z,CAPE RACE NFLD,0,0,0,2,2
Tropical Storm,Lisa,40,2004-09-29T09:00:00Z,31.3N  47.0W,28,1,0,0,29
Tropical Storm,Lisa,40,2004-09-29T09:00:00Z,CAPE RACE NFLD,0,0,0,2,2
Tropical Storm,Lisa,40,2004-09-29T09:00:00Z,33.0N  48.0W,13,6,1,1,21
Tropical Storm,Lisa,40,2004-09-29T09:00:00Z,HIBERNIA OILFLD,0,0,0,2,2
Tropical Storm,Lisa,40,2004-09-29T09:00:00Z,35.0N  48.5W,1,11,3,2,17
Tropical Storm,Lisa,41,2004-09-29T15:00:00Z,33.0N  47.5W,32,1,0,0,33
Tropical Storm,Lisa,41,2004-09-29T15:00:00Z,ILE ST PIERRE,0,0,0,2,2
Tropical Storm,Lisa,41,2004-09-29T15:00:00Z,35.0N  48.0W,12,9,1,1,23
Tropical Storm,Lisa,41,2004-09-29T15:00:00Z,CAPE RACE NFLD,0,0,0,3,3
Tropical Storm,Lisa,41,2004-09-29T15:00:00Z,36.5N  48.0W,1,13,3,2,19
Tropical Storm,Lisa,41,2004-09-29T15:00:00Z,HIBERNIA OILFLD,0,0,0,3,3
Tropical Storm,Lisa,42,2004-09-29T21:00:00Z,34.0N  47.3W,29,0,0,0,29
Tropical Storm,Lisa,42,2004-09-29T21:00:00Z,CAPE RACE NFLD,0,0,0,3,3
Tropical Storm,Lisa,42,2004-09-29T21:00:00Z,36.0N  47.5W,13,5,1,1,20
Tropical Storm,Lisa,42,2004-09-29T21:00:00Z,HIBERNIA OILFLD,0,0,0,5,5
Tropical Storm,Lisa,42,2004-09-29T21:00:00Z,38.0N  46.5W,1,10,4,1,16
Tropical Storm,Lisa,43,2004-09-30T03:00:00Z,34.7N  47.5W,34,1,0,0,35
Tropical Storm,Lisa,43,2004-09-30T03:00:00Z,CAPE RACE NFLD,0,0,0,2,2
Tropical Storm,Lisa,43,2004-09-30T03:00:00Z,36.7N  47.0W,16,5,1,1,23
Tropical Storm,Lisa,43,2004-09-30T03:00:00Z,HIBERNIA OILFLD,0,0,1,5,6
Tropical Storm,Lisa,43,2004-09-30T03:00:00Z,38.6N  45.0W,1,9,6,2,18
Tropical Storm,Lisa,44,2004-09-30T09:00:00Z,35.6N  47.7W,31,0,0,0,31
Tropical Storm,Lisa,44,2004-09-30T09:00:00Z,37.7N  46.5W,8,13,0,0,21
Tropical Storm,Lisa,45,2004-09-30T15:00:00Z,36.7N  48.0W,29,1,0,0,30
Tropical Storm,Lisa,45,2004-09-30T15:00:00Z,39.3N  46.4W,3,18,0,0,21
Tropical Storm,Lisa,46,2004-09-30T21:00:00Z,37.5N  47.0W,26,2,0,0,28
Tropical Storm,Lisa,46,2004-09-30T21:00:00Z,44.0N  38.0W,0,0,12,0,12
Tropical Storm,Lisa,46,2004-09-30T21:00:00Z,40.5N  43.5W,0,17,3,0,20
Tropical Storm,Lisa,46,2004-09-30T21:00:00Z,HIBERNIA OILFLD,0,1,3,0,4
Tropical Storm,Lisa,47,2004-10-01T03:00:00Z,39.0N  44.8W,29,1,1,0,31
Tropical Storm,Lisa,47,2004-10-01T03:00:00Z,45.0N  33.0W,0,0,9,0,9
Tropical Storm,Lisa,47,2004-10-01T03:00:00Z,42.2N  40.4W,1,14,3,0,18
Tropical Storm,Lisa,48,2004-10-01T09:00:00Z,40.5N  42.5W,22,3,0,0,25
Tropical Storm,Lisa,48,2004-10-01T09:00:00Z,46.0N  28.5W,0,1,9,0,10
Tropical Storm,Lisa,48,2004-10-01T09:00:00Z,43.4N  37.0W,0,15,3,0,18
Tropical Storm,Lisa,49,2004-10-01T15:00:00Z,42.0N  39.5W,26,1,0,0,27
Tropical Storm,Lisa,49,2004-10-01T15:00:00Z,46.5N  24.5W,0,1,10,0,11
Tropical Storm,Lisa,49,2004-10-01T15:00:00Z,44.0N  33.5W,4,14,1,0,19
Hurricane,Lisa,50,2004-10-01T21:00:00Z,43.5N  37.0W,27,2,0,0,29
Hurricane,Lisa,50,2004-10-01T21:00:00Z,45.5N  29.0W,0,13,0,0,13
Tropical Storm,Lisa,51,2004-10-02T03:00:00Z,44.2N  32.6W,29,4,0,0,33
Tropical Storm,Lisa,51,2004-10-02T03:00:00Z,46.5N  13.2W,0,0,10,0,10
Tropical Storm,Lisa,51,2004-10-02T03:00:00Z,45.6N  23.8W,0,16,3,0,19
Hurricane,Lisa,52,2004-10-02T09:00:00Z,44.9N  28.1W,27,5,0,0,32
Hurricane,Lisa,52,2004-10-02T09:00:00Z,46.1N  18.5W,0,14,0,0,14
Hurricane,Lisa,53,2004-10-02T15:00:00Z,45.5N  23.0W,27,0,0,0,27
Tropical Storm,Lisa,54,2004-10-02T21:00:00Z,46.5N  20.0W,28,0,0,0,28
Tropical Storm,Matthew,1,2004-10-08T21:00:00Z,25.3N  91.1W,41,1,0,0,42
Tropical Storm,Matthew,1,2004-10-08T21:00:00Z,TAMPA FL,0,0,2,5,7
Tropical Storm,Matthew,1,2004-10-08T21:00:00Z,26.3N  89.2W,11,11,2,0,24
Tropical Storm,Matthew,1,2004-10-08T21:00:00Z,CEDAR KEY FL,0,0,2,7,9
Tropical Storm,Matthew,1,2004-10-08T21:00:00Z,28.0N  87.5W,0,7,9,2,18
Tropical Storm,Matthew,1,2004-10-08T21:00:00Z,ST MARKS FL,0,0,4,7,11
Tropical Storm,Matthew,1,2004-10-08T21:00:00Z,MUHA 230N 824W,0,0,0,2,2
Tropical Storm,Matthew,1,2004-10-08T21:00:00Z,APALACHICOLA FL,0,0,6,7,13
Tropical Storm,Matthew,1,2004-10-08T21:00:00Z,MUAN 219N 850W,0,0,2,1,3
Tropical Storm,Matthew,1,2004-10-08T21:00:00Z,PANAMA CITY FL,0,0,7,7,14
Tropical Storm,Matthew,1,2004-10-08T21:00:00Z,MMCZ 205N 869W,0,0,2,1,3
Tropical Storm,Matthew,1,2004-10-08T21:00:00Z,PENSACOLA FL,0,1,8,5,14
Tropical Storm,Matthew,1,2004-10-08T21:00:00Z,MMMD 210N 897W,0,3,2,0,5
Tropical Storm,Matthew,1,2004-10-08T21:00:00Z,MOBILE AL,0,1,8,5,14
Tropical Storm,Matthew,1,2004-10-08T21:00:00Z,MARATHON FL,0,0,0,2,2
Tropical Storm,Matthew,1,2004-10-08T21:00:00Z,GULFPORT MS,0,2,9,3,14
Tropical Storm,Matthew,1,2004-10-08T21:00:00Z,MIAMI FL,0,0,0,2,2
Tropical Storm,Matthew,1,2004-10-08T21:00:00Z,BURAS LA,0,7,7,3,17
Tropical Storm,Matthew,1,2004-10-08T21:00:00Z,W PALM BEACH FL,0,0,0,2,2
Tropical Storm,Matthew,1,2004-10-08T21:00:00Z,NEW ORLEANS LA,0,4,7,3,14
Tropical Storm,Matthew,1,2004-10-08T21:00:00Z,FT PIERCE FL,0,0,0,3,3
Tropical Storm,Matthew,1,2004-10-08T21:00:00Z,NEW IBERIA LA,0,3,6,2,11
Tropical Storm,Matthew,1,2004-10-08T21:00:00Z,COCOA BEACH FL,0,0,0,4,4
Tropical Storm,Matthew,1,2004-10-08T21:00:00Z,PORT ARTHUR TX,0,1,2,3,6
Tropical Storm,Matthew,1,2004-10-08T21:00:00Z,DAYTONA BEACH FL,0,0,0,5,5
Tropical Storm,Matthew,1,2004-10-08T21:00:00Z,GALVESTON TX,0,1,1,2,4
Tropical Storm,Matthew,1,2004-10-08T21:00:00Z,JACKSONVILLE FL,0,0,1,6,7
Tropical Storm,Matthew,1,2004-10-08T21:00:00Z,FREEPORT TX,0,1,1,1,3
Tropical Storm,Matthew,1,2004-10-08T21:00:00Z,SAVANNAH GA,0,0,0,6,6
Tropical Storm,Matthew,1,2004-10-08T21:00:00Z,GULF 29N 85W,0,0,7,6,13
Tropical Storm,Matthew,1,2004-10-08T21:00:00Z,CHARLESTON SC,0,0,0,4,4
Tropical Storm,Matthew,1,2004-10-08T21:00:00Z,GULF 29N 87W,0,3,10,3,16
Tropical Storm,Matthew,1,2004-10-08T21:00:00Z,MYRTLE BEACH SC,0,0,0,3,3
Tropical Storm,Matthew,1,2004-10-08T21:00:00Z,GULF 28N 89W,1,13,4,2,20
Tropical Storm,Matthew,1,2004-10-08T21:00:00Z,WILMINGTON NC,0,0,0,2,2
Tropical Storm,Matthew,1,2004-10-08T21:00:00Z,GULF 28N 91W,3,13,2,1,19
Tropical Storm,Matthew,1,2004-10-08T21:00:00Z,KEY WEST FL,0,0,1,1,2
Tropical Storm,Matthew,1,2004-10-08T21:00:00Z,GULF 28N 93W,2,9,1,2,14
Tropical Storm,Matthew,1,2004-10-08T21:00:00Z,MARCO ISLAND FL,0,0,1,3,4
Tropical Storm,Matthew,1,2004-10-08T21:00:00Z,GULF 28N 95W,0,2,2,1,5
Tropical Storm,Matthew,1,2004-10-08T21:00:00Z,FT MYERS FL,0,0,1,4,5
Tropical Storm,Matthew,1,2004-10-08T21:00:00Z,GULF 27N 96W,0,1,1,1,3
Tropical Storm,Matthew,1,2004-10-08T21:00:00Z,VENICE FL,0,0,2,4,6
Tropical Storm,Matthew,1,2004-10-08T21:00:00Z,GULF 25N 96W,4,1,0,1,6
Tropical Storm,Matthew,2,2004-10-09T03:00:00Z,26.5N  90.5W,47,0,0,0,47
Tropical Storm,Matthew,2,2004-10-09T03:00:00Z,PENSACOLA FL,0,7,7,2,16
Tropical Storm,Matthew,2,2004-10-09T03:00:00Z,27.8N  89.0W,16,8,1,0,25
Tropical Storm,Matthew,2,2004-10-09T03:00:00Z,MOBILE AL,0,8,6,3,17
Tropical Storm,Matthew,2,2004-10-09T03:00:00Z,29.5N  87.5W,0,12,4,2,18
Tropical Storm,Matthew,2,2004-10-09T03:00:00Z,GULFPORT MS,0,11,4,2,17
Tropical Storm,Matthew,2,2004-10-09T03:00:00Z,FT PIERCE FL,0,0,0,2,2
Tropical Storm,Matthew,2,2004-10-09T03:00:00Z,BURAS LA,2,14,2,1,19
Tropical Storm,Matthew,2,2004-10-09T03:00:00Z,COCOA BEACH FL,0,0,1,2,3
Tropical Storm,Matthew,2,2004-10-09T03:00:00Z,NEW ORLEANS LA,1,12,2,2,17
Tropical Storm,Matthew,2,2004-10-09T03:00:00Z,DAYTONA BEACH FL,0,0,1,3,4
Tropical Storm,Matthew,2,2004-10-09T03:00:00Z,NEW IBERIA LA,0,9,3,2,14
Tropical Storm,Matthew,2,2004-10-09T03:00:00Z,JACKSONVILLE FL,0,0,2,5,7
Tropical Storm,Matthew,2,2004-10-09T03:00:00Z,PORT ARTHUR TX,0,3,2,2,7
Tropical Storm,Matthew,2,2004-10-09T03:00:00Z,SAVANNAH GA,0,0,1,5,6
Tropical Storm,Matthew,2,2004-10-09T03:00:00Z,GALVESTON TX,0,2,2,2,6
Tropical Storm,Matthew,2,2004-10-09T03:00:00Z,CHARLESTON SC,0,0,0,4,4
Tropical Storm,Matthew,2,2004-10-09T03:00:00Z,FREEPORT TX,0,1,2,1,4
Tropical Storm,Matthew,2,2004-10-09T03:00:00Z,MYRTLE BEACH SC,0,0,0,3,3
Tropical Storm,Matthew,2,2004-10-09T03:00:00Z,PORT O CONNOR TX,0,0,1,1,2
Tropical Storm,Matthew,2,2004-10-09T03:00:00Z,WILMINGTON NC,0,0,0,2,2
Tropical Storm,Matthew,2,2004-10-09T03:00:00Z,GULF 29N 85W,0,3,7,3,13
Tropical Storm,Matthew,2,2004-10-09T03:00:00Z,MARCO ISLAND FL,0,0,1,1,2
Tropical Storm,Matthew,2,2004-10-09T03:00:00Z,GULF 29N 87W,0,11,4,2,17
Tropical Storm,Matthew,2,2004-10-09T03:00:00Z,FT MYERS FL,0,0,1,2,3
Tropical Storm,Matthew,2,2004-10-09T03:00:00Z,GULF 28N 89W,14,9,1,0,24
Tropical Storm,Matthew,2,2004-10-09T03:00:00Z,VENICE FL,0,0,2,3,5
Tropical Storm,Matthew,2,2004-10-09T03:00:00Z,GULF 28N 91W,24,3,0,1,28
Tropical Storm,Matthew,2,2004-10-09T03:00:00Z,TAMPA FL,0,0,3,3,6
Tropical Storm,Matthew,2,2004-10-09T03:00:00Z,GULF 28N 93W,13,3,1,1,18
Tropical Storm,Matthew,2,2004-10-09T03:00:00Z,CEDAR KEY FL,0,0,4,4,8
Tropical Storm,Matthew,2,2004-10-09T03:00:00Z,GULF 28N 95W,1,2,2,1,6
Tropical Storm,Matthew,2,2004-10-09T03:00:00Z,ST MARKS FL,0,1,6,5,12
Tropical Storm,Matthew,2,2004-10-09T03:00:00Z,GULF 27N 96W,0,1,1,1,3
Tropical Storm,Matthew,2,2004-10-09T03:00:00Z,APALACHICOLA FL,0,3,7,3,13
Tropical Storm,Matthew,2,2004-10-09T03:00:00Z,GULF 25N 96W,1,1,0,1,3
Tropical Storm,Matthew,2,2004-10-09T03:00:00Z,PANAMA CITY FL,0,4,7,4,15
Tropical Storm,Matthew,3,2004-10-09T09:00:00Z,28.1N  90.5W,47,0,0,0,47
Tropical Storm,Matthew,3,2004-10-09T09:00:00Z,NEW ORLEANS LA,18,12,0,0,30
Tropical Storm,Matthew,3,2004-10-09T09:00:00Z,30.6N  89.4W,6,20,0,0,26
Tropical Storm,Matthew,3,2004-10-09T09:00:00Z,NEW IBERIA LA,14,10,1,0,25
Tropical Storm,Matthew,3,2004-10-09T09:00:00Z,32.5N  89.0W,0,15,3,1,19
Tropical Storm,Matthew,3,2004-10-09T09:00:00Z,PORT ARTHUR TX,2,5,1,1,9
Tropical Storm,Matthew,3,2004-10-09T09:00:00Z,SAVANNAH GA,0,0,0,2,2
Tropical Storm,Matthew,3,2004-10-09T09:00:00Z,GALVESTON TX,1,3,1,1,6
Tropical Storm,Matthew,3,2004-10-09T09:00:00Z,CEDAR KEY FL,0,0,0,2,2
Tropical Storm,Matthew,3,2004-10-09T09:00:00Z,FREEPORT TX,1,1,0,1,3
Tropical Storm,Matthew,3,2004-10-09T09:00:00Z,ST MARKS FL,0,1,2,2,5
Tropical Storm,Matthew,3,2004-10-09T09:00:00Z,GULF 29N 85W,0,2,2,2,6
Tropical Storm,Matthew,3,2004-10-09T09:00:00Z,APALACHICOLA FL,0,2,2,3,7
Tropical Storm,Matthew,3,2004-10-09T09:00:00Z,GULF 29N 87W,2,11,1,1,15
Tropical Storm,Matthew,3,2004-10-09T09:00:00Z,PANAMA CITY FL,0,4,3,3,10
Tropical Storm,Matthew,3,2004-10-09T09:00:00Z,GULF 28N 89W,30,1,0,0,31
Tropical Storm,Matthew,3,2004-10-09T09:00:00Z,PENSACOLA FL,1,13,2,1,17
Tropical Storm,Matthew,3,2004-10-09T09:00:00Z,GULF 28N 91W,51,0,0,0,51
Tropical Storm,Matthew,3,2004-10-09T09:00:00Z,MOBILE AL,2,19,1,0,22
Tropical Storm,Matthew,3,2004-10-09T09:00:00Z,GULF 28N 93W,38,0,0,0,38
Tropical Storm,Matthew,3,2004-10-09T09:00:00Z,GULFPORT MS,7,19,0,1,27
Tropical Storm,Matthew,3,2004-10-09T09:00:00Z,GULF 28N 95W,6,1,0,1,8
Tropical Storm,Matthew,3,2004-10-09T09:00:00Z,BURAS LA,25,7,0,0,32
Tropical Storm,Matthew,3,2004-10-09T09:00:00Z,GULF 27N 96W,1,0,1,0,2
Tropical Depression,Matthew,4,2004-10-09T15:00:00Z,30.0N  91.3W,37,1,0,0,38
Tropical Depression,Matthew,4,2004-10-09T15:00:00Z,NEW IBERIA LA,36,0,0,0,36
Tropical Depression,Matthew,4,2004-10-09T15:00:00Z,32.5N  91.0W,6,15,1,0,22
Tropical Depression,Matthew,4,2004-10-09T15:00:00Z,PORT ARTHUR TX,11,2,1,0,14
Tropical Depression,Matthew,4,2004-10-09T15:00:00Z,34.5N  91.0W,0,13,3,0,16
Tropical Depression,Matthew,4,2004-10-09T15:00:00Z,GALVESTON TX,3,1,1,0,5
Tropical Depression,Matthew,4,2004-10-09T15:00:00Z,PANAMA CITY FL,0,1,1,0,2
Tropical Depression,Matthew,4,2004-10-09T15:00:00Z,FREEPORT TX,0,1,1,0,2
Tropical Depression,Matthew,4,2004-10-09T15:00:00Z,PENSACOLA FL,1,5,2,0,8
Tropical Depression,Matthew,4,2004-10-09T15:00:00Z,GULF 29N 87W,1,3,1,0,5
Tropical Depression,Matthew,4,2004-10-09T15:00:00Z,MOBILE AL,4,9,2,0,15
Tropical Depression,Matthew,4,2004-10-09T15:00:00Z,GULF 28N 89W,18,1,0,0,19
Tropical Depression,Matthew,4,2004-10-09T15:00:00Z,GULFPORT MS,14,6,1,0,21
Tropical Depression,Matthew,4,2004-10-09T15:00:00Z,GULF 28N 91W,62,0,0,0,62
Tropical Depression,Matthew,4,2004-10-09T15:00:00Z,BURAS LA,27,1,0,0,28
Tropical Depression,Matthew,4,2004-10-09T15:00:00Z,GULF 28N 93W,59,0,0,0,59
Tropical Depression,Matthew,4,2004-10-09T15:00:00Z,NEW ORLEANS LA,32,0,1,0,33
Tropical Depression,Matthew,4,2004-10-09T15:00:00Z,GULF 28N 95W,1,0,1,0,2
Tropical Storm,Matthew,5,2004-10-09T21:00:00Z,31.5N  90.9W,33,0,0,0,33
Tropical Storm,Matthew,5,2004-10-09T21:00:00Z,BURAS LA,40,0,0,0,40
Tropical Storm,Matthew,5,2004-10-09T21:00:00Z,33.5N  91.0W,12,6,1,0,19
Tropical Storm,Matthew,5,2004-10-09T21:00:00Z,NEW ORLEANS LA,49,0,0,0,49
Tropical Storm,Matthew,5,2004-10-09T21:00:00Z,36.0N  91.5W,0,10,3,0,13
Tropical Storm,Matthew,5,2004-10-09T21:00:00Z,NEW IBERIA LA,45,0,0,0,45
Tropical Storm,Matthew,5,2004-10-09T21:00:00Z,ST MARKS FL,0,1,2,0,3
Tropical Storm,Matthew,5,2004-10-09T21:00:00Z,PORT ARTHUR TX,2,0,1,0,3
Tropical Storm,Matthew,5,2004-10-09T21:00:00Z,APALACHICOLA FL,0,2,2,0,4
Tropical Storm,Matthew,5,2004-10-09T21:00:00Z,GULF 29N 85W,0,2,1,0,3
Tropical Storm,Matthew,5,2004-10-09T21:00:00Z,PANAMA CITY FL,0,3,2,0,5
Tropical Storm,Matthew,5,2004-10-09T21:00:00Z,GULF 29N 87W,3,4,0,0,7
Tropical Storm,Matthew,5,2004-10-09T21:00:00Z,PENSACOLA FL,4,6,1,0,11
Tropical Storm,Matthew,5,2004-10-09T21:00:00Z,GULF 28N 89W,15,0,0,0,15
Tropical Storm,Matthew,5,2004-10-09T21:00:00Z,MOBILE AL,16,2,0,0,18
Tropical Storm,Matthew,5,2004-10-09T21:00:00Z,GULF 28N 91W,99,0,0,0,99
Tropical Storm,Matthew,5,2004-10-09T21:00:00Z,GULFPORT MS,27,1,0,0,28
Tropical Storm,Matthew,5,2004-10-09T21:00:00Z,GULF 28N 93W,39,0,0,0,39
Tropical Storm,Matthew,6,2004-10-10T03:00:00Z,30.9N  90.4W,38,0,0,0,38
Tropical Storm,Matthew,6,2004-10-10T03:00:00Z,NEW ORLEANS LA,52,0,0,0,52
Tropical Storm,Matthew,6,2004-10-10T03:00:00Z,33.3N  90.6W,6,15,1,0,22
Tropical Storm,Matthew,6,2004-10-10T03:00:00Z,NEW IBERIA LA,39,0,0,0,39
Tropical Storm,Matthew,6,2004-10-10T03:00:00Z,35.5N  91.0W,0,11,5,0,16
Tropical Storm,Matthew,6,2004-10-10T03:00:00Z,PORT ARTHUR TX,2,2,1,0,5
Tropical Storm,Matthew,6,2004-10-10T03:00:00Z,APALACHICOLA FL,0,1,1,0,2
Tropical Storm,Matthew,6,2004-10-10T03:00:00Z,GULF 29N 85W,0,1,1,0,2
Tropical Storm,Matthew,6,2004-10-10T03:00:00Z,PANAMA CITY FL,0,3,1,0,4
Tropical Storm,Matthew,6,2004-10-10T03:00:00Z,GULF 29N 87W,6,3,0,0,9
Tropical Storm,Matthew,6,2004-10-10T03:00:00Z,PENSACOLA FL,7,6,1,0,14
Tropical Storm,Matthew,6,2004-10-10T03:00:00Z,GULF 28N 89W,35,0,0,0,35
Tropical Storm,Matthew,6,2004-10-10T03:00:00Z,MOBILE AL,21,2,0,0,23
Tropical Storm,Matthew,6,2004-10-10T03:00:00Z,GULF 28N 91W,99,0,0,0,99
Tropical Storm,Matthew,6,2004-10-10T03:00:00Z,GULFPORT MS,33,0,0,0,33
Tropical Storm,Matthew,6,2004-10-10T03:00:00Z,GULF 28N 93W,7,1,0,0,8
Tropical Storm,Matthew,6,2004-10-10T03:00:00Z,BURAS LA,51,0,0,0,51
Tropical Storm,Matthew,7,2004-10-10T09:00:00Z,32.4N  90.9W,31,0,0,0,31
Tropical Storm,Matthew,7,2004-10-10T09:00:00Z,BURAS LA,64,0,0,0,64
Tropical Storm,Matthew,7,2004-10-10T09:00:00Z,34.4N  91.8W,11,6,2,0,19
Tropical Storm,Matthew,7,2004-10-10T09:00:00Z,NEW ORLEANS LA,69,0,0,0,69
Tropical Storm,Matthew,7,2004-10-10T09:00:00Z,35.7N  92.7W,2,11,2,0,15
Tropical Storm,Matthew,7,2004-10-10T09:00:00Z,NEW IBERIA LA,36,0,0,0,36
Tropical Storm,Matthew,7,2004-10-10T09:00:00Z,APALACHICOLA FL,0,1,1,0,2
Tropical Storm,Matthew,7,2004-10-10T09:00:00Z,PORT ARTHUR TX,0,1,1,0,2
Tropical Storm,Matthew,7,2004-10-10T09:00:00Z,PANAMA CITY FL,1,2,1,0,4
Tropical Storm,Matthew,7,2004-10-10T09:00:00Z,GULF 29N 85W,0,1,1,0,2
Tropical Storm,Matthew,7,2004-10-10T09:00:00Z,PENSACOLA FL,8,3,0,0,11
Tropical Storm,Matthew,7,2004-10-10T09:00:00Z,GULF 29N 87W,4,2,1,0,7
Tropical Storm,Matthew,7,2004-10-10T09:00:00Z,MOBILE AL,23,0,1,0,24
Tropical Storm,Matthew,7,2004-10-10T09:00:00Z,GULF 28N 89W,19,0,0,0,19
Tropical Storm,Matthew,7,2004-10-10T09:00:00Z,GULFPORT MS,40,0,0,0,40
Tropical Storm,Matthew,7,2004-10-10T09:00:00Z,GULF 28N 91W,99,0,0,0,99
Tropical Storm,Nicole,1,2004-10-10T09:00:00Z,36.0N  65.0W,23,1,0,1,25
Tropical Storm,Nicole,1,2004-10-10T09:00:00Z,EASTPORT ME,0,1,6,5,12
Tropical Storm,Nicole,1,2004-10-10T09:00:00Z,39.0N  63.5W,1,13,3,1,18
Tropical Storm,Nicole,1,2004-10-10T09:00:00Z,ST JOHN NB,0,0,5,7,12
Tropical Storm,Nicole,1,2004-10-10T09:00:00Z,41.5N  63.5W,0,5,8,3,16
Tropical Storm,Nicole,1,2004-10-10T09:00:00Z,MONCTON NB,0,0,3,7,10
Tropical Storm,Nicole,1,2004-10-10T09:00:00Z,BERMUDA,40,0,0,0,40
Tropical Storm,Nicole,1,2004-10-10T09:00:00Z,YARMOUTH NS,0,2,7,5,14
Tropical Storm,Nicole,1,2004-10-10T09:00:00Z,NEW YORK CITY NY,0,0,1,1,2
Tropical Storm,Nicole,1,2004-10-10T09:00:00Z,HALIFAX NS,0,0,5,7,12
Tropical Storm,Nicole,1,2004-10-10T09:00:00Z,MONTAUK POINT NY,0,2,2,2,6
Tropical Storm,Nicole,1,2004-10-10T09:00:00Z,SABLE ISLAND NS,0,0,3,6,9
Tropical Storm,Nicole,1,2004-10-10T09:00:00Z,PROVIDENCE RI,0,2,3,2,7
Tropical Storm,Nicole,1,2004-10-10T09:00:00Z,SYDNEY NS,0,0,1,5,6
Tropical Storm,Nicole,1,2004-10-10T09:00:00Z,NANTUCKET MA,0,4,4,2,10
Tropical Storm,Nicole,1,2004-10-10T09:00:00Z,EDDY POINT NS,0,0,2,6,8
Tropical Storm,Nicole,1,2004-10-10T09:00:00Z,HYANNIS MA,0,3,4,3,10
Tropical Storm,Nicole,1,2004-10-10T09:00:00Z,PTX BASQUES NFLD,0,0,0,3,3
Tropical Storm,Nicole,1,2004-10-10T09:00:00Z,BOSTON MA,0,2,3,3,8
Tropical Storm,Nicole,1,2004-10-10T09:00:00Z,BURGEO NFLD,0,0,0,2,2
Tropical Storm,Nicole,1,2004-10-10T09:00:00Z,PORTLAND ME,0,1,5,4,10
Tropical Storm,Nicole,1,2004-10-10T09:00:00Z,ILE ST PIERRE,0,0,0,2,2
Tropical Storm,Nicole,1,2004-10-10T09:00:00Z,BAR HARBOR ME,0,1,6,5,12
Tropical Storm,Nicole,2,2004-10-10T15:00:00Z,36.6N  65.1W,31,0,0,0,31
Tropical Storm,Nicole,2,2004-10-10T15:00:00Z,EASTPORT ME,0,1,5,5,11
Tropical Storm,Nicole,2,2004-10-10T15:00:00Z,39.5N  64.5W,3,15,1,1,20
Tropical Storm,Nicole,2,2004-10-10T15:00:00Z,ST JOHN NB,0,1,4,5,10
Tropical Storm,Nicole,2,2004-10-10T15:00:00Z,41.1N  64.5W,0,12,3,1,16
Tropical Storm,Nicole,2,2004-10-10T15:00:00Z,MONCTON NB,0,0,3,6,9
Tropical Storm,Nicole,2,2004-10-10T15:00:00Z,BERMUDA,24,0,1,0,25
Tropical Storm,Nicole,2,2004-10-10T15:00:00Z,YARMOUTH NS,0,3,6,4,13
Tropical Storm,Nicole,2,2004-10-10T15:00:00Z,NEW YORK CITY NY,0,0,1,1,2
Tropical Storm,Nicole,2,2004-10-10T15:00:00Z,HALIFAX NS,0,1,3,6,10
Tropical Storm,Nicole,2,2004-10-10T15:00:00Z,MONTAUK POINT NY,0,2,2,2,6
Tropical Storm,Nicole,2,2004-10-10T15:00:00Z,SABLE ISLAND NS,0,0,2,5,7
Tropical Storm,Nicole,2,2004-10-10T15:00:00Z,PROVIDENCE RI,0,2,4,2,8
Tropical Storm,Nicole,2,2004-10-10T15:00:00Z,SYDNEY NS,0,0,0,5,5
Tropical Storm,Nicole,2,2004-10-10T15:00:00Z,NANTUCKET MA,0,5,4,1,10
Tropical Storm,Nicole,2,2004-10-10T15:00:00Z,EDDY POINT NS,0,0,1,6,7
Tropical Storm,Nicole,2,2004-10-10T15:00:00Z,HYANNIS MA,0,4,4,2,10
Tropical Storm,Nicole,2,2004-10-10T15:00:00Z,PTX BASQUES NFLD,0,0,0,3,3
Tropical Storm,Nicole,2,2004-10-10T15:00:00Z,BOSTON MA,0,2,4,3,9
Tropical Storm,Nicole,2,2004-10-10T15:00:00Z,BURGEO NFLD,0,0,0,2,2
Tropical Storm,Nicole,2,2004-10-10T15:00:00Z,PORTLAND ME,0,2,4,4,10
Tropical Storm,Nicole,2,2004-10-10T15:00:00Z,ILE ST PIERRE,0,0,0,2,2
Tropical Storm,Nicole,2,2004-10-10T15:00:00Z,BAR HARBOR ME,0,2,5,4,11
Tropical Storm,Nicole,3,2004-10-10T21:00:00Z,39.0N  65.0W,27,0,1,0,28
Tropical Storm,Nicole,3,2004-10-10T21:00:00Z,PORTLAND ME,0,7,3,0,10
Tropical Storm,Nicole,3,2004-10-10T21:00:00Z,41.0N  65.5W,11,8,1,0,20
Tropical Storm,Nicole,3,2004-10-10T21:00:00Z,BAR HARBOR ME,0,7,4,0,11
Tropical Storm,Nicole,3,2004-10-10T21:00:00Z,41.5N  66.0W,7,11,1,0,19
Tropical Storm,Nicole,3,2004-10-10T21:00:00Z,EASTPORT ME,0,6,4,0,10
Tropical Storm,Nicole,3,2004-10-10T21:00:00Z,BERMUDA,26,0,1,0,27
Tropical Storm,Nicole,3,2004-10-10T21:00:00Z,ST JOHN NB,0,4,4,0,8
Tropical Storm,Nicole,3,2004-10-10T21:00:00Z,NEW YORK CITY NY,0,1,2,0,3
Tropical Storm,Nicole,3,2004-10-10T21:00:00Z,MONCTON NB,0,2,3,0,5
Tropical Storm,Nicole,3,2004-10-10T21:00:00Z,MONTAUK POINT NY,1,4,3,0,8
Tropical Storm,Nicole,3,2004-10-10T21:00:00Z,YARMOUTH NS,0,9,3,0,12
Tropical Storm,Nicole,3,2004-10-10T21:00:00Z,PROVIDENCE RI,1,5,3,0,9
Tropical Storm,Nicole,3,2004-10-10T21:00:00Z,HALIFAX NS,0,4,3,0,7
Tropical Storm,Nicole,3,2004-10-10T21:00:00Z,NANTUCKET MA,2,8,2,0,12
Tropical Storm,Nicole,3,2004-10-10T21:00:00Z,SABLE ISLAND NS,0,1,2,0,3
Tropical Storm,Nicole,3,2004-10-10T21:00:00Z,HYANNIS MA,1,8,3,0,12
Tropical Storm,Nicole,3,2004-10-10T21:00:00Z,EDDY POINT NS,0,1,2,0,3
Tropical Storm,Nicole,3,2004-10-10T21:00:00Z,BOSTON MA,0,7,3,0,10
Tropical Storm,Nicole,4,2004-10-11T03:00:00Z,40.3N  63.4W,20,1,1,0,22
Tropical Storm,Nicole,4,2004-10-11T03:00:00Z,EASTPORT ME,1,8,3,0,12
Tropical Storm,Nicole,4,2004-10-11T03:00:00Z,42.3N  63.8W,12,5,1,0,18
Tropical Storm,Nicole,4,2004-10-11T03:00:00Z,ST JOHN NB,1,8,4,0,13
Tropical Storm,Nicole,4,2004-10-11T03:00:00Z,42.3N  65.0W,11,5,1,0,17
Tropical Storm,Nicole,4,2004-10-11T03:00:00Z,MONCTON NB,1,7,4,0,12
Tropical Storm,Nicole,4,2004-10-11T03:00:00Z,BERMUDA,99,0,0,0,99
Tropical Storm,Nicole,4,2004-10-11T03:00:00Z,YARMOUTH NS,4,8,2,0,14
Tropical Storm,Nicole,4,2004-10-11T03:00:00Z,MONTAUK POINT NY,0,1,2,0,3
Tropical Storm,Nicole,4,2004-10-11T03:00:00Z,HALIFAX NS,3,9,3,0,15
Tropical Storm,Nicole,4,2004-10-11T03:00:00Z,PROVIDENCE RI,0,1,4,0,5
Tropical Storm,Nicole,4,2004-10-11T03:00:00Z,SABLE ISLAND NS,1,8,2,0,11
Tropical Storm,Nicole,4,2004-10-11T03:00:00Z,NANTUCKET MA,0,3,3,0,6
Tropical Storm,Nicole,4,2004-10-11T03:00:00Z,SYDNEY NS,0,5,3,0,8
Tropical Storm,Nicole,4,2004-10-11T03:00:00Z,HYANNIS MA,0,3,3,0,6
Tropical Storm,Nicole,4,2004-10-11T03:00:00Z,EDDY POINT NS,1,7,3,0,11
Tropical Storm,Nicole,4,2004-10-11T03:00:00Z,BOSTON MA,0,2,4,0,6
Tropical Storm,Nicole,4,2004-10-11T03:00:00Z,PTX BASQUES NFLD,0,2,2,0,4
Tropical Storm,Nicole,4,2004-10-11T03:00:00Z,PORTLAND ME,0,3,4,0,7
Tropical Storm,Nicole,4,2004-10-11T03:00:00Z,BURGEO NFLD,0,1,2,0,3
Tropical Storm,Nicole,4,2004-10-11T03:00:00Z,BAR HARBOR ME,1,6,4,0,11
Tropical Storm,Nicole,4,2004-10-11T03:00:00Z,ILE ST PIERRE,0,1,1,0,2
Tropical Storm,Nicole,5,2004-10-11T09:00:00Z,41.5N  63.5W,21,0,0,0,21
Tropical Storm,Nicole,5,2004-10-11T09:00:00Z,MONCTON NB,2,0,0,0,2
Tropical Storm,Nicole,5,2004-10-11T09:00:00Z,BERMUDA,4,0,0,0,4
Tropical Storm,Nicole,5,2004-10-11T09:00:00Z,YARMOUTH NS,8,0,0,0,8
Tropical Storm,Nicole,5,2004-10-11T09:00:00Z,BAR HARBOR ME,2,0,0,0,2
Tropical Storm,Nicole,5,2004-10-11T09:00:00Z,HALIFAX NS,6,0,0,0,6
Tropical Storm,Nicole,5,2004-10-11T09:00:00Z,EASTPORT ME,4,0,0,0,4
Tropical Storm,Nicole,5,2004-10-11T09:00:00Z,SABLE ISLAND NS,2,0,0,0,2
Tropical Storm,Nicole,5,2004-10-11T09:00:00Z,ST JOHN NB,4,0,0,0,4
Tropical Storm,Nicole,6,2004-10-11T15:00:00Z,41.0N  63.0W,30,1,0,0,31
Tropical Storm,Nicole,6,2004-10-11T15:00:00Z,ST JOHN NB,0,7,5,2,14
Tropical Storm,Nicole,6,2004-10-11T15:00:00Z,42.0N  63.0W,21,1,1,0,23
Tropical Storm,Nicole,6,2004-10-11T15:00:00Z,MONCTON NB,0,6,5,3,14
Tropical Storm,Nicole,6,2004-10-11T15:00:00Z,44.0N  62.0W,3,9,3,2,17
Tropical Storm,Nicole,6,2004-10-11T15:00:00Z,YARMOUTH NS,3,8,3,1,15
Tropical Storm,Nicole,6,2004-10-11T15:00:00Z,MONTAUK POINT NY,0,1,0,1,2
Tropical Storm,Nicole,6,2004-10-11T15:00:00Z,HALIFAX NS,1,10,3,2,16
Tropical Storm,Nicole,6,2004-10-11T15:00:00Z,PROVIDENCE RI,0,1,1,1,3
Tropical Storm,Nicole,6,2004-10-11T15:00:00Z,SABLE ISLAND NS,1,8,4,2,15
Tropical Storm,Nicole,6,2004-10-11T15:00:00Z,NANTUCKET MA,0,3,1,1,5
Tropical Storm,Nicole,6,2004-10-11T15:00:00Z,SYDNEY NS,0,3,7,4,14
Tropical Storm,Nicole,6,2004-10-11T15:00:00Z,HYANNIS MA,0,3,1,1,5
Tropical Storm,Nicole,6,2004-10-11T15:00:00Z,EDDY POINT NS,0,7,5,3,15
Tropical Storm,Nicole,6,2004-10-11T15:00:00Z,BOSTON MA,0,2,1,1,4
Tropical Storm,Nicole,6,2004-10-11T15:00:00Z,PTX BASQUES NFLD,0,1,5,5,11
Tropical Storm,Nicole,6,2004-10-11T15:00:00Z,PORTLAND ME,0,2,3,1,6
Tropical Storm,Nicole,6,2004-10-11T15:00:00Z,BURGEO NFLD,0,0,4,6,10
Tropical Storm,Nicole,6,2004-10-11T15:00:00Z,BAR HARBOR ME,0,5,4,1,10
Tropical Storm,Nicole,6,2004-10-11T15:00:00Z,ILE ST PIERRE,0,0,4,5,9
Tropical Storm,Nicole,6,2004-10-11T15:00:00Z,EASTPORT ME,0,7,4,1,12
Tropical Storm,Nicole,6,2004-10-11T15:00:00Z,CAPE RACE NFLD,0,0,1,5,6
Tropical Storm,Nicole,7,2004-10-11T21:00:00Z,43.5N  61.5W,28,0,0,0,28
Tropical Storm,Nicole,7,2004-10-11T21:00:00Z,HALIFAX NS,15,2,1,0,18
Tropical Storm,Nicole,7,2004-10-11T21:00:00Z,45.0N  61.0W,14,3,1,0,18
Tropical Storm,Nicole,7,2004-10-11T21:00:00Z,SABLE ISLAND NS,21,1,1,0,23
Tropical Storm,Nicole,7,2004-10-11T21:00:00Z,48.0N  59.0W,0,6,5,0,11
Tropical Storm,Nicole,7,2004-10-11T21:00:00Z,SYDNEY NS,4,8,2,0,14
Tropical Storm,Nicole,7,2004-10-11T21:00:00Z,BAR HARBOR ME,1,3,1,0,5
Tropical Storm,Nicole,7,2004-10-11T21:00:00Z,EDDY POINT NS,11,4,1,0,16
Tropical Storm,Nicole,7,2004-10-11T21:00:00Z,EASTPORT ME,3,4,1,0,8
Tropical Storm,Nicole,7,2004-10-11T21:00:00Z,PTX BASQUES NFLD,0,8,3,0,11
Tropical Storm,Nicole,7,2004-10-11T21:00:00Z,ST JOHN NB,5,5,1,0,11
Tropical Storm,Nicole,7,2004-10-11T21:00:00Z,BURGEO NFLD,0,6,4,0,10
Tropical Storm,Nicole,7,2004-10-11T21:00:00Z,MONCTON NB,4,7,1,0,12
Tropical Storm,Nicole,7,2004-10-11T21:00:00Z,ILE ST PIERRE,0,5,5,0,10
Tropical Storm,Nicole,7,2004-10-11T21:00:00Z,YARMOUTH NS,7,3,1,0,11
Tropical Storm,Nicole,7,2004-10-11T21:00:00Z,CAPE RACE NFLD,0,1,5,0,6
Tropical Storm,Otto,1,2004-11-30T21:00:00Z,32.0N  50.0W,99,0,0,0,99
Tropical Storm,Otto,1,2004-11-30T21:00:00Z,31.0N  48.5W,10,5,3,1,19
Tropical Storm,Otto,1,2004-11-30T21:00:00Z,31.5N  49.3W,27,1,0,1,29
Tropical Storm,Otto,2,2004-12-01T03:00:00Z,31.0N  49.7W,66,0,0,0,66
Tropical Storm,Otto,2,2004-12-01T03:00:00Z,29.5N  48.0W,9,6,3,2,20
Tropical Storm,Otto,2,2004-12-01T03:00:00Z,30.0N  49.0W,17,3,2,1,23
Tropical Storm,Otto,3,2004-12-01T09:00:00Z,31.0N  50.0W,77,0,0,0,77
Tropical Storm,Otto,3,2004-12-01T09:00:00Z,29.1N  48.5W,7,6,3,3,19
Tropical Storm,Otto,3,2004-12-01T09:00:00Z,30.0N  49.5W,17,3,1,1,22
Tropical Storm,Otto,4,2004-12-01T15:00:00Z,30.0N  49.0W,32,0,0,1,33
Tropical Storm,Otto,4,2004-12-01T15:00:00Z,28.5N  47.5W,12,4,2,2,20
Tropical Storm,Otto,4,2004-12-01T15:00:00Z,29.2N  48.3W,18,3,1,1,23
Tropical Storm,Otto,5,2004-12-01T21:00:00Z,29.2N  48.7W,44,0,0,0,44
Tropical Storm,Otto,5,2004-12-01T21:00:00Z,27.4N  47.0W,15,4,2,1,22
Tropical Storm,Otto,5,2004-12-01T21:00:00Z,28.3N  48.0W,27,1,1,0,29
Tropical Storm,Otto,6,2004-12-02T03:00:00Z,28.8N  48.7W,41,0,0,0,41
Tropical Storm,Otto,6,2004-12-02T03:00:00Z,27.0N  47.0W,12,7,2,1,22
Tropical Storm,Otto,6,2004-12-02T03:00:00Z,27.8N  47.8W,23,2,1,0,26
Tropical Storm,Otto,7,2004-12-02T09:00:00Z,27.9N  49.1W,46,0,0,0,46
Tropical Storm,Otto,7,2004-12-02T09:00:00Z,25.9N  48.1W,13,7,1,1,22
Tropical Storm,Otto,7,2004-12-02T09:00:00Z,26.8N  48.5W,26,1,1,0,28
Tropical Depression,Otto,8,2004-12-02T15:00:00Z,26.7N  50.6W,49,0,0,0,49
Tropical Depression,Otto,8,2004-12-02T15:00:00Z,24.5N  50.5W,9,11,2,1,23
Tropical Depression,Otto,8,2004-12-02T15:00:00Z,25.5N  50.5W,25,2,1,0,28
Tropical Depression,One,1,2005-06-08T21:00:00Z,19.9N  84.3W,38,1,0,0,39
Tropical Depression,One,1,2005-06-08T21:00:00Z,TAMPA FL,0,0,1,5,6
Tropical Depression,One,1,2005-06-08T21:00:00Z,22.2N  85.1W,5,25,1,0,31
Tropical Depression,One,1,2005-06-08T21:00:00Z,CEDAR KEY FL,0,0,0,6,6
Tropical Depression,One,1,2005-06-08T21:00:00Z,24.5N  86.3W,0,13,11,1,25
Tropical Depression,One,1,2005-06-08T21:00:00Z,ST MARKS FL,0,0,0,7,7
Tropical Depression,One,1,2005-06-08T21:00:00Z,MWCG 193N 814W,7,3,1,0,11
Tropical Depression,One,1,2005-06-08T21:00:00Z,APALACHICOLA FL,0,0,1,9,10
Tropical Depression,One,1,2005-06-08T21:00:00Z,MUCF 221N 805W,0,1,0,1,2
Tropical Depression,One,1,2005-06-08T21:00:00Z,PANAMA CITY FL,0,0,1,9,10
Tropical Depression,One,1,2005-06-08T21:00:00Z,MUSN 216N 826W,3,14,0,1,18
Tropical Depression,One,1,2005-06-08T21:00:00Z,PENSACOLA FL,0,0,1,10,11
Tropical Depression,One,1,2005-06-08T21:00:00Z,MUHA 230N 824W,0,7,4,1,12
Tropical Depression,One,1,2005-06-08T21:00:00Z,MOBILE AL,0,0,1,10,11
Tropical Depression,One,1,2005-06-08T21:00:00Z,MUAN 219N 850W,8,24,0,0,32
Tropical Depression,One,1,2005-06-08T21:00:00Z,GULFPORT MS,0,0,1,11,12
Tropical Depression,One,1,2005-06-08T21:00:00Z,MMCZ 205N 869W,9,9,1,0,19
Tropical Depression,One,1,2005-06-08T21:00:00Z,BURAS LA,0,0,2,12,14
Tropical Depression,One,1,2005-06-08T21:00:00Z,MHNJ 165N 859W,6,0,0,0,6
Tropical Depression,One,1,2005-06-08T21:00:00Z,NEW ORLEANS LA,0,0,1,11,12
Tropical Depression,One,1,2005-06-08T21:00:00Z,MMMD 210N 897W,0,0,1,3,4
Tropical Depression,One,1,2005-06-08T21:00:00Z,NEW IBERIA LA,0,0,0,10,10
Tropical Depression,One,1,2005-06-08T21:00:00Z,MARATHON FL,0,0,1,3,4
Tropical Depression,One,1,2005-06-08T21:00:00Z,PORT ARTHUR TX,0,0,0,6,6
Tropical Depression,One,1,2005-06-08T21:00:00Z,MIAMI FL,0,0,0,2,2
Tropical Depression,One,1,2005-06-08T21:00:00Z,GALVESTON TX,0,0,0,5,5
Tropical Depression,One,1,2005-06-08T21:00:00Z,W PALM BEACH FL,0,0,0,2,2
Tropical Depression,One,1,2005-06-08T21:00:00Z,FREEPORT TX,0,0,0,4,4
Tropical Depression,One,1,2005-06-08T21:00:00Z,FT PIERCE FL,0,0,0,2,2
Tropical Depression,One,1,2005-06-08T21:00:00Z,PORT O CONNOR TX,0,0,0,3,3
Tropical Depression,One,1,2005-06-08T21:00:00Z,COCOA BEACH FL,0,0,0,2,2
Tropical Depression,One,1,2005-06-08T21:00:00Z,GULF 29N 85W,0,0,2,9,11
Tropical Depression,One,1,2005-06-08T21:00:00Z,DAYTONA BEACH FL,0,0,0,2,2
Tropical Depression,One,1,2005-06-08T21:00:00Z,GULF 29N 87W,0,0,4,10,14
Tropical Depression,One,1,2005-06-08T21:00:00Z,JACKSONVILLE FL,0,0,0,3,3
Tropical Depression,One,1,2005-06-08T21:00:00Z,GULF 28N 89W,0,0,6,10,16
Tropical Depression,One,1,2005-06-08T21:00:00Z,KEY WEST FL,0,0,3,3,6
Tropical Depression,One,1,2005-06-08T21:00:00Z,GULF 28N 91W,0,0,2,11,13
Tropical Depression,One,1,2005-06-08T21:00:00Z,MARCO ISLAND FL,0,0,1,4,5
Tropical Depression,One,1,2005-06-08T21:00:00Z,GULF 28N 93W,0,0,0,8,8
Tropical Depression,One,1,2005-06-08T21:00:00Z,FT MYERS FL,0,0,1,4,5
Tropical Depression,One,1,2005-06-08T21:00:00Z,GULF 28N 95W,0,0,0,5,5
Tropical Depression,One,1,2005-06-08T21:00:00Z,VENICE FL,0,0,1,6,7
Tropical Depression,One,1,2005-06-08T21:00:00Z,GULF 27N 96W,0,0,0,2,2
Tropical Depression,One,2,2005-06-09T03:00:00Z,21.0N  84.6W,41,1,0,0,42
Tropical Depression,One,2,2005-06-09T03:00:00Z,CEDAR KEY FL,0,0,1,6,7
Tropical Depression,One,2,2005-06-09T03:00:00Z,23.5N  85.7W,4,28,0,0,32
Tropical Depression,One,2,2005-06-09T03:00:00Z,ST MARKS FL,0,0,1,8,9
Tropical Depression,One,2,2005-06-09T03:00:00Z,25.8N  86.8W,0,14,10,0,24
Tropical Depression,One,2,2005-06-09T03:00:00Z,APALACHICOLA FL,0,0,3,9,12
Tropical Depression,One,2,2005-06-09T03:00:00Z,MWCG 193N 814W,5,1,0,0,6
Tropical Depression,One,2,2005-06-09T03:00:00Z,PANAMA CITY FL,0,0,3,10,13
Tropical Depression,One,2,2005-06-09T03:00:00Z,MUSN 216N 826W,12,7,0,0,19
Tropical Depression,One,2,2005-06-09T03:00:00Z,PENSACOLA FL,0,0,3,12,15
Tropical Depression,One,2,2005-06-09T03:00:00Z,MUHA 230N 824W,1,8,2,0,11
Tropical Depression,One,2,2005-06-09T03:00:00Z,MOBILE AL,0,0,3,12,15
Tropical Depression,One,2,2005-06-09T03:00:00Z,MUAN 219N 850W,28,9,0,0,37
Tropical Depression,One,2,2005-06-09T03:00:00Z,GULFPORT MS,0,0,3,12,15
Tropical Depression,One,2,2005-06-09T03:00:00Z,MMCZ 205N 869W,16,4,0,0,20
Tropical Depression,One,2,2005-06-09T03:00:00Z,BURAS LA,0,0,6,10,16
Tropical Depression,One,2,2005-06-09T03:00:00Z,MMMD 210N 897W,0,0,1,1,2
Tropical Depression,One,2,2005-06-09T03:00:00Z,NEW ORLEANS LA,0,0,3,11,14
Tropical Depression,One,2,2005-06-09T03:00:00Z,MARATHON FL,0,0,1,2,3
Tropical Depression,One,2,2005-06-09T03:00:00Z,NEW IBERIA LA,0,0,1,11,12
Tropical Depression,One,2,2005-06-09T03:00:00Z,MIAMI FL,0,0,0,2,2
Tropical Depression,One,2,2005-06-09T03:00:00Z,PORT ARTHUR TX,0,0,0,7,7
Tropical Depression,One,2,2005-06-09T03:00:00Z,FT PIERCE FL,0,0,0,2,2
Tropical Depression,One,2,2005-06-09T03:00:00Z,GALVESTON TX,0,0,0,5,5
Tropical Depression,One,2,2005-06-09T03:00:00Z,COCOA BEACH FL,0,0,0,2,2
Tropical Depression,One,2,2005-06-09T03:00:00Z,FREEPORT TX,0,0,0,4,4
Tropical Depression,One,2,2005-06-09T03:00:00Z,DAYTONA BEACH FL,0,0,0,3,3
Tropical Depression,One,2,2005-06-09T03:00:00Z,PORT O CONNOR TX,0,0,0,2,2
Tropical Depression,One,2,2005-06-09T03:00:00Z,JACKSONVILLE FL,0,0,0,4,4
Tropical Depression,One,2,2005-06-09T03:00:00Z,GULF 29N 85W,0,0,5,8,13
Tropical Depression,One,2,2005-06-09T03:00:00Z,SAVANNAH GA,0,0,0,2,2
Tropical Depression,One,2,2005-06-09T03:00:00Z,GULF 29N 87W,0,0,10,7,17
Tropical Depression,One,2,2005-06-09T03:00:00Z,KEY WEST FL,0,1,2,2,5
Tropical Depression,One,2,2005-06-09T03:00:00Z,GULF 28N 89W,0,0,12,6,18
Tropical Depression,One,2,2005-06-09T03:00:00Z,MARCO ISLAND FL,0,0,1,4,5
Tropical Depression,One,2,2005-06-09T03:00:00Z,GULF 28N 91W,0,0,4,9,13
Tropical Depression,One,2,2005-06-09T03:00:00Z,FT MYERS FL,0,0,1,4,5
Tropical Depression,One,2,2005-06-09T03:00:00Z,GULF 28N 93W,0,0,0,8,8
Tropical Depression,One,2,2005-06-09T03:00:00Z,VENICE FL,0,0,2,5,7
Tropical Depression,One,2,2005-06-09T03:00:00Z,GULF 28N 95W,0,0,0,4,4
Tropical Depression,One,2,2005-06-09T03:00:00Z,TAMPA FL,0,0,1,6,7
Tropical Depression,One,2,2005-06-09T03:00:00Z,GULF 27N 96W,0,0,0,2,2
Tropical Depression,One,3,2005-06-09T09:00:00Z,22.2N  84.8W,41,0,0,0,41
Tropical Depression,One,3,2005-06-09T09:00:00Z,ST MARKS FL,0,0,7,6,13
Tropical Depression,One,3,2005-06-09T09:00:00Z,24.7N  85.8W,4,27,0,0,31
Tropical Depression,One,3,2005-06-09T09:00:00Z,APALACHICOLA FL,0,1,11,4,16
Tropical Depression,One,3,2005-06-09T09:00:00Z,27.2N  87.0W,0,14,11,1,26
Tropical Depression,One,3,2005-06-09T09:00:00Z,PANAMA CITY FL,0,1,11,5,17
Tropical Depression,One,3,2005-06-09T09:00:00Z,MWCG 193N 814W,2,0,0,0,2
Tropical Depression,One,3,2005-06-09T09:00:00Z,PENSACOLA FL,0,0,12,7,19
Tropical Depression,One,3,2005-06-09T09:00:00Z,MUSN 216N 826W,17,2,0,1,20
Tropical Depression,One,3,2005-06-09T09:00:00Z,MOBILE AL,0,0,10,8,18
Tropical Depression,One,3,2005-06-09T09:00:00Z,MUHA 230N 824W,3,7,1,0,11
Tropical Depression,One,3,2005-06-09T09:00:00Z,GULFPORT MS,0,0,10,8,18
Tropical Depression,One,3,2005-06-09T09:00:00Z,MUAN 219N 850W,43,0,0,0,43
Tropical Depression,One,3,2005-06-09T09:00:00Z,BURAS LA,0,0,12,6,18
Tropical Depression,One,3,2005-06-09T09:00:00Z,MMCZ 205N 869W,6,2,1,0,9
Tropical Depression,One,3,2005-06-09T09:00:00Z,NEW ORLEANS LA,0,0,7,9,16
Tropical Depression,One,3,2005-06-09T09:00:00Z,MARATHON FL,0,1,0,1,2
Tropical Depression,One,3,2005-06-09T09:00:00Z,NEW IBERIA LA,0,0,2,11,13
Tropical Depression,One,3,2005-06-09T09:00:00Z,FT PIERCE FL,0,0,0,2,2
Tropical Depression,One,3,2005-06-09T09:00:00Z,PORT ARTHUR TX,0,0,0,8,8
Tropical Depression,One,3,2005-06-09T09:00:00Z,COCOA BEACH FL,0,0,0,2,2
Tropical Depression,One,3,2005-06-09T09:00:00Z,GALVESTON TX,0,0,0,6,6
Tropical Depression,One,3,2005-06-09T09:00:00Z,DAYTONA BEACH FL,0,0,1,3,4
Tropical Depression,One,3,2005-06-09T09:00:00Z,FREEPORT TX,0,0,0,4,4
Tropical Depression,One,3,2005-06-09T09:00:00Z,JACKSONVILLE FL,0,0,1,4,5
Tropical Depression,One,3,2005-06-09T09:00:00Z,PORT O CONNOR TX,0,0,0,3,3
Tropical Depression,One,3,2005-06-09T09:00:00Z,SAVANNAH GA,0,0,0,4,4
Tropical Depression,One,3,2005-06-09T09:00:00Z,GULF 29N 85W,0,2,12,3,17
Tropical Depression,One,3,2005-06-09T09:00:00Z,CHARLESTON SC,0,0,0,2,2
Tropical Depression,One,3,2005-06-09T09:00:00Z,GULF 29N 87W,0,3,16,2,21
Tropical Depression,One,3,2005-06-09T09:00:00Z,KEY WEST FL,0,2,2,1,5
Tropical Depression,One,3,2005-06-09T09:00:00Z,GULF 28N 89W,0,3,15,2,20
Tropical Depression,One,3,2005-06-09T09:00:00Z,MARCO ISLAND FL,0,1,2,1,4
Tropical Depression,One,3,2005-06-09T09:00:00Z,GULF 28N 91W,0,0,8,7,15
Tropical Depression,One,3,2005-06-09T09:00:00Z,FT MYERS FL,0,1,2,2,5
Tropical Depression,One,3,2005-06-09T09:00:00Z,GULF 28N 93W,0,0,1,8,9
Tropical Depression,One,3,2005-06-09T09:00:00Z,VENICE FL,0,1,5,2,8
Tropical Depression,One,3,2005-06-09T09:00:00Z,GULF 28N 95W,0,0,0,4,4
Tropical Depression,One,3,2005-06-09T09:00:00Z,TAMPA FL,0,0,5,3,8
Tropical Depression,One,3,2005-06-09T09:00:00Z,GULF 27N 96W,0,0,0,2,2
Tropical Depression,One,3,2005-06-09T09:00:00Z,CEDAR KEY FL,0,0,5,5,10
Tropical Storm,Arelene,4,2005-06-09T12:00:00Z,22.2N  84.8W,40,1,0,0,41
Tropical Storm,Arelene,4,2005-06-09T12:00:00Z,ST MARKS FL,0,0,6,6,12
Tropical Storm,Arelene,4,2005-06-09T12:00:00Z,24.7N  85.8W,3,29,0,0,32
Tropical Storm,Arelene,4,2005-06-09T12:00:00Z,APALACHICOLA FL,0,0,11,4,15
Tropical Storm,Arelene,4,2005-06-09T12:00:00Z,27.2N  87.0W,0,13,12,1,26
Tropical Storm,Arelene,4,2005-06-09T12:00:00Z,PANAMA CITY FL,0,0,11,6,17
Tropical Storm,Arelene,4,2005-06-09T12:00:00Z,MWCG 193N 814W,3,0,0,0,3
Tropical Storm,Arelene,4,2005-06-09T12:00:00Z,PENSACOLA FL,0,0,12,6,18
Tropical Storm,Arelene,4,2005-06-09T12:00:00Z,MUSN 216N 826W,18,2,0,0,20
Tropical Storm,Arelene,4,2005-06-09T12:00:00Z,MOBILE AL,0,0,10,8,18
Tropical Storm,Arelene,4,2005-06-09T12:00:00Z,MUHA 230N 824W,3,7,1,0,11
Tropical Storm,Arelene,4,2005-06-09T12:00:00Z,GULFPORT MS,0,0,9,9,18
Tropical Storm,Arelene,4,2005-06-09T12:00:00Z,MUAN 219N 850W,43,0,0,0,43
Tropical Storm,Arelene,4,2005-06-09T12:00:00Z,BURAS LA,0,0,11,7,18
Tropical Storm,Arelene,4,2005-06-09T12:00:00Z,MMCZ 205N 869W,6,2,1,0,9
Tropical Storm,Arelene,4,2005-06-09T12:00:00Z,NEW ORLEANS LA,0,0,7,9,16
Tropical Storm,Arelene,4,2005-06-09T12:00:00Z,MARATHON FL,0,0,1,1,2
Tropical Storm,Arelene,4,2005-06-09T12:00:00Z,NEW IBERIA LA,0,0,2,10,12
Tropical Storm,Arelene,4,2005-06-09T12:00:00Z,FT PIERCE FL,0,0,0,2,2
Tropical Storm,Arelene,4,2005-06-09T12:00:00Z,PORT ARTHUR TX,0,0,0,7,7
Tropical Storm,Arelene,4,2005-06-09T12:00:00Z,COCOA BEACH FL,0,0,0,2,2
Tropical Storm,Arelene,4,2005-06-09T12:00:00Z,GALVESTON TX,0,0,0,5,5
Tropical Storm,Arelene,4,2005-06-09T12:00:00Z,DAYTONA BEACH FL,0,0,0,3,3
Tropical Storm,Arelene,4,2005-06-09T12:00:00Z,FREEPORT TX,0,0,0,4,4
Tropical Storm,Arelene,4,2005-06-09T12:00:00Z,JACKSONVILLE FL,0,0,0,5,5
Tropical Storm,Arelene,4,2005-06-09T12:00:00Z,PORT O CONNOR TX,0,0,0,2,2
Tropical Storm,Arelene,4,2005-06-09T12:00:00Z,SAVANNAH GA,0,0,0,3,3
Tropical Storm,Arelene,4,2005-06-09T12:00:00Z,GULF 29N 85W,0,1,12,4,17
Tropical Storm,Arelene,4,2005-06-09T12:00:00Z,CHARLESTON SC,0,0,0,2,2
Tropical Storm,Arelene,4,2005-06-09T12:00:00Z,GULF 29N 87W,0,2,17,2,21
Tropical Storm,Arelene,4,2005-06-09T12:00:00Z,KEY WEST FL,0,2,2,0,4
Tropical Storm,Arelene,4,2005-06-09T12:00:00Z,GULF 28N 89W,0,2,15,3,20
Tropical Storm,Arelene,4,2005-06-09T12:00:00Z,MARCO ISLAND FL,0,1,1,2,4
Tropical Storm,Arelene,4,2005-06-09T12:00:00Z,GULF 28N 91W,0,0,7,7,14
Tropical Storm,Arelene,4,2005-06-09T12:00:00Z,FT MYERS FL,0,1,2,2,5
Tropical Storm,Arelene,4,2005-06-09T12:00:00Z,GULF 28N 93W,0,0,1,7,8
Tropical Storm,Arelene,4,2005-06-09T12:00:00Z,VENICE FL,0,1,4,3,8
Tropical Storm,Arelene,4,2005-06-09T12:00:00Z,GULF 28N 95W,0,0,0,4,4
Tropical Storm,Arelene,4,2005-06-09T12:00:00Z,TAMPA FL,0,0,4,4,8
Tropical Storm,Arelene,4,2005-06-09T12:00:00Z,GULF 27N 96W,0,0,0,2,2
Tropical Storm,Arelene,4,2005-06-09T12:00:00Z,CEDAR KEY FL,0,0,4,5,9
Tropical Storm,Arlene,5,2005-06-09T15:00:00Z,23.8N  85.5W,43,0,0,0,43
Tropical Storm,Arlene,5,2005-06-09T15:00:00Z,ST MARKS FL,0,1,10,3,14
Tropical Storm,Arlene,5,2005-06-09T15:00:00Z,26.0N  86.5W,7,25,0,0,32
Tropical Storm,Arlene,5,2005-06-09T15:00:00Z,APALACHICOLA FL,0,4,12,2,18
Tropical Storm,Arlene,5,2005-06-09T15:00:00Z,28.5N  87.5W,0,13,13,0,26
Tropical Storm,Arlene,5,2005-06-09T15:00:00Z,PANAMA CITY FL,0,3,14,2,19
Tropical Storm,Arlene,5,2005-06-09T15:00:00Z,MUSN 216N 826W,27,0,0,0,27
Tropical Storm,Arlene,5,2005-06-09T15:00:00Z,PENSACOLA FL,0,2,16,3,21
Tropical Storm,Arlene,5,2005-06-09T15:00:00Z,MUHA 230N 824W,13,1,0,0,14
Tropical Storm,Arlene,5,2005-06-09T15:00:00Z,MOBILE AL,0,1,16,4,21
Tropical Storm,Arlene,5,2005-06-09T15:00:00Z,MUAN 219N 850W,60,0,0,0,60
Tropical Storm,Arlene,5,2005-06-09T15:00:00Z,GULFPORT MS,0,1,15,4,20
Tropical Storm,Arlene,5,2005-06-09T15:00:00Z,MMCZ 205N 869W,6,1,0,0,7
Tropical Storm,Arlene,5,2005-06-09T15:00:00Z,BURAS LA,0,1,16,3,20
Tropical Storm,Arlene,5,2005-06-09T15:00:00Z,COCOA BEACH FL,0,0,0,2,2
Tropical Storm,Arlene,5,2005-06-09T15:00:00Z,NEW ORLEANS LA,0,0,12,5,17
Tropical Storm,Arlene,5,2005-06-09T15:00:00Z,DAYTONA BEACH FL,0,0,1,2,3
Tropical Storm,Arlene,5,2005-06-09T15:00:00Z,NEW IBERIA LA,0,0,5,8,13
Tropical Storm,Arlene,5,2005-06-09T15:00:00Z,JACKSONVILLE FL,0,0,1,5,6
Tropical Storm,Arlene,5,2005-06-09T15:00:00Z,PORT ARTHUR TX,0,0,1,6,7
Tropical Storm,Arlene,5,2005-06-09T15:00:00Z,SAVANNAH GA,0,0,0,5,5
Tropical Storm,Arlene,5,2005-06-09T15:00:00Z,GALVESTON TX,0,0,0,4,4
Tropical Storm,Arlene,5,2005-06-09T15:00:00Z,CHARLESTON SC,0,0,0,3,3
Tropical Storm,Arlene,5,2005-06-09T15:00:00Z,FREEPORT TX,0,0,0,3,3
Tropical Storm,Arlene,5,2005-06-09T15:00:00Z,MYRTLE BEACH SC,0,0,0,2,2
Tropical Storm,Arlene,5,2005-06-09T15:00:00Z,GULF 29N 85W,0,7,11,2,20
Tropical Storm,Arlene,5,2005-06-09T15:00:00Z,KEY WEST FL,1,2,0,1,4
Tropical Storm,Arlene,5,2005-06-09T15:00:00Z,GULF 29N 87W,0,10,14,1,25
Tropical Storm,Arlene,5,2005-06-09T15:00:00Z,MARCO ISLAND FL,0,2,0,1,3
Tropical Storm,Arlene,5,2005-06-09T15:00:00Z,GULF 28N 89W,0,8,13,1,22
Tropical Storm,Arlene,5,2005-06-09T15:00:00Z,FT MYERS FL,0,2,1,1,4
Tropical Storm,Arlene,5,2005-06-09T15:00:00Z,GULF 28N 91W,0,1,10,3,14
Tropical Storm,Arlene,5,2005-06-09T15:00:00Z,VENICE FL,0,3,3,1,7
Tropical Storm,Arlene,5,2005-06-09T15:00:00Z,GULF 28N 93W,0,0,2,5,7
Tropical Storm,Arlene,5,2005-06-09T15:00:00Z,TAMPA FL,0,2,3,2,7
Tropical Storm,Arlene,5,2005-06-09T15:00:00Z,GULF 28N 95W,0,0,0,3,3
Tropical Storm,Arlene,5,2005-06-09T15:00:00Z,CEDAR KEY FL,0,1,6,3,10
Tropical Storm,Arlene,6,2005-06-09T21:00:00Z,24.0N  86.0W,41,0,0,0,41
Tropical Storm,Arlene,6,2005-06-09T21:00:00Z,APALACHICOLA FL,0,3,10,2,15
Tropical Storm,Arlene,6,2005-06-09T21:00:00Z,26.5N  87.3W,3,26,1,0,30
Tropical Storm,Arlene,6,2005-06-09T21:00:00Z,PANAMA CITY FL,0,3,12,2,17
Tropical Storm,Arlene,6,2005-06-09T21:00:00Z,29.5N  88.5W,0,8,16,1,25
Tropical Storm,Arlene,6,2005-06-09T21:00:00Z,PENSACOLA FL,0,3,16,2,21
Tropical Storm,Arlene,6,2005-06-09T21:00:00Z,MUSN 216N 826W,26,0,0,0,26
Tropical Storm,Arlene,6,2005-06-09T21:00:00Z,MOBILE AL,0,2,18,2,22
Tropical Storm,Arlene,6,2005-06-09T21:00:00Z,MUHA 230N 824W,8,1,0,0,9
Tropical Storm,Arlene,6,2005-06-09T21:00:00Z,GULFPORT MS,0,3,17,2,22
Tropical Storm,Arlene,6,2005-06-09T21:00:00Z,MUAN 219N 850W,60,0,0,0,60
Tropical Storm,Arlene,6,2005-06-09T21:00:00Z,BURAS LA,0,6,16,1,23
Tropical Storm,Arlene,6,2005-06-09T21:00:00Z,MMCZ 205N 869W,9,0,0,0,9
Tropical Storm,Arlene,6,2005-06-09T21:00:00Z,NEW ORLEANS LA,0,2,17,2,21
Tropical Storm,Arlene,6,2005-06-09T21:00:00Z,DAYTONA BEACH FL,0,0,0,2,2
Tropical Storm,Arlene,6,2005-06-09T21:00:00Z,NEW IBERIA LA,0,1,11,4,16
Tropical Storm,Arlene,6,2005-06-09T21:00:00Z,JACKSONVILLE FL,0,0,1,3,4
Tropical Storm,Arlene,6,2005-06-09T21:00:00Z,PORT ARTHUR TX,0,0,3,6,9
Tropical Storm,Arlene,6,2005-06-09T21:00:00Z,SAVANNAH GA,0,0,0,4,4
Tropical Storm,Arlene,6,2005-06-09T21:00:00Z,GALVESTON TX,0,0,1,5,6
Tropical Storm,Arlene,6,2005-06-09T21:00:00Z,CHARLESTON SC,0,0,0,3,3
Tropical Storm,Arlene,6,2005-06-09T21:00:00Z,FREEPORT TX,0,0,1,3,4
Tropical Storm,Arlene,6,2005-06-09T21:00:00Z,MYRTLE BEACH SC,0,0,0,2,2
Tropical Storm,Arlene,6,2005-06-09T21:00:00Z,PORT O CONNOR TX,0,0,0,2,2
Tropical Storm,Arlene,6,2005-06-09T21:00:00Z,KEY WEST FL,1,0,1,0,2
Tropical Storm,Arlene,6,2005-06-09T21:00:00Z,GULF 29N 85W,0,5,9,2,16
Tropical Storm,Arlene,6,2005-06-09T21:00:00Z,MARCO ISLAND FL,0,1,0,1,2
Tropical Storm,Arlene,6,2005-06-09T21:00:00Z,GULF 29N 87W,0,12,12,0,24
Tropical Storm,Arlene,6,2005-06-09T21:00:00Z,FT MYERS FL,0,1,0,1,2
Tropical Storm,Arlene,6,2005-06-09T21:00:00Z,GULF 28N 89W,0,17,9,0,26
Tropical Storm,Arlene,6,2005-06-09T21:00:00Z,VENICE FL,0,1,2,1,4
Tropical Storm,Arlene,6,2005-06-09T21:00:00Z,GULF 28N 91W,0,5,12,1,18
Tropical Storm,Arlene,6,2005-06-09T21:00:00Z,TAMPA FL,0,1,2,1,4
Tropical Storm,Arlene,6,2005-06-09T21:00:00Z,GULF 28N 93W,0,0,6,3,9
Tropical Storm,Arlene,6,2005-06-09T21:00:00Z,CEDAR KEY FL,0,1,2,4,7
Tropical Storm,Arlene,6,2005-06-09T21:00:00Z,GULF 28N 95W,0,0,1,3,4
Tropical Storm,Arlene,6,2005-06-09T21:00:00Z,ST MARKS FL,0,1,6,4,11
Tropical Storm,Arlene,7,2005-06-10T03:00:00Z,25.0N  86.3W,41,2,0,0,43
Tropical Storm,Arlene,7,2005-06-10T03:00:00Z,PENSACOLA FL,0,8,12,1,21
Tropical Storm,Arlene,7,2005-06-10T03:00:00Z,27.7N  87.9W,2,31,0,0,33
Tropical Storm,Arlene,7,2005-06-10T03:00:00Z,MOBILE AL,0,9,14,1,24
Tropical Storm,Arlene,7,2005-06-10T03:00:00Z,30.5N  88.6W,0,12,12,1,25
Tropical Storm,Arlene,7,2005-06-10T03:00:00Z,GULFPORT MS,0,13,12,1,26
Tropical Storm,Arlene,7,2005-06-10T03:00:00Z,MUSN 216N 826W,19,0,0,0,19
Tropical Storm,Arlene,7,2005-06-10T03:00:00Z,BURAS LA,0,20,6,1,27
Tropical Storm,Arlene,7,2005-06-10T03:00:00Z,MUHA 230N 824W,5,1,0,0,6
Tropical Storm,Arlene,7,2005-06-10T03:00:00Z,NEW ORLEANS LA,0,12,11,1,24
Tropical Storm,Arlene,7,2005-06-10T03:00:00Z,MUAN 219N 850W,75,0,0,0,75
Tropical Storm,Arlene,7,2005-06-10T03:00:00Z,NEW IBERIA LA,0,4,10,2,16
Tropical Storm,Arlene,7,2005-06-10T03:00:00Z,JACKSONVILLE FL,0,0,0,3,3
Tropical Storm,Arlene,7,2005-06-10T03:00:00Z,PORT ARTHUR TX,0,0,3,3,6
Tropical Storm,Arlene,7,2005-06-10T03:00:00Z,SAVANNAH GA,0,0,0,3,3
Tropical Storm,Arlene,7,2005-06-10T03:00:00Z,GALVESTON TX,0,0,1,2,3
Tropical Storm,Arlene,7,2005-06-10T03:00:00Z,CHARLESTON SC,0,0,0,2,2
Tropical Storm,Arlene,7,2005-06-10T03:00:00Z,GULF 29N 85W,0,5,6,1,12
Tropical Storm,Arlene,7,2005-06-10T03:00:00Z,TAMPA FL,0,0,1,1,2
Tropical Storm,Arlene,7,2005-06-10T03:00:00Z,GULF 29N 87W,0,20,4,1,25
Tropical Storm,Arlene,7,2005-06-10T03:00:00Z,CEDAR KEY FL,0,0,1,3,4
Tropical Storm,Arlene,7,2005-06-10T03:00:00Z,GULF 28N 89W,1,28,1,0,30
Tropical Storm,Arlene,7,2005-06-10T03:00:00Z,ST MARKS FL,0,0,4,4,8
Tropical Storm,Arlene,7,2005-06-10T03:00:00Z,GULF 28N 91W,0,11,5,1,17
Tropical Storm,Arlene,7,2005-06-10T03:00:00Z,APALACHICOLA FL,0,2,7,3,12
Tropical Storm,Arlene,7,2005-06-10T03:00:00Z,GULF 28N 93W,0,1,2,2,5
Tropical Storm,Arlene,7,2005-06-10T03:00:00Z,PANAMA CITY FL,0,3,10,2,15
Tropical Storm,Arlene,8,2005-06-10T09:00:00Z,26.2N  87.2W,42,1,0,0,43
Tropical Storm,Arlene,8,2005-06-10T09:00:00Z,MOBILE AL,0,17,7,1,25
Tropical Storm,Arlene,8,2005-06-10T09:00:00Z,28.5N  88.3W,5,26,0,0,31
Tropical Storm,Arlene,8,2005-06-10T09:00:00Z,GULFPORT MS,0,20,6,0,26
Tropical Storm,Arlene,8,2005-06-10T09:00:00Z,31.0N  88.8W,0,15,9,1,25
Tropical Storm,Arlene,8,2005-06-10T09:00:00Z,BURAS LA,0,24,3,0,27
Tropical Storm,Arlene,8,2005-06-10T09:00:00Z,MUSN 216N 826W,2,0,0,0,2
Tropical Storm,Arlene,8,2005-06-10T09:00:00Z,NEW ORLEANS LA,0,18,5,1,24
Tropical Storm,Arlene,8,2005-06-10T09:00:00Z,MUAN 219N 850W,99,0,0,0,99
Tropical Storm,Arlene,8,2005-06-10T09:00:00Z,NEW IBERIA LA,0,7,8,1,16
Tropical Storm,Arlene,8,2005-06-10T09:00:00Z,JACKSONVILLE FL,0,0,0,2,2
Tropical Storm,Arlene,8,2005-06-10T09:00:00Z,PORT ARTHUR TX,0,0,3,3,6
Tropical Storm,Arlene,8,2005-06-10T09:00:00Z,SAVANNAH GA,0,0,0,3,3
Tropical Storm,Arlene,8,2005-06-10T09:00:00Z,GALVESTON TX,0,0,1,2,3
Tropical Storm,Arlene,8,2005-06-10T09:00:00Z,CHARLESTON SC,0,0,0,2,2
Tropical Storm,Arlene,8,2005-06-10T09:00:00Z,GULF 29N 85W,0,7,4,1,12
Tropical Storm,Arlene,8,2005-06-10T09:00:00Z,CEDAR KEY FL,0,0,1,2,3
Tropical Storm,Arlene,8,2005-06-10T09:00:00Z,GULF 29N 87W,1,22,2,0,25
Tropical Storm,Arlene,8,2005-06-10T09:00:00Z,ST MARKS FL,0,1,4,3,8
Tropical Storm,Arlene,8,2005-06-10T09:00:00Z,GULF 28N 89W,9,21,0,0,30
Tropical Storm,Arlene,8,2005-06-10T09:00:00Z,APALACHICOLA FL,0,4,6,2,12
Tropical Storm,Arlene,8,2005-06-10T09:00:00Z,GULF 28N 91W,1,13,2,1,17
Tropical Storm,Arlene,8,2005-06-10T09:00:00Z,PANAMA CITY FL,0,6,7,2,15
Tropical Storm,Arlene,8,2005-06-10T09:00:00Z,GULF 28N 93W,0,1,3,1,5
Tropical Storm,Arlene,8,2005-06-10T09:00:00Z,PENSACOLA FL,0,14,7,1,22
Tropical Storm,Arlene,9,2005-06-10T15:00:00Z,28.8N  87.3W,43,1,0,0,44
Tropical Storm,Arlene,9,2005-06-10T15:00:00Z,GULFPORT MS,9,23,0,0,32
Tropical Storm,Arlene,9,2005-06-10T15:00:00Z,31.1N  88.5W,5,27,0,0,32
Tropical Storm,Arlene,9,2005-06-10T15:00:00Z,BURAS LA,13,14,0,1,28
Tropical Storm,Arlene,9,2005-06-10T15:00:00Z,33.8N  88.8W,0,12,12,1,25
Tropical Storm,Arlene,9,2005-06-10T15:00:00Z,NEW ORLEANS LA,4,18,1,0,23
Tropical Storm,Arlene,9,2005-06-10T15:00:00Z,SAVANNAH GA,0,0,0,2,2
Tropical Storm,Arlene,9,2005-06-10T15:00:00Z,NEW IBERIA LA,0,7,4,0,11
Tropical Storm,Arlene,9,2005-06-10T15:00:00Z,CEDAR KEY FL,1,0,0,1,2
Tropical Storm,Arlene,9,2005-06-10T15:00:00Z,PORT ARTHUR TX,0,0,1,1,2
Tropical Storm,Arlene,9,2005-06-10T15:00:00Z,ST MARKS FL,2,4,2,0,8
Tropical Storm,Arlene,9,2005-06-10T15:00:00Z,GULF 29N 85W,22,2,0,0,24
Tropical Storm,Arlene,9,2005-06-10T15:00:00Z,APALACHICOLA FL,12,5,1,0,18
Tropical Storm,Arlene,9,2005-06-10T15:00:00Z,GULF 29N 87W,41,2,0,0,43
Tropical Storm,Arlene,9,2005-06-10T15:00:00Z,PANAMA CITY FL,14,8,0,0,22
Tropical Storm,Arlene,9,2005-06-10T15:00:00Z,GULF 28N 89W,27,3,0,0,30
Tropical Storm,Arlene,9,2005-06-10T15:00:00Z,PENSACOLA FL,16,16,0,0,32
Tropical Storm,Arlene,9,2005-06-10T15:00:00Z,GULF 28N 91W,2,5,1,0,8
Tropical Storm,Arlene,9,2005-06-10T15:00:00Z,MOBILE AL,11,22,1,0,34
Tropical Storm,Arlene,10,2005-06-10T21:00:00Z,30.4N  87.3W,44,0,0,0,44
Tropical Storm,Arlene,10,2005-06-10T21:00:00Z,GULFPORT MS,28,4,0,0,32
Tropical Storm,Arlene,10,2005-06-10T21:00:00Z,32.6N  87.9W,15,17,0,0,32
Tropical Storm,Arlene,10,2005-06-10T21:00:00Z,BURAS LA,20,4,0,0,24
Tropical Storm,Arlene,10,2005-06-10T21:00:00Z,35.5N  87.5W,0,12,13,0,25
Tropical Storm,Arlene,10,2005-06-10T21:00:00Z,NEW ORLEANS LA,11,7,0,0,18
Tropical Storm,Arlene,10,2005-06-10T21:00:00Z,CEDAR KEY FL,2,0,0,0,2
Tropical Storm,Arlene,10,2005-06-10T21:00:00Z,NEW IBERIA LA,1,3,2,0,6
Tropical Storm,Arlene,10,2005-06-10T21:00:00Z,ST MARKS FL,12,1,1,0,14
Tropical Storm,Arlene,10,2005-06-10T21:00:00Z,GULF 29N 85W,46,0,0,0,46
Tropical Storm,Arlene,10,2005-06-10T21:00:00Z,APALACHICOLA FL,34,0,0,0,34
Tropical Storm,Arlene,10,2005-06-10T21:00:00Z,GULF 29N 87W,57,0,0,0,57
Tropical Storm,Arlene,10,2005-06-10T21:00:00Z,PANAMA CITY FL,40,0,0,0,40
Tropical Storm,Arlene,10,2005-06-10T21:00:00Z,GULF 28N 89W,19,1,0,0,20
Tropical Storm,Arlene,10,2005-06-10T21:00:00Z,PENSACOLA FL,43,0,0,0,43
Tropical Storm,Arlene,10,2005-06-10T21:00:00Z,GULF 28N 91W,1,2,0,0,3
Tropical Storm,Arlene,10,2005-06-10T21:00:00Z,MOBILE AL,37,2,0,0,39
Tropical Storm,Arlene,11,2005-06-11T03:00:00Z,31.0N  88.0W,37,0,0,0,37
Tropical Storm,Arlene,11,2005-06-11T03:00:00Z,GULFPORT MS,33,0,0,0,33
Tropical Storm,Arlene,11,2005-06-11T03:00:00Z,33.5N  88.0W,8,21,2,0,31
Tropical Storm,Arlene,11,2005-06-11T03:00:00Z,BURAS LA,24,1,0,0,25
Tropical Storm,Arlene,11,2005-06-11T03:00:00Z,37.0N  87.6W,0,6,19,0,25
Tropical Storm,Arlene,11,2005-06-11T03:00:00Z,NEW ORLEANS LA,17,2,0,0,19
Tropical Storm,Arlene,11,2005-06-11T03:00:00Z,ST MARKS FL,5,4,0,0,9
Tropical Storm,Arlene,11,2005-06-11T03:00:00Z,NEW IBERIA LA,2,2,0,0,4
Tropical Storm,Arlene,11,2005-06-11T03:00:00Z,APALACHICOLA FL,18,1,0,0,19
Tropical Storm,Arlene,11,2005-06-11T03:00:00Z,GULF 29N 85W,24,0,1,0,25
Tropical Storm,Arlene,11,2005-06-11T03:00:00Z,PANAMA CITY FL,27,1,0,0,28
Tropical Storm,Arlene,11,2005-06-11T03:00:00Z,GULF 29N 87W,64,0,0,0,64
Tropical Storm,Arlene,11,2005-06-11T03:00:00Z,PENSACOLA FL,41,0,0,0,41
Tropical Storm,Arlene,11,2005-06-11T03:00:00Z,GULF 28N 89W,20,0,0,0,20
Tropical Storm,Arlene,11,2005-06-11T03:00:00Z,MOBILE AL,39,0,0,0,39
Tropical Storm,Arlene,11,2005-06-11T03:00:00Z,GULF 28N 91W,1,1,0,0,2
Tropical Storm,Arlene,12,2005-06-11T09:00:00Z,32.5N  88.5W,37,2,0,0,39
Tropical Storm,Arlene,12,2005-06-11T09:00:00Z,GULFPORT MS,50,0,0,0,50
Tropical Storm,Arlene,12,2005-06-11T09:00:00Z,35.5N  88.5W,3,29,3,0,35
Tropical Storm,Arlene,12,2005-06-11T09:00:00Z,BURAS LA,37,0,0,0,37
Tropical Storm,Arlene,12,2005-06-11T09:00:00Z,39.5N  86.5W,0,1,23,0,24
Tropical Storm,Arlene,12,2005-06-11T09:00:00Z,NEW ORLEANS LA,23,0,0,0,23
Tropical Storm,Arlene,12,2005-06-11T09:00:00Z,ST MARKS FL,1,1,0,0,2
Tropical Storm,Arlene,12,2005-06-11T09:00:00Z,NEW IBERIA LA,2,0,0,0,2
Tropical Storm,Arlene,12,2005-06-11T09:00:00Z,APALACHICOLA FL,7,1,0,0,8
Tropical Storm,Arlene,12,2005-06-11T09:00:00Z,GULF 29N 85W,7,0,0,0,7
Tropical Storm,Arlene,12,2005-06-11T09:00:00Z,PANAMA CITY FL,22,0,0,0,22
Tropical Storm,Arlene,12,2005-06-11T09:00:00Z,GULF 29N 87W,99,0,0,0,99
Tropical Storm,Arlene,12,2005-06-11T09:00:00Z,PENSACOLA FL,55,0,0,0,55
Tropical Storm,Arlene,12,2005-06-11T09:00:00Z,GULF 28N 89W,31,0,0,0,31
Tropical Storm,Arlene,12,2005-06-11T09:00:00Z,MOBILE AL,57,0,0,0,57
Tropical Storm,Arlene,13,2005-06-11T15:00:00Z,34.0N  88.0W,36,3,0,0,39
Tropical Storm,Arlene,13,2005-06-11T15:00:00Z,GULFPORT MS,62,0,0,0,62
Tropical Storm,Arlene,13,2005-06-11T15:00:00Z,37.5N  87.5W,1,30,0,0,31
Tropical Storm,Arlene,13,2005-06-11T15:00:00Z,BURAS LA,11,0,0,0,11
Tropical Storm,Arlene,13,2005-06-11T15:00:00Z,APALACHICOLA FL,7,0,0,0,7
Tropical Storm,Arlene,13,2005-06-11T15:00:00Z,NEW ORLEANS LA,4,0,0,0,4
Tropical Storm,Arlene,13,2005-06-11T15:00:00Z,PANAMA CITY FL,42,0,0,0,42
Tropical Storm,Arlene,13,2005-06-11T15:00:00Z,GULF 29N 85W,8,0,0,0,8
Tropical Storm,Arlene,13,2005-06-11T15:00:00Z,PENSACOLA FL,99,0,0,0,99
Tropical Storm,Arlene,13,2005-06-11T15:00:00Z,GULF 29N 87W,99,0,0,0,99
Tropical Storm,Arlene,13,2005-06-11T15:00:00Z,MOBILE AL,79,0,0,0,79
Tropical Storm,Arlene,14,2005-06-11T21:00:00Z,36.0N  87.5W,37,0,0,0,37
Tropical Storm,Arlene,14,2005-06-11T21:00:00Z,MOBILE AL,99,0,0,0,99
Tropical Storm,Arlene,14,2005-06-11T21:00:00Z,PANAMA CITY FL,11,0,0,0,11
Tropical Storm,Arlene,14,2005-06-11T21:00:00Z,GULF 29N 87W,31,0,0,0,31
Tropical Storm,Arlene,14,2005-06-11T21:00:00Z,PENSACOLA FL,99,0,0,0,99
Tropical Depression,Arlene,15,2005-06-12T03:00:00Z,37.9N  87.2W,57,0,0,0,57
Tropical Depression,Arlene,15,2005-06-12T03:00:00Z,MOBILE AL,99,0,0,0,99
Tropical Depression,Arlene,15,2005-06-12T03:00:00Z,PENSACOLA FL,99,0,0,0,99
Tropical Depression,Two,1,2005-06-28T22:00:00Z,20.7N  97.7W,46,0,0,0,46
Tropical Depression,Two,1,2005-06-28T22:00:00Z,MMTM 222N 979W,16,0,0,0,16
Tropical Depression,Two,1,2005-06-28T22:00:00Z,,99,0,0,0,99
Tropical Depression,Two,1,2005-06-28T22:00:00Z,MMTX 210N 974W,47,0,0,0,47
Tropical Depression,Two,1,2005-06-28T22:00:00Z,,99,0,0,0,99
Tropical Depression,Two,1,2005-06-28T22:00:00Z,MMVR 192N 961W,99,0,0,0,99
Tropical Storm,Bret,2,2005-06-29T03:00:00Z,20.9N  97.4W,46,0,0,0,46
Tropical Storm,Bret,2,2005-06-29T03:00:00Z,MMTM 222N 979W,17,6,0,0,23
Tropical Storm,Bret,2,2005-06-29T03:00:00Z,21.5N  98.5W,24,3,0,0,27
Tropical Storm,Bret,2,2005-06-29T03:00:00Z,MMTX 210N 974W,45,0,0,0,45
Tropical Storm,Bret,2,2005-06-29T03:00:00Z,,99,0,0,0,99
Tropical Storm,Bret,2,2005-06-29T03:00:00Z,MMVR 192N 961W,99,0,0,0,99
Tropical Storm,Bret,2,2005-06-29T03:00:00Z,MMSO 238N 982W,0,10,0,0,10
Tropical Storm,Bret,3,2005-06-29T09:00:00Z,21.7N  98.5W,49,0,0,0,49
Tropical Storm,Bret,3,2005-06-29T09:00:00Z,MMTM 222N 979W,43,0,0,0,43
Tropical Storm,Bret,3,2005-06-29T09:00:00Z,,99,0,0,0,99
Tropical Storm,Bret,3,2005-06-29T09:00:00Z,MMTX 210N 974W,99,0,0,0,99
Tropical Storm,Bret,3,2005-06-29T09:00:00Z,,99,0,0,0,99
Tropical Storm,Bret,3,2005-06-29T09:00:00Z,MMVR 192N 961W,16,0,0,0,16
Tropical Storm,Bret,3,2005-06-29T09:00:00Z,MMSO 238N 982W,6,0,0,0,6
Tropical Depression,Bret,4,2005-06-29T15:00:00Z,,99,0,0,0,99
Tropical Depression,Bret,4,2005-06-29T15:00:00Z,MMSO 238N 982W,2,0,0,0,2
Tropical Depression,Bret,4,2005-06-29T15:00:00Z,,99,0,0,0,99
Tropical Depression,Bret,4,2005-06-29T15:00:00Z,MMTM 222N 979W,63,0,0,0,63
Tropical Depression,Bret,4,2005-06-29T15:00:00Z,,99,0,0,0,99
Tropical Depression,Bret,4,2005-06-29T15:00:00Z,MMTX 210N 974W,99,0,0,0,99
Tropical Depression,Bret,5,2005-06-29T21:00:00Z,,99,0,0,0,99
Tropical Depression,Bret,5,2005-06-29T21:00:00Z,MMSO 238N 982W,16,0,0,0,16
Tropical Depression,Bret,5,2005-06-29T21:00:00Z,,99,0,0,0,99
Tropical Depression,Bret,5,2005-06-29T21:00:00Z,MMTM 222N 979W,99,0,0,0,99
Tropical Depression,Bret,5,2005-06-29T21:00:00Z,,99,0,0,0,99
Tropical Depression,Bret,5,2005-06-29T21:00:00Z,MMTX 210N 974W,99,0,0,0,99
Tropical Depression,Bret,6,2005-06-30T03:00:00Z,,99,0,0,0,99
Tropical Depression,Bret,6,2005-06-30T03:00:00Z,MMSO 238N 982W,43,0,0,0,43
Tropical Depression,Bret,6,2005-06-30T03:00:00Z,,99,0,0,0,99
Tropical Depression,Bret,6,2005-06-30T03:00:00Z,MMTM 222N 979W,99,0,0,0,99
Tropical Depression,Bret,6,2005-06-30T03:00:00Z,,99,0,0,0,99
Tropical Depression,Bret,6,2005-06-30T03:00:00Z,MMTX 210N 974W,6,0,0,0,6
Tropical Depression,Three,2,2005-07-04T03:00:00Z,21.1N  90.1W,41,0,0,0,41
Tropical Depression,Three,2,2005-07-04T03:00:00Z,NEW IBERIA LA,0,0,1,9,10
Tropical Depression,Three,2,2005-07-04T03:00:00Z,22.9N  91.8W,2,27,0,0,29
Tropical Depression,Three,2,2005-07-04T03:00:00Z,PORT ARTHUR TX,0,0,1,12,13
Tropical Depression,Three,2,2005-07-04T03:00:00Z,25.0N  93.3W,0,9,14,1,24
Tropical Depression,Three,2,2005-07-04T03:00:00Z,GALVESTON TX,0,0,3,11,14
Tropical Depression,Three,2,2005-07-04T03:00:00Z,MMCZ 205N 869W,36,0,0,0,36
Tropical Depression,Three,2,2005-07-04T03:00:00Z,FREEPORT TX,0,0,4,11,15
Tropical Depression,Three,2,2005-07-04T03:00:00Z,MZBZ 175N 883W,12,0,0,0,12
Tropical Depression,Three,2,2005-07-04T03:00:00Z,PORT O CONNOR TX,0,0,5,10,15
Tropical Depression,Three,2,2005-07-04T03:00:00Z,MMSO 238N 982W,0,0,4,5,9
Tropical Depression,Three,2,2005-07-04T03:00:00Z,CORPUSCHRISTI TX,0,0,4,10,14
Tropical Depression,Three,2,2005-07-04T03:00:00Z,MMTM 222N 979W,0,0,2,4,6
Tropical Depression,Three,2,2005-07-04T03:00:00Z,BROWNSVILLE TX,0,0,8,7,15
Tropical Depression,Three,2,2005-07-04T03:00:00Z,MMTX 210N 974W,0,0,1,2,3
Tropical Depression,Three,2,2005-07-04T03:00:00Z,GULF 29N 87W,0,0,0,3,3
Tropical Depression,Three,2,2005-07-04T03:00:00Z,MMFR 185N 926W,1,0,0,1,2
Tropical Depression,Three,2,2005-07-04T03:00:00Z,GULF 28N 89W,0,0,1,6,7
Tropical Depression,Three,2,2005-07-04T03:00:00Z,MMMD 210N 897W,44,0,0,0,44
Tropical Depression,Three,2,2005-07-04T03:00:00Z,GULF 28N 91W,0,0,4,8,12
Tropical Depression,Three,2,2005-07-04T03:00:00Z,PENSACOLA FL,0,0,0,2,2
Tropical Depression,Three,2,2005-07-04T03:00:00Z,GULF 28N 93W,0,0,8,8,16
Tropical Depression,Three,2,2005-07-04T03:00:00Z,MOBILE AL,0,0,0,3,3
Tropical Depression,Three,2,2005-07-04T03:00:00Z,GULF 28N 95W,0,0,8,9,17
Tropical Depression,Three,2,2005-07-04T03:00:00Z,GULFPORT MS,0,0,0,5,5
Tropical Depression,Three,2,2005-07-04T03:00:00Z,GULF 27N 96W,0,0,11,6,17
Tropical Depression,Three,2,2005-07-04T03:00:00Z,BURAS LA,0,0,0,7,7
Tropical Depression,Three,2,2005-07-04T03:00:00Z,GULF 25N 96W,0,2,13,3,18
Tropical Depression,Three,2,2005-07-04T03:00:00Z,NEW ORLEANS LA,0,0,0,8,8
Tropical Depression,Three,3,2005-07-04T09:00:00Z,22.4N  90.7W,42,0,0,0,42
Tropical Depression,Three,3,2005-07-04T09:00:00Z,PORT ARTHUR TX,0,0,4,11,15
Tropical Depression,Three,3,2005-07-04T09:00:00Z,24.1N  92.1W,3,25,1,0,29
Tropical Depression,Three,3,2005-07-04T09:00:00Z,GALVESTON TX,0,0,8,8,16
Tropical Depression,Three,3,2005-07-04T09:00:00Z,26.2N  93.2W,0,11,12,1,24
Tropical Depression,Three,3,2005-07-04T09:00:00Z,FREEPORT TX,0,0,9,8,17
Tropical Depression,Three,3,2005-07-04T09:00:00Z,MMCZ 205N 869W,59,0,0,1,60
Tropical Depression,Three,3,2005-07-04T09:00:00Z,PORT O CONNOR TX,0,0,10,6,16
Tropical Depression,Three,3,2005-07-04T09:00:00Z,MMSO 238N 982W,0,0,1,4,5
Tropical Depression,Three,3,2005-07-04T09:00:00Z,CORPUSCHRISTI TX,0,0,8,6,14
Tropical Depression,Three,3,2005-07-04T09:00:00Z,MMTM 222N 979W,0,0,0,2,2
Tropical Depression,Three,3,2005-07-04T09:00:00Z,BROWNSVILLE TX,0,1,8,4,13
Tropical Depression,Three,3,2005-07-04T09:00:00Z,MMMD 210N 897W,61,0,0,0,61
Tropical Depression,Three,3,2005-07-04T09:00:00Z,GULF 29N 87W,0,0,0,4,4
Tropical Depression,Three,3,2005-07-04T09:00:00Z,PANAMA CITY FL,0,0,0,2,2
Tropical Depression,Three,3,2005-07-04T09:00:00Z,GULF 28N 89W,0,0,2,7,9
Tropical Depression,Three,3,2005-07-04T09:00:00Z,PENSACOLA FL,0,0,0,3,3
Tropical Depression,Three,3,2005-07-04T09:00:00Z,GULF 28N 91W,0,0,8,6,14
Tropical Depression,Three,3,2005-07-04T09:00:00Z,MOBILE AL,0,0,0,5,5
Tropical Depression,Three,3,2005-07-04T09:00:00Z,GULF 28N 93W,0,1,13,4,18
Tropical Depression,Three,3,2005-07-04T09:00:00Z,GULFPORT MS,0,0,0,7,7
Tropical Depression,Three,3,2005-07-04T09:00:00Z,GULF 28N 95W,0,0,14,5,19
Tropical Depression,Three,3,2005-07-04T09:00:00Z,BURAS LA,0,0,1,8,9
Tropical Depression,Three,3,2005-07-04T09:00:00Z,GULF 27N 96W,0,2,13,3,18
Tropical Depression,Three,3,2005-07-04T09:00:00Z,NEW ORLEANS LA,0,0,1,9,10
Tropical Depression,Three,3,2005-07-04T09:00:00Z,GULF 25N 96W,0,7,8,2,17
Tropical Depression,Three,3,2005-07-04T09:00:00Z,NEW IBERIA LA,0,0,2,10,12
Tropical Depression,Three,4,2005-07-04T15:00:00Z,23.6N  91.6W,41,0,0,0,41
Tropical Depression,Three,4,2005-07-04T15:00:00Z,PORT ARTHUR TX,0,0,10,7,17
Tropical Depression,Three,4,2005-07-04T15:00:00Z,25.7N  93.0W,5,24,1,0,30
Tropical Depression,Three,4,2005-07-04T15:00:00Z,GALVESTON TX,0,2,12,4,18
Tropical Depression,Three,4,2005-07-04T15:00:00Z,27.5N  93.5W,0,15,7,1,23
Tropical Depression,Three,4,2005-07-04T15:00:00Z,FREEPORT TX,0,3,12,4,19
Tropical Depression,Three,4,2005-07-04T15:00:00Z,MMCZ 205N 869W,2,0,0,0,2
Tropical Depression,Three,4,2005-07-04T15:00:00Z,PORT O CONNOR TX,0,3,11,3,17
Tropical Depression,Three,4,2005-07-04T15:00:00Z,MMSO 238N 982W,0,0,0,2,2
Tropical Depression,Three,4,2005-07-04T15:00:00Z,CORPUSCHRISTI TX,0,2,8,4,14
Tropical Depression,Three,4,2005-07-04T15:00:00Z,MMMD 210N 897W,99,0,0,0,99
Tropical Depression,Three,4,2005-07-04T15:00:00Z,BROWNSVILLE TX,0,3,4,3,10
Tropical Depression,Three,4,2005-07-04T15:00:00Z,APALACHICOLA FL,0,0,0,2,2
Tropical Depression,Three,4,2005-07-04T15:00:00Z,GULF 29N 85W,0,0,0,2,2
Tropical Depression,Three,4,2005-07-04T15:00:00Z,PANAMA CITY FL,0,0,0,2,2
Tropical Depression,Three,4,2005-07-04T15:00:00Z,GULF 29N 87W,0,0,0,4,4
Tropical Depression,Three,4,2005-07-04T15:00:00Z,PENSACOLA FL,0,0,0,4,4
Tropical Depression,Three,4,2005-07-04T15:00:00Z,GULF 28N 89W,0,0,4,5,9
Tropical Depression,Three,4,2005-07-04T15:00:00Z,MOBILE AL,0,0,0,6,6
Tropical Depression,Three,4,2005-07-04T15:00:00Z,GULF 28N 91W,0,3,9,4,16
Tropical Depression,Three,4,2005-07-04T15:00:00Z,GULFPORT MS,0,0,1,7,8
Tropical Depression,Three,4,2005-07-04T15:00:00Z,GULF 28N 93W,0,9,9,3,21
Tropical Depression,Three,4,2005-07-04T15:00:00Z,BURAS LA,0,0,2,8,10
Tropical Depression,Three,4,2005-07-04T15:00:00Z,GULF 28N 95W,0,9,10,2,21
Tropical Depression,Three,4,2005-07-04T15:00:00Z,NEW ORLEANS LA,0,0,2,9,11
Tropical Depression,Three,4,2005-07-04T15:00:00Z,GULF 27N 96W,0,11,6,2,19
Tropical Depression,Three,4,2005-07-04T15:00:00Z,NEW IBERIA LA,0,0,6,8,14
Tropical Depression,Three,4,2005-07-04T15:00:00Z,GULF 25N 96W,0,11,2,1,14
Tropical Depression,Three,5,2005-07-04T21:00:00Z,26.5N  91.0W,43,0,0,0,43
Tropical Depression,Three,5,2005-07-04T21:00:00Z,GALVESTON TX,0,12,5,2,19
Tropical Depression,Three,5,2005-07-04T21:00:00Z,28.4N  91.9W,10,21,0,0,31
Tropical Depression,Three,5,2005-07-04T21:00:00Z,FREEPORT TX,0,8,5,2,15
Tropical Depression,Three,5,2005-07-04T21:00:00Z,30.2N  92.0W,0,20,4,1,25
Tropical Depression,Three,5,2005-07-04T21:00:00Z,PORT O CONNOR TX,0,2,5,3,10
Tropical Depression,Three,5,2005-07-04T21:00:00Z,ST MARKS FL,0,0,0,3,3
Tropical Depression,Three,5,2005-07-04T21:00:00Z,CORPUSCHRISTI TX,0,0,2,3,5
Tropical Depression,Three,5,2005-07-04T21:00:00Z,APALACHICOLA FL,0,0,0,4,4
Tropical Depression,Three,5,2005-07-04T21:00:00Z,BROWNSVILLE TX,0,0,0,2,2
Tropical Depression,Three,5,2005-07-04T21:00:00Z,PANAMA CITY FL,0,0,1,4,5
Tropical Depression,Three,5,2005-07-04T21:00:00Z,GULF 29N 85W,0,0,0,3,3
Tropical Depression,Three,5,2005-07-04T21:00:00Z,PENSACOLA FL,0,0,4,6,10
Tropical Depression,Three,5,2005-07-04T21:00:00Z,GULF 29N 87W,0,1,3,4,8
Tropical Depression,Three,5,2005-07-04T21:00:00Z,MOBILE AL,0,2,6,5,13
Tropical Depression,Three,5,2005-07-04T21:00:00Z,GULF 28N 89W,8,9,1,1,19
Tropical Depression,Three,5,2005-07-04T21:00:00Z,GULFPORT MS,0,6,7,3,16
Tropical Depression,Three,5,2005-07-04T21:00:00Z,GULF 28N 91W,19,13,0,0,32
Tropical Depression,Three,5,2005-07-04T21:00:00Z,BURAS LA,1,14,3,1,19
Tropical Depression,Three,5,2005-07-04T21:00:00Z,GULF 28N 93W,8,19,1,0,28
Tropical Depression,Three,5,2005-07-04T21:00:00Z,NEW ORLEANS LA,0,16,4,1,21
Tropical Depression,Three,5,2005-07-04T21:00:00Z,GULF 28N 95W,0,11,3,2,16
Tropical Depression,Three,5,2005-07-04T21:00:00Z,NEW IBERIA LA,0,22,3,1,26
Tropical Depression,Three,5,2005-07-04T21:00:00Z,GULF 27N 96W,0,3,2,3,8
Tropical Depression,Three,5,2005-07-04T21:00:00Z,PORT ARTHUR TX,0,15,5,2,22
Tropical Depression,Three,5,2005-07-04T21:00:00Z,GULF 25N 96W,0,0,1,1,2
Tropical Depression,Three,6,2005-07-05T03:00:00Z,27.6N  90.9W,43,0,0,0,43
Tropical Depression,Three,6,2005-07-05T03:00:00Z,NEW IBERIA LA,5,22,1,0,28
Tropical Depression,Three,6,2005-07-05T03:00:00Z,29.4N  91.2W,13,16,1,0,30
Tropical Depression,Three,6,2005-07-05T03:00:00Z,PORT ARTHUR TX,1,15,2,1,19
Tropical Depression,Three,6,2005-07-05T03:00:00Z,31.0N  90.7W,0,17,4,2,23
Tropical Depression,Three,6,2005-07-05T03:00:00Z,GALVESTON TX,1,9,2,2,14
Tropical Depression,Three,6,2005-07-05T03:00:00Z,JACKSONVILLE FL,0,0,0,2,2
Tropical Depression,Three,6,2005-07-05T03:00:00Z,FREEPORT TX,0,5,3,2,10
Tropical Depression,Three,6,2005-07-05T03:00:00Z,CEDAR KEY FL,0,0,0,2,2
Tropical Depression,Three,6,2005-07-05T03:00:00Z,PORT O CONNOR TX,0,1,1,3,5
Tropical Depression,Three,6,2005-07-05T03:00:00Z,ST MARKS FL,0,0,0,5,5
Tropical Depression,Three,6,2005-07-05T03:00:00Z,CORPUSCHRISTI TX,0,0,0,2,2
Tropical Depression,Three,6,2005-07-05T03:00:00Z,APALACHICOLA FL,0,0,1,5,6
Tropical Depression,Three,6,2005-07-05T03:00:00Z,GULF 29N 85W,0,0,1,4,5
Tropical Depression,Three,6,2005-07-05T03:00:00Z,PANAMA CITY FL,0,0,2,6,8
Tropical Depression,Three,6,2005-07-05T03:00:00Z,GULF 29N 87W,0,1,5,4,10
Tropical Depression,Three,6,2005-07-05T03:00:00Z,PENSACOLA FL,0,1,6,5,12
Tropical Depression,Three,6,2005-07-05T03:00:00Z,GULF 28N 89W,16,4,1,0,21
Tropical Depression,Three,6,2005-07-05T03:00:00Z,MOBILE AL,0,4,8,4,16
Tropical Depression,Three,6,2005-07-05T03:00:00Z,GULF 28N 91W,38,1,0,0,39
Tropical Depression,Three,6,2005-07-05T03:00:00Z,GULFPORT MS,0,10,6,3,19
Tropical Depression,Three,6,2005-07-05T03:00:00Z,GULF 28N 93W,21,4,1,0,26
Tropical Depression,Three,6,2005-07-05T03:00:00Z,BURAS LA,5,14,2,1,22
Tropical Depression,Three,6,2005-07-05T03:00:00Z,GULF 28N 95W,1,4,2,2,9
Tropical Depression,Three,6,2005-07-05T03:00:00Z,NEW ORLEANS LA,3,18,2,1,24
Tropical Depression,Three,6,2005-07-05T03:00:00Z,GULF 27N 96W,0,0,1,2,3
Tropical Storm,Cindy,7,2005-07-05T09:00:00Z,29.3N  90.5W,34,1,0,0,35
Tropical Storm,Cindy,7,2005-07-05T09:00:00Z,APALACHICOLA FL,0,1,5,5,11
Tropical Storm,Cindy,7,2005-07-05T09:00:00Z,31.0N  90.0W,15,9,1,1,26
Tropical Storm,Cindy,7,2005-07-05T09:00:00Z,PANAMA CITY FL,0,2,7,4,13
Tropical Storm,Cindy,7,2005-07-05T09:00:00Z,32.5N  88.5W,1,11,7,2,21
Tropical Storm,Cindy,7,2005-07-05T09:00:00Z,PENSACOLA FL,2,8,6,2,18
Tropical Storm,Cindy,7,2005-07-05T09:00:00Z,FT PIERCE FL,0,0,0,2,2
Tropical Storm,Cindy,7,2005-07-05T09:00:00Z,MOBILE AL,6,11,3,1,21
Tropical Storm,Cindy,7,2005-07-05T09:00:00Z,COCOA BEACH FL,0,0,0,2,2
Tropical Storm,Cindy,7,2005-07-05T09:00:00Z,GULFPORT MS,15,7,2,0,24
Tropical Storm,Cindy,7,2005-07-05T09:00:00Z,DAYTONA BEACH FL,0,0,0,4,4
Tropical Storm,Cindy,7,2005-07-05T09:00:00Z,BURAS LA,27,2,0,0,29
Tropical Storm,Cindy,7,2005-07-05T09:00:00Z,JACKSONVILLE FL,0,0,0,6,6
Tropical Storm,Cindy,7,2005-07-05T09:00:00Z,NEW ORLEANS LA,27,2,0,0,29
Tropical Storm,Cindy,7,2005-07-05T09:00:00Z,SAVANNAH GA,0,0,0,6,6
Tropical Storm,Cindy,7,2005-07-05T09:00:00Z,NEW IBERIA LA,24,1,0,1,26
Tropical Storm,Cindy,7,2005-07-05T09:00:00Z,CHARLESTON SC,0,0,0,5,5
Tropical Storm,Cindy,7,2005-07-05T09:00:00Z,PORT ARTHUR TX,5,3,0,1,9
Tropical Storm,Cindy,7,2005-07-05T09:00:00Z,MYRTLE BEACH SC,0,0,0,3,3
Tropical Storm,Cindy,7,2005-07-05T09:00:00Z,GALVESTON TX,1,1,0,1,3
Tropical Storm,Cindy,7,2005-07-05T09:00:00Z,WILMINGTON NC,0,0,0,2,2
Tropical Storm,Cindy,7,2005-07-05T09:00:00Z,GULF 29N 85W,0,1,4,5,10
Tropical Storm,Cindy,7,2005-07-05T09:00:00Z,FT MYERS FL,0,0,0,2,2
Tropical Storm,Cindy,7,2005-07-05T09:00:00Z,GULF 29N 87W,4,6,4,1,15
Tropical Storm,Cindy,7,2005-07-05T09:00:00Z,VENICE FL,0,0,0,3,3
Tropical Storm,Cindy,7,2005-07-05T09:00:00Z,GULF 28N 89W,30,0,0,0,30
Tropical Storm,Cindy,7,2005-07-05T09:00:00Z,TAMPA FL,0,0,0,4,4
Tropical Storm,Cindy,7,2005-07-05T09:00:00Z,GULF 28N 91W,54,0,0,0,54
Tropical Storm,Cindy,7,2005-07-05T09:00:00Z,CEDAR KEY FL,0,0,1,5,6
Tropical Storm,Cindy,7,2005-07-05T09:00:00Z,GULF 28N 93W,18,0,0,1,19
Tropical Storm,Cindy,7,2005-07-05T09:00:00Z,ST MARKS FL,0,0,3,7,10
Tropical Storm,Cindy,8,2005-07-05T15:00:00Z,30.5N  89.4W,36,0,0,0,36
Tropical Storm,Cindy,8,2005-07-05T15:00:00Z,CEDAR KEY FL,0,0,2,4,6
Tropical Storm,Cindy,8,2005-07-05T15:00:00Z,31.8N  88.5W,19,4,1,0,24
Tropical Storm,Cindy,8,2005-07-05T15:00:00Z,ST MARKS FL,0,1,5,4,10
Tropical Storm,Cindy,8,2005-07-05T15:00:00Z,33.0N  87.0W,3,9,4,2,18
Tropical Storm,Cindy,8,2005-07-05T15:00:00Z,APALACHICOLA FL,0,3,5,3,11
Tropical Storm,Cindy,8,2005-07-05T15:00:00Z,COCOA BEACH FL,0,0,0,2,2
Tropical Storm,Cindy,8,2005-07-05T15:00:00Z,PANAMA CITY FL,1,5,4,3,13
Tropical Storm,Cindy,8,2005-07-05T15:00:00Z,DAYTONA BEACH FL,0,0,0,4,4
Tropical Storm,Cindy,8,2005-07-05T15:00:00Z,PENSACOLA FL,11,5,2,1,19
Tropical Storm,Cindy,8,2005-07-05T15:00:00Z,JACKSONVILLE FL,0,0,1,6,7
Tropical Storm,Cindy,8,2005-07-05T15:00:00Z,MOBILE AL,23,2,0,0,25
Tropical Storm,Cindy,8,2005-07-05T15:00:00Z,SAVANNAH GA,0,0,0,8,8
Tropical Storm,Cindy,8,2005-07-05T15:00:00Z,GULFPORT MS,34,0,0,0,34
Tropical Storm,Cindy,8,2005-07-05T15:00:00Z,CHARLESTON SC,0,0,0,7,7
Tropical Storm,Cindy,8,2005-07-05T15:00:00Z,BURAS LA,50,0,0,0,50
Tropical Storm,Cindy,8,2005-07-05T15:00:00Z,MYRTLE BEACH SC,0,0,0,6,6
Tropical Storm,Cindy,8,2005-07-05T15:00:00Z,NEW ORLEANS LA,45,0,0,0,45
Tropical Storm,Cindy,8,2005-07-05T15:00:00Z,WILMINGTON NC,0,0,0,5,5
Tropical Storm,Cindy,8,2005-07-05T15:00:00Z,NEW IBERIA LA,21,0,1,0,22
Tropical Storm,Cindy,8,2005-07-05T15:00:00Z,MOREHEAD CITY NC,0,0,0,4,4
Tropical Storm,Cindy,8,2005-07-05T15:00:00Z,PORT ARTHUR TX,0,1,0,1,2
Tropical Storm,Cindy,8,2005-07-05T15:00:00Z,CAPE HATTERAS NC,0,0,0,3,3
Tropical Storm,Cindy,8,2005-07-05T15:00:00Z,GULF 29N 85W,0,2,5,2,9
Tropical Storm,Cindy,8,2005-07-05T15:00:00Z,NORFOLK VA,0,0,0,3,3
Tropical Storm,Cindy,8,2005-07-05T15:00:00Z,GULF 29N 87W,8,5,1,1,15
Tropical Storm,Cindy,8,2005-07-05T15:00:00Z,OCEAN CITY MD,0,0,0,2,2
Tropical Storm,Cindy,8,2005-07-05T15:00:00Z,GULF 28N 89W,46,1,0,0,47
Tropical Storm,Cindy,8,2005-07-05T15:00:00Z,VENICE FL,0,0,0,2,2
Tropical Storm,Cindy,8,2005-07-05T15:00:00Z,GULF 28N 91W,75,0,0,0,75
Tropical Storm,Cindy,8,2005-07-05T15:00:00Z,TAMPA FL,0,0,1,3,4
Tropical Storm,Cindy,8,2005-07-05T15:00:00Z,GULF 28N 93W,1,0,1,0,2
Tropical Storm,Cindy,9,2005-07-05T21:00:00Z,31.5N  88.5W,32,0,0,0,32
Tropical Storm,Cindy,9,2005-07-05T21:00:00Z,MONTAUK POINT NY,0,0,0,2,2
Tropical Storm,Cindy,9,2005-07-05T21:00:00Z,33.2N  86.7W,8,12,1,0,21
Tropical Storm,Cindy,9,2005-07-05T21:00:00Z,VENICE FL,0,0,1,1,2
Tropical Storm,Cindy,9,2005-07-05T21:00:00Z,34.7N  84.1W,0,3,11,3,17
Tropical Storm,Cindy,9,2005-07-05T21:00:00Z,TAMPA FL,0,0,1,2,3
Tropical Storm,Cindy,9,2005-07-05T21:00:00Z,FT PIERCE FL,0,0,0,2,2
Tropical Storm,Cindy,9,2005-07-05T21:00:00Z,CEDAR KEY FL,0,1,2,2,5
Tropical Storm,Cindy,9,2005-07-05T21:00:00Z,COCOA BEACH FL,0,0,1,2,3
Tropical Storm,Cindy,9,2005-07-05T21:00:00Z,ST MARKS FL,0,4,5,1,10
Tropical Storm,Cindy,9,2005-07-05T21:00:00Z,DAYTONA BEACH FL,0,0,1,4,5
Tropical Storm,Cindy,9,2005-07-05T21:00:00Z,APALACHICOLA FL,1,5,3,1,10
Tropical Storm,Cindy,9,2005-07-05T21:00:00Z,JACKSONVILLE FL,0,0,4,4,8
Tropical Storm,Cindy,9,2005-07-05T21:00:00Z,PANAMA CITY FL,2,8,2,0,12
Tropical Storm,Cindy,9,2005-07-05T21:00:00Z,SAVANNAH GA,0,0,4,6,10
Tropical Storm,Cindy,9,2005-07-05T21:00:00Z,PENSACOLA FL,18,3,0,0,21
Tropical Storm,Cindy,9,2005-07-05T21:00:00Z,CHARLESTON SC,0,0,2,8,10
Tropical Storm,Cindy,9,2005-07-05T21:00:00Z,MOBILE AL,32,0,0,0,32
Tropical Storm,Cindy,9,2005-07-05T21:00:00Z,MYRTLE BEACH SC,0,0,1,9,10
Tropical Storm,Cindy,9,2005-07-05T21:00:00Z,GULFPORT MS,44,0,0,0,44
Tropical Storm,Cindy,9,2005-07-05T21:00:00Z,WILMINGTON NC,0,0,0,9,9
Tropical Storm,Cindy,9,2005-07-05T21:00:00Z,BURAS LA,63,0,0,0,63
Tropical Storm,Cindy,9,2005-07-05T21:00:00Z,MOREHEAD CITY NC,0,0,0,8,8
Tropical Storm,Cindy,9,2005-07-05T21:00:00Z,NEW ORLEANS LA,54,0,0,0,54
Tropical Storm,Cindy,9,2005-07-05T21:00:00Z,CAPE HATTERAS NC,0,0,0,7,7
Tropical Storm,Cindy,9,2005-07-05T21:00:00Z,NEW IBERIA LA,7,1,0,0,8
Tropical Storm,Cindy,9,2005-07-05T21:00:00Z,NORFOLK VA,0,0,0,8,8
Tropical Storm,Cindy,9,2005-07-05T21:00:00Z,GULF 29N 85W,0,4,3,0,7
Tropical Storm,Cindy,9,2005-07-05T21:00:00Z,OCEAN CITY MD,0,0,0,6,6
Tropical Storm,Cindy,9,2005-07-05T21:00:00Z,GULF 29N 87W,10,3,0,1,14
Tropical Storm,Cindy,9,2005-07-05T21:00:00Z,ATLANTIC CITY NJ,0,0,0,5,5
Tropical Storm,Cindy,9,2005-07-05T21:00:00Z,GULF 28N 89W,48,0,0,0,48
Tropical Storm,Cindy,9,2005-07-05T21:00:00Z,NEW YORK CITY NY,0,0,0,3,3
Tropical Storm,Cindy,9,2005-07-05T21:00:00Z,GULF 28N 91W,99,0,0,0,99
Tropical Storm,Cindy,10,2005-07-06T03:00:00Z,32.1N  87.6W,33,0,0,0,33
Tropical Storm,Cindy,10,2005-07-06T03:00:00Z,NANTUCKET MA,0,0,0,3,3
Tropical Storm,Cindy,10,2005-07-06T03:00:00Z,33.7N  85.2W,5,14,2,0,21
Tropical Storm,Cindy,10,2005-07-06T03:00:00Z,HYANNIS MA,0,0,0,3,3
Tropical Storm,Cindy,10,2005-07-06T03:00:00Z,35.1N  82.1W,0,2,12,2,16
Tropical Storm,Cindy,10,2005-07-06T03:00:00Z,BOSTON MA,0,0,0,3,3
Tropical Storm,Cindy,10,2005-07-06T03:00:00Z,FT PIERCE FL,0,0,1,1,2
Tropical Storm,Cindy,10,2005-07-06T03:00:00Z,PORTLAND ME,0,0,0,2,2
Tropical Storm,Cindy,10,2005-07-06T03:00:00Z,COCOA BEACH FL,0,0,1,2,3
Tropical Storm,Cindy,10,2005-07-06T03:00:00Z,TAMPA FL,0,0,2,1,3
Tropical Storm,Cindy,10,2005-07-06T03:00:00Z,DAYTONA BEACH FL,0,0,3,2,5
Tropical Storm,Cindy,10,2005-07-06T03:00:00Z,CEDAR KEY FL,0,2,3,1,6
Tropical Storm,Cindy,10,2005-07-06T03:00:00Z,JACKSONVILLE FL,0,2,6,1,9
Tropical Storm,Cindy,10,2005-07-06T03:00:00Z,ST MARKS FL,1,8,2,1,12
Tropical Storm,Cindy,10,2005-07-06T03:00:00Z,SAVANNAH GA,0,2,8,2,12
Tropical Storm,Cindy,10,2005-07-06T03:00:00Z,APALACHICOLA FL,2,8,1,0,11
Tropical Storm,Cindy,10,2005-07-06T03:00:00Z,CHARLESTON SC,0,0,8,4,12
Tropical Storm,Cindy,10,2005-07-06T03:00:00Z,PANAMA CITY FL,6,7,1,0,14
Tropical Storm,Cindy,10,2005-07-06T03:00:00Z,MYRTLE BEACH SC,0,0,5,6,11
Tropical Storm,Cindy,10,2005-07-06T03:00:00Z,PENSACOLA FL,28,0,0,0,28
Tropical Storm,Cindy,10,2005-07-06T03:00:00Z,WILMINGTON NC,0,0,2,9,11
Tropical Storm,Cindy,10,2005-07-06T03:00:00Z,MOBILE AL,48,0,0,0,48
Tropical Storm,Cindy,10,2005-07-06T03:00:00Z,MOREHEAD CITY NC,0,0,1,9,10
Tropical Storm,Cindy,10,2005-07-06T03:00:00Z,GULFPORT MS,64,0,0,0,64
Tropical Storm,Cindy,10,2005-07-06T03:00:00Z,CAPE HATTERAS NC,0,0,0,9,9
Tropical Storm,Cindy,10,2005-07-06T03:00:00Z,BURAS LA,99,0,0,0,99
Tropical Storm,Cindy,10,2005-07-06T03:00:00Z,NORFOLK VA,0,0,0,10,10
Tropical Storm,Cindy,10,2005-07-06T03:00:00Z,NEW ORLEANS LA,99,0,0,0,99
Tropical Storm,Cindy,10,2005-07-06T03:00:00Z,OCEAN CITY MD,0,0,0,9,9
Tropical Storm,Cindy,10,2005-07-06T03:00:00Z,NEW IBERIA LA,7,0,0,0,7
Tropical Storm,Cindy,10,2005-07-06T03:00:00Z,ATLANTIC CITY NJ,0,0,0,9,9
Tropical Storm,Cindy,10,2005-07-06T03:00:00Z,GULF 29N 85W,1,5,2,0,8
Tropical Storm,Cindy,10,2005-07-06T03:00:00Z,NEW YORK CITY NY,0,0,0,7,7
Tropical Storm,Cindy,10,2005-07-06T03:00:00Z,GULF 29N 87W,11,2,0,0,13
Tropical Storm,Cindy,10,2005-07-06T03:00:00Z,MONTAUK POINT NY,0,0,0,5,5
Tropical Storm,Cindy,10,2005-07-06T03:00:00Z,GULF 28N 89W,40,0,0,0,40
Tropical Storm,Cindy,10,2005-07-06T03:00:00Z,PROVIDENCE RI,0,0,0,4,4
Tropical Storm,Cindy,10,2005-07-06T03:00:00Z,GULF 28N 91W,99,0,0,0,99
Tropical Storm,Cindy,11,2005-07-06T09:00:00Z,33.5N  86.0W,45,0,0,0,45
Tropical Storm,Cindy,11,2005-07-06T09:00:00Z,NANTUCKET MA,0,0,0,4,4
Tropical Storm,Cindy,11,2005-07-06T09:00:00Z,35.0N  83.5W,8,14,1,0,23
Tropical Storm,Cindy,11,2005-07-06T09:00:00Z,HYANNIS MA,0,0,0,4,4
Tropical Storm,Cindy,11,2005-07-06T09:00:00Z,37.0N  80.0W,0,2,12,2,16
Tropical Storm,Cindy,11,2005-07-06T09:00:00Z,BOSTON MA,0,0,0,5,5
Tropical Storm,Cindy,11,2005-07-06T09:00:00Z,DAYTONA BEACH FL,0,0,2,1,3
Tropical Storm,Cindy,11,2005-07-06T09:00:00Z,PORTLAND ME,0,0,0,3,3
Tropical Storm,Cindy,11,2005-07-06T09:00:00Z,JACKSONVILLE FL,0,3,3,1,7
Tropical Storm,Cindy,11,2005-07-06T09:00:00Z,BAR HARBOR ME,0,0,0,2,2
Tropical Storm,Cindy,11,2005-07-06T09:00:00Z,SAVANNAH GA,0,7,5,1,13
Tropical Storm,Cindy,11,2005-07-06T09:00:00Z,CEDAR KEY FL,0,1,1,0,2
Tropical Storm,Cindy,11,2005-07-06T09:00:00Z,CHARLESTON SC,0,4,7,2,13
Tropical Storm,Cindy,11,2005-07-06T09:00:00Z,ST MARKS FL,1,4,1,1,7
Tropical Storm,Cindy,11,2005-07-06T09:00:00Z,MYRTLE BEACH SC,0,2,8,2,12
Tropical Storm,Cindy,11,2005-07-06T09:00:00Z,APALACHICOLA FL,0,3,0,1,4
Tropical Storm,Cindy,11,2005-07-06T09:00:00Z,WILMINGTON NC,0,1,7,3,11
Tropical Storm,Cindy,11,2005-07-06T09:00:00Z,PANAMA CITY FL,2,3,0,1,6
Tropical Storm,Cindy,11,2005-07-06T09:00:00Z,MOREHEAD CITY NC,0,0,5,5,10
Tropical Storm,Cindy,11,2005-07-06T09:00:00Z,PENSACOLA FL,35,0,0,0,35
Tropical Storm,Cindy,11,2005-07-06T09:00:00Z,CAPE HATTERAS NC,0,0,3,6,9
Tropical Storm,Cindy,11,2005-07-06T09:00:00Z,MOBILE AL,68,0,0,0,68
Tropical Storm,Cindy,11,2005-07-06T09:00:00Z,NORFOLK VA,0,0,4,7,11
Tropical Storm,Cindy,11,2005-07-06T09:00:00Z,GULFPORT MS,99,0,0,0,99
Tropical Storm,Cindy,11,2005-07-06T09:00:00Z,OCEAN CITY MD,0,0,1,9,10
Tropical Storm,Cindy,11,2005-07-06T09:00:00Z,BURAS LA,99,0,0,0,99
Tropical Storm,Cindy,11,2005-07-06T09:00:00Z,ATLANTIC CITY NJ,0,0,1,8,9
Tropical Storm,Cindy,11,2005-07-06T09:00:00Z,NEW ORLEANS LA,99,0,0,0,99
Tropical Storm,Cindy,11,2005-07-06T09:00:00Z,NEW YORK CITY NY,0,0,0,8,8
Tropical Storm,Cindy,11,2005-07-06T09:00:00Z,NEW IBERIA LA,6,0,0,0,6
Tropical Storm,Cindy,11,2005-07-06T09:00:00Z,MONTAUK POINT NY,0,0,0,6,6
Tropical Storm,Cindy,11,2005-07-06T09:00:00Z,GULF 28N 91W,4,0,0,0,4
Tropical Storm,Cindy,11,2005-07-06T09:00:00Z,PROVIDENCE RI,0,0,0,5,5
Tropical Depression,Cindy,12,2005-07-06T15:00:00Z,34.2N  85.1W,46,0,0,0,46
Tropical Depression,Cindy,12,2005-07-06T15:00:00Z,PROVIDENCE RI,0,0,0,8,8
Tropical Depression,Cindy,12,2005-07-06T15:00:00Z,36.0N  81.8W,1,21,1,0,23
Tropical Depression,Cindy,12,2005-07-06T15:00:00Z,NANTUCKET MA,0,0,0,7,7
Tropical Depression,Cindy,12,2005-07-06T15:00:00Z,37.8N  78.5W,0,4,10,2,16
Tropical Depression,Cindy,12,2005-07-06T15:00:00Z,HYANNIS MA,0,0,0,7,7
Tropical Depression,Cindy,12,2005-07-06T15:00:00Z,JACKSONVILLE FL,0,2,1,1,4
Tropical Depression,Cindy,12,2005-07-06T15:00:00Z,BOSTON MA,0,0,0,7,7
Tropical Depression,Cindy,12,2005-07-06T15:00:00Z,SAVANNAH GA,0,9,2,0,11
Tropical Depression,Cindy,12,2005-07-06T15:00:00Z,PORTLAND ME,0,0,0,6,6
Tropical Depression,Cindy,12,2005-07-06T15:00:00Z,CHARLESTON SC,0,9,3,1,13
Tropical Depression,Cindy,12,2005-07-06T15:00:00Z,BAR HARBOR ME,0,0,0,4,4
Tropical Depression,Cindy,12,2005-07-06T15:00:00Z,MYRTLE BEACH SC,0,7,6,0,13
Tropical Depression,Cindy,12,2005-07-06T15:00:00Z,EASTPORT ME,0,0,0,2,2
Tropical Depression,Cindy,12,2005-07-06T15:00:00Z,WILMINGTON NC,0,4,8,1,13
Tropical Depression,Cindy,12,2005-07-06T15:00:00Z,ST JOHN NB,0,0,0,2,2
Tropical Depression,Cindy,12,2005-07-06T15:00:00Z,MOREHEAD CITY NC,0,2,8,2,12
Tropical Depression,Cindy,12,2005-07-06T15:00:00Z,YARMOUTH NS,0,0,0,2,2
Tropical Depression,Cindy,12,2005-07-06T15:00:00Z,CAPE HATTERAS NC,0,1,7,3,11
Tropical Depression,Cindy,12,2005-07-06T15:00:00Z,ST MARKS FL,0,2,0,0,2
Tropical Depression,Cindy,12,2005-07-06T15:00:00Z,NORFOLK VA,0,1,9,3,13
Tropical Depression,Cindy,12,2005-07-06T15:00:00Z,PENSACOLA FL,23,0,0,0,23
Tropical Depression,Cindy,12,2005-07-06T15:00:00Z,OCEAN CITY MD,0,0,6,6,12
Tropical Depression,Cindy,12,2005-07-06T15:00:00Z,MOBILE AL,99,0,0,0,99
Tropical Depression,Cindy,12,2005-07-06T15:00:00Z,ATLANTIC CITY NJ,0,0,4,8,12
Tropical Depression,Cindy,12,2005-07-06T15:00:00Z,GULFPORT MS,99,0,0,0,99
Tropical Depression,Cindy,12,2005-07-06T15:00:00Z,NEW YORK CITY NY,0,0,2,8,10
Tropical Depression,Cindy,12,2005-07-06T15:00:00Z,BURAS LA,20,0,0,0,20
Tropical Depression,Cindy,12,2005-07-06T15:00:00Z,MONTAUK POINT NY,0,0,1,7,8
Tropical Depression,Cindy,12,2005-07-06T15:00:00Z,NEW ORLEANS LA,3,0,0,0,3
Tropical Depression,Four,1,2005-07-05T03:00:00Z,14.7N  68.3W,51,1,0,0,52
Tropical Depression,Four,1,2005-07-05T03:00:00Z,MUHA 230N 824W,0,0,0,9,9
Tropical Depression,Four,1,2005-07-05T03:00:00Z,16.3N  71.4W,0,35,0,0,35
Tropical Depression,Four,1,2005-07-05T03:00:00Z,MUAN 219N 850W,0,0,0,2,2
Tropical Depression,Four,1,2005-07-05T03:00:00Z,17.8N  74.4W,0,3,23,1,27
Tropical Depression,Four,1,2005-07-05T03:00:00Z,TJSJ 184N 661W,1,1,0,0,2
Tropical Depression,Four,1,2005-07-05T03:00:00Z,SKPG 125N 717W,0,2,0,0,2
Tropical Depression,Four,1,2005-07-05T03:00:00Z,MDPP 198N 707W,0,5,9,1,15
Tropical Depression,Four,1,2005-07-05T03:00:00Z,TNCC 122N 690W,5,1,0,0,6
Tropical Depression,Four,1,2005-07-05T03:00:00Z,MBJT 215N 712W,0,0,4,3,7
Tropical Depression,Four,1,2005-07-05T03:00:00Z,SVMG 110N 640W,2,0,0,0,2
Tropical Depression,Four,1,2005-07-05T03:00:00Z,MYMM 224N 730W,0,0,2,7,9
Tropical Depression,Four,1,2005-07-05T03:00:00Z,TGPY 120N 618W,99,0,0,0,99
Tropical Depression,Four,1,2005-07-05T03:00:00Z,MYSM 241N 745W,0,0,0,7,7
Tropical Depression,Four,1,2005-07-05T03:00:00Z,TVSV 131N 612W,22,0,0,0,22
Tropical Depression,Four,1,2005-07-05T03:00:00Z,MYEG 235N 758W,0,0,0,12,12
Tropical Depression,Four,1,2005-07-05T03:00:00Z,80400 157N 636W,3,0,0,0,3
Tropical Depression,Four,1,2005-07-05T03:00:00Z,MYAK 241N 776W,0,0,0,13,13
Tropical Depression,Four,1,2005-07-05T03:00:00Z,TJPS 180N 666W,3,2,1,0,6
Tropical Depression,Four,1,2005-07-05T03:00:00Z,MYNN 251N 775W,0,0,0,8,8
Tropical Depression,Four,1,2005-07-05T03:00:00Z,MDSD 185N 697W,0,19,2,1,22
Tropical Depression,Four,1,2005-07-05T03:00:00Z,MYGF 266N 787W,0,0,0,4,4
Tropical Depression,Four,1,2005-07-05T03:00:00Z,MDCB 176N 714W,0,28,4,0,32
Tropical Depression,Four,1,2005-07-05T03:00:00Z,SAN JUAN PR,1,1,0,0,2
Tropical Depression,Four,1,2005-07-05T03:00:00Z,MTPP 186N 724W,0,11,16,0,27
Tropical Depression,Four,1,2005-07-05T03:00:00Z,PONCE PR,3,2,1,0,6
Tropical Depression,Four,1,2005-07-05T03:00:00Z,MTCA 183N 738W,0,4,23,1,28
Tropical Depression,Four,1,2005-07-05T03:00:00Z,MARATHON FL,0,0,0,9,9
Tropical Depression,Four,1,2005-07-05T03:00:00Z,MKJP 179N 768W,0,0,14,6,20
Tropical Depression,Four,1,2005-07-05T03:00:00Z,MIAMI FL,0,0,0,6,6
Tropical Depression,Four,1,2005-07-05T03:00:00Z,MKJS 185N 779W,0,0,6,13,19
Tropical Depression,Four,1,2005-07-05T03:00:00Z,W PALM BEACH FL,0,0,0,3,3
Tropical Depression,Four,1,2005-07-05T03:00:00Z,MWCG 193N 814W,0,0,0,10,10
Tropical Depression,Four,1,2005-07-05T03:00:00Z,FT PIERCE FL,0,0,0,2,2
Tropical Depression,Four,1,2005-07-05T03:00:00Z,MUGM 200N 751W,0,0,16,7,23
Tropical Depression,Four,1,2005-07-05T03:00:00Z,KEY WEST FL,0,0,0,8,8
Tropical Depression,Four,1,2005-07-05T03:00:00Z,MUCM 214N 779W,0,0,1,19,20
Tropical Depression,Four,1,2005-07-05T03:00:00Z,MARCO ISLAND FL,0,0,0,5,5
Tropical Depression,Four,1,2005-07-05T03:00:00Z,MUCF 221N 805W,0,0,0,16,16
Tropical Depression,Four,1,2005-07-05T03:00:00Z,FT MYERS FL,0,0,0,3,3
Tropical Depression,Four,1,2005-07-05T03:00:00Z,MUSN 216N 826W,0,0,0,9,9
Tropical Depression,Four,1,2005-07-05T03:00:00Z,VENICE FL,0,0,0,2,2
Tropical Depression,Four,2,2005-07-05T09:00:00Z,14.5N  69.5W,53,1,0,0,54
Tropical Depression,Four,2,2005-07-05T09:00:00Z,MUHA 230N 824W,0,0,0,11,11
Tropical Depression,Four,2,2005-07-05T09:00:00Z,16.5N  72.5W,0,35,0,0,35
Tropical Depression,Four,2,2005-07-05T09:00:00Z,MUAN 219N 850W,0,0,0,3,3
Tropical Depression,Four,2,2005-07-05T09:00:00Z,18.0N  75.0W,0,6,19,1,26
Tropical Depression,Four,2,2005-07-05T09:00:00Z,MDPP 198N 707W,0,6,5,1,12
Tropical Depression,Four,2,2005-07-05T09:00:00Z,SKPG 125N 717W,3,4,0,0,7
Tropical Depression,Four,2,2005-07-05T09:00:00Z,MBJT 215N 712W,0,0,4,2,6
Tropical Depression,Four,2,2005-07-05T09:00:00Z,TNCC 122N 690W,15,0,0,0,15
Tropical Depression,Four,2,2005-07-05T09:00:00Z,MYMM 224N 730W,0,0,3,5,8
Tropical Depression,Four,2,2005-07-05T09:00:00Z,SVMG 110N 640W,4,0,0,0,4
Tropical Depression,Four,2,2005-07-05T09:00:00Z,MYSM 241N 745W,0,0,0,5,5
Tropical Depression,Four,2,2005-07-05T09:00:00Z,MDSD 185N 697W,1,13,1,0,15
Tropical Depression,Four,2,2005-07-05T09:00:00Z,MYEG 235N 758W,0,0,0,10,10
Tropical Depression,Four,2,2005-07-05T09:00:00Z,MDCB 176N 714W,0,32,0,0,32
Tropical Depression,Four,2,2005-07-05T09:00:00Z,MYAK 241N 776W,0,0,0,10,10
Tropical Depression,Four,2,2005-07-05T09:00:00Z,MTPP 186N 724W,0,19,7,0,26
Tropical Depression,Four,2,2005-07-05T09:00:00Z,MYNN 251N 775W,0,0,0,6,6
Tropical Depression,Four,2,2005-07-05T09:00:00Z,MTCA 183N 738W,0,14,13,1,28
Tropical Depression,Four,2,2005-07-05T09:00:00Z,MYGF 266N 787W,0,0,0,2,2
Tropical Depression,Four,2,2005-07-05T09:00:00Z,MKJP 179N 768W,0,0,17,4,21
Tropical Depression,Four,2,2005-07-05T09:00:00Z,MARATHON FL,0,0,0,8,8
Tropical Depression,Four,2,2005-07-05T09:00:00Z,MKJS 185N 779W,0,0,10,10,20
Tropical Depression,Four,2,2005-07-05T09:00:00Z,MIAMI FL,0,0,0,5,5
Tropical Depression,Four,2,2005-07-05T09:00:00Z,MWCG 193N 814W,0,0,0,12,12
Tropical Depression,Four,2,2005-07-05T09:00:00Z,W PALM BEACH FL,0,0,0,2,2
Tropical Depression,Four,2,2005-07-05T09:00:00Z,MUGM 200N 751W,0,0,18,4,22
Tropical Depression,Four,2,2005-07-05T09:00:00Z,KEY WEST FL,0,0,0,8,8
Tropical Depression,Four,2,2005-07-05T09:00:00Z,MUCM 214N 779W,0,0,2,17,19
Tropical Depression,Four,2,2005-07-05T09:00:00Z,MARCO ISLAND FL,0,0,0,4,4
Tropical Depression,Four,2,2005-07-05T09:00:00Z,MUCF 221N 805W,0,0,0,16,16
Tropical Depression,Four,2,2005-07-05T09:00:00Z,FT MYERS FL,0,0,0,2,2
Tropical Depression,Four,2,2005-07-05T09:00:00Z,MUSN 216N 826W,0,0,0,11,11
Tropical Storm,Dennis,3,2005-07-05T15:00:00Z,15.9N  71.5W,47,1,0,0,48
Tropical Storm,Dennis,3,2005-07-05T15:00:00Z,MYMM 224N 730W,0,0,4,2,6
Tropical Storm,Dennis,3,2005-07-05T15:00:00Z,17.4N  74.1W,2,32,0,0,34
Tropical Storm,Dennis,3,2005-07-05T15:00:00Z,MYSM 241N 745W,0,0,1,4,5
Tropical Storm,Dennis,3,2005-07-05T15:00:00Z,18.9N  76.6W,0,9,17,1,27
Tropical Storm,Dennis,3,2005-07-05T15:00:00Z,MYEG 235N 758W,0,0,4,7,11
Tropical Storm,Dennis,3,2005-07-05T15:00:00Z,MDSD 185N 697W,6,5,1,0,12
Tropical Storm,Dennis,3,2005-07-05T15:00:00Z,MYAK 241N 776W,0,0,2,11,13
Tropical Storm,Dennis,3,2005-07-05T15:00:00Z,MDCB 176N 714W,26,9,0,0,35
Tropical Storm,Dennis,3,2005-07-05T15:00:00Z,MYNN 251N 775W,0,0,0,10,10
Tropical Storm,Dennis,3,2005-07-05T15:00:00Z,MTPP 186N 724W,3,25,0,1,29
Tropical Storm,Dennis,3,2005-07-05T15:00:00Z,MYGF 266N 787W,0,0,0,7,7
Tropical Storm,Dennis,3,2005-07-05T15:00:00Z,MTCA 183N 738W,1,31,1,0,33
Tropical Storm,Dennis,3,2005-07-05T15:00:00Z,MARATHON FL,0,0,0,14,14
Tropical Storm,Dennis,3,2005-07-05T15:00:00Z,MKJP 179N 768W,0,11,13,1,25
Tropical Storm,Dennis,3,2005-07-05T15:00:00Z,MIAMI FL,0,0,0,11,11
Tropical Storm,Dennis,3,2005-07-05T15:00:00Z,MKJS 185N 779W,0,3,18,2,23
Tropical Storm,Dennis,3,2005-07-05T15:00:00Z,W PALM BEACH FL,0,0,0,8,8
Tropical Storm,Dennis,3,2005-07-05T15:00:00Z,MWCG 193N 814W,0,0,2,13,15
Tropical Storm,Dennis,3,2005-07-05T15:00:00Z,FT PIERCE FL,0,0,0,6,6
Tropical Storm,Dennis,3,2005-07-05T15:00:00Z,MUGM 200N 751W,0,11,14,1,26
Tropical Storm,Dennis,3,2005-07-05T15:00:00Z,COCOA BEACH FL,0,0,0,4,4
Tropical Storm,Dennis,3,2005-07-05T15:00:00Z,MUCM 214N 779W,0,0,15,7,22
Tropical Storm,Dennis,3,2005-07-05T15:00:00Z,DAYTONA BEACH FL,0,0,0,2,2
Tropical Storm,Dennis,3,2005-07-05T15:00:00Z,MUCF 221N 805W,0,0,2,17,19
Tropical Storm,Dennis,3,2005-07-05T15:00:00Z,KEY WEST FL,0,0,0,14,14
Tropical Storm,Dennis,3,2005-07-05T15:00:00Z,MUSN 216N 826W,0,0,0,15,15
Tropical Storm,Dennis,3,2005-07-05T15:00:00Z,MARCO ISLAND FL,0,0,0,11,11
Tropical Storm,Dennis,3,2005-07-05T15:00:00Z,MUHA 230N 824W,0,0,0,16,16
Tropical Storm,Dennis,3,2005-07-05T15:00:00Z,FT MYERS FL,0,0,0,9,9
Tropical Storm,Dennis,3,2005-07-05T15:00:00Z,MUAN 219N 850W,0,0,0,9,9
Tropical Storm,Dennis,3,2005-07-05T15:00:00Z,VENICE FL,0,0,0,7,7
Tropical Storm,Dennis,3,2005-07-05T15:00:00Z,MMCZ 205N 869W,0,0,0,2,2
Tropical Storm,Dennis,3,2005-07-05T15:00:00Z,TAMPA FL,0,0,0,5,5
Tropical Storm,Dennis,3,2005-07-05T15:00:00Z,MDPP 198N 707W,0,6,2,0,8
Tropical Storm,Dennis,3,2005-07-05T15:00:00Z,CEDAR KEY FL,0,0,0,2,2
Tropical Storm,Dennis,3,2005-07-05T15:00:00Z,MBJT 215N 712W,0,1,1,1,3
Tropical Storm,Dennis,3,2005-07-05T15:00:00Z,GULF 29N 85W,0,0,0,2,2
Tropical Storm,Dennis,4,2005-07-05T21:00:00Z,17.0N  73.4W,48,0,0,0,48
Tropical Storm,Dennis,4,2005-07-05T21:00:00Z,MYEG 235N 758W,0,0,8,3,11
Tropical Storm,Dennis,4,2005-07-05T21:00:00Z,18.4N  75.8W,3,30,0,0,33
Tropical Storm,Dennis,4,2005-07-05T21:00:00Z,MYAK 241N 776W,0,0,8,6,14
Tropical Storm,Dennis,4,2005-07-05T21:00:00Z,19.9N  78.4W,0,9,18,1,28
Tropical Storm,Dennis,4,2005-07-05T21:00:00Z,MYNN 251N 775W,0,0,3,7,10
Tropical Storm,Dennis,4,2005-07-05T21:00:00Z,MDSD 185N 697W,4,0,0,0,4
Tropical Storm,Dennis,4,2005-07-05T21:00:00Z,MYGF 266N 787W,0,0,0,7,7
Tropical Storm,Dennis,4,2005-07-05T21:00:00Z,MDCB 176N 714W,44,0,0,0,44
Tropical Storm,Dennis,4,2005-07-05T21:00:00Z,MARATHON FL,0,0,2,14,16
Tropical Storm,Dennis,4,2005-07-05T21:00:00Z,MTPP 186N 724W,29,3,0,0,32
Tropical Storm,Dennis,4,2005-07-05T21:00:00Z,MIAMI FL,0,0,1,12,13
Tropical Storm,Dennis,4,2005-07-05T21:00:00Z,MTCA 183N 738W,30,9,0,0,39
Tropical Storm,Dennis,4,2005-07-05T21:00:00Z,W PALM BEACH FL,0,0,0,9,9
Tropical Storm,Dennis,4,2005-07-05T21:00:00Z,MKJP 179N 768W,1,25,2,0,28
Tropical Storm,Dennis,4,2005-07-05T21:00:00Z,FT PIERCE FL,0,0,0,7,7
Tropical Storm,Dennis,4,2005-07-05T21:00:00Z,MKJS 185N 779W,0,18,8,1,27
Tropical Storm,Dennis,4,2005-07-05T21:00:00Z,COCOA BEACH FL,0,0,0,5,5
Tropical Storm,Dennis,4,2005-07-05T21:00:00Z,MWCG 193N 814W,0,0,10,7,17
Tropical Storm,Dennis,4,2005-07-05T21:00:00Z,DAYTONA BEACH FL,0,0,0,3,3
Tropical Storm,Dennis,4,2005-07-05T21:00:00Z,MUGM 200N 751W,0,27,1,0,28
Tropical Storm,Dennis,4,2005-07-05T21:00:00Z,KEY WEST FL,0,0,1,16,17
Tropical Storm,Dennis,4,2005-07-05T21:00:00Z,MUCM 214N 779W,0,4,21,1,26
Tropical Storm,Dennis,4,2005-07-05T21:00:00Z,MARCO ISLAND FL,0,0,0,13,13
Tropical Storm,Dennis,4,2005-07-05T21:00:00Z,MUCF 221N 805W,0,0,14,8,22
Tropical Storm,Dennis,4,2005-07-05T21:00:00Z,FT MYERS FL,0,0,0,11,11
Tropical Storm,Dennis,4,2005-07-05T21:00:00Z,MUSN 216N 826W,0,0,4,14,18
Tropical Storm,Dennis,4,2005-07-05T21:00:00Z,VENICE FL,0,0,0,9,9
Tropical Storm,Dennis,4,2005-07-05T21:00:00Z,MUHA 230N 824W,0,0,3,15,18
Tropical Storm,Dennis,4,2005-07-05T21:00:00Z,TAMPA FL,0,0,0,7,7
Tropical Storm,Dennis,4,2005-07-05T21:00:00Z,MUAN 219N 850W,0,0,0,11,11
Tropical Storm,Dennis,4,2005-07-05T21:00:00Z,CEDAR KEY FL,0,0,0,4,4
Tropical Storm,Dennis,4,2005-07-05T21:00:00Z,MMCZ 205N 869W,0,0,0,4,4
Tropical Storm,Dennis,4,2005-07-05T21:00:00Z,ST MARKS FL,0,0,0,2,2
Tropical Storm,Dennis,4,2005-07-05T21:00:00Z,MDPP 198N 707W,2,1,0,0,3
Tropical Storm,Dennis,4,2005-07-05T21:00:00Z,APALACHICOLA FL,0,0,0,2,2
Tropical Storm,Dennis,4,2005-07-05T21:00:00Z,MYMM 224N 730W,0,2,1,1,4
Tropical Storm,Dennis,4,2005-07-05T21:00:00Z,GULF 29N 85W,0,0,0,3,3
Tropical Storm,Dennis,4,2005-07-05T21:00:00Z,MYSM 241N 745W,0,0,2,2,4
Tropical Storm,Dennis,5,2005-07-06T03:00:00Z,17.4N  74.0W,48,0,0,1,49
Tropical Storm,Dennis,5,2005-07-06T03:00:00Z,MYAK 241N 776W,0,0,7,6,13
Tropical Storm,Dennis,5,2005-07-06T03:00:00Z,18.8N  76.5W,3,31,0,0,34
Tropical Storm,Dennis,5,2005-07-06T03:00:00Z,MYNN 251N 775W,0,0,2,7,9
Tropical Storm,Dennis,5,2005-07-06T03:00:00Z,20.1N  78.8W,0,11,15,1,27
Tropical Storm,Dennis,5,2005-07-06T03:00:00Z,MYGF 266N 787W,0,0,0,7,7
Tropical Storm,Dennis,5,2005-07-06T03:00:00Z,MDSD 185N 697W,2,0,0,0,2
Tropical Storm,Dennis,5,2005-07-06T03:00:00Z,MARATHON FL,0,0,2,14,16
Tropical Storm,Dennis,5,2005-07-06T03:00:00Z,MDCB 176N 714W,47,0,0,0,47
Tropical Storm,Dennis,5,2005-07-06T03:00:00Z,MIAMI FL,0,0,1,11,12
Tropical Storm,Dennis,5,2005-07-06T03:00:00Z,MTPP 186N 724W,34,0,1,0,35
Tropical Storm,Dennis,5,2005-07-06T03:00:00Z,W PALM BEACH FL,0,0,0,9,9
Tropical Storm,Dennis,5,2005-07-06T03:00:00Z,MTCA 183N 738W,42,2,0,0,44
Tropical Storm,Dennis,5,2005-07-06T03:00:00Z,FT PIERCE FL,0,0,0,7,7
Tropical Storm,Dennis,5,2005-07-06T03:00:00Z,MKJP 179N 768W,4,25,1,0,30
Tropical Storm,Dennis,5,2005-07-06T03:00:00Z,COCOA BEACH FL,0,0,0,5,5
Tropical Storm,Dennis,5,2005-07-06T03:00:00Z,MKJS 185N 779W,0,23,3,1,27
Tropical Storm,Dennis,5,2005-07-06T03:00:00Z,DAYTONA BEACH FL,0,0,0,3,3
Tropical Storm,Dennis,5,2005-07-06T03:00:00Z,MWCG 193N 814W,0,0,11,6,17
Tropical Storm,Dennis,5,2005-07-06T03:00:00Z,KEY WEST FL,0,0,1,16,17
Tropical Storm,Dennis,5,2005-07-06T03:00:00Z,MUGM 200N 751W,3,26,1,0,30
Tropical Storm,Dennis,5,2005-07-06T03:00:00Z,MARCO ISLAND FL,0,0,0,13,13
Tropical Storm,Dennis,5,2005-07-06T03:00:00Z,MUCM 214N 779W,0,8,16,1,25
Tropical Storm,Dennis,5,2005-07-06T03:00:00Z,FT MYERS FL,0,0,0,11,11
Tropical Storm,Dennis,5,2005-07-06T03:00:00Z,MUCF 221N 805W,0,0,15,7,22
Tropical Storm,Dennis,5,2005-07-06T03:00:00Z,VENICE FL,0,0,0,10,10
Tropical Storm,Dennis,5,2005-07-06T03:00:00Z,MUSN 216N 826W,0,0,5,13,18
Tropical Storm,Dennis,5,2005-07-06T03:00:00Z,TAMPA FL,0,0,0,7,7
Tropical Storm,Dennis,5,2005-07-06T03:00:00Z,MUHA 230N 824W,0,0,3,16,19
Tropical Storm,Dennis,5,2005-07-06T03:00:00Z,CEDAR KEY FL,0,0,0,4,4
Tropical Storm,Dennis,5,2005-07-06T03:00:00Z,MUAN 219N 850W,0,0,0,12,12
Tropical Storm,Dennis,5,2005-07-06T03:00:00Z,ST MARKS FL,0,0,0,2,2
Tropical Storm,Dennis,5,2005-07-06T03:00:00Z,MMCZ 205N 869W,0,0,0,5,5
Tropical Storm,Dennis,5,2005-07-06T03:00:00Z,APALACHICOLA FL,0,0,0,3,3
Tropical Storm,Dennis,5,2005-07-06T03:00:00Z,MDPP 198N 707W,2,0,0,0,2
Tropical Storm,Dennis,5,2005-07-06T03:00:00Z,PANAMA CITY FL,0,0,0,2,2
Tropical Storm,Dennis,5,2005-07-06T03:00:00Z,MYMM 224N 730W,0,1,1,1,3
Tropical Storm,Dennis,5,2005-07-06T03:00:00Z,GULF 29N 85W,0,0,0,4,4
Tropical Storm,Dennis,5,2005-07-06T03:00:00Z,MYSM 241N 745W,0,0,1,2,3
Tropical Storm,Dennis,5,2005-07-06T03:00:00Z,GULF 29N 87W,0,0,0,2,2
Tropical Storm,Dennis,5,2005-07-06T03:00:00Z,MYEG 235N 758W,0,1,6,3,10
Tropical Storm,Dennis,6,2005-07-06T09:00:00Z,17.8N  75.0W,48,0,0,0,48
Tropical Storm,Dennis,6,2005-07-06T09:00:00Z,MARATHON FL,0,0,6,11,17
Tropical Storm,Dennis,6,2005-07-06T09:00:00Z,19.0N  77.5W,4,29,0,0,33
Tropical Storm,Dennis,6,2005-07-06T09:00:00Z,MIAMI FL,0,0,2,11,13
Tropical Storm,Dennis,6,2005-07-06T09:00:00Z,20.5N  80.0W,0,10,17,1,28
Tropical Storm,Dennis,6,2005-07-06T09:00:00Z,W PALM BEACH FL,0,0,1,8,9
Tropical Storm,Dennis,6,2005-07-06T09:00:00Z,MDCB 176N 714W,38,0,0,0,38
Tropical Storm,Dennis,6,2005-07-06T09:00:00Z,FT PIERCE FL,0,0,0,7,7
Tropical Storm,Dennis,6,2005-07-06T09:00:00Z,MTPP 186N 724W,29,0,0,0,29
Tropical Storm,Dennis,6,2005-07-06T09:00:00Z,COCOA BEACH FL,0,0,0,5,5
Tropical Storm,Dennis,6,2005-07-06T09:00:00Z,MTCA 183N 738W,49,0,0,0,49
Tropical Storm,Dennis,6,2005-07-06T09:00:00Z,DAYTONA BEACH FL,0,0,0,4,4
Tropical Storm,Dennis,6,2005-07-06T09:00:00Z,MKJP 179N 768W,22,12,0,0,34
Tropical Storm,Dennis,6,2005-07-06T09:00:00Z,JACKSONVILLE FL,0,0,0,2,2
Tropical Storm,Dennis,6,2005-07-06T09:00:00Z,MKJS 185N 779W,3,27,0,0,30
Tropical Storm,Dennis,6,2005-07-06T09:00:00Z,KEY WEST FL,0,0,6,12,18
Tropical Storm,Dennis,6,2005-07-06T09:00:00Z,MWCG 193N 814W,0,3,15,2,20
Tropical Storm,Dennis,6,2005-07-06T09:00:00Z,MARCO ISLAND FL,0,0,1,13,14
Tropical Storm,Dennis,6,2005-07-06T09:00:00Z,MUGM 200N 751W,13,16,0,0,29
Tropical Storm,Dennis,6,2005-07-06T09:00:00Z,FT MYERS FL,0,0,1,11,12
Tropical Storm,Dennis,6,2005-07-06T09:00:00Z,MUCM 214N 779W,0,18,8,1,27
Tropical Storm,Dennis,6,2005-07-06T09:00:00Z,VENICE FL,0,0,0,11,11
Tropical Storm,Dennis,6,2005-07-06T09:00:00Z,MUCF 221N 805W,0,2,20,2,24
Tropical Storm,Dennis,6,2005-07-06T09:00:00Z,TAMPA FL,0,0,0,8,8
Tropical Storm,Dennis,6,2005-07-06T09:00:00Z,MUSN 216N 826W,0,0,13,8,21
Tropical Storm,Dennis,6,2005-07-06T09:00:00Z,CEDAR KEY FL,0,0,0,5,5
Tropical Storm,Dennis,6,2005-07-06T09:00:00Z,MUHA 230N 824W,0,0,11,10,21
Tropical Storm,Dennis,6,2005-07-06T09:00:00Z,ST MARKS FL,0,0,0,3,3
Tropical Storm,Dennis,6,2005-07-06T09:00:00Z,MUAN 219N 850W,0,0,2,13,15
Tropical Storm,Dennis,6,2005-07-06T09:00:00Z,APALACHICOLA FL,0,0,0,4,4
Tropical Storm,Dennis,6,2005-07-06T09:00:00Z,MMCZ 205N 869W,0,0,0,7,7
Tropical Storm,Dennis,6,2005-07-06T09:00:00Z,PANAMA CITY FL,0,0,0,3,3
Tropical Storm,Dennis,6,2005-07-06T09:00:00Z,MYEG 235N 758W,0,1,4,2,7
Tropical Storm,Dennis,6,2005-07-06T09:00:00Z,GULF 29N 85W,0,0,0,5,5
Tropical Storm,Dennis,6,2005-07-06T09:00:00Z,MYAK 241N 776W,0,0,8,3,11
Tropical Storm,Dennis,6,2005-07-06T09:00:00Z,GULF 29N 87W,0,0,0,3,3
Tropical Storm,Dennis,6,2005-07-06T09:00:00Z,MYNN 251N 775W,0,0,3,5,8
Tropical Storm,Dennis,6,2005-07-06T09:00:00Z,GULF 28N 89W,0,0,0,2,2
Tropical Storm,Dennis,6,2005-07-06T09:00:00Z,MYGF 266N 787W,0,0,1,5,6
Tropical Storm,Dennis,7,2005-07-06T15:00:00Z,18.1N  76.1W,47,0,0,1,48
Tropical Storm,Dennis,7,2005-07-06T15:00:00Z,MIAMI FL,0,0,5,8,13
Tropical Storm,Dennis,7,2005-07-06T15:00:00Z,19.8N  78.7W,2,32,0,0,34
Tropical Storm,Dennis,7,2005-07-06T15:00:00Z,W PALM BEACH FL,0,0,2,7,9
Tropical Storm,Dennis,7,2005-07-06T15:00:00Z,21.1N  80.9W,0,14,12,1,27
Tropical Storm,Dennis,7,2005-07-06T15:00:00Z,FT PIERCE FL,0,0,1,6,7
Tropical Storm,Dennis,7,2005-07-06T15:00:00Z,MDCB 176N 714W,17,0,0,0,17
Tropical Storm,Dennis,7,2005-07-06T15:00:00Z,COCOA BEACH FL,0,0,0,6,6
Tropical Storm,Dennis,7,2005-07-06T15:00:00Z,MTPP 186N 724W,14,0,0,0,14
Tropical Storm,Dennis,7,2005-07-06T15:00:00Z,DAYTONA BEACH FL,0,0,0,4,4
Tropical Storm,Dennis,7,2005-07-06T15:00:00Z,MTCA 183N 738W,48,0,0,0,48
Tropical Storm,Dennis,7,2005-07-06T15:00:00Z,JACKSONVILLE FL,0,0,0,2,2
Tropical Storm,Dennis,7,2005-07-06T15:00:00Z,MKJP 179N 768W,39,2,0,1,42
Tropical Storm,Dennis,7,2005-07-06T15:00:00Z,KEY WEST FL,0,0,12,8,20
Tropical Storm,Dennis,7,2005-07-06T15:00:00Z,MKJS 185N 779W,21,15,0,0,36
Tropical Storm,Dennis,7,2005-07-06T15:00:00Z,MARCO ISLAND FL,0,0,4,11,15
Tropical Storm,Dennis,7,2005-07-06T15:00:00Z,MWCG 193N 814W,0,11,8,1,20
Tropical Storm,Dennis,7,2005-07-06T15:00:00Z,FT MYERS FL,0,0,2,11,13
Tropical Storm,Dennis,7,2005-07-06T15:00:00Z,MUGM 200N 751W,20,7,0,1,28
Tropical Storm,Dennis,7,2005-07-06T15:00:00Z,VENICE FL,0,0,1,12,13
Tropical Storm,Dennis,7,2005-07-06T15:00:00Z,MUCM 214N 779W,0,26,2,0,28
Tropical Storm,Dennis,7,2005-07-06T15:00:00Z,TAMPA FL,0,0,0,10,10
Tropical Storm,Dennis,7,2005-07-06T15:00:00Z,MUCF 221N 805W,0,10,15,1,26
Tropical Storm,Dennis,7,2005-07-06T15:00:00Z,CEDAR KEY FL,0,0,0,7,7
Tropical Storm,Dennis,7,2005-07-06T15:00:00Z,MUSN 216N 826W,0,2,17,4,23
Tropical Storm,Dennis,7,2005-07-06T15:00:00Z,ST MARKS FL,0,0,0,5,5
Tropical Storm,Dennis,7,2005-07-06T15:00:00Z,MUHA 230N 824W,0,0,18,5,23
Tropical Storm,Dennis,7,2005-07-06T15:00:00Z,APALACHICOLA FL,0,0,0,6,6
Tropical Storm,Dennis,7,2005-07-06T15:00:00Z,MUAN 219N 850W,0,0,5,12,17
Tropical Storm,Dennis,7,2005-07-06T15:00:00Z,PANAMA CITY FL,0,0,0,5,5
Tropical Storm,Dennis,7,2005-07-06T15:00:00Z,MMCZ 205N 869W,0,0,0,8,8
Tropical Storm,Dennis,7,2005-07-06T15:00:00Z,PENSACOLA FL,0,0,0,3,3
Tropical Storm,Dennis,7,2005-07-06T15:00:00Z,MYEG 235N 758W,0,2,2,1,5
Tropical Storm,Dennis,7,2005-07-06T15:00:00Z,MOBILE AL,0,0,0,2,2
Tropical Storm,Dennis,7,2005-07-06T15:00:00Z,MYAK 241N 776W,0,2,7,2,11
Tropical Storm,Dennis,7,2005-07-06T15:00:00Z,GULFPORT MS,0,0,0,2,2
Tropical Storm,Dennis,7,2005-07-06T15:00:00Z,MYNN 251N 775W,0,0,4,2,6
Tropical Storm,Dennis,7,2005-07-06T15:00:00Z,BURAS LA,0,0,0,2,2
Tropical Storm,Dennis,7,2005-07-06T15:00:00Z,MYGF 266N 787W,0,0,1,5,6
Tropical Storm,Dennis,7,2005-07-06T15:00:00Z,GULF 29N 85W,0,0,0,8,8
Tropical Storm,Dennis,7,2005-07-06T15:00:00Z,MMMD 210N 897W,0,0,0,2,2
Tropical Storm,Dennis,7,2005-07-06T15:00:00Z,GULF 29N 87W,0,0,0,6,6
Tropical Storm,Dennis,7,2005-07-06T15:00:00Z,MARATHON FL,0,0,12,7,19
Tropical Storm,Dennis,7,2005-07-06T15:00:00Z,GULF 28N 89W,0,0,0,4,4
Tropical Storm,Dennis,8,2005-07-06T21:00:00Z,18.4N  76.7W,46,0,1,0,47
Tropical Storm,Dennis,8,2005-07-06T21:00:00Z,W PALM BEACH FL,0,0,3,6,9
Tropical Storm,Dennis,8,2005-07-06T21:00:00Z,20.0N  79.1W,3,31,0,0,34
Tropical Storm,Dennis,8,2005-07-06T21:00:00Z,FT PIERCE FL,0,0,1,7,8
Tropical Storm,Dennis,8,2005-07-06T21:00:00Z,21.4N  81.4W,0,12,15,1,28
Tropical Storm,Dennis,8,2005-07-06T21:00:00Z,COCOA BEACH FL,0,0,0,6,6
Tropical Storm,Dennis,8,2005-07-06T21:00:00Z,MDCB 176N 714W,11,0,0,0,11
Tropical Storm,Dennis,8,2005-07-06T21:00:00Z,DAYTONA BEACH FL,0,0,0,5,5
Tropical Storm,Dennis,8,2005-07-06T21:00:00Z,MTPP 186N 724W,10,0,0,0,10
Tropical Storm,Dennis,8,2005-07-06T21:00:00Z,JACKSONVILLE FL,0,0,0,3,3
Tropical Storm,Dennis,8,2005-07-06T21:00:00Z,MTCA 183N 738W,53,0,0,0,53
Tropical Storm,Dennis,8,2005-07-06T21:00:00Z,KEY WEST FL,0,0,15,6,21
Tropical Storm,Dennis,8,2005-07-06T21:00:00Z,MKJP 179N 768W,44,0,0,1,45
Tropical Storm,Dennis,8,2005-07-06T21:00:00Z,MARCO ISLAND FL,0,0,6,10,16
Tropical Storm,Dennis,8,2005-07-06T21:00:00Z,MKJS 185N 779W,32,6,0,0,38
Tropical Storm,Dennis,8,2005-07-06T21:00:00Z,FT MYERS FL,0,0,3,11,14
Tropical Storm,Dennis,8,2005-07-06T21:00:00Z,MWCG 193N 814W,0,14,7,1,22
Tropical Storm,Dennis,8,2005-07-06T21:00:00Z,VENICE FL,0,0,1,13,14
Tropical Storm,Dennis,8,2005-07-06T21:00:00Z,MUGM 200N 751W,25,2,0,0,27
Tropical Storm,Dennis,8,2005-07-06T21:00:00Z,TAMPA FL,0,0,0,11,11
Tropical Storm,Dennis,8,2005-07-06T21:00:00Z,MUCM 214N 779W,1,27,0,0,28
Tropical Storm,Dennis,8,2005-07-06T21:00:00Z,CEDAR KEY FL,0,0,0,8,8
Tropical Storm,Dennis,8,2005-07-06T21:00:00Z,MUCF 221N 805W,0,15,13,1,29
Tropical Storm,Dennis,8,2005-07-06T21:00:00Z,ST MARKS FL,0,0,0,5,5
Tropical Storm,Dennis,8,2005-07-06T21:00:00Z,MUSN 216N 826W,0,3,20,2,25
Tropical Storm,Dennis,8,2005-07-06T21:00:00Z,APALACHICOLA FL,0,0,0,7,7
Tropical Storm,Dennis,8,2005-07-06T21:00:00Z,MUHA 230N 824W,0,1,21,3,25
Tropical Storm,Dennis,8,2005-07-06T21:00:00Z,PANAMA CITY FL,0,0,0,6,6
Tropical Storm,Dennis,8,2005-07-06T21:00:00Z,MUAN 219N 850W,0,0,8,10,18
Tropical Storm,Dennis,8,2005-07-06T21:00:00Z,PENSACOLA FL,0,0,0,4,4
Tropical Storm,Dennis,8,2005-07-06T21:00:00Z,MMCZ 205N 869W,0,0,1,8,9
Tropical Storm,Dennis,8,2005-07-06T21:00:00Z,MOBILE AL,0,0,0,2,2
Tropical Storm,Dennis,8,2005-07-06T21:00:00Z,MYEG 235N 758W,0,2,1,1,4
Tropical Storm,Dennis,8,2005-07-06T21:00:00Z,GULFPORT MS,0,0,0,2,2
Tropical Storm,Dennis,8,2005-07-06T21:00:00Z,MYAK 241N 776W,0,2,7,1,10
Tropical Storm,Dennis,8,2005-07-06T21:00:00Z,BURAS LA,0,0,0,3,3
Tropical Storm,Dennis,8,2005-07-06T21:00:00Z,MYNN 251N 775W,0,0,4,2,6
Tropical Storm,Dennis,8,2005-07-06T21:00:00Z,GULF 29N 85W,0,0,0,9,9
Tropical Storm,Dennis,8,2005-07-06T21:00:00Z,MYGF 266N 787W,0,0,2,3,5
Tropical Storm,Dennis,8,2005-07-06T21:00:00Z,GULF 29N 87W,0,0,0,7,7
Tropical Storm,Dennis,8,2005-07-06T21:00:00Z,MMMD 210N 897W,0,0,0,2,2
Tropical Storm,Dennis,8,2005-07-06T21:00:00Z,GULF 28N 89W,0,0,0,5,5
Tropical Storm,Dennis,8,2005-07-06T21:00:00Z,MARATHON FL,0,0,14,5,19
Tropical Storm,Dennis,8,2005-07-06T21:00:00Z,GULF 28N 91W,0,0,0,2,2
Tropical Storm,Dennis,8,2005-07-06T21:00:00Z,MIAMI FL,0,0,7,6,13
Hurricane,Dennis,9,2005-07-06T22:00:00Z,18.4N  76.7W,47,0,0,0,47
Hurricane,Dennis,9,2005-07-06T22:00:00Z,W PALM BEACH FL,0,0,2,8,10
Hurricane,Dennis,9,2005-07-06T22:00:00Z,20.0N  79.1W,3,29,0,0,32
Hurricane,Dennis,9,2005-07-06T22:00:00Z,FT PIERCE FL,0,0,1,7,8
Hurricane,Dennis,9,2005-07-06T22:00:00Z,21.4N  81.4W,0,11,13,1,25
Hurricane,Dennis,9,2005-07-06T22:00:00Z,COCOA BEACH FL,0,0,0,6,6
Hurricane,Dennis,9,2005-07-06T22:00:00Z,MDCB 176N 714W,11,0,0,0,11
Hurricane,Dennis,9,2005-07-06T22:00:00Z,DAYTONA BEACH FL,0,0,0,5,5
Hurricane,Dennis,9,2005-07-06T22:00:00Z,MTPP 186N 724W,10,0,0,0,10
Hurricane,Dennis,9,2005-07-06T22:00:00Z,JACKSONVILLE FL,0,0,0,3,3
Hurricane,Dennis,9,2005-07-06T22:00:00Z,MTCA 183N 738W,53,0,0,0,53
Hurricane,Dennis,9,2005-07-06T22:00:00Z,KEY WEST FL,0,0,12,7,19
Hurricane,Dennis,9,2005-07-06T22:00:00Z,MKJP 179N 768W,45,0,0,0,45
Hurricane,Dennis,9,2005-07-06T22:00:00Z,MARCO ISLAND FL,0,0,4,11,15
Hurricane,Dennis,9,2005-07-06T22:00:00Z,MKJS 185N 779W,33,5,0,0,38
Hurricane,Dennis,9,2005-07-06T22:00:00Z,FT MYERS FL,0,0,2,11,13
Hurricane,Dennis,9,2005-07-06T22:00:00Z,MWCG 193N 814W,0,15,5,1,21
Hurricane,Dennis,9,2005-07-06T22:00:00Z,VENICE FL,0,0,1,12,13
Hurricane,Dennis,9,2005-07-06T22:00:00Z,MUGM 200N 751W,26,2,0,0,28
Hurricane,Dennis,9,2005-07-06T22:00:00Z,TAMPA FL,0,0,0,10,10
Hurricane,Dennis,9,2005-07-06T22:00:00Z,MUCM 214N 779W,1,25,0,0,26
Hurricane,Dennis,9,2005-07-06T22:00:00Z,CEDAR KEY FL,0,0,0,7,7
Hurricane,Dennis,9,2005-07-06T22:00:00Z,MUCF 221N 805W,0,12,12,1,25
Hurricane,Dennis,9,2005-07-06T22:00:00Z,ST MARKS FL,0,0,0,5,5
Hurricane,Dennis,9,2005-07-06T22:00:00Z,MUSN 216N 826W,0,3,17,2,22
Hurricane,Dennis,9,2005-07-06T22:00:00Z,APALACHICOLA FL,0,0,0,6,6
Hurricane,Dennis,9,2005-07-06T22:00:00Z,MUHA 230N 824W,0,1,17,4,22
Hurricane,Dennis,9,2005-07-06T22:00:00Z,PANAMA CITY FL,0,0,0,5,5
Hurricane,Dennis,9,2005-07-06T22:00:00Z,MUAN 219N 850W,0,0,8,9,17
Hurricane,Dennis,9,2005-07-06T22:00:00Z,PENSACOLA FL,0,0,0,3,3
Hurricane,Dennis,9,2005-07-06T22:00:00Z,MMCZ 205N 869W,0,0,1,7,8
Hurricane,Dennis,9,2005-07-06T22:00:00Z,MOBILE AL,0,0,0,2,2
Hurricane,Dennis,9,2005-07-06T22:00:00Z,MYEG 235N 758W,0,2,3,0,5
Hurricane,Dennis,9,2005-07-06T22:00:00Z,GULFPORT MS,0,0,0,2,2
Hurricane,Dennis,9,2005-07-06T22:00:00Z,MYAK 241N 776W,0,3,6,2,11
Hurricane,Dennis,9,2005-07-06T22:00:00Z,BURAS LA,0,0,0,2,2
Hurricane,Dennis,9,2005-07-06T22:00:00Z,MYNN 251N 775W,0,0,4,3,7
Hurricane,Dennis,9,2005-07-06T22:00:00Z,GULF 29N 85W,0,0,0,8,8
Hurricane,Dennis,9,2005-07-06T22:00:00Z,MYGF 266N 787W,0,0,2,4,6
Hurricane,Dennis,9,2005-07-06T22:00:00Z,GULF 29N 87W,0,0,0,7,7
Hurricane,Dennis,9,2005-07-06T22:00:00Z,MMMD 210N 897W,0,0,0,2,2
Hurricane,Dennis,9,2005-07-06T22:00:00Z,GULF 28N 89W,0,0,0,5,5
Hurricane,Dennis,9,2005-07-06T22:00:00Z,MARATHON FL,0,0,12,6,18
Hurricane,Dennis,9,2005-07-06T22:00:00Z,GULF 28N 91W,0,0,0,2,2
Hurricane,Dennis,9,2005-07-06T22:00:00Z,MIAMI FL,0,0,5,8,13
Hurricane,Dennis,10,2005-07-07T03:00:00Z,19.2N  77.8W,47,0,0,1,48
Hurricane,Dennis,10,2005-07-07T03:00:00Z,W PALM BEACH FL,0,0,4,6,10
Hurricane,Dennis,10,2005-07-07T03:00:00Z,20.7N  80.1W,3,30,0,0,33
Hurricane,Dennis,10,2005-07-07T03:00:00Z,FT PIERCE FL,0,0,2,6,8
Hurricane,Dennis,10,2005-07-07T03:00:00Z,22.2N  82.1W,0,13,13,1,27
Hurricane,Dennis,10,2005-07-07T03:00:00Z,COCOA BEACH FL,0,0,1,6,7
Hurricane,Dennis,10,2005-07-07T03:00:00Z,MDCB 176N 714W,2,0,0,0,2
Hurricane,Dennis,10,2005-07-07T03:00:00Z,DAYTONA BEACH FL,0,0,0,5,5
Hurricane,Dennis,10,2005-07-07T03:00:00Z,MTPP 186N 724W,3,0,0,0,3
Hurricane,Dennis,10,2005-07-07T03:00:00Z,JACKSONVILLE FL,0,0,0,3,3
Hurricane,Dennis,10,2005-07-07T03:00:00Z,MTCA 183N 738W,56,0,0,0,56
Hurricane,Dennis,10,2005-07-07T03:00:00Z,KEY WEST FL,0,1,17,4,22
Hurricane,Dennis,10,2005-07-07T03:00:00Z,MKJP 179N 768W,54,0,0,0,54
Hurricane,Dennis,10,2005-07-07T03:00:00Z,MARCO ISLAND FL,0,0,9,8,17
Hurricane,Dennis,10,2005-07-07T03:00:00Z,MKJS 185N 779W,45,0,0,0,45
Hurricane,Dennis,10,2005-07-07T03:00:00Z,FT MYERS FL,0,0,6,9,15
Hurricane,Dennis,10,2005-07-07T03:00:00Z,MWCG 193N 814W,1,20,1,1,23
Hurricane,Dennis,10,2005-07-07T03:00:00Z,VENICE FL,0,0,3,12,15
Hurricane,Dennis,10,2005-07-07T03:00:00Z,MUGM 200N 751W,28,0,0,0,28
Hurricane,Dennis,10,2005-07-07T03:00:00Z,TAMPA FL,0,0,1,11,12
Hurricane,Dennis,10,2005-07-07T03:00:00Z,MUCM 214N 779W,12,18,0,0,30
Hurricane,Dennis,10,2005-07-07T03:00:00Z,CEDAR KEY FL,0,0,0,9,9
Hurricane,Dennis,10,2005-07-07T03:00:00Z,MUCF 221N 805W,0,25,3,1,29
Hurricane,Dennis,10,2005-07-07T03:00:00Z,ST MARKS FL,0,0,0,8,8
Hurricane,Dennis,10,2005-07-07T03:00:00Z,MUSN 216N 826W,0,12,12,1,25
Hurricane,Dennis,10,2005-07-07T03:00:00Z,APALACHICOLA FL,0,0,0,10,10
Hurricane,Dennis,10,2005-07-07T03:00:00Z,MUHA 230N 824W,0,5,19,1,25
Hurricane,Dennis,10,2005-07-07T03:00:00Z,PANAMA CITY FL,0,0,0,9,9
Hurricane,Dennis,10,2005-07-07T03:00:00Z,MUAN 219N 850W,0,0,12,6,18
Hurricane,Dennis,10,2005-07-07T03:00:00Z,PENSACOLA FL,0,0,0,7,7
Hurricane,Dennis,10,2005-07-07T03:00:00Z,MMCZ 205N 869W,0,0,2,6,8
Hurricane,Dennis,10,2005-07-07T03:00:00Z,MOBILE AL,0,0,0,5,5
Hurricane,Dennis,10,2005-07-07T03:00:00Z,MYEG 235N 758W,0,2,1,0,3
Hurricane,Dennis,10,2005-07-07T03:00:00Z,GULFPORT MS,0,0,0,5,5
Hurricane,Dennis,10,2005-07-07T03:00:00Z,MYAK 241N 776W,0,4,4,1,9
Hurricane,Dennis,10,2005-07-07T03:00:00Z,BURAS LA,0,0,0,5,5
Hurricane,Dennis,10,2005-07-07T03:00:00Z,MYNN 251N 775W,0,1,3,1,5
Hurricane,Dennis,10,2005-07-07T03:00:00Z,NEW ORLEANS LA,0,0,0,3,3
Hurricane,Dennis,10,2005-07-07T03:00:00Z,MYGF 266N 787W,0,0,2,3,5
Hurricane,Dennis,10,2005-07-07T03:00:00Z,GULF 29N 85W,0,0,0,12,12
Hurricane,Dennis,10,2005-07-07T03:00:00Z,MMMD 210N 897W,0,0,0,2,2
Hurricane,Dennis,10,2005-07-07T03:00:00Z,GULF 29N 87W,0,0,0,11,11
Hurricane,Dennis,10,2005-07-07T03:00:00Z,MARATHON FL,0,2,15,3,20
Hurricane,Dennis,10,2005-07-07T03:00:00Z,GULF 28N 89W,0,0,0,9,9
Hurricane,Dennis,10,2005-07-07T03:00:00Z,MIAMI FL,0,0,9,5,14
Hurricane,Dennis,10,2005-07-07T03:00:00Z,GULF 28N 91W,0,0,0,3,3
Hurricane,Dennis,11,2005-07-07T09:00:00Z,20.0N  79.0W,47,0,0,0,47
Hurricane,Dennis,11,2005-07-07T09:00:00Z,DAYTONA BEACH FL,0,0,0,6,6
Hurricane,Dennis,11,2005-07-07T09:00:00Z,21.6N  81.5W,3,31,0,0,34
Hurricane,Dennis,11,2005-07-07T09:00:00Z,JACKSONVILLE FL,0,0,0,5,5
Hurricane,Dennis,11,2005-07-07T09:00:00Z,23.5N  83.5W,0,11,16,1,28
Hurricane,Dennis,11,2005-07-07T09:00:00Z,SAVANNAH GA,0,0,0,2,2
Hurricane,Dennis,11,2005-07-07T09:00:00Z,MTCA 183N 738W,38,0,0,0,38
Hurricane,Dennis,11,2005-07-07T09:00:00Z,KEY WEST FL,0,9,14,1,24
Hurricane,Dennis,11,2005-07-07T09:00:00Z,MKJP 179N 768W,65,0,0,0,65
Hurricane,Dennis,11,2005-07-07T09:00:00Z,MARCO ISLAND FL,0,1,13,4,18
Hurricane,Dennis,11,2005-07-07T09:00:00Z,MKJS 185N 779W,55,0,0,0,55
Hurricane,Dennis,11,2005-07-07T09:00:00Z,FT MYERS FL,0,0,11,5,16
Hurricane,Dennis,11,2005-07-07T09:00:00Z,MWCG 193N 814W,11,10,0,1,22
Hurricane,Dennis,11,2005-07-07T09:00:00Z,VENICE FL,0,0,9,8,17
Hurricane,Dennis,11,2005-07-07T09:00:00Z,MUGM 200N 751W,15,0,0,0,15
Hurricane,Dennis,11,2005-07-07T09:00:00Z,TAMPA FL,0,0,4,10,14
Hurricane,Dennis,11,2005-07-07T09:00:00Z,MUCM 214N 779W,28,3,0,0,31
Hurricane,Dennis,11,2005-07-07T09:00:00Z,CEDAR KEY FL,0,0,1,11,12
Hurricane,Dennis,11,2005-07-07T09:00:00Z,MUCF 221N 805W,5,29,0,0,34
Hurricane,Dennis,11,2005-07-07T09:00:00Z,ST MARKS FL,0,0,0,12,12
Hurricane,Dennis,11,2005-07-07T09:00:00Z,MUSN 216N 826W,0,28,2,0,30
Hurricane,Dennis,11,2005-07-07T09:00:00Z,APALACHICOLA FL,0,0,0,15,15
Hurricane,Dennis,11,2005-07-07T09:00:00Z,MUHA 230N 824W,0,24,6,0,30
Hurricane,Dennis,11,2005-07-07T09:00:00Z,PANAMA CITY FL,0,0,0,15,15
Hurricane,Dennis,11,2005-07-07T09:00:00Z,MUAN 219N 850W,0,6,12,1,19
Hurricane,Dennis,11,2005-07-07T09:00:00Z,PENSACOLA FL,0,0,0,14,14
Hurricane,Dennis,11,2005-07-07T09:00:00Z,MMCZ 205N 869W,0,0,3,3,6
Hurricane,Dennis,11,2005-07-07T09:00:00Z,MOBILE AL,0,0,0,12,12
Hurricane,Dennis,11,2005-07-07T09:00:00Z,MYAK 241N 776W,0,3,1,0,4
Hurricane,Dennis,11,2005-07-07T09:00:00Z,GULFPORT MS,0,0,0,12,12
Hurricane,Dennis,11,2005-07-07T09:00:00Z,MYNN 251N 775W,0,1,0,1,2
Hurricane,Dennis,11,2005-07-07T09:00:00Z,BURAS LA,0,0,0,12,12
Hurricane,Dennis,11,2005-07-07T09:00:00Z,MYGF 266N 787W,0,0,1,2,3
Hurricane,Dennis,11,2005-07-07T09:00:00Z,NEW ORLEANS LA,0,0,0,9,9
Hurricane,Dennis,11,2005-07-07T09:00:00Z,MMMD 210N 897W,0,0,0,2,2
Hurricane,Dennis,11,2005-07-07T09:00:00Z,NEW IBERIA LA,0,0,0,5,5
Hurricane,Dennis,11,2005-07-07T09:00:00Z,MARATHON FL,0,8,12,1,21
Hurricane,Dennis,11,2005-07-07T09:00:00Z,GULF 29N 85W,0,0,1,15,16
Hurricane,Dennis,11,2005-07-07T09:00:00Z,MIAMI FL,0,1,9,2,12
Hurricane,Dennis,11,2005-07-07T09:00:00Z,GULF 29N 87W,0,0,0,17,17
Hurricane,Dennis,11,2005-07-07T09:00:00Z,W PALM BEACH FL,0,0,5,4,9
Hurricane,Dennis,11,2005-07-07T09:00:00Z,GULF 28N 89W,0,0,0,14,14
Hurricane,Dennis,11,2005-07-07T09:00:00Z,FT PIERCE FL,0,0,2,5,7
Hurricane,Dennis,11,2005-07-07T09:00:00Z,GULF 28N 91W,0,0,0,8,8
Hurricane,Dennis,11,2005-07-07T09:00:00Z,COCOA BEACH FL,0,0,1,6,7
Hurricane,Dennis,11,2005-07-07T09:00:00Z,GULF 28N 93W,0,0,0,3,3
Hurricane,Dennis,12,2005-07-07T15:00:00Z,21.3N  79.8W,48,0,0,0,48
Hurricane,Dennis,12,2005-07-07T15:00:00Z,JACKSONVILLE FL,0,0,1,8,9
Hurricane,Dennis,12,2005-07-07T15:00:00Z,22.8N  81.8W,6,27,0,0,33
Hurricane,Dennis,12,2005-07-07T15:00:00Z,SAVANNAH GA,0,0,0,4,4
Hurricane,Dennis,12,2005-07-07T15:00:00Z,24.7N  83.5W,0,12,15,1,28
Hurricane,Dennis,12,2005-07-07T15:00:00Z,KEY WEST FL,0,23,5,1,29
Hurricane,Dennis,12,2005-07-07T15:00:00Z,MTCA 183N 738W,54,0,0,0,54
Hurricane,Dennis,12,2005-07-07T15:00:00Z,MARCO ISLAND FL,0,6,15,1,22
Hurricane,Dennis,12,2005-07-07T15:00:00Z,MKJP 179N 768W,54,0,0,0,54
Hurricane,Dennis,12,2005-07-07T15:00:00Z,FT MYERS FL,0,2,17,2,21
Hurricane,Dennis,12,2005-07-07T15:00:00Z,MKJS 185N 779W,47,0,0,0,47
Hurricane,Dennis,12,2005-07-07T15:00:00Z,VENICE FL,0,1,16,4,21
Hurricane,Dennis,12,2005-07-07T15:00:00Z,MWCG 193N 814W,6,2,0,0,8
Hurricane,Dennis,12,2005-07-07T15:00:00Z,TAMPA FL,0,0,11,7,18
Hurricane,Dennis,12,2005-07-07T15:00:00Z,MUGM 200N 751W,19,0,0,0,19
Hurricane,Dennis,12,2005-07-07T15:00:00Z,CEDAR KEY FL,0,0,4,12,16
Hurricane,Dennis,12,2005-07-07T15:00:00Z,MUCM 214N 779W,49,0,0,0,49
Hurricane,Dennis,12,2005-07-07T15:00:00Z,ST MARKS FL,0,0,1,15,16
Hurricane,Dennis,12,2005-07-07T15:00:00Z,MUCF 221N 805W,35,5,0,0,40
Hurricane,Dennis,12,2005-07-07T15:00:00Z,APALACHICOLA FL,0,0,1,17,18
Hurricane,Dennis,12,2005-07-07T15:00:00Z,MUSN 216N 826W,7,18,1,0,26
Hurricane,Dennis,12,2005-07-07T15:00:00Z,PANAMA CITY FL,0,0,1,17,18
Hurricane,Dennis,12,2005-07-07T15:00:00Z,MUHA 230N 824W,2,28,1,0,31
Hurricane,Dennis,12,2005-07-07T15:00:00Z,PENSACOLA FL,0,0,0,16,16
Hurricane,Dennis,12,2005-07-07T15:00:00Z,MUAN 219N 850W,0,7,6,2,15
Hurricane,Dennis,12,2005-07-07T15:00:00Z,MOBILE AL,0,0,0,14,14
Hurricane,Dennis,12,2005-07-07T15:00:00Z,MMCZ 205N 869W,0,0,1,1,2
Hurricane,Dennis,12,2005-07-07T15:00:00Z,GULFPORT MS,0,0,0,13,13
Hurricane,Dennis,12,2005-07-07T15:00:00Z,MYAK 241N 776W,2,5,1,1,9
Hurricane,Dennis,12,2005-07-07T15:00:00Z,BURAS LA,0,0,0,12,12
Hurricane,Dennis,12,2005-07-07T15:00:00Z,MYNN 251N 775W,0,2,1,1,4
Hurricane,Dennis,12,2005-07-07T15:00:00Z,NEW ORLEANS LA,0,0,0,9,9
Hurricane,Dennis,12,2005-07-07T15:00:00Z,MYGF 266N 787W,0,1,3,2,6
Hurricane,Dennis,12,2005-07-07T15:00:00Z,NEW IBERIA LA,0,0,0,4,4
Hurricane,Dennis,12,2005-07-07T15:00:00Z,MARATHON FL,0,21,5,0,26
Hurricane,Dennis,12,2005-07-07T15:00:00Z,GULF 29N 85W,0,0,3,16,19
Hurricane,Dennis,12,2005-07-07T15:00:00Z,MIAMI FL,0,8,8,1,17
Hurricane,Dennis,12,2005-07-07T15:00:00Z,GULF 29N 87W,0,0,1,17,18
Hurricane,Dennis,12,2005-07-07T15:00:00Z,W PALM BEACH FL,0,2,9,2,13
Hurricane,Dennis,12,2005-07-07T15:00:00Z,GULF 28N 89W,0,0,0,13,13
Hurricane,Dennis,12,2005-07-07T15:00:00Z,FT PIERCE FL,0,0,8,3,11
Hurricane,Dennis,12,2005-07-07T15:00:00Z,GULF 28N 91W,0,0,0,7,7
Hurricane,Dennis,12,2005-07-07T15:00:00Z,COCOA BEACH FL,0,0,5,6,11
Hurricane,Dennis,12,2005-07-07T15:00:00Z,GULF 28N 93W,0,0,0,2,2
Hurricane,Dennis,12,2005-07-07T15:00:00Z,DAYTONA BEACH FL,0,0,2,8,10
Hurricane,Dennis,13,2005-07-07T21:00:00Z,22.3N  80.5W,47,0,0,0,47
Hurricane,Dennis,13,2005-07-07T21:00:00Z,SAVANNAH GA,0,0,0,6,6
Hurricane,Dennis,13,2005-07-07T21:00:00Z,24.2N  82.5W,4,30,0,0,34
Hurricane,Dennis,13,2005-07-07T21:00:00Z,CHARLESTON SC,0,0,0,2,2
Hurricane,Dennis,13,2005-07-07T21:00:00Z,26.0N  84.0W,0,15,11,1,27
Hurricane,Dennis,13,2005-07-07T21:00:00Z,KEY WEST FL,5,29,0,0,34
Hurricane,Dennis,13,2005-07-07T21:00:00Z,MKJP 179N 768W,99,0,0,0,99
Hurricane,Dennis,13,2005-07-07T21:00:00Z,MARCO ISLAND FL,0,21,4,1,26
Hurricane,Dennis,13,2005-07-07T21:00:00Z,MKJS 185N 779W,16,0,0,0,16
Hurricane,Dennis,13,2005-07-07T21:00:00Z,FT MYERS FL,0,15,7,1,23
Hurricane,Dennis,13,2005-07-07T21:00:00Z,MWCG 193N 814W,2,0,0,0,2
Hurricane,Dennis,13,2005-07-07T21:00:00Z,VENICE FL,0,9,13,1,23
Hurricane,Dennis,13,2005-07-07T21:00:00Z,MUGM 200N 751W,12,0,0,0,12
Hurricane,Dennis,13,2005-07-07T21:00:00Z,TAMPA FL,0,2,16,2,20
Hurricane,Dennis,13,2005-07-07T21:00:00Z,MUCM 214N 779W,61,0,0,0,61
Hurricane,Dennis,13,2005-07-07T21:00:00Z,CEDAR KEY FL,0,0,12,7,19
Hurricane,Dennis,13,2005-07-07T21:00:00Z,MUCF 221N 805W,48,0,0,0,48
Hurricane,Dennis,13,2005-07-07T21:00:00Z,ST MARKS FL,0,0,5,13,18
Hurricane,Dennis,13,2005-07-07T21:00:00Z,MUSN 216N 826W,16,6,1,0,23
Hurricane,Dennis,13,2005-07-07T21:00:00Z,APALACHICOLA FL,0,0,7,13,20
Hurricane,Dennis,13,2005-07-07T21:00:00Z,MUHA 230N 824W,18,16,0,0,34
Hurricane,Dennis,13,2005-07-07T21:00:00Z,PANAMA CITY FL,0,0,4,16,20
Hurricane,Dennis,13,2005-07-07T21:00:00Z,MUAN 219N 850W,0,6,2,1,9
Hurricane,Dennis,13,2005-07-07T21:00:00Z,PENSACOLA FL,0,0,1,17,18
Hurricane,Dennis,13,2005-07-07T21:00:00Z,MYAK 241N 776W,5,2,1,0,8
Hurricane,Dennis,13,2005-07-07T21:00:00Z,MOBILE AL,0,0,0,16,16
Hurricane,Dennis,13,2005-07-07T21:00:00Z,MYNN 251N 775W,1,2,0,0,3
Hurricane,Dennis,13,2005-07-07T21:00:00Z,GULFPORT MS,0,0,0,14,14
Hurricane,Dennis,13,2005-07-07T21:00:00Z,MYGF 266N 787W,0,3,3,0,6
Hurricane,Dennis,13,2005-07-07T21:00:00Z,BURAS LA,0,0,0,13,13
Hurricane,Dennis,13,2005-07-07T21:00:00Z,MARATHON FL,5,26,0,1,32
Hurricane,Dennis,13,2005-07-07T21:00:00Z,NEW ORLEANS LA,0,0,0,11,11
Hurricane,Dennis,13,2005-07-07T21:00:00Z,MIAMI FL,0,18,1,1,20
Hurricane,Dennis,13,2005-07-07T21:00:00Z,NEW IBERIA LA,0,0,0,6,6
Hurricane,Dennis,13,2005-07-07T21:00:00Z,W PALM BEACH FL,0,8,5,1,14
Hurricane,Dennis,13,2005-07-07T21:00:00Z,GULF 29N 85W,0,0,12,10,22
Hurricane,Dennis,13,2005-07-07T21:00:00Z,FT PIERCE FL,0,3,8,1,12
Hurricane,Dennis,13,2005-07-07T21:00:00Z,GULF 29N 87W,0,0,5,15,20
Hurricane,Dennis,13,2005-07-07T21:00:00Z,COCOA BEACH FL,0,1,8,3,12
Hurricane,Dennis,13,2005-07-07T21:00:00Z,GULF 28N 89W,0,0,1,13,14
Hurricane,Dennis,13,2005-07-07T21:00:00Z,DAYTONA BEACH FL,0,0,6,6,12
Hurricane,Dennis,13,2005-07-07T21:00:00Z,GULF 28N 91W,0,0,0,7,7
Hurricane,Dennis,13,2005-07-07T21:00:00Z,JACKSONVILLE FL,0,0,2,9,11
Hurricane,Dennis,13,2005-07-07T21:00:00Z,GULF 28N 93W,0,0,0,2,2
Hurricane,Dennis,14,2005-07-08T03:00:00Z,23.0N  81.2W,48,0,0,0,48
Hurricane,Dennis,14,2005-07-08T03:00:00Z,MARCO ISLAND FL,1,24,1,0,26
Hurricane,Dennis,14,2005-07-08T03:00:00Z,24.8N  83.1W,5,29,0,0,34
Hurricane,Dennis,14,2005-07-08T03:00:00Z,FT MYERS FL,0,20,3,1,24
Hurricane,Dennis,14,2005-07-08T03:00:00Z,26.8N  84.6W,0,14,13,1,28
Hurricane,Dennis,14,2005-07-08T03:00:00Z,VENICE FL,0,16,8,0,24
Hurricane,Dennis,14,2005-07-08T03:00:00Z,MUGM 200N 751W,2,0,0,0,2
Hurricane,Dennis,14,2005-07-08T03:00:00Z,TAMPA FL,0,6,13,2,21
Hurricane,Dennis,14,2005-07-08T03:00:00Z,MUCM 214N 779W,70,0,0,0,70
Hurricane,Dennis,14,2005-07-08T03:00:00Z,CEDAR KEY FL,0,1,14,4,19
Hurricane,Dennis,14,2005-07-08T03:00:00Z,MUCF 221N 805W,58,0,0,0,58
Hurricane,Dennis,14,2005-07-08T03:00:00Z,ST MARKS FL,0,0,10,9,19
Hurricane,Dennis,14,2005-07-08T03:00:00Z,MUSN 216N 826W,19,2,0,0,21
Hurricane,Dennis,14,2005-07-08T03:00:00Z,APALACHICOLA FL,0,0,14,7,21
Hurricane,Dennis,14,2005-07-08T03:00:00Z,MUHA 230N 824W,35,3,0,0,38
Hurricane,Dennis,14,2005-07-08T03:00:00Z,PANAMA CITY FL,0,0,11,10,21
Hurricane,Dennis,14,2005-07-08T03:00:00Z,MUAN 219N 850W,1,4,1,1,7
Hurricane,Dennis,14,2005-07-08T03:00:00Z,PENSACOLA FL,0,0,4,15,19
Hurricane,Dennis,14,2005-07-08T03:00:00Z,MYAK 241N 776W,3,1,0,0,4
Hurricane,Dennis,14,2005-07-08T03:00:00Z,MOBILE AL,0,0,2,15,17
Hurricane,Dennis,14,2005-07-08T03:00:00Z,MYGF 266N 787W,0,2,1,1,4
Hurricane,Dennis,14,2005-07-08T03:00:00Z,GULFPORT MS,0,0,1,15,16
Hurricane,Dennis,14,2005-07-08T03:00:00Z,MARATHON FL,20,13,0,0,33
Hurricane,Dennis,14,2005-07-08T03:00:00Z,BURAS LA,0,0,1,13,14
Hurricane,Dennis,14,2005-07-08T03:00:00Z,MIAMI FL,2,15,1,0,18
Hurricane,Dennis,14,2005-07-08T03:00:00Z,NEW ORLEANS LA,0,0,0,12,12
Hurricane,Dennis,14,2005-07-08T03:00:00Z,W PALM BEACH FL,0,9,3,0,12
Hurricane,Dennis,14,2005-07-08T03:00:00Z,NEW IBERIA LA,0,0,0,7,7
Hurricane,Dennis,14,2005-07-08T03:00:00Z,FT PIERCE FL,0,4,6,1,11
Hurricane,Dennis,14,2005-07-08T03:00:00Z,PORT ARTHUR TX,0,0,0,2,2
Hurricane,Dennis,14,2005-07-08T03:00:00Z,COCOA BEACH FL,0,2,7,2,11
Hurricane,Dennis,14,2005-07-08T03:00:00Z,GULF 29N 85W,0,0,18,5,23
Hurricane,Dennis,14,2005-07-08T03:00:00Z,DAYTONA BEACH FL,0,0,7,4,11
Hurricane,Dennis,14,2005-07-08T03:00:00Z,GULF 29N 87W,0,0,12,9,21
Hurricane,Dennis,14,2005-07-08T03:00:00Z,JACKSONVILLE FL,0,0,4,6,10
Hurricane,Dennis,14,2005-07-08T03:00:00Z,GULF 28N 89W,0,0,5,10,15
Hurricane,Dennis,14,2005-07-08T03:00:00Z,SAVANNAH GA,0,0,0,6,6
Hurricane,Dennis,14,2005-07-08T03:00:00Z,GULF 28N 91W,0,0,0,8,8
Hurricane,Dennis,14,2005-07-08T03:00:00Z,CHARLESTON SC,0,0,0,2,2
Hurricane,Dennis,14,2005-07-08T03:00:00Z,GULF 28N 93W,0,0,0,3,3
Hurricane,Dennis,14,2005-07-08T03:00:00Z,KEY WEST FL,22,14,0,1,37
Hurricane,Dennis,15,2005-07-08T09:00:00Z,23.8N  82.8W,50,0,0,0,50
Hurricane,Dennis,15,2005-07-08T09:00:00Z,FT MYERS FL,7,18,0,0,25
Hurricane,Dennis,15,2005-07-08T09:00:00Z,25.8N  84.5W,5,27,0,1,33
Hurricane,Dennis,15,2005-07-08T09:00:00Z,VENICE FL,2,22,1,0,25
Hurricane,Dennis,15,2005-07-08T09:00:00Z,27.7N  85.7W,0,13,10,1,24
Hurricane,Dennis,15,2005-07-08T09:00:00Z,TAMPA FL,0,15,5,0,20
Hurricane,Dennis,15,2005-07-08T09:00:00Z,MUCM 214N 779W,72,0,0,0,72
Hurricane,Dennis,15,2005-07-08T09:00:00Z,CEDAR KEY FL,0,5,11,2,18
Hurricane,Dennis,15,2005-07-08T09:00:00Z,MUCF 221N 805W,80,0,0,0,80
Hurricane,Dennis,15,2005-07-08T09:00:00Z,ST MARKS FL,0,1,11,6,18
Hurricane,Dennis,15,2005-07-08T09:00:00Z,MUSN 216N 826W,32,0,0,0,32
Hurricane,Dennis,15,2005-07-08T09:00:00Z,APALACHICOLA FL,0,1,15,4,20
Hurricane,Dennis,15,2005-07-08T09:00:00Z,MUHA 230N 824W,55,0,0,0,55
Hurricane,Dennis,15,2005-07-08T09:00:00Z,PANAMA CITY FL,0,0,14,6,20
Hurricane,Dennis,15,2005-07-08T09:00:00Z,MUAN 219N 850W,3,2,0,0,5
Hurricane,Dennis,15,2005-07-08T09:00:00Z,PENSACOLA FL,0,0,7,11,18
Hurricane,Dennis,15,2005-07-08T09:00:00Z,MYGF 266N 787W,0,1,1,0,2
Hurricane,Dennis,15,2005-07-08T09:00:00Z,MOBILE AL,0,0,4,13,17
Hurricane,Dennis,15,2005-07-08T09:00:00Z,MARATHON FL,41,0,0,0,41
Hurricane,Dennis,15,2005-07-08T09:00:00Z,GULFPORT MS,0,0,3,13,16
Hurricane,Dennis,15,2005-07-08T09:00:00Z,MIAMI FL,11,6,0,0,17
Hurricane,Dennis,15,2005-07-08T09:00:00Z,BURAS LA,0,0,4,11,15
Hurricane,Dennis,15,2005-07-08T09:00:00Z,W PALM BEACH FL,2,6,2,0,10
Hurricane,Dennis,15,2005-07-08T09:00:00Z,NEW ORLEANS LA,0,0,2,11,13
Hurricane,Dennis,15,2005-07-08T09:00:00Z,FT PIERCE FL,0,6,3,1,10
Hurricane,Dennis,15,2005-07-08T09:00:00Z,NEW IBERIA LA,0,0,0,9,9
Hurricane,Dennis,15,2005-07-08T09:00:00Z,COCOA BEACH FL,0,4,5,1,10
Hurricane,Dennis,15,2005-07-08T09:00:00Z,PORT ARTHUR TX,0,0,0,4,4
Hurricane,Dennis,15,2005-07-08T09:00:00Z,DAYTONA BEACH FL,0,2,6,3,11
Hurricane,Dennis,15,2005-07-08T09:00:00Z,GALVESTON TX,0,0,0,2,2
Hurricane,Dennis,15,2005-07-08T09:00:00Z,JACKSONVILLE FL,0,0,5,6,11
Hurricane,Dennis,15,2005-07-08T09:00:00Z,GULF 29N 85W,0,4,15,3,22
Hurricane,Dennis,15,2005-07-08T09:00:00Z,SAVANNAH GA,0,0,1,6,7
Hurricane,Dennis,15,2005-07-08T09:00:00Z,GULF 29N 87W,0,1,15,4,20
Hurricane,Dennis,15,2005-07-08T09:00:00Z,CHARLESTON SC,0,0,0,3,3
Hurricane,Dennis,15,2005-07-08T09:00:00Z,GULF 28N 89W,0,0,9,5,14
Hurricane,Dennis,15,2005-07-08T09:00:00Z,KEY WEST FL,48,0,0,0,48
Hurricane,Dennis,15,2005-07-08T09:00:00Z,GULF 28N 91W,0,0,2,7,9
Hurricane,Dennis,15,2005-07-08T09:00:00Z,MARCO ISLAND FL,18,11,0,0,29
Hurricane,Dennis,15,2005-07-08T09:00:00Z,GULF 28N 93W,0,0,0,4,4
Hurricane,Dennis,16,2005-07-08T15:00:00Z,24.5N  83.6W,49,0,0,0,49
Hurricane,Dennis,16,2005-07-08T15:00:00Z,VENICE FL,8,17,0,0,25
Hurricane,Dennis,16,2005-07-08T15:00:00Z,26.5N  85.0W,6,26,0,0,32
Hurricane,Dennis,16,2005-07-08T15:00:00Z,TAMPA FL,1,17,2,0,20
Hurricane,Dennis,16,2005-07-08T15:00:00Z,28.4N  86.2W,0,13,10,1,24
Hurricane,Dennis,16,2005-07-08T15:00:00Z,CEDAR KEY FL,0,9,8,1,18
Hurricane,Dennis,16,2005-07-08T15:00:00Z,MUCM 214N 779W,21,0,0,0,21
Hurricane,Dennis,16,2005-07-08T15:00:00Z,ST MARKS FL,0,2,14,3,19
Hurricane,Dennis,16,2005-07-08T15:00:00Z,MUCF 221N 805W,99,0,0,0,99
Hurricane,Dennis,16,2005-07-08T15:00:00Z,APALACHICOLA FL,0,4,15,2,21
Hurricane,Dennis,16,2005-07-08T15:00:00Z,MUSN 216N 826W,34,0,0,0,34
Hurricane,Dennis,16,2005-07-08T15:00:00Z,PANAMA CITY FL,0,2,16,3,21
Hurricane,Dennis,16,2005-07-08T15:00:00Z,MUHA 230N 824W,68,0,0,0,68
Hurricane,Dennis,16,2005-07-08T15:00:00Z,PENSACOLA FL,0,0,13,7,20
Hurricane,Dennis,16,2005-07-08T15:00:00Z,MUAN 219N 850W,3,0,0,0,3
Hurricane,Dennis,16,2005-07-08T15:00:00Z,MOBILE AL,0,0,9,9,18
Hurricane,Dennis,16,2005-07-08T15:00:00Z,MARATHON FL,43,0,0,0,43
Hurricane,Dennis,16,2005-07-08T15:00:00Z,GULFPORT MS,0,0,7,10,17
Hurricane,Dennis,16,2005-07-08T15:00:00Z,MIAMI FL,9,2,1,0,12
Hurricane,Dennis,16,2005-07-08T15:00:00Z,BURAS LA,0,0,8,7,15
Hurricane,Dennis,16,2005-07-08T15:00:00Z,W PALM BEACH FL,2,4,0,1,7
Hurricane,Dennis,16,2005-07-08T15:00:00Z,NEW ORLEANS LA,0,0,4,10,14
Hurricane,Dennis,16,2005-07-08T15:00:00Z,FT PIERCE FL,1,4,2,0,7
Hurricane,Dennis,16,2005-07-08T15:00:00Z,NEW IBERIA LA,0,0,1,8,9
Hurricane,Dennis,16,2005-07-08T15:00:00Z,COCOA BEACH FL,0,4,3,1,8
Hurricane,Dennis,16,2005-07-08T15:00:00Z,PORT ARTHUR TX,0,0,0,4,4
Hurricane,Dennis,16,2005-07-08T15:00:00Z,DAYTONA BEACH FL,0,3,5,2,10
Hurricane,Dennis,16,2005-07-08T15:00:00Z,GALVESTON TX,0,0,0,2,2
Hurricane,Dennis,16,2005-07-08T15:00:00Z,JACKSONVILLE FL,0,0,6,4,10
Hurricane,Dennis,16,2005-07-08T15:00:00Z,GULF 29N 85W,0,11,11,1,23
Hurricane,Dennis,16,2005-07-08T15:00:00Z,SAVANNAH GA,0,0,1,6,7
Hurricane,Dennis,16,2005-07-08T15:00:00Z,GULF 29N 87W,0,4,16,1,21
Hurricane,Dennis,16,2005-07-08T15:00:00Z,CHARLESTON SC,0,0,0,3,3
Hurricane,Dennis,16,2005-07-08T15:00:00Z,GULF 28N 89W,0,1,11,3,15
Hurricane,Dennis,16,2005-07-08T15:00:00Z,KEY WEST FL,55,0,0,0,55
Hurricane,Dennis,16,2005-07-08T15:00:00Z,GULF 28N 91W,0,0,3,5,8
Hurricane,Dennis,16,2005-07-08T15:00:00Z,MARCO ISLAND FL,25,3,0,1,29
Hurricane,Dennis,16,2005-07-08T15:00:00Z,GULF 28N 93W,0,0,0,3,3
Hurricane,Dennis,16,2005-07-08T15:00:00Z,FT MYERS FL,15,9,0,1,25
Hurricane,Dennis,17,2005-07-08T21:00:00Z,25.7N  84.4W,49,0,0,0,49
Hurricane,Dennis,17,2005-07-08T21:00:00Z,VENICE FL,27,2,0,0,29
Hurricane,Dennis,17,2005-07-08T21:00:00Z,27.8N  85.6W,8,24,1,0,33
Hurricane,Dennis,17,2005-07-08T21:00:00Z,TAMPA FL,11,11,0,1,23
Hurricane,Dennis,17,2005-07-08T21:00:00Z,30.0N  86.7W,0,11,12,1,24
Hurricane,Dennis,17,2005-07-08T21:00:00Z,CEDAR KEY FL,2,17,2,0,21
Hurricane,Dennis,17,2005-07-08T21:00:00Z,MUCF 221N 805W,99,0,0,0,99
Hurricane,Dennis,17,2005-07-08T21:00:00Z,ST MARKS FL,0,13,8,1,22
Hurricane,Dennis,17,2005-07-08T21:00:00Z,MUSN 216N 826W,2,0,0,0,2
Hurricane,Dennis,17,2005-07-08T21:00:00Z,APALACHICOLA FL,0,20,5,1,26
Hurricane,Dennis,17,2005-07-08T21:00:00Z,MUHA 230N 824W,84,0,0,0,84
Hurricane,Dennis,17,2005-07-08T21:00:00Z,PANAMA CITY FL,0,15,9,1,25
Hurricane,Dennis,17,2005-07-08T21:00:00Z,MARATHON FL,54,0,0,0,54
Hurricane,Dennis,17,2005-07-08T21:00:00Z,PENSACOLA FL,0,5,16,1,22
Hurricane,Dennis,17,2005-07-08T21:00:00Z,MIAMI FL,4,0,0,0,4
Hurricane,Dennis,17,2005-07-08T21:00:00Z,MOBILE AL,0,1,16,3,20
Hurricane,Dennis,17,2005-07-08T21:00:00Z,W PALM BEACH FL,1,1,0,0,2
Hurricane,Dennis,17,2005-07-08T21:00:00Z,GULFPORT MS,0,1,13,3,17
Hurricane,Dennis,17,2005-07-08T21:00:00Z,FT PIERCE FL,1,2,0,0,3
Hurricane,Dennis,17,2005-07-08T21:00:00Z,BURAS LA,0,1,11,2,14
Hurricane,Dennis,17,2005-07-08T21:00:00Z,COCOA BEACH FL,1,3,1,0,5
Hurricane,Dennis,17,2005-07-08T21:00:00Z,NEW ORLEANS LA,0,0,8,5,13
Hurricane,Dennis,17,2005-07-08T21:00:00Z,DAYTONA BEACH FL,0,5,3,0,8
Hurricane,Dennis,17,2005-07-08T21:00:00Z,NEW IBERIA LA,0,0,2,6,8
Hurricane,Dennis,17,2005-07-08T21:00:00Z,JACKSONVILLE FL,0,3,6,1,10
Hurricane,Dennis,17,2005-07-08T21:00:00Z,PORT ARTHUR TX,0,0,0,3,3
Hurricane,Dennis,17,2005-07-08T21:00:00Z,SAVANNAH GA,0,0,3,4,7
Hurricane,Dennis,17,2005-07-08T21:00:00Z,GULF 29N 85W,1,26,1,1,29
Hurricane,Dennis,17,2005-07-08T21:00:00Z,CHARLESTON SC,0,0,1,2,3
Hurricane,Dennis,17,2005-07-08T21:00:00Z,GULF 29N 87W,0,19,5,1,25
Hurricane,Dennis,17,2005-07-08T21:00:00Z,KEY WEST FL,73,0,0,0,73
Hurricane,Dennis,17,2005-07-08T21:00:00Z,GULF 28N 89W,0,6,6,1,13
Hurricane,Dennis,17,2005-07-08T21:00:00Z,MARCO ISLAND FL,33,1,0,0,34
Hurricane,Dennis,17,2005-07-08T21:00:00Z,GULF 28N 91W,0,0,3,2,5
Hurricane,Dennis,17,2005-07-08T21:00:00Z,FT MYERS FL,26,1,0,0,27
Hurricane,Dennis,18,2005-07-09T03:00:00Z,26.3N  84.9W,48,0,0,0,48
Hurricane,Dennis,18,2005-07-09T03:00:00Z,CEDAR KEY FL,3,16,1,0,20
Hurricane,Dennis,18,2005-07-09T03:00:00Z,28.5N  86.2W,5,26,0,1,32
Hurricane,Dennis,18,2005-07-09T03:00:00Z,ST MARKS FL,0,18,4,0,22
Hurricane,Dennis,18,2005-07-09T03:00:00Z,30.9N  87.5W,0,9,14,1,24
Hurricane,Dennis,18,2005-07-09T03:00:00Z,APALACHICOLA FL,1,24,2,0,27
Hurricane,Dennis,18,2005-07-09T03:00:00Z,MUHA 230N 824W,99,0,0,0,99
Hurricane,Dennis,18,2005-07-09T03:00:00Z,PANAMA CITY FL,0,23,4,0,27
Hurricane,Dennis,18,2005-07-09T03:00:00Z,MARATHON FL,33,0,0,0,33
Hurricane,Dennis,18,2005-07-09T03:00:00Z,PENSACOLA FL,0,14,11,0,25
Hurricane,Dennis,18,2005-07-09T03:00:00Z,COCOA BEACH FL,0,2,1,0,3
Hurricane,Dennis,18,2005-07-09T03:00:00Z,MOBILE AL,0,7,14,1,22
Hurricane,Dennis,18,2005-07-09T03:00:00Z,DAYTONA BEACH FL,0,4,1,1,6
Hurricane,Dennis,18,2005-07-09T03:00:00Z,GULFPORT MS,0,5,13,1,19
Hurricane,Dennis,18,2005-07-09T03:00:00Z,JACKSONVILLE FL,0,3,4,1,8
Hurricane,Dennis,18,2005-07-09T03:00:00Z,BURAS LA,0,5,9,1,15
Hurricane,Dennis,18,2005-07-09T03:00:00Z,SAVANNAH GA,0,0,2,3,5
Hurricane,Dennis,18,2005-07-09T03:00:00Z,NEW ORLEANS LA,0,2,9,2,13
Hurricane,Dennis,18,2005-07-09T03:00:00Z,CHARLESTON SC,0,0,0,2,2
Hurricane,Dennis,18,2005-07-09T03:00:00Z,NEW IBERIA LA,0,0,4,3,7
Hurricane,Dennis,18,2005-07-09T03:00:00Z,KEY WEST FL,68,0,0,0,68
Hurricane,Dennis,18,2005-07-09T03:00:00Z,PORT ARTHUR TX,0,0,0,2,2
Hurricane,Dennis,18,2005-07-09T03:00:00Z,MARCO ISLAND FL,25,1,0,0,26
Hurricane,Dennis,18,2005-07-09T03:00:00Z,GULF 29N 85W,4,26,1,0,31
Hurricane,Dennis,18,2005-07-09T03:00:00Z,FT MYERS FL,22,1,0,0,23
Hurricane,Dennis,18,2005-07-09T03:00:00Z,GULF 29N 87W,1,25,1,0,27
Hurricane,Dennis,18,2005-07-09T03:00:00Z,VENICE FL,27,1,0,0,28
Hurricane,Dennis,18,2005-07-09T03:00:00Z,GULF 28N 89W,0,10,3,0,13
Hurricane,Dennis,18,2005-07-09T03:00:00Z,TAMPA FL,14,7,0,0,21
Hurricane,Dennis,18,2005-07-09T03:00:00Z,GULF 28N 91W,0,1,2,1,4
Hurricane,Dennis,19,2005-07-09T09:00:00Z,27.5N  85.7W,50,0,0,0,50
Hurricane,Dennis,19,2005-07-09T09:00:00Z,CEDAR KEY FL,11,7,0,0,18
Hurricane,Dennis,19,2005-07-09T09:00:00Z,29.8N  87.1W,4,30,0,0,34
Hurricane,Dennis,19,2005-07-09T09:00:00Z,ST MARKS FL,4,20,0,0,24
Hurricane,Dennis,19,2005-07-09T09:00:00Z,32.5N  88.5W,0,4,21,0,25
Hurricane,Dennis,19,2005-07-09T09:00:00Z,APALACHICOLA FL,14,19,0,0,33
Hurricane,Dennis,19,2005-07-09T09:00:00Z,MUHA 230N 824W,99,0,0,0,99
Hurricane,Dennis,19,2005-07-09T09:00:00Z,PANAMA CITY FL,8,26,0,0,34
Hurricane,Dennis,19,2005-07-09T09:00:00Z,MARATHON FL,15,0,0,0,15
Hurricane,Dennis,19,2005-07-09T09:00:00Z,PENSACOLA FL,1,30,1,0,32
Hurricane,Dennis,19,2005-07-09T09:00:00Z,DAYTONA BEACH FL,0,1,0,1,2
Hurricane,Dennis,19,2005-07-09T09:00:00Z,MOBILE AL,0,24,4,0,28
Hurricane,Dennis,19,2005-07-09T09:00:00Z,JACKSONVILLE FL,0,2,1,1,4
Hurricane,Dennis,19,2005-07-09T09:00:00Z,GULFPORT MS,0,19,5,0,24
Hurricane,Dennis,19,2005-07-09T09:00:00Z,SAVANNAH GA,0,0,1,3,4
Hurricane,Dennis,19,2005-07-09T09:00:00Z,BURAS LA,0,15,2,0,17
Hurricane,Dennis,19,2005-07-09T09:00:00Z,CHARLESTON SC,0,0,0,2,2
Hurricane,Dennis,19,2005-07-09T09:00:00Z,NEW ORLEANS LA,0,9,5,0,14
Hurricane,Dennis,19,2005-07-09T09:00:00Z,KEY WEST FL,75,0,0,0,75
Hurricane,Dennis,19,2005-07-09T09:00:00Z,NEW IBERIA LA,0,1,3,1,5
Hurricane,Dennis,19,2005-07-09T09:00:00Z,MARCO ISLAND FL,19,0,0,0,19
Hurricane,Dennis,19,2005-07-09T09:00:00Z,GULF 29N 85W,31,8,0,0,39
Hurricane,Dennis,19,2005-07-09T09:00:00Z,FT MYERS FL,17,0,0,0,17
Hurricane,Dennis,19,2005-07-09T09:00:00Z,GULF 29N 87W,17,20,0,0,37
Hurricane,Dennis,19,2005-07-09T09:00:00Z,VENICE FL,28,0,0,1,29
Hurricane,Dennis,19,2005-07-09T09:00:00Z,GULF 28N 89W,3,12,0,0,15
Hurricane,Dennis,19,2005-07-09T09:00:00Z,TAMPA FL,16,1,0,0,17
Hurricane,Dennis,19,2005-07-09T09:00:00Z,GULF 28N 91W,0,1,1,0,2
Hurricane,Dennis,20,2005-07-09T15:00:00Z,28.7N  86.4W,49,0,0,0,49
Hurricane,Dennis,20,2005-07-09T15:00:00Z,APALACHICOLA FL,34,2,0,1,37
Hurricane,Dennis,20,2005-07-09T15:00:00Z,31.2N  87.7W,3,29,0,0,32
Hurricane,Dennis,20,2005-07-09T15:00:00Z,PANAMA CITY FL,32,6,0,0,38
Hurricane,Dennis,20,2005-07-09T15:00:00Z,33.6N  89.0W,0,9,15,0,24
Hurricane,Dennis,20,2005-07-09T15:00:00Z,PENSACOLA FL,15,21,0,0,36
Hurricane,Dennis,20,2005-07-09T15:00:00Z,JACKSONVILLE FL,0,1,1,0,2
Hurricane,Dennis,20,2005-07-09T15:00:00Z,MOBILE AL,4,26,0,0,30
Hurricane,Dennis,20,2005-07-09T15:00:00Z,SAVANNAH GA,0,0,1,1,2
Hurricane,Dennis,20,2005-07-09T15:00:00Z,GULFPORT MS,3,21,0,0,24
Hurricane,Dennis,20,2005-07-09T15:00:00Z,KEY WEST FL,24,0,0,0,24
Hurricane,Dennis,20,2005-07-09T15:00:00Z,BURAS LA,4,12,0,0,16
Hurricane,Dennis,20,2005-07-09T15:00:00Z,MARCO ISLAND FL,2,0,0,0,2
Hurricane,Dennis,20,2005-07-09T15:00:00Z,NEW ORLEANS LA,1,10,1,0,12
Hurricane,Dennis,20,2005-07-09T15:00:00Z,FT MYERS FL,3,0,0,0,3
Hurricane,Dennis,20,2005-07-09T15:00:00Z,NEW IBERIA LA,0,2,0,1,3
Hurricane,Dennis,20,2005-07-09T15:00:00Z,VENICE FL,12,0,0,0,12
Hurricane,Dennis,20,2005-07-09T15:00:00Z,GULF 29N 85W,44,0,0,0,44
Hurricane,Dennis,20,2005-07-09T15:00:00Z,TAMPA FL,7,0,0,0,7
Hurricane,Dennis,20,2005-07-09T15:00:00Z,GULF 29N 87W,42,1,0,1,44
Hurricane,Dennis,20,2005-07-09T15:00:00Z,CEDAR KEY FL,11,2,0,0,13
Hurricane,Dennis,20,2005-07-09T15:00:00Z,GULF 28N 89W,11,3,0,0,14
Hurricane,Dennis,20,2005-07-09T15:00:00Z,ST MARKS FL,17,7,0,0,24
Hurricane,Dennis,21,2005-07-09T21:00:00Z,29.9N  87.2W,37,1,0,0,38
Hurricane,Dennis,21,2005-07-09T21:00:00Z,PENSACOLA FL,31,4,0,0,35
Hurricane,Dennis,21,2005-07-09T21:00:00Z,32.3N  88.4W,8,23,1,0,32
Hurricane,Dennis,21,2005-07-09T21:00:00Z,MOBILE AL,27,6,0,0,33
Hurricane,Dennis,21,2005-07-09T21:00:00Z,34.2N  89.3W,0,22,3,1,26
Hurricane,Dennis,21,2005-07-09T21:00:00Z,GULFPORT MS,22,6,0,0,28
Hurricane,Dennis,21,2005-07-09T21:00:00Z,SAVANNAH GA,0,0,0,2,2
Hurricane,Dennis,21,2005-07-09T21:00:00Z,BURAS LA,15,2,1,0,18
Hurricane,Dennis,21,2005-07-09T21:00:00Z,VENICE FL,2,0,0,0,2
Hurricane,Dennis,21,2005-07-09T21:00:00Z,NEW ORLEANS LA,9,5,1,0,15
Hurricane,Dennis,21,2005-07-09T21:00:00Z,TAMPA FL,2,0,0,1,3
Hurricane,Dennis,21,2005-07-09T21:00:00Z,NEW IBERIA LA,1,1,1,2,5
Hurricane,Dennis,21,2005-07-09T21:00:00Z,CEDAR KEY FL,3,2,0,1,6
Hurricane,Dennis,21,2005-07-09T21:00:00Z,GULF 29N 85W,32,0,0,0,32
Hurricane,Dennis,21,2005-07-09T21:00:00Z,ST MARKS FL,8,5,1,0,14
Hurricane,Dennis,21,2005-07-09T21:00:00Z,GULF 29N 87W,45,0,0,0,45
Hurricane,Dennis,21,2005-07-09T21:00:00Z,APALACHICOLA FL,23,2,0,0,25
Hurricane,Dennis,21,2005-07-09T21:00:00Z,GULF 28N 89W,10,1,0,0,11
Hurricane,Dennis,21,2005-07-09T21:00:00Z,PANAMA CITY FL,27,2,0,0,29
Hurricane,Dennis,22,2005-07-09T23:00:00Z,29.9N  87.2W,38,0,0,0,38
Hurricane,Dennis,22,2005-07-09T23:00:00Z,PENSACOLA FL,32,3,0,0,35
Hurricane,Dennis,22,2005-07-09T23:00:00Z,32.3N  88.4W,8,22,1,0,31
Hurricane,Dennis,22,2005-07-09T23:00:00Z,MOBILE AL,27,6,0,0,33
Hurricane,Dennis,22,2005-07-09T23:00:00Z,34.2N  89.3W,0,20,4,1,25
Hurricane,Dennis,22,2005-07-09T23:00:00Z,GULFPORT MS,22,5,0,1,28
Hurricane,Dennis,22,2005-07-09T23:00:00Z,SAVANNAH GA,0,0,0,2,2
Hurricane,Dennis,22,2005-07-09T23:00:00Z,BURAS LA,13,3,1,0,17
Hurricane,Dennis,22,2005-07-09T23:00:00Z,VENICE FL,2,0,0,0,2
Hurricane,Dennis,22,2005-07-09T23:00:00Z,NEW ORLEANS LA,7,7,0,1,15
Hurricane,Dennis,22,2005-07-09T23:00:00Z,TAMPA FL,2,0,0,1,3
Hurricane,Dennis,22,2005-07-09T23:00:00Z,NEW IBERIA LA,1,1,1,2,5
Hurricane,Dennis,22,2005-07-09T23:00:00Z,CEDAR KEY FL,3,2,0,1,6
Hurricane,Dennis,22,2005-07-09T23:00:00Z,PORT ARTHUR TX,0,0,0,2,2
Hurricane,Dennis,22,2005-07-09T23:00:00Z,ST MARKS FL,8,6,0,0,14
Hurricane,Dennis,22,2005-07-09T23:00:00Z,GULF 29N 85W,33,0,0,0,33
Hurricane,Dennis,22,2005-07-09T23:00:00Z,APALACHICOLA FL,24,2,0,0,26
Hurricane,Dennis,22,2005-07-09T23:00:00Z,GULF 29N 87W,46,0,0,0,46
Hurricane,Dennis,22,2005-07-09T23:00:00Z,PANAMA CITY FL,28,2,0,0,30
Hurricane,Dennis,22,2005-07-09T23:00:00Z,GULF 28N 89W,8,2,0,0,10
Hurricane,Dennis,23,2005-07-10T03:00:00Z,30.6N  87.9W,38,0,0,0,38
Hurricane,Dennis,23,2005-07-10T03:00:00Z,BURAS LA,23,0,0,1,24
Hurricane,Dennis,23,2005-07-10T03:00:00Z,32.9N  89.0W,13,17,0,1,31
Hurricane,Dennis,23,2005-07-10T03:00:00Z,NEW ORLEANS LA,16,3,0,1,20
Hurricane,Dennis,23,2005-07-10T03:00:00Z,34.8N  89.8W,1,21,3,1,26
Hurricane,Dennis,23,2005-07-10T03:00:00Z,NEW IBERIA LA,2,3,2,1,8
Hurricane,Dennis,23,2005-07-10T03:00:00Z,ST MARKS FL,5,2,0,1,8
Hurricane,Dennis,23,2005-07-10T03:00:00Z,PORT ARTHUR TX,0,0,1,1,2
Hurricane,Dennis,23,2005-07-10T03:00:00Z,APALACHICOLA FL,18,1,0,0,19
Hurricane,Dennis,23,2005-07-10T03:00:00Z,GULF 29N 85W,26,0,0,0,26
Hurricane,Dennis,23,2005-07-10T03:00:00Z,PANAMA CITY FL,25,1,0,0,26
Hurricane,Dennis,23,2005-07-10T03:00:00Z,GULF 29N 87W,59,0,0,0,59
Hurricane,Dennis,23,2005-07-10T03:00:00Z,PENSACOLA FL,38,0,0,0,38
Hurricane,Dennis,23,2005-07-10T03:00:00Z,GULF 28N 89W,15,1,0,0,16
Hurricane,Dennis,23,2005-07-10T03:00:00Z,MOBILE AL,37,0,0,0,37
Hurricane,Dennis,23,2005-07-10T03:00:00Z,GULF 28N 91W,1,0,0,1,2
Hurricane,Dennis,23,2005-07-10T03:00:00Z,GULFPORT MS,32,1,0,0,33
Hurricane,Dennis,24,2005-07-10T09:00:00Z,32.0N  89.0W,38,0,0,0,38
Hurricane,Dennis,24,2005-07-10T09:00:00Z,GULFPORT MS,42,0,0,0,42
Hurricane,Dennis,24,2005-07-10T09:00:00Z,34.5N  90.0W,11,19,0,0,30
Hurricane,Dennis,24,2005-07-10T09:00:00Z,BURAS LA,17,1,0,0,18
Hurricane,Dennis,24,2005-07-10T09:00:00Z,36.5N  90.0W,1,17,4,2,24
Hurricane,Dennis,24,2005-07-10T09:00:00Z,NEW ORLEANS LA,16,1,0,0,17
Hurricane,Dennis,24,2005-07-10T09:00:00Z,ST MARKS FL,2,0,0,1,3
Hurricane,Dennis,24,2005-07-10T09:00:00Z,NEW IBERIA LA,2,0,1,0,3
Hurricane,Dennis,24,2005-07-10T09:00:00Z,APALACHICOLA FL,14,1,0,0,15
Hurricane,Dennis,24,2005-07-10T09:00:00Z,GULF 29N 85W,27,0,0,1,28
Hurricane,Dennis,24,2005-07-10T09:00:00Z,PANAMA CITY FL,27,0,0,0,27
Hurricane,Dennis,24,2005-07-10T09:00:00Z,GULF 29N 87W,77,0,1,0,78
Hurricane,Dennis,24,2005-07-10T09:00:00Z,PENSACOLA FL,50,0,0,0,50
Hurricane,Dennis,24,2005-07-10T09:00:00Z,GULF 28N 89W,2,0,0,0,2
Hurricane,Dennis,24,2005-07-10T09:00:00Z,MOBILE AL,50,0,0,0,50
Hurricane,Dennis,25,2005-07-10T15:00:00Z,33.9N  88.8W,45,1,0,0,46
Hurricane,Dennis,25,2005-07-10T15:00:00Z,MOBILE AL,73,0,0,0,73
Hurricane,Dennis,25,2005-07-10T15:00:00Z,35.8N  89.3W,17,14,1,0,32
Hurricane,Dennis,25,2005-07-10T15:00:00Z,GULFPORT MS,11,0,0,1,12
Hurricane,Dennis,25,2005-07-10T15:00:00Z,37.5N  89.0W,1,17,5,2,25
Hurricane,Dennis,25,2005-07-10T15:00:00Z,NEW ORLEANS LA,0,0,1,1,2
Hurricane,Dennis,25,2005-07-10T15:00:00Z,APALACHICOLA FL,2,0,0,1,3
Hurricane,Dennis,25,2005-07-10T15:00:00Z,GULF 29N 85W,11,0,0,0,11
Hurricane,Dennis,25,2005-07-10T15:00:00Z,PANAMA CITY FL,28,0,0,0,28
Hurricane,Dennis,25,2005-07-10T15:00:00Z,GULF 29N 87W,99,0,0,0,99
Hurricane,Dennis,25,2005-07-10T15:00:00Z,PENSACOLA FL,94,0,0,0,94
Hurricane,Dennis,26,2005-07-10T21:00:00Z,35.2N  89.2W,53,0,0,0,53
Hurricane,Dennis,26,2005-07-10T21:00:00Z,PENSACOLA FL,99,0,0,0,99
Hurricane,Dennis,26,2005-07-10T21:00:00Z,37.0N  89.5W,32,3,1,0,36
Hurricane,Dennis,26,2005-07-10T21:00:00Z,MOBILE AL,99,0,0,0,99
Hurricane,Dennis,26,2005-07-10T21:00:00Z,37.8N  89.2W,19,11,0,1,31
Hurricane,Dennis,26,2005-07-10T21:00:00Z,GULFPORT MS,2,0,1,1,4
Hurricane,Dennis,26,2005-07-10T21:00:00Z,PANAMA CITY FL,39,0,0,0,39
Hurricane,Dennis,26,2005-07-10T21:00:00Z,GULF 29N 87W,99,0,0,0,99
Tropical Storm,Dennis,27,2005-07-11T03:00:00Z,36.4N  89.4W,41,0,0,0,41
Tropical Storm,Dennis,27,2005-07-11T03:00:00Z,38.4N  89.0W,17,4,1,1,23
Tropical Storm,Dennis,27,2005-07-11T03:00:00Z,37.7N  89.4W,26,1,1,0,28
Tropical Storm,Dennis,27,2005-07-11T03:00:00Z,PENSACOLA FL,2,0,0,0,2
Tropical Depression,Dennis,28,2005-07-11T09:00:00Z,36.9N  89.2W,35,0,0,0,35
Tropical Depression,Dennis,28,2005-07-11T09:00:00Z,CHARLESTON SC,0,0,0,2,2
Tropical Depression,Dennis,28,2005-07-11T09:00:00Z,37.9N  89.0W,24,1,0,1,26
Tropical Depression,Dennis,28,2005-07-11T09:00:00Z,MYRTLE BEACH SC,0,0,0,2,2
Tropical Depression,Dennis,28,2005-07-11T09:00:00Z,38.5N  88.5W,16,3,1,2,22
Tropical Depression,Five,1,2005-07-11T03:00:00Z,11.5N  46.7W,46,0,0,0,46
Tropical Depression,Five,1,2005-07-11T03:00:00Z,TDPR 153N 614W,0,0,0,10,10
Tropical Depression,Five,1,2005-07-11T03:00:00Z,12.1N  49.0W,17,16,0,0,33
Tropical Depression,Five,1,2005-07-11T03:00:00Z,80400 157N 636W,0,0,0,4,4
Tropical Depression,Five,1,2005-07-11T03:00:00Z,12.8N  51.7W,0,16,9,1,26
Tropical Depression,Five,1,2005-07-11T03:00:00Z,TFFR 163N 615W,0,0,0,10,10
Tropical Depression,Five,1,2005-07-11T03:00:00Z,TTPP 106N 614W,0,0,0,3,3
Tropical Depression,Five,1,2005-07-11T03:00:00Z,TAPA 171N 618W,0,0,0,9,9
Tropical Depression,Five,1,2005-07-11T03:00:00Z,TTPT 112N 608W,0,0,0,5,5
Tropical Depression,Five,1,2005-07-11T03:00:00Z,TKPK 173N 627W,0,0,0,7,7
Tropical Depression,Five,1,2005-07-11T03:00:00Z,TGPY 120N 618W,0,0,0,4,4
Tropical Depression,Five,1,2005-07-11T03:00:00Z,TNCM 181N 631W,0,0,0,6,6
Tropical Depression,Five,1,2005-07-11T03:00:00Z,TBPB 131N 595W,0,0,0,12,12
Tropical Depression,Five,1,2005-07-11T03:00:00Z,TISX 177N 648W,0,0,0,3,3
Tropical Depression,Five,1,2005-07-11T03:00:00Z,TVSV 131N 612W,0,0,0,7,7
Tropical Depression,Five,1,2005-07-11T03:00:00Z,TIST 183N 650W,0,0,0,2,2
Tropical Depression,Five,1,2005-07-11T03:00:00Z,TLPL 138N 610W,0,0,0,9,9
Tropical Depression,Five,1,2005-07-11T03:00:00Z,ST CROIX VI,0,0,0,3,3
Tropical Depression,Five,1,2005-07-11T03:00:00Z,TFFF 146N 610W,0,0,0,10,10
Tropical Depression,Five,1,2005-07-11T03:00:00Z,ST THOMAS VI,0,0,0,2,2
Tropical Depression,Five,2,2005-07-11T09:00:00Z,11.6N  48.0W,46,0,0,0,46
Tropical Depression,Five,2,2005-07-11T09:00:00Z,TFFR 163N 615W,0,0,0,15,15
Tropical Depression,Five,2,2005-07-11T09:00:00Z,12.1N  50.6W,11,22,0,0,33
Tropical Depression,Five,2,2005-07-11T09:00:00Z,TAPA 171N 618W,0,0,0,14,14
Tropical Depression,Five,2,2005-07-11T09:00:00Z,12.6N  53.5W,0,13,12,1,26
Tropical Depression,Five,2,2005-07-11T09:00:00Z,TKPK 173N 627W,0,0,0,12,12
Tropical Depression,Five,2,2005-07-11T09:00:00Z,SVMG 110N 640W,0,0,0,3,3
Tropical Depression,Five,2,2005-07-11T09:00:00Z,TNCM 181N 631W,0,0,0,11,11
Tropical Depression,Five,2,2005-07-11T09:00:00Z,TTPP 106N 614W,0,0,0,8,8
Tropical Depression,Five,2,2005-07-11T09:00:00Z,TISX 177N 648W,0,0,0,8,8
Tropical Depression,Five,2,2005-07-11T09:00:00Z,TTPT 112N 608W,0,0,0,11,11
Tropical Depression,Five,2,2005-07-11T09:00:00Z,TIST 183N 650W,0,0,0,7,7
Tropical Depression,Five,2,2005-07-11T09:00:00Z,TGPY 120N 618W,0,0,0,10,10
Tropical Depression,Five,2,2005-07-11T09:00:00Z,TJPS 180N 666W,0,0,0,4,4
Tropical Depression,Five,2,2005-07-11T09:00:00Z,TBPB 131N 595W,0,0,1,15,16
Tropical Depression,Five,2,2005-07-11T09:00:00Z,TJSJ 184N 661W,0,0,0,5,5
Tropical Depression,Five,2,2005-07-11T09:00:00Z,TVSV 131N 612W,0,0,0,13,13
Tropical Depression,Five,2,2005-07-11T09:00:00Z,ST CROIX VI,0,0,0,8,8
Tropical Depression,Five,2,2005-07-11T09:00:00Z,TLPL 138N 610W,0,0,0,15,15
Tropical Depression,Five,2,2005-07-11T09:00:00Z,ST THOMAS VI,0,0,0,7,7
Tropical Depression,Five,2,2005-07-11T09:00:00Z,TFFF 146N 610W,0,0,0,15,15
Tropical Depression,Five,2,2005-07-11T09:00:00Z,SAN JUAN PR,0,0,0,5,5
Tropical Depression,Five,2,2005-07-11T09:00:00Z,TDPR 153N 614W,0,0,0,15,15
Tropical Depression,Five,2,2005-07-11T09:00:00Z,PONCE PR,0,0,0,4,4
Tropical Depression,Five,2,2005-07-11T09:00:00Z,80400 157N 636W,0,0,0,10,10
Tropical Depression,Five,3,2005-07-11T15:00:00Z,10.8N  48.9W,47,0,0,0,47
Tropical Depression,Five,3,2005-07-11T15:00:00Z,TFFR 163N 615W,0,0,1,15,16
Tropical Depression,Five,3,2005-07-11T15:00:00Z,11.5N  52.0W,4,30,0,0,34
Tropical Depression,Five,3,2005-07-11T15:00:00Z,TAPA 171N 618W,0,0,1,14,15
Tropical Depression,Five,3,2005-07-11T15:00:00Z,12.2N  55.2W,0,10,16,0,26
Tropical Depression,Five,3,2005-07-11T15:00:00Z,TKPK 173N 627W,0,0,0,14,14
Tropical Depression,Five,3,2005-07-11T15:00:00Z,SVMG 110N 640W,0,0,0,7,7
Tropical Depression,Five,3,2005-07-11T15:00:00Z,TNCM 181N 631W,0,0,0,12,12
Tropical Depression,Five,3,2005-07-11T15:00:00Z,TTPP 106N 614W,0,0,0,11,11
Tropical Depression,Five,3,2005-07-11T15:00:00Z,TISX 177N 648W,0,0,0,10,10
Tropical Depression,Five,3,2005-07-11T15:00:00Z,TTPT 112N 608W,0,0,1,13,14
Tropical Depression,Five,3,2005-07-11T15:00:00Z,TIST 183N 650W,0,0,0,9,9
Tropical Depression,Five,3,2005-07-11T15:00:00Z,TGPY 120N 618W,0,0,0,13,13
Tropical Depression,Five,3,2005-07-11T15:00:00Z,TJPS 180N 666W,0,0,0,6,6
Tropical Depression,Five,3,2005-07-11T15:00:00Z,TBPB 131N 595W,0,0,7,12,19
Tropical Depression,Five,3,2005-07-11T15:00:00Z,TJSJ 184N 661W,0,0,0,7,7
Tropical Depression,Five,3,2005-07-11T15:00:00Z,TVSV 131N 612W,0,0,1,15,16
Tropical Depression,Five,3,2005-07-11T15:00:00Z,ST CROIX VI,0,0,0,10,10
Tropical Depression,Five,3,2005-07-11T15:00:00Z,TLPL 138N 610W,0,0,2,15,17
Tropical Depression,Five,3,2005-07-11T15:00:00Z,ST THOMAS VI,0,0,0,9,9
Tropical Depression,Five,3,2005-07-11T15:00:00Z,TFFF 146N 610W,0,0,2,15,17
Tropical Depression,Five,3,2005-07-11T15:00:00Z,SAN JUAN PR,0,0,0,7,7
Tropical Depression,Five,3,2005-07-11T15:00:00Z,TDPR 153N 614W,0,0,1,16,17
Tropical Depression,Five,3,2005-07-11T15:00:00Z,PONCE PR,0,0,0,6,6
Tropical Depression,Five,3,2005-07-11T15:00:00Z,80400 157N 636W,0,0,0,13,13
Tropical Depression,Five,4,2005-07-11T21:00:00Z,11.6N  50.3W,47,1,0,0,48
Tropical Depression,Five,4,2005-07-11T21:00:00Z,TFFR 163N 615W,0,0,0,22,22
Tropical Depression,Five,4,2005-07-11T21:00:00Z,12.4N  53.2W,2,31,1,0,34
Tropical Depression,Five,4,2005-07-11T21:00:00Z,TAPA 171N 618W,0,0,0,20,20
Tropical Depression,Five,4,2005-07-11T21:00:00Z,13.2N  56.5W,0,3,23,1,27
Tropical Depression,Five,4,2005-07-11T21:00:00Z,TKPK 173N 627W,0,0,0,19,19
Tropical Depression,Five,4,2005-07-11T21:00:00Z,SVMG 110N 640W,0,0,0,3,3
Tropical Depression,Five,4,2005-07-11T21:00:00Z,TNCM 181N 631W,0,0,0,16,16
Tropical Depression,Five,4,2005-07-11T21:00:00Z,TTPP 106N 614W,0,0,0,6,6
Tropical Depression,Five,4,2005-07-11T21:00:00Z,TISX 177N 648W,0,0,0,15,15
Tropical Depression,Five,4,2005-07-11T21:00:00Z,TTPT 112N 608W,0,0,1,9,10
Tropical Depression,Five,4,2005-07-11T21:00:00Z,TIST 183N 650W,0,0,0,12,12
Tropical Depression,Five,4,2005-07-11T21:00:00Z,TGPY 120N 618W,0,0,0,13,13
Tropical Depression,Five,4,2005-07-11T21:00:00Z,TJPS 180N 666W,0,0,0,9,9
Tropical Depression,Five,4,2005-07-11T21:00:00Z,TBPB 131N 595W,0,0,8,13,21
Tropical Depression,Five,4,2005-07-11T21:00:00Z,TJSJ 184N 661W,0,0,0,9,9
Tropical Depression,Five,4,2005-07-11T21:00:00Z,TVSV 131N 612W,0,0,1,17,18
Tropical Depression,Five,4,2005-07-11T21:00:00Z,ST CROIX VI,0,0,0,15,15
Tropical Depression,Five,4,2005-07-11T21:00:00Z,TLPL 138N 610W,0,0,2,19,21
Tropical Depression,Five,4,2005-07-11T21:00:00Z,ST THOMAS VI,0,0,0,12,12
Tropical Depression,Five,4,2005-07-11T21:00:00Z,TFFF 146N 610W,0,0,1,22,23
Tropical Depression,Five,4,2005-07-11T21:00:00Z,SAN JUAN PR,0,0,0,9,9
Tropical Depression,Five,4,2005-07-11T21:00:00Z,TDPR 153N 614W,0,0,1,22,23
Tropical Depression,Five,4,2005-07-11T21:00:00Z,PONCE PR,0,0,0,9,9
Tropical Depression,Five,4,2005-07-11T21:00:00Z,80400 157N 636W,0,0,0,20,20
Tropical Storm,Emily,5,2005-07-12T03:00:00Z,12.6N  51.5W,49,1,0,0,50
Tropical Storm,Emily,5,2005-07-12T03:00:00Z,TAPA 171N 618W,0,0,2,20,22
Tropical Storm,Emily,5,2005-07-12T03:00:00Z,13.5N  54.7W,1,33,1,0,35
Tropical Storm,Emily,5,2005-07-12T03:00:00Z,TKPK 173N 627W,0,0,1,20,21
Tropical Storm,Emily,5,2005-07-12T03:00:00Z,14.5N  58.0W,0,3,23,1,27
Tropical Storm,Emily,5,2005-07-12T03:00:00Z,TNCM 181N 631W,0,0,0,20,20
Tropical Storm,Emily,5,2005-07-12T03:00:00Z,TTPP 106N 614W,0,0,0,2,2
Tropical Storm,Emily,5,2005-07-12T03:00:00Z,TISX 177N 648W,0,0,0,19,19
Tropical Storm,Emily,5,2005-07-12T03:00:00Z,TTPT 112N 608W,0,0,2,2,4
Tropical Storm,Emily,5,2005-07-12T03:00:00Z,TIST 183N 650W,0,0,0,18,18
Tropical Storm,Emily,5,2005-07-12T03:00:00Z,TGPY 120N 618W,0,0,2,5,7
Tropical Storm,Emily,5,2005-07-12T03:00:00Z,TJPS 180N 666W,0,0,0,15,15
Tropical Storm,Emily,5,2005-07-12T03:00:00Z,TBPB 131N 595W,0,0,14,4,18
Tropical Storm,Emily,5,2005-07-12T03:00:00Z,MDSD 185N 697W,0,0,0,4,4
Tropical Storm,Emily,5,2005-07-12T03:00:00Z,TVSV 131N 612W,0,0,6,8,14
Tropical Storm,Emily,5,2005-07-12T03:00:00Z,TJSJ 184N 661W,0,0,0,16,16
Tropical Storm,Emily,5,2005-07-12T03:00:00Z,TLPL 138N 610W,0,0,8,10,18
Tropical Storm,Emily,5,2005-07-12T03:00:00Z,MDPP 198N 707W,0,0,0,2,2
Tropical Storm,Emily,5,2005-07-12T03:00:00Z,TFFF 146N 610W,0,0,9,12,21
Tropical Storm,Emily,5,2005-07-12T03:00:00Z,ST CROIX VI,0,0,0,19,19
Tropical Storm,Emily,5,2005-07-12T03:00:00Z,TDPR 153N 614W,0,0,6,16,22
Tropical Storm,Emily,5,2005-07-12T03:00:00Z,ST THOMAS VI,0,0,0,18,18
Tropical Storm,Emily,5,2005-07-12T03:00:00Z,80400 157N 636W,0,0,0,19,19
Tropical Storm,Emily,5,2005-07-12T03:00:00Z,SAN JUAN PR,0,0,0,16,16
Tropical Storm,Emily,5,2005-07-12T03:00:00Z,TFFR 163N 615W,0,0,4,19,23
Tropical Storm,Emily,5,2005-07-12T03:00:00Z,PONCE PR,0,0,0,15,15
Tropical Storm,Emily,6,2005-07-12T09:00:00Z,12.9N  53.5W,52,0,0,0,52
Tropical Storm,Emily,6,2005-07-12T09:00:00Z,TKPK 173N 627W,0,0,3,19,22
Tropical Storm,Emily,6,2005-07-12T09:00:00Z,13.6N  56.4W,1,32,1,0,34
Tropical Storm,Emily,6,2005-07-12T09:00:00Z,TNCM 181N 631W,0,0,1,19,20
Tropical Storm,Emily,6,2005-07-12T09:00:00Z,14.4N  59.6W,0,4,22,1,27
Tropical Storm,Emily,6,2005-07-12T09:00:00Z,TISX 177N 648W,0,0,0,21,21
Tropical Storm,Emily,6,2005-07-12T09:00:00Z,SVMG 110N 640W,0,0,0,3,3
Tropical Storm,Emily,6,2005-07-12T09:00:00Z,TIST 183N 650W,0,0,0,20,20
Tropical Storm,Emily,6,2005-07-12T09:00:00Z,TTPP 106N 614W,0,0,2,1,3
Tropical Storm,Emily,6,2005-07-12T09:00:00Z,TJPS 180N 666W,0,0,0,20,20
Tropical Storm,Emily,6,2005-07-12T09:00:00Z,TTPT 112N 608W,0,0,4,3,7
Tropical Storm,Emily,6,2005-07-12T09:00:00Z,MDSD 185N 697W,0,0,0,10,10
Tropical Storm,Emily,6,2005-07-12T09:00:00Z,TGPY 120N 618W,0,0,6,4,10
Tropical Storm,Emily,6,2005-07-12T09:00:00Z,MDCB 176N 714W,0,0,0,4,4
Tropical Storm,Emily,6,2005-07-12T09:00:00Z,TBPB 131N 595W,0,5,17,0,22
Tropical Storm,Emily,6,2005-07-12T09:00:00Z,MTPP 186N 724W,0,0,0,2,2
Tropical Storm,Emily,6,2005-07-12T09:00:00Z,TVSV 131N 612W,0,0,14,4,18
Tropical Storm,Emily,6,2005-07-12T09:00:00Z,TJSJ 184N 661W,0,0,0,19,19
Tropical Storm,Emily,6,2005-07-12T09:00:00Z,TLPL 138N 610W,0,0,18,4,22
Tropical Storm,Emily,6,2005-07-12T09:00:00Z,MDPP 198N 707W,0,0,0,5,5
Tropical Storm,Emily,6,2005-07-12T09:00:00Z,TFFF 146N 610W,0,0,20,4,24
Tropical Storm,Emily,6,2005-07-12T09:00:00Z,MBJT 215N 712W,0,0,0,2,2
Tropical Storm,Emily,6,2005-07-12T09:00:00Z,TDPR 153N 614W,0,0,17,8,25
Tropical Storm,Emily,6,2005-07-12T09:00:00Z,ST CROIX VI,0,0,0,21,21
Tropical Storm,Emily,6,2005-07-12T09:00:00Z,80400 157N 636W,0,0,3,20,23
Tropical Storm,Emily,6,2005-07-12T09:00:00Z,ST THOMAS VI,0,0,0,20,20
Tropical Storm,Emily,6,2005-07-12T09:00:00Z,TFFR 163N 615W,0,0,12,12,24
Tropical Storm,Emily,6,2005-07-12T09:00:00Z,SAN JUAN PR,0,0,0,19,19
Tropical Storm,Emily,6,2005-07-12T09:00:00Z,TAPA 171N 618W,0,0,7,15,22
Tropical Storm,Emily,6,2005-07-12T09:00:00Z,PONCE PR,0,0,0,20,20
Tropical Storm,Emily,7,2005-07-12T15:00:00Z,11.9N  57.0W,49,1,0,0,50
Tropical Storm,Emily,7,2005-07-12T15:00:00Z,TKPK 173N 627W,0,0,11,5,16
Tropical Storm,Emily,7,2005-07-12T15:00:00Z,12.8N  60.2W,1,33,1,0,35
Tropical Storm,Emily,7,2005-07-12T15:00:00Z,TNCM 181N 631W,0,0,5,8,13
Tropical Storm,Emily,7,2005-07-12T15:00:00Z,14.0N  63.5W,0,2,24,1,27
Tropical Storm,Emily,7,2005-07-12T15:00:00Z,TISX 177N 648W,0,0,4,13,17
Tropical Storm,Emily,7,2005-07-12T15:00:00Z,SKPG 125N 717W,0,0,0,4,4
Tropical Storm,Emily,7,2005-07-12T15:00:00Z,TIST 183N 650W,0,0,2,13,15
Tropical Storm,Emily,7,2005-07-12T15:00:00Z,TNCC 122N 690W,0,0,0,8,8
Tropical Storm,Emily,7,2005-07-12T15:00:00Z,TJPS 180N 666W,0,0,1,17,18
Tropical Storm,Emily,7,2005-07-12T15:00:00Z,SVMG 110N 640W,0,1,8,1,10
Tropical Storm,Emily,7,2005-07-12T15:00:00Z,MDSD 185N 697W,0,0,0,16,16
Tropical Storm,Emily,7,2005-07-12T15:00:00Z,TTPP 106N 614W,0,9,4,0,13
Tropical Storm,Emily,7,2005-07-12T15:00:00Z,MDCB 176N 714W,0,0,0,16,16
Tropical Storm,Emily,7,2005-07-12T15:00:00Z,TTPT 112N 608W,0,19,2,1,22
Tropical Storm,Emily,7,2005-07-12T15:00:00Z,MTPP 186N 724W,0,0,0,12,12
Tropical Storm,Emily,7,2005-07-12T15:00:00Z,TGPY 120N 618W,0,17,8,0,25
Tropical Storm,Emily,7,2005-07-12T15:00:00Z,MTCA 183N 738W,0,0,0,8,8
Tropical Storm,Emily,7,2005-07-12T15:00:00Z,TBPB 131N 595W,3,34,1,0,38
Tropical Storm,Emily,7,2005-07-12T15:00:00Z,MUGM 200N 751W,0,0,0,2,2
Tropical Storm,Emily,7,2005-07-12T15:00:00Z,TVSV 131N 612W,0,26,6,0,32
Tropical Storm,Emily,7,2005-07-12T15:00:00Z,TJSJ 184N 661W,0,0,1,15,16
Tropical Storm,Emily,7,2005-07-12T15:00:00Z,TLPL 138N 610W,0,26,7,0,33
Tropical Storm,Emily,7,2005-07-12T15:00:00Z,MDPP 198N 707W,0,0,0,10,10
Tropical Storm,Emily,7,2005-07-12T15:00:00Z,TFFF 146N 610W,0,20,10,0,30
Tropical Storm,Emily,7,2005-07-12T15:00:00Z,MBJT 215N 712W,0,0,0,3,3
Tropical Storm,Emily,7,2005-07-12T15:00:00Z,TDPR 153N 614W,0,10,16,1,27
Tropical Storm,Emily,7,2005-07-12T15:00:00Z,ST CROIX VI,0,0,4,13,17
Tropical Storm,Emily,7,2005-07-12T15:00:00Z,80400 157N 636W,0,0,21,3,24
Tropical Storm,Emily,7,2005-07-12T15:00:00Z,ST THOMAS VI,0,0,2,13,15
Tropical Storm,Emily,7,2005-07-12T15:00:00Z,TFFR 163N 615W,0,3,16,1,20
Tropical Storm,Emily,7,2005-07-12T15:00:00Z,SAN JUAN PR,0,0,1,15,16
Tropical Storm,Emily,7,2005-07-12T15:00:00Z,TAPA 171N 618W,0,1,12,2,15
Tropical Storm,Emily,7,2005-07-12T15:00:00Z,PONCE PR,0,0,1,17,18
Tropical Storm,Emily,8,2005-07-12T21:00:00Z,12.1N  58.6W,51,1,0,0,52
Tropical Storm,Emily,8,2005-07-12T21:00:00Z,TNCM 181N 631W,0,0,6,4,10
Tropical Storm,Emily,8,2005-07-12T21:00:00Z,13.0N  61.6W,1,33,0,0,34
Tropical Storm,Emily,8,2005-07-12T21:00:00Z,TISX 177N 648W,0,0,7,8,15
Tropical Storm,Emily,8,2005-07-12T21:00:00Z,14.0N  64.8W,0,3,23,1,27
Tropical Storm,Emily,8,2005-07-12T21:00:00Z,TIST 183N 650W,0,0,4,9,13
Tropical Storm,Emily,8,2005-07-12T21:00:00Z,SKPG 125N 717W,0,0,0,7,7
Tropical Storm,Emily,8,2005-07-12T21:00:00Z,TJPS 180N 666W,0,0,2,15,17
Tropical Storm,Emily,8,2005-07-12T21:00:00Z,TNCC 122N 690W,0,0,2,9,11
Tropical Storm,Emily,8,2005-07-12T21:00:00Z,MDSD 185N 697W,0,0,0,17,17
Tropical Storm,Emily,8,2005-07-12T21:00:00Z,SVMG 110N 640W,0,5,7,0,12
Tropical Storm,Emily,8,2005-07-12T21:00:00Z,MDCB 176N 714W,0,0,0,19,19
Tropical Storm,Emily,8,2005-07-12T21:00:00Z,TTPP 106N 614W,1,14,1,0,16
Tropical Storm,Emily,8,2005-07-12T21:00:00Z,MTPP 186N 724W,0,0,0,15,15
Tropical Storm,Emily,8,2005-07-12T21:00:00Z,TTPT 112N 608W,6,20,0,0,26
Tropical Storm,Emily,8,2005-07-12T21:00:00Z,MTCA 183N 738W,0,0,0,13,13
Tropical Storm,Emily,8,2005-07-12T21:00:00Z,TGPY 120N 618W,1,27,0,1,29
Tropical Storm,Emily,8,2005-07-12T21:00:00Z,MKJP 179N 768W,0,0,0,3,3
Tropical Storm,Emily,8,2005-07-12T21:00:00Z,TBPB 131N 595W,34,10,0,0,44
Tropical Storm,Emily,8,2005-07-12T21:00:00Z,MUGM 200N 751W,0,0,0,5,5
Tropical Storm,Emily,8,2005-07-12T21:00:00Z,TVSV 131N 612W,2,34,0,0,36
Tropical Storm,Emily,8,2005-07-12T21:00:00Z,TJSJ 184N 661W,0,0,2,12,14
Tropical Storm,Emily,8,2005-07-12T21:00:00Z,TLPL 138N 610W,2,33,0,1,36
Tropical Storm,Emily,8,2005-07-12T21:00:00Z,MDPP 198N 707W,0,0,0,12,12
Tropical Storm,Emily,8,2005-07-12T21:00:00Z,TFFF 146N 610W,1,29,1,0,31
Tropical Storm,Emily,8,2005-07-12T21:00:00Z,MBJT 215N 712W,0,0,0,4,4
Tropical Storm,Emily,8,2005-07-12T21:00:00Z,TDPR 153N 614W,0,21,5,0,26
Tropical Storm,Emily,8,2005-07-12T21:00:00Z,ST CROIX VI,0,0,7,8,15
Tropical Storm,Emily,8,2005-07-12T21:00:00Z,80400 157N 636W,0,4,20,1,25
Tropical Storm,Emily,8,2005-07-12T21:00:00Z,ST THOMAS VI,0,0,4,9,13
Tropical Storm,Emily,8,2005-07-12T21:00:00Z,TFFR 163N 615W,0,9,9,0,18
Tropical Storm,Emily,8,2005-07-12T21:00:00Z,SAN JUAN PR,0,0,2,12,14
Tropical Storm,Emily,8,2005-07-12T21:00:00Z,TAPA 171N 618W,0,3,9,1,13
Tropical Storm,Emily,8,2005-07-12T21:00:00Z,PONCE PR,0,0,2,15,17
Tropical Storm,Emily,8,2005-07-12T21:00:00Z,TKPK 173N 627W,0,1,11,2,14
Tropical Storm,Emily,9,2005-07-13T03:00:00Z,11.8N  60.3W,48,2,0,0,50
Tropical Storm,Emily,9,2005-07-13T03:00:00Z,TNCM 181N 631W,0,0,3,1,4
Tropical Storm,Emily,9,2005-07-13T03:00:00Z,12.7N  63.6W,1,33,1,0,35
Tropical Storm,Emily,9,2005-07-13T03:00:00Z,TISX 177N 648W,0,0,8,2,10
Tropical Storm,Emily,9,2005-07-13T03:00:00Z,13.7N  66.9W,0,3,23,1,27
Tropical Storm,Emily,9,2005-07-13T03:00:00Z,TIST 183N 650W,0,0,5,3,8
Tropical Storm,Emily,9,2005-07-13T03:00:00Z,SKPG 125N 717W,0,0,1,12,13
Tropical Storm,Emily,9,2005-07-13T03:00:00Z,TJPS 180N 666W,0,0,6,7,13
Tropical Storm,Emily,9,2005-07-13T03:00:00Z,TNCC 122N 690W,0,0,10,6,16
Tropical Storm,Emily,9,2005-07-13T03:00:00Z,MDSD 185N 697W,0,0,1,14,15
Tropical Storm,Emily,9,2005-07-13T03:00:00Z,SVMG 110N 640W,0,19,3,0,22
Tropical Storm,Emily,9,2005-07-13T03:00:00Z,MDCB 176N 714W,0,0,0,19,19
Tropical Storm,Emily,9,2005-07-13T03:00:00Z,TTPP 106N 614W,19,10,0,0,29
Tropical Storm,Emily,9,2005-07-13T03:00:00Z,MTPP 186N 724W,0,0,0,16,16
Tropical Storm,Emily,9,2005-07-13T03:00:00Z,TTPT 112N 608W,37,4,0,0,41
Tropical Storm,Emily,9,2005-07-13T03:00:00Z,MTCA 183N 738W,0,0,0,16,16
Tropical Storm,Emily,9,2005-07-13T03:00:00Z,TGPY 120N 618W,22,19,0,0,41
Tropical Storm,Emily,9,2005-07-13T03:00:00Z,MKJP 179N 768W,0,0,0,9,9
Tropical Storm,Emily,9,2005-07-13T03:00:00Z,TBPB 131N 595W,46,1,0,0,47
Tropical Storm,Emily,9,2005-07-13T03:00:00Z,MKJS 185N 779W,0,0,0,5,5
Tropical Storm,Emily,9,2005-07-13T03:00:00Z,TVSV 131N 612W,29,14,0,0,43
Tropical Storm,Emily,9,2005-07-13T03:00:00Z,MUGM 200N 751W,0,0,0,7,7
Tropical Storm,Emily,9,2005-07-13T03:00:00Z,TLPL 138N 610W,21,16,0,0,37
Tropical Storm,Emily,9,2005-07-13T03:00:00Z,TJSJ 184N 661W,0,0,4,6,10
Tropical Storm,Emily,9,2005-07-13T03:00:00Z,TFFF 146N 610W,8,19,0,0,27
Tropical Storm,Emily,9,2005-07-13T03:00:00Z,MDPP 198N 707W,0,0,0,10,10
Tropical Storm,Emily,9,2005-07-13T03:00:00Z,TDPR 153N 614W,2,17,1,0,20
Tropical Storm,Emily,9,2005-07-13T03:00:00Z,MBJT 215N 712W,0,0,0,3,3
Tropical Storm,Emily,9,2005-07-13T03:00:00Z,80400 157N 636W,0,14,8,0,22
Tropical Storm,Emily,9,2005-07-13T03:00:00Z,ST CROIX VI,0,0,8,2,10
Tropical Storm,Emily,9,2005-07-13T03:00:00Z,TFFR 163N 615W,0,7,2,0,9
Tropical Storm,Emily,9,2005-07-13T03:00:00Z,ST THOMAS VI,0,0,5,3,8
Tropical Storm,Emily,9,2005-07-13T03:00:00Z,TAPA 171N 618W,0,3,2,0,5
Tropical Storm,Emily,9,2005-07-13T03:00:00Z,SAN JUAN PR,0,0,4,6,10
Tropical Storm,Emily,9,2005-07-13T03:00:00Z,TKPK 173N 627W,0,2,4,1,7
Tropical Storm,Emily,9,2005-07-13T03:00:00Z,PONCE PR,0,0,6,7,13
Tropical Storm,Emily,10,2005-07-13T09:00:00Z,12.4N  61.7W,48,1,0,0,49
Tropical Storm,Emily,10,2005-07-13T09:00:00Z,TISX 177N 648W,0,2,9,1,12
Tropical Storm,Emily,10,2005-07-13T09:00:00Z,13.3N  64.8W,1,32,1,0,34
Tropical Storm,Emily,10,2005-07-13T09:00:00Z,TIST 183N 650W,0,1,6,1,8
Tropical Storm,Emily,10,2005-07-13T09:00:00Z,14.3N  67.9W,0,3,23,1,27
Tropical Storm,Emily,10,2005-07-13T09:00:00Z,TJPS 180N 666W,0,0,11,3,14
Tropical Storm,Emily,10,2005-07-13T09:00:00Z,SKPG 125N 717W,0,0,2,10,12
Tropical Storm,Emily,10,2005-07-13T09:00:00Z,MDSD 185N 697W,0,0,3,13,16
Tropical Storm,Emily,10,2005-07-13T09:00:00Z,TNCC 122N 690W,0,1,11,3,15
Tropical Storm,Emily,10,2005-07-13T09:00:00Z,MDCB 176N 714W,0,0,2,19,21
Tropical Storm,Emily,10,2005-07-13T09:00:00Z,SVMG 110N 640W,3,16,0,0,19
Tropical Storm,Emily,10,2005-07-13T09:00:00Z,MTPP 186N 724W,0,0,0,18,18
Tropical Storm,Emily,10,2005-07-13T09:00:00Z,TTPP 106N 614W,22,1,0,0,23
Tropical Storm,Emily,10,2005-07-13T09:00:00Z,MTCA 183N 738W,0,0,0,19,19
Tropical Storm,Emily,10,2005-07-13T09:00:00Z,TTPT 112N 608W,42,0,0,0,42
Tropical Storm,Emily,10,2005-07-13T09:00:00Z,MKJP 179N 768W,0,0,0,13,13
Tropical Storm,Emily,10,2005-07-13T09:00:00Z,TGPY 120N 618W,44,1,0,0,45
Tropical Storm,Emily,10,2005-07-13T09:00:00Z,MKJS 185N 779W,0,0,0,9,9
Tropical Storm,Emily,10,2005-07-13T09:00:00Z,TBPB 131N 595W,62,0,0,0,62
Tropical Storm,Emily,10,2005-07-13T09:00:00Z,MUGM 200N 751W,0,0,0,11,11
Tropical Storm,Emily,10,2005-07-13T09:00:00Z,TVSV 131N 612W,51,1,0,0,52
Tropical Storm,Emily,10,2005-07-13T09:00:00Z,MUCM 214N 779W,0,0,0,2,2
Tropical Storm,Emily,10,2005-07-13T09:00:00Z,TLPL 138N 610W,44,1,0,0,45
Tropical Storm,Emily,10,2005-07-13T09:00:00Z,TJSJ 184N 661W,0,0,7,3,10
Tropical Storm,Emily,10,2005-07-13T09:00:00Z,TFFF 146N 610W,27,4,0,0,31
Tropical Storm,Emily,10,2005-07-13T09:00:00Z,MDPP 198N 707W,0,0,0,11,11
Tropical Storm,Emily,10,2005-07-13T09:00:00Z,TDPR 153N 614W,11,10,0,0,21
Tropical Storm,Emily,10,2005-07-13T09:00:00Z,MBJT 215N 712W,0,0,0,3,3
Tropical Storm,Emily,10,2005-07-13T09:00:00Z,80400 157N 636W,1,22,1,1,25
Tropical Storm,Emily,10,2005-07-13T09:00:00Z,MYMM 224N 730W,0,0,0,2,2
Tropical Storm,Emily,10,2005-07-13T09:00:00Z,TFFR 163N 615W,2,6,1,0,9
Tropical Storm,Emily,10,2005-07-13T09:00:00Z,ST CROIX VI,0,2,9,1,12
Tropical Storm,Emily,10,2005-07-13T09:00:00Z,TAPA 171N 618W,0,4,0,0,4
Tropical Storm,Emily,10,2005-07-13T09:00:00Z,ST THOMAS VI,0,1,6,1,8
Tropical Storm,Emily,10,2005-07-13T09:00:00Z,TKPK 173N 627W,0,4,2,1,7
Tropical Storm,Emily,10,2005-07-13T09:00:00Z,SAN JUAN PR,0,0,7,3,10
Tropical Storm,Emily,10,2005-07-13T09:00:00Z,TNCM 181N 631W,0,1,2,1,4
Tropical Storm,Emily,10,2005-07-13T09:00:00Z,PONCE PR,0,0,11,3,14
Tropical Storm,Emily,11,2005-07-13T15:00:00Z,12.4N  64.0W,48,1,0,0,49
Tropical Storm,Emily,11,2005-07-13T15:00:00Z,TJPS 180N 666W,0,2,5,2,9
Tropical Storm,Emily,11,2005-07-13T15:00:00Z,13.3N  67.0W,1,32,1,0,34
Tropical Storm,Emily,11,2005-07-13T15:00:00Z,MDSD 185N 697W,0,0,6,7,13
Tropical Storm,Emily,11,2005-07-13T15:00:00Z,14.2N  70.0W,0,4,22,1,27
Tropical Storm,Emily,11,2005-07-13T15:00:00Z,MDCB 176N 714W,0,0,8,12,20
Tropical Storm,Emily,11,2005-07-13T15:00:00Z,SKPG 125N 717W,0,0,11,5,16
Tropical Storm,Emily,11,2005-07-13T15:00:00Z,MTPP 186N 724W,0,0,2,14,16
Tropical Storm,Emily,11,2005-07-13T15:00:00Z,TNCC 122N 690W,0,11,10,0,21
Tropical Storm,Emily,11,2005-07-13T15:00:00Z,MTCA 183N 738W,0,0,1,18,19
Tropical Storm,Emily,11,2005-07-13T15:00:00Z,SVMG 110N 640W,29,2,0,0,31
Tropical Storm,Emily,11,2005-07-13T15:00:00Z,MKJP 179N 768W,0,0,0,19,19
Tropical Storm,Emily,11,2005-07-13T15:00:00Z,TTPP 106N 614W,39,0,0,0,39
Tropical Storm,Emily,11,2005-07-13T15:00:00Z,MKJS 185N 779W,0,0,0,16,16
Tropical Storm,Emily,11,2005-07-13T15:00:00Z,TTPT 112N 608W,70,0,0,0,70
Tropical Storm,Emily,11,2005-07-13T15:00:00Z,MWCG 193N 814W,0,0,0,5,5
Tropical Storm,Emily,11,2005-07-13T15:00:00Z,TGPY 120N 618W,69,0,0,0,69
Tropical Storm,Emily,11,2005-07-13T15:00:00Z,MUGM 200N 751W,0,0,0,11,11
Tropical Storm,Emily,11,2005-07-13T15:00:00Z,TBPB 131N 595W,57,0,0,0,57
Tropical Storm,Emily,11,2005-07-13T15:00:00Z,MUCM 214N 779W,0,0,0,4,4
Tropical Storm,Emily,11,2005-07-13T15:00:00Z,TVSV 131N 612W,62,0,0,0,62
Tropical Storm,Emily,11,2005-07-13T15:00:00Z,TJSJ 184N 661W,0,1,3,1,5
Tropical Storm,Emily,11,2005-07-13T15:00:00Z,TLPL 138N 610W,36,0,0,0,36
Tropical Storm,Emily,11,2005-07-13T15:00:00Z,MDPP 198N 707W,0,0,1,7,8
Tropical Storm,Emily,11,2005-07-13T15:00:00Z,TFFF 146N 610W,9,0,0,0,9
Tropical Storm,Emily,11,2005-07-13T15:00:00Z,MBJT 215N 712W,0,0,0,2,2
Tropical Storm,Emily,11,2005-07-13T15:00:00Z,TDPR 153N 614W,4,0,0,0,4
Tropical Storm,Emily,11,2005-07-13T15:00:00Z,ST CROIX VI,0,2,2,0,4
Tropical Storm,Emily,11,2005-07-13T15:00:00Z,80400 157N 636W,6,9,0,0,15
Tropical Storm,Emily,11,2005-07-13T15:00:00Z,ST THOMAS VI,0,1,1,0,2
Tropical Storm,Emily,11,2005-07-13T15:00:00Z,TISX 177N 648W,0,2,2,0,4
Tropical Storm,Emily,11,2005-07-13T15:00:00Z,SAN JUAN PR,0,1,3,1,5
Tropical Storm,Emily,11,2005-07-13T15:00:00Z,TIST 183N 650W,0,1,1,0,2
Tropical Storm,Emily,11,2005-07-13T15:00:00Z,PONCE PR,0,2,5,2,9
Tropical Storm,Emily,12,2005-07-13T21:00:00Z,12.8N  65.5W,50,1,0,0,51
Tropical Storm,Emily,12,2005-07-13T21:00:00Z,MDSD 185N 697W,0,0,8,3,11
Tropical Storm,Emily,12,2005-07-13T21:00:00Z,13.8N  68.6W,1,33,0,1,35
Tropical Storm,Emily,12,2005-07-13T21:00:00Z,MDCB 176N 714W,0,0,14,5,19
Tropical Storm,Emily,12,2005-07-13T21:00:00Z,14.7N  71.7W,0,4,22,1,27
Tropical Storm,Emily,12,2005-07-13T21:00:00Z,MTPP 186N 724W,0,0,5,10,15
Tropical Storm,Emily,12,2005-07-13T21:00:00Z,SKPG 125N 717W,0,3,13,0,16
Tropical Storm,Emily,12,2005-07-13T21:00:00Z,MTCA 183N 738W,0,0,3,15,18
Tropical Storm,Emily,12,2005-07-13T21:00:00Z,TNCC 122N 690W,0,20,2,0,22
Tropical Storm,Emily,12,2005-07-13T21:00:00Z,MKJP 179N 768W,0,0,0,21,21
Tropical Storm,Emily,12,2005-07-13T21:00:00Z,SVMG 110N 640W,32,0,0,0,32
Tropical Storm,Emily,12,2005-07-13T21:00:00Z,MKJS 185N 779W,0,0,0,19,19
Tropical Storm,Emily,12,2005-07-13T21:00:00Z,TTPP 106N 614W,34,0,0,0,34
Tropical Storm,Emily,12,2005-07-13T21:00:00Z,MWCG 193N 814W,0,0,0,10,10
Tropical Storm,Emily,12,2005-07-13T21:00:00Z,TTPT 112N 608W,99,0,0,0,99
Tropical Storm,Emily,12,2005-07-13T21:00:00Z,MUGM 200N 751W,0,0,0,12,12
Tropical Storm,Emily,12,2005-07-13T21:00:00Z,TGPY 120N 618W,91,0,0,0,91
Tropical Storm,Emily,12,2005-07-13T21:00:00Z,MUCM 214N 779W,0,0,0,7,7
Tropical Storm,Emily,12,2005-07-13T21:00:00Z,TBPB 131N 595W,51,0,0,0,51
Tropical Storm,Emily,12,2005-07-13T21:00:00Z,MUCF 221N 805W,0,0,0,4,4
Tropical Storm,Emily,12,2005-07-13T21:00:00Z,TVSV 131N 612W,77,0,0,0,77
Tropical Storm,Emily,12,2005-07-13T21:00:00Z,MUSN 216N 826W,0,0,0,2,2
Tropical Storm,Emily,12,2005-07-13T21:00:00Z,TLPL 138N 610W,27,0,0,0,27
Tropical Storm,Emily,12,2005-07-13T21:00:00Z,TJSJ 184N 661W,0,1,1,0,2
Tropical Storm,Emily,12,2005-07-13T21:00:00Z,TFFF 146N 610W,2,0,0,0,2
Tropical Storm,Emily,12,2005-07-13T21:00:00Z,MDPP 198N 707W,0,0,2,4,6
Tropical Storm,Emily,12,2005-07-13T21:00:00Z,80400 157N 636W,7,1,0,0,8
Tropical Storm,Emily,12,2005-07-13T21:00:00Z,SAN JUAN PR,0,1,1,0,2
Tropical Storm,Emily,12,2005-07-13T21:00:00Z,TJPS 180N 666W,0,2,2,0,4
Tropical Storm,Emily,12,2005-07-13T21:00:00Z,PONCE PR,0,2,2,0,4
Hurricane,Emily,13,2005-07-14T03:00:00Z,13.4N  66.7W,49,1,0,0,50
Hurricane,Emily,13,2005-07-14T03:00:00Z,MTPP 186N 724W,0,0,15,3,18
Hurricane,Emily,13,2005-07-14T03:00:00Z,14.5N  70.0W,0,34,1,0,35
Hurricane,Emily,13,2005-07-14T03:00:00Z,MTCA 183N 738W,0,0,14,7,21
Hurricane,Emily,13,2005-07-14T03:00:00Z,15.5N  73.2W,0,3,23,1,27
Hurricane,Emily,13,2005-07-14T03:00:00Z,MKJP 179N 768W,0,0,3,19,22
Hurricane,Emily,13,2005-07-14T03:00:00Z,SKPG 125N 717W,0,9,6,0,15
Hurricane,Emily,13,2005-07-14T03:00:00Z,MKJS 185N 779W,0,0,1,20,21
Hurricane,Emily,13,2005-07-14T03:00:00Z,TNCC 122N 690W,5,17,0,0,22
Hurricane,Emily,13,2005-07-14T03:00:00Z,MWCG 193N 814W,0,0,0,15,15
Hurricane,Emily,13,2005-07-14T03:00:00Z,SVMG 110N 640W,14,0,0,0,14
Hurricane,Emily,13,2005-07-14T03:00:00Z,MUGM 200N 751W,0,0,2,13,15
Hurricane,Emily,13,2005-07-14T03:00:00Z,TTPP 106N 614W,14,0,0,0,14
Hurricane,Emily,13,2005-07-14T03:00:00Z,MUCM 214N 779W,0,0,0,11,11
Hurricane,Emily,13,2005-07-14T03:00:00Z,TTPT 112N 608W,99,0,0,0,99
Hurricane,Emily,13,2005-07-14T03:00:00Z,MUCF 221N 805W,0,0,0,8,8
Hurricane,Emily,13,2005-07-14T03:00:00Z,TGPY 120N 618W,99,0,0,0,99
Hurricane,Emily,13,2005-07-14T03:00:00Z,MUSN 216N 826W,0,0,0,6,6
Hurricane,Emily,13,2005-07-14T03:00:00Z,TBPB 131N 595W,48,0,0,0,48
Hurricane,Emily,13,2005-07-14T03:00:00Z,MUHA 230N 824W,0,0,0,3,3
Hurricane,Emily,13,2005-07-14T03:00:00Z,TVSV 131N 612W,91,0,0,0,91
Hurricane,Emily,13,2005-07-14T03:00:00Z,MUAN 219N 850W,0,0,0,2,2
Hurricane,Emily,13,2005-07-14T03:00:00Z,TLPL 138N 610W,41,0,0,0,41
Hurricane,Emily,13,2005-07-14T03:00:00Z,MDPP 198N 707W,0,0,5,3,8
Hurricane,Emily,13,2005-07-14T03:00:00Z,TFFF 146N 610W,3,0,0,0,3
Hurricane,Emily,13,2005-07-14T03:00:00Z,MBJT 215N 712W,0,0,1,1,2
Hurricane,Emily,13,2005-07-14T03:00:00Z,80400 157N 636W,8,0,0,0,8
Hurricane,Emily,13,2005-07-14T03:00:00Z,MYMM 224N 730W,0,0,0,2,2
Hurricane,Emily,13,2005-07-14T03:00:00Z,TJPS 180N 666W,0,4,0,0,4
Hurricane,Emily,13,2005-07-14T03:00:00Z,MYEG 235N 758W,0,0,0,2,2
Hurricane,Emily,13,2005-07-14T03:00:00Z,MDSD 185N 697W,0,4,9,0,13
Hurricane,Emily,13,2005-07-14T03:00:00Z,PONCE PR,0,4,0,0,4
Hurricane,Emily,13,2005-07-14T03:00:00Z,MDCB 176N 714W,0,5,17,1,23
Hurricane,Emily,14,2005-07-14T09:00:00Z,14.0N  68.0W,49,2,0,0,51
Hurricane,Emily,14,2005-07-14T09:00:00Z,MKJP 179N 768W,0,0,15,11,26
Hurricane,Emily,14,2005-07-14T09:00:00Z,15.2N  71.5W,0,34,2,0,36
Hurricane,Emily,14,2005-07-14T09:00:00Z,MKJS 185N 779W,0,0,6,19,25
Hurricane,Emily,14,2005-07-14T09:00:00Z,16.4N  75.0W,0,2,25,1,28
Hurricane,Emily,14,2005-07-14T09:00:00Z,MWCG 193N 814W,0,0,0,22,22
Hurricane,Emily,14,2005-07-14T09:00:00Z,SKPG 125N 717W,0,10,2,0,12
Hurricane,Emily,14,2005-07-14T09:00:00Z,MUGM 200N 751W,0,0,9,8,17
Hurricane,Emily,14,2005-07-14T09:00:00Z,TNCC 122N 690W,11,6,0,0,17
Hurricane,Emily,14,2005-07-14T09:00:00Z,MUCM 214N 779W,0,0,0,15,15
Hurricane,Emily,14,2005-07-14T09:00:00Z,SVMG 110N 640W,4,0,0,0,4
Hurricane,Emily,14,2005-07-14T09:00:00Z,MUCF 221N 805W,0,0,0,15,15
Hurricane,Emily,14,2005-07-14T09:00:00Z,TTPP 106N 614W,2,0,0,0,2
Hurricane,Emily,14,2005-07-14T09:00:00Z,MUSN 216N 826W,0,0,0,17,17
Hurricane,Emily,14,2005-07-14T09:00:00Z,TTPT 112N 608W,7,0,0,0,7
Hurricane,Emily,14,2005-07-14T09:00:00Z,MUHA 230N 824W,0,0,0,11,11
Hurricane,Emily,14,2005-07-14T09:00:00Z,TGPY 120N 618W,99,0,0,0,99
Hurricane,Emily,14,2005-07-14T09:00:00Z,MUAN 219N 850W,0,0,0,11,11
Hurricane,Emily,14,2005-07-14T09:00:00Z,TVSV 131N 612W,97,0,0,0,97
Hurricane,Emily,14,2005-07-14T09:00:00Z,MMCZ 205N 869W,0,0,0,5,5
Hurricane,Emily,14,2005-07-14T09:00:00Z,TLPL 138N 610W,24,0,0,0,24
Hurricane,Emily,14,2005-07-14T09:00:00Z,MHNJ 165N 859W,0,0,0,2,2
Hurricane,Emily,14,2005-07-14T09:00:00Z,80400 157N 636W,5,0,0,0,5
Hurricane,Emily,14,2005-07-14T09:00:00Z,MDPP 198N 707W,0,2,4,1,7
Hurricane,Emily,14,2005-07-14T09:00:00Z,TJPS 180N 666W,1,2,0,0,3
Hurricane,Emily,14,2005-07-14T09:00:00Z,MYEG 235N 758W,0,0,0,2,2
Hurricane,Emily,14,2005-07-14T09:00:00Z,MDSD 185N 697W,0,9,4,0,13
Hurricane,Emily,14,2005-07-14T09:00:00Z,MYAK 241N 776W,0,0,0,2,2
Hurricane,Emily,14,2005-07-14T09:00:00Z,MDCB 176N 714W,0,19,8,0,27
Hurricane,Emily,14,2005-07-14T09:00:00Z,PONCE PR,1,2,0,0,3
Hurricane,Emily,14,2005-07-14T09:00:00Z,MTPP 186N 724W,0,5,16,0,21
Hurricane,Emily,14,2005-07-14T09:00:00Z,MARATHON FL,0,0,0,3,3
Hurricane,Emily,14,2005-07-14T09:00:00Z,MTCA 183N 738W,0,2,22,1,25
Hurricane,Emily,14,2005-07-14T09:00:00Z,KEY WEST FL,0,0,0,4,4
Hurricane,Emily,15,2005-07-14T15:00:00Z,14.5N  69.9W,50,2,0,0,52
Hurricane,Emily,15,2005-07-14T15:00:00Z,MUCM 214N 779W,0,0,2,11,13
Hurricane,Emily,15,2005-07-14T15:00:00Z,15.6N  73.3W,0,34,2,0,36
Hurricane,Emily,15,2005-07-14T15:00:00Z,MUCF 221N 805W,0,0,0,13,13
Hurricane,Emily,15,2005-07-14T15:00:00Z,17.0N  76.8W,0,2,25,0,27
Hurricane,Emily,15,2005-07-14T15:00:00Z,MUSN 216N 826W,0,0,0,17,17
Hurricane,Emily,15,2005-07-14T15:00:00Z,SKPG 125N 717W,4,5,0,0,9
Hurricane,Emily,15,2005-07-14T15:00:00Z,MUHA 230N 824W,0,0,0,11,11
Hurricane,Emily,15,2005-07-14T15:00:00Z,TNCC 122N 690W,12,1,0,0,13
Hurricane,Emily,15,2005-07-14T15:00:00Z,MUAN 219N 850W,0,0,0,14,14
Hurricane,Emily,15,2005-07-14T15:00:00Z,SVMG 110N 640W,2,0,0,0,2
Hurricane,Emily,15,2005-07-14T15:00:00Z,MMCZ 205N 869W,0,0,0,12,12
Hurricane,Emily,15,2005-07-14T15:00:00Z,MDSD 185N 697W,1,6,0,0,7
Hurricane,Emily,15,2005-07-14T15:00:00Z,MZBZ 175N 883W,0,0,0,3,3
Hurricane,Emily,15,2005-07-14T15:00:00Z,MDCB 176N 714W,1,24,1,0,26
Hurricane,Emily,15,2005-07-14T15:00:00Z,MHNJ 165N 859W,0,0,0,6,6
Hurricane,Emily,15,2005-07-14T15:00:00Z,MTPP 186N 724W,0,12,7,0,19
Hurricane,Emily,15,2005-07-14T15:00:00Z,MNPC 141N 834W,0,0,0,2,2
Hurricane,Emily,15,2005-07-14T15:00:00Z,MTCA 183N 738W,0,11,14,0,25
Hurricane,Emily,15,2005-07-14T15:00:00Z,MDPP 198N 707W,0,2,1,0,3
Hurricane,Emily,15,2005-07-14T15:00:00Z,MKJP 179N 768W,0,1,24,2,27
Hurricane,Emily,15,2005-07-14T15:00:00Z,MMMD 210N 897W,0,0,0,3,3
Hurricane,Emily,15,2005-07-14T15:00:00Z,MKJS 185N 779W,0,0,18,7,25
Hurricane,Emily,15,2005-07-14T15:00:00Z,MARATHON FL,0,0,0,2,2
Hurricane,Emily,15,2005-07-14T15:00:00Z,MWCG 193N 814W,0,0,1,21,22
Hurricane,Emily,15,2005-07-14T15:00:00Z,KEY WEST FL,0,0,0,3,3
Hurricane,Emily,15,2005-07-14T15:00:00Z,MUGM 200N 751W,0,0,12,3,15
Hurricane,Emily,16,2005-07-14T21:00:00Z,15.3N  72.1W,49,1,0,0,50
Hurricane,Emily,16,2005-07-14T21:00:00Z,MUHA 230N 824W,0,0,1,13,14
Hurricane,Emily,16,2005-07-14T21:00:00Z,16.5N  75.7W,0,36,1,0,37
Hurricane,Emily,16,2005-07-14T21:00:00Z,MUAN 219N 850W,0,0,0,17,17
Hurricane,Emily,16,2005-07-14T21:00:00Z,17.6N  79.0W,0,4,24,1,29
Hurricane,Emily,16,2005-07-14T21:00:00Z,MMCZ 205N 869W,0,0,0,15,15
Hurricane,Emily,16,2005-07-14T21:00:00Z,SKPG 125N 717W,3,0,0,0,3
Hurricane,Emily,16,2005-07-14T21:00:00Z,MZBZ 175N 883W,0,0,0,6,6
Hurricane,Emily,16,2005-07-14T21:00:00Z,MDSD 185N 697W,2,0,0,0,2
Hurricane,Emily,16,2005-07-14T21:00:00Z,MGPB 157N 886W,0,0,0,2,2
Hurricane,Emily,16,2005-07-14T21:00:00Z,MDCB 176N 714W,18,8,0,0,26
Hurricane,Emily,16,2005-07-14T21:00:00Z,MHNJ 165N 859W,0,0,0,10,10
Hurricane,Emily,16,2005-07-14T21:00:00Z,MTPP 186N 724W,2,14,0,0,16
Hurricane,Emily,16,2005-07-14T21:00:00Z,MNPC 141N 834W,0,0,0,6,6
Hurricane,Emily,16,2005-07-14T21:00:00Z,MTCA 183N 738W,1,26,1,0,28
Hurricane,Emily,16,2005-07-14T21:00:00Z,SKSP 126N 817W,0,0,0,2,2
Hurricane,Emily,16,2005-07-14T21:00:00Z,MKJP 179N 768W,0,24,9,0,33
Hurricane,Emily,16,2005-07-14T21:00:00Z,MYAK 241N 776W,0,0,1,1,2
Hurricane,Emily,16,2005-07-14T21:00:00Z,MKJS 185N 779W,0,8,22,0,30
Hurricane,Emily,16,2005-07-14T21:00:00Z,MMMD 210N 897W,0,0,0,6,6
Hurricane,Emily,16,2005-07-14T21:00:00Z,MWCG 193N 814W,0,0,14,11,25
Hurricane,Emily,16,2005-07-14T21:00:00Z,MARATHON FL,0,0,0,6,6
Hurricane,Emily,16,2005-07-14T21:00:00Z,MUGM 200N 751W,0,8,7,1,16
Hurricane,Emily,16,2005-07-14T21:00:00Z,MIAMI FL,0,0,0,2,2
Hurricane,Emily,16,2005-07-14T21:00:00Z,MUCM 214N 779W,0,0,12,3,15
Hurricane,Emily,16,2005-07-14T21:00:00Z,KEY WEST FL,0,0,0,8,8
Hurricane,Emily,16,2005-07-14T21:00:00Z,MUCF 221N 805W,0,0,5,11,16
Hurricane,Emily,16,2005-07-14T21:00:00Z,MARCO ISLAND FL,0,0,0,3,3
Hurricane,Emily,16,2005-07-14T21:00:00Z,MUSN 216N 826W,0,0,2,17,19
Hurricane,Emily,16,2005-07-14T21:00:00Z,FT MYERS FL,0,0,0,2,2
Hurricane,Emily,17,2005-07-15T03:00:00Z,15.7N  73.6W,48,1,0,0,49
Hurricane,Emily,17,2005-07-15T03:00:00Z,MUHA 230N 824W,0,0,2,14,16
Hurricane,Emily,17,2005-07-15T03:00:00Z,17.0N  77.1W,0,34,1,0,35
Hurricane,Emily,17,2005-07-15T03:00:00Z,MUAN 219N 850W,0,0,1,20,21
Hurricane,Emily,17,2005-07-15T03:00:00Z,18.2N  80.2W,0,4,23,0,27
Hurricane,Emily,17,2005-07-15T03:00:00Z,MMCZ 205N 869W,0,0,0,19,19
Hurricane,Emily,17,2005-07-15T03:00:00Z,MDCB 176N 714W,17,1,0,0,18
Hurricane,Emily,17,2005-07-15T03:00:00Z,MZBZ 175N 883W,0,0,0,7,7
Hurricane,Emily,17,2005-07-15T03:00:00Z,MTPP 186N 724W,7,5,0,0,12
Hurricane,Emily,17,2005-07-15T03:00:00Z,MGPB 157N 886W,0,0,0,2,2
Hurricane,Emily,17,2005-07-15T03:00:00Z,MTCA 183N 738W,7,19,0,0,26
Hurricane,Emily,17,2005-07-15T03:00:00Z,MHNJ 165N 859W,0,0,0,10,10
Hurricane,Emily,17,2005-07-15T03:00:00Z,MKJP 179N 768W,0,33,1,0,34
Hurricane,Emily,17,2005-07-15T03:00:00Z,MNPC 141N 834W,0,0,1,4,5
Hurricane,Emily,17,2005-07-15T03:00:00Z,MKJS 185N 779W,0,23,7,0,30
Hurricane,Emily,17,2005-07-15T03:00:00Z,MMMD 210N 897W,0,0,0,11,11
Hurricane,Emily,17,2005-07-15T03:00:00Z,MWCG 193N 814W,0,0,21,5,26
Hurricane,Emily,17,2005-07-15T03:00:00Z,MARATHON FL,0,0,1,5,6
Hurricane,Emily,17,2005-07-15T03:00:00Z,MUGM 200N 751W,0,10,3,0,13
Hurricane,Emily,17,2005-07-15T03:00:00Z,KEY WEST FL,0,0,1,7,8
Hurricane,Emily,17,2005-07-15T03:00:00Z,MUCM 214N 779W,0,1,12,1,14
Hurricane,Emily,17,2005-07-15T03:00:00Z,MARCO ISLAND FL,0,0,0,3,3
Hurricane,Emily,17,2005-07-15T03:00:00Z,MUCF 221N 805W,0,0,9,7,16
Hurricane,Emily,17,2005-07-15T03:00:00Z,FT MYERS FL,0,0,0,2,2
Hurricane,Emily,17,2005-07-15T03:00:00Z,MUSN 216N 826W,0,0,6,15,21
Hurricane,Emily,17,2005-07-15T03:00:00Z,GULF 28N 89W,0,0,0,2,2
Hurricane,Emily,18,2005-07-15T09:00:00Z,15.8N  75.3W,48,1,0,0,49
Hurricane,Emily,18,2005-07-15T09:00:00Z,MUHA 230N 824W,0,0,5,8,13
Hurricane,Emily,18,2005-07-15T09:00:00Z,17.2N  78.7W,0,36,1,0,37
Hurricane,Emily,18,2005-07-15T09:00:00Z,MUAN 219N 850W,0,0,5,17,22
Hurricane,Emily,18,2005-07-15T09:00:00Z,18.5N  82.2W,0,3,26,0,29
Hurricane,Emily,18,2005-07-15T09:00:00Z,MMCZ 205N 869W,0,0,2,20,22
Hurricane,Emily,18,2005-07-15T09:00:00Z,MDCB 176N 714W,5,0,0,0,5
Hurricane,Emily,18,2005-07-15T09:00:00Z,MZBZ 175N 883W,0,0,0,10,10
Hurricane,Emily,18,2005-07-15T09:00:00Z,MTPP 186N 724W,2,0,0,0,2
Hurricane,Emily,18,2005-07-15T09:00:00Z,MGPB 157N 886W,0,0,0,3,3
Hurricane,Emily,18,2005-07-15T09:00:00Z,MTCA 183N 738W,10,4,0,0,14
Hurricane,Emily,18,2005-07-15T09:00:00Z,MHNJ 165N 859W,0,0,2,9,11
Hurricane,Emily,18,2005-07-15T09:00:00Z,MKJP 179N 768W,5,31,0,0,36
Hurricane,Emily,18,2005-07-15T09:00:00Z,MNPC 141N 834W,0,0,1,2,3
Hurricane,Emily,18,2005-07-15T09:00:00Z,MKJS 185N 779W,0,32,1,0,33
Hurricane,Emily,18,2005-07-15T09:00:00Z,MMFR 185N 926W,0,0,0,2,2
Hurricane,Emily,18,2005-07-15T09:00:00Z,MWCG 193N 814W,0,4,26,0,30
Hurricane,Emily,18,2005-07-15T09:00:00Z,MMMD 210N 897W,0,0,0,16,16
Hurricane,Emily,18,2005-07-15T09:00:00Z,MUGM 200N 751W,0,4,1,0,5
Hurricane,Emily,18,2005-07-15T09:00:00Z,MARATHON FL,0,0,0,3,3
Hurricane,Emily,18,2005-07-15T09:00:00Z,MUCM 214N 779W,0,2,5,1,8
Hurricane,Emily,18,2005-07-15T09:00:00Z,KEY WEST FL,0,0,1,4,5
Hurricane,Emily,18,2005-07-15T09:00:00Z,MUCF 221N 805W,0,0,10,3,13
Hurricane,Emily,18,2005-07-15T09:00:00Z,GULF 28N 89W,0,0,0,3,3
Hurricane,Emily,18,2005-07-15T09:00:00Z,MUSN 216N 826W,0,0,15,6,21
Hurricane,Emily,18,2005-07-15T09:00:00Z,GULF 28N 91W,0,0,0,2,2
Hurricane,Emily,19,2005-07-15T15:00:00Z,16.5N  77.0W,48,1,0,0,49
Hurricane,Emily,19,2005-07-15T15:00:00Z,MZBZ 175N 883W,0,0,0,9,9
Hurricane,Emily,19,2005-07-15T15:00:00Z,18.0N  80.0W,1,35,1,0,37
Hurricane,Emily,19,2005-07-15T15:00:00Z,MGPB 157N 886W,0,0,0,2,2
Hurricane,Emily,19,2005-07-15T15:00:00Z,19.5N  83.0W,0,5,24,1,30
Hurricane,Emily,19,2005-07-15T15:00:00Z,MHNJ 165N 859W,0,0,2,7,9
Hurricane,Emily,19,2005-07-15T15:00:00Z,MTCA 183N 738W,5,0,0,0,5
Hurricane,Emily,19,2005-07-15T15:00:00Z,MNPC 141N 834W,0,0,1,1,2
Hurricane,Emily,19,2005-07-15T15:00:00Z,MKJP 179N 768W,33,6,0,0,39
Hurricane,Emily,19,2005-07-15T15:00:00Z,MMFR 185N 926W,0,0,0,3,3
Hurricane,Emily,19,2005-07-15T15:00:00Z,MKJS 185N 779W,10,26,0,0,36
Hurricane,Emily,19,2005-07-15T15:00:00Z,MMMD 210N 897W,0,0,0,16,16
Hurricane,Emily,19,2005-07-15T15:00:00Z,MWCG 193N 814W,0,22,11,0,33
Hurricane,Emily,19,2005-07-15T15:00:00Z,MARATHON FL,0,0,2,3,5
Hurricane,Emily,19,2005-07-15T15:00:00Z,MUGM 200N 751W,1,1,0,0,2
Hurricane,Emily,19,2005-07-15T15:00:00Z,KEY WEST FL,0,0,4,4,8
Hurricane,Emily,19,2005-07-15T15:00:00Z,MUCM 214N 779W,0,5,3,0,8
Hurricane,Emily,19,2005-07-15T15:00:00Z,MARCO ISLAND FL,0,0,0,2,2
Hurricane,Emily,19,2005-07-15T15:00:00Z,MUCF 221N 805W,0,3,14,0,17
Hurricane,Emily,19,2005-07-15T15:00:00Z,BURAS LA,0,0,0,2,2
Hurricane,Emily,19,2005-07-15T15:00:00Z,MUSN 216N 826W,0,1,23,2,26
Hurricane,Emily,19,2005-07-15T15:00:00Z,GULF 29N 87W,0,0,0,2,2
Hurricane,Emily,19,2005-07-15T15:00:00Z,MUHA 230N 824W,0,0,14,4,18
Hurricane,Emily,19,2005-07-15T15:00:00Z,GULF 28N 89W,0,0,0,6,6
Hurricane,Emily,19,2005-07-15T15:00:00Z,MUAN 219N 850W,0,0,15,10,25
Hurricane,Emily,19,2005-07-15T15:00:00Z,GULF 28N 91W,0,0,0,6,6
Hurricane,Emily,19,2005-07-15T15:00:00Z,MMCZ 205N 869W,0,0,4,18,22
Hurricane,Emily,19,2005-07-15T15:00:00Z,GULF 28N 93W,0,0,0,3,3
Hurricane,Emily,20,2005-07-15T21:00:00Z,16.6N  78.9W,48,1,0,0,49
Hurricane,Emily,20,2005-07-15T21:00:00Z,MMMD 210N 897W,0,0,3,18,21
Hurricane,Emily,20,2005-07-15T21:00:00Z,18.3N  82.0W,0,37,1,0,38
Hurricane,Emily,20,2005-07-15T21:00:00Z,KEY WEST FL,0,0,1,1,2
Hurricane,Emily,20,2005-07-15T21:00:00Z,20.0N  85.5W,0,2,28,1,31
Hurricane,Emily,20,2005-07-15T21:00:00Z,BURAS LA,0,0,0,2,2
Hurricane,Emily,20,2005-07-15T21:00:00Z,MKJP 179N 768W,29,0,0,0,29
Hurricane,Emily,20,2005-07-15T21:00:00Z,NEW ORLEANS LA,0,0,0,2,2
Hurricane,Emily,20,2005-07-15T21:00:00Z,MKJS 185N 779W,23,4,0,0,27
Hurricane,Emily,20,2005-07-15T21:00:00Z,NEW IBERIA LA,0,0,0,2,2
Hurricane,Emily,20,2005-07-15T21:00:00Z,MWCG 193N 814W,0,35,1,0,36
Hurricane,Emily,20,2005-07-15T21:00:00Z,PORT ARTHUR TX,0,0,0,2,2
Hurricane,Emily,20,2005-07-15T21:00:00Z,MUCF 221N 805W,0,4,4,0,8
Hurricane,Emily,20,2005-07-15T21:00:00Z,GALVESTON TX,0,0,0,3,3
Hurricane,Emily,20,2005-07-15T21:00:00Z,MUSN 216N 826W,0,8,16,0,24
Hurricane,Emily,20,2005-07-15T21:00:00Z,FREEPORT TX,0,0,0,3,3
Hurricane,Emily,20,2005-07-15T21:00:00Z,MUHA 230N 824W,0,1,10,1,12
Hurricane,Emily,20,2005-07-15T21:00:00Z,PORT O CONNOR TX,0,0,0,3,3
Hurricane,Emily,20,2005-07-15T21:00:00Z,MUAN 219N 850W,0,1,25,1,27
Hurricane,Emily,20,2005-07-15T21:00:00Z,CORPUSCHRISTI TX,0,0,0,2,2
Hurricane,Emily,20,2005-07-15T21:00:00Z,MMCZ 205N 869W,0,0,23,4,27
Hurricane,Emily,20,2005-07-15T21:00:00Z,BROWNSVILLE TX,0,0,0,3,3
Hurricane,Emily,20,2005-07-15T21:00:00Z,MZBZ 175N 883W,0,0,3,8,11
Hurricane,Emily,20,2005-07-15T21:00:00Z,GULF 28N 89W,0,0,0,6,6
Hurricane,Emily,20,2005-07-15T21:00:00Z,MGPB 157N 886W,0,0,0,3,3
Hurricane,Emily,20,2005-07-15T21:00:00Z,GULF 28N 91W,0,0,0,8,8
Hurricane,Emily,20,2005-07-15T21:00:00Z,MHNJ 165N 859W,0,1,7,2,10
Hurricane,Emily,20,2005-07-15T21:00:00Z,GULF 28N 93W,0,0,0,8,8
Hurricane,Emily,20,2005-07-15T21:00:00Z,MMSO 238N 982W,0,0,0,2,2
Hurricane,Emily,20,2005-07-15T21:00:00Z,GULF 28N 95W,0,0,0,5,5
Hurricane,Emily,20,2005-07-15T21:00:00Z,MMTM 222N 979W,0,0,0,2,2
Hurricane,Emily,20,2005-07-15T21:00:00Z,GULF 27N 96W,0,0,0,5,5
Hurricane,Emily,20,2005-07-15T21:00:00Z,MMVR 192N 961W,0,0,0,2,2
Hurricane,Emily,20,2005-07-15T21:00:00Z,GULF 25N 96W,0,0,0,7,7
Hurricane,Emily,20,2005-07-15T21:00:00Z,MMFR 185N 926W,0,0,0,7,7
Hurricane,Emily,21,2005-07-16T03:00:00Z,17.0N  79.9W,48,2,0,0,50
Hurricane,Emily,21,2005-07-16T03:00:00Z,MMFR 185N 926W,0,0,0,8,8
Hurricane,Emily,21,2005-07-16T03:00:00Z,18.6N  83.2W,0,37,1,0,38
Hurricane,Emily,21,2005-07-16T03:00:00Z,MMMD 210N 897W,0,0,8,15,23
Hurricane,Emily,21,2005-07-16T03:00:00Z,20.1N  86.4W,0,4,26,0,30
Hurricane,Emily,21,2005-07-16T03:00:00Z,BURAS LA,0,0,0,2,2
Hurricane,Emily,21,2005-07-16T03:00:00Z,MKJP 179N 768W,32,0,0,0,32
Hurricane,Emily,21,2005-07-16T03:00:00Z,NEW ORLEANS LA,0,0,0,2,2
Hurricane,Emily,21,2005-07-16T03:00:00Z,MKJS 185N 779W,27,1,0,0,28
Hurricane,Emily,21,2005-07-16T03:00:00Z,NEW IBERIA LA,0,0,0,2,2
Hurricane,Emily,21,2005-07-16T03:00:00Z,MWCG 193N 814W,3,33,0,0,36
Hurricane,Emily,21,2005-07-16T03:00:00Z,PORT ARTHUR TX,0,0,0,3,3
Hurricane,Emily,21,2005-07-16T03:00:00Z,MUCF 221N 805W,0,3,1,0,4
Hurricane,Emily,21,2005-07-16T03:00:00Z,GALVESTON TX,0,0,0,4,4
Hurricane,Emily,21,2005-07-16T03:00:00Z,MUSN 216N 826W,0,13,7,0,20
Hurricane,Emily,21,2005-07-16T03:00:00Z,FREEPORT TX,0,0,0,4,4
Hurricane,Emily,21,2005-07-16T03:00:00Z,MUHA 230N 824W,0,2,6,0,8
Hurricane,Emily,21,2005-07-16T03:00:00Z,PORT O CONNOR TX,0,0,0,4,4
Hurricane,Emily,21,2005-07-16T03:00:00Z,MUAN 219N 850W,0,4,22,0,26
Hurricane,Emily,21,2005-07-16T03:00:00Z,CORPUSCHRISTI TX,0,0,0,3,3
Hurricane,Emily,21,2005-07-16T03:00:00Z,MMCZ 205N 869W,0,1,27,1,29
Hurricane,Emily,21,2005-07-16T03:00:00Z,BROWNSVILLE TX,0,0,0,5,5
Hurricane,Emily,21,2005-07-16T03:00:00Z,MZBZ 175N 883W,0,0,7,6,13
Hurricane,Emily,21,2005-07-16T03:00:00Z,GULF 28N 89W,0,0,0,6,6
Hurricane,Emily,21,2005-07-16T03:00:00Z,MGPB 157N 886W,0,0,1,3,4
Hurricane,Emily,21,2005-07-16T03:00:00Z,GULF 28N 91W,0,0,0,8,8
Hurricane,Emily,21,2005-07-16T03:00:00Z,MHNJ 165N 859W,0,4,8,0,12
Hurricane,Emily,21,2005-07-16T03:00:00Z,GULF 28N 93W,0,0,0,8,8
Hurricane,Emily,21,2005-07-16T03:00:00Z,MMSO 238N 982W,0,0,0,3,3
Hurricane,Emily,21,2005-07-16T03:00:00Z,GULF 28N 95W,0,0,0,7,7
Hurricane,Emily,21,2005-07-16T03:00:00Z,MMTM 222N 979W,0,0,0,2,2
Hurricane,Emily,21,2005-07-16T03:00:00Z,GULF 27N 96W,0,0,0,7,7
Hurricane,Emily,21,2005-07-16T03:00:00Z,MMTX 210N 974W,0,0,0,2,2
Hurricane,Emily,21,2005-07-16T03:00:00Z,GULF 25N 96W,0,0,0,9,9
Hurricane,Emily,21,2005-07-16T03:00:00Z,MMVR 192N 961W,0,0,0,2,2
Hurricane,Emily,22,2005-07-16T09:00:00Z,17.5N  81.5W,48,1,0,0,49
Hurricane,Emily,22,2005-07-16T09:00:00Z,MMVR 192N 961W,0,0,0,2,2
Hurricane,Emily,22,2005-07-16T09:00:00Z,18.9N  84.7W,1,34,1,0,36
Hurricane,Emily,22,2005-07-16T09:00:00Z,MMFR 185N 926W,0,0,1,7,8
Hurricane,Emily,22,2005-07-16T09:00:00Z,20.3N  87.6W,0,6,22,1,29
Hurricane,Emily,22,2005-07-16T09:00:00Z,MMMD 210N 897W,0,0,18,7,25
Hurricane,Emily,22,2005-07-16T09:00:00Z,MKJP 179N 768W,22,0,0,0,22
Hurricane,Emily,22,2005-07-16T09:00:00Z,NEW IBERIA LA,0,0,0,2,2
Hurricane,Emily,22,2005-07-16T09:00:00Z,MKJS 185N 779W,21,0,0,0,21
Hurricane,Emily,22,2005-07-16T09:00:00Z,PORT ARTHUR TX,0,0,0,3,3
Hurricane,Emily,22,2005-07-16T09:00:00Z,MWCG 193N 814W,25,10,0,0,35
Hurricane,Emily,22,2005-07-16T09:00:00Z,GALVESTON TX,0,0,0,5,5
Hurricane,Emily,22,2005-07-16T09:00:00Z,MUSN 216N 826W,0,11,3,0,14
Hurricane,Emily,22,2005-07-16T09:00:00Z,FREEPORT TX,0,0,0,5,5
Hurricane,Emily,22,2005-07-16T09:00:00Z,MUHA 230N 824W,0,2,1,1,4
Hurricane,Emily,22,2005-07-16T09:00:00Z,PORT O CONNOR TX,0,0,0,6,6
Hurricane,Emily,22,2005-07-16T09:00:00Z,MUAN 219N 850W,0,10,12,0,22
Hurricane,Emily,22,2005-07-16T09:00:00Z,CORPUSCHRISTI TX,0,0,0,5,5
Hurricane,Emily,22,2005-07-16T09:00:00Z,MMCZ 205N 869W,0,11,19,0,30
Hurricane,Emily,22,2005-07-16T09:00:00Z,BROWNSVILLE TX,0,0,0,8,8
Hurricane,Emily,22,2005-07-16T09:00:00Z,MZBZ 175N 883W,0,2,10,2,14
Hurricane,Emily,22,2005-07-16T09:00:00Z,GULF 28N 89W,0,0,0,4,4
Hurricane,Emily,22,2005-07-16T09:00:00Z,MGPB 157N 886W,0,0,1,2,3
Hurricane,Emily,22,2005-07-16T09:00:00Z,GULF 28N 91W,0,0,0,7,7
Hurricane,Emily,22,2005-07-16T09:00:00Z,MHNJ 165N 859W,0,10,3,0,13
Hurricane,Emily,22,2005-07-16T09:00:00Z,GULF 28N 93W,0,0,0,9,9
Hurricane,Emily,22,2005-07-16T09:00:00Z,MMSO 238N 982W,0,0,0,5,5
Hurricane,Emily,22,2005-07-16T09:00:00Z,GULF 28N 95W,0,0,0,9,9
Hurricane,Emily,22,2005-07-16T09:00:00Z,MMTM 222N 979W,0,0,0,4,4
Hurricane,Emily,22,2005-07-16T09:00:00Z,GULF 27N 96W,0,0,0,10,10
Hurricane,Emily,22,2005-07-16T09:00:00Z,MMTX 210N 974W,0,0,0,3,3
Hurricane,Emily,22,2005-07-16T09:00:00Z,GULF 25N 96W,0,0,0,13,13
Hurricane,Emily,23,2005-07-16T15:00:00Z,18.5N  83.0W,49,1,0,0,50
Hurricane,Emily,23,2005-07-16T15:00:00Z,MMMD 210N 897W,0,3,23,1,27
Hurricane,Emily,23,2005-07-16T15:00:00Z,19.9N  86.2W,1,35,1,0,37
Hurricane,Emily,23,2005-07-16T15:00:00Z,BURAS LA,0,0,0,2,2
Hurricane,Emily,23,2005-07-16T15:00:00Z,21.3N  89.4W,0,4,24,1,29
Hurricane,Emily,23,2005-07-16T15:00:00Z,NEW ORLEANS LA,0,0,0,2,2
Hurricane,Emily,23,2005-07-16T15:00:00Z,MKJP 179N 768W,16,0,0,0,16
Hurricane,Emily,23,2005-07-16T15:00:00Z,NEW IBERIA LA,0,0,0,3,3
Hurricane,Emily,23,2005-07-16T15:00:00Z,MKJS 185N 779W,19,0,0,0,19
Hurricane,Emily,23,2005-07-16T15:00:00Z,PORT ARTHUR TX,0,0,0,5,5
Hurricane,Emily,23,2005-07-16T15:00:00Z,MWCG 193N 814W,47,0,0,0,47
Hurricane,Emily,23,2005-07-16T15:00:00Z,GALVESTON TX,0,0,0,7,7
Hurricane,Emily,23,2005-07-16T15:00:00Z,MUSN 216N 826W,4,13,0,0,17
Hurricane,Emily,23,2005-07-16T15:00:00Z,FREEPORT TX,0,0,0,8,8
Hurricane,Emily,23,2005-07-16T15:00:00Z,MUHA 230N 824W,0,3,0,0,3
Hurricane,Emily,23,2005-07-16T15:00:00Z,PORT O CONNOR TX,0,0,0,8,8
Hurricane,Emily,23,2005-07-16T15:00:00Z,MUAN 219N 850W,0,26,1,1,28
Hurricane,Emily,23,2005-07-16T15:00:00Z,CORPUSCHRISTI TX,0,0,0,8,8
Hurricane,Emily,23,2005-07-16T15:00:00Z,MMCZ 205N 869W,0,31,4,0,35
Hurricane,Emily,23,2005-07-16T15:00:00Z,BROWNSVILLE TX,0,0,0,11,11
Hurricane,Emily,23,2005-07-16T15:00:00Z,MZBZ 175N 883W,0,5,7,0,12
Hurricane,Emily,23,2005-07-16T15:00:00Z,GULF 28N 89W,0,0,1,4,5
Hurricane,Emily,23,2005-07-16T15:00:00Z,MHNJ 165N 859W,2,5,0,1,8
Hurricane,Emily,23,2005-07-16T15:00:00Z,GULF 28N 91W,0,0,0,9,9
Hurricane,Emily,23,2005-07-16T15:00:00Z,MMSO 238N 982W,0,0,0,9,9
Hurricane,Emily,23,2005-07-16T15:00:00Z,GULF 28N 93W,0,0,0,11,11
Hurricane,Emily,23,2005-07-16T15:00:00Z,MMTM 222N 979W,0,0,0,7,7
Hurricane,Emily,23,2005-07-16T15:00:00Z,GULF 28N 95W,0,0,0,11,11
Hurricane,Emily,23,2005-07-16T15:00:00Z,MMTX 210N 974W,0,0,0,6,6
Hurricane,Emily,23,2005-07-16T15:00:00Z,GULF 27N 96W,0,0,0,12,12
Hurricane,Emily,23,2005-07-16T15:00:00Z,MMVR 192N 961W,0,0,0,5,5
Hurricane,Emily,23,2005-07-16T15:00:00Z,GULF 25N 96W,0,0,0,15,15
Hurricane,Emily,23,2005-07-16T15:00:00Z,MMFR 185N 926W,0,0,2,7,9
Hurricane,Emily,24,2005-07-16T21:00:00Z,19.1N  84.4W,48,1,0,0,49
Hurricane,Emily,24,2005-07-16T21:00:00Z,MMFR 185N 926W,0,0,7,4,11
Hurricane,Emily,24,2005-07-16T21:00:00Z,20.4N  87.7W,1,33,1,0,35
Hurricane,Emily,24,2005-07-16T21:00:00Z,MMMD 210N 897W,0,17,12,0,29
Hurricane,Emily,24,2005-07-16T21:00:00Z,21.6N  90.7W,0,6,20,1,27
Hurricane,Emily,24,2005-07-16T21:00:00Z,NEW IBERIA LA,0,0,0,2,2
Hurricane,Emily,24,2005-07-16T21:00:00Z,MKJP 179N 768W,6,0,0,0,6
Hurricane,Emily,24,2005-07-16T21:00:00Z,PORT ARTHUR TX,0,0,0,4,4
Hurricane,Emily,24,2005-07-16T21:00:00Z,MKJS 185N 779W,6,0,0,0,6
Hurricane,Emily,24,2005-07-16T21:00:00Z,GALVESTON TX,0,0,0,7,7
Hurricane,Emily,24,2005-07-16T21:00:00Z,MWCG 193N 814W,53,0,0,0,53
Hurricane,Emily,24,2005-07-16T21:00:00Z,FREEPORT TX,0,0,0,8,8
Hurricane,Emily,24,2005-07-16T21:00:00Z,MUSN 216N 826W,9,3,0,0,12
Hurricane,Emily,24,2005-07-16T21:00:00Z,PORT O CONNOR TX,0,0,0,10,10
Hurricane,Emily,24,2005-07-16T21:00:00Z,MUHA 230N 824W,1,1,0,0,2
Hurricane,Emily,24,2005-07-16T21:00:00Z,CORPUSCHRISTI TX,0,0,0,11,11
Hurricane,Emily,24,2005-07-16T21:00:00Z,MUAN 219N 850W,3,22,0,0,25
Hurricane,Emily,24,2005-07-16T21:00:00Z,BROWNSVILLE TX,0,0,0,15,15
Hurricane,Emily,24,2005-07-16T21:00:00Z,MMCZ 205N 869W,2,35,0,0,37
Hurricane,Emily,24,2005-07-16T21:00:00Z,GULF 28N 89W,0,0,1,2,3
Hurricane,Emily,24,2005-07-16T21:00:00Z,MZBZ 175N 883W,0,10,2,0,12
Hurricane,Emily,24,2005-07-16T21:00:00Z,GULF 28N 91W,0,0,1,5,6
Hurricane,Emily,24,2005-07-16T21:00:00Z,MHNJ 165N 859W,2,1,0,0,3
Hurricane,Emily,24,2005-07-16T21:00:00Z,GULF 28N 93W,0,0,0,10,10
Hurricane,Emily,24,2005-07-16T21:00:00Z,MMSO 238N 982W,0,0,0,13,13
Hurricane,Emily,24,2005-07-16T21:00:00Z,GULF 28N 95W,0,0,0,11,11
Hurricane,Emily,24,2005-07-16T21:00:00Z,MMTM 222N 979W,0,0,0,12,12
Hurricane,Emily,24,2005-07-16T21:00:00Z,GULF 27N 96W,0,0,0,14,14
Hurricane,Emily,24,2005-07-16T21:00:00Z,MMTX 210N 974W,0,0,0,10,10
Hurricane,Emily,24,2005-07-16T21:00:00Z,GULF 25N 96W,0,0,0,18,18
Hurricane,Emily,24,2005-07-16T21:00:00Z,MMVR 192N 961W,0,0,0,8,8
Hurricane,Emily,25,2005-07-17T03:00:00Z,19.8N  85.8W,48,1,0,0,49
Hurricane,Emily,25,2005-07-17T03:00:00Z,MMFR 185N 926W,0,1,4,3,8
Hurricane,Emily,25,2005-07-17T03:00:00Z,21.0N  89.0W,1,34,1,0,36
Hurricane,Emily,25,2005-07-17T03:00:00Z,MMMD 210N 897W,0,31,2,0,33
Hurricane,Emily,25,2005-07-17T03:00:00Z,22.2N  92.0W,0,7,21,1,29
Hurricane,Emily,25,2005-07-17T03:00:00Z,PORT ARTHUR TX,0,0,0,3,3
Hurricane,Emily,25,2005-07-17T03:00:00Z,MKJS 185N 779W,2,0,0,0,2
Hurricane,Emily,25,2005-07-17T03:00:00Z,GALVESTON TX,0,0,0,7,7
Hurricane,Emily,25,2005-07-17T03:00:00Z,MWCG 193N 814W,64,0,0,0,64
Hurricane,Emily,25,2005-07-17T03:00:00Z,FREEPORT TX,0,0,0,9,9
Hurricane,Emily,25,2005-07-17T03:00:00Z,MUSN 216N 826W,8,0,0,0,8
Hurricane,Emily,25,2005-07-17T03:00:00Z,PORT O CONNOR TX,0,0,0,12,12
Hurricane,Emily,25,2005-07-17T03:00:00Z,MUAN 219N 850W,18,8,0,0,26
Hurricane,Emily,25,2005-07-17T03:00:00Z,CORPUSCHRISTI TX,0,0,0,14,14
Hurricane,Emily,25,2005-07-17T03:00:00Z,MMCZ 205N 869W,32,11,0,0,43
Hurricane,Emily,25,2005-07-17T03:00:00Z,BROWNSVILLE TX,0,0,0,18,18
Hurricane,Emily,25,2005-07-17T03:00:00Z,MZBZ 175N 883W,1,2,1,0,4
Hurricane,Emily,25,2005-07-17T03:00:00Z,GULF 28N 91W,0,0,1,3,4
Hurricane,Emily,25,2005-07-17T03:00:00Z,MMSO 238N 982W,0,0,0,16,16
Hurricane,Emily,25,2005-07-17T03:00:00Z,GULF 28N 93W,0,0,1,8,9
Hurricane,Emily,25,2005-07-17T03:00:00Z,MMTM 222N 979W,0,0,0,14,14
Hurricane,Emily,25,2005-07-17T03:00:00Z,GULF 28N 95W,0,0,0,12,12
Hurricane,Emily,25,2005-07-17T03:00:00Z,MMTX 210N 974W,0,0,1,10,11
Hurricane,Emily,25,2005-07-17T03:00:00Z,GULF 27N 96W,0,0,1,15,16
Hurricane,Emily,25,2005-07-17T03:00:00Z,MMVR 192N 961W,0,0,1,6,7
Hurricane,Emily,25,2005-07-17T03:00:00Z,GULF 25N 96W,0,0,3,18,21
Hurricane,Emily,26,2005-07-17T09:00:00Z,20.2N  87.4W,45,1,0,0,46
Hurricane,Emily,26,2005-07-17T09:00:00Z,NEW IBERIA LA,0,0,0,2,2
Hurricane,Emily,26,2005-07-17T09:00:00Z,21.5N  90.2W,0,31,0,0,31
Hurricane,Emily,26,2005-07-17T09:00:00Z,PORT ARTHUR TX,0,0,0,4,4
Hurricane,Emily,26,2005-07-17T09:00:00Z,22.7N  93.0W,0,9,15,1,25
Hurricane,Emily,26,2005-07-17T09:00:00Z,GALVESTON TX,0,0,0,6,6
Hurricane,Emily,26,2005-07-17T09:00:00Z,MWCG 193N 814W,40,0,0,0,40
Hurricane,Emily,26,2005-07-17T09:00:00Z,FREEPORT TX,0,0,0,7,7
Hurricane,Emily,26,2005-07-17T09:00:00Z,MUAN 219N 850W,8,3,0,1,12
Hurricane,Emily,26,2005-07-17T09:00:00Z,PORT O CONNOR TX,0,0,0,9,9
Hurricane,Emily,26,2005-07-17T09:00:00Z,MMCZ 205N 869W,45,1,0,0,46
Hurricane,Emily,26,2005-07-17T09:00:00Z,CORPUSCHRISTI TX,0,0,0,10,10
Hurricane,Emily,26,2005-07-17T09:00:00Z,MZBZ 175N 883W,4,0,0,1,5
Hurricane,Emily,26,2005-07-17T09:00:00Z,BROWNSVILLE TX,0,0,3,11,14
Hurricane,Emily,26,2005-07-17T09:00:00Z,MMSO 238N 982W,0,0,4,11,15
Hurricane,Emily,26,2005-07-17T09:00:00Z,GULF 28N 89W,0,0,0,2,2
Hurricane,Emily,26,2005-07-17T09:00:00Z,MMTM 222N 979W,0,0,4,10,14
Hurricane,Emily,26,2005-07-17T09:00:00Z,GULF 28N 91W,0,0,1,3,4
Hurricane,Emily,26,2005-07-17T09:00:00Z,MMTX 210N 974W,0,0,4,8,12
Hurricane,Emily,26,2005-07-17T09:00:00Z,GULF 28N 93W,0,0,1,6,7
Hurricane,Emily,26,2005-07-17T09:00:00Z,MMVR 192N 961W,0,0,2,6,8
Hurricane,Emily,26,2005-07-17T09:00:00Z,GULF 28N 95W,0,0,1,8,9
Hurricane,Emily,26,2005-07-17T09:00:00Z,MMFR 185N 926W,0,2,3,2,7
Hurricane,Emily,26,2005-07-17T09:00:00Z,GULF 27N 96W,0,0,2,11,13
Hurricane,Emily,26,2005-07-17T09:00:00Z,MMMD 210N 897W,4,29,0,0,33
Hurricane,Emily,26,2005-07-17T09:00:00Z,GULF 25N 96W,0,0,9,8,17
Hurricane,Emily,27,2005-07-17T15:00:00Z,20.9N  88.9W,45,1,0,0,46
Hurricane,Emily,27,2005-07-17T15:00:00Z,NEW IBERIA LA,0,0,0,2,2
Hurricane,Emily,27,2005-07-17T15:00:00Z,22.2N  91.6W,1,29,1,0,31
Hurricane,Emily,27,2005-07-17T15:00:00Z,PORT ARTHUR TX,0,0,0,3,3
Hurricane,Emily,27,2005-07-17T15:00:00Z,23.1N  94.2W,0,13,10,1,24
Hurricane,Emily,27,2005-07-17T15:00:00Z,GALVESTON TX,0,0,0,5,5
Hurricane,Emily,27,2005-07-17T15:00:00Z,MWCG 193N 814W,6,0,0,0,6
Hurricane,Emily,27,2005-07-17T15:00:00Z,FREEPORT TX,0,0,0,7,7
Hurricane,Emily,27,2005-07-17T15:00:00Z,MUAN 219N 850W,5,0,0,0,5
Hurricane,Emily,27,2005-07-17T15:00:00Z,PORT O CONNOR TX,0,0,1,8,9
Hurricane,Emily,27,2005-07-17T15:00:00Z,MMCZ 205N 869W,62,0,0,0,62
Hurricane,Emily,27,2005-07-17T15:00:00Z,CORPUSCHRISTI TX,0,0,1,10,11
Hurricane,Emily,27,2005-07-17T15:00:00Z,MMSO 238N 982W,0,0,9,8,17
Hurricane,Emily,27,2005-07-17T15:00:00Z,BROWNSVILLE TX,0,0,7,9,16
Hurricane,Emily,27,2005-07-17T15:00:00Z,MMTM 222N 979W,0,0,9,6,15
Hurricane,Emily,27,2005-07-17T15:00:00Z,GULF 28N 91W,0,0,1,2,3
Hurricane,Emily,27,2005-07-17T15:00:00Z,MMTX 210N 974W,0,0,6,7,13
Hurricane,Emily,27,2005-07-17T15:00:00Z,GULF 28N 93W,0,0,1,5,6
Hurricane,Emily,27,2005-07-17T15:00:00Z,MMVR 192N 961W,0,0,2,5,7
Hurricane,Emily,27,2005-07-17T15:00:00Z,GULF 28N 95W,0,0,2,7,9
Hurricane,Emily,27,2005-07-17T15:00:00Z,MMFR 185N 926W,1,1,1,1,4
Hurricane,Emily,27,2005-07-17T15:00:00Z,GULF 27N 96W,0,0,4,9,13
Hurricane,Emily,27,2005-07-17T15:00:00Z,MMMD 210N 897W,36,4,0,0,40
Hurricane,Emily,27,2005-07-17T15:00:00Z,GULF 25N 96W,0,1,13,5,19
Hurricane,Emily,28,2005-07-17T21:00:00Z,21.8N  90.4W,46,1,0,0,47
Hurricane,Emily,28,2005-07-17T21:00:00Z,GALVESTON TX,0,0,1,4,5
Hurricane,Emily,28,2005-07-17T21:00:00Z,23.0N  93.2W,1,30,0,0,31
Hurricane,Emily,28,2005-07-17T21:00:00Z,FREEPORT TX,0,0,1,6,7
Hurricane,Emily,28,2005-07-17T21:00:00Z,23.9N  95.7W,0,14,9,1,24
Hurricane,Emily,28,2005-07-17T21:00:00Z,PORT O CONNOR TX,0,0,3,7,10
Hurricane,Emily,28,2005-07-17T21:00:00Z,MMCZ 205N 869W,85,0,0,0,85
Hurricane,Emily,28,2005-07-17T21:00:00Z,CORPUSCHRISTI TX,0,0,5,8,13
Hurricane,Emily,28,2005-07-17T21:00:00Z,MMSO 238N 982W,0,2,13,4,19
Hurricane,Emily,28,2005-07-17T21:00:00Z,BROWNSVILLE TX,0,1,13,5,19
Hurricane,Emily,28,2005-07-17T21:00:00Z,MMTM 222N 979W,0,2,10,4,16
Hurricane,Emily,28,2005-07-17T21:00:00Z,GULF 28N 91W,0,0,1,1,2
Hurricane,Emily,28,2005-07-17T21:00:00Z,MMTX 210N 974W,0,1,6,5,12
Hurricane,Emily,28,2005-07-17T21:00:00Z,GULF 28N 93W,0,0,2,4,6
Hurricane,Emily,28,2005-07-17T21:00:00Z,MMVR 192N 961W,0,0,1,3,4
Hurricane,Emily,28,2005-07-17T21:00:00Z,GULF 28N 95W,0,0,4,6,10
Hurricane,Emily,28,2005-07-17T21:00:00Z,MMMD 210N 897W,55,0,0,0,55
Hurricane,Emily,28,2005-07-17T21:00:00Z,GULF 27N 96W,0,0,10,5,15
Hurricane,Emily,28,2005-07-17T21:00:00Z,PORT ARTHUR TX,0,0,0,3,3
Hurricane,Emily,28,2005-07-17T21:00:00Z,GULF 25N 96W,0,6,14,2,22
Hurricane,Emily,29,2005-07-18T03:00:00Z,22.3N  91.7W,45,0,0,0,45
Hurricane,Emily,29,2005-07-18T03:00:00Z,GALVESTON TX,0,0,1,3,4
Hurricane,Emily,29,2005-07-18T03:00:00Z,23.3N  94.4W,2,29,0,0,31
Hurricane,Emily,29,2005-07-18T03:00:00Z,FREEPORT TX,0,0,1,4,5
Hurricane,Emily,29,2005-07-18T03:00:00Z,24.1N  96.8W,0,16,7,1,24
Hurricane,Emily,29,2005-07-18T03:00:00Z,PORT O CONNOR TX,0,0,3,6,9
Hurricane,Emily,29,2005-07-18T03:00:00Z,MMCZ 205N 869W,99,0,0,0,99
Hurricane,Emily,29,2005-07-18T03:00:00Z,CORPUSCHRISTI TX,0,0,6,7,13
Hurricane,Emily,29,2005-07-18T03:00:00Z,MMSO 238N 982W,0,7,12,2,21
Hurricane,Emily,29,2005-07-18T03:00:00Z,BROWNSVILLE TX,0,3,14,2,19
Hurricane,Emily,29,2005-07-18T03:00:00Z,MMTM 222N 979W,0,6,8,3,17
Hurricane,Emily,29,2005-07-18T03:00:00Z,GULF 28N 93W,0,0,1,3,4
Hurricane,Emily,29,2005-07-18T03:00:00Z,MMTX 210N 974W,0,3,5,3,11
Hurricane,Emily,29,2005-07-18T03:00:00Z,GULF 28N 95W,0,0,4,4,8
Hurricane,Emily,29,2005-07-18T03:00:00Z,MMVR 192N 961W,0,0,1,2,3
Hurricane,Emily,29,2005-07-18T03:00:00Z,GULF 27N 96W,0,1,9,4,14
Hurricane,Emily,29,2005-07-18T03:00:00Z,MMMD 210N 897W,69,0,0,0,69
Hurricane,Emily,29,2005-07-18T03:00:00Z,GULF 25N 96W,0,14,8,1,23
Hurricane,Emily,29,2005-07-18T03:00:00Z,PORT ARTHUR TX,0,0,0,2,2
Hurricane,Emily,30,2005-07-18T09:00:00Z,22.9N  92.8W,45,0,0,0,45
Hurricane,Emily,30,2005-07-18T09:00:00Z,GALVESTON TX,0,0,1,2,3
Hurricane,Emily,30,2005-07-18T09:00:00Z,23.8N  95.2W,3,27,0,0,30
Hurricane,Emily,30,2005-07-18T09:00:00Z,FREEPORT TX,0,0,1,4,5
Hurricane,Emily,30,2005-07-18T09:00:00Z,24.4N  97.7W,0,16,7,1,24
Hurricane,Emily,30,2005-07-18T09:00:00Z,PORT O CONNOR TX,0,0,4,4,8
Hurricane,Emily,30,2005-07-18T09:00:00Z,MMCZ 205N 869W,99,0,0,0,99
Hurricane,Emily,30,2005-07-18T09:00:00Z,CORPUSCHRISTI TX,0,0,8,5,13
Hurricane,Emily,30,2005-07-18T09:00:00Z,MMSO 238N 982W,0,13,8,1,22
Hurricane,Emily,30,2005-07-18T09:00:00Z,BROWNSVILLE TX,0,8,11,2,21
Hurricane,Emily,30,2005-07-18T09:00:00Z,MMTM 222N 979W,0,8,6,2,16
Hurricane,Emily,30,2005-07-18T09:00:00Z,GULF 28N 93W,0,0,1,2,3
Hurricane,Emily,30,2005-07-18T09:00:00Z,MMTX 210N 974W,0,3,4,3,10
Hurricane,Emily,30,2005-07-18T09:00:00Z,GULF 28N 95W,0,0,4,3,7
Hurricane,Emily,30,2005-07-18T09:00:00Z,MMVR 192N 961W,0,0,0,2,2
Hurricane,Emily,30,2005-07-18T09:00:00Z,GULF 27N 96W,0,3,9,2,14
Hurricane,Emily,30,2005-07-18T09:00:00Z,MMMD 210N 897W,80,0,0,0,80
Hurricane,Emily,30,2005-07-18T09:00:00Z,GULF 25N 96W,0,21,4,0,25
Hurricane,Emily,31,2005-07-18T15:00:00Z,23.9N  94.4W,44,0,0,0,44
Hurricane,Emily,31,2005-07-18T15:00:00Z,FREEPORT TX,0,0,2,2,4
Hurricane,Emily,31,2005-07-18T15:00:00Z,24.5N  96.8W,6,23,1,0,30
Hurricane,Emily,31,2005-07-18T15:00:00Z,PORT O CONNOR TX,0,1,4,3,8
Hurricane,Emily,31,2005-07-18T15:00:00Z,25.0N  99.2W,0,17,6,1,24
Hurricane,Emily,31,2005-07-18T15:00:00Z,CORPUSCHRISTI TX,0,3,8,2,13
Hurricane,Emily,31,2005-07-18T15:00:00Z,MMSO 238N 982W,1,21,2,0,24
Hurricane,Emily,31,2005-07-18T15:00:00Z,BROWNSVILLE TX,0,20,3,1,24
Hurricane,Emily,31,2005-07-18T15:00:00Z,MMTM 222N 979W,2,9,2,1,14
Hurricane,Emily,31,2005-07-18T15:00:00Z,GULF 28N 93W,0,0,1,1,2
Hurricane,Emily,31,2005-07-18T15:00:00Z,MMTX 210N 974W,1,1,2,2,6
Hurricane,Emily,31,2005-07-18T15:00:00Z,GULF 28N 95W,0,1,3,2,6
Hurricane,Emily,31,2005-07-18T15:00:00Z,MMMD 210N 897W,99,0,0,0,99
Hurricane,Emily,31,2005-07-18T15:00:00Z,GULF 27N 96W,0,9,5,0,14
Hurricane,Emily,31,2005-07-18T15:00:00Z,GALVESTON TX,0,0,1,1,2
Hurricane,Emily,31,2005-07-18T15:00:00Z,GULF 25N 96W,8,21,0,0,29
Hurricane,Emily,32,2005-07-18T21:00:00Z,24.0N  95.5W,44,0,0,0,44
Hurricane,Emily,32,2005-07-18T21:00:00Z,PORT O CONNOR TX,0,1,2,0,3
Hurricane,Emily,32,2005-07-18T21:00:00Z,24.5N  98.0W,6,24,0,0,30
Hurricane,Emily,32,2005-07-18T21:00:00Z,CORPUSCHRISTI TX,0,3,5,0,8
Hurricane,Emily,32,2005-07-18T21:00:00Z,24.5N 100.5W,0,17,6,0,23
Hurricane,Emily,32,2005-07-18T21:00:00Z,BROWNSVILLE TX,1,21,1,0,23
Hurricane,Emily,32,2005-07-18T21:00:00Z,MMSO 238N 982W,8,19,1,0,28
Hurricane,Emily,32,2005-07-18T21:00:00Z,GULF 28N 95W,0,1,1,0,2
Hurricane,Emily,32,2005-07-18T21:00:00Z,MMTM 222N 979W,6,7,2,0,15
Hurricane,Emily,32,2005-07-18T21:00:00Z,GULF 27N 96W,0,8,3,0,11
Hurricane,Emily,32,2005-07-18T21:00:00Z,MMTX 210N 974W,1,0,2,0,3
Hurricane,Emily,32,2005-07-18T21:00:00Z,GULF 25N 96W,25,7,0,0,32
Hurricane,Emily,32,2005-07-18T21:00:00Z,MMMD 210N 897W,5,0,0,0,5
Hurricane,Emily,33,2005-07-19T03:00:00Z,24.2N  96.2W,44,0,0,0,44
Hurricane,Emily,33,2005-07-19T03:00:00Z,PORT O CONNOR TX,0,1,1,0,2
Hurricane,Emily,33,2005-07-19T03:00:00Z,24.5N  98.5W,11,19,0,0,30
Hurricane,Emily,33,2005-07-19T03:00:00Z,CORPUSCHRISTI TX,0,3,4,0,7
Hurricane,Emily,33,2005-07-19T03:00:00Z,24.5N 101.0W,0,17,6,0,23
Hurricane,Emily,33,2005-07-19T03:00:00Z,BROWNSVILLE TX,5,17,1,0,23
Hurricane,Emily,33,2005-07-19T03:00:00Z,MMSO 238N 982W,21,8,1,0,30
Hurricane,Emily,33,2005-07-19T03:00:00Z,GULF 27N 96W,1,7,1,0,9
Hurricane,Emily,33,2005-07-19T03:00:00Z,MMTM 222N 979W,7,5,2,0,14
Hurricane,Emily,33,2005-07-19T03:00:00Z,GULF 25N 96W,37,0,0,0,37
Hurricane,Emily,33,2005-07-19T03:00:00Z,MMTX 210N 974W,0,1,2,0,3
Hurricane,Emily,34,2005-07-19T09:00:00Z,24.5N  97.3W,45,0,0,0,45
Hurricane,Emily,34,2005-07-19T09:00:00Z,CORPUSCHRISTI TX,0,3,2,0,5
Hurricane,Emily,34,2005-07-19T09:00:00Z,24.5N  99.6W,15,15,0,0,30
Hurricane,Emily,34,2005-07-19T09:00:00Z,BROWNSVILLE TX,24,3,0,0,27
Hurricane,Emily,34,2005-07-19T09:00:00Z,24.5N 102.0W,0,18,5,0,23
Hurricane,Emily,34,2005-07-19T09:00:00Z,GULF 27N 96W,6,4,0,0,10
Hurricane,Emily,34,2005-07-19T09:00:00Z,MMSO 238N 982W,33,0,0,0,33
Hurricane,Emily,34,2005-07-19T09:00:00Z,GULF 25N 96W,53,0,0,0,53
Hurricane,Emily,34,2005-07-19T09:00:00Z,MMTM 222N 979W,5,3,2,0,10
Hurricane,Emily,35,2005-07-19T15:00:00Z,24.6N  98.0W,41,0,0,0,41
Hurricane,Emily,35,2005-07-19T15:00:00Z,MMTX 210N 974W,0,0,2,0,2
Hurricane,Emily,35,2005-07-19T15:00:00Z,24.6N 100.0W,21,7,1,0,29
Hurricane,Emily,35,2005-07-19T15:00:00Z,CORPUSCHRISTI TX,1,3,2,0,6
Hurricane,Emily,35,2005-07-19T15:00:00Z,24.6N 102.0W,4,16,3,0,23
Hurricane,Emily,35,2005-07-19T15:00:00Z,BROWNSVILLE TX,30,1,0,0,31
Hurricane,Emily,35,2005-07-19T15:00:00Z,MMSO 238N 982W,29,0,1,0,30
Hurricane,Emily,35,2005-07-19T15:00:00Z,GULF 27N 96W,8,1,1,0,10
Hurricane,Emily,35,2005-07-19T15:00:00Z,MMTM 222N 979W,3,4,2,0,9
Hurricane,Emily,35,2005-07-19T15:00:00Z,GULF 25N 96W,67,0,0,0,67
Hurricane,Emily,36,2005-07-19T21:00:00Z,24.7N  99.3W,40,0,0,0,40
Hurricane,Emily,36,2005-07-19T21:00:00Z,CORPUSCHRISTI TX,2,2,0,0,4
Hurricane,Emily,36,2005-07-19T21:00:00Z,24.7N 101.5W,19,9,0,0,28
Hurricane,Emily,36,2005-07-19T21:00:00Z,BROWNSVILLE TX,44,0,0,0,44
Hurricane,Emily,36,2005-07-19T21:00:00Z,,99,0,0,0,99
Hurricane,Emily,36,2005-07-19T21:00:00Z,GULF 27N 96W,6,1,0,0,7
Hurricane,Emily,36,2005-07-19T21:00:00Z,MMSO 238N 982W,38,0,0,0,38
Hurricane,Emily,36,2005-07-19T21:00:00Z,GULF 25N 96W,99,0,0,0,99
Hurricane,Emily,36,2005-07-19T21:00:00Z,MMTM 222N 979W,1,1,0,0,2
Hurricane,Emily,37,2005-07-19T23:00:00Z,24.7N  99.3W,40,0,0,0,40
Hurricane,Emily,37,2005-07-19T23:00:00Z,CORPUSCHRISTI TX,2,2,0,0,4
Hurricane,Emily,37,2005-07-19T23:00:00Z,24.7N 101.5W,19,9,0,0,28
Hurricane,Emily,37,2005-07-19T23:00:00Z,BROWNSVILLE TX,44,0,0,0,44
Hurricane,Emily,37,2005-07-19T23:00:00Z,,99,0,0,0,99
Hurricane,Emily,37,2005-07-19T23:00:00Z,GULF 27N 96W,6,1,0,0,7
Hurricane,Emily,37,2005-07-19T23:00:00Z,MMSO 238N 982W,38,0,0,0,38
Hurricane,Emily,37,2005-07-19T23:00:00Z,GULF 25N 96W,99,0,0,0,99
Hurricane,Emily,37,2005-07-19T23:00:00Z,MMTM 222N 979W,1,1,0,0,2
Hurricane,Emily,38,2005-07-20T03:00:00Z,24.7N 100.2W,39,0,0,0,39
Hurricane,Emily,38,2005-07-20T03:00:00Z,CORPUSCHRISTI TX,2,0,0,0,2
Hurricane,Emily,38,2005-07-20T03:00:00Z,,99,0,0,0,99
Hurricane,Emily,38,2005-07-20T03:00:00Z,BROWNSVILLE TX,54,0,0,0,54
Hurricane,Emily,38,2005-07-20T03:00:00Z,,99,0,0,0,99
Hurricane,Emily,38,2005-07-20T03:00:00Z,GULF 27N 96W,3,0,0,0,3
Hurricane,Emily,38,2005-07-20T03:00:00Z,MMSO 238N 982W,42,0,0,0,42
Hurricane,Emily,38,2005-07-20T03:00:00Z,GULF 25N 96W,99,0,0,0,99
Hurricane,Emily,39,2005-07-20T09:00:00Z,24.8N 100.7W,40,0,0,0,40
Hurricane,Emily,39,2005-07-20T09:00:00Z,MMSO 238N 982W,51,0,0,0,51
Hurricane,Emily,39,2005-07-20T09:00:00Z,,99,0,0,0,99
Hurricane,Emily,39,2005-07-20T09:00:00Z,BROWNSVILLE TX,65,0,0,0,65
Hurricane,Emily,39,2005-07-20T09:00:00Z,,99,0,0,0,99
Hurricane,Emily,39,2005-07-20T09:00:00Z,GULF 25N 96W,99,0,0,0,99
Hurricane,Emily,40,2005-07-20T15:00:00Z,25.2N 101.1W,43,0,0,0,43
Hurricane,Emily,40,2005-07-20T15:00:00Z,MMSO 238N 982W,47,0,0,0,47
Hurricane,Emily,40,2005-07-20T15:00:00Z,,99,0,0,0,99
Hurricane,Emily,40,2005-07-20T15:00:00Z,BROWNSVILLE TX,84,0,0,0,84
Hurricane,Emily,40,2005-07-20T15:00:00Z,,99,0,0,0,99
Tropical Storm,Emily,41,2005-07-20T21:00:00Z,25.1N 103.0W,40,0,0,0,40
Tropical Storm,Emily,41,2005-07-20T21:00:00Z,MMSO 238N 982W,7,0,0,0,7
Tropical Storm,Emily,41,2005-07-20T21:00:00Z,,99,0,0,0,99
Tropical Storm,Emily,41,2005-07-20T21:00:00Z,BROWNSVILLE TX,6,0,0,0,6
Tropical Storm,Emily,41,2005-07-20T21:00:00Z,,99,0,0,0,99
Tropical Storm,Emily,42,2005-07-21T03:00:00Z,,99,0,0,0,99
Tropical Storm,Emily,42,2005-07-21T03:00:00Z,,99,0,0,0,99
Tropical Storm,Emily,42,2005-07-21T03:00:00Z,,99,0,0,0,99
Tropical Depression,Emily,43,2005-07-21T09:00:00Z,,99,0,0,0,99
Tropical Depression,Emily,43,2005-07-21T09:00:00Z,,99,0,0,0,99
Tropical Depression,Emily,43,2005-07-21T09:00:00Z,,99,0,0,0,99
Tropical Depression,Emily,44,2005-07-21T15:00:00Z,,99,0,0,0,99
Tropical Depression,Emily,44,2005-07-21T15:00:00Z,,99,0,0,0,99
Tropical Depression,Emily,44,2005-07-21T15:00:00Z,,99,0,0,0,99
Tropical Depression,Six,1,2005-07-21T21:00:00Z,27.5N  77.5W,53,0,0,0,53
Tropical Depression,Six,1,2005-07-21T21:00:00Z,CHARLESTON SC,0,0,1,8,9
Tropical Depression,Six,1,2005-07-21T21:00:00Z,28.5N  77.6W,37,1,0,0,38
Tropical Depression,Six,1,2005-07-21T21:00:00Z,MYRTLE BEACH SC,0,0,1,6,7
Tropical Depression,Six,1,2005-07-21T21:00:00Z,29.0N  77.0W,30,1,1,0,32
Tropical Depression,Six,1,2005-07-21T21:00:00Z,WILMINGTON NC,0,0,0,5,5
Tropical Depression,Six,1,2005-07-21T21:00:00Z,MYSM 241N 745W,99,0,0,0,99
Tropical Depression,Six,1,2005-07-21T21:00:00Z,MOREHEAD CITY NC,0,0,0,4,4
Tropical Depression,Six,1,2005-07-21T21:00:00Z,MYAK 241N 776W,0,0,0,2,2
Tropical Depression,Six,1,2005-07-21T21:00:00Z,CAPE HATTERAS NC,0,0,0,2,2
Tropical Depression,Six,1,2005-07-21T21:00:00Z,MYNN 251N 775W,25,0,1,0,26
Tropical Depression,Six,1,2005-07-21T21:00:00Z,MARCO ISLAND FL,0,1,0,3,4
Tropical Depression,Six,1,2005-07-21T21:00:00Z,MYGF 266N 787W,30,0,0,0,30
Tropical Depression,Six,1,2005-07-21T21:00:00Z,FT MYERS FL,0,2,0,3,5
Tropical Depression,Six,1,2005-07-21T21:00:00Z,MIAMI FL,3,2,0,2,7
Tropical Depression,Six,1,2005-07-21T21:00:00Z,VENICE FL,0,1,1,3,5
Tropical Depression,Six,1,2005-07-21T21:00:00Z,W PALM BEACH FL,9,3,0,2,14
Tropical Depression,Six,1,2005-07-21T21:00:00Z,TAMPA FL,0,2,2,3,7
Tropical Depression,Six,1,2005-07-21T21:00:00Z,FT PIERCE FL,8,5,1,2,16
Tropical Depression,Six,1,2005-07-21T21:00:00Z,CEDAR KEY FL,0,1,2,4,7
Tropical Depression,Six,1,2005-07-21T21:00:00Z,COCOA BEACH FL,3,8,2,3,16
Tropical Depression,Six,1,2005-07-21T21:00:00Z,ST MARKS FL,0,0,1,3,4
Tropical Depression,Six,1,2005-07-21T21:00:00Z,DAYTONA BEACH FL,0,7,4,4,15
Tropical Depression,Six,1,2005-07-21T21:00:00Z,APALACHICOLA FL,0,0,0,2,2
Tropical Depression,Six,1,2005-07-21T21:00:00Z,JACKSONVILLE FL,0,2,4,5,11
Tropical Depression,Six,1,2005-07-21T21:00:00Z,PANAMA CITY FL,0,0,0,2,2
Tropical Depression,Six,1,2005-07-21T21:00:00Z,SAVANNAH GA,0,0,2,7,9
Tropical Depression,Six,1,2005-07-21T21:00:00Z,GULF 29N 85W,0,0,0,2,2
Tropical Storm,Franklin,2,2005-07-22T00:00:00Z,27.5N  77.5W,55,0,0,0,55
Tropical Storm,Franklin,2,2005-07-22T00:00:00Z,CHARLESTON SC,0,0,2,8,10
Tropical Storm,Franklin,2,2005-07-22T00:00:00Z,28.5N  77.6W,40,0,0,0,40
Tropical Storm,Franklin,2,2005-07-22T00:00:00Z,MYRTLE BEACH SC,0,0,1,8,9
Tropical Storm,Franklin,2,2005-07-22T00:00:00Z,29.0N  77.0W,32,1,1,0,34
Tropical Storm,Franklin,2,2005-07-22T00:00:00Z,WILMINGTON NC,0,0,0,7,7
Tropical Storm,Franklin,2,2005-07-22T00:00:00Z,MYSM 241N 745W,99,0,0,0,99
Tropical Storm,Franklin,2,2005-07-22T00:00:00Z,MOREHEAD CITY NC,0,0,0,5,5
Tropical Storm,Franklin,2,2005-07-22T00:00:00Z,MYEG 235N 758W,0,0,0,2,2
Tropical Storm,Franklin,2,2005-07-22T00:00:00Z,CAPE HATTERAS NC,0,0,0,3,3
Tropical Storm,Franklin,2,2005-07-22T00:00:00Z,MYAK 241N 776W,0,0,0,2,2
Tropical Storm,Franklin,2,2005-07-22T00:00:00Z,MARCO ISLAND FL,0,1,1,2,4
Tropical Storm,Franklin,2,2005-07-22T00:00:00Z,MYNN 251N 775W,25,0,0,0,25
Tropical Storm,Franklin,2,2005-07-22T00:00:00Z,FT MYERS FL,0,2,1,2,5
Tropical Storm,Franklin,2,2005-07-22T00:00:00Z,MYGF 266N 787W,31,0,0,0,31
Tropical Storm,Franklin,2,2005-07-22T00:00:00Z,VENICE FL,0,1,1,3,5
Tropical Storm,Franklin,2,2005-07-22T00:00:00Z,MIAMI FL,4,1,1,2,8
Tropical Storm,Franklin,2,2005-07-22T00:00:00Z,TAMPA FL,0,1,2,4,7
Tropical Storm,Franklin,2,2005-07-22T00:00:00Z,W PALM BEACH FL,10,3,1,1,15
Tropical Storm,Franklin,2,2005-07-22T00:00:00Z,CEDAR KEY FL,0,0,2,5,7
Tropical Storm,Franklin,2,2005-07-22T00:00:00Z,FT PIERCE FL,7,7,1,1,16
Tropical Storm,Franklin,2,2005-07-22T00:00:00Z,ST MARKS FL,0,0,0,4,4
Tropical Storm,Franklin,2,2005-07-22T00:00:00Z,COCOA BEACH FL,3,9,2,2,16
Tropical Storm,Franklin,2,2005-07-22T00:00:00Z,APALACHICOLA FL,0,0,0,3,3
Tropical Storm,Franklin,2,2005-07-22T00:00:00Z,DAYTONA BEACH FL,0,6,5,3,14
Tropical Storm,Franklin,2,2005-07-22T00:00:00Z,PANAMA CITY FL,0,0,0,2,2
Tropical Storm,Franklin,2,2005-07-22T00:00:00Z,JACKSONVILLE FL,0,1,4,6,11
Tropical Storm,Franklin,2,2005-07-22T00:00:00Z,GULF 29N 85W,0,0,0,2,2
Tropical Storm,Franklin,2,2005-07-22T00:00:00Z,SAVANNAH GA,0,0,2,8,10
Tropical Storm,Franklin,3,2005-07-22T03:00:00Z,28.5N  77.4W,49,0,0,0,49
Tropical Storm,Franklin,3,2005-07-22T03:00:00Z,CHARLESTON SC,0,2,4,6,12
Tropical Storm,Franklin,3,2005-07-22T03:00:00Z,29.5N  77.1W,30,1,0,1,32
Tropical Storm,Franklin,3,2005-07-22T03:00:00Z,MYRTLE BEACH SC,0,1,4,7,12
Tropical Storm,Franklin,3,2005-07-22T03:00:00Z,30.0N  76.5W,21,3,1,1,26
Tropical Storm,Franklin,3,2005-07-22T03:00:00Z,WILMINGTON NC,0,0,3,8,11
Tropical Storm,Franklin,3,2005-07-22T03:00:00Z,MYNN 251N 775W,1,0,0,2,3
Tropical Storm,Franklin,3,2005-07-22T03:00:00Z,MOREHEAD CITY NC,0,0,2,8,10
Tropical Storm,Franklin,3,2005-07-22T03:00:00Z,MYGF 266N 787W,25,0,0,0,25
Tropical Storm,Franklin,3,2005-07-22T03:00:00Z,CAPE HATTERAS NC,0,0,1,7,8
Tropical Storm,Franklin,3,2005-07-22T03:00:00Z,MIAMI FL,0,1,0,1,2
Tropical Storm,Franklin,3,2005-07-22T03:00:00Z,NORFOLK VA,0,0,0,3,3
Tropical Storm,Franklin,3,2005-07-22T03:00:00Z,W PALM BEACH FL,5,0,1,1,7
Tropical Storm,Franklin,3,2005-07-22T03:00:00Z,FT MYERS FL,0,0,1,1,2
Tropical Storm,Franklin,3,2005-07-22T03:00:00Z,FT PIERCE FL,7,2,1,1,11
Tropical Storm,Franklin,3,2005-07-22T03:00:00Z,VENICE FL,0,0,1,1,2
Tropical Storm,Franklin,3,2005-07-22T03:00:00Z,COCOA BEACH FL,7,3,1,1,12
Tropical Storm,Franklin,3,2005-07-22T03:00:00Z,TAMPA FL,0,1,1,1,3
Tropical Storm,Franklin,3,2005-07-22T03:00:00Z,DAYTONA BEACH FL,2,6,2,2,12
Tropical Storm,Franklin,3,2005-07-22T03:00:00Z,CEDAR KEY FL,0,1,1,2,4
Tropical Storm,Franklin,3,2005-07-22T03:00:00Z,JACKSONVILLE FL,0,4,3,4,11
Tropical Storm,Franklin,3,2005-07-22T03:00:00Z,ST MARKS FL,0,0,1,2,3
Tropical Storm,Franklin,3,2005-07-22T03:00:00Z,SAVANNAH GA,0,2,4,5,11
Tropical Storm,Franklin,4,2005-07-22T09:00:00Z,29.0N  77.6W,45,0,0,0,45
Tropical Storm,Franklin,4,2005-07-22T09:00:00Z,JACKSONVILLE FL,1,3,2,1,7
Tropical Storm,Franklin,4,2005-07-22T09:00:00Z,29.9N  76.8W,27,2,0,0,29
Tropical Storm,Franklin,4,2005-07-22T09:00:00Z,SAVANNAH GA,0,3,3,3,9
Tropical Storm,Franklin,4,2005-07-22T09:00:00Z,30.5N  75.5W,10,10,2,1,23
Tropical Storm,Franklin,4,2005-07-22T09:00:00Z,CHARLESTON SC,0,3,4,4,11
Tropical Storm,Franklin,4,2005-07-22T09:00:00Z,MYGF 266N 787W,38,0,1,0,39
Tropical Storm,Franklin,4,2005-07-22T09:00:00Z,MYRTLE BEACH SC,0,1,5,6,12
Tropical Storm,Franklin,4,2005-07-22T09:00:00Z,W PALM BEACH FL,6,1,0,0,7
Tropical Storm,Franklin,4,2005-07-22T09:00:00Z,WILMINGTON NC,0,1,4,6,11
Tropical Storm,Franklin,4,2005-07-22T09:00:00Z,FT PIERCE FL,10,0,1,0,11
Tropical Storm,Franklin,4,2005-07-22T09:00:00Z,MOREHEAD CITY NC,0,0,3,8,11
Tropical Storm,Franklin,4,2005-07-22T09:00:00Z,COCOA BEACH FL,8,2,0,0,10
Tropical Storm,Franklin,4,2005-07-22T09:00:00Z,CAPE HATTERAS NC,0,0,2,7,9
Tropical Storm,Franklin,4,2005-07-22T09:00:00Z,DAYTONA BEACH FL,4,3,1,1,9
Tropical Storm,Franklin,4,2005-07-22T09:00:00Z,NORFOLK VA,0,0,0,4,4
Tropical Storm,Franklin,5,2005-07-22T15:00:00Z,29.0N  77.5W,51,0,0,0,51
Tropical Storm,Franklin,5,2005-07-22T15:00:00Z,JACKSONVILLE FL,1,3,1,0,5
Tropical Storm,Franklin,5,2005-07-22T15:00:00Z,29.9N  76.0W,23,4,0,1,28
Tropical Storm,Franklin,5,2005-07-22T15:00:00Z,SAVANNAH GA,0,2,2,2,6
Tropical Storm,Franklin,5,2005-07-22T15:00:00Z,30.4N  74.4W,4,14,2,2,22
Tropical Storm,Franklin,5,2005-07-22T15:00:00Z,CHARLESTON SC,0,2,3,3,8
Tropical Storm,Franklin,5,2005-07-22T15:00:00Z,MYGF 266N 787W,38,0,0,0,38
Tropical Storm,Franklin,5,2005-07-22T15:00:00Z,MYRTLE BEACH SC,0,1,4,4,9
Tropical Storm,Franklin,5,2005-07-22T15:00:00Z,BERMUDA,0,0,0,2,2
Tropical Storm,Franklin,5,2005-07-22T15:00:00Z,WILMINGTON NC,0,0,3,6,9
Tropical Storm,Franklin,5,2005-07-22T15:00:00Z,W PALM BEACH FL,5,1,0,0,6
Tropical Storm,Franklin,5,2005-07-22T15:00:00Z,MOREHEAD CITY NC,0,0,3,6,9
Tropical Storm,Franklin,5,2005-07-22T15:00:00Z,FT PIERCE FL,8,1,0,1,10
Tropical Storm,Franklin,5,2005-07-22T15:00:00Z,CAPE HATTERAS NC,0,0,1,8,9
Tropical Storm,Franklin,5,2005-07-22T15:00:00Z,COCOA BEACH FL,7,2,0,0,9
Tropical Storm,Franklin,5,2005-07-22T15:00:00Z,NORFOLK VA,0,0,0,4,4
Tropical Storm,Franklin,5,2005-07-22T15:00:00Z,DAYTONA BEACH FL,3,4,0,1,8
Tropical Storm,Franklin,5,2005-07-22T15:00:00Z,OCEAN CITY MD,0,0,0,2,2
Tropical Storm,Franklin,6,2005-07-22T21:00:00Z,30.0N  75.4W,32,1,0,0,33
Tropical Storm,Franklin,6,2005-07-22T21:00:00Z,CAPE HATTERAS NC,0,3,5,3,11
Tropical Storm,Franklin,6,2005-07-22T21:00:00Z,30.9N  73.8W,11,11,1,1,24
Tropical Storm,Franklin,6,2005-07-22T21:00:00Z,NORFOLK VA,0,0,3,3,6
Tropical Storm,Franklin,6,2005-07-22T21:00:00Z,31.5N  72.0W,1,10,5,2,18
Tropical Storm,Franklin,6,2005-07-22T21:00:00Z,OCEAN CITY MD,0,0,1,4,5
Tropical Storm,Franklin,6,2005-07-22T21:00:00Z,MYGF 266N 787W,7,1,0,0,8
Tropical Storm,Franklin,6,2005-07-22T21:00:00Z,ATLANTIC CITY NJ,0,0,0,4,4
Tropical Storm,Franklin,6,2005-07-22T21:00:00Z,BERMUDA,0,0,0,5,5
Tropical Storm,Franklin,6,2005-07-22T21:00:00Z,NEW YORK CITY NY,0,0,0,3,3
Tropical Storm,Franklin,6,2005-07-22T21:00:00Z,CHARLESTON SC,0,2,0,1,3
Tropical Storm,Franklin,6,2005-07-22T21:00:00Z,MONTAUK POINT NY,0,0,0,2,2
Tropical Storm,Franklin,6,2005-07-22T21:00:00Z,MYRTLE BEACH SC,0,3,1,1,5
Tropical Storm,Franklin,6,2005-07-22T21:00:00Z,PROVIDENCE RI,0,0,0,2,2
Tropical Storm,Franklin,6,2005-07-22T21:00:00Z,WILMINGTON NC,0,3,3,1,7
Tropical Storm,Franklin,6,2005-07-22T21:00:00Z,NANTUCKET MA,0,0,0,2,2
Tropical Storm,Franklin,6,2005-07-22T21:00:00Z,MOREHEAD CITY NC,0,4,4,2,10
Tropical Storm,Franklin,6,2005-07-22T21:00:00Z,HYANNIS MA,0,0,0,2,2
Tropical Storm,Franklin,7,2005-07-23T03:00:00Z,30.7N  74.1W,31,1,0,0,32
Tropical Storm,Franklin,7,2005-07-23T03:00:00Z,MOREHEAD CITY NC,0,1,1,0,2
Tropical Storm,Franklin,7,2005-07-23T03:00:00Z,31.5N  72.2W,2,17,3,1,23
Tropical Storm,Franklin,7,2005-07-23T03:00:00Z,CAPE HATTERAS NC,0,2,1,1,4
Tropical Storm,Franklin,7,2005-07-23T03:00:00Z,32.2N  69.9W,0,2,12,4,18
Tropical Storm,Franklin,7,2005-07-23T03:00:00Z,NANTUCKET MA,0,0,0,2,2
Tropical Storm,Franklin,7,2005-07-23T03:00:00Z,BERMUDA,0,0,0,9,9
Tropical Storm,Franklin,8,2005-07-23T09:00:00Z,30.8N  73.0W,38,0,0,0,38
Tropical Storm,Franklin,8,2005-07-23T09:00:00Z,BERMUDA,0,0,1,8,9
Tropical Storm,Franklin,8,2005-07-23T09:00:00Z,31.4N  71.0W,5,16,1,1,23
Tropical Storm,Franklin,8,2005-07-23T09:00:00Z,CAPE HATTERAS NC,0,1,0,1,2
Tropical Storm,Franklin,8,2005-07-23T09:00:00Z,31.8N  69.0W,0,7,7,3,17
Tropical Storm,Franklin,9,2005-07-23T15:00:00Z,30.7N  72.1W,34,1,0,0,35
Tropical Storm,Franklin,9,2005-07-23T15:00:00Z,MYSM 241N 745W,0,0,0,2,2
Tropical Storm,Franklin,9,2005-07-23T15:00:00Z,31.1N  70.4W,6,17,2,1,26
Tropical Storm,Franklin,9,2005-07-23T15:00:00Z,BERMUDA,0,0,3,8,11
Tropical Storm,Franklin,9,2005-07-23T15:00:00Z,31.5N  68.7W,0,12,6,2,20
Tropical Storm,Franklin,10,2005-07-23T21:00:00Z,30.8N  71.5W,30,2,0,0,32
Tropical Storm,Franklin,10,2005-07-23T21:00:00Z,31.4N  68.0W,0,12,6,2,20
Tropical Storm,Franklin,10,2005-07-23T21:00:00Z,31.2N  69.6W,4,19,1,1,25
Tropical Storm,Franklin,10,2005-07-23T21:00:00Z,BERMUDA,0,0,6,7,13
Tropical Storm,Franklin,11,2005-07-24T03:00:00Z,31.5N  69.5W,41,0,0,0,41
Tropical Storm,Franklin,11,2005-07-24T03:00:00Z,32.5N  67.0W,7,9,2,1,19
Tropical Storm,Franklin,11,2005-07-24T03:00:00Z,32.0N  68.0W,21,2,1,0,24
Tropical Storm,Franklin,11,2005-07-24T03:00:00Z,BERMUDA,0,7,4,3,14
Tropical Storm,Franklin,12,2005-07-24T09:00:00Z,31.3N  69.2W,37,1,0,0,38
Tropical Storm,Franklin,12,2005-07-24T09:00:00Z,32.0N  66.5W,2,13,3,2,20
Tropical Storm,Franklin,12,2005-07-24T09:00:00Z,31.6N  67.8W,16,7,1,1,25
Tropical Storm,Franklin,12,2005-07-24T09:00:00Z,BERMUDA,0,5,6,5,16
Tropical Storm,Franklin,13,2005-07-24T15:00:00Z,31.5N  68.5W,35,0,1,0,36
Tropical Storm,Franklin,13,2005-07-24T15:00:00Z,BERMUDA,0,7,5,4,16
Tropical Storm,Franklin,13,2005-07-24T15:00:00Z,32.0N  67.4W,19,4,1,1,25
Tropical Storm,Franklin,13,2005-07-24T15:00:00Z,CAPE HATTERAS NC,0,0,0,2,2
Tropical Storm,Franklin,13,2005-07-24T15:00:00Z,32.5N  66.4W,5,10,3,2,20
Tropical Storm,Franklin,14,2005-07-24T21:00:00Z,32.5N  67.7W,29,1,0,1,31
Tropical Storm,Franklin,14,2005-07-24T21:00:00Z,33.9N  65.4W,2,11,3,3,19
Tropical Storm,Franklin,14,2005-07-24T21:00:00Z,33.3N  66.4W,12,7,2,1,22
Tropical Storm,Franklin,14,2005-07-24T21:00:00Z,BERMUDA,1,9,4,3,17
Tropical Storm,Franklin,15,2005-07-25T03:00:00Z,31.0N  70.3W,99,0,0,0,99
Tropical Storm,Franklin,15,2005-07-25T03:00:00Z,BERMUDA,0,1,6,6,13
Tropical Storm,Franklin,15,2005-07-25T03:00:00Z,31.7N  68.5W,13,14,0,1,28
Tropical Storm,Franklin,15,2005-07-25T03:00:00Z,NANTUCKET MA,0,0,0,2,2
Tropical Storm,Franklin,15,2005-07-25T03:00:00Z,32.5N  67.2W,0,12,5,3,20
Tropical Storm,Franklin,15,2005-07-25T03:00:00Z,HYANNIS MA,0,0,0,2,2
Tropical Storm,Franklin,16,2005-07-25T09:00:00Z,31.2N  69.0W,37,0,0,1,38
Tropical Storm,Franklin,16,2005-07-25T09:00:00Z,BERMUDA,0,2,5,6,13
Tropical Storm,Franklin,16,2005-07-25T09:00:00Z,31.6N  68.5W,22,2,1,1,26
Tropical Storm,Franklin,16,2005-07-25T09:00:00Z,MOREHEAD CITY NC,0,0,0,2,2
Tropical Storm,Franklin,16,2005-07-25T09:00:00Z,32.2N  68.0W,13,4,2,2,21
Tropical Storm,Franklin,16,2005-07-25T09:00:00Z,CAPE HATTERAS NC,0,0,0,3,3
Tropical Storm,Franklin,17,2005-07-25T15:00:00Z,31.7N  68.5W,45,0,0,0,45
Tropical Storm,Franklin,17,2005-07-25T15:00:00Z,BERMUDA,0,3,6,5,14
Tropical Storm,Franklin,17,2005-07-25T15:00:00Z,32.2N  68.0W,23,2,0,1,26
Tropical Storm,Franklin,17,2005-07-25T15:00:00Z,MOREHEAD CITY NC,0,0,0,2,2
Tropical Storm,Franklin,17,2005-07-25T15:00:00Z,32.9N  67.3W,10,6,2,2,20
Tropical Storm,Franklin,17,2005-07-25T15:00:00Z,CAPE HATTERAS NC,0,0,0,3,3
Tropical Storm,Franklin,18,2005-07-25T21:00:00Z,31.6N  69.0W,99,0,0,0,99
Tropical Storm,Franklin,18,2005-07-25T21:00:00Z,PROVIDENCE RI,0,0,0,2,2
Tropical Storm,Franklin,18,2005-07-25T21:00:00Z,32.3N  68.5W,32,1,0,1,34
Tropical Storm,Franklin,18,2005-07-25T21:00:00Z,NANTUCKET MA,0,0,0,4,4
Tropical Storm,Franklin,18,2005-07-25T21:00:00Z,33.5N  68.0W,7,9,3,2,21
Tropical Storm,Franklin,18,2005-07-25T21:00:00Z,HYANNIS MA,0,0,0,3,3
Tropical Storm,Franklin,18,2005-07-25T21:00:00Z,BERMUDA,0,3,4,4,11
Tropical Storm,Franklin,18,2005-07-25T21:00:00Z,BOSTON MA,0,0,0,2,2
Tropical Storm,Franklin,18,2005-07-25T21:00:00Z,CAPE HATTERAS NC,0,0,0,2,2
Tropical Storm,Franklin,18,2005-07-25T21:00:00Z,YARMOUTH NS,0,0,0,2,2
Tropical Storm,Franklin,18,2005-07-25T21:00:00Z,MONTAUK POINT NY,0,0,0,2,2
Tropical Storm,Franklin,19,2005-07-26T03:00:00Z,32.0N  67.5W,46,0,0,0,46
Tropical Storm,Franklin,19,2005-07-26T03:00:00Z,PROVIDENCE RI,0,0,0,2,2
Tropical Storm,Franklin,19,2005-07-26T03:00:00Z,33.0N  67.3W,24,2,0,1,27
Tropical Storm,Franklin,19,2005-07-26T03:00:00Z,NANTUCKET MA,0,0,0,4,4
Tropical Storm,Franklin,19,2005-07-26T03:00:00Z,34.0N  67.2W,10,7,2,2,21
Tropical Storm,Franklin,19,2005-07-26T03:00:00Z,HYANNIS MA,0,0,0,3,3
Tropical Storm,Franklin,19,2005-07-26T03:00:00Z,BERMUDA,3,7,3,2,15
Tropical Storm,Franklin,19,2005-07-26T03:00:00Z,BOSTON MA,0,0,0,2,2
Tropical Storm,Franklin,19,2005-07-26T03:00:00Z,CAPE HATTERAS NC,0,0,0,2,2
Tropical Storm,Franklin,19,2005-07-26T03:00:00Z,YARMOUTH NS,0,0,0,2,2
Tropical Storm,Franklin,19,2005-07-26T03:00:00Z,OCEAN CITY MD,0,0,0,2,2
Tropical Storm,Franklin,19,2005-07-26T03:00:00Z,HALIFAX NS,0,0,0,2,2
Tropical Storm,Franklin,19,2005-07-26T03:00:00Z,MONTAUK POINT NY,0,0,0,2,2
Tropical Storm,Franklin,20,2005-07-26T09:00:00Z,32.7N  67.8W,42,0,0,0,42
Tropical Storm,Franklin,20,2005-07-26T09:00:00Z,BOSTON MA,0,0,0,5,5
Tropical Storm,Franklin,20,2005-07-26T09:00:00Z,34.1N  67.7W,13,6,2,1,22
Tropical Storm,Franklin,20,2005-07-26T09:00:00Z,PORTLAND ME,0,0,0,4,4
Tropical Storm,Franklin,20,2005-07-26T09:00:00Z,36.2N  67.0W,0,6,8,3,17
Tropical Storm,Franklin,20,2005-07-26T09:00:00Z,BAR HARBOR ME,0,0,0,5,5
Tropical Storm,Franklin,20,2005-07-26T09:00:00Z,BERMUDA,5,5,3,2,15
Tropical Storm,Franklin,20,2005-07-26T09:00:00Z,EASTPORT ME,0,0,0,5,5
Tropical Storm,Franklin,20,2005-07-26T09:00:00Z,OCEAN CITY MD,0,0,1,1,2
Tropical Storm,Franklin,20,2005-07-26T09:00:00Z,ST JOHN NB,0,0,0,5,5
Tropical Storm,Franklin,20,2005-07-26T09:00:00Z,ATLANTIC CITY NJ,0,0,1,1,2
Tropical Storm,Franklin,20,2005-07-26T09:00:00Z,MONCTON NB,0,0,0,4,4
Tropical Storm,Franklin,20,2005-07-26T09:00:00Z,NEW YORK CITY NY,0,0,1,2,3
Tropical Storm,Franklin,20,2005-07-26T09:00:00Z,YARMOUTH NS,0,0,0,7,7
Tropical Storm,Franklin,20,2005-07-26T09:00:00Z,MONTAUK POINT NY,0,0,1,4,5
Tropical Storm,Franklin,20,2005-07-26T09:00:00Z,HALIFAX NS,0,0,0,5,5
Tropical Storm,Franklin,20,2005-07-26T09:00:00Z,PROVIDENCE RI,0,0,1,4,5
Tropical Storm,Franklin,20,2005-07-26T09:00:00Z,SABLE ISLAND NS,0,0,0,4,4
Tropical Storm,Franklin,20,2005-07-26T09:00:00Z,NANTUCKET MA,0,0,1,7,8
Tropical Storm,Franklin,20,2005-07-26T09:00:00Z,SYDNEY NS,0,0,0,2,2
Tropical Storm,Franklin,20,2005-07-26T09:00:00Z,HYANNIS MA,0,0,1,6,7
Tropical Storm,Franklin,20,2005-07-26T09:00:00Z,EDDY POINT NS,0,0,0,3,3
Tropical Storm,Franklin,21,2005-07-26T15:00:00Z,33.8N  67.7W,42,0,0,0,42
Tropical Storm,Franklin,21,2005-07-26T15:00:00Z,BOSTON MA,0,0,1,5,6
Tropical Storm,Franklin,21,2005-07-26T15:00:00Z,35.2N  67.5W,17,5,1,1,24
Tropical Storm,Franklin,21,2005-07-26T15:00:00Z,PORTLAND ME,0,0,0,5,5
Tropical Storm,Franklin,21,2005-07-26T15:00:00Z,37.1N  66.7W,0,8,7,3,18
Tropical Storm,Franklin,21,2005-07-26T15:00:00Z,BAR HARBOR ME,0,0,0,6,6
Tropical Storm,Franklin,21,2005-07-26T15:00:00Z,BERMUDA,7,3,2,2,14
Tropical Storm,Franklin,21,2005-07-26T15:00:00Z,EASTPORT ME,0,0,0,6,6
Tropical Storm,Franklin,21,2005-07-26T15:00:00Z,OCEAN CITY MD,0,0,0,2,2
Tropical Storm,Franklin,21,2005-07-26T15:00:00Z,ST JOHN NB,0,0,0,5,5
Tropical Storm,Franklin,21,2005-07-26T15:00:00Z,ATLANTIC CITY NJ,0,0,0,2,2
Tropical Storm,Franklin,21,2005-07-26T15:00:00Z,MONCTON NB,0,0,0,4,4
Tropical Storm,Franklin,21,2005-07-26T15:00:00Z,NEW YORK CITY NY,0,0,1,2,3
Tropical Storm,Franklin,21,2005-07-26T15:00:00Z,YARMOUTH NS,0,0,0,7,7
Tropical Storm,Franklin,21,2005-07-26T15:00:00Z,MONTAUK POINT NY,0,0,2,4,6
Tropical Storm,Franklin,21,2005-07-26T15:00:00Z,HALIFAX NS,0,0,0,6,6
Tropical Storm,Franklin,21,2005-07-26T15:00:00Z,PROVIDENCE RI,0,0,2,5,7
Tropical Storm,Franklin,21,2005-07-26T15:00:00Z,SABLE ISLAND NS,0,0,0,4,4
Tropical Storm,Franklin,21,2005-07-26T15:00:00Z,NANTUCKET MA,0,0,3,6,9
Tropical Storm,Franklin,21,2005-07-26T15:00:00Z,SYDNEY NS,0,0,0,2,2
Tropical Storm,Franklin,21,2005-07-26T15:00:00Z,HYANNIS MA,0,0,2,6,8
Tropical Storm,Franklin,21,2005-07-26T15:00:00Z,EDDY POINT NS,0,0,0,4,4
Tropical Storm,Franklin,22,2005-07-26T21:00:00Z,34.6N  67.5W,33,1,0,0,34
Tropical Storm,Franklin,22,2005-07-26T21:00:00Z,BAR HARBOR ME,0,0,1,5,6
Tropical Storm,Franklin,22,2005-07-26T21:00:00Z,36.2N  67.1W,9,10,2,1,22
Tropical Storm,Franklin,22,2005-07-26T21:00:00Z,EASTPORT ME,0,0,0,6,6
Tropical Storm,Franklin,22,2005-07-26T21:00:00Z,37.9N  66.2W,0,7,7,3,17
Tropical Storm,Franklin,22,2005-07-26T21:00:00Z,ST JOHN NB,0,0,0,6,6
Tropical Storm,Franklin,22,2005-07-26T21:00:00Z,BERMUDA,6,3,2,2,13
Tropical Storm,Franklin,22,2005-07-26T21:00:00Z,MONCTON NB,0,0,0,5,5
Tropical Storm,Franklin,22,2005-07-26T21:00:00Z,ATLANTIC CITY NJ,0,0,1,1,2
Tropical Storm,Franklin,22,2005-07-26T21:00:00Z,YARMOUTH NS,0,0,1,7,8
Tropical Storm,Franklin,22,2005-07-26T21:00:00Z,NEW YORK CITY NY,0,0,1,1,2
Tropical Storm,Franklin,22,2005-07-26T21:00:00Z,HALIFAX NS,0,0,0,7,7
Tropical Storm,Franklin,22,2005-07-26T21:00:00Z,MONTAUK POINT NY,0,0,3,3,6
Tropical Storm,Franklin,22,2005-07-26T21:00:00Z,SABLE ISLAND NS,0,0,0,6,6
Tropical Storm,Franklin,22,2005-07-26T21:00:00Z,PROVIDENCE RI,0,0,3,3,6
Tropical Storm,Franklin,22,2005-07-26T21:00:00Z,SYDNEY NS,0,0,0,4,4
Tropical Storm,Franklin,22,2005-07-26T21:00:00Z,NANTUCKET MA,0,0,5,4,9
Tropical Storm,Franklin,22,2005-07-26T21:00:00Z,EDDY POINT NS,0,0,0,5,5
Tropical Storm,Franklin,22,2005-07-26T21:00:00Z,HYANNIS MA,0,0,4,4,8
Tropical Storm,Franklin,22,2005-07-26T21:00:00Z,PTX BASQUES NFLD,0,0,0,2,2
Tropical Storm,Franklin,22,2005-07-26T21:00:00Z,BOSTON MA,0,0,2,4,6
Tropical Storm,Franklin,22,2005-07-26T21:00:00Z,BURGEO NFLD,0,0,0,2,2
Tropical Storm,Franklin,22,2005-07-26T21:00:00Z,PORTLAND ME,0,0,1,4,5
Tropical Storm,Franklin,23,2005-07-27T03:00:00Z,34.4N  68.4W,34,1,0,0,35
Tropical Storm,Franklin,23,2005-07-27T03:00:00Z,PORTLAND ME,0,0,0,6,6
Tropical Storm,Franklin,23,2005-07-27T03:00:00Z,36.0N  67.8W,6,12,2,0,20
Tropical Storm,Franklin,23,2005-07-27T03:00:00Z,BAR HARBOR ME,0,0,0,7,7
Tropical Storm,Franklin,23,2005-07-27T03:00:00Z,38.0N  66.5W,0,3,10,3,16
Tropical Storm,Franklin,23,2005-07-27T03:00:00Z,EASTPORT ME,0,0,0,7,7
Tropical Storm,Franklin,23,2005-07-27T03:00:00Z,BERMUDA,3,5,2,1,11
Tropical Storm,Franklin,23,2005-07-27T03:00:00Z,ST JOHN NB,0,0,0,6,6
Tropical Storm,Franklin,23,2005-07-27T03:00:00Z,OCEAN CITY MD,0,0,2,1,3
Tropical Storm,Franklin,23,2005-07-27T03:00:00Z,MONCTON NB,0,0,0,5,5
Tropical Storm,Franklin,23,2005-07-27T03:00:00Z,ATLANTIC CITY NJ,0,0,2,2,4
Tropical Storm,Franklin,23,2005-07-27T03:00:00Z,YARMOUTH NS,0,0,0,8,8
Tropical Storm,Franklin,23,2005-07-27T03:00:00Z,NEW YORK CITY NY,0,0,2,3,5
Tropical Storm,Franklin,23,2005-07-27T03:00:00Z,HALIFAX NS,0,0,0,7,7
Tropical Storm,Franklin,23,2005-07-27T03:00:00Z,MONTAUK POINT NY,0,0,3,4,7
Tropical Storm,Franklin,23,2005-07-27T03:00:00Z,SABLE ISLAND NS,0,0,0,5,5
Tropical Storm,Franklin,23,2005-07-27T03:00:00Z,PROVIDENCE RI,0,0,2,5,7
Tropical Storm,Franklin,23,2005-07-27T03:00:00Z,SYDNEY NS,0,0,0,3,3
Tropical Storm,Franklin,23,2005-07-27T03:00:00Z,NANTUCKET MA,0,0,4,6,10
Tropical Storm,Franklin,23,2005-07-27T03:00:00Z,EDDY POINT NS,0,0,0,5,5
Tropical Storm,Franklin,23,2005-07-27T03:00:00Z,HYANNIS MA,0,0,3,6,9
Tropical Storm,Franklin,23,2005-07-27T03:00:00Z,PTX BASQUES NFLD,0,0,0,2,2
Tropical Storm,Franklin,23,2005-07-27T03:00:00Z,BOSTON MA,0,0,2,5,7
Tropical Storm,Franklin,24,2005-07-27T09:00:00Z,35.7N  68.2W,36,1,0,0,37
Tropical Storm,Franklin,24,2005-07-27T09:00:00Z,EASTPORT ME,0,0,1,6,7
Tropical Storm,Franklin,24,2005-07-27T09:00:00Z,37.6N  66.9W,3,17,1,1,22
Tropical Storm,Franklin,24,2005-07-27T09:00:00Z,ST JOHN NB,0,0,1,7,8
Tropical Storm,Franklin,24,2005-07-27T09:00:00Z,39.7N  64.5W,0,2,11,3,16
Tropical Storm,Franklin,24,2005-07-27T09:00:00Z,MONCTON NB,0,0,0,7,7
Tropical Storm,Franklin,24,2005-07-27T09:00:00Z,BERMUDA,0,2,2,1,5
Tropical Storm,Franklin,24,2005-07-27T09:00:00Z,YARMOUTH NS,0,0,3,7,10
Tropical Storm,Franklin,24,2005-07-27T09:00:00Z,NEW YORK CITY NY,0,0,1,1,2
Tropical Storm,Franklin,24,2005-07-27T09:00:00Z,HALIFAX NS,0,0,1,9,10
Tropical Storm,Franklin,24,2005-07-27T09:00:00Z,MONTAUK POINT NY,0,1,3,2,6
Tropical Storm,Franklin,24,2005-07-27T09:00:00Z,SABLE ISLAND NS,0,0,0,10,10
Tropical Storm,Franklin,24,2005-07-27T09:00:00Z,PROVIDENCE RI,0,0,4,2,6
Tropical Storm,Franklin,24,2005-07-27T09:00:00Z,SYDNEY NS,0,0,0,8,8
Tropical Storm,Franklin,24,2005-07-27T09:00:00Z,NANTUCKET MA,0,1,7,1,9
Tropical Storm,Franklin,24,2005-07-27T09:00:00Z,EDDY POINT NS,0,0,0,9,9
Tropical Storm,Franklin,24,2005-07-27T09:00:00Z,HYANNIS MA,0,1,5,2,8
Tropical Storm,Franklin,24,2005-07-27T09:00:00Z,PTX BASQUES NFLD,0,0,0,6,6
Tropical Storm,Franklin,24,2005-07-27T09:00:00Z,BOSTON MA,0,0,4,2,6
Tropical Storm,Franklin,24,2005-07-27T09:00:00Z,BURGEO NFLD,0,0,0,5,5
Tropical Storm,Franklin,24,2005-07-27T09:00:00Z,PORTLAND ME,0,0,2,3,5
Tropical Storm,Franklin,24,2005-07-27T09:00:00Z,ILE ST PIERRE,0,0,0,5,5
Tropical Storm,Franklin,24,2005-07-27T09:00:00Z,BAR HARBOR ME,0,0,2,5,7
Tropical Storm,Franklin,24,2005-07-27T09:00:00Z,CAPE RACE NFLD,0,0,0,3,3
Tropical Storm,Franklin,25,2005-07-27T15:00:00Z,36.4N  67.8W,37,1,0,0,38
Tropical Storm,Franklin,25,2005-07-27T15:00:00Z,ST JOHN NB,0,0,1,6,7
Tropical Storm,Franklin,25,2005-07-27T15:00:00Z,38.4N  65.7W,1,18,3,0,22
Tropical Storm,Franklin,25,2005-07-27T15:00:00Z,MONCTON NB,0,0,1,6,7
Tropical Storm,Franklin,25,2005-07-27T15:00:00Z,40.4N  62.8W,0,1,12,3,16
Tropical Storm,Franklin,25,2005-07-27T15:00:00Z,YARMOUTH NS,0,0,5,5,10
Tropical Storm,Franklin,25,2005-07-27T15:00:00Z,BERMUDA,0,1,1,0,2
Tropical Storm,Franklin,25,2005-07-27T15:00:00Z,HALIFAX NS,0,0,2,8,10
Tropical Storm,Franklin,25,2005-07-27T15:00:00Z,MONTAUK POINT NY,0,1,1,1,3
Tropical Storm,Franklin,25,2005-07-27T15:00:00Z,SABLE ISLAND NS,0,0,1,10,11
Tropical Storm,Franklin,25,2005-07-27T15:00:00Z,PROVIDENCE RI,0,1,2,1,4
Tropical Storm,Franklin,25,2005-07-27T15:00:00Z,SYDNEY NS,0,0,0,9,9
Tropical Storm,Franklin,25,2005-07-27T15:00:00Z,NANTUCKET MA,0,2,5,0,7
Tropical Storm,Franklin,25,2005-07-27T15:00:00Z,EDDY POINT NS,0,0,0,9,9
Tropical Storm,Franklin,25,2005-07-27T15:00:00Z,HYANNIS MA,0,1,4,1,6
Tropical Storm,Franklin,25,2005-07-27T15:00:00Z,PTX BASQUES NFLD,0,0,0,7,7
Tropical Storm,Franklin,25,2005-07-27T15:00:00Z,BOSTON MA,0,0,3,1,4
Tropical Storm,Franklin,25,2005-07-27T15:00:00Z,BURGEO NFLD,0,0,0,7,7
Tropical Storm,Franklin,25,2005-07-27T15:00:00Z,PORTLAND ME,0,0,2,2,4
Tropical Storm,Franklin,25,2005-07-27T15:00:00Z,ILE ST PIERRE,0,0,0,7,7
Tropical Storm,Franklin,25,2005-07-27T15:00:00Z,BAR HARBOR ME,0,0,2,4,6
Tropical Storm,Franklin,25,2005-07-27T15:00:00Z,CAPE RACE NFLD,0,0,0,5,5
Tropical Storm,Franklin,25,2005-07-27T15:00:00Z,EASTPORT ME,0,0,2,5,7
Tropical Storm,Franklin,26,2005-07-27T21:00:00Z,37.0N  67.1W,26,4,0,0,30
Tropical Storm,Franklin,26,2005-07-27T21:00:00Z,ST JOHN NB,0,0,3,3,6
Tropical Storm,Franklin,26,2005-07-27T21:00:00Z,38.8N  64.8W,0,16,4,0,20
Tropical Storm,Franklin,26,2005-07-27T21:00:00Z,MONCTON NB,0,0,2,4,6
Tropical Storm,Franklin,26,2005-07-27T21:00:00Z,40.9N  61.5W,0,1,11,3,15
Tropical Storm,Franklin,26,2005-07-27T21:00:00Z,YARMOUTH NS,0,0,6,3,9
Tropical Storm,Franklin,26,2005-07-27T21:00:00Z,BERMUDA,0,2,1,1,4
Tropical Storm,Franklin,26,2005-07-27T21:00:00Z,HALIFAX NS,0,0,5,5,10
Tropical Storm,Franklin,26,2005-07-27T21:00:00Z,MONTAUK POINT NY,0,1,0,1,2
Tropical Storm,Franklin,26,2005-07-27T21:00:00Z,SABLE ISLAND NS,0,0,3,9,12
Tropical Storm,Franklin,26,2005-07-27T21:00:00Z,PROVIDENCE RI,0,1,1,0,2
Tropical Storm,Franklin,26,2005-07-27T21:00:00Z,SYDNEY NS,0,0,1,8,9
Tropical Storm,Franklin,26,2005-07-27T21:00:00Z,NANTUCKET MA,0,3,3,0,6
Tropical Storm,Franklin,26,2005-07-27T21:00:00Z,EDDY POINT NS,0,0,2,8,10
Tropical Storm,Franklin,26,2005-07-27T21:00:00Z,HYANNIS MA,0,2,2,1,5
Tropical Storm,Franklin,26,2005-07-27T21:00:00Z,PTX BASQUES NFLD,0,0,0,7,7
Tropical Storm,Franklin,26,2005-07-27T21:00:00Z,BOSTON MA,0,1,1,0,2
Tropical Storm,Franklin,26,2005-07-27T21:00:00Z,BURGEO NFLD,0,0,0,8,8
Tropical Storm,Franklin,26,2005-07-27T21:00:00Z,PORTLAND ME,0,0,1,1,2
Tropical Storm,Franklin,26,2005-07-27T21:00:00Z,ILE ST PIERRE,0,0,0,8,8
Tropical Storm,Franklin,26,2005-07-27T21:00:00Z,BAR HARBOR ME,0,0,3,1,4
Tropical Storm,Franklin,26,2005-07-27T21:00:00Z,CAPE RACE NFLD,0,0,0,7,7
Tropical Storm,Franklin,26,2005-07-27T21:00:00Z,EASTPORT ME,0,0,3,2,5
Tropical Storm,Franklin,26,2005-07-27T21:00:00Z,HIBERNIA OILFLD,0,0,0,3,3
Tropical Storm,Franklin,27,2005-07-28T03:00:00Z,37.3N  67.1W,30,4,0,0,34
Tropical Storm,Franklin,27,2005-07-28T03:00:00Z,HALIFAX NS,0,0,7,4,11
Tropical Storm,Franklin,27,2005-07-28T03:00:00Z,39.3N  64.4W,0,18,6,0,24
Tropical Storm,Franklin,27,2005-07-28T03:00:00Z,SABLE ISLAND NS,0,0,7,7,14
Tropical Storm,Franklin,27,2005-07-28T03:00:00Z,41.8N  60.3W,0,0,12,4,16
Tropical Storm,Franklin,27,2005-07-28T03:00:00Z,SYDNEY NS,0,0,2,9,11
Tropical Storm,Franklin,27,2005-07-28T03:00:00Z,NANTUCKET MA,0,3,1,0,4
Tropical Storm,Franklin,27,2005-07-28T03:00:00Z,EDDY POINT NS,0,0,4,7,11
Tropical Storm,Franklin,27,2005-07-28T03:00:00Z,HYANNIS MA,0,2,1,0,3
Tropical Storm,Franklin,27,2005-07-28T03:00:00Z,PTX BASQUES NFLD,0,0,0,9,9
Tropical Storm,Franklin,27,2005-07-28T03:00:00Z,BAR HARBOR ME,0,0,2,0,2
Tropical Storm,Franklin,27,2005-07-28T03:00:00Z,BURGEO NFLD,0,0,0,9,9
Tropical Storm,Franklin,27,2005-07-28T03:00:00Z,EASTPORT ME,0,0,3,1,4
Tropical Storm,Franklin,27,2005-07-28T03:00:00Z,ILE ST PIERRE,0,0,0,10,10
Tropical Storm,Franklin,27,2005-07-28T03:00:00Z,ST JOHN NB,0,0,3,3,6
Tropical Storm,Franklin,27,2005-07-28T03:00:00Z,CAPE RACE NFLD,0,0,0,9,9
Tropical Storm,Franklin,27,2005-07-28T03:00:00Z,MONCTON NB,0,0,3,3,6
Tropical Storm,Franklin,27,2005-07-28T03:00:00Z,HIBERNIA OILFLD,0,0,0,5,5
Tropical Storm,Franklin,27,2005-07-28T03:00:00Z,YARMOUTH NS,0,1,6,2,9
Tropical Storm,Franklin,28,2005-07-28T09:00:00Z,38.0N  66.2W,25,2,0,0,27
Tropical Storm,Franklin,28,2005-07-28T09:00:00Z,HALIFAX NS,0,3,8,1,12
Tropical Storm,Franklin,28,2005-07-28T09:00:00Z,40.1N  63.2W,1,16,4,0,21
Tropical Storm,Franklin,28,2005-07-28T09:00:00Z,SABLE ISLAND NS,0,1,11,3,15
Tropical Storm,Franklin,28,2005-07-28T09:00:00Z,42.4N  59.3W,0,1,12,3,16
Tropical Storm,Franklin,28,2005-07-28T09:00:00Z,SYDNEY NS,0,0,6,6,12
Tropical Storm,Franklin,28,2005-07-28T09:00:00Z,BERMUDA,0,1,1,0,2
Tropical Storm,Franklin,28,2005-07-28T09:00:00Z,EDDY POINT NS,0,1,8,3,12
Tropical Storm,Franklin,28,2005-07-28T09:00:00Z,NANTUCKET MA,0,2,0,0,2
Tropical Storm,Franklin,28,2005-07-28T09:00:00Z,PTX BASQUES NFLD,0,0,3,7,10
Tropical Storm,Franklin,28,2005-07-28T09:00:00Z,BAR HARBOR ME,0,1,1,0,2
Tropical Storm,Franklin,28,2005-07-28T09:00:00Z,BURGEO NFLD,0,0,2,8,10
Tropical Storm,Franklin,28,2005-07-28T09:00:00Z,EASTPORT ME,0,1,2,1,4
Tropical Storm,Franklin,28,2005-07-28T09:00:00Z,ILE ST PIERRE,0,0,2,9,11
Tropical Storm,Franklin,28,2005-07-28T09:00:00Z,ST JOHN NB,0,1,4,1,6
Tropical Storm,Franklin,28,2005-07-28T09:00:00Z,CAPE RACE NFLD,0,0,0,10,10
Tropical Storm,Franklin,28,2005-07-28T09:00:00Z,MONCTON NB,0,1,3,2,6
Tropical Storm,Franklin,28,2005-07-28T09:00:00Z,HIBERNIA OILFLD,0,0,0,7,7
Tropical Storm,Franklin,28,2005-07-28T09:00:00Z,YARMOUTH NS,0,4,5,0,9
Tropical Storm,Franklin,29,2005-07-28T15:00:00Z,39.3N  64.9W,28,4,0,0,32
Tropical Storm,Franklin,29,2005-07-28T15:00:00Z,HALIFAX NS,0,6,7,1,14
Tropical Storm,Franklin,29,2005-07-28T15:00:00Z,41.1N  61.6W,1,19,3,0,23
Tropical Storm,Franklin,29,2005-07-28T15:00:00Z,SABLE ISLAND NS,0,4,13,1,18
Tropical Storm,Franklin,29,2005-07-28T15:00:00Z,43.0N  57.7W,0,2,13,2,17
Tropical Storm,Franklin,29,2005-07-28T15:00:00Z,SYDNEY NS,0,1,9,3,13
Tropical Storm,Franklin,29,2005-07-28T15:00:00Z,NANTUCKET MA,2,2,0,0,4
Tropical Storm,Franklin,29,2005-07-28T15:00:00Z,EDDY POINT NS,0,2,10,2,14
Tropical Storm,Franklin,29,2005-07-28T15:00:00Z,HYANNIS MA,1,1,0,0,2
Tropical Storm,Franklin,29,2005-07-28T15:00:00Z,PTX BASQUES NFLD,0,0,5,5,10
Tropical Storm,Franklin,29,2005-07-28T15:00:00Z,BAR HARBOR ME,0,2,1,0,3
Tropical Storm,Franklin,29,2005-07-28T15:00:00Z,BURGEO NFLD,0,0,4,7,11
Tropical Storm,Franklin,29,2005-07-28T15:00:00Z,EASTPORT ME,0,2,3,0,5
Tropical Storm,Franklin,29,2005-07-28T15:00:00Z,ILE ST PIERRE,0,0,4,8,12
Tropical Storm,Franklin,29,2005-07-28T15:00:00Z,ST JOHN NB,0,2,4,1,7
Tropical Storm,Franklin,29,2005-07-28T15:00:00Z,CAPE RACE NFLD,0,0,1,10,11
Tropical Storm,Franklin,29,2005-07-28T15:00:00Z,MONCTON NB,0,1,5,1,7
Tropical Storm,Franklin,29,2005-07-28T15:00:00Z,HIBERNIA OILFLD,0,0,0,7,7
Tropical Storm,Franklin,29,2005-07-28T15:00:00Z,YARMOUTH NS,0,8,3,0,11
Tropical Storm,Franklin,30,2005-07-28T21:00:00Z,41.3N  62.0W,19,2,0,0,21
Tropical Storm,Franklin,30,2005-07-28T21:00:00Z,SABLE ISLAND NS,5,12,1,0,18
Tropical Storm,Franklin,30,2005-07-28T21:00:00Z,43.2N  57.9W,2,14,2,0,18
Tropical Storm,Franklin,30,2005-07-28T21:00:00Z,SYDNEY NS,1,9,2,0,12
Tropical Storm,Franklin,30,2005-07-28T21:00:00Z,45.3N  53.0W,0,4,10,0,14
Tropical Storm,Franklin,30,2005-07-28T21:00:00Z,EDDY POINT NS,3,8,1,0,12
Tropical Storm,Franklin,30,2005-07-28T21:00:00Z,EASTPORT ME,1,1,0,0,2
Tropical Storm,Franklin,30,2005-07-28T21:00:00Z,PTX BASQUES NFLD,0,6,4,0,10
Tropical Storm,Franklin,30,2005-07-28T21:00:00Z,ST JOHN NB,1,2,0,0,3
Tropical Storm,Franklin,30,2005-07-28T21:00:00Z,BURGEO NFLD,0,7,4,0,11
Tropical Storm,Franklin,30,2005-07-28T21:00:00Z,MONCTON NB,1,2,1,0,4
Tropical Storm,Franklin,30,2005-07-28T21:00:00Z,ILE ST PIERRE,0,8,6,0,14
Tropical Storm,Franklin,30,2005-07-28T21:00:00Z,YARMOUTH NS,4,2,0,0,6
Tropical Storm,Franklin,30,2005-07-28T21:00:00Z,CAPE RACE NFLD,0,4,9,0,13
Tropical Storm,Franklin,30,2005-07-28T21:00:00Z,HALIFAX NS,6,5,0,0,11
Tropical Storm,Franklin,30,2005-07-28T21:00:00Z,HIBERNIA OILFLD,0,0,6,0,6
Tropical Storm,Franklin,31,2005-07-29T03:00:00Z,42.8N  59.3W,21,3,0,0,24
Tropical Storm,Franklin,31,2005-07-29T03:00:00Z,EDDY POINT NS,6,5,0,0,11
Tropical Storm,Franklin,31,2005-07-29T03:00:00Z,45.0N  54.5W,1,16,2,0,19
Tropical Storm,Franklin,31,2005-07-29T03:00:00Z,PTX BASQUES NFLD,1,7,2,0,10
Tropical Storm,Franklin,31,2005-07-29T03:00:00Z,47.3N  49.3W,0,3,10,0,13
Tropical Storm,Franklin,31,2005-07-29T03:00:00Z,BURGEO NFLD,1,10,2,0,13
Tropical Storm,Franklin,31,2005-07-29T03:00:00Z,HALIFAX NS,4,1,0,0,5
Tropical Storm,Franklin,31,2005-07-29T03:00:00Z,ILE ST PIERRE,2,13,2,0,17
Tropical Storm,Franklin,31,2005-07-29T03:00:00Z,SABLE ISLAND NS,18,3,0,0,21
Tropical Storm,Franklin,31,2005-07-29T03:00:00Z,CAPE RACE NFLD,0,12,5,0,17
Tropical Storm,Franklin,31,2005-07-29T03:00:00Z,SYDNEY NS,5,7,0,0,12
Tropical Storm,Franklin,31,2005-07-29T03:00:00Z,HIBERNIA OILFLD,0,2,10,0,12
Tropical Storm,Franklin,32,2005-07-29T09:00:00Z,44.2N  56.2W,20,3,0,0,23
Tropical Storm,Franklin,32,2005-07-29T09:00:00Z,PTX BASQUES NFLD,3,3,0,0,6
Tropical Storm,Franklin,32,2005-07-29T09:00:00Z,46.7N  50.7W,0,15,0,0,15
Tropical Storm,Franklin,32,2005-07-29T09:00:00Z,BURGEO NFLD,5,6,0,0,11
Tropical Storm,Franklin,32,2005-07-29T09:00:00Z,SABLE ISLAND NS,25,0,0,0,25
Tropical Storm,Franklin,32,2005-07-29T09:00:00Z,ILE ST PIERRE,9,8,0,0,17
Tropical Storm,Franklin,32,2005-07-29T09:00:00Z,SYDNEY NS,6,2,0,0,8
Tropical Storm,Franklin,32,2005-07-29T09:00:00Z,CAPE RACE NFLD,3,15,0,0,18
Tropical Storm,Franklin,32,2005-07-29T09:00:00Z,EDDY POINT NS,4,1,0,0,5
Tropical Storm,Franklin,32,2005-07-29T09:00:00Z,HIBERNIA OILFLD,0,10,0,0,10
Tropical Storm,Franklin,33,2005-07-29T15:00:00Z,45.5N  53.5W,26,0,0,0,26
Tropical Storm,Franklin,33,2005-07-29T15:00:00Z,PTX BASQUES NFLD,3,0,0,0,3
Tropical Storm,Franklin,33,2005-07-29T15:00:00Z,HALIFAX NS,2,0,0,0,2
Tropical Storm,Franklin,33,2005-07-29T15:00:00Z,BURGEO NFLD,6,0,0,0,6
Tropical Storm,Franklin,33,2005-07-29T15:00:00Z,SABLE ISLAND NS,36,0,0,0,36
Tropical Storm,Franklin,33,2005-07-29T15:00:00Z,ILE ST PIERRE,16,0,0,0,16
Tropical Storm,Franklin,33,2005-07-29T15:00:00Z,SYDNEY NS,7,0,0,0,7
Tropical Storm,Franklin,33,2005-07-29T15:00:00Z,CAPE RACE NFLD,19,0,0,0,19
Tropical Storm,Franklin,33,2005-07-29T15:00:00Z,EDDY POINT NS,6,0,0,0,6
Tropical Storm,Franklin,33,2005-07-29T15:00:00Z,HIBERNIA OILFLD,5,0,0,0,5
Tropical Storm,Franklin,34,2005-07-29T21:00:00Z,47.0N  49.0W,28,0,0,0,28
Tropical Storm,Franklin,34,2005-07-29T21:00:00Z,ILE ST PIERRE,12,0,0,0,12
Tropical Storm,Franklin,34,2005-07-29T21:00:00Z,SABLE ISLAND NS,8,0,0,0,8
Tropical Storm,Franklin,34,2005-07-29T21:00:00Z,CAPE RACE NFLD,31,0,0,0,31
Tropical Storm,Franklin,34,2005-07-29T21:00:00Z,BURGEO NFLD,2,0,0,0,2
Tropical Storm,Franklin,34,2005-07-29T21:00:00Z,HIBERNIA OILFLD,25,0,0,0,25
Tropical Depression,Seven,1,2005-07-23T21:00:00Z,20.4N  96.0W,47,0,0,0,47
Tropical Depression,Seven,1,2005-07-23T21:00:00Z,MMFR 185N 926W,99,0,0,0,99
Tropical Depression,Seven,1,2005-07-23T21:00:00Z,21.1N  97.3W,20,7,1,0,28
Tropical Depression,Seven,1,2005-07-23T21:00:00Z,PORT O CONNOR TX,0,0,0,3,3
Tropical Depression,Seven,1,2005-07-23T21:00:00Z,21.9N  98.8W,1,18,3,2,24
Tropical Depression,Seven,1,2005-07-23T21:00:00Z,CORPUSCHRISTI TX,0,0,0,5,5
Tropical Depression,Seven,1,2005-07-23T21:00:00Z,MMSO 238N 982W,0,6,9,3,18
Tropical Depression,Seven,1,2005-07-23T21:00:00Z,BROWNSVILLE TX,0,0,3,7,10
Tropical Depression,Seven,1,2005-07-23T21:00:00Z,MMTM 222N 979W,2,18,3,1,24
Tropical Depression,Seven,1,2005-07-23T21:00:00Z,GULF 28N 95W,0,0,0,2,2
Tropical Depression,Seven,1,2005-07-23T21:00:00Z,MMTX 210N 974W,20,7,1,0,28
Tropical Depression,Seven,1,2005-07-23T21:00:00Z,GULF 27N 96W,0,0,0,4,4
Tropical Depression,Seven,1,2005-07-23T21:00:00Z,MMVR 192N 961W,35,0,0,0,35
Tropical Depression,Seven,1,2005-07-23T21:00:00Z,GULF 25N 96W,0,1,4,5,10
Tropical Depression,Seven,2,2005-07-24T03:00:00Z,21.0N  97.0W,44,0,0,0,44
Tropical Depression,Seven,2,2005-07-24T03:00:00Z,MMTX 210N 974W,39,1,0,0,40
Tropical Depression,Seven,2,2005-07-24T03:00:00Z,22.0N  98.5W,13,15,0,0,28
Tropical Depression,Seven,2,2005-07-24T03:00:00Z,MMVR 192N 961W,40,0,0,0,40
Tropical Depression,Seven,2,2005-07-24T03:00:00Z,23.0N 100.0W,0,18,4,0,22
Tropical Depression,Seven,2,2005-07-24T03:00:00Z,BROWNSVILLE TX,0,1,5,0,6
Tropical Depression,Seven,2,2005-07-24T03:00:00Z,MMSO 238N 982W,0,14,5,0,19
Tropical Depression,Seven,2,2005-07-24T03:00:00Z,GULF 25N 96W,0,2,4,0,6
Tropical Depression,Seven,2,2005-07-24T03:00:00Z,MMTM 222N 979W,16,12,0,0,28
Tropical Storm,Gert,3,2005-07-24T06:00:00Z,21.0N  97.0W,42,1,0,0,43
Tropical Storm,Gert,3,2005-07-24T06:00:00Z,MMTX 210N 974W,38,0,0,0,38
Tropical Storm,Gert,3,2005-07-24T06:00:00Z,22.0N  98.5W,12,15,1,0,28
Tropical Storm,Gert,3,2005-07-24T06:00:00Z,MMVR 192N 961W,40,0,0,0,40
Tropical Storm,Gert,3,2005-07-24T06:00:00Z,23.0N 100.0W,0,18,4,0,22
Tropical Storm,Gert,3,2005-07-24T06:00:00Z,BROWNSVILLE TX,0,1,5,0,6
Tropical Storm,Gert,3,2005-07-24T06:00:00Z,MMSO 238N 982W,0,15,4,0,19
Tropical Storm,Gert,3,2005-07-24T06:00:00Z,GULF 25N 96W,0,2,4,0,6
Tropical Storm,Gert,3,2005-07-24T06:00:00Z,MMTM 222N 979W,15,12,1,0,28
Tropical Storm,Gert,4,2005-07-24T09:00:00Z,22.0N  98.5W,43,0,0,0,43
Tropical Storm,Gert,4,2005-07-24T09:00:00Z,MMTX 210N 974W,57,0,0,0,57
Tropical Storm,Gert,4,2005-07-24T09:00:00Z,22.8N  99.9W,17,10,0,0,27
Tropical Storm,Gert,4,2005-07-24T09:00:00Z,MMVR 192N 961W,2,0,0,0,2
Tropical Storm,Gert,4,2005-07-24T09:00:00Z,,99,0,0,0,99
Tropical Storm,Gert,4,2005-07-24T09:00:00Z,BROWNSVILLE TX,0,2,0,0,2
Tropical Storm,Gert,4,2005-07-24T09:00:00Z,MMSO 238N 982W,14,6,0,0,20
Tropical Storm,Gert,4,2005-07-24T09:00:00Z,GULF 25N 96W,1,2,0,0,3
Tropical Storm,Gert,4,2005-07-24T09:00:00Z,MMTM 222N 979W,48,0,0,0,48
Tropical Storm,Gert,5,2005-07-24T15:00:00Z,22.3N  98.7W,46,0,0,0,46
Tropical Storm,Gert,5,2005-07-24T15:00:00Z,MMTM 222N 979W,60,0,0,0,60
Tropical Storm,Gert,5,2005-07-24T15:00:00Z,22.7N 100.0W,26,3,0,0,29
Tropical Storm,Gert,5,2005-07-24T15:00:00Z,MMTX 210N 974W,64,0,0,0,64
Tropical Storm,Gert,5,2005-07-24T15:00:00Z,,99,0,0,0,99
Tropical Storm,Gert,5,2005-07-24T15:00:00Z,BROWNSVILLE TX,0,2,0,0,2
Tropical Storm,Gert,5,2005-07-24T15:00:00Z,MMSO 238N 982W,20,2,0,0,22
Tropical Storm,Gert,5,2005-07-24T15:00:00Z,GULF 25N 96W,1,2,0,0,3
Tropical Storm,Gert,6,2005-07-24T21:00:00Z,22.7N  99.7W,45,0,0,0,45
Tropical Storm,Gert,6,2005-07-24T21:00:00Z,MMTM 222N 979W,99,0,0,0,99
Tropical Storm,Gert,6,2005-07-24T21:00:00Z,23.0N 101.0W,26,3,0,0,29
Tropical Storm,Gert,6,2005-07-24T21:00:00Z,MMTX 210N 974W,99,0,0,0,99
Tropical Storm,Gert,6,2005-07-24T21:00:00Z,,99,0,0,0,99
Tropical Storm,Gert,6,2005-07-24T21:00:00Z,BROWNSVILLE TX,0,2,0,0,2
Tropical Storm,Gert,6,2005-07-24T21:00:00Z,MMSO 238N 982W,29,0,0,0,29
Tropical Storm,Gert,7,2005-07-25T03:00:00Z,23.1N 100.9W,44,0,0,0,44
Tropical Storm,Gert,7,2005-07-25T03:00:00Z,MMSO 238N 982W,39,0,0,0,39
Tropical Storm,Gert,7,2005-07-25T03:00:00Z,,99,0,0,0,99
Tropical Storm,Gert,7,2005-07-25T03:00:00Z,MMTM 222N 979W,99,0,0,0,99
Tropical Storm,Gert,7,2005-07-25T03:00:00Z,,99,0,0,0,99
Tropical Storm,Gert,7,2005-07-25T03:00:00Z,MMTX 210N 974W,99,0,0,0,99
Tropical Depression,Gert,8,2005-07-25T09:00:00Z,,99,0,0,0,99
Tropical Depression,Gert,8,2005-07-25T09:00:00Z,MMSO 238N 982W,46,0,0,0,46
Tropical Depression,Gert,8,2005-07-25T09:00:00Z,,99,0,0,0,99
Tropical Depression,Gert,8,2005-07-25T09:00:00Z,MMTM 222N 979W,99,0,0,0,99
Tropical Depression,Gert,8,2005-07-25T09:00:00Z,,99,0,0,0,99
Tropical Depression,Gert,9,2005-07-25T15:00:00Z,,99,0,0,0,99
Tropical Depression,Gert,9,2005-07-25T15:00:00Z,,99,0,0,0,99
Tropical Depression,Gert,9,2005-07-25T15:00:00Z,,99,0,0,0,99
Tropical Depression,Eight,1,2005-08-02T21:00:00Z,32.0N  66.7W,30,2,0,0,32
Tropical Depression,Eight,1,2005-08-02T21:00:00Z,BERMUDA,4,16,1,1,22
Tropical Depression,Eight,1,2005-08-02T21:00:00Z,33.3N  64.7W,1,16,3,0,20
Tropical Depression,Eight,1,2005-08-02T21:00:00Z,SABLE ISLAND NS,0,0,0,2,2
Tropical Depression,Eight,1,2005-08-02T21:00:00Z,33.8N  62.2W,0,3,10,3,16
Tropical Depression,Eight,2,2005-08-03T03:00:00Z,31.7N  66.2W,30,2,0,0,32
Tropical Depression,Eight,2,2005-08-03T03:00:00Z,33.6N  61.1W,0,2,11,3,16
Tropical Depression,Eight,2,2005-08-03T03:00:00Z,32.8N  63.9W,1,16,3,1,21
Tropical Depression,Eight,2,2005-08-03T03:00:00Z,BERMUDA,5,17,1,0,23
Tropical Depression,Eight,3,2005-08-03T09:00:00Z,32.1N  65.3W,29,2,0,0,31
Tropical Depression,Eight,3,2005-08-03T09:00:00Z,33.7N  60.0W,0,2,11,3,16
Tropical Depression,Eight,3,2005-08-03T09:00:00Z,33.1N  62.7W,1,16,3,1,21
Tropical Depression,Eight,3,2005-08-03T09:00:00Z,BERMUDA,20,7,0,1,28
Tropical Storm,Harvey,4,2005-08-03T15:00:00Z,32.6N  64.3W,22,2,0,1,25
Tropical Storm,Harvey,4,2005-08-03T15:00:00Z,BERMUDA,26,1,0,0,27
Tropical Storm,Harvey,4,2005-08-03T15:00:00Z,33.3N  61.7W,1,13,3,1,18
Tropical Storm,Harvey,4,2005-08-03T15:00:00Z,SABLE ISLAND NS,0,0,0,2,2
Tropical Storm,Harvey,4,2005-08-03T15:00:00Z,34.0N  59.5W,0,4,8,3,15
Tropical Storm,Harvey,5,2005-08-03T18:00:00Z,32.6N  64.3W,27,2,0,0,29
Tropical Storm,Harvey,5,2005-08-03T18:00:00Z,34.0N  59.5W,0,6,8,3,17
Tropical Storm,Harvey,5,2005-08-03T18:00:00Z,33.3N  61.7W,2,15,3,1,21
Tropical Storm,Harvey,5,2005-08-03T18:00:00Z,BERMUDA,32,0,0,0,32
Tropical Storm,Harvey,6,2005-08-03T21:00:00Z,32.5N  63.7W,26,1,0,1,28
Tropical Storm,Harvey,6,2005-08-03T21:00:00Z,33.5N  59.5W,0,8,6,3,17
Tropical Storm,Harvey,6,2005-08-03T21:00:00Z,33.0N  61.5W,3,13,3,1,20
Tropical Storm,Harvey,6,2005-08-03T21:00:00Z,BERMUDA,35,0,0,1,36
Tropical Storm,Harvey,7,2005-08-04T03:00:00Z,32.8N  62.0W,27,1,0,0,28
Tropical Storm,Harvey,7,2005-08-04T03:00:00Z,33.5N  58.5W,2,8,4,3,17
Tropical Storm,Harvey,7,2005-08-04T03:00:00Z,33.0N  60.0W,9,7,2,1,19
Tropical Storm,Harvey,7,2005-08-04T03:00:00Z,BERMUDA,60,0,0,0,60
Tropical Storm,Harvey,8,2005-08-04T09:00:00Z,32.6N  60.8W,29,1,0,0,30
Tropical Storm,Harvey,8,2005-08-04T09:00:00Z,33.3N  58.3W,5,8,4,2,19
Tropical Storm,Harvey,8,2005-08-04T09:00:00Z,32.9N  59.5W,15,5,1,1,22
Tropical Storm,Harvey,8,2005-08-04T09:00:00Z,BERMUDA,99,0,0,0,99
Tropical Storm,Harvey,9,2005-08-04T15:00:00Z,32.6N  59.7W,30,0,1,0,31
Tropical Storm,Harvey,9,2005-08-04T15:00:00Z,33.5N  57.0W,2,12,3,2,19
Tropical Storm,Harvey,9,2005-08-04T15:00:00Z,33.0N  58.0W,8,11,2,1,22
Tropical Storm,Harvey,9,2005-08-04T15:00:00Z,BERMUDA,99,0,0,0,99
Tropical Storm,Harvey,10,2005-08-04T21:00:00Z,33.2N  58.5W,29,0,1,0,30
Tropical Storm,Harvey,10,2005-08-04T21:00:00Z,34.5N  56.0W,4,10,3,2,19
Tropical Storm,Harvey,10,2005-08-04T21:00:00Z,34.0N  57.0W,12,7,1,2,22
Tropical Storm,Harvey,10,2005-08-04T21:00:00Z,BERMUDA,0,1,2,3,6
Tropical Storm,Harvey,11,2005-08-05T03:00:00Z,33.4N  57.4W,30,1,0,0,31
Tropical Storm,Harvey,11,2005-08-05T03:00:00Z,35.4N  55.2W,2,9,4,3,18
Tropical Storm,Harvey,11,2005-08-05T03:00:00Z,34.1N  56.4W,16,4,2,0,22
Tropical Storm,Harvey,11,2005-08-05T03:00:00Z,BERMUDA,0,0,0,2,2
Tropical Storm,Harvey,12,2005-08-05T09:00:00Z,33.5N  57.0W,35,0,0,0,35
Tropical Storm,Harvey,12,2005-08-05T09:00:00Z,36.0N  55.0W,1,10,5,2,18
Tropical Storm,Harvey,12,2005-08-05T09:00:00Z,34.6N  56.1W,14,6,1,1,22
Tropical Storm,Harvey,13,2005-08-05T15:00:00Z,34.0N  56.5W,35,0,1,0,36
Tropical Storm,Harvey,13,2005-08-05T15:00:00Z,37.0N  54.5W,1,10,4,3,18
Tropical Storm,Harvey,13,2005-08-05T15:00:00Z,35.5N  56.0W,16,5,1,1,23
Tropical Storm,Harvey,13,2005-08-05T15:00:00Z,HIBERNIA OILFLD,0,0,0,2,2
Tropical Storm,Harvey,14,2005-08-05T21:00:00Z,34.1N  55.5W,30,0,0,0,30
Tropical Storm,Harvey,14,2005-08-05T21:00:00Z,SABLE ISLAND NS,0,0,0,2,2
Tropical Storm,Harvey,14,2005-08-05T21:00:00Z,36.1N  54.5W,12,8,1,0,21
Tropical Storm,Harvey,14,2005-08-05T21:00:00Z,ILE ST PIERRE,0,0,0,2,2
Tropical Storm,Harvey,14,2005-08-05T21:00:00Z,38.0N  53.0W,1,13,3,1,18
Tropical Storm,Harvey,14,2005-08-05T21:00:00Z,CAPE RACE NFLD,0,0,0,4,4
Tropical Storm,Harvey,14,2005-08-05T21:00:00Z,BERMUDA,0,1,0,1,2
Tropical Storm,Harvey,14,2005-08-05T21:00:00Z,HIBERNIA OILFLD,0,0,0,5,5
Tropical Storm,Harvey,15,2005-08-06T03:00:00Z,34.5N  55.3W,30,0,0,0,30
Tropical Storm,Harvey,15,2005-08-06T03:00:00Z,ILE ST PIERRE,0,0,0,2,2
Tropical Storm,Harvey,15,2005-08-06T03:00:00Z,36.1N  54.4W,17,4,1,1,23
Tropical Storm,Harvey,15,2005-08-06T03:00:00Z,CAPE RACE NFLD,0,0,0,4,4
Tropical Storm,Harvey,15,2005-08-06T03:00:00Z,38.0N  52.5W,2,12,4,1,19
Tropical Storm,Harvey,15,2005-08-06T03:00:00Z,HIBERNIA OILFLD,0,0,0,6,6
Tropical Storm,Harvey,16,2005-08-06T09:00:00Z,35.6N  55.1W,26,1,0,0,27
Tropical Storm,Harvey,16,2005-08-06T09:00:00Z,ILE ST PIERRE,0,0,0,2,2
Tropical Storm,Harvey,16,2005-08-06T09:00:00Z,37.2N  53.8W,11,7,2,0,20
Tropical Storm,Harvey,16,2005-08-06T09:00:00Z,CAPE RACE NFLD,0,0,2,4,6
Tropical Storm,Harvey,16,2005-08-06T09:00:00Z,39.2N  51.2W,0,9,7,1,17
Tropical Storm,Harvey,16,2005-08-06T09:00:00Z,HIBERNIA OILFLD,0,0,3,6,9
Tropical Storm,Harvey,17,2005-08-06T15:00:00Z,36.2N  55.1W,27,1,0,0,28
Tropical Storm,Harvey,17,2005-08-06T15:00:00Z,ILE ST PIERRE,0,0,1,2,3
Tropical Storm,Harvey,17,2005-08-06T15:00:00Z,37.7N  53.4W,10,9,1,1,21
Tropical Storm,Harvey,17,2005-08-06T15:00:00Z,CAPE RACE NFLD,0,0,3,4,7
Tropical Storm,Harvey,17,2005-08-06T15:00:00Z,39.3N  51.1W,0,10,6,2,18
Tropical Storm,Harvey,17,2005-08-06T15:00:00Z,HIBERNIA OILFLD,0,0,2,6,8
Tropical Storm,Harvey,18,2005-08-06T21:00:00Z,35.9N  54.4W,27,1,0,0,28
Tropical Storm,Harvey,18,2005-08-06T21:00:00Z,CAPE RACE NFLD,0,0,0,3,3
Tropical Storm,Harvey,18,2005-08-06T21:00:00Z,37.6N  52.6W,9,11,1,1,22
Tropical Storm,Harvey,18,2005-08-06T21:00:00Z,HIBERNIA OILFLD,0,0,1,5,6
Tropical Storm,Harvey,18,2005-08-06T21:00:00Z,39.3N  50.0W,0,11,6,2,19
Tropical Storm,Harvey,19,2005-08-07T03:00:00Z,37.0N  52.8W,26,1,0,0,27
Tropical Storm,Harvey,19,2005-08-07T03:00:00Z,CAPE RACE NFLD,0,0,1,2,3
Tropical Storm,Harvey,19,2005-08-07T03:00:00Z,38.5N  51.0W,10,9,1,1,21
Tropical Storm,Harvey,19,2005-08-07T03:00:00Z,HIBERNIA OILFLD,0,0,2,5,7
Tropical Storm,Harvey,19,2005-08-07T03:00:00Z,39.7N  48.6W,1,10,5,2,18
Tropical Storm,Harvey,20,2005-08-07T09:00:00Z,37.7N  52.1W,30,0,1,0,31
Tropical Storm,Harvey,20,2005-08-07T09:00:00Z,CAPE RACE NFLD,0,0,0,2,2
Tropical Storm,Harvey,20,2005-08-07T09:00:00Z,38.9N  50.5W,15,5,2,0,22
Tropical Storm,Harvey,20,2005-08-07T09:00:00Z,HIBERNIA OILFLD,0,0,2,4,6
Tropical Storm,Harvey,20,2005-08-07T09:00:00Z,39.9N  48.2W,2,11,4,1,18
Tropical Storm,Harvey,21,2005-08-07T15:00:00Z,38.1N  50.9W,26,1,0,0,27
Tropical Storm,Harvey,21,2005-08-07T15:00:00Z,40.2N  46.4W,2,10,4,2,18
Tropical Storm,Harvey,21,2005-08-07T15:00:00Z,39.3N  48.8W,13,6,2,0,21
Tropical Storm,Harvey,21,2005-08-07T15:00:00Z,HIBERNIA OILFLD,0,0,1,3,4
Tropical Storm,Harvey,22,2005-08-07T21:00:00Z,39.1N  49.5W,21,1,0,1,23
Tropical Storm,Harvey,22,2005-08-07T21:00:00Z,CAPE RACE NFLD,0,1,0,1,2
Tropical Storm,Harvey,22,2005-08-07T21:00:00Z,40.2N  47.2W,9,6,1,1,17
Tropical Storm,Harvey,22,2005-08-07T21:00:00Z,HIBERNIA OILFLD,0,1,3,2,6
Tropical Storm,Harvey,22,2005-08-07T21:00:00Z,41.0N  44.5W,1,8,4,2,15
Tropical Storm,Harvey,23,2005-08-08T03:00:00Z,39.8N  48.1W,27,0,0,0,27
Tropical Storm,Harvey,23,2005-08-08T03:00:00Z,41.5N  44.0W,4,7,2,2,15
Tropical Storm,Harvey,23,2005-08-08T03:00:00Z,40.7N  46.0W,14,3,1,1,19
Tropical Storm,Harvey,23,2005-08-08T03:00:00Z,HIBERNIA OILFLD,0,1,2,2,5
Tropical Storm,Harvey,24,2005-08-08T09:00:00Z,40.9N  46.5W,19,1,1,0,21
Tropical Storm,Harvey,24,2005-08-08T09:00:00Z,42.1N  42.0W,2,7,2,3,14
Tropical Storm,Harvey,24,2005-08-08T09:00:00Z,41.5N  44.3W,10,3,1,2,16
Tropical Storm,Harvey,24,2005-08-08T09:00:00Z,HIBERNIA OILFLD,1,2,1,2,6
Tropical Storm,Harvey,25,2005-08-08T15:00:00Z,42.2N  42.5W,25,1,0,0,26
Tropical Storm,Harvey,25,2005-08-08T15:00:00Z,42.9N  38.0W,2,9,3,2,16
Tropical Storm,Harvey,25,2005-08-08T15:00:00Z,42.7N  40.0W,12,4,2,1,19
Tropical Storm,Harvey,25,2005-08-08T15:00:00Z,HIBERNIA OILFLD,0,0,1,2,3
Tropical Storm,Harvey,26,2005-08-08T21:00:00Z,43.3N  41.0W,23,1,1,0,25
Tropical Storm,Harvey,26,2005-08-08T21:00:00Z,44.6N  36.0W,2,9,3,2,16
Tropical Storm,Harvey,26,2005-08-08T21:00:00Z,44.0N  38.3W,11,5,1,1,18
Tropical Depression,Nine,1,2005-08-04T21:00:00Z,13.5N  38.5W,45,0,0,0,45
Tropical Depression,Nine,1,2005-08-04T21:00:00Z,14.5N  42.5W,1,18,4,1,24
Tropical Depression,Nine,1,2005-08-04T21:00:00Z,14.0N  40.5W,21,9,1,0,31
Tropical Depression,Nine,2,2005-08-05T03:00:00Z,13.7N  38.9W,44,0,0,0,44
Tropical Depression,Nine,2,2005-08-05T03:00:00Z,14.9N  43.2W,0,19,4,2,25
Tropical Depression,Nine,2,2005-08-05T03:00:00Z,14.3N  41.1W,17,14,0,0,31
Tropical Depression,Nine,3,2005-08-05T09:00:00Z,15.9N  39.5W,49,0,0,0,49
Tropical Depression,Nine,3,2005-08-05T09:00:00Z,17.7N  44.4W,0,14,15,0,29
Tropical Depression,Nine,3,2005-08-05T09:00:00Z,16.7N  41.6W,20,15,0,0,35
Tropical Depression,Nine,4,2005-08-05T15:00:00Z,18.5N  41.5W,55,0,0,0,55
Tropical Depression,Nine,4,2005-08-05T15:00:00Z,20.5N  45.0W,0,24,5,1,30
Tropical Depression,Nine,4,2005-08-05T15:00:00Z,19.5N  43.5W,11,27,1,0,39
Tropical Depression,Nine,5,2005-08-05T21:00:00Z,19.0N  43.5W,49,0,0,0,49
Tropical Depression,Nine,5,2005-08-05T21:00:00Z,21.5N  48.0W,0,15,13,1,29
Tropical Depression,Nine,5,2005-08-05T21:00:00Z,20.0N  45.5W,17,17,0,1,35
Tropical Depression,Nine,6,2005-08-06T03:00:00Z,19.6N  44.9W,53,0,0,0,53
Tropical Depression,Nine,6,2005-08-06T03:00:00Z,21.7N  49.0W,0,23,4,1,28
Tropical Depression,Nine,6,2005-08-06T03:00:00Z,20.6N  46.9W,24,13,0,0,37
Tropical Depression,Nine,7,2005-08-06T09:00:00Z,18.8N  46.4W,47,0,0,0,47
Tropical Depression,Nine,7,2005-08-06T09:00:00Z,20.1N  51.0W,0,18,7,1,26
Tropical Depression,Nine,7,2005-08-06T09:00:00Z,19.4N  48.6W,19,14,0,0,33
Tropical Depression,Nine,8,2005-08-06T15:00:00Z,18.9N  46.0W,50,0,0,0,50
Tropical Depression,Nine,8,2005-08-06T15:00:00Z,20.4N  50.0W,1,23,3,1,28
Tropical Depression,Nine,8,2005-08-06T15:00:00Z,19.4N  48.0W,25,11,0,0,36
Tropical Depression,Nine,9,2005-08-06T21:00:00Z,20.3N  46.8W,53,0,0,0,53
Tropical Depression,Nine,9,2005-08-06T21:00:00Z,21.6N  50.3W,2,26,1,1,30
Tropical Depression,Nine,9,2005-08-06T21:00:00Z,21.0N  48.7W,27,10,0,0,37
Tropical Depression,Nine,10,2005-08-07T03:00:00Z,19.7N  47.6W,53,0,0,0,53
Tropical Depression,Nine,10,2005-08-07T03:00:00Z,21.5N  51.0W,5,23,1,1,30
Tropical Depression,Nine,10,2005-08-07T03:00:00Z,20.5N  49.5W,30,7,0,0,37
Tropical Depression,Nine,11,2005-08-07T09:00:00Z,20.7N  48.4W,54,0,0,0,54
Tropical Depression,Nine,11,2005-08-07T09:00:00Z,22.2N  52.0W,3,23,2,1,29
Tropical Depression,Nine,11,2005-08-07T09:00:00Z,21.4N  50.2W,32,6,0,0,38
Tropical Storm,Irene,12,2005-08-07T15:00:00Z,21.5N  49.0W,53,0,0,0,53
Tropical Storm,Irene,12,2005-08-07T15:00:00Z,22.8N  52.1W,4,25,1,0,30
Tropical Storm,Irene,12,2005-08-07T15:00:00Z,22.1N  50.6W,33,6,0,0,39
Tropical Storm,Irene,13,2005-08-07T21:00:00Z,22.4N  49.6W,48,0,0,0,48
Tropical Storm,Irene,13,2005-08-07T21:00:00Z,23.8N  53.0W,2,20,4,1,27
Tropical Storm,Irene,13,2005-08-07T21:00:00Z,23.0N  51.3W,23,9,1,0,33
Tropical Storm,Irene,14,2005-08-08T03:00:00Z,22.9N  50.7W,47,0,0,0,47
Tropical Storm,Irene,14,2005-08-08T03:00:00Z,24.5N  54.0W,2,20,4,1,27
Tropical Storm,Irene,14,2005-08-08T03:00:00Z,23.6N  52.4W,21,11,0,0,32
Tropical Storm,Irene,15,2005-08-08T09:00:00Z,23.4N  52.4W,47,0,0,0,47
Tropical Storm,Irene,15,2005-08-08T09:00:00Z,25.1N  55.9W,0,17,8,1,26
Tropical Storm,Irene,15,2005-08-08T09:00:00Z,24.2N  54.1W,15,16,0,0,31
Tropical Depression,Irene,16,2005-08-08T15:00:00Z,23.5N  54.3W,46,0,0,1,47
Tropical Depression,Irene,16,2005-08-08T15:00:00Z,24.6N  58.8W,0,13,13,0,26
Tropical Depression,Irene,16,2005-08-08T15:00:00Z,24.0N  56.5W,8,24,0,0,32
Tropical Depression,Irene,16,2005-08-08T15:00:00Z,BERMUDA,0,0,0,3,3
Tropical Depression,Irene,17,2005-08-08T21:00:00Z,23.6N  55.4W,50,0,0,0,50
Tropical Depression,Irene,17,2005-08-08T21:00:00Z,25.1N  59.7W,0,15,10,1,26
Tropical Depression,Irene,17,2005-08-08T21:00:00Z,24.3N  57.8W,2,31,1,0,34
Tropical Depression,Irene,17,2005-08-08T21:00:00Z,BERMUDA,0,0,0,6,6
Tropical Depression,Irene,18,2005-08-09T03:00:00Z,23.7N  56.7W,50,1,0,0,51
Tropical Depression,Irene,18,2005-08-09T03:00:00Z,25.5N  61.2W,0,11,16,1,28
Tropical Depression,Irene,18,2005-08-09T03:00:00Z,24.5N  59.0W,3,32,0,0,35
Tropical Depression,Irene,18,2005-08-09T03:00:00Z,BERMUDA,0,0,0,9,9
Tropical Depression,Irene,19,2005-08-09T09:00:00Z,23.0N  57.4W,50,1,0,0,51
Tropical Depression,Irene,19,2005-08-09T09:00:00Z,25.2N  61.4W,0,12,16,0,28
Tropical Depression,Irene,19,2005-08-09T09:00:00Z,23.9N  59.4W,8,27,0,0,35
Tropical Depression,Irene,19,2005-08-09T09:00:00Z,BERMUDA,0,0,0,7,7
Tropical Depression,Irene,20,2005-08-09T15:00:00Z,23.6N  57.9W,50,0,0,1,51
Tropical Depression,Irene,20,2005-08-09T15:00:00Z,26.3N  62.6W,0,7,20,1,28
Tropical Depression,Irene,20,2005-08-09T15:00:00Z,25.0N  60.3W,1,33,0,0,34
Tropical Depression,Irene,20,2005-08-09T15:00:00Z,BERMUDA,0,0,0,9,9
Tropical Depression,Irene,21,2005-08-09T21:00:00Z,23.4N  57.7W,47,0,0,0,47
Tropical Depression,Irene,21,2005-08-09T21:00:00Z,25.7N  60.5W,0,24,3,1,28
Tropical Depression,Irene,21,2005-08-09T21:00:00Z,24.7N  59.5W,9,25,0,1,35
Tropical Depression,Irene,21,2005-08-09T21:00:00Z,BERMUDA,0,0,0,5,5
Tropical Depression,Irene,22,2005-08-10T03:00:00Z,24.0N  59.4W,46,0,0,0,46
Tropical Depression,Irene,22,2005-08-10T03:00:00Z,25.9N  63.9W,0,13,13,1,27
Tropical Depression,Irene,22,2005-08-10T03:00:00Z,25.0N  61.6W,7,25,0,0,32
Tropical Depression,Irene,22,2005-08-10T03:00:00Z,BERMUDA,0,0,0,5,5
Tropical Depression,Irene,23,2005-08-10T09:00:00Z,23.7N  61.1W,50,0,0,0,50
Tropical Depression,Irene,23,2005-08-10T09:00:00Z,25.7N  65.5W,0,11,17,0,28
Tropical Depression,Irene,23,2005-08-10T09:00:00Z,24.6N  63.4W,3,32,1,0,36
Tropical Depression,Irene,23,2005-08-10T09:00:00Z,BERMUDA,0,0,0,4,4
Tropical Depression,Irene,24,2005-08-10T15:00:00Z,23.7N  61.9W,52,0,0,0,52
Tropical Depression,Irene,24,2005-08-10T15:00:00Z,MYMM 224N 730W,0,0,0,2,2
Tropical Depression,Irene,24,2005-08-10T15:00:00Z,24.6N  64.3W,2,34,1,0,37
Tropical Depression,Irene,24,2005-08-10T15:00:00Z,MYSM 241N 745W,0,0,0,2,2
Tropical Depression,Irene,24,2005-08-10T15:00:00Z,25.7N  66.6W,0,9,20,0,29
Tropical Depression,Irene,24,2005-08-10T15:00:00Z,BERMUDA,0,0,0,2,2
Tropical Depression,Irene,24,2005-08-10T15:00:00Z,MBJT 215N 712W,0,0,0,2,2
Tropical Depression,Irene,25,2005-08-10T21:00:00Z,24.1N  62.8W,52,0,0,0,52
Tropical Depression,Irene,25,2005-08-10T21:00:00Z,MYMM 224N 730W,0,0,0,2,2
Tropical Depression,Irene,25,2005-08-10T21:00:00Z,25.1N  65.1W,2,33,0,0,35
Tropical Depression,Irene,25,2005-08-10T21:00:00Z,MYSM 241N 745W,0,0,0,2,2
Tropical Depression,Irene,25,2005-08-10T21:00:00Z,26.1N  67.3W,0,10,17,1,28
Tropical Depression,Irene,25,2005-08-10T21:00:00Z,BERMUDA,0,0,0,3,3
Tropical Depression,Irene,25,2005-08-10T21:00:00Z,MBJT 215N 712W,0,0,0,2,2
Tropical Storm,Irene,26,2005-08-11T03:00:00Z,25.4N  63.8W,46,0,0,0,46
Tropical Storm,Irene,26,2005-08-11T03:00:00Z,27.2N  67.5W,0,18,7,1,26
Tropical Storm,Irene,26,2005-08-11T03:00:00Z,26.3N  65.7W,12,19,0,0,31
Tropical Storm,Irene,26,2005-08-11T03:00:00Z,BERMUDA,0,0,1,2,3
Tropical Storm,Irene,27,2005-08-11T09:00:00Z,26.0N  64.9W,46,0,0,0,46
Tropical Storm,Irene,27,2005-08-11T09:00:00Z,BERMUDA,0,0,1,3,4
Tropical Storm,Irene,27,2005-08-11T09:00:00Z,27.0N  66.7W,13,18,0,0,31
Tropical Storm,Irene,27,2005-08-11T09:00:00Z,MOREHEAD CITY NC,0,0,0,2,2
Tropical Storm,Irene,27,2005-08-11T09:00:00Z,27.9N  68.3W,0,19,6,1,26
Tropical Storm,Irene,27,2005-08-11T09:00:00Z,CAPE HATTERAS NC,0,0,0,2,2
Tropical Storm,Irene,28,2005-08-11T15:00:00Z,27.2N  66.4W,49,0,0,0,49
Tropical Storm,Irene,28,2005-08-11T15:00:00Z,MYRTLE BEACH SC,0,0,0,2,2
Tropical Storm,Irene,28,2005-08-11T15:00:00Z,28.0N  68.0W,24,9,0,0,33
Tropical Storm,Irene,28,2005-08-11T15:00:00Z,WILMINGTON NC,0,0,0,3,3
Tropical Storm,Irene,28,2005-08-11T15:00:00Z,28.6N  69.5W,3,20,3,1,27
Tropical Storm,Irene,28,2005-08-11T15:00:00Z,MOREHEAD CITY NC,0,0,0,4,4
Tropical Storm,Irene,28,2005-08-11T15:00:00Z,BERMUDA,0,0,1,2,3
Tropical Storm,Irene,28,2005-08-11T15:00:00Z,CAPE HATTERAS NC,0,0,0,4,4
Tropical Storm,Irene,28,2005-08-11T15:00:00Z,CHARLESTON SC,0,0,0,2,2
Tropical Storm,Irene,29,2005-08-11T21:00:00Z,27.8N  67.6W,66,0,0,0,66
Tropical Storm,Irene,29,2005-08-11T21:00:00Z,DAYTONA BEACH FL,0,0,0,3,3
Tropical Storm,Irene,29,2005-08-11T21:00:00Z,28.5N  69.1W,30,9,0,0,39
Tropical Storm,Irene,29,2005-08-11T21:00:00Z,JACKSONVILLE FL,0,0,0,3,3
Tropical Storm,Irene,29,2005-08-11T21:00:00Z,29.1N  70.5W,1,22,1,1,25
Tropical Storm,Irene,29,2005-08-11T21:00:00Z,SAVANNAH GA,0,0,0,3,3
Tropical Storm,Irene,29,2005-08-11T21:00:00Z,MYSM 241N 745W,0,0,0,2,2
Tropical Storm,Irene,29,2005-08-11T21:00:00Z,CHARLESTON SC,0,0,0,4,4
Tropical Storm,Irene,29,2005-08-11T21:00:00Z,MYNN 251N 775W,0,0,0,2,2
Tropical Storm,Irene,29,2005-08-11T21:00:00Z,MYRTLE BEACH SC,0,0,0,4,4
Tropical Storm,Irene,29,2005-08-11T21:00:00Z,MYGF 266N 787W,0,0,0,4,4
Tropical Storm,Irene,29,2005-08-11T21:00:00Z,WILMINGTON NC,0,0,0,4,4
Tropical Storm,Irene,29,2005-08-11T21:00:00Z,BERMUDA,0,0,1,4,5
Tropical Storm,Irene,29,2005-08-11T21:00:00Z,MOREHEAD CITY NC,0,0,0,4,4
Tropical Storm,Irene,29,2005-08-11T21:00:00Z,W PALM BEACH FL,0,0,0,2,2
Tropical Storm,Irene,29,2005-08-11T21:00:00Z,CAPE HATTERAS NC,0,0,0,3,3
Tropical Storm,Irene,29,2005-08-11T21:00:00Z,FT PIERCE FL,0,0,0,3,3
Tropical Storm,Irene,29,2005-08-11T21:00:00Z,TAMPA FL,0,0,0,2,2
Tropical Storm,Irene,29,2005-08-11T21:00:00Z,COCOA BEACH FL,0,0,0,3,3
Tropical Storm,Irene,29,2005-08-11T21:00:00Z,CEDAR KEY FL,0,0,0,2,2
Tropical Storm,Irene,30,2005-08-12T03:00:00Z,28.3N  67.9W,67,0,0,0,67
Tropical Storm,Irene,30,2005-08-12T03:00:00Z,JACKSONVILLE FL,0,0,0,3,3
Tropical Storm,Irene,30,2005-08-12T03:00:00Z,29.0N  69.2W,35,5,0,0,40
Tropical Storm,Irene,30,2005-08-12T03:00:00Z,SAVANNAH GA,0,0,0,3,3
Tropical Storm,Irene,30,2005-08-12T03:00:00Z,29.8N  70.5W,2,20,1,1,24
Tropical Storm,Irene,30,2005-08-12T03:00:00Z,CHARLESTON SC,0,0,0,4,4
Tropical Storm,Irene,30,2005-08-12T03:00:00Z,MYGF 266N 787W,0,0,0,2,2
Tropical Storm,Irene,30,2005-08-12T03:00:00Z,MYRTLE BEACH SC,0,0,0,4,4
Tropical Storm,Irene,30,2005-08-12T03:00:00Z,BERMUDA,0,0,1,5,6
Tropical Storm,Irene,30,2005-08-12T03:00:00Z,WILMINGTON NC,0,0,0,4,4
Tropical Storm,Irene,30,2005-08-12T03:00:00Z,W PALM BEACH FL,0,0,0,2,2
Tropical Storm,Irene,30,2005-08-12T03:00:00Z,MOREHEAD CITY NC,0,0,0,5,5
Tropical Storm,Irene,30,2005-08-12T03:00:00Z,FT PIERCE FL,0,0,0,2,2
Tropical Storm,Irene,30,2005-08-12T03:00:00Z,CAPE HATTERAS NC,0,0,0,4,4
Tropical Storm,Irene,30,2005-08-12T03:00:00Z,COCOA BEACH FL,0,0,0,3,3
Tropical Storm,Irene,30,2005-08-12T03:00:00Z,NORFOLK VA,0,0,0,2,2
Tropical Storm,Irene,30,2005-08-12T03:00:00Z,DAYTONA BEACH FL,0,0,0,3,3
Tropical Storm,Irene,31,2005-08-12T09:00:00Z,29.4N  68.0W,74,0,0,0,74
Tropical Storm,Irene,31,2005-08-12T09:00:00Z,MYRTLE BEACH SC,0,0,0,5,5
Tropical Storm,Irene,31,2005-08-12T09:00:00Z,30.1N  69.1W,42,1,0,0,43
Tropical Storm,Irene,31,2005-08-12T09:00:00Z,WILMINGTON NC,0,0,0,6,6
Tropical Storm,Irene,31,2005-08-12T09:00:00Z,31.0N  70.1W,14,11,1,0,26
Tropical Storm,Irene,31,2005-08-12T09:00:00Z,MOREHEAD CITY NC,0,0,0,7,7
Tropical Storm,Irene,31,2005-08-12T09:00:00Z,BERMUDA,0,1,2,5,8
Tropical Storm,Irene,31,2005-08-12T09:00:00Z,CAPE HATTERAS NC,0,0,0,7,7
Tropical Storm,Irene,31,2005-08-12T09:00:00Z,JACKSONVILLE FL,0,0,0,2,2
Tropical Storm,Irene,31,2005-08-12T09:00:00Z,NORFOLK VA,0,0,0,4,4
Tropical Storm,Irene,31,2005-08-12T09:00:00Z,SAVANNAH GA,0,0,0,3,3
Tropical Storm,Irene,31,2005-08-12T09:00:00Z,OCEAN CITY MD,0,0,0,2,2
Tropical Storm,Irene,31,2005-08-12T09:00:00Z,CHARLESTON SC,0,0,0,4,4
Tropical Storm,Irene,32,2005-08-12T15:00:00Z,30.0N  69.3W,75,0,0,0,75
Tropical Storm,Irene,32,2005-08-12T15:00:00Z,MYRTLE BEACH SC,0,0,1,6,7
Tropical Storm,Irene,32,2005-08-12T15:00:00Z,31.0N  70.0W,44,0,0,0,44
Tropical Storm,Irene,32,2005-08-12T15:00:00Z,WILMINGTON NC,0,0,1,7,8
Tropical Storm,Irene,32,2005-08-12T15:00:00Z,32.0N  71.0W,14,9,1,1,25
Tropical Storm,Irene,32,2005-08-12T15:00:00Z,MOREHEAD CITY NC,0,0,2,7,9
Tropical Storm,Irene,32,2005-08-12T15:00:00Z,BERMUDA,0,0,2,5,7
Tropical Storm,Irene,32,2005-08-12T15:00:00Z,CAPE HATTERAS NC,0,0,2,7,9
Tropical Storm,Irene,32,2005-08-12T15:00:00Z,JACKSONVILLE FL,0,0,0,2,2
Tropical Storm,Irene,32,2005-08-12T15:00:00Z,NORFOLK VA,0,0,0,6,6
Tropical Storm,Irene,32,2005-08-12T15:00:00Z,SAVANNAH GA,0,0,0,3,3
Tropical Storm,Irene,32,2005-08-12T15:00:00Z,OCEAN CITY MD,0,0,0,4,4
Tropical Storm,Irene,32,2005-08-12T15:00:00Z,CHARLESTON SC,0,0,0,5,5
Tropical Storm,Irene,32,2005-08-12T15:00:00Z,ATLANTIC CITY NJ,0,0,0,2,2
Tropical Storm,Irene,33,2005-08-12T21:00:00Z,30.8N  70.0W,66,0,0,0,66
Tropical Storm,Irene,33,2005-08-12T21:00:00Z,NORFOLK VA,0,0,1,7,8
Tropical Storm,Irene,33,2005-08-12T21:00:00Z,32.5N  70.5W,25,8,1,0,34
Tropical Storm,Irene,33,2005-08-12T21:00:00Z,OCEAN CITY MD,0,0,0,7,7
Tropical Storm,Irene,33,2005-08-12T21:00:00Z,34.0N  70.5W,1,17,2,1,21
Tropical Storm,Irene,33,2005-08-12T21:00:00Z,ATLANTIC CITY NJ,0,0,0,5,5
Tropical Storm,Irene,33,2005-08-12T21:00:00Z,BERMUDA,0,0,2,4,6
Tropical Storm,Irene,33,2005-08-12T21:00:00Z,NEW YORK CITY NY,0,0,0,3,3
Tropical Storm,Irene,33,2005-08-12T21:00:00Z,CHARLESTON SC,0,0,0,3,3
Tropical Storm,Irene,33,2005-08-12T21:00:00Z,MONTAUK POINT NY,0,0,0,3,3
Tropical Storm,Irene,33,2005-08-12T21:00:00Z,MYRTLE BEACH SC,0,0,1,4,5
Tropical Storm,Irene,33,2005-08-12T21:00:00Z,PROVIDENCE RI,0,0,0,2,2
Tropical Storm,Irene,33,2005-08-12T21:00:00Z,WILMINGTON NC,0,0,2,5,7
Tropical Storm,Irene,33,2005-08-12T21:00:00Z,NANTUCKET MA,0,0,0,2,2
Tropical Storm,Irene,33,2005-08-12T21:00:00Z,MOREHEAD CITY NC,0,0,4,6,10
Tropical Storm,Irene,33,2005-08-12T21:00:00Z,HYANNIS MA,0,0,0,2,2
Tropical Storm,Irene,33,2005-08-12T21:00:00Z,CAPE HATTERAS NC,0,0,6,6,12
Tropical Storm,Irene,34,2005-08-13T03:00:00Z,31.4N  70.3W,64,0,0,0,64
Tropical Storm,Irene,34,2005-08-13T03:00:00Z,NORFOLK VA,0,0,3,7,10
Tropical Storm,Irene,34,2005-08-13T03:00:00Z,33.0N  70.6W,26,6,1,0,33
Tropical Storm,Irene,34,2005-08-13T03:00:00Z,OCEAN CITY MD,0,0,1,8,9
Tropical Storm,Irene,34,2005-08-13T03:00:00Z,34.6N  70.5W,1,14,4,2,21
Tropical Storm,Irene,34,2005-08-13T03:00:00Z,ATLANTIC CITY NJ,0,0,0,6,6
Tropical Storm,Irene,34,2005-08-13T03:00:00Z,BERMUDA,0,0,2,4,6
Tropical Storm,Irene,34,2005-08-13T03:00:00Z,NEW YORK CITY NY,0,0,0,5,5
Tropical Storm,Irene,34,2005-08-13T03:00:00Z,CHARLESTON SC,0,0,0,2,2
Tropical Storm,Irene,34,2005-08-13T03:00:00Z,MONTAUK POINT NY,0,0,0,4,4
Tropical Storm,Irene,34,2005-08-13T03:00:00Z,MYRTLE BEACH SC,0,0,1,3,4
Tropical Storm,Irene,34,2005-08-13T03:00:00Z,PROVIDENCE RI,0,0,0,3,3
Tropical Storm,Irene,34,2005-08-13T03:00:00Z,WILMINGTON NC,0,0,3,4,7
Tropical Storm,Irene,34,2005-08-13T03:00:00Z,NANTUCKET MA,0,0,0,3,3
Tropical Storm,Irene,34,2005-08-13T03:00:00Z,MOREHEAD CITY NC,0,0,5,5,10
Tropical Storm,Irene,34,2005-08-13T03:00:00Z,HYANNIS MA,0,0,0,3,3
Tropical Storm,Irene,34,2005-08-13T03:00:00Z,CAPE HATTERAS NC,0,1,7,4,12
Tropical Storm,Irene,34,2005-08-13T03:00:00Z,BOSTON MA,0,0,0,2,2
Tropical Storm,Irene,35,2005-08-13T09:00:00Z,32.6N  69.8W,54,0,0,0,54
Tropical Storm,Irene,35,2005-08-13T09:00:00Z,ATLANTIC CITY NJ,0,0,1,6,7
Tropical Storm,Irene,35,2005-08-13T09:00:00Z,34.2N  69.8W,18,11,1,0,30
Tropical Storm,Irene,35,2005-08-13T09:00:00Z,NEW YORK CITY NY,0,0,0,6,6
Tropical Storm,Irene,35,2005-08-13T09:00:00Z,36.0N  69.2W,0,11,6,2,19
Tropical Storm,Irene,35,2005-08-13T09:00:00Z,MONTAUK POINT NY,0,0,0,6,6
Tropical Storm,Irene,35,2005-08-13T09:00:00Z,BERMUDA,0,1,2,4,7
Tropical Storm,Irene,35,2005-08-13T09:00:00Z,PROVIDENCE RI,0,0,0,5,5
Tropical Storm,Irene,35,2005-08-13T09:00:00Z,WILMINGTON NC,0,0,1,1,2
Tropical Storm,Irene,35,2005-08-13T09:00:00Z,NANTUCKET MA,0,0,0,6,6
Tropical Storm,Irene,35,2005-08-13T09:00:00Z,MOREHEAD CITY NC,0,0,2,2,4
Tropical Storm,Irene,35,2005-08-13T09:00:00Z,HYANNIS MA,0,0,0,5,5
Tropical Storm,Irene,35,2005-08-13T09:00:00Z,CAPE HATTERAS NC,0,1,4,3,8
Tropical Storm,Irene,35,2005-08-13T09:00:00Z,BOSTON MA,0,0,0,4,4
Tropical Storm,Irene,35,2005-08-13T09:00:00Z,NORFOLK VA,0,0,3,4,7
Tropical Storm,Irene,35,2005-08-13T09:00:00Z,PORTLAND ME,0,0,0,2,2
Tropical Storm,Irene,35,2005-08-13T09:00:00Z,OCEAN CITY MD,0,0,3,5,8
Tropical Storm,Irene,36,2005-08-13T15:00:00Z,33.5N  70.0W,58,0,0,0,58
Tropical Storm,Irene,36,2005-08-13T15:00:00Z,NANTUCKET MA,0,0,2,8,10
Tropical Storm,Irene,36,2005-08-13T15:00:00Z,35.5N  69.4W,9,19,1,0,29
Tropical Storm,Irene,36,2005-08-13T15:00:00Z,HYANNIS MA,0,0,2,7,9
Tropical Storm,Irene,36,2005-08-13T15:00:00Z,37.6N  68.4W,0,7,10,2,19
Tropical Storm,Irene,36,2005-08-13T15:00:00Z,BOSTON MA,0,0,1,6,7
Tropical Storm,Irene,36,2005-08-13T15:00:00Z,BERMUDA,0,0,2,2,4
Tropical Storm,Irene,36,2005-08-13T15:00:00Z,PORTLAND ME,0,0,0,5,5
Tropical Storm,Irene,36,2005-08-13T15:00:00Z,CAPE HATTERAS NC,0,1,2,1,4
Tropical Storm,Irene,36,2005-08-13T15:00:00Z,BAR HARBOR ME,0,0,0,4,4
Tropical Storm,Irene,36,2005-08-13T15:00:00Z,NORFOLK VA,0,0,2,2,4
Tropical Storm,Irene,36,2005-08-13T15:00:00Z,EASTPORT ME,0,0,0,3,3
Tropical Storm,Irene,36,2005-08-13T15:00:00Z,OCEAN CITY MD,0,0,5,2,7
Tropical Storm,Irene,36,2005-08-13T15:00:00Z,ST JOHN NB,0,0,0,2,2
Tropical Storm,Irene,36,2005-08-13T15:00:00Z,ATLANTIC CITY NJ,0,0,4,4,8
Tropical Storm,Irene,36,2005-08-13T15:00:00Z,YARMOUTH NS,0,0,0,4,4
Tropical Storm,Irene,36,2005-08-13T15:00:00Z,NEW YORK CITY NY,0,0,3,5,8
Tropical Storm,Irene,36,2005-08-13T15:00:00Z,HALIFAX NS,0,0,0,2,2
Tropical Storm,Irene,36,2005-08-13T15:00:00Z,MONTAUK POINT NY,0,0,3,6,9
Tropical Storm,Irene,36,2005-08-13T15:00:00Z,SABLE ISLAND NS,0,0,0,2,2
Tropical Storm,Irene,36,2005-08-13T15:00:00Z,PROVIDENCE RI,0,0,1,7,8
Tropical Storm,Irene,37,2005-08-13T21:00:00Z,34.5N  70.0W,36,1,0,0,37
Tropical Storm,Irene,37,2005-08-13T21:00:00Z,HYANNIS MA,0,0,4,5,9
Tropical Storm,Irene,37,2005-08-13T21:00:00Z,36.5N  69.0W,4,16,2,1,23
Tropical Storm,Irene,37,2005-08-13T21:00:00Z,BOSTON MA,0,0,2,5,7
Tropical Storm,Irene,37,2005-08-13T21:00:00Z,38.5N  66.5W,0,3,11,3,17
Tropical Storm,Irene,37,2005-08-13T21:00:00Z,PORTLAND ME,0,0,1,5,6
Tropical Storm,Irene,37,2005-08-13T21:00:00Z,BERMUDA,0,1,3,3,7
Tropical Storm,Irene,37,2005-08-13T21:00:00Z,BAR HARBOR ME,0,0,0,6,6
Tropical Storm,Irene,37,2005-08-13T21:00:00Z,CAPE HATTERAS NC,0,4,1,0,5
Tropical Storm,Irene,37,2005-08-13T21:00:00Z,EASTPORT ME,0,0,0,6,6
Tropical Storm,Irene,37,2005-08-13T21:00:00Z,NORFOLK VA,0,1,2,0,3
Tropical Storm,Irene,37,2005-08-13T21:00:00Z,ST JOHN NB,0,0,0,6,6
Tropical Storm,Irene,37,2005-08-13T21:00:00Z,OCEAN CITY MD,0,1,3,1,5
Tropical Storm,Irene,37,2005-08-13T21:00:00Z,MONCTON NB,0,0,0,5,5
Tropical Storm,Irene,37,2005-08-13T21:00:00Z,ATLANTIC CITY NJ,0,1,2,2,5
Tropical Storm,Irene,37,2005-08-13T21:00:00Z,YARMOUTH NS,0,0,0,8,8
Tropical Storm,Irene,37,2005-08-13T21:00:00Z,NEW YORK CITY NY,0,0,3,2,5
Tropical Storm,Irene,37,2005-08-13T21:00:00Z,HALIFAX NS,0,0,0,7,7
Tropical Storm,Irene,37,2005-08-13T21:00:00Z,MONTAUK POINT NY,0,0,4,4,8
Tropical Storm,Irene,37,2005-08-13T21:00:00Z,SABLE ISLAND NS,0,0,0,6,6
Tropical Storm,Irene,37,2005-08-13T21:00:00Z,PROVIDENCE RI,0,0,3,5,8
Tropical Storm,Irene,37,2005-08-13T21:00:00Z,SYDNEY NS,0,0,0,3,3
Tropical Storm,Irene,37,2005-08-13T21:00:00Z,NANTUCKET MA,0,0,5,5,10
Tropical Storm,Irene,37,2005-08-13T21:00:00Z,EDDY POINT NS,0,0,0,5,5
Tropical Storm,Irene,38,2005-08-14T03:00:00Z,35.6N  69.3W,33,1,0,0,34
Tropical Storm,Irene,38,2005-08-14T03:00:00Z,BAR HARBOR ME,0,0,1,4,5
Tropical Storm,Irene,38,2005-08-14T03:00:00Z,37.4N  67.3W,1,16,2,0,19
Tropical Storm,Irene,38,2005-08-14T03:00:00Z,EASTPORT ME,0,0,1,5,6
Tropical Storm,Irene,38,2005-08-14T03:00:00Z,38.7N  64.3W,0,2,10,3,15
Tropical Storm,Irene,38,2005-08-14T03:00:00Z,ST JOHN NB,0,0,0,6,6
Tropical Storm,Irene,38,2005-08-14T03:00:00Z,BERMUDA,0,3,3,1,7
Tropical Storm,Irene,38,2005-08-14T03:00:00Z,MONCTON NB,0,0,0,5,5
Tropical Storm,Irene,38,2005-08-14T03:00:00Z,ATLANTIC CITY NJ,0,1,0,1,2
Tropical Storm,Irene,38,2005-08-14T03:00:00Z,YARMOUTH NS,0,0,2,6,8
Tropical Storm,Irene,38,2005-08-14T03:00:00Z,NEW YORK CITY NY,0,1,1,0,2
Tropical Storm,Irene,38,2005-08-14T03:00:00Z,HALIFAX NS,0,0,0,8,8
Tropical Storm,Irene,38,2005-08-14T03:00:00Z,MONTAUK POINT NY,0,2,3,1,6
Tropical Storm,Irene,38,2005-08-14T03:00:00Z,SABLE ISLAND NS,0,0,0,8,8
Tropical Storm,Irene,38,2005-08-14T03:00:00Z,PROVIDENCE RI,0,1,3,2,6
Tropical Storm,Irene,38,2005-08-14T03:00:00Z,SYDNEY NS,0,0,0,5,5
Tropical Storm,Irene,38,2005-08-14T03:00:00Z,NANTUCKET MA,0,2,5,2,9
Tropical Storm,Irene,38,2005-08-14T03:00:00Z,EDDY POINT NS,0,0,0,6,6
Tropical Storm,Irene,38,2005-08-14T03:00:00Z,HYANNIS MA,0,1,5,1,7
Tropical Storm,Irene,38,2005-08-14T03:00:00Z,PTX BASQUES NFLD,0,0,0,3,3
Tropical Storm,Irene,38,2005-08-14T03:00:00Z,BOSTON MA,0,0,4,1,5
Tropical Storm,Irene,38,2005-08-14T03:00:00Z,BURGEO NFLD,0,0,0,3,3
Tropical Storm,Irene,38,2005-08-14T03:00:00Z,PORTLAND ME,0,0,2,2,4
Tropical Storm,Irene,38,2005-08-14T03:00:00Z,ILE ST PIERRE,0,0,0,3,3
Tropical Storm,Irene,39,2005-08-14T09:00:00Z,36.1N  68.4W,28,3,0,0,31
Tropical Storm,Irene,39,2005-08-14T09:00:00Z,ST JOHN NB,0,0,1,4,5
Tropical Storm,Irene,39,2005-08-14T09:00:00Z,37.7N  65.9W,0,17,3,0,20
Tropical Storm,Irene,39,2005-08-14T09:00:00Z,MONCTON NB,0,0,0,5,5
Tropical Storm,Irene,39,2005-08-14T09:00:00Z,38.9N  62.8W,0,2,11,3,16
Tropical Storm,Irene,39,2005-08-14T09:00:00Z,YARMOUTH NS,0,0,2,5,7
Tropical Storm,Irene,39,2005-08-14T09:00:00Z,BERMUDA,0,3,3,1,7
Tropical Storm,Irene,39,2005-08-14T09:00:00Z,HALIFAX NS,0,0,1,6,7
Tropical Storm,Irene,39,2005-08-14T09:00:00Z,MONTAUK POINT NY,0,1,1,1,3
Tropical Storm,Irene,39,2005-08-14T09:00:00Z,SABLE ISLAND NS,0,0,0,9,9
Tropical Storm,Irene,39,2005-08-14T09:00:00Z,PROVIDENCE RI,0,1,1,1,3
Tropical Storm,Irene,39,2005-08-14T09:00:00Z,SYDNEY NS,0,0,0,6,6
Tropical Storm,Irene,39,2005-08-14T09:00:00Z,NANTUCKET MA,0,2,3,1,6
Tropical Storm,Irene,39,2005-08-14T09:00:00Z,EDDY POINT NS,0,0,0,7,7
Tropical Storm,Irene,39,2005-08-14T09:00:00Z,HYANNIS MA,0,1,3,1,5
Tropical Storm,Irene,39,2005-08-14T09:00:00Z,PTX BASQUES NFLD,0,0,0,4,4
Tropical Storm,Irene,39,2005-08-14T09:00:00Z,BOSTON MA,0,0,2,1,3
Tropical Storm,Irene,39,2005-08-14T09:00:00Z,BURGEO NFLD,0,0,0,4,4
Tropical Storm,Irene,39,2005-08-14T09:00:00Z,PORTLAND ME,0,0,1,1,2
Tropical Storm,Irene,39,2005-08-14T09:00:00Z,ILE ST PIERRE,0,0,0,5,5
Tropical Storm,Irene,39,2005-08-14T09:00:00Z,BAR HARBOR ME,0,0,1,3,4
Tropical Storm,Irene,39,2005-08-14T09:00:00Z,CAPE RACE NFLD,0,0,0,3,3
Tropical Storm,Irene,39,2005-08-14T09:00:00Z,EASTPORT ME,0,0,1,3,4
Tropical Storm,Irene,40,2005-08-14T15:00:00Z,37.0N  67.3W,23,1,0,0,24
Tropical Storm,Irene,40,2005-08-14T15:00:00Z,ST JOHN NB,0,1,3,2,6
Tropical Storm,Irene,40,2005-08-14T15:00:00Z,38.6N  64.5W,1,13,2,1,17
Tropical Storm,Irene,40,2005-08-14T15:00:00Z,MONCTON NB,0,0,3,3,6
Tropical Storm,Irene,40,2005-08-14T15:00:00Z,39.7N  61.5W,0,3,8,3,14
Tropical Storm,Irene,40,2005-08-14T15:00:00Z,YARMOUTH NS,0,3,4,2,9
Tropical Storm,Irene,40,2005-08-14T15:00:00Z,BERMUDA,1,3,2,1,7
Tropical Storm,Irene,40,2005-08-14T15:00:00Z,HALIFAX NS,0,1,5,3,9
Tropical Storm,Irene,40,2005-08-14T15:00:00Z,MONTAUK POINT NY,0,2,0,0,2
Tropical Storm,Irene,40,2005-08-14T15:00:00Z,SABLE ISLAND NS,0,0,3,8,11
Tropical Storm,Irene,40,2005-08-14T15:00:00Z,PROVIDENCE RI,0,2,1,0,3
Tropical Storm,Irene,40,2005-08-14T15:00:00Z,SYDNEY NS,0,0,1,7,8
Tropical Storm,Irene,40,2005-08-14T15:00:00Z,NANTUCKET MA,1,5,1,0,7
Tropical Storm,Irene,40,2005-08-14T15:00:00Z,EDDY POINT NS,0,0,3,6,9
Tropical Storm,Irene,40,2005-08-14T15:00:00Z,HYANNIS MA,1,3,1,1,6
Tropical Storm,Irene,40,2005-08-14T15:00:00Z,PTX BASQUES NFLD,0,0,0,6,6
Tropical Storm,Irene,40,2005-08-14T15:00:00Z,BOSTON MA,0,2,1,0,3
Tropical Storm,Irene,40,2005-08-14T15:00:00Z,BURGEO NFLD,0,0,0,6,6
Tropical Storm,Irene,40,2005-08-14T15:00:00Z,PORTLAND ME,0,1,1,1,3
Tropical Storm,Irene,40,2005-08-14T15:00:00Z,ILE ST PIERRE,0,0,0,7,7
Tropical Storm,Irene,40,2005-08-14T15:00:00Z,BAR HARBOR ME,0,2,2,1,5
Tropical Storm,Irene,40,2005-08-14T15:00:00Z,CAPE RACE NFLD,0,0,0,5,5
Tropical Storm,Irene,40,2005-08-14T15:00:00Z,EASTPORT ME,0,1,3,2,6
Tropical Storm,Irene,41,2005-08-14T21:00:00Z,37.1N  66.5W,21,1,1,0,23
Tropical Storm,Irene,41,2005-08-14T21:00:00Z,ST JOHN NB,0,1,2,2,5
Tropical Storm,Irene,41,2005-08-14T21:00:00Z,38.4N  64.0W,2,11,3,1,17
Tropical Storm,Irene,41,2005-08-14T21:00:00Z,MONCTON NB,0,0,2,3,5
Tropical Storm,Irene,41,2005-08-14T21:00:00Z,39.5N  61.0W,0,3,8,3,14
Tropical Storm,Irene,41,2005-08-14T21:00:00Z,YARMOUTH NS,0,3,3,2,8
Tropical Storm,Irene,41,2005-08-14T21:00:00Z,BERMUDA,1,4,1,1,7
Tropical Storm,Irene,41,2005-08-14T21:00:00Z,HALIFAX NS,0,1,4,4,9
Tropical Storm,Irene,41,2005-08-14T21:00:00Z,MONTAUK POINT NY,0,1,0,1,2
Tropical Storm,Irene,41,2005-08-14T21:00:00Z,SABLE ISLAND NS,0,0,4,6,10
Tropical Storm,Irene,41,2005-08-14T21:00:00Z,PROVIDENCE RI,0,1,1,0,2
Tropical Storm,Irene,41,2005-08-14T21:00:00Z,SYDNEY NS,0,0,1,7,8
Tropical Storm,Irene,41,2005-08-14T21:00:00Z,NANTUCKET MA,1,3,1,0,5
Tropical Storm,Irene,41,2005-08-14T21:00:00Z,EDDY POINT NS,0,0,3,5,8
Tropical Storm,Irene,41,2005-08-14T21:00:00Z,HYANNIS MA,0,3,1,0,4
Tropical Storm,Irene,41,2005-08-14T21:00:00Z,PTX BASQUES NFLD,0,0,0,6,6
Tropical Storm,Irene,41,2005-08-14T21:00:00Z,BOSTON MA,0,1,1,0,2
Tropical Storm,Irene,41,2005-08-14T21:00:00Z,BURGEO NFLD,0,0,0,6,6
Tropical Storm,Irene,41,2005-08-14T21:00:00Z,PORTLAND ME,0,1,1,0,2
Tropical Storm,Irene,41,2005-08-14T21:00:00Z,ILE ST PIERRE,0,0,0,7,7
Tropical Storm,Irene,41,2005-08-14T21:00:00Z,BAR HARBOR ME,0,1,2,1,4
Tropical Storm,Irene,41,2005-08-14T21:00:00Z,CAPE RACE NFLD,0,0,0,5,5
Tropical Storm,Irene,41,2005-08-14T21:00:00Z,EASTPORT ME,0,1,2,2,5
Tropical Storm,Irene,41,2005-08-14T21:00:00Z,HIBERNIA OILFLD,0,0,0,2,2
Hurricane,Irene,42,2005-08-15T03:00:00Z,37.6N  65.1W,31,0,0,0,31
Hurricane,Irene,42,2005-08-15T03:00:00Z,YARMOUTH NS,0,1,3,2,6
Hurricane,Irene,42,2005-08-15T03:00:00Z,38.8N  62.2W,4,14,2,0,20
Hurricane,Irene,42,2005-08-15T03:00:00Z,HALIFAX NS,0,1,4,3,8
Hurricane,Irene,42,2005-08-15T03:00:00Z,40.0N  59.0W,0,5,8,3,16
Hurricane,Irene,42,2005-08-15T03:00:00Z,SABLE ISLAND NS,0,1,6,5,12
Hurricane,Irene,42,2005-08-15T03:00:00Z,BERMUDA,0,2,1,0,3
Hurricane,Irene,42,2005-08-15T03:00:00Z,SYDNEY NS,0,0,2,6,8
Hurricane,Irene,42,2005-08-15T03:00:00Z,NANTUCKET MA,0,1,1,0,2
Hurricane,Irene,42,2005-08-15T03:00:00Z,EDDY POINT NS,0,0,3,5,8
Hurricane,Irene,42,2005-08-15T03:00:00Z,HYANNIS MA,0,1,0,1,2
Hurricane,Irene,42,2005-08-15T03:00:00Z,PTX BASQUES NFLD,0,0,1,5,6
Hurricane,Irene,42,2005-08-15T03:00:00Z,BAR HARBOR ME,0,0,1,1,2
Hurricane,Irene,42,2005-08-15T03:00:00Z,BURGEO NFLD,0,0,0,7,7
Hurricane,Irene,42,2005-08-15T03:00:00Z,EASTPORT ME,0,0,1,2,3
Hurricane,Irene,42,2005-08-15T03:00:00Z,ILE ST PIERRE,0,0,1,8,9
Hurricane,Irene,42,2005-08-15T03:00:00Z,ST JOHN NB,0,0,2,1,3
Hurricane,Irene,42,2005-08-15T03:00:00Z,CAPE RACE NFLD,0,0,0,8,8
Hurricane,Irene,42,2005-08-15T03:00:00Z,MONCTON NB,0,0,1,3,4
Hurricane,Irene,42,2005-08-15T03:00:00Z,HIBERNIA OILFLD,0,0,0,4,4
Hurricane,Irene,43,2005-08-15T09:00:00Z,38.1N  63.8W,28,2,0,0,30
Hurricane,Irene,43,2005-08-15T09:00:00Z,SYDNEY NS,0,0,4,5,9
Hurricane,Irene,43,2005-08-15T09:00:00Z,39.3N  60.7W,2,18,2,0,22
Hurricane,Irene,43,2005-08-15T09:00:00Z,EDDY POINT NS,0,0,5,4,9
Hurricane,Irene,43,2005-08-15T09:00:00Z,41.3N  57.3W,0,2,13,2,17
Hurricane,Irene,43,2005-08-15T09:00:00Z,PTX BASQUES NFLD,0,0,1,6,7
Hurricane,Irene,43,2005-08-15T09:00:00Z,ST JOHN NB,0,0,1,1,2
Hurricane,Irene,43,2005-08-15T09:00:00Z,BURGEO NFLD,0,0,1,8,9
Hurricane,Irene,43,2005-08-15T09:00:00Z,MONCTON NB,0,0,1,1,2
Hurricane,Irene,43,2005-08-15T09:00:00Z,ILE ST PIERRE,0,0,2,9,11
Hurricane,Irene,43,2005-08-15T09:00:00Z,YARMOUTH NS,0,1,2,0,3
Hurricane,Irene,43,2005-08-15T09:00:00Z,CAPE RACE NFLD,0,0,1,10,11
Hurricane,Irene,43,2005-08-15T09:00:00Z,HALIFAX NS,0,1,4,2,7
Hurricane,Irene,43,2005-08-15T09:00:00Z,HIBERNIA OILFLD,0,0,0,8,8
Hurricane,Irene,43,2005-08-15T09:00:00Z,SABLE ISLAND NS,0,2,10,2,14
Hurricane,Irene,44,2005-08-15T15:00:00Z,38.5N  62.5W,28,1,0,0,29
Hurricane,Irene,44,2005-08-15T15:00:00Z,EDDY POINT NS,0,1,4,1,6
Hurricane,Irene,44,2005-08-15T15:00:00Z,40.0N  59.5W,2,14,2,0,18
Hurricane,Irene,44,2005-08-15T15:00:00Z,PTX BASQUES NFLD,0,0,2,4,6
Hurricane,Irene,44,2005-08-15T15:00:00Z,42.0N  56.0W,0,3,9,2,14
Hurricane,Irene,44,2005-08-15T15:00:00Z,BURGEO NFLD,0,0,3,5,8
Hurricane,Irene,44,2005-08-15T15:00:00Z,HALIFAX NS,0,2,2,1,5
Hurricane,Irene,44,2005-08-15T15:00:00Z,ILE ST PIERRE,0,0,5,5,10
Hurricane,Irene,44,2005-08-15T15:00:00Z,SABLE ISLAND NS,0,5,6,1,12
Hurricane,Irene,44,2005-08-15T15:00:00Z,CAPE RACE NFLD,0,0,3,8,11
Hurricane,Irene,44,2005-08-15T15:00:00Z,SYDNEY NS,0,1,4,2,7
Hurricane,Irene,44,2005-08-15T15:00:00Z,HIBERNIA OILFLD,0,0,0,9,9
Hurricane,Irene,45,2005-08-15T21:00:00Z,38.4N  61.5W,29,2,0,0,31
Hurricane,Irene,45,2005-08-15T21:00:00Z,EDDY POINT NS,0,1,3,3,7
Hurricane,Irene,45,2005-08-15T21:00:00Z,40.0N  58.5W,2,18,4,1,25
Hurricane,Irene,45,2005-08-15T21:00:00Z,PTX BASQUES NFLD,0,0,2,4,6
Hurricane,Irene,45,2005-08-15T21:00:00Z,43.0N  54.0W,0,1,13,3,17
Hurricane,Irene,45,2005-08-15T21:00:00Z,BURGEO NFLD,0,0,3,6,9
Hurricane,Irene,45,2005-08-15T21:00:00Z,HALIFAX NS,0,1,1,1,3
Hurricane,Irene,45,2005-08-15T21:00:00Z,ILE ST PIERRE,0,0,6,6,12
Hurricane,Irene,45,2005-08-15T21:00:00Z,SABLE ISLAND NS,0,5,9,0,14
Hurricane,Irene,45,2005-08-15T21:00:00Z,CAPE RACE NFLD,0,0,5,9,14
Hurricane,Irene,45,2005-08-15T21:00:00Z,SYDNEY NS,0,0,4,3,7
Hurricane,Irene,45,2005-08-15T21:00:00Z,HIBERNIA OILFLD,0,0,1,11,12
Hurricane,Irene,46,2005-08-16T03:00:00Z,38.2N  59.8W,31,2,0,0,33
Hurricane,Irene,46,2005-08-16T03:00:00Z,EDDY POINT NS,0,0,2,1,3
Hurricane,Irene,46,2005-08-16T03:00:00Z,40.4N  56.3W,1,18,4,0,23
Hurricane,Irene,46,2005-08-16T03:00:00Z,PTX BASQUES NFLD,0,0,1,3,4
Hurricane,Irene,46,2005-08-16T03:00:00Z,43.5N  51.5W,0,1,13,3,17
Hurricane,Irene,46,2005-08-16T03:00:00Z,BURGEO NFLD,0,0,2,4,6
Hurricane,Irene,46,2005-08-16T03:00:00Z,HALIFAX NS,0,0,1,1,2
Hurricane,Irene,46,2005-08-16T03:00:00Z,ILE ST PIERRE,0,0,5,5,10
Hurricane,Irene,46,2005-08-16T03:00:00Z,SABLE ISLAND NS,0,4,6,1,11
Hurricane,Irene,46,2005-08-16T03:00:00Z,CAPE RACE NFLD,0,0,7,6,13
Hurricane,Irene,46,2005-08-16T03:00:00Z,SYDNEY NS,0,0,3,1,4
Hurricane,Irene,46,2005-08-16T03:00:00Z,HIBERNIA OILFLD,0,0,3,11,14
Hurricane,Irene,47,2005-08-16T09:00:00Z,37.8N  60.1W,26,3,1,0,30
Hurricane,Irene,47,2005-08-16T09:00:00Z,PTX BASQUES NFLD,0,0,0,2,2
Hurricane,Irene,47,2005-08-16T09:00:00Z,39.8N  56.7W,3,17,9,0,29
Hurricane,Irene,47,2005-08-16T09:00:00Z,BURGEO NFLD,0,0,1,3,4
Hurricane,Irene,47,2005-08-16T09:00:00Z,44.6N  50.1W,0,0,13,6,19
Hurricane,Irene,47,2005-08-16T09:00:00Z,ILE ST PIERRE,0,0,2,5,7
Hurricane,Irene,47,2005-08-16T09:00:00Z,SABLE ISLAND NS,0,0,3,1,4
Hurricane,Irene,47,2005-08-16T09:00:00Z,CAPE RACE NFLD,0,0,5,8,13
Hurricane,Irene,47,2005-08-16T09:00:00Z,SYDNEY NS,0,0,1,1,2
Hurricane,Irene,47,2005-08-16T09:00:00Z,HIBERNIA OILFLD,0,0,4,12,16
Hurricane,Irene,48,2005-08-16T15:00:00Z,38.3N  58.8W,30,3,0,1,34
Hurricane,Irene,48,2005-08-16T15:00:00Z,BURGEO NFLD,0,0,2,1,3
Hurricane,Irene,48,2005-08-16T15:00:00Z,41.0N  54.5W,0,17,8,0,25
Hurricane,Irene,48,2005-08-16T15:00:00Z,ILE ST PIERRE,0,0,5,2,7
Hurricane,Irene,48,2005-08-16T15:00:00Z,46.0N  48.0W,0,0,11,5,16
Hurricane,Irene,48,2005-08-16T15:00:00Z,CAPE RACE NFLD,0,0,10,3,13
Hurricane,Irene,48,2005-08-16T15:00:00Z,SABLE ISLAND NS,0,2,2,0,4
Hurricane,Irene,48,2005-08-16T15:00:00Z,HIBERNIA OILFLD,0,0,9,7,16
Hurricane,Irene,49,2005-08-16T21:00:00Z,38.8N  57.3W,27,6,0,0,33
Hurricane,Irene,49,2005-08-16T21:00:00Z,ILE ST PIERRE,0,0,1,2,3
Hurricane,Irene,49,2005-08-16T21:00:00Z,42.0N  52.5W,1,18,8,0,27
Hurricane,Irene,49,2005-08-16T21:00:00Z,CAPE RACE NFLD,0,1,6,3,10
Hurricane,Irene,49,2005-08-16T21:00:00Z,47.0N  46.0W,0,0,13,4,17
Hurricane,Irene,49,2005-08-16T21:00:00Z,HIBERNIA OILFLD,0,1,12,4,17
Hurricane,Irene,50,2005-08-17T03:00:00Z,39.0N  55.0W,28,8,0,0,36
Hurricane,Irene,50,2005-08-17T03:00:00Z,ILE ST PIERRE,0,0,2,0,2
Hurricane,Irene,50,2005-08-17T03:00:00Z,43.3N  49.3W,0,22,5,0,27
Hurricane,Irene,50,2005-08-17T03:00:00Z,CAPE RACE NFLD,0,1,6,0,7
Hurricane,Irene,50,2005-08-17T03:00:00Z,50.0N  42.0W,0,0,15,0,15
Hurricane,Irene,50,2005-08-17T03:00:00Z,HIBERNIA OILFLD,0,3,17,0,20
Hurricane,Irene,51,2005-08-17T09:00:00Z,41.0N  52.8W,32,6,0,0,38
Hurricane,Irene,51,2005-08-17T09:00:00Z,ILE ST PIERRE,0,2,0,0,2
Hurricane,Irene,51,2005-08-17T09:00:00Z,46.7N  46.5W,0,14,6,0,20
Hurricane,Irene,51,2005-08-17T09:00:00Z,CAPE RACE NFLD,0,8,2,0,10
Hurricane,Irene,51,2005-08-17T09:00:00Z,54.7N  39.2W,0,0,8,0,8
Hurricane,Irene,51,2005-08-17T09:00:00Z,HIBERNIA OILFLD,0,13,6,0,19
Hurricane,Irene,52,2005-08-17T15:00:00Z,43.0N  50.5W,23,7,0,0,30
Hurricane,Irene,52,2005-08-17T15:00:00Z,CAPE RACE NFLD,1,3,0,0,4
Hurricane,Irene,52,2005-08-17T15:00:00Z,50.5N  44.0W,0,12,5,0,17
Hurricane,Irene,52,2005-08-17T15:00:00Z,HIBERNIA OILFLD,1,17,0,0,18
Hurricane,Irene,52,2005-08-17T15:00:00Z,59.5N  36.0W,0,0,8,0,8
Tropical Storm,Irene,53,2005-08-17T21:00:00Z,47.1N  46.9W,26,5,0,0,31
Tropical Storm,Irene,53,2005-08-17T21:00:00Z,CAPE RACE NFLD,4,0,0,0,4
Tropical Storm,Irene,53,2005-08-17T21:00:00Z,55.5N  40.5W,0,12,0,0,12
Tropical Storm,Irene,53,2005-08-17T21:00:00Z,HIBERNIA OILFLD,24,3,0,0,27
Tropical Storm,Irene,54,2005-08-18T03:00:00Z,48.0N  44.5W,25,0,0,0,25
Tropical Storm,Irene,54,2005-08-18T03:00:00Z,HIBERNIA OILFLD,18,0,0,0,18
Tropical Storm,Irene,55,2005-08-18T09:00:00Z,54.0N  40.0W,25,0,0,0,25
Tropical Storm,Irene,55,2005-08-18T09:00:00Z,HIBERNIA OILFLD,12,0,0,0,12
Tropical Depression,Ten,1,2005-08-13T21:00:00Z,16.5N  47.0W,51,0,0,0,51
Tropical Depression,Ten,1,2005-08-13T21:00:00Z,18.5N  49.0W,8,19,1,1,29
Tropical Depression,Ten,1,2005-08-13T21:00:00Z,17.5N  48.0W,33,4,0,0,37
Tropical Depression,Ten,2,2005-08-14T03:00:00Z,16.9N  47.3W,50,0,0,0,50
Tropical Depression,Ten,2,2005-08-14T03:00:00Z,18.6N  50.3W,2,17,9,1,29
Tropical Depression,Ten,2,2005-08-14T03:00:00Z,17.5N  48.6W,26,6,1,0,33
Tropical Depression,Ten,3,2005-08-14T09:00:00Z,15.4N  48.4W,58,0,0,0,58
Tropical Depression,Ten,3,2005-08-14T09:00:00Z,17.5N  51.0W,0,20,9,1,30
Tropical Depression,Ten,3,2005-08-14T09:00:00Z,16.5N  49.7W,11,28,0,0,39
Tropical Depression,Ten,4,2005-08-14T15:00:00Z,15.6N  49.2W,50,0,0,0,50
Tropical Depression,Ten,4,2005-08-14T15:00:00Z,18.0N  52.5W,0,14,15,1,30
Tropical Depression,Ten,4,2005-08-14T15:00:00Z,16.8N  50.8W,9,28,0,0,37
Tropical Depression,Eleven,1,2005-08-22T16:00:00Z,19.9N  97.6W,46,0,0,0,46
Tropical Depression,Eleven,1,2005-08-22T16:00:00Z,MMTM 222N 979W,6,0,0,0,6
Tropical Depression,Eleven,1,2005-08-22T16:00:00Z,,99,0,0,0,99
Tropical Depression,Eleven,1,2005-08-22T16:00:00Z,MMTX 210N 974W,33,0,0,0,33
Tropical Depression,Eleven,1,2005-08-22T16:00:00Z,,99,0,0,0,99
Tropical Depression,Eleven,1,2005-08-22T16:00:00Z,MMVR 192N 961W,64,0,0,0,64
Tropical Depression,Eleven,2,2005-08-22T21:00:00Z,20.1N  98.3W,45,0,0,0,45
Tropical Depression,Eleven,2,2005-08-22T21:00:00Z,MMTM 222N 979W,14,0,0,0,14
Tropical Depression,Eleven,2,2005-08-22T21:00:00Z,,99,0,0,0,99
Tropical Depression,Eleven,2,2005-08-22T21:00:00Z,MMTX 210N 974W,44,0,0,0,44
Tropical Depression,Eleven,2,2005-08-22T21:00:00Z,,99,0,0,0,99
Tropical Depression,Eleven,2,2005-08-22T21:00:00Z,MMVR 192N 961W,99,0,0,0,99
Tropical Storm,Jose,3,2005-08-22T22:15:00Z,19.9N  97.1W,53,0,0,0,53
Tropical Storm,Jose,3,2005-08-22T22:15:00Z,MMTM 222N 979W,4,9,0,0,13
Tropical Storm,Jose,3,2005-08-22T22:15:00Z,20.1N  98.1W,30,1,0,0,31
Tropical Storm,Jose,3,2005-08-22T22:15:00Z,MMTX 210N 974W,27,1,0,0,28
Tropical Storm,Jose,3,2005-08-22T22:15:00Z,,99,0,0,0,99
Tropical Storm,Jose,3,2005-08-22T22:15:00Z,MMVR 192N 961W,99,0,0,0,99
Tropical Storm,Jose,3,2005-08-22T22:15:00Z,MMSO 238N 982W,0,2,0,0,2
Tropical Storm,Jose,4,2005-08-23T03:00:00Z,20.1N  98.3W,52,0,0,0,52
Tropical Storm,Jose,4,2005-08-23T03:00:00Z,MMTM 222N 979W,14,0,0,0,14
Tropical Storm,Jose,4,2005-08-23T03:00:00Z,,99,0,0,0,99
Tropical Storm,Jose,4,2005-08-23T03:00:00Z,MMTX 210N 974W,50,0,0,0,50
Tropical Storm,Jose,4,2005-08-23T03:00:00Z,,99,0,0,0,99
Tropical Storm,Jose,4,2005-08-23T03:00:00Z,MMVR 192N 961W,99,0,0,0,99
Tropical Storm,Jose,5,2005-08-23T09:00:00Z,20.1N  99.8W,47,0,0,0,47
Tropical Storm,Jose,5,2005-08-23T09:00:00Z,MMTM 222N 979W,14,0,0,0,14
Tropical Storm,Jose,5,2005-08-23T09:00:00Z,,99,0,0,0,99
Tropical Storm,Jose,5,2005-08-23T09:00:00Z,MMTX 210N 974W,66,0,0,0,66
Tropical Storm,Jose,5,2005-08-23T09:00:00Z,,99,0,0,0,99
Tropical Storm,Jose,5,2005-08-23T09:00:00Z,MMVR 192N 961W,99,0,0,0,99
Tropical Depression,Jose,6,2005-08-23T15:00:00Z,,99,0,0,0,99
Tropical Depression,Jose,6,2005-08-23T15:00:00Z,,99,0,0,0,99
Tropical Depression,Jose,6,2005-08-23T15:00:00Z,,99,0,0,0,99
Tropical Depression,Jose,6,2005-08-23T15:00:00Z,MMTX 210N 974W,64,0,0,0,64
Tropical Depression,Twelve,1,2005-08-23T21:00:00Z,25.0N  77.7W,50,0,0,0,50
Tropical Depression,Twelve,1,2005-08-23T21:00:00Z,JACKSONVILLE FL,0,0,2,9,11
Tropical Depression,Twelve,1,2005-08-23T21:00:00Z,25.7N  78.5W,36,0,0,1,37
Tropical Depression,Twelve,1,2005-08-23T21:00:00Z,SAVANNAH GA,0,0,0,6,6
Tropical Depression,Twelve,1,2005-08-23T21:00:00Z,26.0N  79.4W,19,6,1,1,27
Tropical Depression,Twelve,1,2005-08-23T21:00:00Z,CHARLESTON SC,0,0,0,3,3
Tropical Depression,Twelve,1,2005-08-23T21:00:00Z,MUCF 221N 805W,0,1,0,3,4
Tropical Depression,Twelve,1,2005-08-23T21:00:00Z,MYRTLE BEACH SC,0,0,0,2,2
Tropical Depression,Twelve,1,2005-08-23T21:00:00Z,MUSN 216N 826W,0,0,0,2,2
Tropical Depression,Twelve,1,2005-08-23T21:00:00Z,KEY WEST FL,0,5,3,5,13
Tropical Depression,Twelve,1,2005-08-23T21:00:00Z,MUHA 230N 824W,0,0,1,5,6
Tropical Depression,Twelve,1,2005-08-23T21:00:00Z,MARCO ISLAND FL,0,9,4,5,18
Tropical Depression,Twelve,1,2005-08-23T21:00:00Z,MYSM 241N 745W,60,0,0,0,60
Tropical Depression,Twelve,1,2005-08-23T21:00:00Z,FT MYERS FL,0,7,6,5,18
Tropical Depression,Twelve,1,2005-08-23T21:00:00Z,MYEG 235N 758W,99,0,0,0,99
Tropical Depression,Twelve,1,2005-08-23T21:00:00Z,VENICE FL,0,3,7,7,17
Tropical Depression,Twelve,1,2005-08-23T21:00:00Z,MYAK 241N 776W,50,0,0,0,50
Tropical Depression,Twelve,1,2005-08-23T21:00:00Z,TAMPA FL,0,1,7,8,16
Tropical Depression,Twelve,1,2005-08-23T21:00:00Z,MYNN 251N 775W,53,0,0,0,53
Tropical Depression,Twelve,1,2005-08-23T21:00:00Z,CEDAR KEY FL,0,0,3,10,13
Tropical Depression,Twelve,1,2005-08-23T21:00:00Z,MYGF 266N 787W,20,6,1,1,28
Tropical Depression,Twelve,1,2005-08-23T21:00:00Z,ST MARKS FL,0,0,0,8,8
Tropical Depression,Twelve,1,2005-08-23T21:00:00Z,MARATHON FL,2,8,2,4,16
Tropical Depression,Twelve,1,2005-08-23T21:00:00Z,APALACHICOLA FL,0,0,0,7,7
Tropical Depression,Twelve,1,2005-08-23T21:00:00Z,MIAMI FL,7,11,2,2,22
Tropical Depression,Twelve,1,2005-08-23T21:00:00Z,PANAMA CITY FL,0,0,0,6,6
Tropical Depression,Twelve,1,2005-08-23T21:00:00Z,W PALM BEACH FL,3,14,3,2,22
Tropical Depression,Twelve,1,2005-08-23T21:00:00Z,PENSACOLA FL,0,0,0,2,2
Tropical Depression,Twelve,1,2005-08-23T21:00:00Z,FT PIERCE FL,0,12,5,4,21
Tropical Depression,Twelve,1,2005-08-23T21:00:00Z,GULF 29N 85W,0,0,1,8,9
Tropical Depression,Twelve,1,2005-08-23T21:00:00Z,COCOA BEACH FL,0,7,6,6,19
Tropical Depression,Twelve,1,2005-08-23T21:00:00Z,GULF 29N 87W,0,0,0,4,4
Tropical Depression,Twelve,1,2005-08-23T21:00:00Z,DAYTONA BEACH FL,0,1,6,8,15
Tropical Depression,Twelve,2,2005-08-24T03:00:00Z,25.1N  77.7W,52,0,0,0,52
Tropical Depression,Twelve,2,2005-08-24T03:00:00Z,JACKSONVILLE FL,0,0,2,9,11
Tropical Depression,Twelve,2,2005-08-24T03:00:00Z,25.7N  78.5W,36,1,0,0,37
Tropical Depression,Twelve,2,2005-08-24T03:00:00Z,SAVANNAH GA,0,0,0,6,6
Tropical Depression,Twelve,2,2005-08-24T03:00:00Z,26.1N  79.5W,18,6,1,1,26
Tropical Depression,Twelve,2,2005-08-24T03:00:00Z,CHARLESTON SC,0,0,0,3,3
Tropical Depression,Twelve,2,2005-08-24T03:00:00Z,MUCF 221N 805W,0,1,0,3,4
Tropical Depression,Twelve,2,2005-08-24T03:00:00Z,KEY WEST FL,1,5,3,5,14
Tropical Depression,Twelve,2,2005-08-24T03:00:00Z,MUSN 216N 826W,0,0,0,2,2
Tropical Depression,Twelve,2,2005-08-24T03:00:00Z,MARCO ISLAND FL,0,10,4,4,18
Tropical Depression,Twelve,2,2005-08-24T03:00:00Z,MUHA 230N 824W,0,1,1,4,6
Tropical Depression,Twelve,2,2005-08-24T03:00:00Z,FT MYERS FL,0,8,5,5,18
Tropical Depression,Twelve,2,2005-08-24T03:00:00Z,MYSM 241N 745W,47,0,0,0,47
Tropical Depression,Twelve,2,2005-08-24T03:00:00Z,VENICE FL,0,4,7,6,17
Tropical Depression,Twelve,2,2005-08-24T03:00:00Z,MYEG 235N 758W,99,0,0,0,99
Tropical Depression,Twelve,2,2005-08-24T03:00:00Z,TAMPA FL,0,2,7,7,16
Tropical Depression,Twelve,2,2005-08-24T03:00:00Z,MYAK 241N 776W,51,0,0,0,51
Tropical Depression,Twelve,2,2005-08-24T03:00:00Z,CEDAR KEY FL,0,0,5,9,14
Tropical Depression,Twelve,2,2005-08-24T03:00:00Z,MYNN 251N 775W,54,0,0,0,54
Tropical Depression,Twelve,2,2005-08-24T03:00:00Z,ST MARKS FL,0,0,1,8,9
Tropical Depression,Twelve,2,2005-08-24T03:00:00Z,MYGF 266N 787W,21,5,1,0,27
Tropical Depression,Twelve,2,2005-08-24T03:00:00Z,APALACHICOLA FL,0,0,1,8,9
Tropical Depression,Twelve,2,2005-08-24T03:00:00Z,MARATHON FL,4,7,2,3,16
Tropical Depression,Twelve,2,2005-08-24T03:00:00Z,PANAMA CITY FL,0,0,0,7,7
Tropical Depression,Twelve,2,2005-08-24T03:00:00Z,MIAMI FL,9,9,2,2,22
Tropical Depression,Twelve,2,2005-08-24T03:00:00Z,PENSACOLA FL,0,0,0,4,4
Tropical Depression,Twelve,2,2005-08-24T03:00:00Z,W PALM BEACH FL,4,13,3,2,22
Tropical Depression,Twelve,2,2005-08-24T03:00:00Z,MOBILE AL,0,0,0,2,2
Tropical Depression,Twelve,2,2005-08-24T03:00:00Z,FT PIERCE FL,1,11,5,3,20
Tropical Depression,Twelve,2,2005-08-24T03:00:00Z,GULF 29N 85W,0,0,1,9,10
Tropical Depression,Twelve,2,2005-08-24T03:00:00Z,COCOA BEACH FL,0,7,6,6,19
Tropical Depression,Twelve,2,2005-08-24T03:00:00Z,GULF 29N 87W,0,0,0,6,6
Tropical Depression,Twelve,2,2005-08-24T03:00:00Z,DAYTONA BEACH FL,0,1,7,7,15
Tropical Depression,Twelve,2,2005-08-24T03:00:00Z,GULF 28N 89W,0,0,0,2,2
Tropical Depression,Twelve,3,2005-08-24T09:00:00Z,25.5N  78.0W,50,0,0,0,50
Tropical Depression,Twelve,3,2005-08-24T09:00:00Z,SAVANNAH GA,0,0,0,6,6
Tropical Depression,Twelve,3,2005-08-24T09:00:00Z,25.9N  78.9W,31,1,0,0,32
Tropical Depression,Twelve,3,2005-08-24T09:00:00Z,CHARLESTON SC,0,0,0,3,3
Tropical Depression,Twelve,3,2005-08-24T09:00:00Z,26.1N  80.0W,17,4,1,2,24
Tropical Depression,Twelve,3,2005-08-24T09:00:00Z,KEY WEST FL,1,4,3,5,13
Tropical Depression,Twelve,3,2005-08-24T09:00:00Z,MUCF 221N 805W,0,0,0,3,3
Tropical Depression,Twelve,3,2005-08-24T09:00:00Z,MARCO ISLAND FL,2,9,4,3,18
Tropical Depression,Twelve,3,2005-08-24T09:00:00Z,MUSN 216N 826W,0,0,0,2,2
Tropical Depression,Twelve,3,2005-08-24T09:00:00Z,FT MYERS FL,1,9,5,4,19
Tropical Depression,Twelve,3,2005-08-24T09:00:00Z,MUHA 230N 824W,0,0,1,4,5
Tropical Depression,Twelve,3,2005-08-24T09:00:00Z,VENICE FL,0,7,6,5,18
Tropical Depression,Twelve,3,2005-08-24T09:00:00Z,MYSM 241N 745W,22,0,0,0,22
Tropical Depression,Twelve,3,2005-08-24T09:00:00Z,TAMPA FL,0,5,7,6,18
Tropical Depression,Twelve,3,2005-08-24T09:00:00Z,MYEG 235N 758W,99,0,0,0,99
Tropical Depression,Twelve,3,2005-08-24T09:00:00Z,CEDAR KEY FL,0,1,6,8,15
Tropical Depression,Twelve,3,2005-08-24T09:00:00Z,MYAK 241N 776W,55,0,0,0,55
Tropical Depression,Twelve,3,2005-08-24T09:00:00Z,ST MARKS FL,0,0,2,8,10
Tropical Depression,Twelve,3,2005-08-24T09:00:00Z,MYNN 251N 775W,67,0,0,0,67
Tropical Depression,Twelve,3,2005-08-24T09:00:00Z,APALACHICOLA FL,0,0,2,8,10
Tropical Depression,Twelve,3,2005-08-24T09:00:00Z,MYGF 266N 787W,28,1,1,0,30
Tropical Depression,Twelve,3,2005-08-24T09:00:00Z,PANAMA CITY FL,0,0,1,7,8
Tropical Depression,Twelve,3,2005-08-24T09:00:00Z,MARATHON FL,3,6,2,4,15
Tropical Depression,Twelve,3,2005-08-24T09:00:00Z,PENSACOLA FL,0,0,0,5,5
Tropical Depression,Twelve,3,2005-08-24T09:00:00Z,MIAMI FL,14,4,2,2,22
Tropical Depression,Twelve,3,2005-08-24T09:00:00Z,MOBILE AL,0,0,0,3,3
Tropical Depression,Twelve,3,2005-08-24T09:00:00Z,W PALM BEACH FL,13,7,2,2,24
Tropical Depression,Twelve,3,2005-08-24T09:00:00Z,GULFPORT MS,0,0,0,2,2
Tropical Depression,Twelve,3,2005-08-24T09:00:00Z,FT PIERCE FL,5,11,3,3,22
Tropical Depression,Twelve,3,2005-08-24T09:00:00Z,BURAS LA,0,0,0,2,2
Tropical Depression,Twelve,3,2005-08-24T09:00:00Z,COCOA BEACH FL,1,10,5,4,20
Tropical Depression,Twelve,3,2005-08-24T09:00:00Z,GULF 29N 85W,0,0,3,8,11
Tropical Depression,Twelve,3,2005-08-24T09:00:00Z,DAYTONA BEACH FL,0,4,6,6,16
Tropical Depression,Twelve,3,2005-08-24T09:00:00Z,GULF 29N 87W,0,0,0,7,7
Tropical Depression,Twelve,3,2005-08-24T09:00:00Z,JACKSONVILLE FL,0,0,3,8,11
Tropical Depression,Twelve,3,2005-08-24T09:00:00Z,GULF 28N 89W,0,0,0,3,3
Tropical Storm,Katrina,4,2005-08-24T15:00:00Z,25.9N  78.4W,49,0,0,0,49
Tropical Storm,Katrina,4,2005-08-24T15:00:00Z,SAVANNAH GA,0,0,0,4,4
Tropical Storm,Katrina,4,2005-08-24T15:00:00Z,26.0N  79.2W,34,0,0,0,34
Tropical Storm,Katrina,4,2005-08-24T15:00:00Z,KEY WEST FL,1,4,3,4,12
Tropical Storm,Katrina,4,2005-08-24T15:00:00Z,26.1N  80.1W,21,2,1,1,25
Tropical Storm,Katrina,4,2005-08-24T15:00:00Z,MARCO ISLAND FL,5,7,4,3,19
Tropical Storm,Katrina,4,2005-08-24T15:00:00Z,MUCM 214N 779W,0,0,0,2,2
Tropical Storm,Katrina,4,2005-08-24T15:00:00Z,FT MYERS FL,3,9,4,3,19
Tropical Storm,Katrina,4,2005-08-24T15:00:00Z,MUCF 221N 805W,0,0,0,3,3
Tropical Storm,Katrina,4,2005-08-24T15:00:00Z,VENICE FL,1,8,5,4,18
Tropical Storm,Katrina,4,2005-08-24T15:00:00Z,MUSN 216N 826W,0,0,0,2,2
Tropical Storm,Katrina,4,2005-08-24T15:00:00Z,TAMPA FL,0,7,5,5,17
Tropical Storm,Katrina,4,2005-08-24T15:00:00Z,MUHA 230N 824W,0,0,1,4,5
Tropical Storm,Katrina,4,2005-08-24T15:00:00Z,CEDAR KEY FL,0,2,5,7,14
Tropical Storm,Katrina,4,2005-08-24T15:00:00Z,MYSM 241N 745W,0,1,1,2,4
Tropical Storm,Katrina,4,2005-08-24T15:00:00Z,ST MARKS FL,0,0,2,8,10
Tropical Storm,Katrina,4,2005-08-24T15:00:00Z,MYEG 235N 758W,15,0,1,0,16
Tropical Storm,Katrina,4,2005-08-24T15:00:00Z,APALACHICOLA FL,0,0,2,8,10
Tropical Storm,Katrina,4,2005-08-24T15:00:00Z,MYAK 241N 776W,99,0,0,0,99
Tropical Storm,Katrina,4,2005-08-24T15:00:00Z,PANAMA CITY FL,0,0,1,8,9
Tropical Storm,Katrina,4,2005-08-24T15:00:00Z,MYNN 251N 775W,99,0,0,0,99
Tropical Storm,Katrina,4,2005-08-24T15:00:00Z,PENSACOLA FL,0,0,0,6,6
Tropical Storm,Katrina,4,2005-08-24T15:00:00Z,MYGF 266N 787W,37,0,0,1,38
Tropical Storm,Katrina,4,2005-08-24T15:00:00Z,MOBILE AL,0,0,0,4,4
Tropical Storm,Katrina,4,2005-08-24T15:00:00Z,MARATHON FL,4,5,3,3,15
Tropical Storm,Katrina,4,2005-08-24T15:00:00Z,GULFPORT MS,0,0,0,4,4
Tropical Storm,Katrina,4,2005-08-24T15:00:00Z,MIAMI FL,18,3,1,1,23
Tropical Storm,Katrina,4,2005-08-24T15:00:00Z,BURAS LA,0,0,0,4,4
Tropical Storm,Katrina,4,2005-08-24T15:00:00Z,W PALM BEACH FL,20,3,1,1,25
Tropical Storm,Katrina,4,2005-08-24T15:00:00Z,NEW ORLEANS LA,0,0,0,3,3
Tropical Storm,Katrina,4,2005-08-24T15:00:00Z,FT PIERCE FL,12,7,2,2,23
Tropical Storm,Katrina,4,2005-08-24T15:00:00Z,GULF 29N 85W,0,0,3,8,11
Tropical Storm,Katrina,4,2005-08-24T15:00:00Z,COCOA BEACH FL,4,9,4,3,20
Tropical Storm,Katrina,4,2005-08-24T15:00:00Z,GULF 29N 87W,0,0,1,7,8
Tropical Storm,Katrina,4,2005-08-24T15:00:00Z,DAYTONA BEACH FL,0,5,6,4,15
Tropical Storm,Katrina,4,2005-08-24T15:00:00Z,GULF 28N 89W,0,0,0,5,5
Tropical Storm,Katrina,4,2005-08-24T15:00:00Z,JACKSONVILLE FL,0,0,4,6,10
Tropical Storm,Katrina,4,2005-08-24T15:00:00Z,GULF 28N 91W,0,0,0,2,2
Tropical Storm,Katrina,5,2005-08-24T21:00:00Z,26.1N  78.8W,47,0,0,0,47
Tropical Storm,Katrina,5,2005-08-24T21:00:00Z,CHARLESTON SC,0,0,0,3,3
Tropical Storm,Katrina,5,2005-08-24T21:00:00Z,26.2N  79.7W,31,1,0,0,32
Tropical Storm,Katrina,5,2005-08-24T21:00:00Z,KEY WEST FL,2,4,3,4,13
Tropical Storm,Katrina,5,2005-08-24T21:00:00Z,26.3N  80.7W,19,3,1,1,24
Tropical Storm,Katrina,5,2005-08-24T21:00:00Z,MARCO ISLAND FL,8,7,2,3,20
Tropical Storm,Katrina,5,2005-08-24T21:00:00Z,MUCF 221N 805W,0,0,0,3,3
Tropical Storm,Katrina,5,2005-08-24T21:00:00Z,FT MYERS FL,7,8,3,3,21
Tropical Storm,Katrina,5,2005-08-24T21:00:00Z,MUSN 216N 826W,0,0,0,2,2
Tropical Storm,Katrina,5,2005-08-24T21:00:00Z,VENICE FL,2,10,4,4,20
Tropical Storm,Katrina,5,2005-08-24T21:00:00Z,MUHA 230N 824W,0,0,1,5,6
Tropical Storm,Katrina,5,2005-08-24T21:00:00Z,TAMPA FL,1,9,5,4,19
Tropical Storm,Katrina,5,2005-08-24T21:00:00Z,MUAN 219N 850W,0,0,0,2,2
Tropical Storm,Katrina,5,2005-08-24T21:00:00Z,CEDAR KEY FL,0,3,6,7,16
Tropical Storm,Katrina,5,2005-08-24T21:00:00Z,MYEG 235N 758W,0,0,1,1,2
Tropical Storm,Katrina,5,2005-08-24T21:00:00Z,ST MARKS FL,0,0,3,9,12
Tropical Storm,Katrina,5,2005-08-24T21:00:00Z,MYAK 241N 776W,5,1,1,2,9
Tropical Storm,Katrina,5,2005-08-24T21:00:00Z,APALACHICOLA FL,0,0,3,9,12
Tropical Storm,Katrina,5,2005-08-24T21:00:00Z,MYNN 251N 775W,99,0,0,0,99
Tropical Storm,Katrina,5,2005-08-24T21:00:00Z,PANAMA CITY FL,0,0,2,8,10
Tropical Storm,Katrina,5,2005-08-24T21:00:00Z,MYGF 266N 787W,48,0,0,0,48
Tropical Storm,Katrina,5,2005-08-24T21:00:00Z,PENSACOLA FL,0,0,0,6,6
Tropical Storm,Katrina,5,2005-08-24T21:00:00Z,MARATHON FL,5,4,3,3,15
Tropical Storm,Katrina,5,2005-08-24T21:00:00Z,MOBILE AL,0,0,0,4,4
Tropical Storm,Katrina,5,2005-08-24T21:00:00Z,MIAMI FL,20,2,1,1,24
Tropical Storm,Katrina,5,2005-08-24T21:00:00Z,GULFPORT MS,0,0,0,3,3
Tropical Storm,Katrina,5,2005-08-24T21:00:00Z,W PALM BEACH FL,26,2,0,1,29
Tropical Storm,Katrina,5,2005-08-24T21:00:00Z,BURAS LA,0,0,0,4,4
Tropical Storm,Katrina,5,2005-08-24T21:00:00Z,FT PIERCE FL,19,3,2,1,25
Tropical Storm,Katrina,5,2005-08-24T21:00:00Z,NEW ORLEANS LA,0,0,0,2,2
Tropical Storm,Katrina,5,2005-08-24T21:00:00Z,COCOA BEACH FL,9,7,3,3,22
Tropical Storm,Katrina,5,2005-08-24T21:00:00Z,GULF 29N 85W,0,1,4,8,13
Tropical Storm,Katrina,5,2005-08-24T21:00:00Z,DAYTONA BEACH FL,1,7,5,4,17
Tropical Storm,Katrina,5,2005-08-24T21:00:00Z,GULF 29N 87W,0,0,1,8,9
Tropical Storm,Katrina,5,2005-08-24T21:00:00Z,JACKSONVILLE FL,0,1,4,7,12
Tropical Storm,Katrina,5,2005-08-24T21:00:00Z,GULF 28N 89W,0,0,0,5,5
Tropical Storm,Katrina,5,2005-08-24T21:00:00Z,SAVANNAH GA,0,0,1,5,6
Tropical Storm,Katrina,5,2005-08-24T21:00:00Z,GULF 28N 91W,0,0,0,2,2
Tropical Storm,Katrina,6,2005-08-25T03:00:00Z,26.0N  79.5W,55,0,0,0,55
Tropical Storm,Katrina,6,2005-08-25T03:00:00Z,MYRTLE BEACH SC,0,0,0,2,2
Tropical Storm,Katrina,6,2005-08-25T03:00:00Z,26.0N  80.5W,30,1,0,1,32
Tropical Storm,Katrina,6,2005-08-25T03:00:00Z,KEY WEST FL,4,9,2,2,17
Tropical Storm,Katrina,6,2005-08-25T03:00:00Z,26.3N  81.5W,14,9,1,1,25
Tropical Storm,Katrina,6,2005-08-25T03:00:00Z,MARCO ISLAND FL,11,10,1,2,24
Tropical Storm,Katrina,6,2005-08-25T03:00:00Z,MUCF 221N 805W,0,0,1,1,2
Tropical Storm,Katrina,6,2005-08-25T03:00:00Z,FT MYERS FL,8,11,3,1,23
Tropical Storm,Katrina,6,2005-08-25T03:00:00Z,MUSN 216N 826W,0,0,1,1,2
Tropical Storm,Katrina,6,2005-08-25T03:00:00Z,VENICE FL,1,12,5,3,21
Tropical Storm,Katrina,6,2005-08-25T03:00:00Z,MUHA 230N 824W,0,3,2,2,7
Tropical Storm,Katrina,6,2005-08-25T03:00:00Z,TAMPA FL,1,8,6,4,19
Tropical Storm,Katrina,6,2005-08-25T03:00:00Z,MUAN 219N 850W,0,0,0,2,2
Tropical Storm,Katrina,6,2005-08-25T03:00:00Z,CEDAR KEY FL,0,1,7,8,16
Tropical Storm,Katrina,6,2005-08-25T03:00:00Z,MYAK 241N 776W,1,0,1,2,4
Tropical Storm,Katrina,6,2005-08-25T03:00:00Z,ST MARKS FL,0,0,1,10,11
Tropical Storm,Katrina,6,2005-08-25T03:00:00Z,MYNN 251N 775W,99,0,0,0,99
Tropical Storm,Katrina,6,2005-08-25T03:00:00Z,APALACHICOLA FL,0,0,1,10,11
Tropical Storm,Katrina,6,2005-08-25T03:00:00Z,MYGF 266N 787W,99,0,0,0,99
Tropical Storm,Katrina,6,2005-08-25T03:00:00Z,PANAMA CITY FL,0,0,0,9,9
Tropical Storm,Katrina,6,2005-08-25T03:00:00Z,MARATHON FL,11,6,1,1,19
Tropical Storm,Katrina,6,2005-08-25T03:00:00Z,PENSACOLA FL,0,0,0,6,6
Tropical Storm,Katrina,6,2005-08-25T03:00:00Z,MIAMI FL,32,1,0,0,33
Tropical Storm,Katrina,6,2005-08-25T03:00:00Z,MOBILE AL,0,0,0,4,4
Tropical Storm,Katrina,6,2005-08-25T03:00:00Z,W PALM BEACH FL,40,0,0,0,40
Tropical Storm,Katrina,6,2005-08-25T03:00:00Z,GULFPORT MS,0,0,0,4,4
Tropical Storm,Katrina,6,2005-08-25T03:00:00Z,FT PIERCE FL,28,1,1,0,30
Tropical Storm,Katrina,6,2005-08-25T03:00:00Z,BURAS LA,0,0,0,4,4
Tropical Storm,Katrina,6,2005-08-25T03:00:00Z,COCOA BEACH FL,15,6,1,2,24
Tropical Storm,Katrina,6,2005-08-25T03:00:00Z,NEW ORLEANS LA,0,0,0,3,3
Tropical Storm,Katrina,6,2005-08-25T03:00:00Z,DAYTONA BEACH FL,2,8,5,4,19
Tropical Storm,Katrina,6,2005-08-25T03:00:00Z,GULF 29N 85W,0,0,2,11,13
Tropical Storm,Katrina,6,2005-08-25T03:00:00Z,JACKSONVILLE FL,0,1,4,8,13
Tropical Storm,Katrina,6,2005-08-25T03:00:00Z,GULF 29N 87W,0,0,0,9,9
Tropical Storm,Katrina,6,2005-08-25T03:00:00Z,SAVANNAH GA,0,0,1,6,7
Tropical Storm,Katrina,6,2005-08-25T03:00:00Z,GULF 28N 89W,0,0,0,6,6
Tropical Storm,Katrina,6,2005-08-25T03:00:00Z,CHARLESTON SC,0,0,0,4,4
Tropical Storm,Katrina,6,2005-08-25T03:00:00Z,GULF 28N 91W,0,0,0,3,3
Tropical Storm,Katrina,7,2005-08-25T09:00:00Z,26.3N  80.4W,50,1,0,0,51
Tropical Storm,Katrina,7,2005-08-25T09:00:00Z,MARCO ISLAND FL,26,2,0,1,29
Tropical Storm,Katrina,7,2005-08-25T09:00:00Z,26.3N  81.4W,33,1,0,0,34
Tropical Storm,Katrina,7,2005-08-25T09:00:00Z,FT MYERS FL,25,3,0,1,29
Tropical Storm,Katrina,7,2005-08-25T09:00:00Z,26.5N  82.5W,13,8,2,1,24
Tropical Storm,Katrina,7,2005-08-25T09:00:00Z,VENICE FL,12,9,2,1,24
Tropical Storm,Katrina,7,2005-08-25T09:00:00Z,MUHA 230N 824W,0,2,1,2,5
Tropical Storm,Katrina,7,2005-08-25T09:00:00Z,TAMPA FL,7,10,3,2,22
Tropical Storm,Katrina,7,2005-08-25T09:00:00Z,MUAN 219N 850W,0,0,0,2,2
Tropical Storm,Katrina,7,2005-08-25T09:00:00Z,CEDAR KEY FL,0,7,6,5,18
Tropical Storm,Katrina,7,2005-08-25T09:00:00Z,MYAK 241N 776W,0,0,0,2,2
Tropical Storm,Katrina,7,2005-08-25T09:00:00Z,ST MARKS FL,0,0,3,10,13
Tropical Storm,Katrina,7,2005-08-25T09:00:00Z,MYNN 251N 775W,0,0,1,2,3
Tropical Storm,Katrina,7,2005-08-25T09:00:00Z,APALACHICOLA FL,0,0,3,10,13
Tropical Storm,Katrina,7,2005-08-25T09:00:00Z,MYGF 266N 787W,99,0,0,0,99
Tropical Storm,Katrina,7,2005-08-25T09:00:00Z,PANAMA CITY FL,0,0,1,10,11
Tropical Storm,Katrina,7,2005-08-25T09:00:00Z,MARATHON FL,16,2,0,1,19
Tropical Storm,Katrina,7,2005-08-25T09:00:00Z,PENSACOLA FL,0,0,0,8,8
Tropical Storm,Katrina,7,2005-08-25T09:00:00Z,MIAMI FL,44,0,0,0,44
Tropical Storm,Katrina,7,2005-08-25T09:00:00Z,MOBILE AL,0,0,0,6,6
Tropical Storm,Katrina,7,2005-08-25T09:00:00Z,W PALM BEACH FL,64,0,0,0,64
Tropical Storm,Katrina,7,2005-08-25T09:00:00Z,GULFPORT MS,0,0,0,5,5
Tropical Storm,Katrina,7,2005-08-25T09:00:00Z,FT PIERCE FL,46,0,0,0,46
Tropical Storm,Katrina,7,2005-08-25T09:00:00Z,BURAS LA,0,0,0,6,6
Tropical Storm,Katrina,7,2005-08-25T09:00:00Z,COCOA BEACH FL,30,0,1,0,31
Tropical Storm,Katrina,7,2005-08-25T09:00:00Z,NEW ORLEANS LA,0,0,0,4,4
Tropical Storm,Katrina,7,2005-08-25T09:00:00Z,DAYTONA BEACH FL,10,7,2,2,21
Tropical Storm,Katrina,7,2005-08-25T09:00:00Z,NEW IBERIA LA,0,0,0,2,2
Tropical Storm,Katrina,7,2005-08-25T09:00:00Z,JACKSONVILLE FL,0,4,5,5,14
Tropical Storm,Katrina,7,2005-08-25T09:00:00Z,GULF 29N 85W,0,0,5,9,14
Tropical Storm,Katrina,7,2005-08-25T09:00:00Z,SAVANNAH GA,0,0,2,6,8
Tropical Storm,Katrina,7,2005-08-25T09:00:00Z,GULF 29N 87W,0,0,1,10,11
Tropical Storm,Katrina,7,2005-08-25T09:00:00Z,CHARLESTON SC,0,0,1,4,5
Tropical Storm,Katrina,7,2005-08-25T09:00:00Z,GULF 28N 89W,0,0,0,8,8
Tropical Storm,Katrina,7,2005-08-25T09:00:00Z,MYRTLE BEACH SC,0,0,0,2,2
Tropical Storm,Katrina,7,2005-08-25T09:00:00Z,GULF 28N 91W,0,0,0,4,4
Tropical Storm,Katrina,7,2005-08-25T09:00:00Z,KEY WEST FL,9,5,1,1,16
Tropical Storm,Katrina,7,2005-08-25T09:00:00Z,GULF 28N 93W,0,0,0,2,2
Tropical Storm,Katrina,8,2005-08-25T15:00:00Z,26.2N  81.0W,48,0,0,0,48
Tropical Storm,Katrina,8,2005-08-25T15:00:00Z,FT MYERS FL,35,1,0,0,36
Tropical Storm,Katrina,8,2005-08-25T15:00:00Z,26.3N  82.0W,32,1,0,0,33
Tropical Storm,Katrina,8,2005-08-25T15:00:00Z,VENICE FL,24,4,1,0,29
Tropical Storm,Katrina,8,2005-08-25T15:00:00Z,26.7N  83.0W,15,8,2,1,26
Tropical Storm,Katrina,8,2005-08-25T15:00:00Z,TAMPA FL,17,6,2,1,26
Tropical Storm,Katrina,8,2005-08-25T15:00:00Z,MUHA 230N 824W,0,2,1,2,5
Tropical Storm,Katrina,8,2005-08-25T15:00:00Z,CEDAR KEY FL,3,9,4,4,20
Tropical Storm,Katrina,8,2005-08-25T15:00:00Z,MYNN 251N 775W,0,0,0,2,2
Tropical Storm,Katrina,8,2005-08-25T15:00:00Z,ST MARKS FL,0,1,6,8,15
Tropical Storm,Katrina,8,2005-08-25T15:00:00Z,MYGF 266N 787W,99,0,0,0,99
Tropical Storm,Katrina,8,2005-08-25T15:00:00Z,APALACHICOLA FL,0,1,5,9,15
Tropical Storm,Katrina,8,2005-08-25T15:00:00Z,MARATHON FL,18,1,0,1,20
Tropical Storm,Katrina,8,2005-08-25T15:00:00Z,PANAMA CITY FL,0,0,3,10,13
Tropical Storm,Katrina,8,2005-08-25T15:00:00Z,MIAMI FL,99,0,0,0,99
Tropical Storm,Katrina,8,2005-08-25T15:00:00Z,PENSACOLA FL,0,0,0,10,10
Tropical Storm,Katrina,8,2005-08-25T15:00:00Z,W PALM BEACH FL,99,0,0,0,99
Tropical Storm,Katrina,8,2005-08-25T15:00:00Z,MOBILE AL,0,0,0,7,7
Tropical Storm,Katrina,8,2005-08-25T15:00:00Z,FT PIERCE FL,53,0,0,0,53
Tropical Storm,Katrina,8,2005-08-25T15:00:00Z,GULFPORT MS,0,0,0,7,7
Tropical Storm,Katrina,8,2005-08-25T15:00:00Z,COCOA BEACH FL,32,0,0,1,33
Tropical Storm,Katrina,8,2005-08-25T15:00:00Z,BURAS LA,0,0,0,7,7
Tropical Storm,Katrina,8,2005-08-25T15:00:00Z,DAYTONA BEACH FL,14,4,2,2,22
Tropical Storm,Katrina,8,2005-08-25T15:00:00Z,NEW ORLEANS LA,0,0,0,5,5
Tropical Storm,Katrina,8,2005-08-25T15:00:00Z,JACKSONVILLE FL,1,5,4,6,16
Tropical Storm,Katrina,8,2005-08-25T15:00:00Z,NEW IBERIA LA,0,0,0,3,3
Tropical Storm,Katrina,8,2005-08-25T15:00:00Z,SAVANNAH GA,0,0,2,7,9
Tropical Storm,Katrina,8,2005-08-25T15:00:00Z,GULF 29N 85W,0,1,8,8,17
Tropical Storm,Katrina,8,2005-08-25T15:00:00Z,CHARLESTON SC,0,0,1,5,6
Tropical Storm,Katrina,8,2005-08-25T15:00:00Z,GULF 29N 87W,0,0,2,10,12
Tropical Storm,Katrina,8,2005-08-25T15:00:00Z,MYRTLE BEACH SC,0,0,0,3,3
Tropical Storm,Katrina,8,2005-08-25T15:00:00Z,GULF 28N 89W,0,0,0,9,9
Tropical Storm,Katrina,8,2005-08-25T15:00:00Z,WILMINGTON NC,0,0,0,2,2
Tropical Storm,Katrina,8,2005-08-25T15:00:00Z,GULF 28N 91W,0,0,0,5,5
Tropical Storm,Katrina,8,2005-08-25T15:00:00Z,KEY WEST FL,12,3,1,1,17
Tropical Storm,Katrina,8,2005-08-25T15:00:00Z,GULF 28N 93W,0,0,0,2,2
Tropical Storm,Katrina,8,2005-08-25T15:00:00Z,MARCO ISLAND FL,34,0,0,0,34
Hurricane,Katrina,9,2005-08-25T21:00:00Z,26.1N  81.7W,49,0,0,0,49
Hurricane,Katrina,9,2005-08-25T21:00:00Z,VENICE FL,32,1,0,0,33
Hurricane,Katrina,9,2005-08-25T21:00:00Z,26.4N  82.8W,28,1,1,0,30
Hurricane,Katrina,9,2005-08-25T21:00:00Z,TAMPA FL,23,2,1,1,27
Hurricane,Katrina,9,2005-08-25T21:00:00Z,27.0N  83.7W,10,10,2,1,23
Hurricane,Katrina,9,2005-08-25T21:00:00Z,CEDAR KEY FL,5,9,4,3,21
Hurricane,Katrina,9,2005-08-25T21:00:00Z,MUHA 230N 824W,1,2,0,1,4
Hurricane,Katrina,9,2005-08-25T21:00:00Z,ST MARKS FL,0,2,6,8,16
Hurricane,Katrina,9,2005-08-25T21:00:00Z,MYGF 266N 787W,99,0,0,0,99
Hurricane,Katrina,9,2005-08-25T21:00:00Z,APALACHICOLA FL,0,1,6,9,16
Hurricane,Katrina,9,2005-08-25T21:00:00Z,MARATHON FL,23,1,0,0,24
Hurricane,Katrina,9,2005-08-25T21:00:00Z,PANAMA CITY FL,0,0,4,10,14
Hurricane,Katrina,9,2005-08-25T21:00:00Z,MIAMI FL,99,0,0,0,99
Hurricane,Katrina,9,2005-08-25T21:00:00Z,PENSACOLA FL,0,0,1,10,11
Hurricane,Katrina,9,2005-08-25T21:00:00Z,W PALM BEACH FL,99,0,0,0,99
Hurricane,Katrina,9,2005-08-25T21:00:00Z,MOBILE AL,0,0,0,9,9
Hurricane,Katrina,9,2005-08-25T21:00:00Z,FT PIERCE FL,58,0,0,0,58
Hurricane,Katrina,9,2005-08-25T21:00:00Z,GULFPORT MS,0,0,0,8,8
Hurricane,Katrina,9,2005-08-25T21:00:00Z,COCOA BEACH FL,30,0,0,0,30
Hurricane,Katrina,9,2005-08-25T21:00:00Z,BURAS LA,0,0,0,8,8
Hurricane,Katrina,9,2005-08-25T21:00:00Z,DAYTONA BEACH FL,13,4,2,2,21
Hurricane,Katrina,9,2005-08-25T21:00:00Z,NEW ORLEANS LA,0,0,0,7,7
Hurricane,Katrina,9,2005-08-25T21:00:00Z,JACKSONVILLE FL,1,7,4,5,17
Hurricane,Katrina,9,2005-08-25T21:00:00Z,NEW IBERIA LA,0,0,0,4,4
Hurricane,Katrina,9,2005-08-25T21:00:00Z,SAVANNAH GA,0,1,3,7,11
Hurricane,Katrina,9,2005-08-25T21:00:00Z,PORT ARTHUR TX,0,0,0,2,2
Hurricane,Katrina,9,2005-08-25T21:00:00Z,CHARLESTON SC,0,0,2,6,8
Hurricane,Katrina,9,2005-08-25T21:00:00Z,GALVESTON TX,0,0,0,2,2
Hurricane,Katrina,9,2005-08-25T21:00:00Z,MYRTLE BEACH SC,0,0,0,5,5
Hurricane,Katrina,9,2005-08-25T21:00:00Z,GULF 29N 85W,0,3,7,7,17
Hurricane,Katrina,9,2005-08-25T21:00:00Z,WILMINGTON NC,0,0,0,3,3
Hurricane,Katrina,9,2005-08-25T21:00:00Z,GULF 29N 87W,0,0,3,10,13
Hurricane,Katrina,9,2005-08-25T21:00:00Z,MOREHEAD CITY NC,0,0,0,2,2
Hurricane,Katrina,9,2005-08-25T21:00:00Z,GULF 28N 89W,0,0,1,9,10
Hurricane,Katrina,9,2005-08-25T21:00:00Z,KEY WEST FL,17,1,0,1,19
Hurricane,Katrina,9,2005-08-25T21:00:00Z,GULF 28N 91W,0,0,0,6,6
Hurricane,Katrina,9,2005-08-25T21:00:00Z,MARCO ISLAND FL,47,0,0,0,47
Hurricane,Katrina,9,2005-08-25T21:00:00Z,GULF 28N 93W,0,0,0,3,3
Hurricane,Katrina,9,2005-08-25T21:00:00Z,FT MYERS FL,46,0,0,0,46
Hurricane,Katrina,10,2005-08-26T03:00:00Z,25.5N  83.0W,45,0,0,0,45
Hurricane,Katrina,10,2005-08-26T03:00:00Z,FT MYERS FL,56,0,0,0,56
Hurricane,Katrina,10,2005-08-26T03:00:00Z,26.0N  84.0W,31,0,1,0,32
Hurricane,Katrina,10,2005-08-26T03:00:00Z,VENICE FL,37,0,0,0,37
Hurricane,Katrina,10,2005-08-26T03:00:00Z,26.5N  84.5W,22,3,1,1,27
Hurricane,Katrina,10,2005-08-26T03:00:00Z,TAMPA FL,19,2,2,1,24
Hurricane,Katrina,10,2005-08-26T03:00:00Z,MUSN 216N 826W,0,1,0,1,2
Hurricane,Katrina,10,2005-08-26T03:00:00Z,CEDAR KEY FL,5,8,4,3,20
Hurricane,Katrina,10,2005-08-26T03:00:00Z,MUHA 230N 824W,7,2,1,0,10
Hurricane,Katrina,10,2005-08-26T03:00:00Z,ST MARKS FL,0,5,5,7,17
Hurricane,Katrina,10,2005-08-26T03:00:00Z,MUAN 219N 850W,0,1,1,2,4
Hurricane,Katrina,10,2005-08-26T03:00:00Z,APALACHICOLA FL,0,6,6,6,18
Hurricane,Katrina,10,2005-08-26T03:00:00Z,MYGF 266N 787W,0,0,1,3,4
Hurricane,Katrina,10,2005-08-26T03:00:00Z,PANAMA CITY FL,0,3,5,8,16
Hurricane,Katrina,10,2005-08-26T03:00:00Z,MARATHON FL,53,0,0,0,53
Hurricane,Katrina,10,2005-08-26T03:00:00Z,PENSACOLA FL,0,0,2,11,13
Hurricane,Katrina,10,2005-08-26T03:00:00Z,MIAMI FL,99,0,0,0,99
Hurricane,Katrina,10,2005-08-26T03:00:00Z,MOBILE AL,0,0,1,9,10
Hurricane,Katrina,10,2005-08-26T03:00:00Z,W PALM BEACH FL,99,0,0,0,99
Hurricane,Katrina,10,2005-08-26T03:00:00Z,GULFPORT MS,0,0,0,9,9
Hurricane,Katrina,10,2005-08-26T03:00:00Z,FT PIERCE FL,35,0,0,0,35
Hurricane,Katrina,10,2005-08-26T03:00:00Z,BURAS LA,0,0,0,9,9
Hurricane,Katrina,10,2005-08-26T03:00:00Z,COCOA BEACH FL,4,3,3,4,14
Hurricane,Katrina,10,2005-08-26T03:00:00Z,NEW ORLEANS LA,0,0,0,7,7
Hurricane,Katrina,10,2005-08-26T03:00:00Z,DAYTONA BEACH FL,1,4,4,5,14
Hurricane,Katrina,10,2005-08-26T03:00:00Z,NEW IBERIA LA,0,0,0,4,4
Hurricane,Katrina,10,2005-08-26T03:00:00Z,JACKSONVILLE FL,0,2,5,6,13
Hurricane,Katrina,10,2005-08-26T03:00:00Z,GULF 29N 85W,2,8,5,5,20
Hurricane,Katrina,10,2005-08-26T03:00:00Z,SAVANNAH GA,0,0,1,7,8
Hurricane,Katrina,10,2005-08-26T03:00:00Z,GULF 29N 87W,0,2,5,9,16
Hurricane,Katrina,10,2005-08-26T03:00:00Z,CHARLESTON SC,0,0,0,4,4
Hurricane,Katrina,10,2005-08-26T03:00:00Z,GULF 28N 89W,0,0,1,10,11
Hurricane,Katrina,10,2005-08-26T03:00:00Z,MYRTLE BEACH SC,0,0,0,2,2
Hurricane,Katrina,10,2005-08-26T03:00:00Z,GULF 28N 91W,0,0,0,6,6
Hurricane,Katrina,10,2005-08-26T03:00:00Z,KEY WEST FL,40,1,0,0,41
Hurricane,Katrina,10,2005-08-26T03:00:00Z,GULF 28N 93W,0,0,0,2,2
Hurricane,Katrina,10,2005-08-26T03:00:00Z,MARCO ISLAND FL,99,0,0,0,99
Hurricane,Katrina,11,2005-08-26T09:00:00Z,25.4N  83.8W,48,0,0,0,48
Hurricane,Katrina,11,2005-08-26T09:00:00Z,VENICE FL,32,0,0,0,32
Hurricane,Katrina,11,2005-08-26T09:00:00Z,25.9N  84.6W,35,0,1,0,36
Hurricane,Katrina,11,2005-08-26T09:00:00Z,TAMPA FL,13,4,1,2,20
Hurricane,Katrina,11,2005-08-26T09:00:00Z,26.6N  85.4W,17,6,1,1,25
Hurricane,Katrina,11,2005-08-26T09:00:00Z,CEDAR KEY FL,4,7,4,3,18
Hurricane,Katrina,11,2005-08-26T09:00:00Z,MUHA 230N 824W,6,0,0,1,7
Hurricane,Katrina,11,2005-08-26T09:00:00Z,ST MARKS FL,0,4,6,7,17
Hurricane,Katrina,11,2005-08-26T09:00:00Z,MUAN 219N 850W,0,1,1,0,2
Hurricane,Katrina,11,2005-08-26T09:00:00Z,APALACHICOLA FL,0,6,6,6,18
Hurricane,Katrina,11,2005-08-26T09:00:00Z,MARATHON FL,99,0,0,0,99
Hurricane,Katrina,11,2005-08-26T09:00:00Z,PANAMA CITY FL,0,2,7,8,17
Hurricane,Katrina,11,2005-08-26T09:00:00Z,MIAMI FL,99,0,0,0,99
Hurricane,Katrina,11,2005-08-26T09:00:00Z,PENSACOLA FL,0,0,3,11,14
Hurricane,Katrina,11,2005-08-26T09:00:00Z,W PALM BEACH FL,0,1,1,1,3
Hurricane,Katrina,11,2005-08-26T09:00:00Z,MOBILE AL,0,0,1,11,12
Hurricane,Katrina,11,2005-08-26T09:00:00Z,FT PIERCE FL,1,1,1,2,5
Hurricane,Katrina,11,2005-08-26T09:00:00Z,GULFPORT MS,0,0,0,11,11
Hurricane,Katrina,11,2005-08-26T09:00:00Z,COCOA BEACH FL,0,2,2,3,7
Hurricane,Katrina,11,2005-08-26T09:00:00Z,BURAS LA,0,0,1,10,11
Hurricane,Katrina,11,2005-08-26T09:00:00Z,DAYTONA BEACH FL,0,2,4,4,10
Hurricane,Katrina,11,2005-08-26T09:00:00Z,NEW ORLEANS LA,0,0,0,8,8
Hurricane,Katrina,11,2005-08-26T09:00:00Z,JACKSONVILLE FL,0,1,4,5,10
Hurricane,Katrina,11,2005-08-26T09:00:00Z,NEW IBERIA LA,0,0,0,5,5
Hurricane,Katrina,11,2005-08-26T09:00:00Z,SAVANNAH GA,0,0,1,5,6
Hurricane,Katrina,11,2005-08-26T09:00:00Z,GULF 29N 85W,2,9,5,4,20
Hurricane,Katrina,11,2005-08-26T09:00:00Z,CHARLESTON SC,0,0,0,3,3
Hurricane,Katrina,11,2005-08-26T09:00:00Z,GULF 29N 87W,0,2,7,8,17
Hurricane,Katrina,11,2005-08-26T09:00:00Z,KEY WEST FL,99,0,0,0,99
Hurricane,Katrina,11,2005-08-26T09:00:00Z,GULF 28N 89W,0,0,3,10,13
Hurricane,Katrina,11,2005-08-26T09:00:00Z,MARCO ISLAND FL,99,0,0,0,99
Hurricane,Katrina,11,2005-08-26T09:00:00Z,GULF 28N 91W,0,0,0,8,8
Hurricane,Katrina,11,2005-08-26T09:00:00Z,FT MYERS FL,53,0,0,0,53
Hurricane,Katrina,11,2005-08-26T09:00:00Z,GULF 28N 93W,0,0,0,3,3
Hurricane,Katrina,12,2005-08-26T15:00:00Z,25.5N  84.3W,48,0,0,0,48
Hurricane,Katrina,12,2005-08-26T15:00:00Z,CEDAR KEY FL,4,8,3,3,18
Hurricane,Katrina,12,2005-08-26T15:00:00Z,26.2N  85.2W,32,1,0,0,33
Hurricane,Katrina,12,2005-08-26T15:00:00Z,ST MARKS FL,0,6,5,6,17
Hurricane,Katrina,12,2005-08-26T15:00:00Z,27.1N  85.9W,14,7,1,2,24
Hurricane,Katrina,12,2005-08-26T15:00:00Z,APALACHICOLA FL,1,7,5,6,19
Hurricane,Katrina,12,2005-08-26T15:00:00Z,MUHA 230N 824W,2,0,0,0,2
Hurricane,Katrina,12,2005-08-26T15:00:00Z,PANAMA CITY FL,0,4,7,7,18
Hurricane,Katrina,12,2005-08-26T15:00:00Z,MARATHON FL,99,0,0,0,99
Hurricane,Katrina,12,2005-08-26T15:00:00Z,PENSACOLA FL,0,0,5,10,15
Hurricane,Katrina,12,2005-08-26T15:00:00Z,MIAMI FL,0,1,0,2,3
Hurricane,Katrina,12,2005-08-26T15:00:00Z,MOBILE AL,0,0,2,11,13
Hurricane,Katrina,12,2005-08-26T15:00:00Z,W PALM BEACH FL,0,1,1,2,4
Hurricane,Katrina,12,2005-08-26T15:00:00Z,GULFPORT MS,0,0,1,11,12
Hurricane,Katrina,12,2005-08-26T15:00:00Z,FT PIERCE FL,0,2,2,3,7
Hurricane,Katrina,12,2005-08-26T15:00:00Z,BURAS LA,0,0,2,10,12
Hurricane,Katrina,12,2005-08-26T15:00:00Z,COCOA BEACH FL,0,3,3,3,9
Hurricane,Katrina,12,2005-08-26T15:00:00Z,NEW ORLEANS LA,0,0,1,9,10
Hurricane,Katrina,12,2005-08-26T15:00:00Z,DAYTONA BEACH FL,0,3,4,5,12
Hurricane,Katrina,12,2005-08-26T15:00:00Z,NEW IBERIA LA,0,0,0,7,7
Hurricane,Katrina,12,2005-08-26T15:00:00Z,JACKSONVILLE FL,0,2,5,6,13
Hurricane,Katrina,12,2005-08-26T15:00:00Z,PORT ARTHUR TX,0,0,0,3,3
Hurricane,Katrina,12,2005-08-26T15:00:00Z,SAVANNAH GA,0,0,2,7,9
Hurricane,Katrina,12,2005-08-26T15:00:00Z,GALVESTON TX,0,0,0,2,2
Hurricane,Katrina,12,2005-08-26T15:00:00Z,CHARLESTON SC,0,0,0,5,5
Hurricane,Katrina,12,2005-08-26T15:00:00Z,GULF 29N 85W,4,9,4,3,20
Hurricane,Katrina,12,2005-08-26T15:00:00Z,MYRTLE BEACH SC,0,0,0,3,3
Hurricane,Katrina,12,2005-08-26T15:00:00Z,GULF 29N 87W,0,5,7,6,18
Hurricane,Katrina,12,2005-08-26T15:00:00Z,KEY WEST FL,99,0,0,0,99
Hurricane,Katrina,12,2005-08-26T15:00:00Z,GULF 28N 89W,0,1,6,7,14
Hurricane,Katrina,12,2005-08-26T15:00:00Z,MARCO ISLAND FL,99,0,0,0,99
Hurricane,Katrina,12,2005-08-26T15:00:00Z,GULF 28N 91W,0,0,1,8,9
Hurricane,Katrina,12,2005-08-26T15:00:00Z,FT MYERS FL,58,0,0,0,58
Hurricane,Katrina,12,2005-08-26T15:00:00Z,GULF 28N 93W,0,0,0,4,4
Hurricane,Katrina,12,2005-08-26T15:00:00Z,VENICE FL,35,0,0,0,35
Hurricane,Katrina,12,2005-08-26T15:00:00Z,GULF 28N 95W,0,0,0,2,2
Hurricane,Katrina,12,2005-08-26T15:00:00Z,TAMPA FL,13,4,1,2,20
Hurricane,Katrina,13,2005-08-26T15:30:00Z,25.5N  84.3W,49,0,0,0,49
Hurricane,Katrina,13,2005-08-26T15:30:00Z,TAMPA FL,13,3,1,2,19
Hurricane,Katrina,13,2005-08-26T15:30:00Z,26.2N  85.2W,33,0,1,0,34
Hurricane,Katrina,13,2005-08-26T15:30:00Z,CEDAR KEY FL,4,7,4,3,18
Hurricane,Katrina,13,2005-08-26T15:30:00Z,27.1N  85.9W,14,8,2,1,25
Hurricane,Katrina,13,2005-08-26T15:30:00Z,ST MARKS FL,0,6,6,5,17
Hurricane,Katrina,13,2005-08-26T15:30:00Z,MUHA 230N 824W,1,1,0,0,2
Hurricane,Katrina,13,2005-08-26T15:30:00Z,APALACHICOLA FL,1,7,6,5,19
Hurricane,Katrina,13,2005-08-26T15:30:00Z,MARATHON FL,99,0,0,0,99
Hurricane,Katrina,13,2005-08-26T15:30:00Z,PANAMA CITY FL,0,5,7,6,18
Hurricane,Katrina,13,2005-08-26T15:30:00Z,MIAMI FL,0,0,1,2,3
Hurricane,Katrina,13,2005-08-26T15:30:00Z,PENSACOLA FL,0,0,6,10,16
Hurricane,Katrina,13,2005-08-26T15:30:00Z,W PALM BEACH FL,0,0,1,3,4
Hurricane,Katrina,13,2005-08-26T15:30:00Z,MOBILE AL,0,0,3,11,14
Hurricane,Katrina,13,2005-08-26T15:30:00Z,FT PIERCE FL,0,1,1,4,6
Hurricane,Katrina,13,2005-08-26T15:30:00Z,GULFPORT MS,0,0,2,11,13
Hurricane,Katrina,13,2005-08-26T15:30:00Z,COCOA BEACH FL,0,1,3,4,8
Hurricane,Katrina,13,2005-08-26T15:30:00Z,BURAS LA,0,0,3,10,13
Hurricane,Katrina,13,2005-08-26T15:30:00Z,DAYTONA BEACH FL,0,2,3,6,11
Hurricane,Katrina,13,2005-08-26T15:30:00Z,NEW ORLEANS LA,0,0,1,10,11
Hurricane,Katrina,13,2005-08-26T15:30:00Z,JACKSONVILLE FL,0,1,4,7,12
Hurricane,Katrina,13,2005-08-26T15:30:00Z,NEW IBERIA LA,0,0,0,7,7
Hurricane,Katrina,13,2005-08-26T15:30:00Z,SAVANNAH GA,0,0,1,7,8
Hurricane,Katrina,13,2005-08-26T15:30:00Z,PORT ARTHUR TX,0,0,0,3,3
Hurricane,Katrina,13,2005-08-26T15:30:00Z,CHARLESTON SC,0,0,0,4,4
Hurricane,Katrina,13,2005-08-26T15:30:00Z,GALVESTON TX,0,0,0,2,2
Hurricane,Katrina,13,2005-08-26T15:30:00Z,MYRTLE BEACH SC,0,0,0,2,2
Hurricane,Katrina,13,2005-08-26T15:30:00Z,GULF 29N 85W,4,10,4,3,21
Hurricane,Katrina,13,2005-08-26T15:30:00Z,KEY WEST FL,99,0,0,0,99
Hurricane,Katrina,13,2005-08-26T15:30:00Z,GULF 29N 87W,0,5,8,6,19
Hurricane,Katrina,13,2005-08-26T15:30:00Z,MARCO ISLAND FL,99,0,0,0,99
Hurricane,Katrina,13,2005-08-26T15:30:00Z,GULF 28N 89W,0,1,7,7,15
Hurricane,Katrina,13,2005-08-26T15:30:00Z,FT MYERS FL,56,0,0,0,56
Hurricane,Katrina,13,2005-08-26T15:30:00Z,GULF 28N 91W,0,0,1,8,9
Hurricane,Katrina,13,2005-08-26T15:30:00Z,VENICE FL,35,0,0,0,35
Hurricane,Katrina,13,2005-08-26T15:30:00Z,GULF 28N 93W,0,0,0,4,4
Hurricane,Katrina,14,2005-08-26T21:00:00Z,25.2N  85.1W,46,0,0,0,46
Hurricane,Katrina,14,2005-08-26T21:00:00Z,PENSACOLA FL,0,1,7,9,17
Hurricane,Katrina,14,2005-08-26T21:00:00Z,25.8N  86.4W,24,4,0,0,28
Hurricane,Katrina,14,2005-08-26T21:00:00Z,MOBILE AL,0,0,6,10,16
Hurricane,Katrina,14,2005-08-26T21:00:00Z,26.9N  87.7W,2,15,4,1,22
Hurricane,Katrina,14,2005-08-26T21:00:00Z,GULFPORT MS,0,0,5,11,16
Hurricane,Katrina,14,2005-08-26T21:00:00Z,MUHA 230N 824W,1,1,0,0,2
Hurricane,Katrina,14,2005-08-26T21:00:00Z,BURAS LA,0,0,8,9,17
Hurricane,Katrina,14,2005-08-26T21:00:00Z,MUAN 219N 850W,1,1,0,0,2
Hurricane,Katrina,14,2005-08-26T21:00:00Z,NEW ORLEANS LA,0,0,4,11,15
Hurricane,Katrina,14,2005-08-26T21:00:00Z,COCOA BEACH FL,0,0,1,1,2
Hurricane,Katrina,14,2005-08-26T21:00:00Z,NEW IBERIA LA,0,0,1,11,12
Hurricane,Katrina,14,2005-08-26T21:00:00Z,DAYTONA BEACH FL,0,0,1,3,4
Hurricane,Katrina,14,2005-08-26T21:00:00Z,PORT ARTHUR TX,0,0,0,7,7
Hurricane,Katrina,14,2005-08-26T21:00:00Z,JACKSONVILLE FL,0,0,1,5,6
Hurricane,Katrina,14,2005-08-26T21:00:00Z,GALVESTON TX,0,0,0,5,5
Hurricane,Katrina,14,2005-08-26T21:00:00Z,SAVANNAH GA,0,0,0,3,3
Hurricane,Katrina,14,2005-08-26T21:00:00Z,FREEPORT TX,0,0,0,4,4
Hurricane,Katrina,14,2005-08-26T21:00:00Z,KEY WEST FL,99,0,0,0,99
Hurricane,Katrina,14,2005-08-26T21:00:00Z,PORT O CONNOR TX,0,0,0,2,2
Hurricane,Katrina,14,2005-08-26T21:00:00Z,MARCO ISLAND FL,45,0,0,0,45
Hurricane,Katrina,14,2005-08-26T21:00:00Z,GULF 29N 85W,3,9,4,2,18
Hurricane,Katrina,14,2005-08-26T21:00:00Z,FT MYERS FL,19,1,0,0,20
Hurricane,Katrina,14,2005-08-26T21:00:00Z,GULF 29N 87W,0,8,8,4,20
Hurricane,Katrina,14,2005-08-26T21:00:00Z,VENICE FL,12,2,0,1,15
Hurricane,Katrina,14,2005-08-26T21:00:00Z,GULF 28N 89W,0,4,11,4,19
Hurricane,Katrina,14,2005-08-26T21:00:00Z,TAMPA FL,3,4,2,2,11
Hurricane,Katrina,14,2005-08-26T21:00:00Z,GULF 28N 91W,0,0,6,8,14
Hurricane,Katrina,14,2005-08-26T21:00:00Z,CEDAR KEY FL,1,4,4,3,12
Hurricane,Katrina,14,2005-08-26T21:00:00Z,GULF 28N 93W,0,0,1,8,9
Hurricane,Katrina,14,2005-08-26T21:00:00Z,ST MARKS FL,0,3,5,5,13
Hurricane,Katrina,14,2005-08-26T21:00:00Z,GULF 28N 95W,0,0,0,4,4
Hurricane,Katrina,14,2005-08-26T21:00:00Z,APALACHICOLA FL,0,6,6,5,17
Hurricane,Katrina,14,2005-08-26T21:00:00Z,GULF 27N 96W,0,0,0,2,2
Hurricane,Katrina,14,2005-08-26T21:00:00Z,PANAMA CITY FL,0,4,8,5,17
Hurricane,Katrina,15,2005-08-27T03:00:00Z,25.0N  86.0W,46,0,0,0,46
Hurricane,Katrina,15,2005-08-27T03:00:00Z,BURAS LA,0,2,11,6,19
Hurricane,Katrina,15,2005-08-27T03:00:00Z,26.0N  87.5W,20,10,0,0,30
Hurricane,Katrina,15,2005-08-27T03:00:00Z,NEW ORLEANS LA,0,0,8,9,17
Hurricane,Katrina,15,2005-08-27T03:00:00Z,27.0N  89.0W,1,15,6,1,23
Hurricane,Katrina,15,2005-08-27T03:00:00Z,NEW IBERIA LA,0,0,2,12,14
Hurricane,Katrina,15,2005-08-27T03:00:00Z,MUAN 219N 850W,2,0,0,0,2
Hurricane,Katrina,15,2005-08-27T03:00:00Z,PORT ARTHUR TX,0,0,0,9,9
Hurricane,Katrina,15,2005-08-27T03:00:00Z,JACKSONVILLE FL,0,0,0,2,2
Hurricane,Katrina,15,2005-08-27T03:00:00Z,GALVESTON TX,0,0,0,7,7
Hurricane,Katrina,15,2005-08-27T03:00:00Z,VENICE FL,1,1,0,1,3
Hurricane,Katrina,15,2005-08-27T03:00:00Z,FREEPORT TX,0,0,0,5,5
Hurricane,Katrina,15,2005-08-27T03:00:00Z,TAMPA FL,0,1,1,1,3
Hurricane,Katrina,15,2005-08-27T03:00:00Z,PORT O CONNOR TX,0,0,0,3,3
Hurricane,Katrina,15,2005-08-27T03:00:00Z,CEDAR KEY FL,0,1,1,3,5
Hurricane,Katrina,15,2005-08-27T03:00:00Z,GULF 29N 85W,1,9,3,2,15
Hurricane,Katrina,15,2005-08-27T03:00:00Z,ST MARKS FL,0,1,4,4,9
Hurricane,Katrina,15,2005-08-27T03:00:00Z,GULF 29N 87W,1,13,5,2,21
Hurricane,Katrina,15,2005-08-27T03:00:00Z,APALACHICOLA FL,0,5,5,3,13
Hurricane,Katrina,15,2005-08-27T03:00:00Z,GULF 28N 89W,0,11,9,2,22
Hurricane,Katrina,15,2005-08-27T03:00:00Z,PANAMA CITY FL,0,5,6,4,15
Hurricane,Katrina,15,2005-08-27T03:00:00Z,GULF 28N 91W,0,1,11,5,17
Hurricane,Katrina,15,2005-08-27T03:00:00Z,PENSACOLA FL,0,2,9,6,17
Hurricane,Katrina,15,2005-08-27T03:00:00Z,GULF 28N 93W,0,0,2,9,11
Hurricane,Katrina,15,2005-08-27T03:00:00Z,MOBILE AL,0,1,8,8,17
Hurricane,Katrina,15,2005-08-27T03:00:00Z,GULF 28N 95W,0,0,0,6,6
Hurricane,Katrina,15,2005-08-27T03:00:00Z,GULFPORT MS,0,1,8,9,18
Hurricane,Katrina,15,2005-08-27T03:00:00Z,GULF 27N 96W,0,0,0,3,3
Hurricane,Katrina,16,2005-08-27T09:00:00Z,25.0N  87.0W,43,0,0,0,43
Hurricane,Katrina,16,2005-08-27T09:00:00Z,BURAS LA,0,3,11,4,18
Hurricane,Katrina,16,2005-08-27T09:00:00Z,26.0N  88.7W,19,9,1,0,29
Hurricane,Katrina,16,2005-08-27T09:00:00Z,NEW ORLEANS LA,0,1,9,7,17
Hurricane,Katrina,16,2005-08-27T09:00:00Z,27.4N  89.9W,1,17,4,1,23
Hurricane,Katrina,16,2005-08-27T09:00:00Z,NEW IBERIA LA,0,0,9,7,16
Hurricane,Katrina,16,2005-08-27T09:00:00Z,DAYTONA BEACH FL,0,0,0,2,2
Hurricane,Katrina,16,2005-08-27T09:00:00Z,PORT ARTHUR TX,0,0,4,9,13
Hurricane,Katrina,16,2005-08-27T09:00:00Z,JACKSONVILLE FL,0,0,0,3,3
Hurricane,Katrina,16,2005-08-27T09:00:00Z,GALVESTON TX,0,0,4,8,12
Hurricane,Katrina,16,2005-08-27T09:00:00Z,SAVANNAH GA,0,0,0,2,2
Hurricane,Katrina,16,2005-08-27T09:00:00Z,FREEPORT TX,0,0,3,8,11
Hurricane,Katrina,16,2005-08-27T09:00:00Z,MARCO ISLAND FL,0,1,0,1,2
Hurricane,Katrina,16,2005-08-27T09:00:00Z,PORT O CONNOR TX,0,0,2,6,8
Hurricane,Katrina,16,2005-08-27T09:00:00Z,FT MYERS FL,0,1,0,1,2
Hurricane,Katrina,16,2005-08-27T09:00:00Z,CORPUSCHRISTI TX,0,0,1,4,5
Hurricane,Katrina,16,2005-08-27T09:00:00Z,VENICE FL,1,1,1,1,4
Hurricane,Katrina,16,2005-08-27T09:00:00Z,BROWNSVILLE TX,0,0,1,2,3
Hurricane,Katrina,16,2005-08-27T09:00:00Z,TAMPA FL,0,1,1,2,4
Hurricane,Katrina,16,2005-08-27T09:00:00Z,GULF 29N 85W,0,2,4,5,11
Hurricane,Katrina,16,2005-08-27T09:00:00Z,CEDAR KEY FL,0,0,1,4,5
Hurricane,Katrina,16,2005-08-27T09:00:00Z,GULF 29N 87W,0,6,6,4,16
Hurricane,Katrina,16,2005-08-27T09:00:00Z,ST MARKS FL,0,0,2,6,8
Hurricane,Katrina,16,2005-08-27T09:00:00Z,GULF 28N 89W,1,14,5,2,22
Hurricane,Katrina,16,2005-08-27T09:00:00Z,APALACHICOLA FL,0,1,3,6,10
Hurricane,Katrina,16,2005-08-27T09:00:00Z,GULF 28N 91W,0,10,9,2,21
Hurricane,Katrina,16,2005-08-27T09:00:00Z,PANAMA CITY FL,0,1,3,7,11
Hurricane,Katrina,16,2005-08-27T09:00:00Z,GULF 28N 93W,0,3,10,4,17
Hurricane,Katrina,16,2005-08-27T09:00:00Z,PENSACOLA FL,0,0,6,7,13
Hurricane,Katrina,16,2005-08-27T09:00:00Z,GULF 28N 95W,0,0,6,6,12
Hurricane,Katrina,16,2005-08-27T09:00:00Z,MOBILE AL,0,0,6,8,14
Hurricane,Katrina,16,2005-08-27T09:00:00Z,GULF 27N 96W,0,0,3,5,8
Hurricane,Katrina,16,2005-08-27T09:00:00Z,GULFPORT MS,0,1,7,8,16
Hurricane,Katrina,16,2005-08-27T09:00:00Z,GULF 25N 96W,0,0,2,2,4
Hurricane,Katrina,17,2005-08-27T15:00:00Z,25.3N  87.6W,42,0,0,0,42
Hurricane,Katrina,17,2005-08-27T15:00:00Z,NEW ORLEANS LA,0,3,13,3,19
Hurricane,Katrina,17,2005-08-27T15:00:00Z,26.7N  89.0W,17,12,0,0,29
Hurricane,Katrina,17,2005-08-27T15:00:00Z,NEW IBERIA LA,0,1,12,5,18
Hurricane,Katrina,17,2005-08-27T15:00:00Z,28.6N  89.9W,0,15,7,1,23
Hurricane,Katrina,17,2005-08-27T15:00:00Z,PORT ARTHUR TX,0,0,7,7,14
Hurricane,Katrina,17,2005-08-27T15:00:00Z,DAYTONA BEACH FL,0,0,0,2,2
Hurricane,Katrina,17,2005-08-27T15:00:00Z,GALVESTON TX,0,0,6,6,12
Hurricane,Katrina,17,2005-08-27T15:00:00Z,JACKSONVILLE FL,0,0,0,4,4
Hurricane,Katrina,17,2005-08-27T15:00:00Z,FREEPORT TX,0,0,4,6,10
Hurricane,Katrina,17,2005-08-27T15:00:00Z,SAVANNAH GA,0,0,0,3,3
Hurricane,Katrina,17,2005-08-27T15:00:00Z,PORT O CONNOR TX,0,0,2,5,7
Hurricane,Katrina,17,2005-08-27T15:00:00Z,CHARLESTON SC,0,0,0,2,2
Hurricane,Katrina,17,2005-08-27T15:00:00Z,CORPUSCHRISTI TX,0,0,1,3,4
Hurricane,Katrina,17,2005-08-27T15:00:00Z,VENICE FL,0,0,1,2,3
Hurricane,Katrina,17,2005-08-27T15:00:00Z,BROWNSVILLE TX,0,0,0,2,2
Hurricane,Katrina,17,2005-08-27T15:00:00Z,TAMPA FL,0,0,1,2,3
Hurricane,Katrina,17,2005-08-27T15:00:00Z,GULF 29N 85W,0,3,5,3,11
Hurricane,Katrina,17,2005-08-27T15:00:00Z,CEDAR KEY FL,0,0,2,3,5
Hurricane,Katrina,17,2005-08-27T15:00:00Z,GULF 29N 87W,1,8,7,2,18
Hurricane,Katrina,17,2005-08-27T15:00:00Z,ST MARKS FL,0,0,3,6,9
Hurricane,Katrina,17,2005-08-27T15:00:00Z,GULF 28N 89W,3,18,3,0,24
Hurricane,Katrina,17,2005-08-27T15:00:00Z,APALACHICOLA FL,0,1,5,5,11
Hurricane,Katrina,17,2005-08-27T15:00:00Z,GULF 28N 91W,0,15,6,1,22
Hurricane,Katrina,17,2005-08-27T15:00:00Z,PANAMA CITY FL,0,1,6,5,12
Hurricane,Katrina,17,2005-08-27T15:00:00Z,GULF 28N 93W,0,4,10,3,17
Hurricane,Katrina,17,2005-08-27T15:00:00Z,PENSACOLA FL,0,1,9,5,15
Hurricane,Katrina,17,2005-08-27T15:00:00Z,GULF 28N 95W,0,0,6,4,10
Hurricane,Katrina,17,2005-08-27T15:00:00Z,MOBILE AL,0,1,10,6,17
Hurricane,Katrina,17,2005-08-27T15:00:00Z,GULF 27N 96W,0,0,2,4,6
Hurricane,Katrina,17,2005-08-27T15:00:00Z,GULFPORT MS,0,2,12,4,18
Hurricane,Katrina,17,2005-08-27T15:00:00Z,GULF 25N 96W,0,0,1,1,2
Hurricane,Katrina,17,2005-08-27T15:00:00Z,BURAS LA,0,8,11,2,21
Hurricane,Katrina,18,2005-08-27T21:00:00Z,25.8N  88.3W,43,0,0,0,43
Hurricane,Katrina,18,2005-08-27T21:00:00Z,NEW ORLEANS LA,0,9,11,1,21
Hurricane,Katrina,18,2005-08-27T21:00:00Z,27.5N  89.6W,14,15,0,0,29
Hurricane,Katrina,18,2005-08-27T21:00:00Z,NEW IBERIA LA,0,6,12,2,20
Hurricane,Katrina,18,2005-08-27T21:00:00Z,29.6N  90.0W,0,14,7,1,22
Hurricane,Katrina,18,2005-08-27T21:00:00Z,PORT ARTHUR TX,0,1,10,4,15
Hurricane,Katrina,18,2005-08-27T21:00:00Z,JACKSONVILLE FL,0,0,0,3,3
Hurricane,Katrina,18,2005-08-27T21:00:00Z,GALVESTON TX,0,1,8,3,12
Hurricane,Katrina,18,2005-08-27T21:00:00Z,SAVANNAH GA,0,0,0,3,3
Hurricane,Katrina,18,2005-08-27T21:00:00Z,FREEPORT TX,0,1,6,3,10
Hurricane,Katrina,18,2005-08-27T21:00:00Z,CHARLESTON SC,0,0,0,2,2
Hurricane,Katrina,18,2005-08-27T21:00:00Z,PORT O CONNOR TX,0,0,3,3,6
Hurricane,Katrina,18,2005-08-27T21:00:00Z,TAMPA FL,0,0,0,2,2
Hurricane,Katrina,18,2005-08-27T21:00:00Z,CORPUSCHRISTI TX,0,0,1,2,3
Hurricane,Katrina,18,2005-08-27T21:00:00Z,CEDAR KEY FL,0,0,1,3,4
Hurricane,Katrina,18,2005-08-27T21:00:00Z,GULF 29N 85W,0,3,4,3,10
Hurricane,Katrina,18,2005-08-27T21:00:00Z,ST MARKS FL,0,0,3,5,8
Hurricane,Katrina,18,2005-08-27T21:00:00Z,GULF 29N 87W,2,10,4,1,17
Hurricane,Katrina,18,2005-08-27T21:00:00Z,APALACHICOLA FL,0,1,5,4,10
Hurricane,Katrina,18,2005-08-27T21:00:00Z,GULF 28N 89W,11,15,1,0,27
Hurricane,Katrina,18,2005-08-27T21:00:00Z,PANAMA CITY FL,0,2,6,4,12
Hurricane,Katrina,18,2005-08-27T21:00:00Z,GULF 28N 91W,2,21,2,0,25
Hurricane,Katrina,18,2005-08-27T21:00:00Z,PENSACOLA FL,0,3,9,4,16
Hurricane,Katrina,18,2005-08-27T21:00:00Z,GULF 28N 93W,0,11,5,1,17
Hurricane,Katrina,18,2005-08-27T21:00:00Z,MOBILE AL,0,4,11,3,18
Hurricane,Katrina,18,2005-08-27T21:00:00Z,GULF 28N 95W,0,2,5,2,9
Hurricane,Katrina,18,2005-08-27T21:00:00Z,GULFPORT MS,0,6,11,3,20
Hurricane,Katrina,18,2005-08-27T21:00:00Z,GULF 27N 96W,0,0,2,2,4
Hurricane,Katrina,18,2005-08-27T21:00:00Z,BURAS LA,1,15,6,1,23
Hurricane,Katrina,19,2005-08-28T03:00:00Z,27.0N  89.0W,40,0,0,0,40
Hurricane,Katrina,19,2005-08-28T03:00:00Z,BURAS LA,3,23,1,0,27
Hurricane,Katrina,19,2005-08-28T03:00:00Z,29.0N  89.8W,7,21,1,0,29
Hurricane,Katrina,19,2005-08-28T03:00:00Z,NEW ORLEANS LA,0,23,3,0,26
Hurricane,Katrina,19,2005-08-28T03:00:00Z,31.0N  89.8W,0,12,9,1,22
Hurricane,Katrina,19,2005-08-28T03:00:00Z,NEW IBERIA LA,0,18,4,1,23
Hurricane,Katrina,19,2005-08-28T03:00:00Z,JACKSONVILLE FL,0,0,0,3,3
Hurricane,Katrina,19,2005-08-28T03:00:00Z,PORT ARTHUR TX,0,7,6,1,14
Hurricane,Katrina,19,2005-08-28T03:00:00Z,SAVANNAH GA,0,0,0,4,4
Hurricane,Katrina,19,2005-08-28T03:00:00Z,GALVESTON TX,0,4,5,1,10
Hurricane,Katrina,19,2005-08-28T03:00:00Z,CHARLESTON SC,0,0,0,3,3
Hurricane,Katrina,19,2005-08-28T03:00:00Z,FREEPORT TX,0,2,3,2,7
Hurricane,Katrina,19,2005-08-28T03:00:00Z,MYRTLE BEACH SC,0,0,0,2,2
Hurricane,Katrina,19,2005-08-28T03:00:00Z,PORT O CONNOR TX,0,1,0,2,3
Hurricane,Katrina,19,2005-08-28T03:00:00Z,CEDAR KEY FL,0,0,1,2,3
Hurricane,Katrina,19,2005-08-28T03:00:00Z,GULF 29N 85W,1,4,3,1,9
Hurricane,Katrina,19,2005-08-28T03:00:00Z,ST MARKS FL,0,1,3,3,7
Hurricane,Katrina,19,2005-08-28T03:00:00Z,GULF 29N 87W,6,12,1,0,19
Hurricane,Katrina,19,2005-08-28T03:00:00Z,APALACHICOLA FL,0,3,5,1,9
Hurricane,Katrina,19,2005-08-28T03:00:00Z,GULF 28N 89W,25,6,0,0,31
Hurricane,Katrina,19,2005-08-28T03:00:00Z,PANAMA CITY FL,0,5,5,2,12
Hurricane,Katrina,19,2005-08-28T03:00:00Z,GULF 28N 91W,13,14,0,0,27
Hurricane,Katrina,19,2005-08-28T03:00:00Z,PENSACOLA FL,0,9,7,1,17
Hurricane,Katrina,19,2005-08-28T03:00:00Z,GULF 28N 93W,2,12,1,1,16
Hurricane,Katrina,19,2005-08-28T03:00:00Z,MOBILE AL,0,12,7,1,20
Hurricane,Katrina,19,2005-08-28T03:00:00Z,GULF 28N 95W,0,3,2,0,5
Hurricane,Katrina,19,2005-08-28T03:00:00Z,GULFPORT MS,0,17,6,0,23
Hurricane,Katrina,20,2005-08-28T06:00:00Z,27.0N  89.0W,39,0,0,0,39
Hurricane,Katrina,20,2005-08-28T06:00:00Z,MOBILE AL,0,12,7,1,20
Hurricane,Katrina,20,2005-08-28T06:00:00Z,29.0N  89.8W,10,17,1,0,28
Hurricane,Katrina,20,2005-08-28T06:00:00Z,GULFPORT MS,1,16,5,1,23
Hurricane,Katrina,20,2005-08-28T06:00:00Z,31.0N  89.8W,0,13,8,1,22
Hurricane,Katrina,20,2005-08-28T06:00:00Z,BURAS LA,6,19,1,1,27
Hurricane,Katrina,20,2005-08-28T06:00:00Z,DAYTONA BEACH FL,0,0,0,2,2
Hurricane,Katrina,20,2005-08-28T06:00:00Z,NEW ORLEANS LA,2,20,3,0,25
Hurricane,Katrina,20,2005-08-28T06:00:00Z,JACKSONVILLE FL,0,0,0,4,4
Hurricane,Katrina,20,2005-08-28T06:00:00Z,NEW IBERIA LA,1,17,3,1,22
Hurricane,Katrina,20,2005-08-28T06:00:00Z,SAVANNAH GA,0,0,0,4,4
Hurricane,Katrina,20,2005-08-28T06:00:00Z,PORT ARTHUR TX,0,8,5,1,14
Hurricane,Katrina,20,2005-08-28T06:00:00Z,CHARLESTON SC,0,0,0,3,3
Hurricane,Katrina,20,2005-08-28T06:00:00Z,GALVESTON TX,0,5,4,1,10
Hurricane,Katrina,20,2005-08-28T06:00:00Z,MYRTLE BEACH SC,0,0,0,2,2
Hurricane,Katrina,20,2005-08-28T06:00:00Z,FREEPORT TX,0,2,3,1,6
Hurricane,Katrina,20,2005-08-28T06:00:00Z,WILMINGTON NC,0,0,0,2,2
Hurricane,Katrina,20,2005-08-28T06:00:00Z,PORT O CONNOR TX,0,1,0,1,2
Hurricane,Katrina,20,2005-08-28T06:00:00Z,TAMPA FL,0,0,1,1,2
Hurricane,Katrina,20,2005-08-28T06:00:00Z,GULF 29N 85W,1,4,3,2,10
Hurricane,Katrina,20,2005-08-28T06:00:00Z,CEDAR KEY FL,0,0,2,2,4
Hurricane,Katrina,20,2005-08-28T06:00:00Z,GULF 29N 87W,6,11,2,0,19
Hurricane,Katrina,20,2005-08-28T06:00:00Z,ST MARKS FL,0,1,3,5,9
Hurricane,Katrina,20,2005-08-28T06:00:00Z,GULF 28N 89W,26,4,0,1,31
Hurricane,Katrina,20,2005-08-28T06:00:00Z,APALACHICOLA FL,0,3,5,3,11
Hurricane,Katrina,20,2005-08-28T06:00:00Z,GULF 28N 91W,17,10,0,0,27
Hurricane,Katrina,20,2005-08-28T06:00:00Z,PANAMA CITY FL,0,5,5,3,13
Hurricane,Katrina,20,2005-08-28T06:00:00Z,GULF 28N 93W,3,12,1,0,16
Hurricane,Katrina,20,2005-08-28T06:00:00Z,PENSACOLA FL,0,9,7,2,18
Hurricane,Katrina,20,2005-08-28T06:00:00Z,GULF 28N 95W,0,3,2,1,6
Hurricane,Katrina,21,2005-08-28T09:00:00Z,28.0N  89.4W,38,0,0,1,39
Hurricane,Katrina,21,2005-08-28T09:00:00Z,MOBILE AL,1,17,4,1,23
Hurricane,Katrina,21,2005-08-28T09:00:00Z,30.0N  89.8W,7,21,0,0,28
Hurricane,Katrina,21,2005-08-28T09:00:00Z,GULFPORT MS,3,21,2,0,26
Hurricane,Katrina,21,2005-08-28T09:00:00Z,32.3N  89.3W,0,7,14,1,22
Hurricane,Katrina,21,2005-08-28T09:00:00Z,BURAS LA,17,12,0,1,30
Hurricane,Katrina,21,2005-08-28T09:00:00Z,JACKSONVILLE FL,0,0,0,3,3
Hurricane,Katrina,21,2005-08-28T09:00:00Z,NEW ORLEANS LA,7,21,1,0,29
Hurricane,Katrina,21,2005-08-28T09:00:00Z,SAVANNAH GA,0,0,0,4,4
Hurricane,Katrina,21,2005-08-28T09:00:00Z,NEW IBERIA LA,3,20,1,0,24
Hurricane,Katrina,21,2005-08-28T09:00:00Z,CHARLESTON SC,0,0,0,3,3
Hurricane,Katrina,21,2005-08-28T09:00:00Z,PORT ARTHUR TX,0,9,2,1,12
Hurricane,Katrina,21,2005-08-28T09:00:00Z,MYRTLE BEACH SC,0,0,0,3,3
Hurricane,Katrina,21,2005-08-28T09:00:00Z,GALVESTON TX,0,4,1,1,6
Hurricane,Katrina,21,2005-08-28T09:00:00Z,WILMINGTON NC,0,0,0,2,2
Hurricane,Katrina,21,2005-08-28T09:00:00Z,FREEPORT TX,0,1,1,0,2
Hurricane,Katrina,21,2005-08-28T09:00:00Z,CEDAR KEY FL,0,0,1,1,2
Hurricane,Katrina,21,2005-08-28T09:00:00Z,GULF 29N 85W,1,3,3,1,8
Hurricane,Katrina,21,2005-08-28T09:00:00Z,ST MARKS FL,0,1,3,3,7
Hurricane,Katrina,21,2005-08-28T09:00:00Z,GULF 29N 87W,10,8,1,0,19
Hurricane,Katrina,21,2005-08-28T09:00:00Z,APALACHICOLA FL,0,3,4,2,9
Hurricane,Katrina,21,2005-08-28T09:00:00Z,GULF 28N 89W,39,0,0,0,39
Hurricane,Katrina,21,2005-08-28T09:00:00Z,PANAMA CITY FL,0,5,5,1,11
Hurricane,Katrina,21,2005-08-28T09:00:00Z,GULF 28N 91W,26,2,0,0,28
Hurricane,Katrina,21,2005-08-28T09:00:00Z,PENSACOLA FL,1,12,5,1,19
Hurricane,Katrina,21,2005-08-28T09:00:00Z,GULF 28N 93W,6,5,0,1,12
Hurricane,Katrina,23,2005-08-28T15:00:00Z,29.1N  89.6W,40,0,0,1,41
Hurricane,Katrina,23,2005-08-28T15:00:00Z,PENSACOLA FL,7,13,3,0,23
Hurricane,Katrina,23,2005-08-28T15:00:00Z,31.4N  89.5W,12,19,0,1,32
Hurricane,Katrina,23,2005-08-28T15:00:00Z,MOBILE AL,15,13,1,0,29
Hurricane,Katrina,23,2005-08-28T15:00:00Z,34.5N  88.5W,0,5,18,1,24
Hurricane,Katrina,23,2005-08-28T15:00:00Z,GULFPORT MS,25,7,0,1,33
Hurricane,Katrina,23,2005-08-28T15:00:00Z,JACKSONVILLE FL,0,0,0,2,2
Hurricane,Katrina,23,2005-08-28T15:00:00Z,BURAS LA,38,0,0,0,38
Hurricane,Katrina,23,2005-08-28T15:00:00Z,SAVANNAH GA,0,0,0,3,3
Hurricane,Katrina,23,2005-08-28T15:00:00Z,NEW ORLEANS LA,31,3,1,0,35
Hurricane,Katrina,23,2005-08-28T15:00:00Z,CHARLESTON SC,0,0,0,3,3
Hurricane,Katrina,23,2005-08-28T15:00:00Z,NEW IBERIA LA,16,7,0,0,23
Hurricane,Katrina,23,2005-08-28T15:00:00Z,MYRTLE BEACH SC,0,0,0,2,2
Hurricane,Katrina,23,2005-08-28T15:00:00Z,PORT ARTHUR TX,1,3,0,1,5
Hurricane,Katrina,23,2005-08-28T15:00:00Z,WILMINGTON NC,0,0,0,2,2
Hurricane,Katrina,23,2005-08-28T15:00:00Z,GULF 29N 85W,0,3,2,1,6
Hurricane,Katrina,23,2005-08-28T15:00:00Z,NORFOLK VA,0,0,0,2,2
Hurricane,Katrina,23,2005-08-28T15:00:00Z,GULF 29N 87W,14,5,1,0,20
Hurricane,Katrina,23,2005-08-28T15:00:00Z,ST MARKS FL,0,1,3,2,6
Hurricane,Katrina,23,2005-08-28T15:00:00Z,GULF 28N 89W,55,0,0,0,55
Hurricane,Katrina,23,2005-08-28T15:00:00Z,APALACHICOLA FL,0,3,4,1,8
Hurricane,Katrina,23,2005-08-28T15:00:00Z,GULF 28N 91W,31,0,0,0,31
Hurricane,Katrina,23,2005-08-28T15:00:00Z,PANAMA CITY FL,1,5,6,0,12
Hurricane,Katrina,23,2005-08-28T15:00:00Z,GULF 28N 93W,4,3,0,0,7
Hurricane,Katrina,24,2005-08-28T21:00:00Z,30.6N  89.9W,40,1,0,0,41
Hurricane,Katrina,24,2005-08-28T21:00:00Z,PANAMA CITY FL,0,2,2,1,5
Hurricane,Katrina,24,2005-08-28T21:00:00Z,33.4N  89.2W,5,27,0,0,32
Hurricane,Katrina,24,2005-08-28T21:00:00Z,PENSACOLA FL,9,8,1,0,18
Hurricane,Katrina,24,2005-08-28T21:00:00Z,36.0N  87.5W,0,6,17,1,24
Hurricane,Katrina,24,2005-08-28T21:00:00Z,MOBILE AL,25,5,0,0,30
Hurricane,Katrina,24,2005-08-28T21:00:00Z,SAVANNAH GA,0,0,0,2,2
Hurricane,Katrina,24,2005-08-28T21:00:00Z,GULFPORT MS,36,2,0,0,38
Hurricane,Katrina,24,2005-08-28T21:00:00Z,CHARLESTON SC,0,0,0,2,2
Hurricane,Katrina,24,2005-08-28T21:00:00Z,BURAS LA,52,0,0,0,52
Hurricane,Katrina,24,2005-08-28T21:00:00Z,MYRTLE BEACH SC,0,0,0,2,2
Hurricane,Katrina,24,2005-08-28T21:00:00Z,NEW ORLEANS LA,46,0,0,1,47
Hurricane,Katrina,24,2005-08-28T21:00:00Z,WILMINGTON NC,0,0,0,2,2
Hurricane,Katrina,24,2005-08-28T21:00:00Z,NEW IBERIA LA,31,1,0,0,32
Hurricane,Katrina,24,2005-08-28T21:00:00Z,NORFOLK VA,0,0,0,3,3
Hurricane,Katrina,24,2005-08-28T21:00:00Z,PORT ARTHUR TX,3,2,0,0,5
Hurricane,Katrina,24,2005-08-28T21:00:00Z,OCEAN CITY MD,0,0,0,3,3
Hurricane,Katrina,24,2005-08-28T21:00:00Z,GULF 29N 87W,7,4,0,0,11
Hurricane,Katrina,24,2005-08-28T21:00:00Z,ATLANTIC CITY NJ,0,0,0,3,3
Hurricane,Katrina,24,2005-08-28T21:00:00Z,GULF 28N 89W,72,0,0,0,72
Hurricane,Katrina,24,2005-08-28T21:00:00Z,NEW YORK CITY NY,0,0,0,2,2
Hurricane,Katrina,24,2005-08-28T21:00:00Z,GULF 28N 91W,51,0,0,0,51
Hurricane,Katrina,24,2005-08-28T21:00:00Z,ST MARKS FL,0,0,1,1,2
Hurricane,Katrina,24,2005-08-28T21:00:00Z,GULF 28N 93W,8,1,0,0,9
Hurricane,Katrina,24,2005-08-28T21:00:00Z,APALACHICOLA FL,0,1,0,1,2
Hurricane,Katrina,25,2005-08-29T03:00:00Z,31.8N  89.5W,43,2,0,0,45
Hurricane,Katrina,25,2005-08-29T03:00:00Z,NANTUCKET MA,0,0,0,2,2
Hurricane,Katrina,25,2005-08-29T03:00:00Z,34.8N  88.1W,3,30,1,0,34
Hurricane,Katrina,25,2005-08-29T03:00:00Z,HYANNIS MA,0,0,0,2,2
Hurricane,Katrina,25,2005-08-29T03:00:00Z,37.7N  85.9W,0,3,20,1,24
Hurricane,Katrina,25,2005-08-29T03:00:00Z,BOSTON MA,0,0,0,2,2
Hurricane,Katrina,25,2005-08-29T03:00:00Z,CHARLESTON SC,0,0,0,2,2
Hurricane,Katrina,25,2005-08-29T03:00:00Z,PORTLAND ME,0,0,0,2,2
Hurricane,Katrina,25,2005-08-29T03:00:00Z,MYRTLE BEACH SC,0,0,0,2,2
Hurricane,Katrina,25,2005-08-29T03:00:00Z,PANAMA CITY FL,1,1,0,0,2
Hurricane,Katrina,25,2005-08-29T03:00:00Z,WILMINGTON NC,0,0,0,2,2
Hurricane,Katrina,25,2005-08-29T03:00:00Z,PENSACOLA FL,18,3,1,0,22
Hurricane,Katrina,25,2005-08-29T03:00:00Z,MOREHEAD CITY NC,0,0,0,2,2
Hurricane,Katrina,25,2005-08-29T03:00:00Z,MOBILE AL,40,0,0,0,40
Hurricane,Katrina,25,2005-08-29T03:00:00Z,CAPE HATTERAS NC,0,0,0,2,2
Hurricane,Katrina,25,2005-08-29T03:00:00Z,GULFPORT MS,54,0,0,0,54
Hurricane,Katrina,25,2005-08-29T03:00:00Z,NORFOLK VA,0,0,0,4,4
Hurricane,Katrina,25,2005-08-29T03:00:00Z,BURAS LA,77,0,0,0,77
Hurricane,Katrina,25,2005-08-29T03:00:00Z,OCEAN CITY MD,0,0,0,5,5
Hurricane,Katrina,25,2005-08-29T03:00:00Z,NEW ORLEANS LA,59,0,0,0,59
Hurricane,Katrina,25,2005-08-29T03:00:00Z,ATLANTIC CITY NJ,0,0,0,5,5
Hurricane,Katrina,25,2005-08-29T03:00:00Z,NEW IBERIA LA,28,1,0,0,29
Hurricane,Katrina,25,2005-08-29T03:00:00Z,NEW YORK CITY NY,0,0,0,5,5
Hurricane,Katrina,25,2005-08-29T03:00:00Z,GULF 29N 87W,8,2,0,0,10
Hurricane,Katrina,25,2005-08-29T03:00:00Z,MONTAUK POINT NY,0,0,0,3,3
Hurricane,Katrina,25,2005-08-29T03:00:00Z,GULF 28N 89W,99,0,0,0,99
Hurricane,Katrina,25,2005-08-29T03:00:00Z,PROVIDENCE RI,0,0,0,3,3
Hurricane,Katrina,25,2005-08-29T03:00:00Z,GULF 28N 91W,47,0,0,0,47
Hurricane,Katrina,26,2005-08-29T09:00:00Z,33.6N  89.0W,38,1,0,0,39
Hurricane,Katrina,26,2005-08-29T09:00:00Z,PORTLAND ME,0,0,0,4,4
Hurricane,Katrina,26,2005-08-29T09:00:00Z,36.7N  87.2W,3,20,1,1,25
Hurricane,Katrina,26,2005-08-29T09:00:00Z,BAR HARBOR ME,0,0,0,3,3
Hurricane,Katrina,26,2005-08-29T09:00:00Z,39.8N  84.1W,0,1,14,2,17
Hurricane,Katrina,26,2005-08-29T09:00:00Z,EASTPORT ME,0,0,0,2,2
Hurricane,Katrina,26,2005-08-29T09:00:00Z,NORFOLK VA,0,0,0,3,3
Hurricane,Katrina,26,2005-08-29T09:00:00Z,PANAMA CITY FL,1,1,0,0,2
Hurricane,Katrina,26,2005-08-29T09:00:00Z,OCEAN CITY MD,0,0,0,4,4
Hurricane,Katrina,26,2005-08-29T09:00:00Z,PENSACOLA FL,15,1,1,0,17
Hurricane,Katrina,26,2005-08-29T09:00:00Z,ATLANTIC CITY NJ,0,0,0,5,5
Hurricane,Katrina,26,2005-08-29T09:00:00Z,MOBILE AL,49,0,0,0,49
Hurricane,Katrina,26,2005-08-29T09:00:00Z,NEW YORK CITY NY,0,0,0,6,6
Hurricane,Katrina,26,2005-08-29T09:00:00Z,GULFPORT MS,72,0,0,0,72
Hurricane,Katrina,26,2005-08-29T09:00:00Z,MONTAUK POINT NY,0,0,0,4,4
Hurricane,Katrina,26,2005-08-29T09:00:00Z,BURAS LA,99,0,0,0,99
Hurricane,Katrina,26,2005-08-29T09:00:00Z,PROVIDENCE RI,0,0,0,4,4
Hurricane,Katrina,26,2005-08-29T09:00:00Z,NEW ORLEANS LA,74,0,0,0,74
Hurricane,Katrina,26,2005-08-29T09:00:00Z,NANTUCKET MA,0,0,0,3,3
Hurricane,Katrina,26,2005-08-29T09:00:00Z,NEW IBERIA LA,3,0,0,0,3
Hurricane,Katrina,26,2005-08-29T09:00:00Z,HYANNIS MA,0,0,0,3,3
Hurricane,Katrina,26,2005-08-29T09:00:00Z,GULF 29N 87W,2,1,0,0,3
Hurricane,Katrina,26,2005-08-29T09:00:00Z,BOSTON MA,0,0,0,4,4
Hurricane,Katrina,26,2005-08-29T09:00:00Z,GULF 28N 89W,99,0,0,0,99
Hurricane,Katrina,27,2005-08-29T15:00:00Z,35.4N  88.3W,51,1,0,0,52
Hurricane,Katrina,27,2005-08-29T15:00:00Z,PORTLAND ME,0,0,0,6,6
Hurricane,Katrina,27,2005-08-29T15:00:00Z,39.0N  86.0W,1,24,1,0,26
Hurricane,Katrina,27,2005-08-29T15:00:00Z,BAR HARBOR ME,0,0,0,5,5
Hurricane,Katrina,27,2005-08-29T15:00:00Z,42.0N  82.5W,0,1,14,2,17
Hurricane,Katrina,27,2005-08-29T15:00:00Z,EASTPORT ME,0,0,0,4,4
Hurricane,Katrina,27,2005-08-29T15:00:00Z,NORFOLK VA,0,0,1,2,3
Hurricane,Katrina,27,2005-08-29T15:00:00Z,ST JOHN NB,0,0,0,3,3
Hurricane,Katrina,27,2005-08-29T15:00:00Z,OCEAN CITY MD,0,0,1,4,5
Hurricane,Katrina,27,2005-08-29T15:00:00Z,MONCTON NB,0,0,0,2,2
Hurricane,Katrina,27,2005-08-29T15:00:00Z,ATLANTIC CITY NJ,0,0,1,5,6
Hurricane,Katrina,27,2005-08-29T15:00:00Z,YARMOUTH NS,0,0,0,3,3
Hurricane,Katrina,27,2005-08-29T15:00:00Z,NEW YORK CITY NY,0,0,0,7,7
Hurricane,Katrina,27,2005-08-29T15:00:00Z,MOBILE AL,60,0,0,0,60
Hurricane,Katrina,27,2005-08-29T15:00:00Z,MONTAUK POINT NY,0,0,0,6,6
Hurricane,Katrina,27,2005-08-29T15:00:00Z,GULFPORT MS,99,0,0,0,99
Hurricane,Katrina,27,2005-08-29T15:00:00Z,PROVIDENCE RI,0,0,0,6,6
Hurricane,Katrina,27,2005-08-29T15:00:00Z,BURAS LA,99,0,0,0,99
Hurricane,Katrina,27,2005-08-29T15:00:00Z,NANTUCKET MA,0,0,0,5,5
Hurricane,Katrina,27,2005-08-29T15:00:00Z,NEW ORLEANS LA,99,0,0,0,99
Hurricane,Katrina,27,2005-08-29T15:00:00Z,HYANNIS MA,0,0,0,5,5
Hurricane,Katrina,27,2005-08-29T15:00:00Z,NEW IBERIA LA,4,0,0,0,4
Hurricane,Katrina,27,2005-08-29T15:00:00Z,BOSTON MA,0,0,0,6,6
Hurricane,Katrina,27,2005-08-29T15:00:00Z,GULF 28N 89W,11,0,0,0,11
Hurricane,Katrina,28,2005-08-29T21:00:00Z,37.2N  87.3W,39,1,1,0,41
Hurricane,Katrina,28,2005-08-29T21:00:00Z,BAR HARBOR ME,0,0,0,8,8
Hurricane,Katrina,28,2005-08-29T21:00:00Z,40.5N  83.4W,0,20,1,1,22
Hurricane,Katrina,28,2005-08-29T21:00:00Z,EASTPORT ME,0,0,0,7,7
Hurricane,Katrina,28,2005-08-29T21:00:00Z,44.0N  78.0W,0,0,13,2,15
Hurricane,Katrina,28,2005-08-29T21:00:00Z,ST JOHN NB,0,0,0,6,6
Hurricane,Katrina,28,2005-08-29T21:00:00Z,NORFOLK VA,0,0,2,0,2
Hurricane,Katrina,28,2005-08-29T21:00:00Z,MONCTON NB,0,0,0,6,6
Hurricane,Katrina,28,2005-08-29T21:00:00Z,OCEAN CITY MD,0,0,3,1,4
Hurricane,Katrina,28,2005-08-29T21:00:00Z,YARMOUTH NS,0,0,0,5,5
Hurricane,Katrina,28,2005-08-29T21:00:00Z,ATLANTIC CITY NJ,0,0,5,1,6
Hurricane,Katrina,28,2005-08-29T21:00:00Z,HALIFAX NS,0,0,0,4,4
Hurricane,Katrina,28,2005-08-29T21:00:00Z,NEW YORK CITY NY,0,0,5,3,8
Hurricane,Katrina,28,2005-08-29T21:00:00Z,SYDNEY NS,0,0,0,2,2
Hurricane,Katrina,28,2005-08-29T21:00:00Z,MONTAUK POINT NY,0,0,3,4,7
Hurricane,Katrina,28,2005-08-29T21:00:00Z,EDDY POINT NS,0,0,0,3,3
Hurricane,Katrina,28,2005-08-29T21:00:00Z,PROVIDENCE RI,0,0,3,4,7
Hurricane,Katrina,28,2005-08-29T21:00:00Z,PTX BASQUES NFLD,0,0,0,2,2
Hurricane,Katrina,28,2005-08-29T21:00:00Z,NANTUCKET MA,0,0,1,5,6
Hurricane,Katrina,28,2005-08-29T21:00:00Z,MOBILE AL,77,0,0,0,77
Hurricane,Katrina,28,2005-08-29T21:00:00Z,HYANNIS MA,0,0,2,4,6
Hurricane,Katrina,28,2005-08-29T21:00:00Z,GULFPORT MS,99,0,0,0,99
Hurricane,Katrina,28,2005-08-29T21:00:00Z,BOSTON MA,0,0,2,6,8
Hurricane,Katrina,28,2005-08-29T21:00:00Z,NEW ORLEANS LA,20,0,0,0,20
Hurricane,Katrina,28,2005-08-29T21:00:00Z,PORTLAND ME,0,0,2,7,9
Tropical Storm,Katrina,29,2005-08-30T03:00:00Z,39.4N  84.1W,35,1,0,0,36
Tropical Storm,Katrina,29,2005-08-30T03:00:00Z,PORTLAND ME,0,0,7,3,10
Tropical Storm,Katrina,29,2005-08-30T03:00:00Z,42.5N  80.0W,1,20,3,0,24
Tropical Storm,Katrina,29,2005-08-30T03:00:00Z,BAR HARBOR ME,0,0,4,5,9
Tropical Storm,Katrina,29,2005-08-30T03:00:00Z,46.0N  73.5W,0,0,12,2,14
Tropical Storm,Katrina,29,2005-08-30T03:00:00Z,EASTPORT ME,0,0,2,6,8
Tropical Storm,Katrina,29,2005-08-30T03:00:00Z,NORFOLK VA,0,1,1,0,2
Tropical Storm,Katrina,29,2005-08-30T03:00:00Z,ST JOHN NB,0,0,1,7,8
Tropical Storm,Katrina,29,2005-08-30T03:00:00Z,OCEAN CITY MD,0,1,2,1,4
Tropical Storm,Katrina,29,2005-08-30T03:00:00Z,MONCTON NB,0,0,1,6,7
Tropical Storm,Katrina,29,2005-08-30T03:00:00Z,ATLANTIC CITY NJ,0,2,4,0,6
Tropical Storm,Katrina,29,2005-08-30T03:00:00Z,YARMOUTH NS,0,0,1,5,6
Tropical Storm,Katrina,29,2005-08-30T03:00:00Z,NEW YORK CITY NY,0,1,7,0,8
Tropical Storm,Katrina,29,2005-08-30T03:00:00Z,HALIFAX NS,0,0,0,5,5
Tropical Storm,Katrina,29,2005-08-30T03:00:00Z,MONTAUK POINT NY,0,0,6,1,7
Tropical Storm,Katrina,29,2005-08-30T03:00:00Z,SABLE ISLAND NS,0,0,0,2,2
Tropical Storm,Katrina,29,2005-08-30T03:00:00Z,PROVIDENCE RI,0,0,6,2,8
Tropical Storm,Katrina,29,2005-08-30T03:00:00Z,SYDNEY NS,0,0,0,3,3
Tropical Storm,Katrina,29,2005-08-30T03:00:00Z,NANTUCKET MA,0,0,4,2,6
Tropical Storm,Katrina,29,2005-08-30T03:00:00Z,EDDY POINT NS,0,0,0,4,4
Tropical Storm,Katrina,29,2005-08-30T03:00:00Z,HYANNIS MA,0,0,5,2,7
Tropical Storm,Katrina,29,2005-08-30T03:00:00Z,PTX BASQUES NFLD,0,0,0,3,3
Tropical Storm,Katrina,29,2005-08-30T03:00:00Z,BOSTON MA,0,0,7,2,9
Tropical Storm,Katrina,29,2005-08-30T03:00:00Z,BURGEO NFLD,0,0,0,2,2
Tropical Storm,Katrina,30,2005-08-30T09:00:00Z,40.3N  82.8W,33,2,0,0,35
Tropical Storm,Katrina,30,2005-08-30T09:00:00Z,BAR HARBOR ME,0,0,7,2,9
Tropical Storm,Katrina,30,2005-08-30T09:00:00Z,43.7N  77.0W,0,17,2,0,19
Tropical Storm,Katrina,30,2005-08-30T09:00:00Z,EASTPORT ME,0,0,5,3,8
Tropical Storm,Katrina,30,2005-08-30T09:00:00Z,47.5N  71.4W,0,0,11,2,13
Tropical Storm,Katrina,30,2005-08-30T09:00:00Z,ST JOHN NB,0,0,4,4,8
Tropical Storm,Katrina,30,2005-08-30T09:00:00Z,OCEAN CITY MD,0,3,0,0,3
Tropical Storm,Katrina,30,2005-08-30T09:00:00Z,MONCTON NB,0,0,2,6,8
Tropical Storm,Katrina,30,2005-08-30T09:00:00Z,ATLANTIC CITY NJ,0,5,1,0,6
Tropical Storm,Katrina,30,2005-08-30T09:00:00Z,YARMOUTH NS,0,0,3,3,6
Tropical Storm,Katrina,30,2005-08-30T09:00:00Z,NEW YORK CITY NY,0,6,2,1,9
Tropical Storm,Katrina,30,2005-08-30T09:00:00Z,HALIFAX NS,0,0,1,4,5
Tropical Storm,Katrina,30,2005-08-30T09:00:00Z,MONTAUK POINT NY,0,3,4,0,7
Tropical Storm,Katrina,30,2005-08-30T09:00:00Z,SABLE ISLAND NS,0,0,0,2,2
Tropical Storm,Katrina,30,2005-08-30T09:00:00Z,PROVIDENCE RI,0,2,5,1,8
Tropical Storm,Katrina,30,2005-08-30T09:00:00Z,SYDNEY NS,0,0,0,4,4
Tropical Storm,Katrina,30,2005-08-30T09:00:00Z,NANTUCKET MA,0,1,4,1,6
Tropical Storm,Katrina,30,2005-08-30T09:00:00Z,EDDY POINT NS,0,0,0,4,4
Tropical Storm,Katrina,30,2005-08-30T09:00:00Z,HYANNIS MA,0,1,5,1,7
Tropical Storm,Katrina,30,2005-08-30T09:00:00Z,PTX BASQUES NFLD,0,0,0,4,4
Tropical Storm,Katrina,30,2005-08-30T09:00:00Z,BOSTON MA,0,2,6,1,9
Tropical Storm,Katrina,30,2005-08-30T09:00:00Z,BURGEO NFLD,0,0,0,3,3
Tropical Storm,Katrina,30,2005-08-30T09:00:00Z,PORTLAND ME,0,1,8,1,10
Tropical Storm,Katrina,30,2005-08-30T09:00:00Z,ILE ST PIERRE,0,0,0,2,2
Tropical Depression,Katrina,31,2005-08-30T15:00:00Z,42.0N  80.5W,29,3,0,0,32
Tropical Depression,Katrina,31,2005-08-30T15:00:00Z,PORTLAND ME,0,4,6,0,10
Tropical Depression,Katrina,31,2005-08-30T15:00:00Z,45.5N  74.5W,0,16,2,0,18
Tropical Depression,Katrina,31,2005-08-30T15:00:00Z,BAR HARBOR ME,0,1,6,1,8
Tropical Depression,Katrina,31,2005-08-30T15:00:00Z,50.0N  71.0W,0,1,12,1,14
Tropical Depression,Katrina,31,2005-08-30T15:00:00Z,EASTPORT ME,0,0,5,1,6
Tropical Depression,Katrina,31,2005-08-30T15:00:00Z,OCEAN CITY MD,0,2,0,0,2
Tropical Depression,Katrina,31,2005-08-30T15:00:00Z,ST JOHN NB,0,0,3,3,6
Tropical Depression,Katrina,31,2005-08-30T15:00:00Z,ATLANTIC CITY NJ,0,4,0,0,4
Tropical Depression,Katrina,31,2005-08-30T15:00:00Z,MONCTON NB,0,0,2,3,5
Tropical Depression,Katrina,31,2005-08-30T15:00:00Z,NEW YORK CITY NY,0,6,1,0,7
Tropical Depression,Katrina,31,2005-08-30T15:00:00Z,YARMOUTH NS,0,0,2,2,4
Tropical Depression,Katrina,31,2005-08-30T15:00:00Z,MONTAUK POINT NY,0,4,2,0,6
Tropical Depression,Katrina,31,2005-08-30T15:00:00Z,HALIFAX NS,0,0,1,2,3
Tropical Depression,Katrina,31,2005-08-30T15:00:00Z,PROVIDENCE RI,0,4,3,0,7
Tropical Depression,Katrina,31,2005-08-30T15:00:00Z,SYDNEY NS,0,0,0,2,2
Tropical Depression,Katrina,31,2005-08-30T15:00:00Z,NANTUCKET MA,0,2,2,0,4
Tropical Depression,Katrina,31,2005-08-30T15:00:00Z,EDDY POINT NS,0,0,0,2,2
Tropical Depression,Katrina,31,2005-08-30T15:00:00Z,HYANNIS MA,0,2,3,0,5
Tropical Depression,Katrina,31,2005-08-30T15:00:00Z,PTX BASQUES NFLD,0,0,0,3,3
Tropical Depression,Katrina,31,2005-08-30T15:00:00Z,BOSTON MA,0,4,4,0,8
Tropical Depression,Katrina,31,2005-08-30T15:00:00Z,BURGEO NFLD,0,0,0,2,2
Tropical Depression,Thirteen,1,2005-08-28T21:00:00Z,17.0N  50.5W,53,0,0,0,53
Tropical Depression,Thirteen,1,2005-08-28T21:00:00Z,TAPA 171N 618W,0,0,0,3,3
Tropical Depression,Thirteen,1,2005-08-28T21:00:00Z,18.0N  53.0W,1,40,0,0,41
Tropical Depression,Thirteen,1,2005-08-28T21:00:00Z,TKPK 173N 627W,0,0,0,2,2
Tropical Depression,Thirteen,1,2005-08-28T21:00:00Z,19.0N  55.0W,0,10,21,0,31
Tropical Depression,Thirteen,1,2005-08-28T21:00:00Z,TNCM 181N 631W,0,0,0,2,2
Tropical Depression,Thirteen,1,2005-08-28T21:00:00Z,TFFR 163N 615W,0,0,0,3,3
Tropical Depression,Thirteen,2,2005-08-29T03:00:00Z,18.1N  50.7W,50,0,0,0,50
Tropical Depression,Thirteen,2,2005-08-29T03:00:00Z,TAPA 171N 618W,0,0,0,3,3
Tropical Depression,Thirteen,2,2005-08-29T03:00:00Z,19.2N  52.8W,10,23,0,0,33
Tropical Depression,Thirteen,2,2005-08-29T03:00:00Z,TKPK 173N 627W,0,0,0,2,2
Tropical Depression,Thirteen,2,2005-08-29T03:00:00Z,20.4N  54.8W,0,14,11,1,26
Tropical Depression,Thirteen,2,2005-08-29T03:00:00Z,TNCM 181N 631W,0,0,0,3,3
Tropical Depression,Thirteen,2,2005-08-29T03:00:00Z,TFFR 163N 615W,0,0,0,2,2
Tropical Depression,Thirteen,3,2005-08-29T09:00:00Z,19.3N  53.2W,52,0,0,0,52
Tropical Depression,Thirteen,3,2005-08-29T09:00:00Z,22.0N  57.3W,0,13,16,1,30
Tropical Depression,Thirteen,3,2005-08-29T09:00:00Z,20.7N  55.3W,4,33,0,0,37
Tropical Depression,Thirteen,5,2005-08-31T15:00:00Z,32.0N  48.0W,25,1,0,1,27
Tropical Depression,Thirteen,5,2005-08-31T15:00:00Z,36.0N  46.0W,0,8,6,2,16
Tropical Depression,Thirteen,5,2005-08-31T15:00:00Z,34.0N  47.0W,7,10,2,1,20
Tropical Depression,Thirteen,5,2005-08-31T15:00:00Z,HIBERNIA OILFLD,0,0,0,2,2
Tropical Storm,Lee,6,2005-08-31T21:00:00Z,34.0N  49.0W,28,1,0,1,30
Tropical Storm,Lee,6,2005-08-31T21:00:00Z,BURGEO NFLD,0,0,0,2,2
Tropical Storm,Lee,6,2005-08-31T21:00:00Z,35.0N  49.5W,18,3,1,1,23
Tropical Storm,Lee,6,2005-08-31T21:00:00Z,ILE ST PIERRE,0,0,0,2,2
Tropical Storm,Lee,6,2005-08-31T21:00:00Z,36.0N  50.0W,10,6,2,1,19
Tropical Storm,Lee,6,2005-08-31T21:00:00Z,CAPE RACE NFLD,0,0,0,2,2
Tropical Storm,Lee,6,2005-08-31T21:00:00Z,SABLE ISLAND NS,0,0,0,2,2
Tropical Depression,Lee,7,2005-09-01T03:00:00Z,33.0N  48.4W,34,0,0,0,34
Tropical Depression,Lee,7,2005-09-01T03:00:00Z,CAPE RACE NFLD,0,0,0,2,2
Tropical Depression,Lee,7,2005-09-01T03:00:00Z,33.8N  48.4W,22,1,1,0,24
Tropical Depression,Lee,7,2005-09-01T03:00:00Z,HIBERNIA OILFLD,0,0,0,2,2
Tropical Depression,Lee,7,2005-09-01T03:00:00Z,34.5N  48.7W,15,3,1,1,20
Tropical Depression,Lee,8,2005-09-01T09:00:00Z,33.4N  51.6W,59,0,0,0,59
Tropical Depression,Lee,8,2005-09-01T09:00:00Z,BURGEO NFLD,0,0,0,2,2
Tropical Depression,Lee,8,2005-09-01T09:00:00Z,34.6N  51.6W,25,1,1,0,27
Tropical Depression,Lee,8,2005-09-01T09:00:00Z,ILE ST PIERRE,0,0,0,3,3
Tropical Depression,Lee,8,2005-09-01T09:00:00Z,35.8N  51.6W,14,4,2,1,21
Tropical Depression,Lee,8,2005-09-01T09:00:00Z,CAPE RACE NFLD,0,0,0,4,4
Tropical Depression,Lee,8,2005-09-01T09:00:00Z,SABLE ISLAND NS,0,0,0,3,3
Tropical Depression,Lee,8,2005-09-01T09:00:00Z,HIBERNIA OILFLD,0,0,0,2,2
Tropical Depression,Lee,8,2005-09-01T09:00:00Z,SYDNEY NS,0,0,0,2,2
Tropical Depression,Lee,9,2005-09-01T15:00:00Z,33.5N  52.0W,53,0,0,0,53
Tropical Depression,Lee,9,2005-09-01T15:00:00Z,36.1N  52.0W,13,4,2,0,19
Tropical Depression,Lee,9,2005-09-01T15:00:00Z,34.5N  52.0W,26,1,1,0,28
Tropical Depression,Lee,10,2005-09-01T21:00:00Z,34.0N  52.0W,50,0,0,0,50
Tropical Depression,Lee,10,2005-09-01T21:00:00Z,37.5N  52.0W,8,8,3,0,19
Tropical Depression,Lee,10,2005-09-01T21:00:00Z,35.5N  52.0W,22,2,1,0,25
Tropical Depression,Lee,11,2005-09-02T03:00:00Z,34.0N  53.6W,53,0,0,0,53
Tropical Depression,Lee,11,2005-09-02T03:00:00Z,37.0N  53.6W,8,7,3,0,18
Tropical Depression,Lee,11,2005-09-02T03:00:00Z,35.0N  53.7W,28,1,0,0,29
Tropical Depression,Lee,11,2005-09-02T03:00:00Z,SABLE ISLAND NS,0,0,2,0,2
Tropical Depression,Fourteen,1,2005-09-01T15:00:00Z,20.4N  50.4W,54,0,0,0,54
Tropical Depression,Fourteen,1,2005-09-01T15:00:00Z,22.1N  54.0W,0,17,13,1,31
Tropical Depression,Fourteen,1,2005-09-01T15:00:00Z,21.2N  52.3W,6,33,0,0,39
Tropical Depression,Fourteen,2,2005-09-01T21:00:00Z,21.3N  49.7W,45,0,0,0,45
Tropical Depression,Fourteen,2,2005-09-01T21:00:00Z,23.7N  52.9W,1,20,4,1,26
Tropical Depression,Fourteen,2,2005-09-01T21:00:00Z,22.5N  51.4W,19,12,1,0,32
Tropical Depression,Fourteen,3,2005-09-02T03:00:00Z,22.4N  50.2W,41,0,0,0,41
Tropical Depression,Fourteen,3,2005-09-02T03:00:00Z,25.5N  53.0W,1,12,7,2,22
Tropical Depression,Fourteen,3,2005-09-02T03:00:00Z,23.9N  51.5W,17,10,0,1,28
Tropical Depression,Fourteen,4,2005-09-02T09:00:00Z,23.2N  50.9W,39,0,0,0,39
Tropical Depression,Fourteen,4,2005-09-02T09:00:00Z,26.8N  53.7W,0,14,5,2,21
Tropical Depression,Fourteen,4,2005-09-02T09:00:00Z,25.0N  52.5W,9,15,1,1,26
Tropical Storm,Maria,5,2005-09-02T15:00:00Z,24.0N  53.0W,43,0,0,0,43
Tropical Storm,Maria,5,2005-09-02T15:00:00Z,28.0N  55.0W,1,12,9,2,24
Tropical Storm,Maria,5,2005-09-02T15:00:00Z,26.0N  54.0W,16,13,0,1,30
Tropical Storm,Maria,5,2005-09-02T15:00:00Z,BERMUDA,0,0,0,2,2
Tropical Storm,Maria,6,2005-09-02T21:00:00Z,25.5N  53.3W,39,0,0,0,39
Tropical Storm,Maria,6,2005-09-02T21:00:00Z,30.0N  55.4W,0,14,6,2,22
Tropical Storm,Maria,6,2005-09-02T21:00:00Z,28.0N  54.5W,5,22,0,1,28
Tropical Storm,Maria,6,2005-09-02T21:00:00Z,BERMUDA,0,0,0,3,3
Tropical Storm,Maria,7,2005-09-03T03:00:00Z,25.5N  54.1W,38,0,0,0,38
Tropical Storm,Maria,7,2005-09-03T03:00:00Z,29.3N  55.7W,1,13,5,2,21
Tropical Storm,Maria,7,2005-09-03T03:00:00Z,27.5N  55.0W,12,12,1,1,26
Tropical Storm,Maria,7,2005-09-03T03:00:00Z,BERMUDA,0,0,0,4,4
Tropical Storm,Maria,8,2005-09-03T09:00:00Z,26.6N  54.8W,39,0,0,0,39
Tropical Storm,Maria,8,2005-09-03T09:00:00Z,30.2N  56.5W,0,16,4,2,22
Tropical Storm,Maria,8,2005-09-03T09:00:00Z,28.4N  55.7W,12,13,1,1,27
Tropical Storm,Maria,8,2005-09-03T09:00:00Z,BERMUDA,0,0,0,6,6
Tropical Storm,Maria,9,2005-09-03T15:00:00Z,28.5N  56.5W,39,0,0,0,39
Tropical Storm,Maria,9,2005-09-03T15:00:00Z,32.0N  57.5W,1,15,4,2,22
Tropical Storm,Maria,9,2005-09-03T15:00:00Z,30.5N  57.0W,11,14,1,0,26
Tropical Storm,Maria,9,2005-09-03T15:00:00Z,BERMUDA,0,0,2,4,6
Tropical Storm,Maria,10,2005-09-03T21:00:00Z,30.0N  57.0W,32,1,0,0,33
Tropical Storm,Maria,10,2005-09-03T21:00:00Z,34.0N  58.0W,0,10,8,2,20
Tropical Storm,Maria,10,2005-09-03T21:00:00Z,32.0N  57.5W,3,18,2,1,24
Tropical Storm,Maria,10,2005-09-03T21:00:00Z,BERMUDA,0,0,3,3,6
Tropical Storm,Maria,11,2005-09-04T03:00:00Z,30.8N  56.5W,41,0,0,0,41
Tropical Storm,Maria,11,2005-09-04T03:00:00Z,35.2N  56.7W,0,11,8,2,21
Tropical Storm,Maria,11,2005-09-04T03:00:00Z,33.0N  57.0W,5,21,0,1,27
Tropical Storm,Maria,11,2005-09-04T03:00:00Z,SABLE ISLAND NS,0,0,0,3,3
Hurricane,Maria,12,2005-09-04T09:00:00Z,31.6N  56.6W,40,0,0,0,40
Hurricane,Maria,12,2005-09-04T09:00:00Z,35.2N  55.9W,3,16,2,2,23
Hurricane,Maria,12,2005-09-04T09:00:00Z,33.4N  56.7W,21,7,0,1,29
Hurricane,Maria,12,2005-09-04T09:00:00Z,SABLE ISLAND NS,0,0,0,2,2
Hurricane,Maria,13,2005-09-04T15:00:00Z,32.3N  56.4W,38,0,0,0,38
Hurricane,Maria,13,2005-09-04T15:00:00Z,35.9N  54.7W,2,16,3,1,22
Hurricane,Maria,13,2005-09-04T15:00:00Z,34.1N  56.1W,20,7,0,1,28
Hurricane,Maria,13,2005-09-04T15:00:00Z,SABLE ISLAND NS,0,0,0,2,2
Hurricane,Maria,14,2005-09-04T21:00:00Z,33.3N  56.5W,45,0,0,0,45
Hurricane,Maria,14,2005-09-04T21:00:00Z,35.8N  54.9W,11,7,2,1,21
Hurricane,Maria,14,2005-09-04T21:00:00Z,34.7N  55.9W,25,2,0,1,28
Hurricane,Maria,14,2005-09-04T21:00:00Z,SABLE ISLAND NS,0,0,0,3,3
Hurricane,Maria,15,2005-09-05T03:00:00Z,33.9N  56.7W,43,0,0,0,43
Hurricane,Maria,15,2005-09-05T03:00:00Z,36.7N  54.3W,5,12,3,1,21
Hurricane,Maria,15,2005-09-05T03:00:00Z,35.4N  55.8W,24,3,0,1,28
Hurricane,Maria,15,2005-09-05T03:00:00Z,SABLE ISLAND NS,0,0,0,3,3
Hurricane,Maria,16,2005-09-05T09:00:00Z,34.4N  56.2W,32,1,0,0,33
Hurricane,Maria,16,2005-09-05T09:00:00Z,ILE ST PIERRE,0,0,0,2,2
Hurricane,Maria,16,2005-09-05T09:00:00Z,36.0N  54.8W,4,15,1,1,21
Hurricane,Maria,16,2005-09-05T09:00:00Z,CAPE RACE NFLD,0,0,0,3,3
Hurricane,Maria,16,2005-09-05T09:00:00Z,37.3N  52.9W,0,5,9,3,17
Hurricane,Maria,16,2005-09-05T09:00:00Z,HIBERNIA OILFLD,0,0,0,2,2
Hurricane,Maria,16,2005-09-05T09:00:00Z,SABLE ISLAND NS,0,0,0,2,2
Hurricane,Maria,17,2005-09-05T15:00:00Z,34.4N  55.6W,29,0,0,0,29
Hurricane,Maria,17,2005-09-05T15:00:00Z,BURGEO NFLD,0,0,0,2,2
Hurricane,Maria,17,2005-09-05T15:00:00Z,35.8N  54.3W,13,5,2,0,20
Hurricane,Maria,17,2005-09-05T15:00:00Z,ILE ST PIERRE,0,0,1,3,4
Hurricane,Maria,17,2005-09-05T15:00:00Z,37.0N  52.5W,1,11,3,2,17
Hurricane,Maria,17,2005-09-05T15:00:00Z,CAPE RACE NFLD,0,0,2,4,6
Hurricane,Maria,17,2005-09-05T15:00:00Z,SABLE ISLAND NS,0,0,1,1,2
Hurricane,Maria,17,2005-09-05T15:00:00Z,HIBERNIA OILFLD,0,0,1,4,5
Hurricane,Maria,18,2005-09-05T21:00:00Z,34.9N  55.0W,27,0,1,0,28
Hurricane,Maria,18,2005-09-05T21:00:00Z,CAPE RACE NFLD,0,0,1,3,4
Hurricane,Maria,18,2005-09-05T21:00:00Z,36.3N  53.4W,9,9,2,0,20
Hurricane,Maria,18,2005-09-05T21:00:00Z,HIBERNIA OILFLD,0,0,1,5,6
Hurricane,Maria,18,2005-09-05T21:00:00Z,37.4N  51.3W,1,10,4,2,17
Hurricane,Maria,19,2005-09-06T03:00:00Z,35.3N  54.4W,29,0,1,0,30
Hurricane,Maria,19,2005-09-06T03:00:00Z,CAPE RACE NFLD,0,0,0,3,3
Hurricane,Maria,19,2005-09-06T03:00:00Z,36.6N  52.7W,14,6,1,1,22
Hurricane,Maria,19,2005-09-06T03:00:00Z,HIBERNIA OILFLD,0,0,0,5,5
Hurricane,Maria,19,2005-09-06T03:00:00Z,37.8N  50.3W,1,11,4,2,18
Hurricane,Maria,20,2005-09-06T09:00:00Z,35.6N  53.9W,26,1,1,0,28
Hurricane,Maria,20,2005-09-06T09:00:00Z,CAPE RACE NFLD,0,0,0,2,2
Hurricane,Maria,20,2005-09-06T09:00:00Z,36.9N  52.1W,11,8,2,0,21
Hurricane,Maria,20,2005-09-06T09:00:00Z,HIBERNIA OILFLD,0,0,0,5,5
Hurricane,Maria,20,2005-09-06T09:00:00Z,38.2N  49.8W,1,11,5,1,18
Hurricane,Maria,21,2005-09-06T15:00:00Z,35.9N  52.8W,26,1,0,0,27
Hurricane,Maria,21,2005-09-06T15:00:00Z,38.8N  48.5W,1,11,5,2,19
Hurricane,Maria,21,2005-09-06T15:00:00Z,37.4N  50.8W,9,11,1,1,22
Hurricane,Maria,21,2005-09-06T15:00:00Z,HIBERNIA OILFLD,0,0,0,4,4
Hurricane,Maria,22,2005-09-06T21:00:00Z,36.5N  52.0W,28,1,0,0,29
Hurricane,Maria,22,2005-09-06T21:00:00Z,CAPE RACE NFLD,0,0,0,2,2
Hurricane,Maria,22,2005-09-06T21:00:00Z,37.8N  50.1W,13,7,1,1,22
Hurricane,Maria,22,2005-09-06T21:00:00Z,HIBERNIA OILFLD,0,0,1,4,5
Hurricane,Maria,22,2005-09-06T21:00:00Z,39.3N  48.0W,2,12,3,1,18
Tropical Storm,Maria,23,2005-09-07T03:00:00Z,37.1N  51.0W,22,1,0,0,23
Tropical Storm,Maria,23,2005-09-07T03:00:00Z,CAPE RACE NFLD,0,0,1,2,3
Tropical Storm,Maria,23,2005-09-07T03:00:00Z,38.5N  48.9W,9,5,2,1,17
Tropical Storm,Maria,23,2005-09-07T03:00:00Z,HIBERNIA OILFLD,0,0,2,4,6
Tropical Storm,Maria,23,2005-09-07T03:00:00Z,40.1N  46.5W,1,8,3,2,14
Tropical Storm,Maria,24,2005-09-07T09:00:00Z,37.2N  49.7W,25,1,0,0,26
Tropical Storm,Maria,24,2005-09-07T09:00:00Z,40.4N  45.0W,1,9,2,3,15
Tropical Storm,Maria,24,2005-09-07T09:00:00Z,38.6N  47.3W,12,4,1,1,18
Tropical Storm,Maria,24,2005-09-07T09:00:00Z,HIBERNIA OILFLD,0,0,1,3,4
Hurricane,Maria,25,2005-09-07T15:00:00Z,38.2N  47.4W,30,0,0,0,30
Hurricane,Maria,25,2005-09-07T15:00:00Z,CAPE RACE NFLD,0,0,0,2,2
Hurricane,Maria,25,2005-09-07T15:00:00Z,39.8N  45.0W,13,4,1,1,19
Hurricane,Maria,25,2005-09-07T15:00:00Z,HIBERNIA OILFLD,0,1,2,3,6
Hurricane,Maria,25,2005-09-07T15:00:00Z,41.5N  43.0W,2,8,2,2,14
Hurricane,Maria,26,2005-09-07T21:00:00Z,39.4N  46.8W,29,0,0,0,29
Hurricane,Maria,26,2005-09-07T21:00:00Z,CAPE RACE NFLD,0,0,1,1,2
Hurricane,Maria,26,2005-09-07T21:00:00Z,40.8N  44.7W,11,5,2,0,18
Hurricane,Maria,26,2005-09-07T21:00:00Z,HIBERNIA OILFLD,0,1,2,3,6
Hurricane,Maria,26,2005-09-07T21:00:00Z,42.5N  42.5W,1,8,3,3,15
Hurricane,Maria,27,2005-09-08T03:00:00Z,40.2N  45.3W,21,1,0,0,22
Hurricane,Maria,27,2005-09-08T03:00:00Z,CAPE RACE NFLD,0,0,0,2,2
Hurricane,Maria,27,2005-09-08T03:00:00Z,41.7N  43.0W,10,4,2,1,17
Hurricane,Maria,27,2005-09-08T03:00:00Z,HIBERNIA OILFLD,0,1,2,3,6
Hurricane,Maria,27,2005-09-08T03:00:00Z,43.2N  41.0W,2,8,2,3,15
Hurricane,Maria,28,2005-09-08T09:00:00Z,41.0N  44.7W,20,1,0,1,22
Hurricane,Maria,28,2005-09-08T09:00:00Z,44.2N  39.9W,1,7,3,3,14
Hurricane,Maria,28,2005-09-08T09:00:00Z,42.4N  42.2W,9,4,1,2,16
Hurricane,Maria,28,2005-09-08T09:00:00Z,HIBERNIA OILFLD,0,2,1,2,5
Hurricane,Maria,29,2005-09-08T15:00:00Z,41.7N  43.5W,20,1,1,0,22
Hurricane,Maria,29,2005-09-08T15:00:00Z,45.5N  39.0W,1,7,3,3,14
Hurricane,Maria,29,2005-09-08T15:00:00Z,43.3N  41.3W,9,5,1,1,16
Hurricane,Maria,29,2005-09-08T15:00:00Z,HIBERNIA OILFLD,0,2,1,2,5
Hurricane,Maria,30,2005-09-08T21:00:00Z,42.0N  43.0W,20,1,1,0,22
Hurricane,Maria,30,2005-09-08T21:00:00Z,46.0N  38.5W,1,7,3,3,14
Hurricane,Maria,30,2005-09-08T21:00:00Z,44.0N  40.5W,7,6,2,1,16
Hurricane,Maria,30,2005-09-08T21:00:00Z,HIBERNIA OILFLD,0,2,1,2,5
Tropical Storm,Maria,31,2005-09-09T03:00:00Z,42.3N  42.0W,21,1,0,0,22
Tropical Storm,Maria,31,2005-09-09T03:00:00Z,47.6N  37.5W,0,7,4,3,14
Tropical Storm,Maria,31,2005-09-09T03:00:00Z,44.8N  39.5W,5,9,2,0,16
Tropical Storm,Maria,31,2005-09-09T03:00:00Z,HIBERNIA OILFLD,0,1,1,2,4
Tropical Storm,Maria,32,2005-09-09T09:00:00Z,43.6N  39.6W,25,0,0,0,25
Tropical Storm,Maria,32,2005-09-09T09:00:00Z,50.4N  34.2W,0,5,7,2,14
Tropical Storm,Maria,32,2005-09-09T09:00:00Z,46.8N  36.8W,4,12,2,0,18
Tropical Storm,Maria,33,2005-09-09T15:00:00Z,45.1N  38.2W,25,0,0,0,25
Tropical Storm,Maria,33,2005-09-09T15:00:00Z,52.0N  33.0W,0,5,6,3,14
Tropical Storm,Maria,33,2005-09-09T15:00:00Z,48.5N  35.5W,4,12,1,1,18
Tropical Storm,Maria,34,2005-09-09T21:00:00Z,46.7N  37.2W,24,0,1,0,25
Tropical Storm,Maria,34,2005-09-09T21:00:00Z,54.5N  33.0W,0,5,6,2,13
Tropical Storm,Maria,34,2005-09-09T21:00:00Z,50.5N  35.0W,3,12,1,1,17
Tropical Storm,Maria,35,2005-09-10T03:00:00Z,48.2N  35.5W,27,1,0,0,28
Tropical Storm,Maria,35,2005-09-10T03:00:00Z,55.7N  31.5W,0,5,6,2,13
Tropical Storm,Maria,35,2005-09-10T03:00:00Z,52.0N  33.5W,3,12,1,1,17
Tropical Storm,Maria,36,2005-09-10T09:00:00Z,49.7N  34.1W,30,1,0,0,31
Tropical Storm,Maria,36,2005-09-10T09:00:00Z,56.6N  28.8W,0,7,5,2,14
Tropical Storm,Maria,36,2005-09-10T09:00:00Z,54.1N  31.5W,1,15,2,0,18
Tropical Depression,Fifteen,1,2005-09-05T21:00:00Z,27.9N  68.2W,99,0,0,0,99
Tropical Depression,Fifteen,1,2005-09-05T21:00:00Z,MYRTLE BEACH SC,0,0,0,3,3
Tropical Depression,Fifteen,1,2005-09-05T21:00:00Z,28.0N  69.0W,60,0,0,0,60
Tropical Depression,Fifteen,1,2005-09-05T21:00:00Z,WILMINGTON NC,0,0,0,4,4
Tropical Depression,Fifteen,1,2005-09-05T21:00:00Z,28.3N  70.0W,33,1,0,0,34
Tropical Depression,Fifteen,1,2005-09-05T21:00:00Z,MOREHEAD CITY NC,0,0,0,5,5
Tropical Depression,Fifteen,1,2005-09-05T21:00:00Z,MBJT 215N 712W,0,0,0,2,2
Tropical Depression,Fifteen,1,2005-09-05T21:00:00Z,CAPE HATTERAS NC,0,0,0,5,5
Tropical Depression,Fifteen,1,2005-09-05T21:00:00Z,MYMM 224N 730W,0,0,0,2,2
Tropical Depression,Fifteen,1,2005-09-05T21:00:00Z,NORFOLK VA,0,0,0,3,3
Tropical Depression,Fifteen,1,2005-09-05T21:00:00Z,MYSM 241N 745W,0,0,0,3,3
Tropical Depression,Fifteen,1,2005-09-05T21:00:00Z,OCEAN CITY MD,0,0,0,2,2
Tropical Depression,Fifteen,1,2005-09-05T21:00:00Z,CHARLESTON SC,0,0,0,2,2
Tropical Storm,Nate,2,2005-09-06T03:00:00Z,28.3N  67.8W,99,0,0,0,99
Tropical Storm,Nate,2,2005-09-06T03:00:00Z,FT PIERCE FL,0,0,0,2,2
Tropical Storm,Nate,2,2005-09-06T03:00:00Z,28.6N  68.6W,46,0,0,0,46
Tropical Storm,Nate,2,2005-09-06T03:00:00Z,COCOA BEACH FL,0,0,0,2,2
Tropical Storm,Nate,2,2005-09-06T03:00:00Z,29.1N  69.7W,21,6,0,1,28
Tropical Storm,Nate,2,2005-09-06T03:00:00Z,DAYTONA BEACH FL,0,0,0,2,2
Tropical Storm,Nate,2,2005-09-06T03:00:00Z,MYSM 241N 745W,0,0,0,3,3
Tropical Storm,Nate,2,2005-09-06T03:00:00Z,CHARLESTON SC,0,0,0,2,2
Tropical Storm,Nate,2,2005-09-06T03:00:00Z,MYNN 251N 775W,0,0,0,3,3
Tropical Storm,Nate,2,2005-09-06T03:00:00Z,MYRTLE BEACH SC,0,0,0,2,2
Tropical Storm,Nate,2,2005-09-06T03:00:00Z,MYGF 266N 787W,0,0,0,3,3
Tropical Storm,Nate,2,2005-09-06T03:00:00Z,WILMINGTON NC,0,0,0,2,2
Tropical Storm,Nate,2,2005-09-06T03:00:00Z,BERMUDA,0,0,1,6,7
Tropical Storm,Nate,2,2005-09-06T03:00:00Z,MOREHEAD CITY NC,0,0,0,2,2
Tropical Storm,Nate,2,2005-09-06T03:00:00Z,W PALM BEACH FL,0,0,0,2,2
Tropical Storm,Nate,2,2005-09-06T03:00:00Z,CAPE HATTERAS NC,0,0,0,2,2
Tropical Storm,Nate,3,2005-09-06T09:00:00Z,29.0N  67.4W,99,0,0,0,99
Tropical Storm,Nate,3,2005-09-06T09:00:00Z,WILMINGTON NC,0,0,0,2,2
Tropical Storm,Nate,3,2005-09-06T09:00:00Z,29.4N  68.0W,47,0,0,0,47
Tropical Storm,Nate,3,2005-09-06T09:00:00Z,MOREHEAD CITY NC,0,0,0,2,2
Tropical Storm,Nate,3,2005-09-06T09:00:00Z,30.3N  68.3W,24,4,1,0,29
Tropical Storm,Nate,3,2005-09-06T09:00:00Z,CAPE HATTERAS NC,0,0,0,2,2
Tropical Storm,Nate,3,2005-09-06T09:00:00Z,BERMUDA,0,1,5,6,12
Tropical Storm,Nate,4,2005-09-06T15:00:00Z,29.0N  67.2W,99,0,0,0,99
Tropical Storm,Nate,4,2005-09-06T15:00:00Z,BERMUDA,0,2,5,6,13
Tropical Storm,Nate,4,2005-09-06T15:00:00Z,29.5N  67.5W,53,0,0,0,53
Tropical Storm,Nate,4,2005-09-06T15:00:00Z,MOREHEAD CITY NC,0,0,0,2,2
Tropical Storm,Nate,4,2005-09-06T15:00:00Z,30.5N  67.5W,25,1,1,0,27
Tropical Storm,Nate,4,2005-09-06T15:00:00Z,CAPE HATTERAS NC,0,0,0,2,2
Tropical Storm,Nate,5,2005-09-06T21:00:00Z,29.2N  67.4W,99,0,0,0,99
Tropical Storm,Nate,5,2005-09-06T21:00:00Z,31.0N  66.5W,16,3,2,1,22
Tropical Storm,Nate,5,2005-09-06T21:00:00Z,29.7N  67.5W,54,0,0,0,54
Tropical Storm,Nate,5,2005-09-06T21:00:00Z,BERMUDA,0,2,8,5,15
Tropical Storm,Nate,6,2005-09-07T03:00:00Z,29.6N  66.7W,99,0,0,0,99
Tropical Storm,Nate,6,2005-09-07T03:00:00Z,31.8N  64.0W,1,8,8,2,19
Tropical Storm,Nate,6,2005-09-07T03:00:00Z,30.5N  66.0W,41,0,0,0,41
Tropical Storm,Nate,6,2005-09-07T03:00:00Z,BERMUDA,1,8,7,2,18
Tropical Storm,Nate,7,2005-09-07T09:00:00Z,30.1N  66.2W,61,0,0,0,61
Tropical Storm,Nate,7,2005-09-07T09:00:00Z,33.0N  61.5W,0,2,14,2,18
Tropical Storm,Nate,7,2005-09-07T09:00:00Z,31.6N  64.7W,9,18,1,0,28
Tropical Storm,Nate,7,2005-09-07T09:00:00Z,BERMUDA,2,19,3,1,25
Hurricane,Nate,8,2005-09-07T15:00:00Z,30.4N  65.2W,42,0,0,0,42
Hurricane,Nate,8,2005-09-07T15:00:00Z,33.1N  59.5W,0,1,13,3,17
Hurricane,Nate,8,2005-09-07T15:00:00Z,31.6N  63.0W,4,18,2,0,24
Hurricane,Nate,8,2005-09-07T15:00:00Z,BERMUDA,4,17,1,0,22
Hurricane,Nate,10,2005-09-08T03:00:00Z,31.9N  62.2W,30,5,0,0,35
Hurricane,Nate,10,2005-09-08T03:00:00Z,35.1N  54.0W,0,0,13,4,17
Hurricane,Nate,10,2005-09-08T03:00:00Z,33.4N  58.8W,0,17,7,0,24
Hurricane,Nate,10,2005-09-08T03:00:00Z,BERMUDA,32,0,0,0,32
Hurricane,Nate,11,2005-09-08T09:00:00Z,32.9N  60.1W,25,3,0,0,28
Hurricane,Nate,11,2005-09-08T09:00:00Z,36.0N  50.6W,0,1,12,3,16
Hurricane,Nate,11,2005-09-08T09:00:00Z,34.5N  55.9W,1,15,5,0,21
Hurricane,Nate,11,2005-09-08T09:00:00Z,BERMUDA,24,0,0,0,24
Hurricane,Nate,12,2005-09-08T15:00:00Z,33.5N  57.0W,27,2,0,0,29
Hurricane,Nate,12,2005-09-08T15:00:00Z,36.5N  47.0W,0,2,8,3,13
Hurricane,Nate,12,2005-09-08T15:00:00Z,35.0N  52.0W,0,14,2,0,16
Hurricane,Nate,13,2005-09-08T21:00:00Z,35.0N  55.5W,26,1,0,1,28
Hurricane,Nate,13,2005-09-08T21:00:00Z,37.0N  46.0W,0,2,7,2,11
Hurricane,Nate,13,2005-09-08T21:00:00Z,36.0N  51.0W,1,12,1,1,15
Hurricane,Nate,14,2005-09-09T03:00:00Z,35.3N  52.6W,23,4,0,0,27
Hurricane,Nate,14,2005-09-09T03:00:00Z,37.3N  43.5W,0,3,8,2,13
Hurricane,Nate,14,2005-09-09T03:00:00Z,36.2N  47.7W,0,16,2,0,18
Hurricane,Nate,15,2005-09-09T09:00:00Z,35.1N  50.2W,20,5,0,0,25
Hurricane,Nate,15,2005-09-09T09:00:00Z,37.3N  40.5W,0,4,10,2,16
Hurricane,Nate,15,2005-09-09T09:00:00Z,36.1N  44.8W,0,17,2,1,20
Tropical Storm,Nate,16,2005-09-09T15:00:00Z,35.8N  46.2W,19,1,0,1,21
Tropical Storm,Nate,16,2005-09-09T15:00:00Z,39.1N  37.1W,0,7,5,2,14
Tropical Storm,Nate,16,2005-09-09T15:00:00Z,36.8N  41.5W,3,11,1,1,16
Tropical Storm,Nate,17,2005-09-09T21:00:00Z,36.0N  44.0W,20,1,0,0,21
Tropical Storm,Nate,17,2005-09-09T21:00:00Z,40.5N  35.5W,0,6,6,2,14
Tropical Storm,Nate,17,2005-09-09T21:00:00Z,37.5N  39.5W,3,12,1,1,17
Tropical Storm,Nate,18,2005-09-10T03:00:00Z,36.1N  41.7W,26,1,0,0,27
Tropical Storm,Nate,18,2005-09-10T03:00:00Z,42.2N  33.0W,0,4,8,0,12
Tropical Storm,Nate,18,2005-09-10T03:00:00Z,38.3N  37.1W,2,14,2,0,18
Tropical Storm,Nate,19,2005-09-10T09:00:00Z,35.5N  41.0W,19,1,0,0,20
Tropical Storm,Nate,19,2005-09-10T09:00:00Z,41.5N  31.8W,0,3,7,0,10
Tropical Storm,Nate,19,2005-09-10T09:00:00Z,37.2N  36.5W,3,9,1,0,13
Tropical Storm,Nate,20,2005-09-10T15:00:00Z,36.5N  37.5W,26,1,0,0,27
Tropical Storm,Nate,20,2005-09-10T15:00:00Z,44.0N  28.0W,0,2,10,0,12
Tropical Storm,Nate,20,2005-09-10T15:00:00Z,39.5N  32.5W,2,15,1,0,18
Tropical Depression,Sixteen,1,2005-09-06T15:00:00Z,27.6N  79.3W,71,0,0,0,71
Tropical Depression,Sixteen,1,2005-09-06T15:00:00Z,MOREHEAD CITY NC,0,0,0,3,3
Tropical Depression,Sixteen,1,2005-09-06T15:00:00Z,28.0N  79.7W,47,0,0,0,47
Tropical Depression,Sixteen,1,2005-09-06T15:00:00Z,CAPE HATTERAS NC,0,0,0,2,2
Tropical Depression,Sixteen,1,2005-09-06T15:00:00Z,28.5N  80.0W,32,1,0,0,33
Tropical Depression,Sixteen,1,2005-09-06T15:00:00Z,KEY WEST FL,0,0,1,3,4
Tropical Depression,Sixteen,1,2005-09-06T15:00:00Z,MYSM 241N 745W,0,0,0,2,2
Tropical Depression,Sixteen,1,2005-09-06T15:00:00Z,MARCO ISLAND FL,5,2,2,3,12
Tropical Depression,Sixteen,1,2005-09-06T15:00:00Z,MYEG 235N 758W,0,0,0,2,2
Tropical Depression,Sixteen,1,2005-09-06T15:00:00Z,FT MYERS FL,7,3,2,2,14
Tropical Depression,Sixteen,1,2005-09-06T15:00:00Z,MYAK 241N 776W,0,0,1,3,4
Tropical Depression,Sixteen,1,2005-09-06T15:00:00Z,VENICE FL,4,5,2,3,14
Tropical Depression,Sixteen,1,2005-09-06T15:00:00Z,MYNN 251N 775W,2,1,1,3,7
Tropical Depression,Sixteen,1,2005-09-06T15:00:00Z,TAMPA FL,6,6,2,3,17
Tropical Depression,Sixteen,1,2005-09-06T15:00:00Z,MYGF 266N 787W,99,0,0,0,99
Tropical Depression,Sixteen,1,2005-09-06T15:00:00Z,CEDAR KEY FL,2,8,4,3,17
Tropical Depression,Sixteen,1,2005-09-06T15:00:00Z,MARATHON FL,1,0,1,4,6
Tropical Depression,Sixteen,1,2005-09-06T15:00:00Z,ST MARKS FL,0,3,5,6,14
Tropical Depression,Sixteen,1,2005-09-06T15:00:00Z,MIAMI FL,20,0,1,0,21
Tropical Depression,Sixteen,1,2005-09-06T15:00:00Z,APALACHICOLA FL,0,2,4,6,12
Tropical Depression,Sixteen,1,2005-09-06T15:00:00Z,W PALM BEACH FL,48,0,0,0,48
Tropical Depression,Sixteen,1,2005-09-06T15:00:00Z,PANAMA CITY FL,0,1,3,6,10
Tropical Depression,Sixteen,1,2005-09-06T15:00:00Z,FT PIERCE FL,39,0,0,0,39
Tropical Depression,Sixteen,1,2005-09-06T15:00:00Z,PENSACOLA FL,0,0,1,6,7
Tropical Depression,Sixteen,1,2005-09-06T15:00:00Z,COCOA BEACH FL,28,1,0,1,30
Tropical Depression,Sixteen,1,2005-09-06T15:00:00Z,MOBILE AL,0,0,0,5,5
Tropical Depression,Sixteen,1,2005-09-06T15:00:00Z,DAYTONA BEACH FL,15,5,2,1,23
Tropical Depression,Sixteen,1,2005-09-06T15:00:00Z,GULFPORT MS,0,0,0,3,3
Tropical Depression,Sixteen,1,2005-09-06T15:00:00Z,JACKSONVILLE FL,2,9,4,4,19
Tropical Depression,Sixteen,1,2005-09-06T15:00:00Z,BURAS LA,0,0,0,2,2
Tropical Depression,Sixteen,1,2005-09-06T15:00:00Z,SAVANNAH GA,0,3,6,5,14
Tropical Depression,Sixteen,1,2005-09-06T15:00:00Z,NEW ORLEANS LA,0,0,0,2,2
Tropical Depression,Sixteen,1,2005-09-06T15:00:00Z,CHARLESTON SC,0,1,4,6,11
Tropical Depression,Sixteen,1,2005-09-06T15:00:00Z,GULF 29N 85W,0,2,3,6,11
Tropical Depression,Sixteen,1,2005-09-06T15:00:00Z,MYRTLE BEACH SC,0,0,2,6,8
Tropical Depression,Sixteen,1,2005-09-06T15:00:00Z,GULF 29N 87W,0,0,1,5,6
Tropical Depression,Sixteen,1,2005-09-06T15:00:00Z,WILMINGTON NC,0,0,1,4,5
Tropical Depression,Sixteen,1,2005-09-06T15:00:00Z,GULF 28N 89W,0,0,0,2,2
Tropical Depression,Sixteen,2,2005-09-06T21:00:00Z,27.7N  79.2W,99,0,0,0,99
Tropical Depression,Sixteen,2,2005-09-06T21:00:00Z,MOREHEAD CITY NC,0,0,0,2,2
Tropical Depression,Sixteen,2,2005-09-06T21:00:00Z,28.1N  79.6W,49,0,0,0,49
Tropical Depression,Sixteen,2,2005-09-06T21:00:00Z,KEY WEST FL,0,0,0,4,4
Tropical Depression,Sixteen,2,2005-09-06T21:00:00Z,28.7N  80.2W,31,0,1,0,32
Tropical Depression,Sixteen,2,2005-09-06T21:00:00Z,MARCO ISLAND FL,1,2,2,4,9
Tropical Depression,Sixteen,2,2005-09-06T21:00:00Z,MYSM 241N 745W,0,0,0,2,2
Tropical Depression,Sixteen,2,2005-09-06T21:00:00Z,FT MYERS FL,2,3,3,3,11
Tropical Depression,Sixteen,2,2005-09-06T21:00:00Z,MYEG 235N 758W,0,0,0,2,2
Tropical Depression,Sixteen,2,2005-09-06T21:00:00Z,VENICE FL,1,4,3,4,12
Tropical Depression,Sixteen,2,2005-09-06T21:00:00Z,MYAK 241N 776W,0,1,0,3,4
Tropical Depression,Sixteen,2,2005-09-06T21:00:00Z,TAMPA FL,3,6,3,3,15
Tropical Depression,Sixteen,2,2005-09-06T21:00:00Z,MYNN 251N 775W,3,2,1,3,9
Tropical Depression,Sixteen,2,2005-09-06T21:00:00Z,CEDAR KEY FL,2,7,4,3,16
Tropical Depression,Sixteen,2,2005-09-06T21:00:00Z,MYGF 266N 787W,99,0,0,0,99
Tropical Depression,Sixteen,2,2005-09-06T21:00:00Z,ST MARKS FL,0,4,5,5,14
Tropical Depression,Sixteen,2,2005-09-06T21:00:00Z,MARATHON FL,0,0,1,4,5
Tropical Depression,Sixteen,2,2005-09-06T21:00:00Z,APALACHICOLA FL,0,1,5,6,12
Tropical Depression,Sixteen,2,2005-09-06T21:00:00Z,MIAMI FL,8,2,1,2,13
Tropical Depression,Sixteen,2,2005-09-06T21:00:00Z,PANAMA CITY FL,0,1,3,7,11
Tropical Depression,Sixteen,2,2005-09-06T21:00:00Z,W PALM BEACH FL,28,1,0,0,29
Tropical Depression,Sixteen,2,2005-09-06T21:00:00Z,PENSACOLA FL,0,0,1,6,7
Tropical Depression,Sixteen,2,2005-09-06T21:00:00Z,FT PIERCE FL,32,1,0,0,33
Tropical Depression,Sixteen,2,2005-09-06T21:00:00Z,MOBILE AL,0,0,1,4,5
Tropical Depression,Sixteen,2,2005-09-06T21:00:00Z,COCOA BEACH FL,28,1,0,0,29
Tropical Depression,Sixteen,2,2005-09-06T21:00:00Z,GULFPORT MS,0,0,0,4,4
Tropical Depression,Sixteen,2,2005-09-06T21:00:00Z,DAYTONA BEACH FL,17,4,1,1,23
Tropical Depression,Sixteen,2,2005-09-06T21:00:00Z,BURAS LA,0,0,0,3,3
Tropical Depression,Sixteen,2,2005-09-06T21:00:00Z,JACKSONVILLE FL,4,9,4,2,19
Tropical Depression,Sixteen,2,2005-09-06T21:00:00Z,NEW ORLEANS LA,0,0,0,2,2
Tropical Depression,Sixteen,2,2005-09-06T21:00:00Z,SAVANNAH GA,0,4,6,4,14
Tropical Depression,Sixteen,2,2005-09-06T21:00:00Z,GULF 29N 85W,0,1,4,6,11
Tropical Depression,Sixteen,2,2005-09-06T21:00:00Z,CHARLESTON SC,0,1,4,5,10
Tropical Depression,Sixteen,2,2005-09-06T21:00:00Z,GULF 29N 87W,0,0,1,5,6
Tropical Depression,Sixteen,2,2005-09-06T21:00:00Z,MYRTLE BEACH SC,0,0,1,5,6
Tropical Depression,Sixteen,2,2005-09-06T21:00:00Z,GULF 28N 89W,0,0,0,2,2
Tropical Depression,Sixteen,2,2005-09-06T21:00:00Z,WILMINGTON NC,0,0,0,4,4
Tropical Depression,Sixteen,3,2005-09-07T03:00:00Z,28.1N  79.3W,76,0,0,0,76
Tropical Depression,Sixteen,3,2005-09-07T03:00:00Z,MOREHEAD CITY NC,0,0,0,3,3
Tropical Depression,Sixteen,3,2005-09-07T03:00:00Z,28.5N  79.7W,52,0,0,0,52
Tropical Depression,Sixteen,3,2005-09-07T03:00:00Z,KEY WEST FL,0,0,0,3,3
Tropical Depression,Sixteen,3,2005-09-07T03:00:00Z,28.8N  80.0W,41,0,0,0,41
Tropical Depression,Sixteen,3,2005-09-07T03:00:00Z,MARCO ISLAND FL,1,1,2,4,8
Tropical Depression,Sixteen,3,2005-09-07T03:00:00Z,MYSM 241N 745W,0,0,0,2,2
Tropical Depression,Sixteen,3,2005-09-07T03:00:00Z,FT MYERS FL,1,3,3,4,11
Tropical Depression,Sixteen,3,2005-09-07T03:00:00Z,MYEG 235N 758W,0,0,0,2,2
Tropical Depression,Sixteen,3,2005-09-07T03:00:00Z,VENICE FL,1,4,2,4,11
Tropical Depression,Sixteen,3,2005-09-07T03:00:00Z,MYAK 241N 776W,0,0,0,3,3
Tropical Depression,Sixteen,3,2005-09-07T03:00:00Z,TAMPA FL,3,6,3,3,15
Tropical Depression,Sixteen,3,2005-09-07T03:00:00Z,MYNN 251N 775W,1,1,0,4,6
Tropical Depression,Sixteen,3,2005-09-07T03:00:00Z,CEDAR KEY FL,2,8,4,3,17
Tropical Depression,Sixteen,3,2005-09-07T03:00:00Z,MYGF 266N 787W,99,0,0,0,99
Tropical Depression,Sixteen,3,2005-09-07T03:00:00Z,ST MARKS FL,0,4,6,4,14
Tropical Depression,Sixteen,3,2005-09-07T03:00:00Z,MARATHON FL,0,0,1,3,4
Tropical Depression,Sixteen,3,2005-09-07T03:00:00Z,APALACHICOLA FL,0,2,4,6,12
Tropical Depression,Sixteen,3,2005-09-07T03:00:00Z,MIAMI FL,3,2,1,4,10
Tropical Depression,Sixteen,3,2005-09-07T03:00:00Z,PANAMA CITY FL,0,1,4,6,11
Tropical Depression,Sixteen,3,2005-09-07T03:00:00Z,W PALM BEACH FL,19,1,0,1,21
Tropical Depression,Sixteen,3,2005-09-07T03:00:00Z,PENSACOLA FL,0,0,2,5,7
Tropical Depression,Sixteen,3,2005-09-07T03:00:00Z,FT PIERCE FL,29,0,1,0,30
Tropical Depression,Sixteen,3,2005-09-07T03:00:00Z,MOBILE AL,0,0,1,4,5
Tropical Depression,Sixteen,3,2005-09-07T03:00:00Z,COCOA BEACH FL,30,0,1,0,31
Tropical Depression,Sixteen,3,2005-09-07T03:00:00Z,GULFPORT MS,0,0,0,3,3
Tropical Depression,Sixteen,3,2005-09-07T03:00:00Z,DAYTONA BEACH FL,21,2,1,1,25
Tropical Depression,Sixteen,3,2005-09-07T03:00:00Z,BURAS LA,0,0,0,2,2
Tropical Depression,Sixteen,3,2005-09-07T03:00:00Z,JACKSONVILLE FL,6,8,3,3,20
Tropical Depression,Sixteen,3,2005-09-07T03:00:00Z,NEW ORLEANS LA,0,0,0,2,2
Tropical Depression,Sixteen,3,2005-09-07T03:00:00Z,SAVANNAH GA,0,5,5,5,15
Tropical Depression,Sixteen,3,2005-09-07T03:00:00Z,GULF 29N 85W,0,2,3,6,11
Tropical Depression,Sixteen,3,2005-09-07T03:00:00Z,CHARLESTON SC,0,1,4,6,11
Tropical Depression,Sixteen,3,2005-09-07T03:00:00Z,GULF 29N 87W,0,0,1,5,6
Tropical Depression,Sixteen,3,2005-09-07T03:00:00Z,MYRTLE BEACH SC,0,0,2,5,7
Tropical Depression,Sixteen,3,2005-09-07T03:00:00Z,GULF 28N 89W,0,0,0,2,2
Tropical Depression,Sixteen,3,2005-09-07T03:00:00Z,WILMINGTON NC,0,0,0,5,5
Tropical Storm,Ophelia,4,2005-09-07T09:00:00Z,28.8N  79.8W,99,0,0,0,99
Tropical Storm,Ophelia,4,2005-09-07T09:00:00Z,CAPE HATTERAS NC,0,0,0,2,2
Tropical Storm,Ophelia,4,2005-09-07T09:00:00Z,29.0N  80.1W,65,0,0,0,65
Tropical Storm,Ophelia,4,2005-09-07T09:00:00Z,KEY WEST FL,0,0,0,2,2
Tropical Storm,Ophelia,4,2005-09-07T09:00:00Z,29.4N  80.3W,48,0,1,0,49
Tropical Storm,Ophelia,4,2005-09-07T09:00:00Z,MARCO ISLAND FL,0,1,1,4,6
Tropical Storm,Ophelia,4,2005-09-07T09:00:00Z,MYAK 241N 776W,0,0,0,2,2
Tropical Storm,Ophelia,4,2005-09-07T09:00:00Z,FT MYERS FL,1,2,2,4,9
Tropical Storm,Ophelia,4,2005-09-07T09:00:00Z,MYNN 251N 775W,0,0,1,3,4
Tropical Storm,Ophelia,4,2005-09-07T09:00:00Z,VENICE FL,1,3,2,4,10
Tropical Storm,Ophelia,4,2005-09-07T09:00:00Z,MYGF 266N 787W,9,1,1,2,13
Tropical Storm,Ophelia,4,2005-09-07T09:00:00Z,TAMPA FL,5,5,2,3,15
Tropical Storm,Ophelia,4,2005-09-07T09:00:00Z,MARATHON FL,0,0,0,3,3
Tropical Storm,Ophelia,4,2005-09-07T09:00:00Z,CEDAR KEY FL,6,6,3,2,17
Tropical Storm,Ophelia,4,2005-09-07T09:00:00Z,MIAMI FL,1,0,1,5,7
Tropical Storm,Ophelia,4,2005-09-07T09:00:00Z,ST MARKS FL,1,6,4,4,15
Tropical Storm,Ophelia,4,2005-09-07T09:00:00Z,W PALM BEACH FL,11,1,1,2,15
Tropical Storm,Ophelia,4,2005-09-07T09:00:00Z,APALACHICOLA FL,0,4,4,4,12
Tropical Storm,Ophelia,4,2005-09-07T09:00:00Z,FT PIERCE FL,34,0,0,0,34
Tropical Storm,Ophelia,4,2005-09-07T09:00:00Z,PANAMA CITY FL,0,2,4,5,11
Tropical Storm,Ophelia,4,2005-09-07T09:00:00Z,COCOA BEACH FL,41,0,0,0,41
Tropical Storm,Ophelia,4,2005-09-07T09:00:00Z,PENSACOLA FL,0,0,2,6,8
Tropical Storm,Ophelia,4,2005-09-07T09:00:00Z,DAYTONA BEACH FL,29,1,0,1,31
Tropical Storm,Ophelia,4,2005-09-07T09:00:00Z,MOBILE AL,0,0,1,4,5
Tropical Storm,Ophelia,4,2005-09-07T09:00:00Z,JACKSONVILLE FL,15,4,2,2,23
Tropical Storm,Ophelia,4,2005-09-07T09:00:00Z,GULFPORT MS,0,0,0,4,4
Tropical Storm,Ophelia,4,2005-09-07T09:00:00Z,SAVANNAH GA,2,7,4,4,17
Tropical Storm,Ophelia,4,2005-09-07T09:00:00Z,BURAS LA,0,0,0,2,2
Tropical Storm,Ophelia,4,2005-09-07T09:00:00Z,CHARLESTON SC,0,3,5,5,13
Tropical Storm,Ophelia,4,2005-09-07T09:00:00Z,NEW ORLEANS LA,0,0,0,2,2
Tropical Storm,Ophelia,4,2005-09-07T09:00:00Z,MYRTLE BEACH SC,0,0,3,6,9
Tropical Storm,Ophelia,4,2005-09-07T09:00:00Z,GULF 29N 85W,0,3,3,5,11
Tropical Storm,Ophelia,4,2005-09-07T09:00:00Z,WILMINGTON NC,0,0,1,5,6
Tropical Storm,Ophelia,4,2005-09-07T09:00:00Z,GULF 29N 87W,0,0,1,5,6
Tropical Storm,Ophelia,4,2005-09-07T09:00:00Z,MOREHEAD CITY NC,0,0,0,4,4
Tropical Storm,Ophelia,4,2005-09-07T09:00:00Z,GULF 28N 89W,0,0,0,2,2
Tropical Storm,Ophelia,5,2005-09-07T15:00:00Z,29.5N  80.0W,99,0,0,0,99
Tropical Storm,Ophelia,5,2005-09-07T15:00:00Z,NORFOLK VA,0,0,0,2,2
Tropical Storm,Ophelia,5,2005-09-07T15:00:00Z,29.8N  80.2W,70,0,0,0,70
Tropical Storm,Ophelia,5,2005-09-07T15:00:00Z,KEY WEST FL,0,0,0,2,2
Tropical Storm,Ophelia,5,2005-09-07T15:00:00Z,30.0N  80.3W,58,0,0,0,58
Tropical Storm,Ophelia,5,2005-09-07T15:00:00Z,MARCO ISLAND FL,0,0,1,4,5
Tropical Storm,Ophelia,5,2005-09-07T15:00:00Z,MYNN 251N 775W,0,0,0,3,3
Tropical Storm,Ophelia,5,2005-09-07T15:00:00Z,FT MYERS FL,0,1,1,5,7
Tropical Storm,Ophelia,5,2005-09-07T15:00:00Z,MYGF 266N 787W,1,0,2,4,7
Tropical Storm,Ophelia,5,2005-09-07T15:00:00Z,VENICE FL,1,1,1,5,8
Tropical Storm,Ophelia,5,2005-09-07T15:00:00Z,MARATHON FL,0,0,0,2,2
Tropical Storm,Ophelia,5,2005-09-07T15:00:00Z,TAMPA FL,5,2,2,4,13
Tropical Storm,Ophelia,5,2005-09-07T15:00:00Z,MIAMI FL,0,0,1,4,5
Tropical Storm,Ophelia,5,2005-09-07T15:00:00Z,CEDAR KEY FL,7,4,2,3,16
Tropical Storm,Ophelia,5,2005-09-07T15:00:00Z,W PALM BEACH FL,2,1,1,4,8
Tropical Storm,Ophelia,5,2005-09-07T15:00:00Z,ST MARKS FL,1,5,4,4,14
Tropical Storm,Ophelia,5,2005-09-07T15:00:00Z,FT PIERCE FL,17,0,1,1,19
Tropical Storm,Ophelia,5,2005-09-07T15:00:00Z,APALACHICOLA FL,0,3,3,5,11
Tropical Storm,Ophelia,5,2005-09-07T15:00:00Z,COCOA BEACH FL,45,0,0,0,45
Tropical Storm,Ophelia,5,2005-09-07T15:00:00Z,PANAMA CITY FL,0,1,3,6,10
Tropical Storm,Ophelia,5,2005-09-07T15:00:00Z,DAYTONA BEACH FL,40,0,0,0,40
Tropical Storm,Ophelia,5,2005-09-07T15:00:00Z,PENSACOLA FL,0,0,1,6,7
Tropical Storm,Ophelia,5,2005-09-07T15:00:00Z,JACKSONVILLE FL,19,3,1,1,24
Tropical Storm,Ophelia,5,2005-09-07T15:00:00Z,MOBILE AL,0,0,1,4,5
Tropical Storm,Ophelia,5,2005-09-07T15:00:00Z,SAVANNAH GA,7,8,3,2,20
Tropical Storm,Ophelia,5,2005-09-07T15:00:00Z,GULFPORT MS,0,0,0,3,3
Tropical Storm,Ophelia,5,2005-09-07T15:00:00Z,CHARLESTON SC,1,8,5,3,17
Tropical Storm,Ophelia,5,2005-09-07T15:00:00Z,BURAS LA,0,0,0,2,2
Tropical Storm,Ophelia,5,2005-09-07T15:00:00Z,MYRTLE BEACH SC,0,3,5,5,13
Tropical Storm,Ophelia,5,2005-09-07T15:00:00Z,NEW ORLEANS LA,0,0,0,2,2
Tropical Storm,Ophelia,5,2005-09-07T15:00:00Z,WILMINGTON NC,0,1,3,6,10
Tropical Storm,Ophelia,5,2005-09-07T15:00:00Z,GULF 29N 85W,0,2,2,5,9
Tropical Storm,Ophelia,5,2005-09-07T15:00:00Z,MOREHEAD CITY NC,0,0,2,5,7
Tropical Storm,Ophelia,5,2005-09-07T15:00:00Z,GULF 29N 87W,0,0,1,4,5
Tropical Storm,Ophelia,5,2005-09-07T15:00:00Z,CAPE HATTERAS NC,0,0,0,4,4
Tropical Storm,Ophelia,6,2005-09-07T21:00:00Z,29.5N  80.0W,99,0,0,0,99
Tropical Storm,Ophelia,6,2005-09-07T21:00:00Z,MOREHEAD CITY NC,0,0,1,5,6
Tropical Storm,Ophelia,6,2005-09-07T21:00:00Z,30.0N  80.2W,58,0,0,0,58
Tropical Storm,Ophelia,6,2005-09-07T21:00:00Z,CAPE HATTERAS NC,0,0,0,3,3
Tropical Storm,Ophelia,6,2005-09-07T21:00:00Z,30.3N  80.0W,49,0,0,0,49
Tropical Storm,Ophelia,6,2005-09-07T21:00:00Z,KEY WEST FL,0,0,0,2,2
Tropical Storm,Ophelia,6,2005-09-07T21:00:00Z,MYAK 241N 776W,0,0,0,2,2
Tropical Storm,Ophelia,6,2005-09-07T21:00:00Z,MARCO ISLAND FL,0,0,0,4,4
Tropical Storm,Ophelia,6,2005-09-07T21:00:00Z,MYNN 251N 775W,0,0,0,3,3
Tropical Storm,Ophelia,6,2005-09-07T21:00:00Z,FT MYERS FL,0,1,0,5,6
Tropical Storm,Ophelia,6,2005-09-07T21:00:00Z,MYGF 266N 787W,2,0,1,5,8
Tropical Storm,Ophelia,6,2005-09-07T21:00:00Z,VENICE FL,0,1,1,5,7
Tropical Storm,Ophelia,6,2005-09-07T21:00:00Z,MARATHON FL,0,0,0,2,2
Tropical Storm,Ophelia,6,2005-09-07T21:00:00Z,TAMPA FL,3,2,2,4,11
Tropical Storm,Ophelia,6,2005-09-07T21:00:00Z,MIAMI FL,0,0,0,4,4
Tropical Storm,Ophelia,6,2005-09-07T21:00:00Z,CEDAR KEY FL,5,4,3,3,15
Tropical Storm,Ophelia,6,2005-09-07T21:00:00Z,W PALM BEACH FL,2,1,1,4,8
Tropical Storm,Ophelia,6,2005-09-07T21:00:00Z,ST MARKS FL,1,6,3,4,14
Tropical Storm,Ophelia,6,2005-09-07T21:00:00Z,FT PIERCE FL,15,0,1,1,17
Tropical Storm,Ophelia,6,2005-09-07T21:00:00Z,APALACHICOLA FL,0,2,4,5,11
Tropical Storm,Ophelia,6,2005-09-07T21:00:00Z,COCOA BEACH FL,31,0,0,1,32
Tropical Storm,Ophelia,6,2005-09-07T21:00:00Z,PANAMA CITY FL,0,2,3,5,10
Tropical Storm,Ophelia,6,2005-09-07T21:00:00Z,DAYTONA BEACH FL,33,0,0,0,33
Tropical Storm,Ophelia,6,2005-09-07T21:00:00Z,PENSACOLA FL,0,0,2,5,7
Tropical Storm,Ophelia,6,2005-09-07T21:00:00Z,JACKSONVILLE FL,23,1,1,1,26
Tropical Storm,Ophelia,6,2005-09-07T21:00:00Z,MOBILE AL,0,0,1,4,5
Tropical Storm,Ophelia,6,2005-09-07T21:00:00Z,SAVANNAH GA,8,7,3,2,20
Tropical Storm,Ophelia,6,2005-09-07T21:00:00Z,GULFPORT MS,0,0,0,3,3
Tropical Storm,Ophelia,6,2005-09-07T21:00:00Z,CHARLESTON SC,1,8,4,3,16
Tropical Storm,Ophelia,6,2005-09-07T21:00:00Z,BURAS LA,0,0,0,2,2
Tropical Storm,Ophelia,6,2005-09-07T21:00:00Z,MYRTLE BEACH SC,0,2,4,6,12
Tropical Storm,Ophelia,6,2005-09-07T21:00:00Z,GULF 29N 85W,0,1,3,5,9
Tropical Storm,Ophelia,6,2005-09-07T21:00:00Z,WILMINGTON NC,0,0,3,5,8
Tropical Storm,Ophelia,6,2005-09-07T21:00:00Z,GULF 29N 87W,0,0,1,4,5
Tropical Storm,Ophelia,7,2005-09-08T03:00:00Z,29.4N  79.7W,99,0,0,0,99
Tropical Storm,Ophelia,7,2005-09-08T03:00:00Z,WILMINGTON NC,0,0,2,6,8
Tropical Storm,Ophelia,7,2005-09-08T03:00:00Z,29.8N  79.8W,99,0,0,0,99
Tropical Storm,Ophelia,7,2005-09-08T03:00:00Z,MOREHEAD CITY NC,0,0,1,4,5
Tropical Storm,Ophelia,7,2005-09-08T03:00:00Z,30.3N  79.6W,46,0,0,0,46
Tropical Storm,Ophelia,7,2005-09-08T03:00:00Z,CAPE HATTERAS NC,0,0,0,3,3
Tropical Storm,Ophelia,7,2005-09-08T03:00:00Z,MYAK 241N 776W,0,0,0,2,2
Tropical Storm,Ophelia,7,2005-09-08T03:00:00Z,MARCO ISLAND FL,0,0,0,4,4
Tropical Storm,Ophelia,7,2005-09-08T03:00:00Z,MYNN 251N 775W,0,0,0,4,4
Tropical Storm,Ophelia,7,2005-09-08T03:00:00Z,FT MYERS FL,0,0,1,4,5
Tropical Storm,Ophelia,7,2005-09-08T03:00:00Z,MYGF 266N 787W,2,2,1,4,9
Tropical Storm,Ophelia,7,2005-09-08T03:00:00Z,VENICE FL,0,1,1,4,6
Tropical Storm,Ophelia,7,2005-09-08T03:00:00Z,MARATHON FL,0,0,0,2,2
Tropical Storm,Ophelia,7,2005-09-08T03:00:00Z,TAMPA FL,1,2,2,4,9
Tropical Storm,Ophelia,7,2005-09-08T03:00:00Z,MIAMI FL,0,0,1,4,5
Tropical Storm,Ophelia,7,2005-09-08T03:00:00Z,CEDAR KEY FL,2,4,3,4,13
Tropical Storm,Ophelia,7,2005-09-08T03:00:00Z,W PALM BEACH FL,2,1,1,4,8
Tropical Storm,Ophelia,7,2005-09-08T03:00:00Z,ST MARKS FL,0,4,3,5,12
Tropical Storm,Ophelia,7,2005-09-08T03:00:00Z,FT PIERCE FL,23,0,0,0,23
Tropical Storm,Ophelia,7,2005-09-08T03:00:00Z,APALACHICOLA FL,0,1,2,5,8
Tropical Storm,Ophelia,7,2005-09-08T03:00:00Z,COCOA BEACH FL,60,0,0,0,60
Tropical Storm,Ophelia,7,2005-09-08T03:00:00Z,PANAMA CITY FL,0,1,1,5,7
Tropical Storm,Ophelia,7,2005-09-08T03:00:00Z,DAYTONA BEACH FL,25,1,0,1,27
Tropical Storm,Ophelia,7,2005-09-08T03:00:00Z,PENSACOLA FL,0,0,1,4,5
Tropical Storm,Ophelia,7,2005-09-08T03:00:00Z,JACKSONVILLE FL,18,3,1,1,23
Tropical Storm,Ophelia,7,2005-09-08T03:00:00Z,MOBILE AL,0,0,0,3,3
Tropical Storm,Ophelia,7,2005-09-08T03:00:00Z,SAVANNAH GA,8,7,2,3,20
Tropical Storm,Ophelia,7,2005-09-08T03:00:00Z,GULFPORT MS,0,0,0,2,2
Tropical Storm,Ophelia,7,2005-09-08T03:00:00Z,CHARLESTON SC,2,6,4,4,16
Tropical Storm,Ophelia,7,2005-09-08T03:00:00Z,GULF 29N 85W,0,0,2,5,7
Tropical Storm,Ophelia,7,2005-09-08T03:00:00Z,MYRTLE BEACH SC,0,2,4,6,12
Tropical Storm,Ophelia,7,2005-09-08T03:00:00Z,GULF 29N 87W,0,0,0,3,3
Tropical Storm,Ophelia,8,2005-09-08T09:00:00Z,29.4N  79.6W,99,0,0,0,99
Tropical Storm,Ophelia,8,2005-09-08T09:00:00Z,WILMINGTON NC,0,0,2,6,8
Tropical Storm,Ophelia,8,2005-09-08T09:00:00Z,29.9N  79.4W,67,0,0,0,67
Tropical Storm,Ophelia,8,2005-09-08T09:00:00Z,MOREHEAD CITY NC,0,0,1,4,5
Tropical Storm,Ophelia,8,2005-09-08T09:00:00Z,30.0N  79.1W,56,0,0,0,56
Tropical Storm,Ophelia,8,2005-09-08T09:00:00Z,CAPE HATTERAS NC,0,0,0,3,3
Tropical Storm,Ophelia,8,2005-09-08T09:00:00Z,MYSM 241N 745W,0,0,0,2,2
Tropical Storm,Ophelia,8,2005-09-08T09:00:00Z,KEY WEST FL,0,0,0,2,2
Tropical Storm,Ophelia,8,2005-09-08T09:00:00Z,MYAK 241N 776W,0,0,0,2,2
Tropical Storm,Ophelia,8,2005-09-08T09:00:00Z,MARCO ISLAND FL,0,0,0,5,5
Tropical Storm,Ophelia,8,2005-09-08T09:00:00Z,MYNN 251N 775W,0,0,0,4,4
Tropical Storm,Ophelia,8,2005-09-08T09:00:00Z,FT MYERS FL,0,1,0,5,6
Tropical Storm,Ophelia,8,2005-09-08T09:00:00Z,MYGF 266N 787W,3,2,1,4,10
Tropical Storm,Ophelia,8,2005-09-08T09:00:00Z,VENICE FL,0,1,1,5,7
Tropical Storm,Ophelia,8,2005-09-08T09:00:00Z,MARATHON FL,0,0,0,2,2
Tropical Storm,Ophelia,8,2005-09-08T09:00:00Z,TAMPA FL,2,2,2,4,10
Tropical Storm,Ophelia,8,2005-09-08T09:00:00Z,MIAMI FL,0,0,1,4,5
Tropical Storm,Ophelia,8,2005-09-08T09:00:00Z,CEDAR KEY FL,3,3,3,3,12
Tropical Storm,Ophelia,8,2005-09-08T09:00:00Z,W PALM BEACH FL,4,1,1,4,10
Tropical Storm,Ophelia,8,2005-09-08T09:00:00Z,ST MARKS FL,0,3,4,4,11
Tropical Storm,Ophelia,8,2005-09-08T09:00:00Z,FT PIERCE FL,19,1,0,1,21
Tropical Storm,Ophelia,8,2005-09-08T09:00:00Z,APALACHICOLA FL,0,1,2,5,8
Tropical Storm,Ophelia,8,2005-09-08T09:00:00Z,COCOA BEACH FL,45,0,0,0,45
Tropical Storm,Ophelia,8,2005-09-08T09:00:00Z,PANAMA CITY FL,0,0,2,5,7
Tropical Storm,Ophelia,8,2005-09-08T09:00:00Z,DAYTONA BEACH FL,29,1,0,0,30
Tropical Storm,Ophelia,8,2005-09-08T09:00:00Z,PENSACOLA FL,0,0,1,3,4
Tropical Storm,Ophelia,8,2005-09-08T09:00:00Z,JACKSONVILLE FL,16,3,2,1,22
Tropical Storm,Ophelia,8,2005-09-08T09:00:00Z,MOBILE AL,0,0,0,3,3
Tropical Storm,Ophelia,8,2005-09-08T09:00:00Z,SAVANNAH GA,5,8,3,3,19
Tropical Storm,Ophelia,8,2005-09-08T09:00:00Z,GULFPORT MS,0,0,0,2,2
Tropical Storm,Ophelia,8,2005-09-08T09:00:00Z,CHARLESTON SC,1,7,4,4,16
Tropical Storm,Ophelia,8,2005-09-08T09:00:00Z,GULF 29N 85W,0,0,2,5,7
Tropical Storm,Ophelia,8,2005-09-08T09:00:00Z,MYRTLE BEACH SC,0,2,4,5,11
Tropical Storm,Ophelia,8,2005-09-08T09:00:00Z,GULF 29N 87W,0,0,0,3,3
Tropical Storm,Ophelia,9,2005-09-08T15:00:00Z,29.0N  79.3W,99,0,0,0,99
Tropical Storm,Ophelia,9,2005-09-08T15:00:00Z,CHARLESTON SC,1,7,5,3,16
Tropical Storm,Ophelia,9,2005-09-08T15:00:00Z,29.5N  78.7W,70,0,0,0,70
Tropical Storm,Ophelia,9,2005-09-08T15:00:00Z,MYRTLE BEACH SC,0,3,6,5,14
Tropical Storm,Ophelia,9,2005-09-08T15:00:00Z,30.0N  78.0W,17,4,1,2,24
Tropical Storm,Ophelia,9,2005-09-08T15:00:00Z,WILMINGTON NC,0,1,4,7,12
Tropical Storm,Ophelia,9,2005-09-08T15:00:00Z,MYSM 241N 745W,0,0,0,3,3
Tropical Storm,Ophelia,9,2005-09-08T15:00:00Z,MOREHEAD CITY NC,0,0,2,8,10
Tropical Storm,Ophelia,9,2005-09-08T15:00:00Z,MYEG 235N 758W,0,0,0,2,2
Tropical Storm,Ophelia,9,2005-09-08T15:00:00Z,CAPE HATTERAS NC,0,0,1,6,7
Tropical Storm,Ophelia,9,2005-09-08T15:00:00Z,MYAK 241N 776W,0,0,0,3,3
Tropical Storm,Ophelia,9,2005-09-08T15:00:00Z,NORFOLK VA,0,0,0,4,4
Tropical Storm,Ophelia,9,2005-09-08T15:00:00Z,MYNN 251N 775W,0,1,1,4,6
Tropical Storm,Ophelia,9,2005-09-08T15:00:00Z,OCEAN CITY MD,0,0,0,2,2
Tropical Storm,Ophelia,9,2005-09-08T15:00:00Z,MYGF 266N 787W,8,3,1,1,13
Tropical Storm,Ophelia,9,2005-09-08T15:00:00Z,MARCO ISLAND FL,0,1,0,2,3
Tropical Storm,Ophelia,9,2005-09-08T15:00:00Z,MIAMI FL,1,1,1,2,5
Tropical Storm,Ophelia,9,2005-09-08T15:00:00Z,FT MYERS FL,1,1,0,2,4
Tropical Storm,Ophelia,9,2005-09-08T15:00:00Z,W PALM BEACH FL,9,2,0,2,13
Tropical Storm,Ophelia,9,2005-09-08T15:00:00Z,VENICE FL,1,0,1,2,4
Tropical Storm,Ophelia,9,2005-09-08T15:00:00Z,FT PIERCE FL,25,0,0,1,26
Tropical Storm,Ophelia,9,2005-09-08T15:00:00Z,TAMPA FL,4,1,0,2,7
Tropical Storm,Ophelia,9,2005-09-08T15:00:00Z,COCOA BEACH FL,99,0,0,0,99
Tropical Storm,Ophelia,9,2005-09-08T15:00:00Z,CEDAR KEY FL,2,2,1,2,7
Tropical Storm,Ophelia,9,2005-09-08T15:00:00Z,DAYTONA BEACH FL,36,0,0,1,37
Tropical Storm,Ophelia,9,2005-09-08T15:00:00Z,ST MARKS FL,0,1,1,2,4
Tropical Storm,Ophelia,9,2005-09-08T15:00:00Z,JACKSONVILLE FL,10,4,2,1,17
Tropical Storm,Ophelia,9,2005-09-08T15:00:00Z,APALACHICOLA FL,0,0,0,2,2
Tropical Storm,Ophelia,9,2005-09-08T15:00:00Z,SAVANNAH GA,2,8,4,2,16
Tropical Storm,Ophelia,9,2005-09-08T15:00:00Z,GULF 29N 85W,0,0,0,2,2
Hurricane,Ophelia,10,2005-09-08T21:00:00Z,29.5N  78.7W,99,0,0,0,99
Hurricane,Ophelia,10,2005-09-08T21:00:00Z,CHARLESTON SC,1,7,4,3,15
Hurricane,Ophelia,10,2005-09-08T21:00:00Z,30.0N  78.0W,36,0,0,0,36
Hurricane,Ophelia,10,2005-09-08T21:00:00Z,MYRTLE BEACH SC,0,7,5,3,15
Hurricane,Ophelia,10,2005-09-08T21:00:00Z,30.7N  77.2W,16,3,2,2,23
Hurricane,Ophelia,10,2005-09-08T21:00:00Z,WILMINGTON NC,0,4,6,4,14
Hurricane,Ophelia,10,2005-09-08T21:00:00Z,MYSM 241N 745W,0,0,0,3,3
Hurricane,Ophelia,10,2005-09-08T21:00:00Z,MOREHEAD CITY NC,0,2,5,6,13
Hurricane,Ophelia,10,2005-09-08T21:00:00Z,MYEG 235N 758W,0,0,0,3,3
Hurricane,Ophelia,10,2005-09-08T21:00:00Z,CAPE HATTERAS NC,0,0,4,6,10
Hurricane,Ophelia,10,2005-09-08T21:00:00Z,MYAK 241N 776W,0,0,1,4,5
Hurricane,Ophelia,10,2005-09-08T21:00:00Z,NORFOLK VA,0,0,2,5,7
Hurricane,Ophelia,10,2005-09-08T21:00:00Z,MYNN 251N 775W,0,1,2,4,7
Hurricane,Ophelia,10,2005-09-08T21:00:00Z,OCEAN CITY MD,0,0,0,4,4
Hurricane,Ophelia,10,2005-09-08T21:00:00Z,MYGF 266N 787W,6,4,1,3,14
Hurricane,Ophelia,10,2005-09-08T21:00:00Z,ATLANTIC CITY NJ,0,0,0,2,2
Hurricane,Ophelia,10,2005-09-08T21:00:00Z,MARATHON FL,0,0,1,2,3
Hurricane,Ophelia,10,2005-09-08T21:00:00Z,KEY WEST FL,0,0,0,2,2
Hurricane,Ophelia,10,2005-09-08T21:00:00Z,MIAMI FL,1,1,2,3,7
Hurricane,Ophelia,10,2005-09-08T21:00:00Z,MARCO ISLAND FL,0,1,0,4,5
Hurricane,Ophelia,10,2005-09-08T21:00:00Z,W PALM BEACH FL,7,2,1,2,12
Hurricane,Ophelia,10,2005-09-08T21:00:00Z,FT MYERS FL,0,1,1,3,5
Hurricane,Ophelia,10,2005-09-08T21:00:00Z,FT PIERCE FL,21,0,1,0,22
Hurricane,Ophelia,10,2005-09-08T21:00:00Z,VENICE FL,0,0,1,3,4
Hurricane,Ophelia,10,2005-09-08T21:00:00Z,COCOA BEACH FL,33,0,0,0,33
Hurricane,Ophelia,10,2005-09-08T21:00:00Z,TAMPA FL,0,1,1,3,5
Hurricane,Ophelia,10,2005-09-08T21:00:00Z,DAYTONA BEACH FL,31,1,0,0,32
Hurricane,Ophelia,10,2005-09-08T21:00:00Z,CEDAR KEY FL,0,1,0,4,5
Hurricane,Ophelia,10,2005-09-08T21:00:00Z,JACKSONVILLE FL,2,4,2,3,11
Hurricane,Ophelia,10,2005-09-08T21:00:00Z,ST MARKS FL,0,0,0,3,3
Hurricane,Ophelia,10,2005-09-08T21:00:00Z,SAVANNAH GA,1,4,3,4,12
Hurricane,Ophelia,10,2005-09-08T21:00:00Z,APALACHICOLA FL,0,0,0,2,2
Hurricane,Ophelia,11,2005-09-09T03:00:00Z,29.6N  78.5W,60,0,0,0,60
Hurricane,Ophelia,11,2005-09-09T03:00:00Z,CHARLESTON SC,1,7,4,3,15
Hurricane,Ophelia,11,2005-09-09T03:00:00Z,30.2N  77.8W,34,0,1,0,35
Hurricane,Ophelia,11,2005-09-09T03:00:00Z,MYRTLE BEACH SC,0,7,5,3,15
Hurricane,Ophelia,11,2005-09-09T03:00:00Z,30.6N  77.0W,17,3,2,1,23
Hurricane,Ophelia,11,2005-09-09T03:00:00Z,WILMINGTON NC,0,5,5,4,14
Hurricane,Ophelia,11,2005-09-09T03:00:00Z,MYSM 241N 745W,0,0,0,3,3
Hurricane,Ophelia,11,2005-09-09T03:00:00Z,MOREHEAD CITY NC,0,2,5,6,13
Hurricane,Ophelia,11,2005-09-09T03:00:00Z,MYEG 235N 758W,0,0,0,3,3
Hurricane,Ophelia,11,2005-09-09T03:00:00Z,CAPE HATTERAS NC,0,0,4,6,10
Hurricane,Ophelia,11,2005-09-09T03:00:00Z,MYAK 241N 776W,0,0,1,4,5
Hurricane,Ophelia,11,2005-09-09T03:00:00Z,NORFOLK VA,0,0,2,5,7
Hurricane,Ophelia,11,2005-09-09T03:00:00Z,MYNN 251N 775W,0,1,2,5,8
Hurricane,Ophelia,11,2005-09-09T03:00:00Z,OCEAN CITY MD,0,0,0,4,4
Hurricane,Ophelia,11,2005-09-09T03:00:00Z,MYGF 266N 787W,6,3,2,3,14
Hurricane,Ophelia,11,2005-09-09T03:00:00Z,ATLANTIC CITY NJ,0,0,0,2,2
Hurricane,Ophelia,11,2005-09-09T03:00:00Z,MARATHON FL,0,0,0,3,3
Hurricane,Ophelia,11,2005-09-09T03:00:00Z,KEY WEST FL,0,0,0,2,2
Hurricane,Ophelia,11,2005-09-09T03:00:00Z,MIAMI FL,0,2,1,4,7
Hurricane,Ophelia,11,2005-09-09T03:00:00Z,MARCO ISLAND FL,0,0,1,3,4
Hurricane,Ophelia,11,2005-09-09T03:00:00Z,W PALM BEACH FL,6,2,1,3,12
Hurricane,Ophelia,11,2005-09-09T03:00:00Z,FT MYERS FL,0,0,1,4,5
Hurricane,Ophelia,11,2005-09-09T03:00:00Z,FT PIERCE FL,19,1,0,1,21
Hurricane,Ophelia,11,2005-09-09T03:00:00Z,VENICE FL,0,0,1,3,4
Hurricane,Ophelia,11,2005-09-09T03:00:00Z,COCOA BEACH FL,28,0,0,1,29
Hurricane,Ophelia,11,2005-09-09T03:00:00Z,TAMPA FL,0,1,0,4,5
Hurricane,Ophelia,11,2005-09-09T03:00:00Z,DAYTONA BEACH FL,19,1,0,1,21
Hurricane,Ophelia,11,2005-09-09T03:00:00Z,CEDAR KEY FL,0,0,1,3,4
Hurricane,Ophelia,11,2005-09-09T03:00:00Z,JACKSONVILLE FL,2,3,2,3,10
Hurricane,Ophelia,11,2005-09-09T03:00:00Z,ST MARKS FL,0,0,0,2,2
Hurricane,Ophelia,11,2005-09-09T03:00:00Z,SAVANNAH GA,1,4,3,3,11
Tropical Storm,Ophelia,12,2005-09-09T09:00:00Z,30.5N  77.9W,33,1,0,1,35
Tropical Storm,Ophelia,12,2005-09-09T09:00:00Z,SAVANNAH GA,2,2,2,5,11
Tropical Storm,Ophelia,12,2005-09-09T09:00:00Z,31.0N  77.3W,18,4,2,1,25
Tropical Storm,Ophelia,12,2005-09-09T09:00:00Z,CHARLESTON SC,5,4,3,3,15
Tropical Storm,Ophelia,12,2005-09-09T09:00:00Z,31.0N  76.8W,10,7,3,2,22
Tropical Storm,Ophelia,12,2005-09-09T09:00:00Z,MYRTLE BEACH SC,2,7,4,3,16
Tropical Storm,Ophelia,12,2005-09-09T09:00:00Z,MUCM 214N 779W,0,0,0,2,2
Tropical Storm,Ophelia,12,2005-09-09T09:00:00Z,WILMINGTON NC,0,8,4,4,16
Tropical Storm,Ophelia,12,2005-09-09T09:00:00Z,MUCF 221N 805W,0,0,0,3,3
Tropical Storm,Ophelia,12,2005-09-09T09:00:00Z,MOREHEAD CITY NC,0,5,5,4,14
Tropical Storm,Ophelia,12,2005-09-09T09:00:00Z,MUHA 230N 824W,0,0,0,2,2
Tropical Storm,Ophelia,12,2005-09-09T09:00:00Z,CAPE HATTERAS NC,0,1,5,5,11
Tropical Storm,Ophelia,12,2005-09-09T09:00:00Z,MYSM 241N 745W,0,0,0,2,2
Tropical Storm,Ophelia,12,2005-09-09T09:00:00Z,NORFOLK VA,0,0,3,5,8
Tropical Storm,Ophelia,12,2005-09-09T09:00:00Z,MYEG 235N 758W,0,0,0,3,3
Tropical Storm,Ophelia,12,2005-09-09T09:00:00Z,OCEAN CITY MD,0,0,1,3,4
Tropical Storm,Ophelia,12,2005-09-09T09:00:00Z,MYAK 241N 776W,0,0,2,5,7
Tropical Storm,Ophelia,12,2005-09-09T09:00:00Z,ATLANTIC CITY NJ,0,0,0,2,2
Tropical Storm,Ophelia,12,2005-09-09T09:00:00Z,MYNN 251N 775W,0,1,3,6,10
Tropical Storm,Ophelia,12,2005-09-09T09:00:00Z,KEY WEST FL,0,0,1,4,5
Tropical Storm,Ophelia,12,2005-09-09T09:00:00Z,MYGF 266N 787W,1,6,5,4,16
Tropical Storm,Ophelia,12,2005-09-09T09:00:00Z,MARCO ISLAND FL,0,0,2,5,7
Tropical Storm,Ophelia,12,2005-09-09T09:00:00Z,MARATHON FL,0,0,2,5,7
Tropical Storm,Ophelia,12,2005-09-09T09:00:00Z,FT MYERS FL,0,0,2,5,7
Tropical Storm,Ophelia,12,2005-09-09T09:00:00Z,MIAMI FL,0,2,4,5,11
Tropical Storm,Ophelia,12,2005-09-09T09:00:00Z,VENICE FL,0,0,1,5,6
Tropical Storm,Ophelia,12,2005-09-09T09:00:00Z,W PALM BEACH FL,0,4,5,5,14
Tropical Storm,Ophelia,12,2005-09-09T09:00:00Z,TAMPA FL,0,0,1,5,6
Tropical Storm,Ophelia,12,2005-09-09T09:00:00Z,FT PIERCE FL,0,6,5,4,15
Tropical Storm,Ophelia,12,2005-09-09T09:00:00Z,CEDAR KEY FL,0,0,0,5,5
Tropical Storm,Ophelia,12,2005-09-09T09:00:00Z,COCOA BEACH FL,1,5,5,4,15
Tropical Storm,Ophelia,12,2005-09-09T09:00:00Z,ST MARKS FL,0,0,0,3,3
Tropical Storm,Ophelia,12,2005-09-09T09:00:00Z,DAYTONA BEACH FL,1,4,3,5,13
Tropical Storm,Ophelia,12,2005-09-09T09:00:00Z,APALACHICOLA FL,0,0,0,2,2
Tropical Storm,Ophelia,12,2005-09-09T09:00:00Z,JACKSONVILLE FL,1,1,2,6,10
Tropical Storm,Ophelia,12,2005-09-09T09:00:00Z,GULF 29N 85W,0,0,0,2,2
Tropical Storm,Ophelia,13,2005-09-09T15:00:00Z,30.6N  78.0W,33,0,1,0,34
Tropical Storm,Ophelia,13,2005-09-09T15:00:00Z,CHARLESTON SC,5,4,3,4,16
Tropical Storm,Ophelia,13,2005-09-09T15:00:00Z,31.0N  77.4W,18,3,1,2,24
Tropical Storm,Ophelia,13,2005-09-09T15:00:00Z,MYRTLE BEACH SC,4,6,3,3,16
Tropical Storm,Ophelia,13,2005-09-09T15:00:00Z,30.5N  77.5W,22,2,1,1,26
Tropical Storm,Ophelia,13,2005-09-09T15:00:00Z,WILMINGTON NC,1,7,3,4,15
Tropical Storm,Ophelia,13,2005-09-09T15:00:00Z,MUCM 214N 779W,0,0,0,2,2
Tropical Storm,Ophelia,13,2005-09-09T15:00:00Z,MOREHEAD CITY NC,0,4,4,4,12
Tropical Storm,Ophelia,13,2005-09-09T15:00:00Z,MUCF 221N 805W,0,0,0,3,3
Tropical Storm,Ophelia,13,2005-09-09T15:00:00Z,CAPE HATTERAS NC,0,1,3,5,9
Tropical Storm,Ophelia,13,2005-09-09T15:00:00Z,MUSN 216N 826W,0,0,0,2,2
Tropical Storm,Ophelia,13,2005-09-09T15:00:00Z,NORFOLK VA,0,0,2,4,6
Tropical Storm,Ophelia,13,2005-09-09T15:00:00Z,MUHA 230N 824W,0,0,0,4,4
Tropical Storm,Ophelia,13,2005-09-09T15:00:00Z,OCEAN CITY MD,0,0,0,3,3
Tropical Storm,Ophelia,13,2005-09-09T15:00:00Z,MYSM 241N 745W,0,0,0,2,2
Tropical Storm,Ophelia,13,2005-09-09T15:00:00Z,ATLANTIC CITY NJ,0,0,0,2,2
Tropical Storm,Ophelia,13,2005-09-09T15:00:00Z,MYEG 235N 758W,0,0,0,2,2
Tropical Storm,Ophelia,13,2005-09-09T15:00:00Z,KEY WEST FL,0,0,2,5,7
Tropical Storm,Ophelia,13,2005-09-09T15:00:00Z,MYAK 241N 776W,0,0,2,4,6
Tropical Storm,Ophelia,13,2005-09-09T15:00:00Z,MARCO ISLAND FL,0,1,3,6,10
Tropical Storm,Ophelia,13,2005-09-09T15:00:00Z,MYNN 251N 775W,0,1,3,4,8
Tropical Storm,Ophelia,13,2005-09-09T15:00:00Z,FT MYERS FL,0,1,3,6,10
Tropical Storm,Ophelia,13,2005-09-09T15:00:00Z,MYGF 266N 787W,3,5,3,4,15
Tropical Storm,Ophelia,13,2005-09-09T15:00:00Z,VENICE FL,0,0,3,6,9
Tropical Storm,Ophelia,13,2005-09-09T15:00:00Z,MARATHON FL,0,0,3,5,8
Tropical Storm,Ophelia,13,2005-09-09T15:00:00Z,TAMPA FL,0,0,4,6,10
Tropical Storm,Ophelia,13,2005-09-09T15:00:00Z,MIAMI FL,0,2,5,5,12
Tropical Storm,Ophelia,13,2005-09-09T15:00:00Z,CEDAR KEY FL,0,0,2,7,9
Tropical Storm,Ophelia,13,2005-09-09T15:00:00Z,W PALM BEACH FL,1,4,5,4,14
Tropical Storm,Ophelia,13,2005-09-09T15:00:00Z,ST MARKS FL,0,0,0,6,6
Tropical Storm,Ophelia,13,2005-09-09T15:00:00Z,FT PIERCE FL,2,5,5,4,16
Tropical Storm,Ophelia,13,2005-09-09T15:00:00Z,APALACHICOLA FL,0,0,0,5,5
Tropical Storm,Ophelia,13,2005-09-09T15:00:00Z,COCOA BEACH FL,2,6,4,4,16
Tropical Storm,Ophelia,13,2005-09-09T15:00:00Z,PANAMA CITY FL,0,0,0,4,4
Tropical Storm,Ophelia,13,2005-09-09T15:00:00Z,DAYTONA BEACH FL,5,3,4,4,16
Tropical Storm,Ophelia,13,2005-09-09T15:00:00Z,PENSACOLA FL,0,0,0,2,2
Tropical Storm,Ophelia,13,2005-09-09T15:00:00Z,JACKSONVILLE FL,1,2,5,5,13
Tropical Storm,Ophelia,13,2005-09-09T15:00:00Z,GULF 29N 85W,0,0,0,5,5
Tropical Storm,Ophelia,13,2005-09-09T15:00:00Z,SAVANNAH GA,1,3,4,5,13
Tropical Storm,Ophelia,13,2005-09-09T15:00:00Z,GULF 29N 87W,0,0,0,2,2
Hurricane,Ophelia,14,2005-09-09T21:00:00Z,31.3N  77.5W,38,0,0,0,38
Hurricane,Ophelia,14,2005-09-09T21:00:00Z,MOREHEAD CITY NC,1,6,4,3,14
Hurricane,Ophelia,14,2005-09-09T21:00:00Z,31.5N  77.7W,38,0,0,0,38
Hurricane,Ophelia,14,2005-09-09T21:00:00Z,CAPE HATTERAS NC,0,2,3,4,9
Hurricane,Ophelia,14,2005-09-09T21:00:00Z,31.6N  78.0W,40,0,0,0,40
Hurricane,Ophelia,14,2005-09-09T21:00:00Z,NORFOLK VA,0,1,2,4,7
Hurricane,Ophelia,14,2005-09-09T21:00:00Z,MUHA 230N 824W,0,0,0,2,2
Hurricane,Ophelia,14,2005-09-09T21:00:00Z,OCEAN CITY MD,0,0,1,2,3
Hurricane,Ophelia,14,2005-09-09T21:00:00Z,MYAK 241N 776W,0,0,1,2,3
Hurricane,Ophelia,14,2005-09-09T21:00:00Z,ATLANTIC CITY NJ,0,0,0,2,2
Hurricane,Ophelia,14,2005-09-09T21:00:00Z,MYNN 251N 775W,0,0,1,3,4
Hurricane,Ophelia,14,2005-09-09T21:00:00Z,KEY WEST FL,0,0,0,4,4
Hurricane,Ophelia,14,2005-09-09T21:00:00Z,MYGF 266N 787W,0,3,3,4,10
Hurricane,Ophelia,14,2005-09-09T21:00:00Z,MARCO ISLAND FL,0,0,2,5,7
Hurricane,Ophelia,14,2005-09-09T21:00:00Z,MARATHON FL,0,0,1,4,5
Hurricane,Ophelia,14,2005-09-09T21:00:00Z,FT MYERS FL,0,0,2,6,8
Hurricane,Ophelia,14,2005-09-09T21:00:00Z,MIAMI FL,0,0,3,5,8
Hurricane,Ophelia,14,2005-09-09T21:00:00Z,VENICE FL,0,0,2,6,8
Hurricane,Ophelia,14,2005-09-09T21:00:00Z,W PALM BEACH FL,0,1,4,5,10
Hurricane,Ophelia,14,2005-09-09T21:00:00Z,TAMPA FL,0,0,2,7,9
Hurricane,Ophelia,14,2005-09-09T21:00:00Z,FT PIERCE FL,0,2,5,5,12
Hurricane,Ophelia,14,2005-09-09T21:00:00Z,CEDAR KEY FL,0,0,2,7,9
Hurricane,Ophelia,14,2005-09-09T21:00:00Z,COCOA BEACH FL,0,3,5,5,13
Hurricane,Ophelia,14,2005-09-09T21:00:00Z,ST MARKS FL,0,0,1,6,7
Hurricane,Ophelia,14,2005-09-09T21:00:00Z,DAYTONA BEACH FL,0,3,6,5,14
Hurricane,Ophelia,14,2005-09-09T21:00:00Z,APALACHICOLA FL,0,0,0,5,5
Hurricane,Ophelia,14,2005-09-09T21:00:00Z,JACKSONVILLE FL,0,2,5,7,14
Hurricane,Ophelia,14,2005-09-09T21:00:00Z,PANAMA CITY FL,0,0,0,4,4
Hurricane,Ophelia,14,2005-09-09T21:00:00Z,SAVANNAH GA,0,4,6,5,15
Hurricane,Ophelia,14,2005-09-09T21:00:00Z,PENSACOLA FL,0,0,0,2,2
Hurricane,Ophelia,14,2005-09-09T21:00:00Z,CHARLESTON SC,6,5,4,3,18
Hurricane,Ophelia,14,2005-09-09T21:00:00Z,GULF 29N 85W,0,0,0,5,5
Hurricane,Ophelia,14,2005-09-09T21:00:00Z,MYRTLE BEACH SC,7,7,3,2,19
Hurricane,Ophelia,14,2005-09-09T21:00:00Z,GULF 29N 87W,0,0,0,2,2
Hurricane,Ophelia,14,2005-09-09T21:00:00Z,WILMINGTON NC,4,8,3,2,17
Hurricane,Ophelia,15,2005-09-10T03:00:00Z,31.2N  76.7W,99,0,0,0,99
Hurricane,Ophelia,15,2005-09-10T03:00:00Z,WILMINGTON NC,2,10,4,2,18
Hurricane,Ophelia,15,2005-09-10T03:00:00Z,31.5N  77.2W,74,0,0,0,74
Hurricane,Ophelia,15,2005-09-10T03:00:00Z,MOREHEAD CITY NC,1,8,4,3,16
Hurricane,Ophelia,15,2005-09-10T03:00:00Z,31.7N  77.9W,52,0,0,0,52
Hurricane,Ophelia,15,2005-09-10T03:00:00Z,CAPE HATTERAS NC,0,4,4,3,11
Hurricane,Ophelia,15,2005-09-10T03:00:00Z,MUHA 230N 824W,0,0,0,2,2
Hurricane,Ophelia,15,2005-09-10T03:00:00Z,NORFOLK VA,0,1,3,4,8
Hurricane,Ophelia,15,2005-09-10T03:00:00Z,MYAK 241N 776W,0,0,0,2,2
Hurricane,Ophelia,15,2005-09-10T03:00:00Z,OCEAN CITY MD,0,0,1,3,4
Hurricane,Ophelia,15,2005-09-10T03:00:00Z,MYNN 251N 775W,0,0,0,3,3
Hurricane,Ophelia,15,2005-09-10T03:00:00Z,ATLANTIC CITY NJ,0,0,0,2,2
Hurricane,Ophelia,15,2005-09-10T03:00:00Z,MYGF 266N 787W,0,2,3,5,10
Hurricane,Ophelia,15,2005-09-10T03:00:00Z,KEY WEST FL,0,0,1,4,5
Hurricane,Ophelia,15,2005-09-10T03:00:00Z,MARATHON FL,0,0,1,5,6
Hurricane,Ophelia,15,2005-09-10T03:00:00Z,MARCO ISLAND FL,0,0,3,5,8
Hurricane,Ophelia,15,2005-09-10T03:00:00Z,MIAMI FL,0,0,4,4,8
Hurricane,Ophelia,15,2005-09-10T03:00:00Z,FT MYERS FL,0,0,4,5,9
Hurricane,Ophelia,15,2005-09-10T03:00:00Z,W PALM BEACH FL,0,2,5,4,11
Hurricane,Ophelia,15,2005-09-10T03:00:00Z,VENICE FL,0,0,3,6,9
Hurricane,Ophelia,15,2005-09-10T03:00:00Z,FT PIERCE FL,0,4,6,4,14
Hurricane,Ophelia,15,2005-09-10T03:00:00Z,TAMPA FL,0,0,4,6,10
Hurricane,Ophelia,15,2005-09-10T03:00:00Z,COCOA BEACH FL,0,5,6,4,15
Hurricane,Ophelia,15,2005-09-10T03:00:00Z,CEDAR KEY FL,0,0,3,7,10
Hurricane,Ophelia,15,2005-09-10T03:00:00Z,DAYTONA BEACH FL,0,5,6,5,16
Hurricane,Ophelia,15,2005-09-10T03:00:00Z,ST MARKS FL,0,0,0,6,6
Hurricane,Ophelia,15,2005-09-10T03:00:00Z,JACKSONVILLE FL,0,2,6,6,14
Hurricane,Ophelia,15,2005-09-10T03:00:00Z,APALACHICOLA FL,0,0,0,4,4
Hurricane,Ophelia,15,2005-09-10T03:00:00Z,SAVANNAH GA,0,2,7,6,15
Hurricane,Ophelia,15,2005-09-10T03:00:00Z,PANAMA CITY FL,0,0,0,3,3
Hurricane,Ophelia,15,2005-09-10T03:00:00Z,CHARLESTON SC,2,6,6,4,18
Hurricane,Ophelia,15,2005-09-10T03:00:00Z,GULF 29N 85W,0,0,0,4,4
Hurricane,Ophelia,15,2005-09-10T03:00:00Z,MYRTLE BEACH SC,4,8,4,3,19
Tropical Storm,Ophelia,16,2005-09-10T09:00:00Z,31.9N  76.7W,99,0,0,0,99
Tropical Storm,Ophelia,16,2005-09-10T09:00:00Z,MOREHEAD CITY NC,4,5,3,3,15
Tropical Storm,Ophelia,16,2005-09-10T09:00:00Z,32.0N  77.3W,99,0,0,0,99
Tropical Storm,Ophelia,16,2005-09-10T09:00:00Z,CAPE HATTERAS NC,0,2,3,4,9
Tropical Storm,Ophelia,16,2005-09-10T09:00:00Z,32.3N  78.0W,29,1,0,1,31
Tropical Storm,Ophelia,16,2005-09-10T09:00:00Z,NORFOLK VA,0,1,2,5,8
Tropical Storm,Ophelia,16,2005-09-10T09:00:00Z,MYAK 241N 776W,0,0,0,2,2
Tropical Storm,Ophelia,16,2005-09-10T09:00:00Z,OCEAN CITY MD,0,0,0,3,3
Tropical Storm,Ophelia,16,2005-09-10T09:00:00Z,MYNN 251N 775W,0,0,1,3,4
Tropical Storm,Ophelia,16,2005-09-10T09:00:00Z,ATLANTIC CITY NJ,0,0,0,2,2
Tropical Storm,Ophelia,16,2005-09-10T09:00:00Z,MYGF 266N 787W,0,1,3,4,8
Tropical Storm,Ophelia,16,2005-09-10T09:00:00Z,KEY WEST FL,0,0,0,3,3
Tropical Storm,Ophelia,16,2005-09-10T09:00:00Z,MARATHON FL,0,0,0,4,4
Tropical Storm,Ophelia,16,2005-09-10T09:00:00Z,MARCO ISLAND FL,0,0,1,4,5
Tropical Storm,Ophelia,16,2005-09-10T09:00:00Z,MIAMI FL,0,0,1,5,6
Tropical Storm,Ophelia,16,2005-09-10T09:00:00Z,FT MYERS FL,0,0,1,5,6
Tropical Storm,Ophelia,16,2005-09-10T09:00:00Z,W PALM BEACH FL,0,0,3,5,8
Tropical Storm,Ophelia,16,2005-09-10T09:00:00Z,VENICE FL,0,0,1,5,6
Tropical Storm,Ophelia,16,2005-09-10T09:00:00Z,FT PIERCE FL,0,1,4,5,10
Tropical Storm,Ophelia,16,2005-09-10T09:00:00Z,TAMPA FL,0,0,2,6,8
Tropical Storm,Ophelia,16,2005-09-10T09:00:00Z,COCOA BEACH FL,0,1,5,6,12
Tropical Storm,Ophelia,16,2005-09-10T09:00:00Z,CEDAR KEY FL,0,0,2,7,9
Tropical Storm,Ophelia,16,2005-09-10T09:00:00Z,DAYTONA BEACH FL,0,1,6,6,13
Tropical Storm,Ophelia,16,2005-09-10T09:00:00Z,ST MARKS FL,0,0,1,6,7
Tropical Storm,Ophelia,16,2005-09-10T09:00:00Z,JACKSONVILLE FL,0,1,6,6,13
Tropical Storm,Ophelia,16,2005-09-10T09:00:00Z,APALACHICOLA FL,0,0,0,5,5
Tropical Storm,Ophelia,16,2005-09-10T09:00:00Z,SAVANNAH GA,0,5,6,5,16
Tropical Storm,Ophelia,16,2005-09-10T09:00:00Z,PANAMA CITY FL,0,0,0,4,4
Tropical Storm,Ophelia,16,2005-09-10T09:00:00Z,CHARLESTON SC,5,8,4,2,19
Tropical Storm,Ophelia,16,2005-09-10T09:00:00Z,PENSACOLA FL,0,0,0,2,2
Tropical Storm,Ophelia,16,2005-09-10T09:00:00Z,MYRTLE BEACH SC,12,5,3,1,21
Tropical Storm,Ophelia,16,2005-09-10T09:00:00Z,GULF 29N 85W,0,0,0,4,4
Tropical Storm,Ophelia,16,2005-09-10T09:00:00Z,WILMINGTON NC,11,5,2,2,20
Tropical Storm,Ophelia,16,2005-09-10T09:00:00Z,GULF 29N 87W,0,0,0,2,2
Hurricane,Ophelia,17,2005-09-10T15:00:00Z,32.2N  76.9W,99,0,0,0,99
Hurricane,Ophelia,17,2005-09-10T15:00:00Z,MOREHEAD CITY NC,10,4,2,1,17
Hurricane,Ophelia,17,2005-09-10T15:00:00Z,32.3N  77.4W,99,0,0,0,99
Hurricane,Ophelia,17,2005-09-10T15:00:00Z,CAPE HATTERAS NC,2,4,2,3,11
Hurricane,Ophelia,17,2005-09-10T15:00:00Z,32.5N  78.0W,31,1,0,0,32
Hurricane,Ophelia,17,2005-09-10T15:00:00Z,NORFOLK VA,0,2,3,4,9
Hurricane,Ophelia,17,2005-09-10T15:00:00Z,MYAK 241N 776W,0,0,0,2,2
Hurricane,Ophelia,17,2005-09-10T15:00:00Z,OCEAN CITY MD,0,0,1,3,4
Hurricane,Ophelia,17,2005-09-10T15:00:00Z,MYNN 251N 775W,0,0,1,2,3
Hurricane,Ophelia,17,2005-09-10T15:00:00Z,ATLANTIC CITY NJ,0,0,0,2,2
Hurricane,Ophelia,17,2005-09-10T15:00:00Z,MYGF 266N 787W,0,1,2,4,7
Hurricane,Ophelia,17,2005-09-10T15:00:00Z,KEY WEST FL,0,0,0,3,3
Hurricane,Ophelia,17,2005-09-10T15:00:00Z,MARATHON FL,0,0,0,3,3
Hurricane,Ophelia,17,2005-09-10T15:00:00Z,MARCO ISLAND FL,0,0,1,4,5
Hurricane,Ophelia,17,2005-09-10T15:00:00Z,MIAMI FL,0,0,1,4,5
Hurricane,Ophelia,17,2005-09-10T15:00:00Z,FT MYERS FL,0,0,1,4,5
Hurricane,Ophelia,17,2005-09-10T15:00:00Z,W PALM BEACH FL,0,0,3,4,7
Hurricane,Ophelia,17,2005-09-10T15:00:00Z,VENICE FL,0,0,1,4,5
Hurricane,Ophelia,17,2005-09-10T15:00:00Z,FT PIERCE FL,0,1,3,5,9
Hurricane,Ophelia,17,2005-09-10T15:00:00Z,TAMPA FL,0,0,1,6,7
Hurricane,Ophelia,17,2005-09-10T15:00:00Z,COCOA BEACH FL,0,2,3,5,10
Hurricane,Ophelia,17,2005-09-10T15:00:00Z,CEDAR KEY FL,0,0,2,5,7
Hurricane,Ophelia,17,2005-09-10T15:00:00Z,DAYTONA BEACH FL,0,3,4,4,11
Hurricane,Ophelia,17,2005-09-10T15:00:00Z,ST MARKS FL,0,0,1,5,6
Hurricane,Ophelia,17,2005-09-10T15:00:00Z,JACKSONVILLE FL,0,4,4,4,12
Hurricane,Ophelia,17,2005-09-10T15:00:00Z,APALACHICOLA FL,0,0,0,4,4
Hurricane,Ophelia,17,2005-09-10T15:00:00Z,SAVANNAH GA,3,6,4,3,16
Hurricane,Ophelia,17,2005-09-10T15:00:00Z,PANAMA CITY FL,0,0,0,4,4
Hurricane,Ophelia,17,2005-09-10T15:00:00Z,CHARLESTON SC,12,5,2,2,21
Hurricane,Ophelia,17,2005-09-10T15:00:00Z,PENSACOLA FL,0,0,0,2,2
Hurricane,Ophelia,17,2005-09-10T15:00:00Z,MYRTLE BEACH SC,18,3,1,1,23
Hurricane,Ophelia,17,2005-09-10T15:00:00Z,GULF 29N 85W,0,0,0,4,4
Hurricane,Ophelia,17,2005-09-10T15:00:00Z,WILMINGTON NC,17,3,1,1,22
Hurricane,Ophelia,17,2005-09-10T15:00:00Z,GULF 29N 87W,0,0,0,2,2
Hurricane,Ophelia,18,2005-09-10T21:00:00Z,32.0N  76.0W,99,0,0,0,99
Hurricane,Ophelia,18,2005-09-10T21:00:00Z,MOREHEAD CITY NC,9,6,2,2,19
Hurricane,Ophelia,18,2005-09-10T21:00:00Z,32.2N  76.6W,99,0,0,0,99
Hurricane,Ophelia,18,2005-09-10T21:00:00Z,CAPE HATTERAS NC,2,7,2,3,14
Hurricane,Ophelia,18,2005-09-10T21:00:00Z,32.5N  77.5W,48,0,0,0,48
Hurricane,Ophelia,18,2005-09-10T21:00:00Z,NORFOLK VA,0,3,4,4,11
Hurricane,Ophelia,18,2005-09-10T21:00:00Z,MYAK 241N 776W,0,0,0,2,2
Hurricane,Ophelia,18,2005-09-10T21:00:00Z,OCEAN CITY MD,0,0,2,4,6
Hurricane,Ophelia,18,2005-09-10T21:00:00Z,MYNN 251N 775W,0,0,1,2,3
Hurricane,Ophelia,18,2005-09-10T21:00:00Z,ATLANTIC CITY NJ,0,0,1,3,4
Hurricane,Ophelia,18,2005-09-10T21:00:00Z,MYGF 266N 787W,0,0,3,4,7
Hurricane,Ophelia,18,2005-09-10T21:00:00Z,NEW YORK CITY NY,0,0,0,2,2
Hurricane,Ophelia,18,2005-09-10T21:00:00Z,MARATHON FL,0,0,0,2,2
Hurricane,Ophelia,18,2005-09-10T21:00:00Z,KEY WEST FL,0,0,0,2,2
Hurricane,Ophelia,18,2005-09-10T21:00:00Z,MIAMI FL,0,0,1,3,4
Hurricane,Ophelia,18,2005-09-10T21:00:00Z,MARCO ISLAND FL,0,0,0,3,3
Hurricane,Ophelia,18,2005-09-10T21:00:00Z,W PALM BEACH FL,0,0,2,4,6
Hurricane,Ophelia,18,2005-09-10T21:00:00Z,FT MYERS FL,0,0,0,4,4
Hurricane,Ophelia,18,2005-09-10T21:00:00Z,FT PIERCE FL,0,0,3,4,7
Hurricane,Ophelia,18,2005-09-10T21:00:00Z,VENICE FL,0,0,0,4,4
Hurricane,Ophelia,18,2005-09-10T21:00:00Z,COCOA BEACH FL,0,0,3,5,8
Hurricane,Ophelia,18,2005-09-10T21:00:00Z,TAMPA FL,0,0,1,4,5
Hurricane,Ophelia,18,2005-09-10T21:00:00Z,DAYTONA BEACH FL,0,0,4,5,9
Hurricane,Ophelia,18,2005-09-10T21:00:00Z,CEDAR KEY FL,0,0,1,4,5
Hurricane,Ophelia,18,2005-09-10T21:00:00Z,JACKSONVILLE FL,0,0,4,6,10
Hurricane,Ophelia,18,2005-09-10T21:00:00Z,ST MARKS FL,0,0,0,4,4
Hurricane,Ophelia,18,2005-09-10T21:00:00Z,SAVANNAH GA,0,2,5,5,12
Hurricane,Ophelia,18,2005-09-10T21:00:00Z,APALACHICOLA FL,0,0,0,3,3
Hurricane,Ophelia,18,2005-09-10T21:00:00Z,CHARLESTON SC,1,6,5,4,16
Hurricane,Ophelia,18,2005-09-10T21:00:00Z,PANAMA CITY FL,0,0,0,2,2
Hurricane,Ophelia,18,2005-09-10T21:00:00Z,MYRTLE BEACH SC,6,7,3,3,19
Hurricane,Ophelia,18,2005-09-10T21:00:00Z,GULF 29N 85W,0,0,0,2,2
Hurricane,Ophelia,18,2005-09-10T21:00:00Z,WILMINGTON NC,10,6,2,2,20
Hurricane,Ophelia,19,2005-09-11T03:00:00Z,31.7N  76.1W,99,0,0,0,99
Hurricane,Ophelia,19,2005-09-11T03:00:00Z,WILMINGTON NC,6,6,4,2,18
Hurricane,Ophelia,19,2005-09-11T03:00:00Z,32.0N  76.4W,99,0,0,0,99
Hurricane,Ophelia,19,2005-09-11T03:00:00Z,MOREHEAD CITY NC,3,6,4,3,16
Hurricane,Ophelia,19,2005-09-11T03:00:00Z,32.4N  76.7W,99,0,0,0,99
Hurricane,Ophelia,19,2005-09-11T03:00:00Z,CAPE HATTERAS NC,0,3,4,5,12
Hurricane,Ophelia,19,2005-09-11T03:00:00Z,COCOA BEACH FL,0,0,0,2,2
Hurricane,Ophelia,19,2005-09-11T03:00:00Z,NORFOLK VA,0,0,1,7,8
Hurricane,Ophelia,19,2005-09-11T03:00:00Z,DAYTONA BEACH FL,0,0,0,4,4
Hurricane,Ophelia,19,2005-09-11T03:00:00Z,OCEAN CITY MD,0,0,0,4,4
Hurricane,Ophelia,19,2005-09-11T03:00:00Z,JACKSONVILLE FL,0,0,2,4,6
Hurricane,Ophelia,19,2005-09-11T03:00:00Z,ATLANTIC CITY NJ,0,0,0,2,2
Hurricane,Ophelia,19,2005-09-11T03:00:00Z,SAVANNAH GA,0,4,4,4,12
Hurricane,Ophelia,19,2005-09-11T03:00:00Z,CEDAR KEY FL,0,0,0,2,2
Hurricane,Ophelia,19,2005-09-11T03:00:00Z,CHARLESTON SC,3,7,4,3,17
Hurricane,Ophelia,19,2005-09-11T03:00:00Z,ST MARKS FL,0,0,0,3,3
Hurricane,Ophelia,19,2005-09-11T03:00:00Z,MYRTLE BEACH SC,7,6,4,2,19
Hurricane,Ophelia,20,2005-09-11T09:00:00Z,31.6N  76.2W,99,0,0,0,99
Hurricane,Ophelia,20,2005-09-11T09:00:00Z,WILMINGTON NC,5,8,4,2,19
Hurricane,Ophelia,20,2005-09-11T09:00:00Z,32.0N  76.5W,99,0,0,0,99
Hurricane,Ophelia,20,2005-09-11T09:00:00Z,MOREHEAD CITY NC,6,9,3,2,20
Hurricane,Ophelia,20,2005-09-11T09:00:00Z,32.6N  76.7W,98,0,0,0,98
Hurricane,Ophelia,20,2005-09-11T09:00:00Z,CAPE HATTERAS NC,2,9,4,2,17
Hurricane,Ophelia,20,2005-09-11T09:00:00Z,MYNN 251N 775W,0,0,0,2,2
Hurricane,Ophelia,20,2005-09-11T09:00:00Z,NORFOLK VA,0,3,6,5,14
Hurricane,Ophelia,20,2005-09-11T09:00:00Z,MYGF 266N 787W,0,0,1,3,4
Hurricane,Ophelia,20,2005-09-11T09:00:00Z,OCEAN CITY MD,0,0,4,5,9
Hurricane,Ophelia,20,2005-09-11T09:00:00Z,MIAMI FL,0,0,0,2,2
Hurricane,Ophelia,20,2005-09-11T09:00:00Z,ATLANTIC CITY NJ,0,0,1,5,6
Hurricane,Ophelia,20,2005-09-11T09:00:00Z,W PALM BEACH FL,0,0,0,3,3
Hurricane,Ophelia,20,2005-09-11T09:00:00Z,NEW YORK CITY NY,0,0,0,4,4
Hurricane,Ophelia,20,2005-09-11T09:00:00Z,FT PIERCE FL,0,0,1,3,4
Hurricane,Ophelia,20,2005-09-11T09:00:00Z,MONTAUK POINT NY,0,0,0,2,2
Hurricane,Ophelia,20,2005-09-11T09:00:00Z,COCOA BEACH FL,0,0,1,4,5
Hurricane,Ophelia,20,2005-09-11T09:00:00Z,FT MYERS FL,0,0,0,2,2
Hurricane,Ophelia,20,2005-09-11T09:00:00Z,DAYTONA BEACH FL,0,0,1,5,6
Hurricane,Ophelia,20,2005-09-11T09:00:00Z,VENICE FL,0,0,0,2,2
Hurricane,Ophelia,20,2005-09-11T09:00:00Z,JACKSONVILLE FL,0,0,1,5,6
Hurricane,Ophelia,20,2005-09-11T09:00:00Z,TAMPA FL,0,0,0,2,2
Hurricane,Ophelia,20,2005-09-11T09:00:00Z,SAVANNAH GA,0,1,2,6,9
Hurricane,Ophelia,20,2005-09-11T09:00:00Z,CEDAR KEY FL,0,0,0,3,3
Hurricane,Ophelia,20,2005-09-11T09:00:00Z,CHARLESTON SC,1,4,4,5,14
Hurricane,Ophelia,20,2005-09-11T09:00:00Z,ST MARKS FL,0,0,0,2,2
Hurricane,Ophelia,20,2005-09-11T09:00:00Z,MYRTLE BEACH SC,4,6,4,3,17
Hurricane,Ophelia,21,2005-09-11T15:00:00Z,31.9N  76.1W,99,0,0,0,99
Hurricane,Ophelia,21,2005-09-11T15:00:00Z,CHARLESTON SC,1,5,4,4,14
Hurricane,Ophelia,21,2005-09-11T15:00:00Z,32.2N  76.5W,99,0,0,0,99
Hurricane,Ophelia,21,2005-09-11T15:00:00Z,MYRTLE BEACH SC,6,8,3,2,19
Hurricane,Ophelia,21,2005-09-11T15:00:00Z,32.7N  76.7W,37,0,1,0,38
Hurricane,Ophelia,21,2005-09-11T15:00:00Z,WILMINGTON NC,9,7,3,2,21
Hurricane,Ophelia,21,2005-09-11T15:00:00Z,MYGF 266N 787W,0,0,0,2,2
Hurricane,Ophelia,21,2005-09-11T15:00:00Z,MOREHEAD CITY NC,9,6,2,3,20
Hurricane,Ophelia,21,2005-09-11T15:00:00Z,FT PIERCE FL,0,0,0,2,2
Hurricane,Ophelia,21,2005-09-11T15:00:00Z,CAPE HATTERAS NC,3,5,3,4,15
Hurricane,Ophelia,21,2005-09-11T15:00:00Z,COCOA BEACH FL,0,0,0,2,2
Hurricane,Ophelia,21,2005-09-11T15:00:00Z,NORFOLK VA,0,2,3,7,12
Hurricane,Ophelia,21,2005-09-11T15:00:00Z,DAYTONA BEACH FL,0,0,0,3,3
Hurricane,Ophelia,21,2005-09-11T15:00:00Z,OCEAN CITY MD,0,0,1,6,7
Hurricane,Ophelia,21,2005-09-11T15:00:00Z,JACKSONVILLE FL,0,0,1,3,4
Hurricane,Ophelia,21,2005-09-11T15:00:00Z,ATLANTIC CITY NJ,0,0,0,4,4
Hurricane,Ophelia,21,2005-09-11T15:00:00Z,SAVANNAH GA,0,1,2,5,8
Hurricane,Ophelia,21,2005-09-11T15:00:00Z,NEW YORK CITY NY,0,0,0,2,2
Hurricane,Ophelia,22,2005-09-11T21:00:00Z,31.9N  77.1W,99,0,0,0,99
Hurricane,Ophelia,22,2005-09-11T21:00:00Z,NORFOLK VA,0,1,5,6,12
Hurricane,Ophelia,22,2005-09-11T21:00:00Z,32.4N  77.3W,56,0,0,0,56
Hurricane,Ophelia,22,2005-09-11T21:00:00Z,OCEAN CITY MD,0,0,1,7,8
Hurricane,Ophelia,22,2005-09-11T21:00:00Z,32.9N  77.3W,42,0,0,0,42
Hurricane,Ophelia,22,2005-09-11T21:00:00Z,ATLANTIC CITY NJ,0,0,0,5,5
Hurricane,Ophelia,22,2005-09-11T21:00:00Z,FT PIERCE FL,0,0,0,2,2
Hurricane,Ophelia,22,2005-09-11T21:00:00Z,NEW YORK CITY NY,0,0,0,3,3
Hurricane,Ophelia,22,2005-09-11T21:00:00Z,COCOA BEACH FL,0,0,1,2,3
Hurricane,Ophelia,22,2005-09-11T21:00:00Z,MONTAUK POINT NY,0,0,0,2,2
Hurricane,Ophelia,22,2005-09-11T21:00:00Z,DAYTONA BEACH FL,0,1,2,3,6
Hurricane,Ophelia,22,2005-09-11T21:00:00Z,TAMPA FL,0,0,0,2,2
Hurricane,Ophelia,22,2005-09-11T21:00:00Z,JACKSONVILLE FL,0,3,3,4,10
Hurricane,Ophelia,22,2005-09-11T21:00:00Z,CEDAR KEY FL,0,0,1,3,4
Hurricane,Ophelia,22,2005-09-11T21:00:00Z,SAVANNAH GA,2,6,4,3,15
Hurricane,Ophelia,22,2005-09-11T21:00:00Z,ST MARKS FL,0,0,1,4,5
Hurricane,Ophelia,22,2005-09-11T21:00:00Z,CHARLESTON SC,8,6,3,2,19
Hurricane,Ophelia,22,2005-09-11T21:00:00Z,APALACHICOLA FL,0,0,0,3,3
Hurricane,Ophelia,22,2005-09-11T21:00:00Z,MYRTLE BEACH SC,12,5,2,2,21
Hurricane,Ophelia,22,2005-09-11T21:00:00Z,PANAMA CITY FL,0,0,0,3,3
Hurricane,Ophelia,22,2005-09-11T21:00:00Z,WILMINGTON NC,11,5,3,2,21
Hurricane,Ophelia,22,2005-09-11T21:00:00Z,PENSACOLA FL,0,0,0,2,2
Hurricane,Ophelia,22,2005-09-11T21:00:00Z,MOREHEAD CITY NC,8,6,3,3,20
Hurricane,Ophelia,22,2005-09-11T21:00:00Z,GULF 29N 85W,0,0,0,2,2
Hurricane,Ophelia,22,2005-09-11T21:00:00Z,CAPE HATTERAS NC,2,7,4,4,17
Hurricane,Ophelia,23,2005-09-12T03:00:00Z,31.8N  77.5W,77,0,0,0,77
Hurricane,Ophelia,23,2005-09-12T03:00:00Z,CAPE HATTERAS NC,1,7,5,5,18
Hurricane,Ophelia,23,2005-09-12T03:00:00Z,32.2N  77.6W,59,0,0,0,59
Hurricane,Ophelia,23,2005-09-12T03:00:00Z,NORFOLK VA,0,2,5,7,14
Hurricane,Ophelia,23,2005-09-12T03:00:00Z,32.9N  77.7W,30,1,1,0,32
Hurricane,Ophelia,23,2005-09-12T03:00:00Z,OCEAN CITY MD,0,0,2,8,10
Hurricane,Ophelia,23,2005-09-12T03:00:00Z,FT PIERCE FL,0,0,1,1,2
Hurricane,Ophelia,23,2005-09-12T03:00:00Z,ATLANTIC CITY NJ,0,0,0,7,7
Hurricane,Ophelia,23,2005-09-12T03:00:00Z,COCOA BEACH FL,0,1,1,2,4
Hurricane,Ophelia,23,2005-09-12T03:00:00Z,NEW YORK CITY NY,0,0,0,4,4
Hurricane,Ophelia,23,2005-09-12T03:00:00Z,DAYTONA BEACH FL,0,2,3,2,7
Hurricane,Ophelia,23,2005-09-12T03:00:00Z,MONTAUK POINT NY,0,0,0,2,2
Hurricane,Ophelia,23,2005-09-12T03:00:00Z,JACKSONVILLE FL,0,3,3,3,9
Hurricane,Ophelia,23,2005-09-12T03:00:00Z,TAMPA FL,0,0,1,1,2
Hurricane,Ophelia,23,2005-09-12T03:00:00Z,SAVANNAH GA,1,5,4,4,14
Hurricane,Ophelia,23,2005-09-12T03:00:00Z,CEDAR KEY FL,0,0,1,2,3
Hurricane,Ophelia,23,2005-09-12T03:00:00Z,CHARLESTON SC,7,5,4,3,19
Hurricane,Ophelia,23,2005-09-12T03:00:00Z,ST MARKS FL,0,0,1,2,3
Hurricane,Ophelia,23,2005-09-12T03:00:00Z,MYRTLE BEACH SC,9,6,3,3,21
Hurricane,Ophelia,23,2005-09-12T03:00:00Z,APALACHICOLA FL,0,0,0,2,2
Hurricane,Ophelia,23,2005-09-12T03:00:00Z,WILMINGTON NC,8,7,3,3,21
Hurricane,Ophelia,23,2005-09-12T03:00:00Z,PANAMA CITY FL,0,0,0,2,2
Hurricane,Ophelia,23,2005-09-12T03:00:00Z,MOREHEAD CITY NC,5,8,4,3,20
Hurricane,Ophelia,24,2005-09-12T09:00:00Z,31.9N  77.5W,99,0,0,0,99
Hurricane,Ophelia,24,2005-09-12T09:00:00Z,MOREHEAD CITY NC,6,8,4,2,20
Hurricane,Ophelia,24,2005-09-12T09:00:00Z,32.5N  77.6W,53,0,0,0,53
Hurricane,Ophelia,24,2005-09-12T09:00:00Z,CAPE HATTERAS NC,1,8,5,4,18
Hurricane,Ophelia,24,2005-09-12T09:00:00Z,33.3N  77.5W,27,1,1,0,29
Hurricane,Ophelia,24,2005-09-12T09:00:00Z,NORFOLK VA,0,1,6,7,14
Hurricane,Ophelia,24,2005-09-12T09:00:00Z,DAYTONA BEACH FL,0,1,0,2,3
Hurricane,Ophelia,24,2005-09-12T09:00:00Z,OCEAN CITY MD,0,0,2,8,10
Hurricane,Ophelia,24,2005-09-12T09:00:00Z,JACKSONVILLE FL,1,2,1,3,7
Hurricane,Ophelia,24,2005-09-12T09:00:00Z,ATLANTIC CITY NJ,0,0,0,7,7
Hurricane,Ophelia,24,2005-09-12T09:00:00Z,SAVANNAH GA,3,6,3,2,14
Hurricane,Ophelia,24,2005-09-12T09:00:00Z,NEW YORK CITY NY,0,0,0,4,4
Hurricane,Ophelia,24,2005-09-12T09:00:00Z,CHARLESTON SC,11,5,2,2,20
Hurricane,Ophelia,24,2005-09-12T09:00:00Z,MONTAUK POINT NY,0,0,0,2,2
Hurricane,Ophelia,24,2005-09-12T09:00:00Z,MYRTLE BEACH SC,13,5,2,2,22
Hurricane,Ophelia,24,2005-09-12T09:00:00Z,PROVIDENCE RI,0,0,0,2,2
Hurricane,Ophelia,24,2005-09-12T09:00:00Z,WILMINGTON NC,10,7,3,2,22
Hurricane,Ophelia,24,2005-09-12T09:00:00Z,ST MARKS FL,0,0,0,2,2
Tropical Storm,Ophelia,25,2005-09-12T15:00:00Z,32.3N  77.7W,99,0,0,0,99
Tropical Storm,Ophelia,25,2005-09-12T15:00:00Z,MOREHEAD CITY NC,9,6,3,2,20
Tropical Storm,Ophelia,25,2005-09-12T15:00:00Z,33.0N  77.7W,46,0,0,0,46
Tropical Storm,Ophelia,25,2005-09-12T15:00:00Z,CAPE HATTERAS NC,2,6,5,4,17
Tropical Storm,Ophelia,25,2005-09-12T15:00:00Z,33.9N  77.4W,21,2,1,1,25
Tropical Storm,Ophelia,25,2005-09-12T15:00:00Z,NORFOLK VA,0,1,5,7,13
Tropical Storm,Ophelia,25,2005-09-12T15:00:00Z,DAYTONA BEACH FL,0,0,1,1,2
Tropical Storm,Ophelia,25,2005-09-12T15:00:00Z,OCEAN CITY MD,0,0,1,7,8
Tropical Storm,Ophelia,25,2005-09-12T15:00:00Z,JACKSONVILLE FL,1,1,1,2,5
Tropical Storm,Ophelia,25,2005-09-12T15:00:00Z,ATLANTIC CITY NJ,0,0,0,5,5
Tropical Storm,Ophelia,25,2005-09-12T15:00:00Z,SAVANNAH GA,5,5,2,2,14
Tropical Storm,Ophelia,25,2005-09-12T15:00:00Z,NEW YORK CITY NY,0,0,0,3,3
Tropical Storm,Ophelia,25,2005-09-12T15:00:00Z,CHARLESTON SC,15,3,2,1,21
Tropical Storm,Ophelia,25,2005-09-12T15:00:00Z,MONTAUK POINT NY,0,0,0,2,2
Tropical Storm,Ophelia,25,2005-09-12T15:00:00Z,MYRTLE BEACH SC,19,3,1,1,24
Tropical Storm,Ophelia,25,2005-09-12T15:00:00Z,ST MARKS FL,0,0,0,2,2
Tropical Storm,Ophelia,25,2005-09-12T15:00:00Z,WILMINGTON NC,15,4,2,1,22
Tropical Storm,Ophelia,26,2005-09-12T21:00:00Z,32.8N  78.0W,99,0,0,0,99
Tropical Storm,Ophelia,26,2005-09-12T21:00:00Z,WILMINGTON NC,20,2,1,1,24
Tropical Storm,Ophelia,26,2005-09-12T21:00:00Z,33.3N  78.0W,55,1,0,0,56
Tropical Storm,Ophelia,26,2005-09-12T21:00:00Z,MOREHEAD CITY NC,8,6,3,2,19
Tropical Storm,Ophelia,26,2005-09-12T21:00:00Z,34.2N  77.7W,21,2,1,1,25
Tropical Storm,Ophelia,26,2005-09-12T21:00:00Z,CAPE HATTERAS NC,1,4,6,4,15
Tropical Storm,Ophelia,26,2005-09-12T21:00:00Z,JACKSONVILLE FL,0,0,1,3,4
Tropical Storm,Ophelia,26,2005-09-12T21:00:00Z,NORFOLK VA,0,1,4,7,12
Tropical Storm,Ophelia,26,2005-09-12T21:00:00Z,SAVANNAH GA,3,5,2,2,12
Tropical Storm,Ophelia,26,2005-09-12T21:00:00Z,OCEAN CITY MD,0,0,1,6,7
Tropical Storm,Ophelia,26,2005-09-12T21:00:00Z,CHARLESTON SC,20,2,0,1,23
Tropical Storm,Ophelia,26,2005-09-12T21:00:00Z,ATLANTIC CITY NJ,0,0,0,5,5
Tropical Storm,Ophelia,26,2005-09-12T21:00:00Z,MYRTLE BEACH SC,34,1,0,0,35
Tropical Storm,Ophelia,26,2005-09-12T21:00:00Z,NEW YORK CITY NY,0,0,0,3,3
Tropical Storm,Ophelia,27,2005-09-13T03:00:00Z,32.9N  78.1W,99,0,0,0,99
Tropical Storm,Ophelia,27,2005-09-13T03:00:00Z,WILMINGTON NC,18,3,1,1,23
Tropical Storm,Ophelia,27,2005-09-13T03:00:00Z,33.7N  77.8W,33,1,0,0,34
Tropical Storm,Ophelia,27,2005-09-13T03:00:00Z,MOREHEAD CITY NC,4,9,3,3,19
Tropical Storm,Ophelia,27,2005-09-13T03:00:00Z,34.6N  77.2W,9,6,3,2,20
Tropical Storm,Ophelia,27,2005-09-13T03:00:00Z,CAPE HATTERAS NC,0,5,6,5,16
Tropical Storm,Ophelia,27,2005-09-13T03:00:00Z,JACKSONVILLE FL,0,0,1,1,2
Tropical Storm,Ophelia,27,2005-09-13T03:00:00Z,NORFOLK VA,0,1,5,7,13
Tropical Storm,Ophelia,27,2005-09-13T03:00:00Z,SAVANNAH GA,4,3,2,1,10
Tropical Storm,Ophelia,27,2005-09-13T03:00:00Z,OCEAN CITY MD,0,0,1,8,9
Tropical Storm,Ophelia,27,2005-09-13T03:00:00Z,CHARLESTON SC,25,1,0,0,26
Tropical Storm,Ophelia,27,2005-09-13T03:00:00Z,ATLANTIC CITY NJ,0,0,0,5,5
Tropical Storm,Ophelia,27,2005-09-13T03:00:00Z,MYRTLE BEACH SC,37,0,0,0,37
Tropical Storm,Ophelia,27,2005-09-13T03:00:00Z,NEW YORK CITY NY,0,0,0,3,3
Tropical Storm,Ophelia,28,2005-09-13T09:00:00Z,33.1N  78.2W,67,0,0,0,67
Tropical Storm,Ophelia,28,2005-09-13T09:00:00Z,CAPE HATTERAS NC,0,8,5,4,17
Tropical Storm,Ophelia,28,2005-09-13T09:00:00Z,34.0N  77.8W,26,2,0,0,28
Tropical Storm,Ophelia,28,2005-09-13T09:00:00Z,NORFOLK VA,0,2,7,6,15
Tropical Storm,Ophelia,28,2005-09-13T09:00:00Z,34.9N  76.9W,5,10,3,2,20
Tropical Storm,Ophelia,28,2005-09-13T09:00:00Z,OCEAN CITY MD,0,0,3,8,11
Tropical Storm,Ophelia,28,2005-09-13T09:00:00Z,SAVANNAH GA,2,3,0,2,7
Tropical Storm,Ophelia,28,2005-09-13T09:00:00Z,ATLANTIC CITY NJ,0,0,1,6,7
Tropical Storm,Ophelia,28,2005-09-13T09:00:00Z,CHARLESTON SC,25,0,0,1,26
Tropical Storm,Ophelia,28,2005-09-13T09:00:00Z,NEW YORK CITY NY,0,0,0,5,5
Tropical Storm,Ophelia,28,2005-09-13T09:00:00Z,MYRTLE BEACH SC,40,0,0,0,40
Tropical Storm,Ophelia,28,2005-09-13T09:00:00Z,MONTAUK POINT NY,0,0,0,2,2
Tropical Storm,Ophelia,28,2005-09-13T09:00:00Z,WILMINGTON NC,22,2,1,0,25
Tropical Storm,Ophelia,28,2005-09-13T09:00:00Z,PROVIDENCE RI,0,0,0,2,2
Tropical Storm,Ophelia,28,2005-09-13T09:00:00Z,MOREHEAD CITY NC,6,10,2,2,20
Tropical Storm,Ophelia,29,2005-09-13T15:00:00Z,33.9N  77.7W,31,0,1,0,32
Tropical Storm,Ophelia,29,2005-09-13T15:00:00Z,NORFOLK VA,1,6,5,3,15
Tropical Storm,Ophelia,29,2005-09-13T15:00:00Z,34.9N  76.9W,16,4,1,1,22
Tropical Storm,Ophelia,29,2005-09-13T15:00:00Z,OCEAN CITY MD,0,1,3,7,11
Tropical Storm,Ophelia,29,2005-09-13T15:00:00Z,35.4N  75.7W,4,8,4,2,18
Tropical Storm,Ophelia,29,2005-09-13T15:00:00Z,ATLANTIC CITY NJ,0,0,1,7,8
Tropical Storm,Ophelia,29,2005-09-13T15:00:00Z,SAVANNAH GA,6,2,0,1,9
Tropical Storm,Ophelia,29,2005-09-13T15:00:00Z,NEW YORK CITY NY,0,0,0,5,5
Tropical Storm,Ophelia,29,2005-09-13T15:00:00Z,CHARLESTON SC,28,0,0,0,28
Tropical Storm,Ophelia,29,2005-09-13T15:00:00Z,MONTAUK POINT NY,0,0,0,3,3
Tropical Storm,Ophelia,29,2005-09-13T15:00:00Z,MYRTLE BEACH SC,35,0,1,0,36
Tropical Storm,Ophelia,29,2005-09-13T15:00:00Z,PROVIDENCE RI,0,0,0,2,2
Tropical Storm,Ophelia,29,2005-09-13T15:00:00Z,WILMINGTON NC,28,1,0,1,30
Tropical Storm,Ophelia,29,2005-09-13T15:00:00Z,NANTUCKET MA,0,0,0,2,2
Tropical Storm,Ophelia,29,2005-09-13T15:00:00Z,MOREHEAD CITY NC,16,4,1,1,22
Tropical Storm,Ophelia,29,2005-09-13T15:00:00Z,HYANNIS MA,0,0,0,2,2
Tropical Storm,Ophelia,29,2005-09-13T15:00:00Z,CAPE HATTERAS NC,4,8,4,2,18
Tropical Storm,Ophelia,29,2005-09-13T15:00:00Z,BOSTON MA,0,0,0,2,2
Tropical Storm,Ophelia,30,2005-09-13T21:00:00Z,34.3N  77.2W,35,0,0,0,35
Tropical Storm,Ophelia,30,2005-09-13T21:00:00Z,OCEAN CITY MD,0,2,6,4,12
Tropical Storm,Ophelia,30,2005-09-13T21:00:00Z,35.2N  76.1W,13,6,2,0,21
Tropical Storm,Ophelia,30,2005-09-13T21:00:00Z,ATLANTIC CITY NJ,0,0,4,6,10
Tropical Storm,Ophelia,30,2005-09-13T21:00:00Z,35.7N  74.7W,2,9,4,1,16
Tropical Storm,Ophelia,30,2005-09-13T21:00:00Z,NEW YORK CITY NY,0,0,1,7,8
Tropical Storm,Ophelia,30,2005-09-13T21:00:00Z,BERMUDA,0,0,0,3,3
Tropical Storm,Ophelia,30,2005-09-13T21:00:00Z,MONTAUK POINT NY,0,0,0,7,7
Tropical Storm,Ophelia,30,2005-09-13T21:00:00Z,SAVANNAH GA,1,1,1,1,4
Tropical Storm,Ophelia,30,2005-09-13T21:00:00Z,PROVIDENCE RI,0,0,0,6,6
Tropical Storm,Ophelia,30,2005-09-13T21:00:00Z,CHARLESTON SC,12,2,1,0,15
Tropical Storm,Ophelia,30,2005-09-13T21:00:00Z,NANTUCKET MA,0,0,0,5,5
Tropical Storm,Ophelia,30,2005-09-13T21:00:00Z,MYRTLE BEACH SC,45,0,0,0,45
Tropical Storm,Ophelia,30,2005-09-13T21:00:00Z,HYANNIS MA,0,0,0,5,5
Tropical Storm,Ophelia,30,2005-09-13T21:00:00Z,WILMINGTON NC,42,0,0,0,42
Tropical Storm,Ophelia,30,2005-09-13T21:00:00Z,BOSTON MA,0,0,0,5,5
Tropical Storm,Ophelia,30,2005-09-13T21:00:00Z,MOREHEAD CITY NC,23,2,1,0,26
Tropical Storm,Ophelia,30,2005-09-13T21:00:00Z,PORTLAND ME,0,0,0,4,4
Tropical Storm,Ophelia,30,2005-09-13T21:00:00Z,CAPE HATTERAS NC,8,8,3,1,20
Tropical Storm,Ophelia,30,2005-09-13T21:00:00Z,BAR HARBOR ME,0,0,0,2,2
Tropical Storm,Ophelia,30,2005-09-13T21:00:00Z,NORFOLK VA,2,9,4,1,16
Hurricane,Ophelia,31,2005-09-13T21:30:00Z,34.3N  77.2W,32,0,1,0,33
Hurricane,Ophelia,31,2005-09-13T21:30:00Z,ATLANTIC CITY NJ,0,0,4,6,10
Hurricane,Ophelia,31,2005-09-13T21:30:00Z,35.2N  76.1W,12,6,2,0,20
Hurricane,Ophelia,31,2005-09-13T21:30:00Z,NEW YORK CITY NY,0,0,2,6,8
Hurricane,Ophelia,31,2005-09-13T21:30:00Z,35.7N  74.7W,2,8,4,2,16
Hurricane,Ophelia,31,2005-09-13T21:30:00Z,MONTAUK POINT NY,0,0,0,7,7
Hurricane,Ophelia,31,2005-09-13T21:30:00Z,BERMUDA,0,0,0,3,3
Hurricane,Ophelia,31,2005-09-13T21:30:00Z,PROVIDENCE RI,0,0,0,6,6
Hurricane,Ophelia,31,2005-09-13T21:30:00Z,SAVANNAH GA,1,2,1,0,4
Hurricane,Ophelia,31,2005-09-13T21:30:00Z,NANTUCKET MA,0,0,0,6,6
Hurricane,Ophelia,31,2005-09-13T21:30:00Z,CHARLESTON SC,11,2,1,1,15
Hurricane,Ophelia,31,2005-09-13T21:30:00Z,HYANNIS MA,0,0,0,5,5
Hurricane,Ophelia,31,2005-09-13T21:30:00Z,MYRTLE BEACH SC,46,0,0,0,46
Hurricane,Ophelia,31,2005-09-13T21:30:00Z,BOSTON MA,0,0,0,5,5
Hurricane,Ophelia,31,2005-09-13T21:30:00Z,WILMINGTON NC,40,0,0,0,40
Hurricane,Ophelia,31,2005-09-13T21:30:00Z,PORTLAND ME,0,0,0,4,4
Hurricane,Ophelia,31,2005-09-13T21:30:00Z,MOREHEAD CITY NC,21,2,1,1,25
Hurricane,Ophelia,31,2005-09-13T21:30:00Z,BAR HARBOR ME,0,0,0,3,3
Hurricane,Ophelia,31,2005-09-13T21:30:00Z,CAPE HATTERAS NC,8,8,2,1,19
Hurricane,Ophelia,31,2005-09-13T21:30:00Z,EASTPORT ME,0,0,0,2,2
Hurricane,Ophelia,31,2005-09-13T21:30:00Z,NORFOLK VA,2,8,4,2,16
Hurricane,Ophelia,31,2005-09-13T21:30:00Z,YARMOUTH NS,0,0,0,2,2
Hurricane,Ophelia,31,2005-09-13T21:30:00Z,OCEAN CITY MD,0,2,6,4,12
Hurricane,Ophelia,32,2005-09-14T03:00:00Z,34.4N  76.9W,31,1,0,0,32
Hurricane,Ophelia,32,2005-09-14T03:00:00Z,ATLANTIC CITY NJ,0,0,4,6,10
Hurricane,Ophelia,32,2005-09-14T03:00:00Z,35.1N  75.8W,12,7,1,1,21
Hurricane,Ophelia,32,2005-09-14T03:00:00Z,NEW YORK CITY NY,0,0,1,7,8
Hurricane,Ophelia,32,2005-09-14T03:00:00Z,35.7N  74.3W,1,8,5,2,16
Hurricane,Ophelia,32,2005-09-14T03:00:00Z,MONTAUK POINT NY,0,0,0,7,7
Hurricane,Ophelia,32,2005-09-14T03:00:00Z,BERMUDA,0,0,0,3,3
Hurricane,Ophelia,32,2005-09-14T03:00:00Z,PROVIDENCE RI,0,0,0,6,6
Hurricane,Ophelia,32,2005-09-14T03:00:00Z,SAVANNAH GA,0,1,1,1,3
Hurricane,Ophelia,32,2005-09-14T03:00:00Z,NANTUCKET MA,0,0,0,6,6
Hurricane,Ophelia,32,2005-09-14T03:00:00Z,CHARLESTON SC,8,3,1,0,12
Hurricane,Ophelia,32,2005-09-14T03:00:00Z,HYANNIS MA,0,0,0,6,6
Hurricane,Ophelia,32,2005-09-14T03:00:00Z,MYRTLE BEACH SC,45,0,0,0,45
Hurricane,Ophelia,32,2005-09-14T03:00:00Z,BOSTON MA,0,0,0,6,6
Hurricane,Ophelia,32,2005-09-14T03:00:00Z,WILMINGTON NC,42,0,1,0,43
Hurricane,Ophelia,32,2005-09-14T03:00:00Z,PORTLAND ME,0,0,0,4,4
Hurricane,Ophelia,32,2005-09-14T03:00:00Z,MOREHEAD CITY NC,25,1,1,0,27
Hurricane,Ophelia,32,2005-09-14T03:00:00Z,BAR HARBOR ME,0,0,0,3,3
Hurricane,Ophelia,32,2005-09-14T03:00:00Z,CAPE HATTERAS NC,9,8,2,1,20
Hurricane,Ophelia,32,2005-09-14T03:00:00Z,EASTPORT ME,0,0,0,2,2
Hurricane,Ophelia,32,2005-09-14T03:00:00Z,NORFOLK VA,2,8,5,1,16
Hurricane,Ophelia,32,2005-09-14T03:00:00Z,YARMOUTH NS,0,0,0,2,2
Hurricane,Ophelia,32,2005-09-14T03:00:00Z,OCEAN CITY MD,0,1,7,4,12
Hurricane,Ophelia,33,2005-09-14T09:00:00Z,34.7N  76.5W,30,1,0,0,31
Hurricane,Ophelia,33,2005-09-14T09:00:00Z,MONTAUK POINT NY,0,0,1,7,8
Hurricane,Ophelia,33,2005-09-14T09:00:00Z,35.3N  75.5W,12,6,2,0,20
Hurricane,Ophelia,33,2005-09-14T09:00:00Z,PROVIDENCE RI,0,0,0,8,8
Hurricane,Ophelia,33,2005-09-14T09:00:00Z,36.0N  73.5W,0,5,7,3,15
Hurricane,Ophelia,33,2005-09-14T09:00:00Z,NANTUCKET MA,0,0,0,7,7
Hurricane,Ophelia,33,2005-09-14T09:00:00Z,BERMUDA,0,0,0,4,4
Hurricane,Ophelia,33,2005-09-14T09:00:00Z,HYANNIS MA,0,0,0,7,7
Hurricane,Ophelia,33,2005-09-14T09:00:00Z,CHARLESTON SC,5,2,1,0,8
Hurricane,Ophelia,33,2005-09-14T09:00:00Z,BOSTON MA,0,0,0,7,7
Hurricane,Ophelia,33,2005-09-14T09:00:00Z,MYRTLE BEACH SC,52,0,0,0,52
Hurricane,Ophelia,33,2005-09-14T09:00:00Z,PORTLAND ME,0,0,0,6,6
Hurricane,Ophelia,33,2005-09-14T09:00:00Z,WILMINGTON NC,58,0,0,0,58
Hurricane,Ophelia,33,2005-09-14T09:00:00Z,BAR HARBOR ME,0,0,0,4,4
Hurricane,Ophelia,33,2005-09-14T09:00:00Z,MOREHEAD CITY NC,33,0,0,1,34
Hurricane,Ophelia,33,2005-09-14T09:00:00Z,EASTPORT ME,0,0,0,4,4
Hurricane,Ophelia,33,2005-09-14T09:00:00Z,CAPE HATTERAS NC,13,5,2,1,21
Hurricane,Ophelia,33,2005-09-14T09:00:00Z,ST JOHN NB,0,0,0,3,3
Hurricane,Ophelia,33,2005-09-14T09:00:00Z,NORFOLK VA,2,9,4,1,16
Hurricane,Ophelia,33,2005-09-14T09:00:00Z,MONCTON NB,0,0,0,2,2
Hurricane,Ophelia,33,2005-09-14T09:00:00Z,OCEAN CITY MD,0,2,8,3,13
Hurricane,Ophelia,33,2005-09-14T09:00:00Z,YARMOUTH NS,0,0,0,4,4
Hurricane,Ophelia,33,2005-09-14T09:00:00Z,ATLANTIC CITY NJ,0,0,6,5,11
Hurricane,Ophelia,33,2005-09-14T09:00:00Z,HALIFAX NS,0,0,0,2,2
Hurricane,Ophelia,33,2005-09-14T09:00:00Z,NEW YORK CITY NY,0,0,3,6,9
Hurricane,Ophelia,34,2005-09-14T15:00:00Z,35.1N  75.9W,34,0,1,0,35
Hurricane,Ophelia,34,2005-09-14T15:00:00Z,MONTAUK POINT NY,0,0,5,5,10
Hurricane,Ophelia,34,2005-09-14T15:00:00Z,35.8N  74.5W,13,5,2,0,20
Hurricane,Ophelia,34,2005-09-14T15:00:00Z,PROVIDENCE RI,0,0,4,5,9
Hurricane,Ophelia,34,2005-09-14T15:00:00Z,36.8N  72.5W,1,7,5,3,16
Hurricane,Ophelia,34,2005-09-14T15:00:00Z,NANTUCKET MA,0,0,3,7,10
Hurricane,Ophelia,34,2005-09-14T15:00:00Z,BERMUDA,0,0,0,4,4
Hurricane,Ophelia,34,2005-09-14T15:00:00Z,HYANNIS MA,0,0,3,6,9
Hurricane,Ophelia,34,2005-09-14T15:00:00Z,JACKSONVILLE FL,0,0,1,1,2
Hurricane,Ophelia,34,2005-09-14T15:00:00Z,BOSTON MA,0,0,2,6,8
Hurricane,Ophelia,34,2005-09-14T15:00:00Z,SAVANNAH GA,0,1,2,1,4
Hurricane,Ophelia,34,2005-09-14T15:00:00Z,PORTLAND ME,0,0,1,6,7
Hurricane,Ophelia,34,2005-09-14T15:00:00Z,CHARLESTON SC,2,4,2,1,9
Hurricane,Ophelia,34,2005-09-14T15:00:00Z,BAR HARBOR ME,0,0,0,6,6
Hurricane,Ophelia,34,2005-09-14T15:00:00Z,MYRTLE BEACH SC,99,0,0,0,99
Hurricane,Ophelia,34,2005-09-14T15:00:00Z,EASTPORT ME,0,0,0,5,5
Hurricane,Ophelia,34,2005-09-14T15:00:00Z,WILMINGTON NC,99,0,0,0,99
Hurricane,Ophelia,34,2005-09-14T15:00:00Z,ST JOHN NB,0,0,0,5,5
Hurricane,Ophelia,34,2005-09-14T15:00:00Z,MOREHEAD CITY NC,62,0,0,0,62
Hurricane,Ophelia,34,2005-09-14T15:00:00Z,MONCTON NB,0,0,0,4,4
Hurricane,Ophelia,34,2005-09-14T15:00:00Z,CAPE HATTERAS NC,27,1,0,0,28
Hurricane,Ophelia,34,2005-09-14T15:00:00Z,YARMOUTH NS,0,0,0,6,6
Hurricane,Ophelia,34,2005-09-14T15:00:00Z,NORFOLK VA,13,4,2,0,19
Hurricane,Ophelia,34,2005-09-14T15:00:00Z,HALIFAX NS,0,0,0,4,4
Hurricane,Ophelia,34,2005-09-14T15:00:00Z,OCEAN CITY MD,2,8,3,2,15
Hurricane,Ophelia,34,2005-09-14T15:00:00Z,SABLE ISLAND NS,0,0,0,3,3
Hurricane,Ophelia,34,2005-09-14T15:00:00Z,ATLANTIC CITY NJ,0,4,6,2,12
Hurricane,Ophelia,34,2005-09-14T15:00:00Z,SYDNEY NS,0,0,0,2,2
Hurricane,Ophelia,34,2005-09-14T15:00:00Z,NEW YORK CITY NY,0,1,6,4,11
Hurricane,Ophelia,34,2005-09-14T15:00:00Z,EDDY POINT NS,0,0,0,3,3
Hurricane,Ophelia,35,2005-09-14T21:00:00Z,35.3N  75.4W,35,1,0,0,36
Hurricane,Ophelia,35,2005-09-14T21:00:00Z,NANTUCKET MA,0,0,3,7,10
Hurricane,Ophelia,35,2005-09-14T21:00:00Z,36.0N  74.1W,12,5,2,1,20
Hurricane,Ophelia,35,2005-09-14T21:00:00Z,HYANNIS MA,0,0,2,8,10
Hurricane,Ophelia,35,2005-09-14T21:00:00Z,37.5N  72.2W,0,4,9,2,15
Hurricane,Ophelia,35,2005-09-14T21:00:00Z,BOSTON MA,0,0,2,7,9
Hurricane,Ophelia,35,2005-09-14T21:00:00Z,BERMUDA,0,0,0,3,3
Hurricane,Ophelia,35,2005-09-14T21:00:00Z,PORTLAND ME,0,0,1,6,7
Hurricane,Ophelia,35,2005-09-14T21:00:00Z,CHARLESTON SC,1,1,1,0,3
Hurricane,Ophelia,35,2005-09-14T21:00:00Z,BAR HARBOR ME,0,0,0,7,7
Hurricane,Ophelia,35,2005-09-14T21:00:00Z,MYRTLE BEACH SC,9,2,1,0,12
Hurricane,Ophelia,35,2005-09-14T21:00:00Z,EASTPORT ME,0,0,0,7,7
Hurricane,Ophelia,35,2005-09-14T21:00:00Z,WILMINGTON NC,99,0,0,0,99
Hurricane,Ophelia,35,2005-09-14T21:00:00Z,ST JOHN NB,0,0,0,6,6
Hurricane,Ophelia,35,2005-09-14T21:00:00Z,MOREHEAD CITY NC,99,0,0,0,99
Hurricane,Ophelia,35,2005-09-14T21:00:00Z,MONCTON NB,0,0,0,5,5
Hurricane,Ophelia,35,2005-09-14T21:00:00Z,CAPE HATTERAS NC,40,0,0,0,40
Hurricane,Ophelia,35,2005-09-14T21:00:00Z,YARMOUTH NS,0,0,0,7,7
Hurricane,Ophelia,35,2005-09-14T21:00:00Z,NORFOLK VA,14,4,2,0,20
Hurricane,Ophelia,35,2005-09-14T21:00:00Z,HALIFAX NS,0,0,0,6,6
Hurricane,Ophelia,35,2005-09-14T21:00:00Z,OCEAN CITY MD,2,8,5,1,16
Hurricane,Ophelia,35,2005-09-14T21:00:00Z,SABLE ISLAND NS,0,0,0,3,3
Hurricane,Ophelia,35,2005-09-14T21:00:00Z,ATLANTIC CITY NJ,0,4,7,2,13
Hurricane,Ophelia,35,2005-09-14T21:00:00Z,SYDNEY NS,0,0,0,3,3
Hurricane,Ophelia,35,2005-09-14T21:00:00Z,NEW YORK CITY NY,0,1,7,3,11
Hurricane,Ophelia,35,2005-09-14T21:00:00Z,EDDY POINT NS,0,0,0,4,4
Hurricane,Ophelia,35,2005-09-14T21:00:00Z,MONTAUK POINT NY,0,0,5,5,10
Hurricane,Ophelia,35,2005-09-14T21:00:00Z,PTX BASQUES NFLD,0,0,0,2,2
Hurricane,Ophelia,35,2005-09-14T21:00:00Z,PROVIDENCE RI,0,0,4,6,10
Hurricane,Ophelia,36,2005-09-15T03:00:00Z,35.3N  74.9W,37,0,0,0,37
Hurricane,Ophelia,36,2005-09-15T03:00:00Z,HYANNIS MA,0,0,5,6,11
Hurricane,Ophelia,36,2005-09-15T03:00:00Z,36.3N  73.6W,12,6,2,1,21
Hurricane,Ophelia,36,2005-09-15T03:00:00Z,BOSTON MA,0,0,4,6,10
Hurricane,Ophelia,36,2005-09-15T03:00:00Z,38.0N  71.5W,0,5,8,3,16
Hurricane,Ophelia,36,2005-09-15T03:00:00Z,PORTLAND ME,0,0,1,7,8
Hurricane,Ophelia,36,2005-09-15T03:00:00Z,CHARLESTON SC,0,1,1,0,2
Hurricane,Ophelia,36,2005-09-15T03:00:00Z,BAR HARBOR ME,0,0,1,7,8
Hurricane,Ophelia,36,2005-09-15T03:00:00Z,MYRTLE BEACH SC,2,4,1,1,8
Hurricane,Ophelia,36,2005-09-15T03:00:00Z,EASTPORT ME,0,0,0,7,7
Hurricane,Ophelia,36,2005-09-15T03:00:00Z,WILMINGTON NC,99,0,0,0,99
Hurricane,Ophelia,36,2005-09-15T03:00:00Z,ST JOHN NB,0,0,0,7,7
Hurricane,Ophelia,36,2005-09-15T03:00:00Z,MOREHEAD CITY NC,99,0,0,0,99
Hurricane,Ophelia,36,2005-09-15T03:00:00Z,MONCTON NB,0,0,0,6,6
Hurricane,Ophelia,36,2005-09-15T03:00:00Z,CAPE HATTERAS NC,49,0,0,0,49
Hurricane,Ophelia,36,2005-09-15T03:00:00Z,YARMOUTH NS,0,0,0,8,8
Hurricane,Ophelia,36,2005-09-15T03:00:00Z,NORFOLK VA,12,5,2,0,19
Hurricane,Ophelia,36,2005-09-15T03:00:00Z,HALIFAX NS,0,0,0,7,7
Hurricane,Ophelia,36,2005-09-15T03:00:00Z,OCEAN CITY MD,2,10,3,1,16
Hurricane,Ophelia,36,2005-09-15T03:00:00Z,SABLE ISLAND NS,0,0,0,4,4
Hurricane,Ophelia,36,2005-09-15T03:00:00Z,ATLANTIC CITY NJ,0,5,7,2,14
Hurricane,Ophelia,36,2005-09-15T03:00:00Z,SYDNEY NS,0,0,0,5,5
Hurricane,Ophelia,36,2005-09-15T03:00:00Z,NEW YORK CITY NY,0,2,7,3,12
Hurricane,Ophelia,36,2005-09-15T03:00:00Z,EDDY POINT NS,0,0,0,5,5
Hurricane,Ophelia,36,2005-09-15T03:00:00Z,MONTAUK POINT NY,0,0,8,4,12
Hurricane,Ophelia,36,2005-09-15T03:00:00Z,PTX BASQUES NFLD,0,0,0,4,4
Hurricane,Ophelia,36,2005-09-15T03:00:00Z,PROVIDENCE RI,0,0,6,5,11
Hurricane,Ophelia,36,2005-09-15T03:00:00Z,BURGEO NFLD,0,0,0,3,3
Hurricane,Ophelia,36,2005-09-15T03:00:00Z,NANTUCKET MA,0,0,5,6,11
Hurricane,Ophelia,36,2005-09-15T03:00:00Z,ILE ST PIERRE,0,0,0,2,2
Hurricane,Ophelia,37,2005-09-15T09:00:00Z,35.7N  74.7W,37,0,0,0,37
Hurricane,Ophelia,37,2005-09-15T09:00:00Z,BOSTON MA,0,0,6,5,11
Hurricane,Ophelia,37,2005-09-15T09:00:00Z,37.0N  73.5W,11,8,2,0,21
Hurricane,Ophelia,37,2005-09-15T09:00:00Z,PORTLAND ME,0,0,3,7,10
Hurricane,Ophelia,37,2005-09-15T09:00:00Z,39.0N  71.5W,0,4,10,2,16
Hurricane,Ophelia,37,2005-09-15T09:00:00Z,BAR HARBOR ME,0,0,1,8,9
Hurricane,Ophelia,37,2005-09-15T09:00:00Z,MYRTLE BEACH SC,1,3,1,0,5
Hurricane,Ophelia,37,2005-09-15T09:00:00Z,EASTPORT ME,0,0,0,9,9
Hurricane,Ophelia,37,2005-09-15T09:00:00Z,WILMINGTON NC,10,2,1,0,13
Hurricane,Ophelia,37,2005-09-15T09:00:00Z,ST JOHN NB,0,0,0,8,8
Hurricane,Ophelia,37,2005-09-15T09:00:00Z,MOREHEAD CITY NC,99,0,0,0,99
Hurricane,Ophelia,37,2005-09-15T09:00:00Z,MONCTON NB,0,0,0,7,7
Hurricane,Ophelia,37,2005-09-15T09:00:00Z,CAPE HATTERAS NC,99,0,0,0,99
Hurricane,Ophelia,37,2005-09-15T09:00:00Z,YARMOUTH NS,0,0,0,9,9
Hurricane,Ophelia,37,2005-09-15T09:00:00Z,NORFOLK VA,15,5,1,0,21
Hurricane,Ophelia,37,2005-09-15T09:00:00Z,HALIFAX NS,0,0,0,7,7
Hurricane,Ophelia,37,2005-09-15T09:00:00Z,OCEAN CITY MD,4,12,2,1,19
Hurricane,Ophelia,37,2005-09-15T09:00:00Z,SABLE ISLAND NS,0,0,0,4,4
Hurricane,Ophelia,37,2005-09-15T09:00:00Z,ATLANTIC CITY NJ,0,9,6,1,16
Hurricane,Ophelia,37,2005-09-15T09:00:00Z,SYDNEY NS,0,0,0,5,5
Hurricane,Ophelia,37,2005-09-15T09:00:00Z,NEW YORK CITY NY,0,3,9,2,14
Hurricane,Ophelia,37,2005-09-15T09:00:00Z,EDDY POINT NS,0,0,0,6,6
Hurricane,Ophelia,37,2005-09-15T09:00:00Z,MONTAUK POINT NY,0,1,9,4,14
Hurricane,Ophelia,37,2005-09-15T09:00:00Z,PTX BASQUES NFLD,0,0,0,4,4
Hurricane,Ophelia,37,2005-09-15T09:00:00Z,PROVIDENCE RI,0,0,8,5,13
Hurricane,Ophelia,37,2005-09-15T09:00:00Z,BURGEO NFLD,0,0,0,3,3
Hurricane,Ophelia,37,2005-09-15T09:00:00Z,NANTUCKET MA,0,0,7,6,13
Hurricane,Ophelia,37,2005-09-15T09:00:00Z,ILE ST PIERRE,0,0,0,2,2
Hurricane,Ophelia,37,2005-09-15T09:00:00Z,HYANNIS MA,0,0,7,5,12
Hurricane,Ophelia,38,2005-09-15T15:00:00Z,35.7N  74.3W,39,0,0,0,39
Hurricane,Ophelia,38,2005-09-15T15:00:00Z,BOSTON MA,0,0,7,5,12
Hurricane,Ophelia,38,2005-09-15T15:00:00Z,37.1N  73.2W,11,9,1,1,22
Hurricane,Ophelia,38,2005-09-15T15:00:00Z,PORTLAND ME,0,0,3,7,10
Hurricane,Ophelia,38,2005-09-15T15:00:00Z,39.2N  70.9W,0,4,10,2,16
Hurricane,Ophelia,38,2005-09-15T15:00:00Z,BAR HARBOR ME,0,0,2,7,9
Hurricane,Ophelia,38,2005-09-15T15:00:00Z,MYRTLE BEACH SC,0,3,1,1,5
Hurricane,Ophelia,38,2005-09-15T15:00:00Z,EASTPORT ME,0,0,1,8,9
Hurricane,Ophelia,38,2005-09-15T15:00:00Z,WILMINGTON NC,5,4,1,1,11
Hurricane,Ophelia,38,2005-09-15T15:00:00Z,ST JOHN NB,0,0,0,9,9
Hurricane,Ophelia,38,2005-09-15T15:00:00Z,MOREHEAD CITY NC,99,0,0,0,99
Hurricane,Ophelia,38,2005-09-15T15:00:00Z,MONCTON NB,0,0,0,8,8
Hurricane,Ophelia,38,2005-09-15T15:00:00Z,CAPE HATTERAS NC,99,0,0,0,99
Hurricane,Ophelia,38,2005-09-15T15:00:00Z,YARMOUTH NS,0,0,1,9,10
Hurricane,Ophelia,38,2005-09-15T15:00:00Z,NORFOLK VA,12,6,1,1,20
Hurricane,Ophelia,38,2005-09-15T15:00:00Z,HALIFAX NS,0,0,0,8,8
Hurricane,Ophelia,38,2005-09-15T15:00:00Z,OCEAN CITY MD,5,11,2,1,19
Hurricane,Ophelia,38,2005-09-15T15:00:00Z,SABLE ISLAND NS,0,0,0,6,6
Hurricane,Ophelia,38,2005-09-15T15:00:00Z,ATLANTIC CITY NJ,1,8,6,1,16
Hurricane,Ophelia,38,2005-09-15T15:00:00Z,SYDNEY NS,0,0,0,6,6
Hurricane,Ophelia,38,2005-09-15T15:00:00Z,NEW YORK CITY NY,0,4,9,1,14
Hurricane,Ophelia,38,2005-09-15T15:00:00Z,EDDY POINT NS,0,0,0,7,7
Hurricane,Ophelia,38,2005-09-15T15:00:00Z,MONTAUK POINT NY,0,1,11,2,14
Hurricane,Ophelia,38,2005-09-15T15:00:00Z,PTX BASQUES NFLD,0,0,0,5,5
Hurricane,Ophelia,38,2005-09-15T15:00:00Z,PROVIDENCE RI,0,1,9,3,13
Hurricane,Ophelia,38,2005-09-15T15:00:00Z,BURGEO NFLD,0,0,0,4,4
Hurricane,Ophelia,38,2005-09-15T15:00:00Z,NANTUCKET MA,0,0,9,5,14
Hurricane,Ophelia,38,2005-09-15T15:00:00Z,ILE ST PIERRE,0,0,0,3,3
Hurricane,Ophelia,38,2005-09-15T15:00:00Z,HYANNIS MA,0,0,8,5,13
Hurricane,Ophelia,38,2005-09-15T15:00:00Z,CAPE RACE NFLD,0,0,0,2,2
Hurricane,Ophelia,39,2005-09-15T21:00:00Z,36.4N  74.1W,31,4,0,0,35
Hurricane,Ophelia,39,2005-09-15T21:00:00Z,PORTLAND ME,0,0,11,2,13
Hurricane,Ophelia,39,2005-09-15T21:00:00Z,38.7N  71.6W,0,19,6,0,25
Hurricane,Ophelia,39,2005-09-15T21:00:00Z,BAR HARBOR ME,0,0,8,5,13
Hurricane,Ophelia,39,2005-09-15T21:00:00Z,41.7N  67.7W,0,0,13,3,16
Hurricane,Ophelia,39,2005-09-15T21:00:00Z,EASTPORT ME,0,0,6,6,12
Hurricane,Ophelia,39,2005-09-15T21:00:00Z,WILMINGTON NC,3,1,0,0,4
Hurricane,Ophelia,39,2005-09-15T21:00:00Z,ST JOHN NB,0,0,4,7,11
Hurricane,Ophelia,39,2005-09-15T21:00:00Z,MOREHEAD CITY NC,99,0,0,0,99
Hurricane,Ophelia,39,2005-09-15T21:00:00Z,MONCTON NB,0,0,2,8,10
Hurricane,Ophelia,39,2005-09-15T21:00:00Z,CAPE HATTERAS NC,99,0,0,0,99
Hurricane,Ophelia,39,2005-09-15T21:00:00Z,YARMOUTH NS,0,0,6,7,13
Hurricane,Ophelia,39,2005-09-15T21:00:00Z,NORFOLK VA,21,4,0,0,25
Hurricane,Ophelia,39,2005-09-15T21:00:00Z,HALIFAX NS,0,0,2,9,11
Hurricane,Ophelia,39,2005-09-15T21:00:00Z,OCEAN CITY MD,11,14,0,0,25
Hurricane,Ophelia,39,2005-09-15T21:00:00Z,SABLE ISLAND NS,0,0,0,8,8
Hurricane,Ophelia,39,2005-09-15T21:00:00Z,ATLANTIC CITY NJ,2,17,2,1,22
Hurricane,Ophelia,39,2005-09-15T21:00:00Z,SYDNEY NS,0,0,0,9,9
Hurricane,Ophelia,39,2005-09-15T21:00:00Z,NEW YORK CITY NY,0,12,7,0,19
Hurricane,Ophelia,39,2005-09-15T21:00:00Z,EDDY POINT NS,0,0,0,9,9
Hurricane,Ophelia,39,2005-09-15T21:00:00Z,MONTAUK POINT NY,0,8,12,0,20
Hurricane,Ophelia,39,2005-09-15T21:00:00Z,PTX BASQUES NFLD,0,0,0,8,8
Hurricane,Ophelia,39,2005-09-15T21:00:00Z,PROVIDENCE RI,0,4,14,0,18
Hurricane,Ophelia,39,2005-09-15T21:00:00Z,BURGEO NFLD,0,0,0,7,7
Hurricane,Ophelia,39,2005-09-15T21:00:00Z,NANTUCKET MA,0,3,15,1,19
Hurricane,Ophelia,39,2005-09-15T21:00:00Z,ILE ST PIERRE,0,0,0,6,6
Hurricane,Ophelia,39,2005-09-15T21:00:00Z,HYANNIS MA,0,2,16,0,18
Hurricane,Ophelia,39,2005-09-15T21:00:00Z,CAPE RACE NFLD,0,0,0,4,4
Hurricane,Ophelia,39,2005-09-15T21:00:00Z,BOSTON MA,0,2,14,0,16
Tropical Storm,Ophelia,40,2005-09-16T03:00:00Z,37.2N  73.0W,29,5,0,0,34
Tropical Storm,Ophelia,40,2005-09-16T03:00:00Z,BAR HARBOR ME,0,1,12,2,15
Tropical Storm,Ophelia,40,2005-09-16T03:00:00Z,40.0N  70.4W,1,19,3,1,24
Tropical Storm,Ophelia,40,2005-09-16T03:00:00Z,EASTPORT ME,0,0,11,3,14
Tropical Storm,Ophelia,40,2005-09-16T03:00:00Z,43.0N  67.0W,0,1,14,2,17
Tropical Storm,Ophelia,40,2005-09-16T03:00:00Z,ST JOHN NB,0,0,8,6,14
Tropical Storm,Ophelia,40,2005-09-16T03:00:00Z,MOREHEAD CITY NC,12,2,0,0,14
Tropical Storm,Ophelia,40,2005-09-16T03:00:00Z,MONCTON NB,0,0,5,7,12
Tropical Storm,Ophelia,40,2005-09-16T03:00:00Z,CAPE HATTERAS NC,99,0,0,0,99
Tropical Storm,Ophelia,40,2005-09-16T03:00:00Z,YARMOUTH NS,0,0,12,3,15
Tropical Storm,Ophelia,40,2005-09-16T03:00:00Z,NORFOLK VA,17,3,0,0,20
Tropical Storm,Ophelia,40,2005-09-16T03:00:00Z,HALIFAX NS,0,0,6,7,13
Tropical Storm,Ophelia,40,2005-09-16T03:00:00Z,OCEAN CITY MD,16,7,0,0,23
Tropical Storm,Ophelia,40,2005-09-16T03:00:00Z,SABLE ISLAND NS,0,0,1,9,10
Tropical Storm,Ophelia,40,2005-09-16T03:00:00Z,ATLANTIC CITY NJ,7,13,0,1,21
Tropical Storm,Ophelia,40,2005-09-16T03:00:00Z,SYDNEY NS,0,0,1,9,10
Tropical Storm,Ophelia,40,2005-09-16T03:00:00Z,NEW YORK CITY NY,2,15,2,0,19
Tropical Storm,Ophelia,40,2005-09-16T03:00:00Z,EDDY POINT NS,0,0,2,9,11
Tropical Storm,Ophelia,40,2005-09-16T03:00:00Z,MONTAUK POINT NY,1,16,4,0,21
Tropical Storm,Ophelia,40,2005-09-16T03:00:00Z,PTX BASQUES NFLD,0,0,0,9,9
Tropical Storm,Ophelia,40,2005-09-16T03:00:00Z,PROVIDENCE RI,0,13,7,0,20
Tropical Storm,Ophelia,40,2005-09-16T03:00:00Z,BURGEO NFLD,0,0,0,9,9
Tropical Storm,Ophelia,40,2005-09-16T03:00:00Z,NANTUCKET MA,0,13,8,0,21
Tropical Storm,Ophelia,40,2005-09-16T03:00:00Z,ILE ST PIERRE,0,0,0,8,8
Tropical Storm,Ophelia,40,2005-09-16T03:00:00Z,HYANNIS MA,0,12,8,1,21
Tropical Storm,Ophelia,40,2005-09-16T03:00:00Z,CAPE RACE NFLD,0,0,0,6,6
Tropical Storm,Ophelia,40,2005-09-16T03:00:00Z,BOSTON MA,0,9,9,0,18
Tropical Storm,Ophelia,40,2005-09-16T03:00:00Z,HIBERNIA OILFLD,0,0,0,3,3
Tropical Storm,Ophelia,40,2005-09-16T03:00:00Z,PORTLAND ME,0,3,11,2,16
Tropical Storm,Ophelia,41,2005-09-16T09:00:00Z,38.0N  72.0W,27,5,0,0,32
Tropical Storm,Ophelia,41,2005-09-16T09:00:00Z,BAR HARBOR ME,0,2,12,0,14
Tropical Storm,Ophelia,41,2005-09-16T09:00:00Z,41.0N  69.0W,0,16,6,0,22
Tropical Storm,Ophelia,41,2005-09-16T09:00:00Z,EASTPORT ME,0,1,12,1,14
Tropical Storm,Ophelia,41,2005-09-16T09:00:00Z,44.0N  64.0W,0,0,11,3,14
Tropical Storm,Ophelia,41,2005-09-16T09:00:00Z,ST JOHN NB,0,0,11,2,13
Tropical Storm,Ophelia,41,2005-09-16T09:00:00Z,MOREHEAD CITY NC,2,0,0,0,2
Tropical Storm,Ophelia,41,2005-09-16T09:00:00Z,MONCTON NB,0,0,9,3,12
Tropical Storm,Ophelia,41,2005-09-16T09:00:00Z,CAPE HATTERAS NC,99,0,0,0,99
Tropical Storm,Ophelia,41,2005-09-16T09:00:00Z,YARMOUTH NS,0,1,14,0,15
Tropical Storm,Ophelia,41,2005-09-16T09:00:00Z,NORFOLK VA,18,0,0,0,18
Tropical Storm,Ophelia,41,2005-09-16T09:00:00Z,HALIFAX NS,0,0,9,4,13
Tropical Storm,Ophelia,41,2005-09-16T09:00:00Z,OCEAN CITY MD,18,2,0,0,20
Tropical Storm,Ophelia,41,2005-09-16T09:00:00Z,SABLE ISLAND NS,0,0,2,8,10
Tropical Storm,Ophelia,41,2005-09-16T09:00:00Z,ATLANTIC CITY NJ,10,6,0,0,16
Tropical Storm,Ophelia,41,2005-09-16T09:00:00Z,SYDNEY NS,0,0,2,8,10
Tropical Storm,Ophelia,41,2005-09-16T09:00:00Z,NEW YORK CITY NY,4,11,0,0,15
Tropical Storm,Ophelia,41,2005-09-16T09:00:00Z,EDDY POINT NS,0,0,4,7,11
Tropical Storm,Ophelia,41,2005-09-16T09:00:00Z,MONTAUK POINT NY,1,18,1,0,20
Tropical Storm,Ophelia,41,2005-09-16T09:00:00Z,PTX BASQUES NFLD,0,0,1,8,9
Tropical Storm,Ophelia,41,2005-09-16T09:00:00Z,PROVIDENCE RI,0,17,2,0,19
Tropical Storm,Ophelia,41,2005-09-16T09:00:00Z,BURGEO NFLD,0,0,0,9,9
Tropical Storm,Ophelia,41,2005-09-16T09:00:00Z,NANTUCKET MA,0,18,3,1,22
Tropical Storm,Ophelia,41,2005-09-16T09:00:00Z,ILE ST PIERRE,0,0,0,9,9
Tropical Storm,Ophelia,41,2005-09-16T09:00:00Z,HYANNIS MA,0,17,3,0,20
Tropical Storm,Ophelia,41,2005-09-16T09:00:00Z,CAPE RACE NFLD,0,0,0,7,7
Tropical Storm,Ophelia,41,2005-09-16T09:00:00Z,BOSTON MA,0,13,4,0,17
Tropical Storm,Ophelia,41,2005-09-16T09:00:00Z,HIBERNIA OILFLD,0,0,0,5,5
Tropical Storm,Ophelia,41,2005-09-16T09:00:00Z,PORTLAND ME,0,6,8,0,14
Tropical Storm,Ophelia,42,2005-09-16T15:00:00Z,39.8N  70.6W,38,1,0,0,39
Tropical Storm,Ophelia,42,2005-09-16T15:00:00Z,BAR HARBOR ME,0,14,1,0,15
Tropical Storm,Ophelia,42,2005-09-16T15:00:00Z,42.8N  66.7W,0,16,1,0,17
Tropical Storm,Ophelia,42,2005-09-16T15:00:00Z,EASTPORT ME,0,12,3,0,15
Tropical Storm,Ophelia,42,2005-09-16T15:00:00Z,46.0N  60.8W,0,1,7,2,10
Tropical Storm,Ophelia,42,2005-09-16T15:00:00Z,ST JOHN NB,0,9,5,0,14
Tropical Storm,Ophelia,42,2005-09-16T15:00:00Z,CAPE HATTERAS NC,99,0,0,0,99
Tropical Storm,Ophelia,42,2005-09-16T15:00:00Z,MONCTON NB,0,5,7,0,12
Tropical Storm,Ophelia,42,2005-09-16T15:00:00Z,NORFOLK VA,4,0,0,0,4
Tropical Storm,Ophelia,42,2005-09-16T15:00:00Z,YARMOUTH NS,0,12,3,1,16
Tropical Storm,Ophelia,42,2005-09-16T15:00:00Z,OCEAN CITY MD,19,1,0,0,20
Tropical Storm,Ophelia,42,2005-09-16T15:00:00Z,HALIFAX NS,0,4,8,0,12
Tropical Storm,Ophelia,42,2005-09-16T15:00:00Z,ATLANTIC CITY NJ,15,2,0,0,17
Tropical Storm,Ophelia,42,2005-09-16T15:00:00Z,SABLE ISLAND NS,0,0,6,3,9
Tropical Storm,Ophelia,42,2005-09-16T15:00:00Z,NEW YORK CITY NY,13,4,0,0,17
Tropical Storm,Ophelia,42,2005-09-16T15:00:00Z,SYDNEY NS,0,0,6,3,9
Tropical Storm,Ophelia,42,2005-09-16T15:00:00Z,MONTAUK POINT NY,20,6,0,0,26
Tropical Storm,Ophelia,42,2005-09-16T15:00:00Z,EDDY POINT NS,0,1,7,2,10
Tropical Storm,Ophelia,42,2005-09-16T15:00:00Z,PROVIDENCE RI,12,10,0,0,22
Tropical Storm,Ophelia,42,2005-09-16T15:00:00Z,PTX BASQUES NFLD,0,0,5,4,9
Tropical Storm,Ophelia,42,2005-09-16T15:00:00Z,NANTUCKET MA,16,11,0,0,27
Tropical Storm,Ophelia,42,2005-09-16T15:00:00Z,BURGEO NFLD,0,0,3,6,9
Tropical Storm,Ophelia,42,2005-09-16T15:00:00Z,HYANNIS MA,11,13,0,0,24
Tropical Storm,Ophelia,42,2005-09-16T15:00:00Z,ILE ST PIERRE,0,0,1,7,8
Tropical Storm,Ophelia,42,2005-09-16T15:00:00Z,BOSTON MA,5,14,0,0,19
Tropical Storm,Ophelia,42,2005-09-16T15:00:00Z,CAPE RACE NFLD,0,0,0,7,7
Tropical Storm,Ophelia,42,2005-09-16T15:00:00Z,PORTLAND ME,1,14,0,0,15
Tropical Storm,Ophelia,42,2005-09-16T15:00:00Z,HIBERNIA OILFLD,0,0,0,6,6
Tropical Storm,Ophelia,43,2005-09-16T21:00:00Z,41.6N  68.5W,16,5,0,0,21
Tropical Storm,Ophelia,43,2005-09-16T21:00:00Z,EASTPORT ME,1,14,0,0,15
Tropical Storm,Ophelia,43,2005-09-16T21:00:00Z,45.2N  63.6W,0,10,3,1,14
Tropical Storm,Ophelia,43,2005-09-16T21:00:00Z,ST JOHN NB,0,14,0,0,14
Tropical Storm,Ophelia,43,2005-09-16T21:00:00Z,48.0N  57.3W,0,0,8,2,10
Tropical Storm,Ophelia,43,2005-09-16T21:00:00Z,MONCTON NB,0,11,2,1,14
Tropical Storm,Ophelia,43,2005-09-16T21:00:00Z,OCEAN CITY MD,5,0,0,0,5
Tropical Storm,Ophelia,43,2005-09-16T21:00:00Z,YARMOUTH NS,1,14,1,0,16
Tropical Storm,Ophelia,43,2005-09-16T21:00:00Z,ATLANTIC CITY NJ,7,0,0,0,7
Tropical Storm,Ophelia,43,2005-09-16T21:00:00Z,HALIFAX NS,0,10,3,0,13
Tropical Storm,Ophelia,43,2005-09-16T21:00:00Z,NEW YORK CITY NY,11,0,0,0,11
Tropical Storm,Ophelia,43,2005-09-16T21:00:00Z,SABLE ISLAND NS,0,2,7,1,10
Tropical Storm,Ophelia,43,2005-09-16T21:00:00Z,MONTAUK POINT NY,25,0,0,0,25
Tropical Storm,Ophelia,43,2005-09-16T21:00:00Z,SYDNEY NS,0,3,8,0,11
Tropical Storm,Ophelia,43,2005-09-16T21:00:00Z,PROVIDENCE RI,22,0,0,0,22
Tropical Storm,Ophelia,43,2005-09-16T21:00:00Z,EDDY POINT NS,0,5,6,1,12
Tropical Storm,Ophelia,43,2005-09-16T21:00:00Z,NANTUCKET MA,25,0,0,0,25
Tropical Storm,Ophelia,43,2005-09-16T21:00:00Z,PTX BASQUES NFLD,0,1,9,1,11
Tropical Storm,Ophelia,43,2005-09-16T21:00:00Z,HYANNIS MA,23,0,0,0,23
Tropical Storm,Ophelia,43,2005-09-16T21:00:00Z,BURGEO NFLD,0,0,8,2,10
Tropical Storm,Ophelia,43,2005-09-16T21:00:00Z,BOSTON MA,18,1,0,0,19
Tropical Storm,Ophelia,43,2005-09-16T21:00:00Z,ILE ST PIERRE,0,0,6,4,10
Tropical Storm,Ophelia,43,2005-09-16T21:00:00Z,PORTLAND ME,10,4,1,0,15
Tropical Storm,Ophelia,43,2005-09-16T21:00:00Z,CAPE RACE NFLD,0,0,2,7,9
Tropical Storm,Ophelia,43,2005-09-16T21:00:00Z,BAR HARBOR ME,4,11,0,0,15
Tropical Storm,Ophelia,43,2005-09-16T21:00:00Z,HIBERNIA OILFLD,0,0,0,7,7
Tropical Storm,Ophelia,44,2005-09-17T03:00:00Z,43.5N  65.5W,19,5,0,0,24
Tropical Storm,Ophelia,44,2005-09-17T03:00:00Z,MONCTON NB,5,14,0,1,20
Tropical Storm,Ophelia,44,2005-09-17T03:00:00Z,46.5N  60.0W,0,13,3,0,16
Tropical Storm,Ophelia,44,2005-09-17T03:00:00Z,YARMOUTH NS,20,4,0,0,24
Tropical Storm,Ophelia,44,2005-09-17T03:00:00Z,48.7N  53.8W,0,0,9,2,11
Tropical Storm,Ophelia,44,2005-09-17T03:00:00Z,HALIFAX NS,5,16,0,0,21
Tropical Storm,Ophelia,44,2005-09-17T03:00:00Z,MONTAUK POINT NY,10,0,0,0,10
Tropical Storm,Ophelia,44,2005-09-17T03:00:00Z,SABLE ISLAND NS,0,12,2,0,14
Tropical Storm,Ophelia,44,2005-09-17T03:00:00Z,PROVIDENCE RI,11,0,0,0,11
Tropical Storm,Ophelia,44,2005-09-17T03:00:00Z,SYDNEY NS,0,13,3,0,16
Tropical Storm,Ophelia,44,2005-09-17T03:00:00Z,NANTUCKET MA,38,0,0,0,38
Tropical Storm,Ophelia,44,2005-09-17T03:00:00Z,EDDY POINT NS,0,16,2,0,18
Tropical Storm,Ophelia,44,2005-09-17T03:00:00Z,HYANNIS MA,29,0,0,0,29
Tropical Storm,Ophelia,44,2005-09-17T03:00:00Z,PTX BASQUES NFLD,0,9,6,0,15
Tropical Storm,Ophelia,44,2005-09-17T03:00:00Z,BOSTON MA,10,0,0,0,10
Tropical Storm,Ophelia,44,2005-09-17T03:00:00Z,BURGEO NFLD,0,5,8,1,14
Tropical Storm,Ophelia,44,2005-09-17T03:00:00Z,PORTLAND ME,7,1,0,0,8
Tropical Storm,Ophelia,44,2005-09-17T03:00:00Z,ILE ST PIERRE,0,3,9,1,13
Tropical Storm,Ophelia,44,2005-09-17T03:00:00Z,BAR HARBOR ME,16,1,1,0,18
Tropical Storm,Ophelia,44,2005-09-17T03:00:00Z,CAPE RACE NFLD,0,0,8,2,10
Tropical Storm,Ophelia,44,2005-09-17T03:00:00Z,EASTPORT ME,16,4,0,0,20
Tropical Storm,Ophelia,44,2005-09-17T03:00:00Z,HIBERNIA OILFLD,0,0,2,6,8
Tropical Storm,Ophelia,44,2005-09-17T03:00:00Z,ST JOHN NB,12,9,0,0,21
Tropical Storm,Ophelia,45,2005-09-17T09:00:00Z,45.4N  62.4W,19,6,0,0,25
Tropical Storm,Ophelia,45,2005-09-17T09:00:00Z,MONCTON NB,21,2,0,0,23
Tropical Storm,Ophelia,45,2005-09-17T09:00:00Z,48.0N  56.3W,0,14,3,0,17
Tropical Storm,Ophelia,45,2005-09-17T09:00:00Z,YARMOUTH NS,37,0,0,0,37
Tropical Storm,Ophelia,45,2005-09-17T09:00:00Z,49.6N  49.7W,0,1,9,2,12
Tropical Storm,Ophelia,45,2005-09-17T09:00:00Z,HALIFAX NS,26,2,0,0,28
Tropical Storm,Ophelia,45,2005-09-17T09:00:00Z,MONTAUK POINT NY,4,0,0,0,4
Tropical Storm,Ophelia,45,2005-09-17T09:00:00Z,SABLE ISLAND NS,6,11,0,1,18
Tropical Storm,Ophelia,45,2005-09-17T09:00:00Z,PROVIDENCE RI,6,0,0,0,6
Tropical Storm,Ophelia,45,2005-09-17T09:00:00Z,SYDNEY NS,6,15,1,0,22
Tropical Storm,Ophelia,45,2005-09-17T09:00:00Z,NANTUCKET MA,53,0,0,0,53
Tropical Storm,Ophelia,45,2005-09-17T09:00:00Z,EDDY POINT NS,13,10,0,1,24
Tropical Storm,Ophelia,45,2005-09-17T09:00:00Z,HYANNIS MA,33,0,0,0,33
Tropical Storm,Ophelia,45,2005-09-17T09:00:00Z,PTX BASQUES NFLD,2,17,1,0,20
Tropical Storm,Ophelia,45,2005-09-17T09:00:00Z,BOSTON MA,5,0,0,0,5
Tropical Storm,Ophelia,45,2005-09-17T09:00:00Z,BURGEO NFLD,0,17,1,1,19
Tropical Storm,Ophelia,45,2005-09-17T09:00:00Z,PORTLAND ME,4,0,0,0,4
Tropical Storm,Ophelia,45,2005-09-17T09:00:00Z,ILE ST PIERRE,0,14,3,0,17
Tropical Storm,Ophelia,45,2005-09-17T09:00:00Z,BAR HARBOR ME,17,0,0,0,17
Tropical Storm,Ophelia,45,2005-09-17T09:00:00Z,CAPE RACE NFLD,0,5,8,0,13
Tropical Storm,Ophelia,45,2005-09-17T09:00:00Z,EASTPORT ME,24,0,0,0,24
Tropical Storm,Ophelia,45,2005-09-17T09:00:00Z,HIBERNIA OILFLD,0,0,7,4,11
Tropical Storm,Ophelia,45,2005-09-17T09:00:00Z,ST JOHN NB,25,0,1,0,26
Tropical Storm,Ophelia,46,2005-09-17T15:00:00Z,46.4N  59.8W,22,7,0,0,29
Tropical Storm,Ophelia,46,2005-09-17T15:00:00Z,HALIFAX NS,44,0,0,0,44
Tropical Storm,Ophelia,46,2005-09-17T15:00:00Z,48.8N  53.8W,0,14,4,0,18
Tropical Storm,Ophelia,46,2005-09-17T15:00:00Z,SABLE ISLAND NS,21,2,1,0,24
Tropical Storm,Ophelia,46,2005-09-17T15:00:00Z,50.5N  47.0W,0,1,9,3,13
Tropical Storm,Ophelia,46,2005-09-17T15:00:00Z,SYDNEY NS,25,5,0,0,30
Tropical Storm,Ophelia,46,2005-09-17T15:00:00Z,NANTUCKET MA,22,0,0,0,22
Tropical Storm,Ophelia,46,2005-09-17T15:00:00Z,EDDY POINT NS,33,1,0,0,34
Tropical Storm,Ophelia,46,2005-09-17T15:00:00Z,HYANNIS MA,7,0,0,0,7
Tropical Storm,Ophelia,46,2005-09-17T15:00:00Z,PTX BASQUES NFLD,12,13,0,0,25
Tropical Storm,Ophelia,46,2005-09-17T15:00:00Z,BAR HARBOR ME,6,0,0,0,6
Tropical Storm,Ophelia,46,2005-09-17T15:00:00Z,BURGEO NFLD,5,18,0,1,24
Tropical Storm,Ophelia,46,2005-09-17T15:00:00Z,EASTPORT ME,17,0,0,0,17
Tropical Storm,Ophelia,46,2005-09-17T15:00:00Z,ILE ST PIERRE,2,19,0,0,21
Tropical Storm,Ophelia,46,2005-09-17T15:00:00Z,ST JOHN NB,26,0,0,0,26
Tropical Storm,Ophelia,46,2005-09-17T15:00:00Z,CAPE RACE NFLD,0,12,4,0,16
Tropical Storm,Ophelia,46,2005-09-17T15:00:00Z,MONCTON NB,26,0,0,0,26
Tropical Storm,Ophelia,46,2005-09-17T15:00:00Z,HIBERNIA OILFLD,0,1,9,2,12
Tropical Storm,Ophelia,46,2005-09-17T15:00:00Z,YARMOUTH NS,51,0,0,0,51
Tropical Storm,Ophelia,47,2005-09-17T21:00:00Z,47.7N  56.5W,22,6,1,0,29
Tropical Storm,Ophelia,47,2005-09-17T21:00:00Z,SABLE ISLAND NS,28,0,0,0,28
Tropical Storm,Ophelia,47,2005-09-17T21:00:00Z,49.8N  50.4W,0,14,4,1,19
Tropical Storm,Ophelia,47,2005-09-17T21:00:00Z,SYDNEY NS,42,0,0,0,42
Tropical Storm,Ophelia,47,2005-09-17T21:00:00Z,51.4N  43.2W,0,0,10,3,13
Tropical Storm,Ophelia,47,2005-09-17T21:00:00Z,EDDY POINT NS,48,0,1,0,49
Tropical Storm,Ophelia,47,2005-09-17T21:00:00Z,EASTPORT ME,3,0,0,0,3
Tropical Storm,Ophelia,47,2005-09-17T21:00:00Z,PTX BASQUES NFLD,32,0,1,0,33
Tropical Storm,Ophelia,47,2005-09-17T21:00:00Z,ST JOHN NB,10,0,0,0,10
Tropical Storm,Ophelia,47,2005-09-17T21:00:00Z,BURGEO NFLD,28,3,0,0,31
Tropical Storm,Ophelia,47,2005-09-17T21:00:00Z,MONCTON NB,15,0,0,0,15
Tropical Storm,Ophelia,47,2005-09-17T21:00:00Z,ILE ST PIERRE,21,6,0,1,28
Tropical Storm,Ophelia,47,2005-09-17T21:00:00Z,YARMOUTH NS,46,0,0,0,46
Tropical Storm,Ophelia,47,2005-09-17T21:00:00Z,CAPE RACE NFLD,3,15,1,0,19
Tropical Storm,Ophelia,47,2005-09-17T21:00:00Z,HALIFAX NS,60,0,0,0,60
Tropical Storm,Ophelia,47,2005-09-17T21:00:00Z,HIBERNIA OILFLD,0,6,7,1,14
Tropical Storm,Ophelia,48,2005-09-18T03:00:00Z,48.8N  53.4W,22,6,1,0,29
Tropical Storm,Ophelia,48,2005-09-18T03:00:00Z,SYDNEY NS,57,0,0,0,57
Tropical Storm,Ophelia,48,2005-09-18T03:00:00Z,50.6N  47.0W,0,14,4,0,18
Tropical Storm,Ophelia,48,2005-09-18T03:00:00Z,EDDY POINT NS,68,0,0,0,68
Tropical Storm,Ophelia,48,2005-09-18T03:00:00Z,52.2N  40.5W,0,1,9,3,13
Tropical Storm,Ophelia,48,2005-09-18T03:00:00Z,PTX BASQUES NFLD,40,0,0,0,40
Tropical Storm,Ophelia,48,2005-09-18T03:00:00Z,MONCTON NB,2,0,0,0,2
Tropical Storm,Ophelia,48,2005-09-18T03:00:00Z,BURGEO NFLD,42,0,0,0,42
Tropical Storm,Ophelia,48,2005-09-18T03:00:00Z,YARMOUTH NS,99,0,0,0,99
Tropical Storm,Ophelia,48,2005-09-18T03:00:00Z,ILE ST PIERRE,38,0,0,0,38
Tropical Storm,Ophelia,48,2005-09-18T03:00:00Z,HALIFAX NS,99,0,0,0,99
Tropical Storm,Ophelia,48,2005-09-18T03:00:00Z,CAPE RACE NFLD,17,6,0,0,23
Tropical Storm,Ophelia,48,2005-09-18T03:00:00Z,SABLE ISLAND NS,29,0,0,0,29
Tropical Storm,Ophelia,48,2005-09-18T03:00:00Z,HIBERNIA OILFLD,0,13,2,0,15
Tropical Depression,Seventeen,1,2005-09-17T15:00:00Z,14.9N  56.9W,50,0,0,0,50
Tropical Depression,Seventeen,1,2005-09-17T15:00:00Z,TKPK 173N 627W,0,0,7,8,15
Tropical Depression,Seventeen,1,2005-09-17T15:00:00Z,16.1N  57.9W,21,10,0,0,31
Tropical Depression,Seventeen,1,2005-09-17T15:00:00Z,TNCM 181N 631W,0,0,5,10,15
Tropical Depression,Seventeen,1,2005-09-17T15:00:00Z,17.3N  58.9W,1,19,4,2,26
Tropical Depression,Seventeen,1,2005-09-17T15:00:00Z,TISX 177N 648W,0,0,1,7,8
Tropical Depression,Seventeen,1,2005-09-17T15:00:00Z,TBPB 131N 595W,4,7,1,0,12
Tropical Depression,Seventeen,1,2005-09-17T15:00:00Z,TIST 183N 650W,0,0,0,8,8
Tropical Depression,Seventeen,1,2005-09-17T15:00:00Z,TVSV 131N 612W,0,2,2,2,6
Tropical Depression,Seventeen,1,2005-09-17T15:00:00Z,TJPS 180N 666W,0,0,0,3,3
Tropical Depression,Seventeen,1,2005-09-17T15:00:00Z,TLPL 138N 610W,0,4,4,2,10
Tropical Depression,Seventeen,1,2005-09-17T15:00:00Z,TJSJ 184N 661W,0,0,0,5,5
Tropical Depression,Seventeen,1,2005-09-17T15:00:00Z,TFFF 146N 610W,0,7,4,2,13
Tropical Depression,Seventeen,1,2005-09-17T15:00:00Z,ST CROIX VI,0,0,1,7,8
Tropical Depression,Seventeen,1,2005-09-17T15:00:00Z,TDPR 153N 614W,0,5,6,4,15
Tropical Depression,Seventeen,1,2005-09-17T15:00:00Z,ST THOMAS VI,0,0,0,8,8
Tropical Depression,Seventeen,1,2005-09-17T15:00:00Z,80400 157N 636W,0,0,2,6,8
Tropical Depression,Seventeen,1,2005-09-17T15:00:00Z,SAN JUAN PR,0,0,0,5,5
Tropical Depression,Seventeen,1,2005-09-17T15:00:00Z,TFFR 163N 615W,0,4,9,4,17
Tropical Depression,Seventeen,1,2005-09-17T15:00:00Z,PONCE PR,0,0,0,3,3
Tropical Depression,Seventeen,1,2005-09-17T15:00:00Z,TAPA 171N 618W,0,2,10,6,18
Tropical Depression,Seventeen,2,2005-09-17T21:00:00Z,15.6N  57.1W,55,0,0,0,55
Tropical Depression,Seventeen,2,2005-09-17T21:00:00Z,TAPA 171N 618W,0,3,11,5,19
Tropical Depression,Seventeen,2,2005-09-17T21:00:00Z,16.6N  58.1W,30,5,0,0,35
Tropical Depression,Seventeen,2,2005-09-17T21:00:00Z,TKPK 173N 627W,0,1,8,7,16
Tropical Depression,Seventeen,2,2005-09-17T21:00:00Z,17.6N  59.1W,6,19,2,1,28
Tropical Depression,Seventeen,2,2005-09-17T21:00:00Z,TNCM 181N 631W,0,0,6,10,16
Tropical Depression,Seventeen,2,2005-09-17T21:00:00Z,TGPY 120N 618W,0,0,0,2,2
Tropical Depression,Seventeen,2,2005-09-17T21:00:00Z,TISX 177N 648W,0,0,1,9,10
Tropical Depression,Seventeen,2,2005-09-17T21:00:00Z,TBPB 131N 595W,1,6,1,2,10
Tropical Depression,Seventeen,2,2005-09-17T21:00:00Z,TIST 183N 650W,0,0,1,9,10
Tropical Depression,Seventeen,2,2005-09-17T21:00:00Z,TVSV 131N 612W,0,1,2,3,6
Tropical Depression,Seventeen,2,2005-09-17T21:00:00Z,TJPS 180N 666W,0,0,0,5,5
Tropical Depression,Seventeen,2,2005-09-17T21:00:00Z,TLPL 138N 610W,0,3,4,3,10
Tropical Depression,Seventeen,2,2005-09-17T21:00:00Z,TJSJ 184N 661W,0,0,0,6,6
Tropical Depression,Seventeen,2,2005-09-17T21:00:00Z,TFFF 146N 610W,0,5,5,3,13
Tropical Depression,Seventeen,2,2005-09-17T21:00:00Z,ST CROIX VI,0,0,1,9,10
Tropical Depression,Seventeen,2,2005-09-17T21:00:00Z,TDPR 153N 614W,0,5,7,3,15
Tropical Depression,Seventeen,2,2005-09-17T21:00:00Z,ST THOMAS VI,0,0,1,9,10
Tropical Depression,Seventeen,2,2005-09-17T21:00:00Z,80400 157N 636W,0,0,2,7,9
Tropical Depression,Seventeen,2,2005-09-17T21:00:00Z,SAN JUAN PR,0,0,0,6,6
Tropical Depression,Seventeen,2,2005-09-17T21:00:00Z,TFFR 163N 615W,0,5,9,4,18
Tropical Depression,Seventeen,2,2005-09-17T21:00:00Z,PONCE PR,0,0,0,5,5
Tropical Storm,Philippe,3,2005-09-18T03:00:00Z,15.8N  56.4W,43,0,0,0,43
Tropical Storm,Philippe,3,2005-09-18T03:00:00Z,TKPK 173N 627W,0,1,4,6,11
Tropical Storm,Philippe,3,2005-09-18T03:00:00Z,17.0N  57.3W,21,4,1,0,26
Tropical Storm,Philippe,3,2005-09-18T03:00:00Z,TNCM 181N 631W,0,0,4,7,11
Tropical Storm,Philippe,3,2005-09-18T03:00:00Z,18.1N  58.3W,3,14,3,2,22
Tropical Storm,Philippe,3,2005-09-18T03:00:00Z,TISX 177N 648W,0,0,1,5,6
Tropical Storm,Philippe,3,2005-09-18T03:00:00Z,TBPB 131N 595W,1,3,2,1,7
Tropical Storm,Philippe,3,2005-09-18T03:00:00Z,TIST 183N 650W,0,0,1,5,6
Tropical Storm,Philippe,3,2005-09-18T03:00:00Z,TVSV 131N 612W,0,1,1,2,4
Tropical Storm,Philippe,3,2005-09-18T03:00:00Z,TJPS 180N 666W,0,0,0,2,2
Tropical Storm,Philippe,3,2005-09-18T03:00:00Z,TLPL 138N 610W,0,2,2,2,6
Tropical Storm,Philippe,3,2005-09-18T03:00:00Z,TJSJ 184N 661W,0,0,0,4,4
Tropical Storm,Philippe,3,2005-09-18T03:00:00Z,TFFF 146N 610W,0,3,3,3,9
Tropical Storm,Philippe,3,2005-09-18T03:00:00Z,ST CROIX VI,0,0,1,5,6
Tropical Storm,Philippe,3,2005-09-18T03:00:00Z,TDPR 153N 614W,0,3,3,4,10
Tropical Storm,Philippe,3,2005-09-18T03:00:00Z,ST THOMAS VI,0,0,1,5,6
Tropical Storm,Philippe,3,2005-09-18T03:00:00Z,80400 157N 636W,0,0,2,4,6
Tropical Storm,Philippe,3,2005-09-18T03:00:00Z,SAN JUAN PR,0,0,0,4,4
Tropical Storm,Philippe,3,2005-09-18T03:00:00Z,TFFR 163N 615W,0,3,5,4,12
Tropical Storm,Philippe,3,2005-09-18T03:00:00Z,PONCE PR,0,0,0,2,2
Tropical Storm,Philippe,3,2005-09-18T03:00:00Z,TAPA 171N 618W,0,2,6,5,13
Tropical Storm,Philippe,4,2005-09-18T09:00:00Z,16.4N  56.9W,45,0,0,0,45
Tropical Storm,Philippe,4,2005-09-18T09:00:00Z,TKPK 173N 627W,0,1,5,5,11
Tropical Storm,Philippe,4,2005-09-18T09:00:00Z,17.5N  57.8W,23,4,1,0,28
Tropical Storm,Philippe,4,2005-09-18T09:00:00Z,TNCM 181N 631W,0,1,4,7,12
Tropical Storm,Philippe,4,2005-09-18T09:00:00Z,18.7N  58.7W,3,15,2,2,22
Tropical Storm,Philippe,4,2005-09-18T09:00:00Z,TISX 177N 648W,0,0,1,5,6
Tropical Storm,Philippe,4,2005-09-18T09:00:00Z,TBPB 131N 595W,0,2,1,1,4
Tropical Storm,Philippe,4,2005-09-18T09:00:00Z,TIST 183N 650W,0,0,1,6,7
Tropical Storm,Philippe,4,2005-09-18T09:00:00Z,TVSV 131N 612W,0,0,1,1,2
Tropical Storm,Philippe,4,2005-09-18T09:00:00Z,TJPS 180N 666W,0,0,0,3,3
Tropical Storm,Philippe,4,2005-09-18T09:00:00Z,TLPL 138N 610W,0,1,2,1,4
Tropical Storm,Philippe,4,2005-09-18T09:00:00Z,TJSJ 184N 661W,0,0,0,4,4
Tropical Storm,Philippe,4,2005-09-18T09:00:00Z,TFFF 146N 610W,0,3,2,3,8
Tropical Storm,Philippe,4,2005-09-18T09:00:00Z,ST CROIX VI,0,0,1,5,6
Tropical Storm,Philippe,4,2005-09-18T09:00:00Z,TDPR 153N 614W,0,3,3,3,9
Tropical Storm,Philippe,4,2005-09-18T09:00:00Z,ST THOMAS VI,0,0,1,6,7
Tropical Storm,Philippe,4,2005-09-18T09:00:00Z,80400 157N 636W,0,0,2,3,5
Tropical Storm,Philippe,4,2005-09-18T09:00:00Z,SAN JUAN PR,0,0,0,4,4
Tropical Storm,Philippe,4,2005-09-18T09:00:00Z,TFFR 163N 615W,0,4,5,3,12
Tropical Storm,Philippe,4,2005-09-18T09:00:00Z,PONCE PR,0,0,0,3,3
Tropical Storm,Philippe,4,2005-09-18T09:00:00Z,TAPA 171N 618W,0,3,6,4,13
Tropical Storm,Philippe,5,2005-09-18T15:00:00Z,17.1N  57.0W,38,0,1,0,39
Tropical Storm,Philippe,5,2005-09-18T15:00:00Z,TKPK 173N 627W,0,3,4,3,10
Tropical Storm,Philippe,5,2005-09-18T15:00:00Z,18.2N  58.0W,19,4,1,1,25
Tropical Storm,Philippe,5,2005-09-18T15:00:00Z,TNCM 181N 631W,0,2,5,4,11
Tropical Storm,Philippe,5,2005-09-18T15:00:00Z,19.4N  58.8W,4,12,3,2,21
Tropical Storm,Philippe,5,2005-09-18T15:00:00Z,TISX 177N 648W,0,0,2,3,5
Tropical Storm,Philippe,5,2005-09-18T15:00:00Z,TBPB 131N 595W,0,1,0,1,2
Tropical Storm,Philippe,5,2005-09-18T15:00:00Z,TIST 183N 650W,0,0,2,4,6
Tropical Storm,Philippe,5,2005-09-18T15:00:00Z,TLPL 138N 610W,0,1,1,1,3
Tropical Storm,Philippe,5,2005-09-18T15:00:00Z,TJPS 180N 666W,0,0,0,2,2
Tropical Storm,Philippe,5,2005-09-18T15:00:00Z,TFFF 146N 610W,0,2,2,2,6
Tropical Storm,Philippe,5,2005-09-18T15:00:00Z,TJSJ 184N 661W,0,0,1,2,3
Tropical Storm,Philippe,5,2005-09-18T15:00:00Z,TDPR 153N 614W,0,3,2,3,8
Tropical Storm,Philippe,5,2005-09-18T15:00:00Z,ST CROIX VI,0,0,2,3,5
Tropical Storm,Philippe,5,2005-09-18T15:00:00Z,80400 157N 636W,0,0,2,2,4
Tropical Storm,Philippe,5,2005-09-18T15:00:00Z,ST THOMAS VI,0,0,2,4,6
Tropical Storm,Philippe,5,2005-09-18T15:00:00Z,TFFR 163N 615W,0,6,2,3,11
Tropical Storm,Philippe,5,2005-09-18T15:00:00Z,SAN JUAN PR,0,0,1,2,3
Tropical Storm,Philippe,5,2005-09-18T15:00:00Z,TAPA 171N 618W,0,6,4,3,13
Tropical Storm,Philippe,5,2005-09-18T15:00:00Z,PONCE PR,0,0,0,2,2
Tropical Storm,Philippe,6,2005-09-18T21:00:00Z,17.8N  57.3W,38,0,0,0,38
Tropical Storm,Philippe,6,2005-09-18T21:00:00Z,TKPK 173N 627W,0,2,2,3,7
Tropical Storm,Philippe,6,2005-09-18T21:00:00Z,18.9N  58.2W,21,3,1,1,26
Tropical Storm,Philippe,6,2005-09-18T21:00:00Z,TNCM 181N 631W,0,1,3,3,7
Tropical Storm,Philippe,6,2005-09-18T21:00:00Z,20.1N  58.7W,6,12,2,3,23
Tropical Storm,Philippe,6,2005-09-18T21:00:00Z,TISX 177N 648W,0,0,1,1,2
Tropical Storm,Philippe,6,2005-09-18T21:00:00Z,TFFF 146N 610W,0,1,1,1,3
Tropical Storm,Philippe,6,2005-09-18T21:00:00Z,TIST 183N 650W,0,0,1,1,2
Tropical Storm,Philippe,6,2005-09-18T21:00:00Z,TDPR 153N 614W,0,2,1,1,4
Tropical Storm,Philippe,6,2005-09-18T21:00:00Z,ST CROIX VI,0,0,1,1,2
Tropical Storm,Philippe,6,2005-09-18T21:00:00Z,TFFR 163N 615W,1,3,1,3,8
Tropical Storm,Philippe,6,2005-09-18T21:00:00Z,ST THOMAS VI,0,0,1,1,2
Tropical Storm,Philippe,6,2005-09-18T21:00:00Z,TAPA 171N 618W,0,4,3,2,9
Hurricane,Philippe,7,2005-09-19T03:00:00Z,18.6N  57.5W,37,0,1,0,38
Hurricane,Philippe,7,2005-09-19T03:00:00Z,TAPA 171N 618W,0,3,3,2,8
Hurricane,Philippe,7,2005-09-19T03:00:00Z,19.6N  58.3W,22,3,0,1,26
Hurricane,Philippe,7,2005-09-19T03:00:00Z,TKPK 173N 627W,0,2,1,4,7
Hurricane,Philippe,7,2005-09-19T03:00:00Z,20.8N  58.8W,7,11,2,2,22
Hurricane,Philippe,7,2005-09-19T03:00:00Z,TNCM 181N 631W,0,2,2,4,8
Hurricane,Philippe,7,2005-09-19T03:00:00Z,TFFF 146N 610W,0,0,1,1,2
Hurricane,Philippe,7,2005-09-19T03:00:00Z,TISX 177N 648W,0,0,1,2,3
Hurricane,Philippe,7,2005-09-19T03:00:00Z,TDPR 153N 614W,0,1,0,2,3
Hurricane,Philippe,7,2005-09-19T03:00:00Z,TIST 183N 650W,0,0,1,2,3
Hurricane,Philippe,7,2005-09-19T03:00:00Z,80400 157N 636W,0,0,0,2,2
Hurricane,Philippe,7,2005-09-19T03:00:00Z,ST CROIX VI,0,0,1,2,3
Hurricane,Philippe,7,2005-09-19T03:00:00Z,TFFR 163N 615W,0,2,2,2,6
Hurricane,Philippe,7,2005-09-19T03:00:00Z,ST THOMAS VI,0,0,1,2,3
Hurricane,Philippe,8,2005-09-19T09:00:00Z,18.9N  57.2W,42,0,0,0,42
Hurricane,Philippe,8,2005-09-19T09:00:00Z,TKPK 173N 627W,0,1,1,3,5
Hurricane,Philippe,8,2005-09-19T09:00:00Z,19.9N  57.9W,23,2,1,1,27
Hurricane,Philippe,8,2005-09-19T09:00:00Z,TNCM 181N 631W,0,1,2,3,6
Hurricane,Philippe,8,2005-09-19T09:00:00Z,21.0N  58.4W,9,9,3,2,23
Hurricane,Philippe,8,2005-09-19T09:00:00Z,TISX 177N 648W,0,0,0,2,2
Hurricane,Philippe,8,2005-09-19T09:00:00Z,TFFF 146N 610W,0,0,1,1,2
Hurricane,Philippe,8,2005-09-19T09:00:00Z,TIST 183N 650W,0,0,0,2,2
Hurricane,Philippe,8,2005-09-19T09:00:00Z,TDPR 153N 614W,0,0,1,2,3
Hurricane,Philippe,8,2005-09-19T09:00:00Z,ST CROIX VI,0,0,0,2,2
Hurricane,Philippe,8,2005-09-19T09:00:00Z,TFFR 163N 615W,0,2,1,2,5
Hurricane,Philippe,8,2005-09-19T09:00:00Z,ST THOMAS VI,0,0,0,2,2
Hurricane,Philippe,8,2005-09-19T09:00:00Z,TAPA 171N 618W,0,2,2,3,7
Hurricane,Philippe,9,2005-09-19T15:00:00Z,19.2N  57.4W,37,0,0,0,37
Hurricane,Philippe,9,2005-09-19T15:00:00Z,TAPA 171N 618W,0,2,1,2,5
Hurricane,Philippe,9,2005-09-19T15:00:00Z,20.2N  58.0W,22,2,1,1,26
Hurricane,Philippe,9,2005-09-19T15:00:00Z,TKPK 173N 627W,0,1,1,1,3
Hurricane,Philippe,9,2005-09-19T15:00:00Z,21.7N  58.7W,5,11,3,2,21
Hurricane,Philippe,9,2005-09-19T15:00:00Z,TNCM 181N 631W,0,1,1,2,4
Hurricane,Philippe,9,2005-09-19T15:00:00Z,TFFR 163N 615W,0,1,1,1,3
Hurricane,Philippe,10,2005-09-19T21:00:00Z,19.9N  57.2W,43,0,0,0,43
Hurricane,Philippe,10,2005-09-19T21:00:00Z,23.7N  58.5W,1,13,5,2,21
Hurricane,Philippe,10,2005-09-19T21:00:00Z,21.8N  57.8W,15,10,1,0,26
Hurricane,Philippe,10,2005-09-19T21:00:00Z,BERMUDA,0,0,0,4,4
Hurricane,Philippe,11,2005-09-20T03:00:00Z,20.5N  57.5W,44,0,0,0,44
Hurricane,Philippe,11,2005-09-20T03:00:00Z,24.2N  58.5W,1,14,4,2,21
Hurricane,Philippe,11,2005-09-20T03:00:00Z,22.3N  58.0W,16,8,1,1,26
Hurricane,Philippe,11,2005-09-20T03:00:00Z,BERMUDA,0,0,0,5,5
Hurricane,Philippe,12,2005-09-20T09:00:00Z,21.3N  57.6W,37,0,0,0,37
Hurricane,Philippe,12,2005-09-20T09:00:00Z,25.0N  58.6W,0,13,5,3,21
Hurricane,Philippe,12,2005-09-20T09:00:00Z,23.0N  58.1W,13,10,1,1,25
Hurricane,Philippe,12,2005-09-20T09:00:00Z,BERMUDA,0,0,0,6,6
Hurricane,Philippe,13,2005-09-20T15:00:00Z,20.7N  57.8W,34,0,0,0,34
Hurricane,Philippe,13,2005-09-20T15:00:00Z,25.0N  59.0W,0,13,6,2,21
Hurricane,Philippe,13,2005-09-20T15:00:00Z,22.9N  58.4W,9,14,1,1,25
Hurricane,Philippe,13,2005-09-20T15:00:00Z,BERMUDA,0,0,0,7,7
Tropical Storm,Philippe,14,2005-09-20T21:00:00Z,21.8N  58.3W,34,0,0,0,34
Tropical Storm,Philippe,14,2005-09-20T21:00:00Z,26.5N  59.7W,0,10,9,2,21
Tropical Storm,Philippe,14,2005-09-20T21:00:00Z,24.0N  59.0W,7,16,1,1,25
Tropical Storm,Philippe,14,2005-09-20T21:00:00Z,BERMUDA,0,0,1,10,11
Tropical Storm,Philippe,15,2005-09-21T03:00:00Z,22.9N  58.1W,32,0,0,0,32
Tropical Storm,Philippe,15,2005-09-21T03:00:00Z,27.5N  59.5W,0,8,9,3,20
Tropical Storm,Philippe,15,2005-09-21T03:00:00Z,25.2N  58.9W,3,19,1,1,24
Tropical Storm,Philippe,15,2005-09-21T03:00:00Z,BERMUDA,0,0,0,8,8
Tropical Storm,Philippe,16,2005-09-21T09:00:00Z,23.3N  58.2W,28,4,0,0,32
Tropical Storm,Philippe,16,2005-09-21T09:00:00Z,28.2N  59.6W,0,7,13,2,22
Tropical Storm,Philippe,16,2005-09-21T09:00:00Z,25.7N  59.0W,1,23,2,0,26
Tropical Storm,Philippe,16,2005-09-21T09:00:00Z,BERMUDA,0,0,0,7,7
Tropical Storm,Philippe,17,2005-09-21T15:00:00Z,23.8N  58.0W,41,0,0,0,41
Tropical Storm,Philippe,17,2005-09-21T15:00:00Z,28.5N  59.0W,0,12,8,2,22
Tropical Storm,Philippe,17,2005-09-21T15:00:00Z,26.0N  58.6W,10,17,0,0,27
Tropical Storm,Philippe,17,2005-09-21T15:00:00Z,BERMUDA,0,0,1,6,7
Tropical Storm,Philippe,18,2005-09-21T21:00:00Z,25.3N  57.9W,39,0,0,0,39
Tropical Storm,Philippe,18,2005-09-21T21:00:00Z,30.5N  59.0W,0,12,9,1,22
Tropical Storm,Philippe,18,2005-09-21T21:00:00Z,27.8N  58.4W,11,15,1,0,27
Tropical Storm,Philippe,18,2005-09-21T21:00:00Z,BERMUDA,0,0,3,4,7
Tropical Storm,Philippe,19,2005-09-22T03:00:00Z,26.6N  58.0W,41,1,0,0,42
Tropical Storm,Philippe,19,2005-09-22T03:00:00Z,31.7N  59.3W,0,13,6,2,21
Tropical Storm,Philippe,19,2005-09-22T03:00:00Z,29.2N  58.8W,10,16,1,0,27
Tropical Storm,Philippe,19,2005-09-22T03:00:00Z,BERMUDA,0,0,4,4,8
Tropical Storm,Philippe,20,2005-09-22T09:00:00Z,28.1N  59.0W,44,0,0,0,44
Tropical Storm,Philippe,20,2005-09-22T09:00:00Z,32.5N  59.0W,0,12,6,2,20
Tropical Storm,Philippe,20,2005-09-22T09:00:00Z,30.5N  60.0W,8,20,0,0,28
Tropical Storm,Philippe,20,2005-09-22T09:00:00Z,BERMUDA,0,2,5,1,8
Tropical Storm,Philippe,21,2005-09-22T15:00:00Z,30.6N  58.7W,35,0,0,1,36
Tropical Storm,Philippe,21,2005-09-22T15:00:00Z,BERMUDA,0,1,2,0,3
Tropical Storm,Philippe,21,2005-09-22T15:00:00Z,32.6N  58.8W,13,9,1,0,23
Tropical Storm,Philippe,21,2005-09-22T15:00:00Z,SABLE ISLAND NS,0,0,0,2,2
Tropical Storm,Philippe,21,2005-09-22T15:00:00Z,34.5N  57.0W,0,10,6,2,18
Tropical Storm,Philippe,22,2005-09-22T21:00:00Z,31.3N  60.2W,41,1,0,0,42
Tropical Storm,Philippe,22,2005-09-22T21:00:00Z,35.0N  58.0W,0,4,12,0,16
Tropical Storm,Philippe,22,2005-09-22T21:00:00Z,32.8N  60.2W,21,5,0,0,26
Tropical Storm,Philippe,22,2005-09-22T21:00:00Z,BERMUDA,0,3,2,0,5
Tropical Storm,Philippe,23,2005-09-23T03:00:00Z,33.0N  59.8W,37,0,0,0,37
Tropical Storm,Philippe,23,2005-09-23T03:00:00Z,36.5N  55.5W,0,7,9,0,16
Tropical Storm,Philippe,23,2005-09-23T03:00:00Z,35.3N  58.2W,7,17,1,0,25
Tropical Storm,Philippe,24,2005-09-23T09:00:00Z,33.7N  61.2W,39,0,0,0,39
Tropical Storm,Philippe,24,2005-09-23T09:00:00Z,37.4N  54.6W,0,0,13,0,13
Tropical Storm,Philippe,24,2005-09-23T09:00:00Z,35.1N  59.3W,6,14,5,0,25
Tropical Storm,Philippe,24,2005-09-23T09:00:00Z,BERMUDA,8,3,0,0,11
Tropical Depression,Eighteen,1,2005-09-18T03:00:00Z,23.1N  73.6W,44,0,0,0,44
Tropical Depression,Eighteen,1,2005-09-18T03:00:00Z,FT PIERCE FL,0,0,8,10,18
Tropical Depression,Eighteen,1,2005-09-18T03:00:00Z,23.6N  75.5W,19,12,0,0,31
Tropical Depression,Eighteen,1,2005-09-18T03:00:00Z,COCOA BEACH FL,0,0,4,12,16
Tropical Depression,Eighteen,1,2005-09-18T03:00:00Z,24.0N  77.7W,0,17,7,2,26
Tropical Depression,Eighteen,1,2005-09-18T03:00:00Z,DAYTONA BEACH FL,0,0,1,11,12
Tropical Depression,Eighteen,1,2005-09-18T03:00:00Z,MKJS 185N 779W,0,0,0,2,2
Tropical Depression,Eighteen,1,2005-09-18T03:00:00Z,JACKSONVILLE FL,0,0,0,8,8
Tropical Depression,Eighteen,1,2005-09-18T03:00:00Z,MWCG 193N 814W,0,0,0,3,3
Tropical Depression,Eighteen,1,2005-09-18T03:00:00Z,SAVANNAH GA,0,0,0,3,3
Tropical Depression,Eighteen,1,2005-09-18T03:00:00Z,MUGM 200N 751W,1,0,1,2,4
Tropical Depression,Eighteen,1,2005-09-18T03:00:00Z,KEY WEST FL,0,0,5,13,18
Tropical Depression,Eighteen,1,2005-09-18T03:00:00Z,MUCM 214N 779W,0,4,5,4,13
Tropical Depression,Eighteen,1,2005-09-18T03:00:00Z,MARCO ISLAND FL,0,0,6,13,19
Tropical Depression,Eighteen,1,2005-09-18T03:00:00Z,MUCF 221N 805W,0,0,5,9,14
Tropical Depression,Eighteen,1,2005-09-18T03:00:00Z,FT MYERS FL,0,0,4,14,18
Tropical Depression,Eighteen,1,2005-09-18T03:00:00Z,MUSN 216N 826W,0,0,0,9,9
Tropical Depression,Eighteen,1,2005-09-18T03:00:00Z,VENICE FL,0,0,2,15,17
Tropical Depression,Eighteen,1,2005-09-18T03:00:00Z,MUHA 230N 824W,0,0,1,12,13
Tropical Depression,Eighteen,1,2005-09-18T03:00:00Z,TAMPA FL,0,0,1,14,15
Tropical Depression,Eighteen,1,2005-09-18T03:00:00Z,MUAN 219N 850W,0,0,0,5,5
Tropical Depression,Eighteen,1,2005-09-18T03:00:00Z,CEDAR KEY FL,0,0,0,12,12
Tropical Depression,Eighteen,1,2005-09-18T03:00:00Z,MBJT 215N 712W,43,0,0,0,43
Tropical Depression,Eighteen,1,2005-09-18T03:00:00Z,ST MARKS FL,0,0,0,8,8
Tropical Depression,Eighteen,1,2005-09-18T03:00:00Z,MYMM 224N 730W,45,0,0,0,45
Tropical Depression,Eighteen,1,2005-09-18T03:00:00Z,APALACHICOLA FL,0,0,0,8,8
Tropical Depression,Eighteen,1,2005-09-18T03:00:00Z,MYSM 241N 745W,30,5,0,0,35
Tropical Depression,Eighteen,1,2005-09-18T03:00:00Z,PANAMA CITY FL,0,0,0,7,7
Tropical Depression,Eighteen,1,2005-09-18T03:00:00Z,MYEG 235N 758W,14,14,1,0,29
Tropical Depression,Eighteen,1,2005-09-18T03:00:00Z,PENSACOLA FL,0,0,0,4,4
Tropical Depression,Eighteen,1,2005-09-18T03:00:00Z,MYAK 241N 776W,0,18,7,1,26
Tropical Depression,Eighteen,1,2005-09-18T03:00:00Z,MOBILE AL,0,0,0,2,2
Tropical Depression,Eighteen,1,2005-09-18T03:00:00Z,MYNN 251N 775W,0,17,9,1,27
Tropical Depression,Eighteen,1,2005-09-18T03:00:00Z,GULFPORT MS,0,0,0,2,2
Tropical Depression,Eighteen,1,2005-09-18T03:00:00Z,MYGF 266N 787W,0,2,16,4,22
Tropical Depression,Eighteen,1,2005-09-18T03:00:00Z,GULF 29N 85W,0,0,0,10,10
Tropical Depression,Eighteen,1,2005-09-18T03:00:00Z,MARATHON FL,0,0,9,10,19
Tropical Depression,Eighteen,1,2005-09-18T03:00:00Z,GULF 29N 87W,0,0,0,6,6
Tropical Depression,Eighteen,1,2005-09-18T03:00:00Z,MIAMI FL,0,0,14,7,21
Tropical Depression,Eighteen,1,2005-09-18T03:00:00Z,GULF 28N 89W,0,0,0,2,2
Tropical Depression,Eighteen,1,2005-09-18T03:00:00Z,W PALM BEACH FL,0,0,12,8,20
Tropical Depression,Eighteen,2,2005-09-18T09:00:00Z,22.8N  75.3W,44,0,0,0,44
Tropical Depression,Eighteen,2,2005-09-18T09:00:00Z,COCOA BEACH FL,0,0,7,6,13
Tropical Depression,Eighteen,2,2005-09-18T09:00:00Z,23.4N  77.5W,12,19,0,1,32
Tropical Depression,Eighteen,2,2005-09-18T09:00:00Z,DAYTONA BEACH FL,0,0,2,7,9
Tropical Depression,Eighteen,2,2005-09-18T09:00:00Z,23.8N  80.0W,0,14,11,1,26
Tropical Depression,Eighteen,2,2005-09-18T09:00:00Z,JACKSONVILLE FL,0,0,0,5,5
Tropical Depression,Eighteen,2,2005-09-18T09:00:00Z,MWCG 193N 814W,0,0,1,4,5
Tropical Depression,Eighteen,2,2005-09-18T09:00:00Z,KEY WEST FL,0,1,17,5,23
Tropical Depression,Eighteen,2,2005-09-18T09:00:00Z,MUGM 200N 751W,3,1,0,0,4
Tropical Depression,Eighteen,2,2005-09-18T09:00:00Z,MARCO ISLAND FL,0,0,16,5,21
Tropical Depression,Eighteen,2,2005-09-18T09:00:00Z,MUCM 214N 779W,5,11,1,1,18
Tropical Depression,Eighteen,2,2005-09-18T09:00:00Z,FT MYERS FL,0,0,13,7,20
Tropical Depression,Eighteen,2,2005-09-18T09:00:00Z,MUCF 221N 805W,0,6,10,2,18
Tropical Depression,Eighteen,2,2005-09-18T09:00:00Z,VENICE FL,0,0,8,10,18
Tropical Depression,Eighteen,2,2005-09-18T09:00:00Z,MUSN 216N 826W,0,0,5,9,14
Tropical Depression,Eighteen,2,2005-09-18T09:00:00Z,TAMPA FL,0,0,4,11,15
Tropical Depression,Eighteen,2,2005-09-18T09:00:00Z,MUHA 230N 824W,0,0,12,7,19
Tropical Depression,Eighteen,2,2005-09-18T09:00:00Z,CEDAR KEY FL,0,0,1,10,11
Tropical Depression,Eighteen,2,2005-09-18T09:00:00Z,MUAN 219N 850W,0,0,1,10,11
Tropical Depression,Eighteen,2,2005-09-18T09:00:00Z,ST MARKS FL,0,0,0,7,7
Tropical Depression,Eighteen,2,2005-09-18T09:00:00Z,MMCZ 205N 869W,0,0,0,4,4
Tropical Depression,Eighteen,2,2005-09-18T09:00:00Z,APALACHICOLA FL,0,0,0,9,9
Tropical Depression,Eighteen,2,2005-09-18T09:00:00Z,MBJT 215N 712W,99,0,0,0,99
Tropical Depression,Eighteen,2,2005-09-18T09:00:00Z,PANAMA CITY FL,0,0,0,8,8
Tropical Depression,Eighteen,2,2005-09-18T09:00:00Z,MYMM 224N 730W,70,0,0,0,70
Tropical Depression,Eighteen,2,2005-09-18T09:00:00Z,PENSACOLA FL,0,0,0,5,5
Tropical Depression,Eighteen,2,2005-09-18T09:00:00Z,MYSM 241N 745W,37,1,0,0,38
Tropical Depression,Eighteen,2,2005-09-18T09:00:00Z,MOBILE AL,0,0,0,4,4
Tropical Depression,Eighteen,2,2005-09-18T09:00:00Z,MYEG 235N 758W,38,1,0,0,39
Tropical Depression,Eighteen,2,2005-09-18T09:00:00Z,GULFPORT MS,0,0,0,3,3
Tropical Depression,Eighteen,2,2005-09-18T09:00:00Z,MYAK 241N 776W,7,24,0,0,31
Tropical Depression,Eighteen,2,2005-09-18T09:00:00Z,BURAS LA,0,0,0,4,4
Tropical Depression,Eighteen,2,2005-09-18T09:00:00Z,MYNN 251N 775W,2,24,2,0,28
Tropical Depression,Eighteen,2,2005-09-18T09:00:00Z,NEW ORLEANS LA,0,0,0,3,3
Tropical Depression,Eighteen,2,2005-09-18T09:00:00Z,MYGF 266N 787W,0,8,11,1,20
Tropical Depression,Eighteen,2,2005-09-18T09:00:00Z,GULF 29N 85W,0,0,0,11,11
Tropical Depression,Eighteen,2,2005-09-18T09:00:00Z,MARATHON FL,0,3,19,2,24
Tropical Depression,Eighteen,2,2005-09-18T09:00:00Z,GULF 29N 87W,0,0,0,9,9
Tropical Depression,Eighteen,2,2005-09-18T09:00:00Z,MIAMI FL,0,4,18,2,24
Tropical Depression,Eighteen,2,2005-09-18T09:00:00Z,GULF 28N 89W,0,0,0,7,7
Tropical Depression,Eighteen,2,2005-09-18T09:00:00Z,W PALM BEACH FL,0,2,15,3,20
Tropical Depression,Eighteen,2,2005-09-18T09:00:00Z,GULF 28N 91W,0,0,0,3,3
Tropical Depression,Eighteen,2,2005-09-18T09:00:00Z,FT PIERCE FL,0,1,11,4,16
Tropical Depression,Eighteen,3,2005-09-18T15:00:00Z,23.2N  76.2W,43,0,0,0,43
Tropical Depression,Eighteen,3,2005-09-18T15:00:00Z,COCOA BEACH FL,0,0,8,4,12
Tropical Depression,Eighteen,3,2005-09-18T15:00:00Z,23.7N  78.3W,14,16,1,0,31
Tropical Depression,Eighteen,3,2005-09-18T15:00:00Z,DAYTONA BEACH FL,0,0,3,5,8
Tropical Depression,Eighteen,3,2005-09-18T15:00:00Z,23.8N  80.8W,0,14,11,1,26
Tropical Depression,Eighteen,3,2005-09-18T15:00:00Z,JACKSONVILLE FL,0,0,0,4,4
Tropical Depression,Eighteen,3,2005-09-18T15:00:00Z,MWCG 193N 814W,0,0,1,4,5
Tropical Depression,Eighteen,3,2005-09-18T15:00:00Z,KEY WEST FL,0,5,18,2,25
Tropical Depression,Eighteen,3,2005-09-18T15:00:00Z,MUCM 214N 779W,8,6,1,0,15
Tropical Depression,Eighteen,3,2005-09-18T15:00:00Z,MARCO ISLAND FL,0,3,17,3,23
Tropical Depression,Eighteen,3,2005-09-18T15:00:00Z,MUCF 221N 805W,0,8,8,2,18
Tropical Depression,Eighteen,3,2005-09-18T15:00:00Z,FT MYERS FL,0,1,16,4,21
Tropical Depression,Eighteen,3,2005-09-18T15:00:00Z,MUSN 216N 826W,0,0,7,7,14
Tropical Depression,Eighteen,3,2005-09-18T15:00:00Z,VENICE FL,0,0,12,7,19
Tropical Depression,Eighteen,3,2005-09-18T15:00:00Z,MUHA 230N 824W,0,2,13,5,20
Tropical Depression,Eighteen,3,2005-09-18T15:00:00Z,TAMPA FL,0,0,7,8,15
Tropical Depression,Eighteen,3,2005-09-18T15:00:00Z,MUAN 219N 850W,0,0,1,12,13
Tropical Depression,Eighteen,3,2005-09-18T15:00:00Z,CEDAR KEY FL,0,0,2,8,10
Tropical Depression,Eighteen,3,2005-09-18T15:00:00Z,MMCZ 205N 869W,0,0,0,6,6
Tropical Depression,Eighteen,3,2005-09-18T15:00:00Z,ST MARKS FL,0,0,0,7,7
Tropical Depression,Eighteen,3,2005-09-18T15:00:00Z,MBJT 215N 712W,99,0,0,0,99
Tropical Depression,Eighteen,3,2005-09-18T15:00:00Z,APALACHICOLA FL,0,0,0,9,9
Tropical Depression,Eighteen,3,2005-09-18T15:00:00Z,MYMM 224N 730W,99,0,0,0,99
Tropical Depression,Eighteen,3,2005-09-18T15:00:00Z,PANAMA CITY FL,0,0,0,8,8
Tropical Depression,Eighteen,3,2005-09-18T15:00:00Z,MYSM 241N 745W,45,0,0,0,45
Tropical Depression,Eighteen,3,2005-09-18T15:00:00Z,PENSACOLA FL,0,0,0,6,6
Tropical Depression,Eighteen,3,2005-09-18T15:00:00Z,MYEG 235N 758W,47,0,0,0,47
Tropical Depression,Eighteen,3,2005-09-18T15:00:00Z,MOBILE AL,0,0,0,5,5
Tropical Depression,Eighteen,3,2005-09-18T15:00:00Z,MYAK 241N 776W,23,11,0,0,34
Tropical Depression,Eighteen,3,2005-09-18T15:00:00Z,GULFPORT MS,0,0,0,5,5
Tropical Depression,Eighteen,3,2005-09-18T15:00:00Z,MYNN 251N 775W,10,18,1,0,29
Tropical Depression,Eighteen,3,2005-09-18T15:00:00Z,BURAS LA,0,0,0,6,6
Tropical Depression,Eighteen,3,2005-09-18T15:00:00Z,MYGF 266N 787W,0,13,7,0,20
Tropical Depression,Eighteen,3,2005-09-18T15:00:00Z,NEW ORLEANS LA,0,0,0,4,4
Tropical Depression,Eighteen,3,2005-09-18T15:00:00Z,MMMD 210N 897W,0,0,0,2,2
Tropical Depression,Eighteen,3,2005-09-18T15:00:00Z,NEW IBERIA LA,0,0,0,2,2
Tropical Depression,Eighteen,3,2005-09-18T15:00:00Z,MARATHON FL,0,11,14,1,26
Tropical Depression,Eighteen,3,2005-09-18T15:00:00Z,GULF 29N 85W,0,0,1,10,11
Tropical Depression,Eighteen,3,2005-09-18T15:00:00Z,MIAMI FL,0,12,12,1,25
Tropical Depression,Eighteen,3,2005-09-18T15:00:00Z,GULF 29N 87W,0,0,0,10,10
Tropical Depression,Eighteen,3,2005-09-18T15:00:00Z,W PALM BEACH FL,0,7,12,2,21
Tropical Depression,Eighteen,3,2005-09-18T15:00:00Z,GULF 28N 89W,0,0,0,9,9
Tropical Depression,Eighteen,3,2005-09-18T15:00:00Z,FT PIERCE FL,0,2,12,2,16
Tropical Depression,Eighteen,3,2005-09-18T15:00:00Z,GULF 28N 91W,0,0,0,5,5
Tropical Storm,Rita,4,2005-09-18T21:00:00Z,23.2N  77.3W,46,0,0,0,46
Tropical Storm,Rita,4,2005-09-18T21:00:00Z,KEY WEST FL,0,19,11,1,31
Tropical Storm,Rita,4,2005-09-18T21:00:00Z,23.5N  79.7W,11,22,0,0,33
Tropical Storm,Rita,4,2005-09-18T21:00:00Z,MARCO ISLAND FL,0,13,12,1,26
Tropical Storm,Rita,4,2005-09-18T21:00:00Z,23.5N  82.5W,0,11,15,1,27
Tropical Storm,Rita,4,2005-09-18T21:00:00Z,FT MYERS FL,0,7,14,1,22
Tropical Storm,Rita,4,2005-09-18T21:00:00Z,MWCG 193N 814W,0,0,1,5,6
Tropical Storm,Rita,4,2005-09-18T21:00:00Z,VENICE FL,0,2,14,2,18
Tropical Storm,Rita,4,2005-09-18T21:00:00Z,MUCM 214N 779W,19,2,1,0,22
Tropical Storm,Rita,4,2005-09-18T21:00:00Z,TAMPA FL,0,1,8,4,13
Tropical Storm,Rita,4,2005-09-18T21:00:00Z,MUCF 221N 805W,2,17,3,1,23
Tropical Storm,Rita,4,2005-09-18T21:00:00Z,CEDAR KEY FL,0,0,3,5,8
Tropical Storm,Rita,4,2005-09-18T21:00:00Z,MUSN 216N 826W,0,2,12,3,17
Tropical Storm,Rita,4,2005-09-18T21:00:00Z,ST MARKS FL,0,0,0,4,4
Tropical Storm,Rita,4,2005-09-18T21:00:00Z,MUHA 230N 824W,0,10,14,1,25
Tropical Storm,Rita,4,2005-09-18T21:00:00Z,APALACHICOLA FL,0,0,1,6,7
Tropical Storm,Rita,4,2005-09-18T21:00:00Z,MUAN 219N 850W,0,0,6,10,16
Tropical Storm,Rita,4,2005-09-18T21:00:00Z,PANAMA CITY FL,0,0,0,6,6
Tropical Storm,Rita,4,2005-09-18T21:00:00Z,MMCZ 205N 869W,0,0,0,9,9
Tropical Storm,Rita,4,2005-09-18T21:00:00Z,PENSACOLA FL,0,0,0,6,6
Tropical Storm,Rita,4,2005-09-18T21:00:00Z,MYMM 224N 730W,99,0,0,0,99
Tropical Storm,Rita,4,2005-09-18T21:00:00Z,MOBILE AL,0,0,0,5,5
Tropical Storm,Rita,4,2005-09-18T21:00:00Z,MYSM 241N 745W,46,0,0,0,46
Tropical Storm,Rita,4,2005-09-18T21:00:00Z,GULFPORT MS,0,0,0,6,6
Tropical Storm,Rita,4,2005-09-18T21:00:00Z,MYEG 235N 758W,56,0,0,0,56
Tropical Storm,Rita,4,2005-09-18T21:00:00Z,BURAS LA,0,0,0,8,8
Tropical Storm,Rita,4,2005-09-18T21:00:00Z,MYAK 241N 776W,40,1,0,1,42
Tropical Storm,Rita,4,2005-09-18T21:00:00Z,NEW ORLEANS LA,0,0,0,6,6
Tropical Storm,Rita,4,2005-09-18T21:00:00Z,MYNN 251N 775W,26,5,0,1,32
Tropical Storm,Rita,4,2005-09-18T21:00:00Z,NEW IBERIA LA,0,0,0,5,5
Tropical Storm,Rita,4,2005-09-18T21:00:00Z,MYGF 266N 787W,2,14,2,0,18
Tropical Storm,Rita,4,2005-09-18T21:00:00Z,PORT ARTHUR TX,0,0,0,2,2
Tropical Storm,Rita,4,2005-09-18T21:00:00Z,MMMD 210N 897W,0,0,0,6,6
Tropical Storm,Rita,4,2005-09-18T21:00:00Z,GALVESTON TX,0,0,0,2,2
Tropical Storm,Rita,4,2005-09-18T21:00:00Z,MARATHON FL,0,25,6,1,32
Tropical Storm,Rita,4,2005-09-18T21:00:00Z,GULF 29N 85W,0,0,2,8,10
Tropical Storm,Rita,4,2005-09-18T21:00:00Z,MIAMI FL,1,22,4,0,27
Tropical Storm,Rita,4,2005-09-18T21:00:00Z,GULF 29N 87W,0,0,1,10,11
Tropical Storm,Rita,4,2005-09-18T21:00:00Z,W PALM BEACH FL,0,14,6,0,20
Tropical Storm,Rita,4,2005-09-18T21:00:00Z,GULF 28N 89W,0,0,0,12,12
Tropical Storm,Rita,4,2005-09-18T21:00:00Z,FT PIERCE FL,0,6,7,0,13
Tropical Storm,Rita,4,2005-09-18T21:00:00Z,GULF 28N 91W,0,0,0,9,9
Tropical Storm,Rita,4,2005-09-18T21:00:00Z,COCOA BEACH FL,0,2,5,2,9
Tropical Storm,Rita,4,2005-09-18T21:00:00Z,GULF 28N 93W,0,0,0,5,5
Tropical Storm,Rita,4,2005-09-18T21:00:00Z,DAYTONA BEACH FL,0,0,2,2,4
Tropical Storm,Rita,4,2005-09-18T21:00:00Z,GULF 28N 95W,0,0,0,2,2
Tropical Storm,Rita,5,2005-09-19T03:00:00Z,24.1N  77.5W,45,0,0,0,45
Tropical Storm,Rita,5,2005-09-19T03:00:00Z,VENICE FL,0,1,12,4,17
Tropical Storm,Rita,5,2005-09-19T03:00:00Z,24.3N  80.1W,5,23,1,0,29
Tropical Storm,Rita,5,2005-09-19T03:00:00Z,TAMPA FL,0,0,7,5,12
Tropical Storm,Rita,5,2005-09-19T03:00:00Z,24.2N  83.0W,0,7,12,2,21
Tropical Storm,Rita,5,2005-09-19T03:00:00Z,CEDAR KEY FL,0,0,1,6,7
Tropical Storm,Rita,5,2005-09-19T03:00:00Z,MUCM 214N 779W,2,0,1,0,3
Tropical Storm,Rita,5,2005-09-19T03:00:00Z,ST MARKS FL,0,0,0,3,3
Tropical Storm,Rita,5,2005-09-19T03:00:00Z,MUCF 221N 805W,1,6,1,1,9
Tropical Storm,Rita,5,2005-09-19T03:00:00Z,APALACHICOLA FL,0,0,0,5,5
Tropical Storm,Rita,5,2005-09-19T03:00:00Z,MUSN 216N 826W,0,1,3,3,7
Tropical Storm,Rita,5,2005-09-19T03:00:00Z,PANAMA CITY FL,0,0,0,4,4
Tropical Storm,Rita,5,2005-09-19T03:00:00Z,MUHA 230N 824W,0,7,7,2,16
Tropical Storm,Rita,5,2005-09-19T03:00:00Z,PENSACOLA FL,0,0,0,3,3
Tropical Storm,Rita,5,2005-09-19T03:00:00Z,MUAN 219N 850W,0,0,3,6,9
Tropical Storm,Rita,5,2005-09-19T03:00:00Z,MOBILE AL,0,0,0,2,2
Tropical Storm,Rita,5,2005-09-19T03:00:00Z,MMCZ 205N 869W,0,0,0,4,4
Tropical Storm,Rita,5,2005-09-19T03:00:00Z,GULFPORT MS,0,0,0,3,3
Tropical Storm,Rita,5,2005-09-19T03:00:00Z,MYMM 224N 730W,99,0,0,0,99
Tropical Storm,Rita,5,2005-09-19T03:00:00Z,BURAS LA,0,0,0,5,5
Tropical Storm,Rita,5,2005-09-19T03:00:00Z,MYSM 241N 745W,74,0,0,0,74
Tropical Storm,Rita,5,2005-09-19T03:00:00Z,NEW ORLEANS LA,0,0,0,4,4
Tropical Storm,Rita,5,2005-09-19T03:00:00Z,MYEG 235N 758W,61,1,0,0,62
Tropical Storm,Rita,5,2005-09-19T03:00:00Z,NEW IBERIA LA,0,0,0,3,3
Tropical Storm,Rita,5,2005-09-19T03:00:00Z,MYAK 241N 776W,44,0,0,0,44
Tropical Storm,Rita,5,2005-09-19T03:00:00Z,PORT ARTHUR TX,0,0,0,2,2
Tropical Storm,Rita,5,2005-09-19T03:00:00Z,MYNN 251N 775W,43,1,0,0,44
Tropical Storm,Rita,5,2005-09-19T03:00:00Z,GALVESTON TX,0,0,0,2,2
Tropical Storm,Rita,5,2005-09-19T03:00:00Z,MYGF 266N 787W,6,20,0,0,26
Tropical Storm,Rita,5,2005-09-19T03:00:00Z,FREEPORT TX,0,0,0,2,2
Tropical Storm,Rita,5,2005-09-19T03:00:00Z,MMMD 210N 897W,0,0,0,4,4
Tropical Storm,Rita,5,2005-09-19T03:00:00Z,PORT O CONNOR TX,0,0,0,2,2
Tropical Storm,Rita,5,2005-09-19T03:00:00Z,MARATHON FL,0,23,3,0,26
Tropical Storm,Rita,5,2005-09-19T03:00:00Z,BROWNSVILLE TX,0,0,0,2,2
Tropical Storm,Rita,5,2005-09-19T03:00:00Z,MIAMI FL,1,24,2,0,27
Tropical Storm,Rita,5,2005-09-19T03:00:00Z,GULF 29N 85W,0,0,0,8,8
Tropical Storm,Rita,5,2005-09-19T03:00:00Z,W PALM BEACH FL,0,18,4,1,23
Tropical Storm,Rita,5,2005-09-19T03:00:00Z,GULF 29N 87W,0,0,0,7,7
Tropical Storm,Rita,5,2005-09-19T03:00:00Z,FT PIERCE FL,0,8,7,2,17
Tropical Storm,Rita,5,2005-09-19T03:00:00Z,GULF 28N 89W,0,0,0,10,10
Tropical Storm,Rita,5,2005-09-19T03:00:00Z,COCOA BEACH FL,0,2,7,2,11
Tropical Storm,Rita,5,2005-09-19T03:00:00Z,GULF 28N 91W,0,0,0,8,8
Tropical Storm,Rita,5,2005-09-19T03:00:00Z,DAYTONA BEACH FL,0,0,2,4,6
Tropical Storm,Rita,5,2005-09-19T03:00:00Z,GULF 28N 93W,0,0,0,6,6
Tropical Storm,Rita,5,2005-09-19T03:00:00Z,JACKSONVILLE FL,0,0,0,2,2
Tropical Storm,Rita,5,2005-09-19T03:00:00Z,GULF 28N 95W,0,0,0,4,4
Tropical Storm,Rita,5,2005-09-19T03:00:00Z,KEY WEST FL,0,17,6,1,24
Tropical Storm,Rita,5,2005-09-19T03:00:00Z,GULF 27N 96W,0,0,0,3,3
Tropical Storm,Rita,5,2005-09-19T03:00:00Z,MARCO ISLAND FL,0,12,10,1,23
Tropical Storm,Rita,5,2005-09-19T03:00:00Z,GULF 25N 96W,0,0,0,3,3
Tropical Storm,Rita,5,2005-09-19T03:00:00Z,FT MYERS FL,0,6,12,2,20
Tropical Storm,Rita,6,2005-09-19T09:00:00Z,23.6N  78.5W,46,0,0,0,46
Tropical Storm,Rita,6,2005-09-19T09:00:00Z,VENICE FL,0,5,12,2,19
Tropical Storm,Rita,6,2005-09-19T09:00:00Z,24.0N  81.2W,3,28,1,0,32
Tropical Storm,Rita,6,2005-09-19T09:00:00Z,TAMPA FL,0,1,10,3,14
Tropical Storm,Rita,6,2005-09-19T09:00:00Z,24.2N  84.0W,0,5,16,2,23
Tropical Storm,Rita,6,2005-09-19T09:00:00Z,CEDAR KEY FL,0,0,3,5,8
Tropical Storm,Rita,6,2005-09-19T09:00:00Z,MUCM 214N 779W,11,1,0,1,13
Tropical Storm,Rita,6,2005-09-19T09:00:00Z,ST MARKS FL,0,0,0,5,5
Tropical Storm,Rita,6,2005-09-19T09:00:00Z,MUCF 221N 805W,4,13,1,0,18
Tropical Storm,Rita,6,2005-09-19T09:00:00Z,APALACHICOLA FL,0,0,1,6,7
Tropical Storm,Rita,6,2005-09-19T09:00:00Z,MUSN 216N 826W,0,5,4,2,11
Tropical Storm,Rita,6,2005-09-19T09:00:00Z,PANAMA CITY FL,0,0,0,6,6
Tropical Storm,Rita,6,2005-09-19T09:00:00Z,MUHA 230N 824W,0,17,4,1,22
Tropical Storm,Rita,6,2005-09-19T09:00:00Z,PENSACOLA FL,0,0,0,4,4
Tropical Storm,Rita,6,2005-09-19T09:00:00Z,MUAN 219N 850W,0,0,7,4,11
Tropical Storm,Rita,6,2005-09-19T09:00:00Z,MOBILE AL,0,0,0,4,4
Tropical Storm,Rita,6,2005-09-19T09:00:00Z,MMCZ 205N 869W,0,0,1,4,5
Tropical Storm,Rita,6,2005-09-19T09:00:00Z,GULFPORT MS,0,0,0,4,4
Tropical Storm,Rita,6,2005-09-19T09:00:00Z,MYMM 224N 730W,99,0,0,0,99
Tropical Storm,Rita,6,2005-09-19T09:00:00Z,BURAS LA,0,0,0,7,7
Tropical Storm,Rita,6,2005-09-19T09:00:00Z,MYSM 241N 745W,73,0,0,0,73
Tropical Storm,Rita,6,2005-09-19T09:00:00Z,NEW ORLEANS LA,0,0,0,5,5
Tropical Storm,Rita,6,2005-09-19T09:00:00Z,MYEG 235N 758W,79,0,0,1,80
Tropical Storm,Rita,6,2005-09-19T09:00:00Z,NEW IBERIA LA,0,0,0,4,4
Tropical Storm,Rita,6,2005-09-19T09:00:00Z,MYAK 241N 776W,56,0,0,0,56
Tropical Storm,Rita,6,2005-09-19T09:00:00Z,PORT ARTHUR TX,0,0,0,3,3
Tropical Storm,Rita,6,2005-09-19T09:00:00Z,MYNN 251N 775W,44,0,0,0,44
Tropical Storm,Rita,6,2005-09-19T09:00:00Z,GALVESTON TX,0,0,0,3,3
Tropical Storm,Rita,6,2005-09-19T09:00:00Z,MYGF 266N 787W,8,15,0,0,23
Tropical Storm,Rita,6,2005-09-19T09:00:00Z,FREEPORT TX,0,0,0,3,3
Tropical Storm,Rita,6,2005-09-19T09:00:00Z,MMMD 210N 897W,0,0,0,4,4
Tropical Storm,Rita,6,2005-09-19T09:00:00Z,PORT O CONNOR TX,0,0,0,3,3
Tropical Storm,Rita,6,2005-09-19T09:00:00Z,MARATHON FL,3,30,0,0,33
Tropical Storm,Rita,6,2005-09-19T09:00:00Z,CORPUSCHRISTI TX,0,0,0,2,2
Tropical Storm,Rita,6,2005-09-19T09:00:00Z,MIAMI FL,5,26,0,0,31
Tropical Storm,Rita,6,2005-09-19T09:00:00Z,BROWNSVILLE TX,0,0,0,2,2
Tropical Storm,Rita,6,2005-09-19T09:00:00Z,W PALM BEACH FL,1,21,1,1,24
Tropical Storm,Rita,6,2005-09-19T09:00:00Z,GULF 29N 85W,0,0,2,8,10
Tropical Storm,Rita,6,2005-09-19T09:00:00Z,FT PIERCE FL,0,11,5,1,17
Tropical Storm,Rita,6,2005-09-19T09:00:00Z,GULF 29N 87W,0,0,0,9,9
Tropical Storm,Rita,6,2005-09-19T09:00:00Z,COCOA BEACH FL,0,4,6,2,12
Tropical Storm,Rita,6,2005-09-19T09:00:00Z,GULF 28N 89W,0,0,0,11,11
Tropical Storm,Rita,6,2005-09-19T09:00:00Z,DAYTONA BEACH FL,0,0,4,3,7
Tropical Storm,Rita,6,2005-09-19T09:00:00Z,GULF 28N 91W,0,0,0,9,9
Tropical Storm,Rita,6,2005-09-19T09:00:00Z,JACKSONVILLE FL,0,0,0,3,3
Tropical Storm,Rita,6,2005-09-19T09:00:00Z,GULF 28N 93W,0,0,0,7,7
Tropical Storm,Rita,6,2005-09-19T09:00:00Z,KEY WEST FL,1,27,2,0,30
Tropical Storm,Rita,6,2005-09-19T09:00:00Z,GULF 28N 95W,0,0,0,4,4
Tropical Storm,Rita,6,2005-09-19T09:00:00Z,MARCO ISLAND FL,0,21,5,1,27
Tropical Storm,Rita,6,2005-09-19T09:00:00Z,GULF 27N 96W,0,0,0,4,4
Tropical Storm,Rita,6,2005-09-19T09:00:00Z,FT MYERS FL,0,13,9,1,23
Tropical Storm,Rita,6,2005-09-19T09:00:00Z,GULF 25N 96W,0,0,0,3,3
Tropical Storm,Rita,7,2005-09-19T15:00:00Z,24.0N  79.4W,47,0,0,0,47
Tropical Storm,Rita,7,2005-09-19T15:00:00Z,VENICE FL,0,11,8,1,20
Tropical Storm,Rita,7,2005-09-19T15:00:00Z,24.4N  81.9W,5,22,0,1,28
Tropical Storm,Rita,7,2005-09-19T15:00:00Z,TAMPA FL,0,4,9,2,15
Tropical Storm,Rita,7,2005-09-19T15:00:00Z,24.7N  84.5W,0,9,10,2,21
Tropical Storm,Rita,7,2005-09-19T15:00:00Z,CEDAR KEY FL,0,0,5,5,10
Tropical Storm,Rita,7,2005-09-19T15:00:00Z,MUCM 214N 779W,4,0,0,0,4
Tropical Storm,Rita,7,2005-09-19T15:00:00Z,ST MARKS FL,0,0,1,6,7
Tropical Storm,Rita,7,2005-09-19T15:00:00Z,MUCF 221N 805W,8,5,0,0,13
Tropical Storm,Rita,7,2005-09-19T15:00:00Z,APALACHICOLA FL,0,0,1,8,9
Tropical Storm,Rita,7,2005-09-19T15:00:00Z,MUSN 216N 826W,0,3,2,1,6
Tropical Storm,Rita,7,2005-09-19T15:00:00Z,PANAMA CITY FL,0,0,1,7,8
Tropical Storm,Rita,7,2005-09-19T15:00:00Z,MUHA 230N 824W,1,15,1,0,17
Tropical Storm,Rita,7,2005-09-19T15:00:00Z,PENSACOLA FL,0,0,0,7,7
Tropical Storm,Rita,7,2005-09-19T15:00:00Z,MUAN 219N 850W,0,1,4,3,8
Tropical Storm,Rita,7,2005-09-19T15:00:00Z,MOBILE AL,0,0,0,6,6
Tropical Storm,Rita,7,2005-09-19T15:00:00Z,MMCZ 205N 869W,0,0,0,2,2
Tropical Storm,Rita,7,2005-09-19T15:00:00Z,GULFPORT MS,0,0,0,7,7
Tropical Storm,Rita,7,2005-09-19T15:00:00Z,MYSM 241N 745W,74,0,0,0,74
Tropical Storm,Rita,7,2005-09-19T15:00:00Z,BURAS LA,0,0,0,9,9
Tropical Storm,Rita,7,2005-09-19T15:00:00Z,MYEG 235N 758W,99,0,0,0,99
Tropical Storm,Rita,7,2005-09-19T15:00:00Z,NEW ORLEANS LA,0,0,0,7,7
Tropical Storm,Rita,7,2005-09-19T15:00:00Z,MYAK 241N 776W,71,0,0,0,71
Tropical Storm,Rita,7,2005-09-19T15:00:00Z,NEW IBERIA LA,0,0,0,6,6
Tropical Storm,Rita,7,2005-09-19T15:00:00Z,MYNN 251N 775W,52,0,0,0,52
Tropical Storm,Rita,7,2005-09-19T15:00:00Z,PORT ARTHUR TX,0,0,0,3,3
Tropical Storm,Rita,7,2005-09-19T15:00:00Z,MYGF 266N 787W,19,5,0,0,24
Tropical Storm,Rita,7,2005-09-19T15:00:00Z,GALVESTON TX,0,0,0,3,3
Tropical Storm,Rita,7,2005-09-19T15:00:00Z,MMMD 210N 897W,0,0,0,3,3
Tropical Storm,Rita,7,2005-09-19T15:00:00Z,FREEPORT TX,0,0,0,3,3
Tropical Storm,Rita,7,2005-09-19T15:00:00Z,MARATHON FL,18,14,0,1,33
Tropical Storm,Rita,7,2005-09-19T15:00:00Z,PORT O CONNOR TX,0,0,0,2,2
Tropical Storm,Rita,7,2005-09-19T15:00:00Z,MIAMI FL,21,11,0,0,32
Tropical Storm,Rita,7,2005-09-19T15:00:00Z,GULF 29N 85W,0,0,3,9,12
Tropical Storm,Rita,7,2005-09-19T15:00:00Z,W PALM BEACH FL,8,15,1,0,24
Tropical Storm,Rita,7,2005-09-19T15:00:00Z,GULF 29N 87W,0,0,1,11,12
Tropical Storm,Rita,7,2005-09-19T15:00:00Z,FT PIERCE FL,1,13,3,0,17
Tropical Storm,Rita,7,2005-09-19T15:00:00Z,GULF 28N 89W,0,0,1,12,13
Tropical Storm,Rita,7,2005-09-19T15:00:00Z,COCOA BEACH FL,0,7,5,1,13
Tropical Storm,Rita,7,2005-09-19T15:00:00Z,GULF 28N 91W,0,0,0,11,11
Tropical Storm,Rita,7,2005-09-19T15:00:00Z,DAYTONA BEACH FL,0,1,4,3,8
Tropical Storm,Rita,7,2005-09-19T15:00:00Z,GULF 28N 93W,0,0,0,7,7
Tropical Storm,Rita,7,2005-09-19T15:00:00Z,JACKSONVILLE FL,0,0,1,3,4
Tropical Storm,Rita,7,2005-09-19T15:00:00Z,GULF 28N 95W,0,0,0,4,4
Tropical Storm,Rita,7,2005-09-19T15:00:00Z,KEY WEST FL,6,22,0,0,28
Tropical Storm,Rita,7,2005-09-19T15:00:00Z,GULF 27N 96W,0,0,0,3,3
Tropical Storm,Rita,7,2005-09-19T15:00:00Z,MARCO ISLAND FL,2,23,1,0,26
Tropical Storm,Rita,7,2005-09-19T15:00:00Z,GULF 25N 96W,0,0,0,2,2
Tropical Storm,Rita,7,2005-09-19T15:00:00Z,FT MYERS FL,1,18,3,1,23
Tropical Storm,Rita,8,2005-09-19T21:00:00Z,24.2N  80.9W,46,0,0,0,46
Tropical Storm,Rita,8,2005-09-19T21:00:00Z,TAMPA FL,0,10,4,1,15
Tropical Storm,Rita,8,2005-09-19T21:00:00Z,24.6N  83.5W,4,26,0,0,30
Tropical Storm,Rita,8,2005-09-19T21:00:00Z,CEDAR KEY FL,0,2,5,2,9
Tropical Storm,Rita,8,2005-09-19T21:00:00Z,24.9N  85.9W,0,11,10,2,23
Tropical Storm,Rita,8,2005-09-19T21:00:00Z,ST MARKS FL,0,0,2,4,6
Tropical Storm,Rita,8,2005-09-19T21:00:00Z,MUCF 221N 805W,15,1,0,0,16
Tropical Storm,Rita,8,2005-09-19T21:00:00Z,APALACHICOLA FL,0,0,3,6,9
Tropical Storm,Rita,8,2005-09-19T21:00:00Z,MUSN 216N 826W,2,3,1,0,6
Tropical Storm,Rita,8,2005-09-19T21:00:00Z,PANAMA CITY FL,0,0,2,7,9
Tropical Storm,Rita,8,2005-09-19T21:00:00Z,MUHA 230N 824W,14,9,0,0,23
Tropical Storm,Rita,8,2005-09-19T21:00:00Z,PENSACOLA FL,0,0,0,8,8
Tropical Storm,Rita,8,2005-09-19T21:00:00Z,MUAN 219N 850W,0,4,3,2,9
Tropical Storm,Rita,8,2005-09-19T21:00:00Z,MOBILE AL,0,0,0,7,7
Tropical Storm,Rita,8,2005-09-19T21:00:00Z,MMCZ 205N 869W,0,0,1,2,3
Tropical Storm,Rita,8,2005-09-19T21:00:00Z,GULFPORT MS,0,0,0,8,8
Tropical Storm,Rita,8,2005-09-19T21:00:00Z,MYSM 241N 745W,10,0,0,0,10
Tropical Storm,Rita,8,2005-09-19T21:00:00Z,BURAS LA,0,0,0,11,11
Tropical Storm,Rita,8,2005-09-19T21:00:00Z,MYEG 235N 758W,99,0,0,0,99
Tropical Storm,Rita,8,2005-09-19T21:00:00Z,NEW ORLEANS LA,0,0,0,9,9
Tropical Storm,Rita,8,2005-09-19T21:00:00Z,MYAK 241N 776W,85,0,0,0,85
Tropical Storm,Rita,8,2005-09-19T21:00:00Z,NEW IBERIA LA,0,0,0,8,8
Tropical Storm,Rita,8,2005-09-19T21:00:00Z,MYNN 251N 775W,52,0,0,0,52
Tropical Storm,Rita,8,2005-09-19T21:00:00Z,PORT ARTHUR TX,0,0,0,5,5
Tropical Storm,Rita,8,2005-09-19T21:00:00Z,MYGF 266N 787W,18,1,0,0,19
Tropical Storm,Rita,8,2005-09-19T21:00:00Z,GALVESTON TX,0,0,0,5,5
Tropical Storm,Rita,8,2005-09-19T21:00:00Z,MMMD 210N 897W,0,0,0,5,5
Tropical Storm,Rita,8,2005-09-19T21:00:00Z,FREEPORT TX,0,0,0,4,4
Tropical Storm,Rita,8,2005-09-19T21:00:00Z,MARATHON FL,44,0,0,0,44
Tropical Storm,Rita,8,2005-09-19T21:00:00Z,PORT O CONNOR TX,0,0,0,3,3
Tropical Storm,Rita,8,2005-09-19T21:00:00Z,MIAMI FL,39,1,0,0,40
Tropical Storm,Rita,8,2005-09-19T21:00:00Z,CORPUSCHRISTI TX,0,0,0,2,2
Tropical Storm,Rita,8,2005-09-19T21:00:00Z,W PALM BEACH FL,22,3,1,0,26
Tropical Storm,Rita,8,2005-09-19T21:00:00Z,BROWNSVILLE TX,0,0,0,2,2
Tropical Storm,Rita,8,2005-09-19T21:00:00Z,FT PIERCE FL,6,9,1,0,16
Tropical Storm,Rita,8,2005-09-19T21:00:00Z,GULF 29N 85W,0,0,7,5,12
Tropical Storm,Rita,8,2005-09-19T21:00:00Z,COCOA BEACH FL,1,7,1,1,10
Tropical Storm,Rita,8,2005-09-19T21:00:00Z,GULF 29N 87W,0,0,4,9,13
Tropical Storm,Rita,8,2005-09-19T21:00:00Z,DAYTONA BEACH FL,0,2,2,1,5
Tropical Storm,Rita,8,2005-09-19T21:00:00Z,GULF 28N 89W,0,0,2,13,15
Tropical Storm,Rita,8,2005-09-19T21:00:00Z,JACKSONVILLE FL,0,0,1,1,2
Tropical Storm,Rita,8,2005-09-19T21:00:00Z,GULF 28N 91W,0,0,0,13,13
Tropical Storm,Rita,8,2005-09-19T21:00:00Z,KEY WEST FL,34,5,0,0,39
Tropical Storm,Rita,8,2005-09-19T21:00:00Z,GULF 28N 93W,0,0,0,10,10
Tropical Storm,Rita,8,2005-09-19T21:00:00Z,MARCO ISLAND FL,21,12,0,1,34
Tropical Storm,Rita,8,2005-09-19T21:00:00Z,GULF 28N 95W,0,0,0,6,6
Tropical Storm,Rita,8,2005-09-19T21:00:00Z,FT MYERS FL,9,18,0,0,27
Tropical Storm,Rita,8,2005-09-19T21:00:00Z,GULF 27N 96W,0,0,0,4,4
Tropical Storm,Rita,8,2005-09-19T21:00:00Z,VENICE FL,2,19,1,0,22
Tropical Storm,Rita,8,2005-09-19T21:00:00Z,GULF 25N 96W,0,0,0,4,4
Tropical Storm,Rita,9,2005-09-20T03:00:00Z,24.2N  82.1W,47,0,0,0,47
Tropical Storm,Rita,9,2005-09-20T03:00:00Z,CEDAR KEY FL,0,2,3,1,6
Tropical Storm,Rita,9,2005-09-20T03:00:00Z,24.5N  84.9W,3,27,1,0,31
Tropical Storm,Rita,9,2005-09-20T03:00:00Z,ST MARKS FL,0,0,2,2,4
Tropical Storm,Rita,9,2005-09-20T03:00:00Z,24.8N  87.4W,0,10,11,2,23
Tropical Storm,Rita,9,2005-09-20T03:00:00Z,APALACHICOLA FL,0,0,4,3,7
Tropical Storm,Rita,9,2005-09-20T03:00:00Z,MUCF 221N 805W,22,0,0,0,22
Tropical Storm,Rita,9,2005-09-20T03:00:00Z,PANAMA CITY FL,0,0,2,5,7
Tropical Storm,Rita,9,2005-09-20T03:00:00Z,MUSN 216N 826W,4,2,0,0,6
Tropical Storm,Rita,9,2005-09-20T03:00:00Z,PENSACOLA FL,0,0,1,5,6
Tropical Storm,Rita,9,2005-09-20T03:00:00Z,MUHA 230N 824W,29,1,0,1,31
Tropical Storm,Rita,9,2005-09-20T03:00:00Z,MOBILE AL,0,0,0,7,7
Tropical Storm,Rita,9,2005-09-20T03:00:00Z,MUAN 219N 850W,0,7,1,1,9
Tropical Storm,Rita,9,2005-09-20T03:00:00Z,GULFPORT MS,0,0,0,8,8
Tropical Storm,Rita,9,2005-09-20T03:00:00Z,MMCZ 205N 869W,0,0,1,2,3
Tropical Storm,Rita,9,2005-09-20T03:00:00Z,BURAS LA,0,0,1,11,12
Tropical Storm,Rita,9,2005-09-20T03:00:00Z,MYAK 241N 776W,99,0,0,0,99
Tropical Storm,Rita,9,2005-09-20T03:00:00Z,NEW ORLEANS LA,0,0,0,10,10
Tropical Storm,Rita,9,2005-09-20T03:00:00Z,MYNN 251N 775W,41,0,0,0,41
Tropical Storm,Rita,9,2005-09-20T03:00:00Z,NEW IBERIA LA,0,0,0,9,9
Tropical Storm,Rita,9,2005-09-20T03:00:00Z,MYGF 266N 787W,7,1,0,0,8
Tropical Storm,Rita,9,2005-09-20T03:00:00Z,PORT ARTHUR TX,0,0,0,7,7
Tropical Storm,Rita,9,2005-09-20T03:00:00Z,MMSO 238N 982W,0,0,0,2,2
Tropical Storm,Rita,9,2005-09-20T03:00:00Z,GALVESTON TX,0,0,0,8,8
Tropical Storm,Rita,9,2005-09-20T03:00:00Z,MMMD 210N 897W,0,0,1,4,5
Tropical Storm,Rita,9,2005-09-20T03:00:00Z,FREEPORT TX,0,0,0,7,7
Tropical Storm,Rita,9,2005-09-20T03:00:00Z,MARATHON FL,57,0,0,0,57
Tropical Storm,Rita,9,2005-09-20T03:00:00Z,PORT O CONNOR TX,0,0,0,6,6
Tropical Storm,Rita,9,2005-09-20T03:00:00Z,MIAMI FL,42,0,0,1,43
Tropical Storm,Rita,9,2005-09-20T03:00:00Z,CORPUSCHRISTI TX,0,0,0,4,4
Tropical Storm,Rita,9,2005-09-20T03:00:00Z,W PALM BEACH FL,20,1,0,0,21
Tropical Storm,Rita,9,2005-09-20T03:00:00Z,BROWNSVILLE TX,0,0,0,4,4
Tropical Storm,Rita,9,2005-09-20T03:00:00Z,FT PIERCE FL,6,3,1,0,10
Tropical Storm,Rita,9,2005-09-20T03:00:00Z,GULF 29N 85W,0,1,6,3,10
Tropical Storm,Rita,9,2005-09-20T03:00:00Z,COCOA BEACH FL,1,3,0,1,5
Tropical Storm,Rita,9,2005-09-20T03:00:00Z,GULF 29N 87W,0,0,6,6,12
Tropical Storm,Rita,9,2005-09-20T03:00:00Z,DAYTONA BEACH FL,0,1,1,0,2
Tropical Storm,Rita,9,2005-09-20T03:00:00Z,GULF 28N 89W,0,0,6,10,16
Tropical Storm,Rita,9,2005-09-20T03:00:00Z,KEY WEST FL,50,0,0,0,50
Tropical Storm,Rita,9,2005-09-20T03:00:00Z,GULF 28N 91W,0,0,2,13,15
Tropical Storm,Rita,9,2005-09-20T03:00:00Z,MARCO ISLAND FL,36,2,0,0,38
Tropical Storm,Rita,9,2005-09-20T03:00:00Z,GULF 28N 93W,0,0,0,12,12
Tropical Storm,Rita,9,2005-09-20T03:00:00Z,FT MYERS FL,22,7,0,0,29
Tropical Storm,Rita,9,2005-09-20T03:00:00Z,GULF 28N 95W,0,0,0,9,9
Tropical Storm,Rita,9,2005-09-20T03:00:00Z,VENICE FL,9,13,1,0,23
Tropical Storm,Rita,9,2005-09-20T03:00:00Z,GULF 27N 96W,0,0,0,8,8
Tropical Storm,Rita,9,2005-09-20T03:00:00Z,TAMPA FL,1,10,2,0,13
Tropical Storm,Rita,9,2005-09-20T03:00:00Z,GULF 25N 96W,0,0,0,7,7
Tropical Storm,Rita,10,2005-09-20T09:00:00Z,24.4N  84.4W,46,0,0,0,46
Tropical Storm,Rita,10,2005-09-20T09:00:00Z,PANAMA CITY FL,0,0,2,2,4
Tropical Storm,Rita,10,2005-09-20T09:00:00Z,24.6N  87.0W,5,25,0,0,30
Tropical Storm,Rita,10,2005-09-20T09:00:00Z,PENSACOLA FL,0,0,1,4,5
Tropical Storm,Rita,10,2005-09-20T09:00:00Z,24.7N  89.3W,0,11,10,2,23
Tropical Storm,Rita,10,2005-09-20T09:00:00Z,MOBILE AL,0,0,1,4,5
Tropical Storm,Rita,10,2005-09-20T09:00:00Z,MUHA 230N 824W,40,0,0,0,40
Tropical Storm,Rita,10,2005-09-20T09:00:00Z,GULFPORT MS,0,0,1,6,7
Tropical Storm,Rita,10,2005-09-20T09:00:00Z,MUAN 219N 850W,3,3,0,0,6
Tropical Storm,Rita,10,2005-09-20T09:00:00Z,BURAS LA,0,0,3,8,11
Tropical Storm,Rita,10,2005-09-20T09:00:00Z,MYAK 241N 776W,4,0,0,0,4
Tropical Storm,Rita,10,2005-09-20T09:00:00Z,NEW ORLEANS LA,0,0,1,8,9
Tropical Storm,Rita,10,2005-09-20T09:00:00Z,MYNN 251N 775W,6,0,0,0,6
Tropical Storm,Rita,10,2005-09-20T09:00:00Z,NEW IBERIA LA,0,0,0,9,9
Tropical Storm,Rita,10,2005-09-20T09:00:00Z,MMSO 238N 982W,0,0,0,4,4
Tropical Storm,Rita,10,2005-09-20T09:00:00Z,PORT ARTHUR TX,0,0,0,8,8
Tropical Storm,Rita,10,2005-09-20T09:00:00Z,MMTM 222N 979W,0,0,0,3,3
Tropical Storm,Rita,10,2005-09-20T09:00:00Z,GALVESTON TX,0,0,0,9,9
Tropical Storm,Rita,10,2005-09-20T09:00:00Z,MMTX 210N 974W,0,0,0,2,2
Tropical Storm,Rita,10,2005-09-20T09:00:00Z,FREEPORT TX,0,0,0,9,9
Tropical Storm,Rita,10,2005-09-20T09:00:00Z,MMMD 210N 897W,0,0,2,3,5
Tropical Storm,Rita,10,2005-09-20T09:00:00Z,PORT O CONNOR TX,0,0,0,8,8
Tropical Storm,Rita,10,2005-09-20T09:00:00Z,MARATHON FL,86,0,0,0,86
Tropical Storm,Rita,10,2005-09-20T09:00:00Z,CORPUSCHRISTI TX,0,0,0,7,7
Tropical Storm,Rita,10,2005-09-20T09:00:00Z,MIAMI FL,37,0,0,0,37
Tropical Storm,Rita,10,2005-09-20T09:00:00Z,BROWNSVILLE TX,0,0,0,7,7
Tropical Storm,Rita,10,2005-09-20T09:00:00Z,W PALM BEACH FL,3,0,0,0,3
Tropical Storm,Rita,10,2005-09-20T09:00:00Z,GULF 29N 85W,0,3,3,1,7
Tropical Storm,Rita,10,2005-09-20T09:00:00Z,KEY WEST FL,83,0,0,0,83
Tropical Storm,Rita,10,2005-09-20T09:00:00Z,GULF 29N 87W,0,2,6,3,11
Tropical Storm,Rita,10,2005-09-20T09:00:00Z,MARCO ISLAND FL,45,0,0,0,45
Tropical Storm,Rita,10,2005-09-20T09:00:00Z,GULF 28N 89W,0,2,10,5,17
Tropical Storm,Rita,10,2005-09-20T09:00:00Z,FT MYERS FL,25,0,0,0,25
Tropical Storm,Rita,10,2005-09-20T09:00:00Z,GULF 28N 91W,0,0,6,10,16
Tropical Storm,Rita,10,2005-09-20T09:00:00Z,VENICE FL,16,2,0,0,18
Tropical Storm,Rita,10,2005-09-20T09:00:00Z,GULF 28N 93W,0,0,1,13,14
Tropical Storm,Rita,10,2005-09-20T09:00:00Z,TAMPA FL,3,2,0,1,6
Tropical Storm,Rita,10,2005-09-20T09:00:00Z,GULF 28N 95W,0,0,0,11,11
Tropical Storm,Rita,10,2005-09-20T09:00:00Z,CEDAR KEY FL,0,1,1,0,2
Tropical Storm,Rita,10,2005-09-20T09:00:00Z,GULF 27N 96W,0,0,0,10,10
Tropical Storm,Rita,10,2005-09-20T09:00:00Z,ST MARKS FL,0,0,1,1,2
Tropical Storm,Rita,10,2005-09-20T09:00:00Z,GULF 25N 96W,0,0,0,10,10
Tropical Storm,Rita,10,2005-09-20T09:00:00Z,APALACHICOLA FL,0,1,2,1,4
Hurricane,Rita,11,2005-09-20T15:00:00Z,24.3N  85.8W,46,0,0,0,46
Hurricane,Rita,11,2005-09-20T15:00:00Z,GULFPORT MS,0,0,1,5,6
Hurricane,Rita,11,2005-09-20T15:00:00Z,24.5N  88.3W,5,24,1,0,30
Hurricane,Rita,11,2005-09-20T15:00:00Z,BURAS LA,0,0,4,7,11
Hurricane,Rita,11,2005-09-20T15:00:00Z,24.5N  90.5W,0,12,9,2,23
Hurricane,Rita,11,2005-09-20T15:00:00Z,NEW ORLEANS LA,0,0,1,8,9
Hurricane,Rita,11,2005-09-20T15:00:00Z,MUHA 230N 824W,60,0,0,0,60
Hurricane,Rita,11,2005-09-20T15:00:00Z,NEW IBERIA LA,0,0,1,9,10
Hurricane,Rita,11,2005-09-20T15:00:00Z,MUAN 219N 850W,6,1,0,0,7
Hurricane,Rita,11,2005-09-20T15:00:00Z,PORT ARTHUR TX,0,0,0,9,9
Hurricane,Rita,11,2005-09-20T15:00:00Z,MMSO 238N 982W,0,0,0,6,6
Hurricane,Rita,11,2005-09-20T15:00:00Z,GALVESTON TX,0,0,0,11,11
Hurricane,Rita,11,2005-09-20T15:00:00Z,MMTM 222N 979W,0,0,0,4,4
Hurricane,Rita,11,2005-09-20T15:00:00Z,FREEPORT TX,0,0,0,11,11
Hurricane,Rita,11,2005-09-20T15:00:00Z,MMTX 210N 974W,0,0,0,2,2
Hurricane,Rita,11,2005-09-20T15:00:00Z,PORT O CONNOR TX,0,0,0,10,10
Hurricane,Rita,11,2005-09-20T15:00:00Z,MMMD 210N 897W,0,1,2,1,4
Hurricane,Rita,11,2005-09-20T15:00:00Z,CORPUSCHRISTI TX,0,0,0,9,9
Hurricane,Rita,11,2005-09-20T15:00:00Z,MARATHON FL,99,0,0,0,99
Hurricane,Rita,11,2005-09-20T15:00:00Z,BROWNSVILLE TX,0,0,0,10,10
Hurricane,Rita,11,2005-09-20T15:00:00Z,MIAMI FL,6,0,0,0,6
Hurricane,Rita,11,2005-09-20T15:00:00Z,GULF 29N 85W,0,2,1,1,4
Hurricane,Rita,11,2005-09-20T15:00:00Z,KEY WEST FL,99,0,0,0,99
Hurricane,Rita,11,2005-09-20T15:00:00Z,GULF 29N 87W,0,3,4,2,9
Hurricane,Rita,11,2005-09-20T15:00:00Z,MARCO ISLAND FL,21,0,0,0,21
Hurricane,Rita,11,2005-09-20T15:00:00Z,GULF 28N 89W,0,5,8,3,16
Hurricane,Rita,11,2005-09-20T15:00:00Z,FT MYERS FL,5,0,0,0,5
Hurricane,Rita,11,2005-09-20T15:00:00Z,GULF 28N 91W,0,1,8,7,16
Hurricane,Rita,11,2005-09-20T15:00:00Z,VENICE FL,3,1,0,0,4
Hurricane,Rita,11,2005-09-20T15:00:00Z,GULF 28N 93W,0,0,3,12,15
Hurricane,Rita,11,2005-09-20T15:00:00Z,APALACHICOLA FL,0,0,1,1,2
Hurricane,Rita,11,2005-09-20T15:00:00Z,GULF 28N 95W,0,0,0,13,13
Hurricane,Rita,11,2005-09-20T15:00:00Z,PANAMA CITY FL,0,0,1,2,3
Hurricane,Rita,11,2005-09-20T15:00:00Z,GULF 27N 96W,0,0,0,13,13
Hurricane,Rita,11,2005-09-20T15:00:00Z,PENSACOLA FL,0,0,1,3,4
Hurricane,Rita,11,2005-09-20T15:00:00Z,GULF 25N 96W,0,0,1,11,12
Hurricane,Rita,11,2005-09-20T15:00:00Z,MOBILE AL,0,0,1,4,5
Hurricane,Rita,12,2005-09-20T18:00:00Z,24.3N  85.8W,46,0,0,0,46
Hurricane,Rita,12,2005-09-20T18:00:00Z,GULFPORT MS,0,0,1,5,6
Hurricane,Rita,12,2005-09-20T18:00:00Z,24.5N  88.3W,5,24,0,0,29
Hurricane,Rita,12,2005-09-20T18:00:00Z,BURAS LA,0,0,4,7,11
Hurricane,Rita,12,2005-09-20T18:00:00Z,24.5N  90.5W,0,12,9,1,22
Hurricane,Rita,12,2005-09-20T18:00:00Z,NEW ORLEANS LA,0,0,1,8,9
Hurricane,Rita,12,2005-09-20T18:00:00Z,MUHA 230N 824W,59,0,0,0,59
Hurricane,Rita,12,2005-09-20T18:00:00Z,NEW IBERIA LA,0,0,1,9,10
Hurricane,Rita,12,2005-09-20T18:00:00Z,MUAN 219N 850W,6,1,0,0,7
Hurricane,Rita,12,2005-09-20T18:00:00Z,PORT ARTHUR TX,0,0,0,9,9
Hurricane,Rita,12,2005-09-20T18:00:00Z,MMSO 238N 982W,0,0,0,6,6
Hurricane,Rita,12,2005-09-20T18:00:00Z,GALVESTON TX,0,0,0,11,11
Hurricane,Rita,12,2005-09-20T18:00:00Z,MMTM 222N 979W,0,0,0,3,3
Hurricane,Rita,12,2005-09-20T18:00:00Z,FREEPORT TX,0,0,0,11,11
Hurricane,Rita,12,2005-09-20T18:00:00Z,MMTX 210N 974W,0,0,0,2,2
Hurricane,Rita,12,2005-09-20T18:00:00Z,PORT O CONNOR TX,0,0,0,10,10
Hurricane,Rita,12,2005-09-20T18:00:00Z,MMMD 210N 897W,0,1,2,1,4
Hurricane,Rita,12,2005-09-20T18:00:00Z,CORPUSCHRISTI TX,0,0,0,9,9
Hurricane,Rita,12,2005-09-20T18:00:00Z,MARATHON FL,99,0,0,0,99
Hurricane,Rita,12,2005-09-20T18:00:00Z,BROWNSVILLE TX,0,0,0,10,10
Hurricane,Rita,12,2005-09-20T18:00:00Z,MIAMI FL,8,0,0,0,8
Hurricane,Rita,12,2005-09-20T18:00:00Z,GULF 29N 85W,0,2,1,1,4
Hurricane,Rita,12,2005-09-20T18:00:00Z,KEY WEST FL,99,0,0,0,99
Hurricane,Rita,12,2005-09-20T18:00:00Z,GULF 29N 87W,0,3,4,2,9
Hurricane,Rita,12,2005-09-20T18:00:00Z,MARCO ISLAND FL,21,0,0,0,21
Hurricane,Rita,12,2005-09-20T18:00:00Z,GULF 28N 89W,0,5,8,3,16
Hurricane,Rita,12,2005-09-20T18:00:00Z,FT MYERS FL,5,0,0,0,5
Hurricane,Rita,12,2005-09-20T18:00:00Z,GULF 28N 91W,0,1,8,7,16
Hurricane,Rita,12,2005-09-20T18:00:00Z,VENICE FL,3,1,0,0,4
Hurricane,Rita,12,2005-09-20T18:00:00Z,GULF 28N 93W,0,0,3,12,15
Hurricane,Rita,12,2005-09-20T18:00:00Z,APALACHICOLA FL,0,0,1,1,2
Hurricane,Rita,12,2005-09-20T18:00:00Z,GULF 28N 95W,0,0,0,13,13
Hurricane,Rita,12,2005-09-20T18:00:00Z,PANAMA CITY FL,0,0,1,2,3
Hurricane,Rita,12,2005-09-20T18:00:00Z,GULF 27N 96W,0,0,0,12,12
Hurricane,Rita,12,2005-09-20T18:00:00Z,PENSACOLA FL,0,0,1,3,4
Hurricane,Rita,12,2005-09-20T18:00:00Z,GULF 25N 96W,0,0,1,11,12
Hurricane,Rita,12,2005-09-20T18:00:00Z,MOBILE AL,0,0,1,4,5
Hurricane,Rita,13,2005-09-20T21:00:00Z,24.2N  87.0W,45,1,0,0,46
Hurricane,Rita,13,2005-09-20T21:00:00Z,NEW ORLEANS LA,0,0,3,8,11
Hurricane,Rita,13,2005-09-20T21:00:00Z,24.5N  89.5W,5,24,1,0,30
Hurricane,Rita,13,2005-09-20T21:00:00Z,NEW IBERIA LA,0,0,2,10,12
Hurricane,Rita,13,2005-09-20T21:00:00Z,25.0N  91.5W,0,13,8,2,23
Hurricane,Rita,13,2005-09-20T21:00:00Z,PORT ARTHUR TX,0,0,0,12,12
Hurricane,Rita,13,2005-09-20T21:00:00Z,MUHA 230N 824W,99,0,0,0,99
Hurricane,Rita,13,2005-09-20T21:00:00Z,GALVESTON TX,0,0,0,13,13
Hurricane,Rita,13,2005-09-20T21:00:00Z,MUAN 219N 850W,4,0,0,0,4
Hurricane,Rita,13,2005-09-20T21:00:00Z,FREEPORT TX,0,0,0,13,13
Hurricane,Rita,13,2005-09-20T21:00:00Z,MMSO 238N 982W,0,0,0,6,6
Hurricane,Rita,13,2005-09-20T21:00:00Z,PORT O CONNOR TX,0,0,0,12,12
Hurricane,Rita,13,2005-09-20T21:00:00Z,MMTM 222N 979W,0,0,0,3,3
Hurricane,Rita,13,2005-09-20T21:00:00Z,CORPUSCHRISTI TX,0,0,0,11,11
Hurricane,Rita,13,2005-09-20T21:00:00Z,MMTX 210N 974W,0,0,0,2,2
Hurricane,Rita,13,2005-09-20T21:00:00Z,BROWNSVILLE TX,0,0,0,11,11
Hurricane,Rita,13,2005-09-20T21:00:00Z,MMMD 210N 897W,0,1,1,1,3
Hurricane,Rita,13,2005-09-20T21:00:00Z,GULF 29N 85W,0,0,1,1,2
Hurricane,Rita,13,2005-09-20T21:00:00Z,MARATHON FL,99,0,0,0,99
Hurricane,Rita,13,2005-09-20T21:00:00Z,GULF 29N 87W,0,3,2,3,8
Hurricane,Rita,13,2005-09-20T21:00:00Z,KEY WEST FL,99,0,0,0,99
Hurricane,Rita,13,2005-09-20T21:00:00Z,GULF 28N 89W,0,10,5,2,17
Hurricane,Rita,13,2005-09-20T21:00:00Z,MARCO ISLAND FL,8,0,0,0,8
Hurricane,Rita,13,2005-09-20T21:00:00Z,GULF 28N 91W,0,3,10,5,18
Hurricane,Rita,13,2005-09-20T21:00:00Z,PANAMA CITY FL,0,0,1,1,2
Hurricane,Rita,13,2005-09-20T21:00:00Z,GULF 28N 93W,0,0,7,10,17
Hurricane,Rita,13,2005-09-20T21:00:00Z,PENSACOLA FL,0,0,1,3,4
Hurricane,Rita,13,2005-09-20T21:00:00Z,GULF 28N 95W,0,0,1,14,15
Hurricane,Rita,13,2005-09-20T21:00:00Z,MOBILE AL,0,0,1,5,6
Hurricane,Rita,13,2005-09-20T21:00:00Z,GULF 27N 96W,0,0,1,13,14
Hurricane,Rita,13,2005-09-20T21:00:00Z,GULFPORT MS,0,0,2,6,8
Hurricane,Rita,13,2005-09-20T21:00:00Z,GULF 25N 96W,0,0,2,11,13
Hurricane,Rita,13,2005-09-20T21:00:00Z,BURAS LA,0,1,5,6,12
Hurricane,Rita,14,2005-09-21T03:00:00Z,24.4N  87.5W,45,0,0,0,45
Hurricane,Rita,14,2005-09-21T03:00:00Z,NEW IBERIA LA,0,0,2,10,12
Hurricane,Rita,14,2005-09-21T03:00:00Z,24.6N  89.4W,13,14,0,1,28
Hurricane,Rita,14,2005-09-21T03:00:00Z,PORT ARTHUR TX,0,0,0,12,12
Hurricane,Rita,14,2005-09-21T03:00:00Z,25.1N  91.4W,0,14,7,1,22
Hurricane,Rita,14,2005-09-21T03:00:00Z,GALVESTON TX,0,0,1,12,13
Hurricane,Rita,14,2005-09-21T03:00:00Z,MUHA 230N 824W,99,0,0,0,99
Hurricane,Rita,14,2005-09-21T03:00:00Z,FREEPORT TX,0,0,0,13,13
Hurricane,Rita,14,2005-09-21T03:00:00Z,MUAN 219N 850W,1,1,0,0,2
Hurricane,Rita,14,2005-09-21T03:00:00Z,PORT O CONNOR TX,0,0,0,13,13
Hurricane,Rita,14,2005-09-21T03:00:00Z,MMSO 238N 982W,0,0,0,6,6
Hurricane,Rita,14,2005-09-21T03:00:00Z,CORPUSCHRISTI TX,0,0,0,11,11
Hurricane,Rita,14,2005-09-21T03:00:00Z,MMTM 222N 979W,0,0,0,3,3
Hurricane,Rita,14,2005-09-21T03:00:00Z,BROWNSVILLE TX,0,0,0,11,11
Hurricane,Rita,14,2005-09-21T03:00:00Z,MMMD 210N 897W,0,1,1,0,2
Hurricane,Rita,14,2005-09-21T03:00:00Z,GULF 29N 85W,0,1,0,1,2
Hurricane,Rita,14,2005-09-21T03:00:00Z,KEY WEST FL,99,0,0,0,99
Hurricane,Rita,14,2005-09-21T03:00:00Z,GULF 29N 87W,0,3,4,2,9
Hurricane,Rita,14,2005-09-21T03:00:00Z,APALACHICOLA FL,0,0,1,1,2
Hurricane,Rita,14,2005-09-21T03:00:00Z,GULF 28N 89W,1,9,5,2,17
Hurricane,Rita,14,2005-09-21T03:00:00Z,PANAMA CITY FL,0,0,1,1,2
Hurricane,Rita,14,2005-09-21T03:00:00Z,GULF 28N 91W,0,3,11,4,18
Hurricane,Rita,14,2005-09-21T03:00:00Z,PENSACOLA FL,0,0,1,3,4
Hurricane,Rita,14,2005-09-21T03:00:00Z,GULF 28N 93W,0,0,8,9,17
Hurricane,Rita,14,2005-09-21T03:00:00Z,MOBILE AL,0,0,1,5,6
Hurricane,Rita,14,2005-09-21T03:00:00Z,GULF 28N 95W,0,0,2,13,15
Hurricane,Rita,14,2005-09-21T03:00:00Z,GULFPORT MS,0,0,2,6,8
Hurricane,Rita,14,2005-09-21T03:00:00Z,GULF 27N 96W,0,0,1,13,14
Hurricane,Rita,14,2005-09-21T03:00:00Z,BURAS LA,0,1,6,5,12
Hurricane,Rita,14,2005-09-21T03:00:00Z,GULF 25N 96W,0,0,2,10,12
Hurricane,Rita,14,2005-09-21T03:00:00Z,NEW ORLEANS LA,0,0,3,8,11
Hurricane,Rita,15,2005-09-21T09:00:00Z,24.7N  88.7W,41,0,0,0,41
Hurricane,Rita,15,2005-09-21T09:00:00Z,PORT ARTHUR TX,0,0,4,9,13
Hurricane,Rita,15,2005-09-21T09:00:00Z,25.2N  90.8W,20,8,1,0,29
Hurricane,Rita,15,2005-09-21T09:00:00Z,GALVESTON TX,0,0,6,8,14
Hurricane,Rita,15,2005-09-21T09:00:00Z,25.9N  92.8W,2,18,3,1,24
Hurricane,Rita,15,2005-09-21T09:00:00Z,FREEPORT TX,0,0,6,9,15
Hurricane,Rita,15,2005-09-21T09:00:00Z,MMSO 238N 982W,0,0,2,6,8
Hurricane,Rita,15,2005-09-21T09:00:00Z,PORT O CONNOR TX,0,0,6,9,15
Hurricane,Rita,15,2005-09-21T09:00:00Z,MMTM 222N 979W,0,0,1,4,5
Hurricane,Rita,15,2005-09-21T09:00:00Z,CORPUSCHRISTI TX,0,0,5,9,14
Hurricane,Rita,15,2005-09-21T09:00:00Z,MMTX 210N 974W,0,0,0,2,2
Hurricane,Rita,15,2005-09-21T09:00:00Z,BROWNSVILLE TX,0,0,7,7,14
Hurricane,Rita,15,2005-09-21T09:00:00Z,MMMD 210N 897W,0,0,1,1,2
Hurricane,Rita,15,2005-09-21T09:00:00Z,GULF 29N 85W,0,0,0,2,2
Hurricane,Rita,15,2005-09-21T09:00:00Z,PANAMA CITY FL,0,0,0,2,2
Hurricane,Rita,15,2005-09-21T09:00:00Z,GULF 29N 87W,0,1,1,3,5
Hurricane,Rita,15,2005-09-21T09:00:00Z,PENSACOLA FL,0,0,0,3,3
Hurricane,Rita,15,2005-09-21T09:00:00Z,GULF 28N 89W,2,7,3,2,14
Hurricane,Rita,15,2005-09-21T09:00:00Z,MOBILE AL,0,0,1,4,5
Hurricane,Rita,15,2005-09-21T09:00:00Z,GULF 28N 91W,0,10,5,3,18
Hurricane,Rita,15,2005-09-21T09:00:00Z,GULFPORT MS,0,0,1,6,7
Hurricane,Rita,15,2005-09-21T09:00:00Z,GULF 28N 93W,0,5,10,4,19
Hurricane,Rita,15,2005-09-21T09:00:00Z,BURAS LA,0,1,4,5,10
Hurricane,Rita,15,2005-09-21T09:00:00Z,GULF 28N 95W,0,1,11,5,17
Hurricane,Rita,15,2005-09-21T09:00:00Z,NEW ORLEANS LA,0,0,3,6,9
Hurricane,Rita,15,2005-09-21T09:00:00Z,GULF 27N 96W,0,1,11,5,17
Hurricane,Rita,15,2005-09-21T09:00:00Z,NEW IBERIA LA,0,0,4,8,12
Hurricane,Rita,15,2005-09-21T09:00:00Z,GULF 25N 96W,0,3,9,4,16
Hurricane,Rita,16,2005-09-21T15:00:00Z,25.0N  90.0W,41,0,0,0,41
Hurricane,Rita,16,2005-09-21T15:00:00Z,GALVESTON TX,0,1,9,6,16
Hurricane,Rita,16,2005-09-21T15:00:00Z,25.7N  92.0W,19,9,0,1,29
Hurricane,Rita,16,2005-09-21T15:00:00Z,FREEPORT TX,0,1,10,6,17
Hurricane,Rita,16,2005-09-21T15:00:00Z,26.6N  94.0W,1,18,4,1,24
Hurricane,Rita,16,2005-09-21T15:00:00Z,PORT O CONNOR TX,0,1,11,5,17
Hurricane,Rita,16,2005-09-21T15:00:00Z,MMSO 238N 982W,0,0,3,5,8
Hurricane,Rita,16,2005-09-21T15:00:00Z,CORPUSCHRISTI TX,0,1,9,6,16
Hurricane,Rita,16,2005-09-21T15:00:00Z,MMTM 222N 979W,0,0,1,3,4
Hurricane,Rita,16,2005-09-21T15:00:00Z,BROWNSVILLE TX,0,2,9,5,16
Hurricane,Rita,16,2005-09-21T15:00:00Z,PENSACOLA FL,0,0,0,3,3
Hurricane,Rita,16,2005-09-21T15:00:00Z,GULF 29N 87W,0,1,1,2,4
Hurricane,Rita,16,2005-09-21T15:00:00Z,MOBILE AL,0,0,1,3,4
Hurricane,Rita,16,2005-09-21T15:00:00Z,GULF 28N 89W,3,7,2,2,14
Hurricane,Rita,16,2005-09-21T15:00:00Z,GULFPORT MS,0,0,2,4,6
Hurricane,Rita,16,2005-09-21T15:00:00Z,GULF 28N 91W,2,12,3,2,19
Hurricane,Rita,16,2005-09-21T15:00:00Z,BURAS LA,0,2,4,4,10
Hurricane,Rita,16,2005-09-21T15:00:00Z,GULF 28N 93W,0,12,7,2,21
Hurricane,Rita,16,2005-09-21T15:00:00Z,NEW ORLEANS LA,0,1,3,6,10
Hurricane,Rita,16,2005-09-21T15:00:00Z,GULF 28N 95W,0,5,12,3,20
Hurricane,Rita,16,2005-09-21T15:00:00Z,NEW IBERIA LA,0,1,6,5,12
Hurricane,Rita,16,2005-09-21T15:00:00Z,GULF 27N 96W,0,6,11,3,20
Hurricane,Rita,16,2005-09-21T15:00:00Z,PORT ARTHUR TX,0,0,7,7,14
Hurricane,Rita,16,2005-09-21T15:00:00Z,GULF 25N 96W,0,8,6,3,17
Hurricane,Rita,17,2005-09-21T21:00:00Z,25.2N  90.6W,42,0,0,0,42
Hurricane,Rita,17,2005-09-21T21:00:00Z,GALVESTON TX,0,2,11,5,18
Hurricane,Rita,17,2005-09-21T21:00:00Z,26.0N  92.7W,17,13,0,0,30
Hurricane,Rita,17,2005-09-21T21:00:00Z,FREEPORT TX,0,2,12,4,18
Hurricane,Rita,17,2005-09-21T21:00:00Z,27.0N  94.5W,1,18,4,1,24
Hurricane,Rita,17,2005-09-21T21:00:00Z,PORT O CONNOR TX,0,2,12,4,18
Hurricane,Rita,17,2005-09-21T21:00:00Z,MMSO 238N 982W,0,0,3,3,6
Hurricane,Rita,17,2005-09-21T21:00:00Z,CORPUSCHRISTI TX,0,1,11,5,17
Hurricane,Rita,17,2005-09-21T21:00:00Z,MMTM 222N 979W,0,0,1,1,2
Hurricane,Rita,17,2005-09-21T21:00:00Z,BROWNSVILLE TX,0,4,8,3,15
Hurricane,Rita,17,2005-09-21T21:00:00Z,PENSACOLA FL,0,0,0,3,3
Hurricane,Rita,17,2005-09-21T21:00:00Z,GULF 29N 87W,0,0,1,2,3
Hurricane,Rita,17,2005-09-21T21:00:00Z,MOBILE AL,0,0,1,3,4
Hurricane,Rita,17,2005-09-21T21:00:00Z,GULF 28N 89W,4,6,1,1,12
Hurricane,Rita,17,2005-09-21T21:00:00Z,GULFPORT MS,0,0,2,4,6
Hurricane,Rita,17,2005-09-21T21:00:00Z,GULF 28N 91W,5,11,2,1,19
Hurricane,Rita,17,2005-09-21T21:00:00Z,BURAS LA,0,2,4,3,9
Hurricane,Rita,17,2005-09-21T21:00:00Z,GULF 28N 93W,1,16,3,2,22
Hurricane,Rita,17,2005-09-21T21:00:00Z,NEW ORLEANS LA,0,1,4,5,10
Hurricane,Rita,17,2005-09-21T21:00:00Z,GULF 28N 95W,0,9,9,3,21
Hurricane,Rita,17,2005-09-21T21:00:00Z,NEW IBERIA LA,0,1,7,5,13
Hurricane,Rita,17,2005-09-21T21:00:00Z,GULF 27N 96W,0,9,9,2,20
Hurricane,Rita,17,2005-09-21T21:00:00Z,PORT ARTHUR TX,0,1,8,6,15
Hurricane,Rita,17,2005-09-21T21:00:00Z,GULF 25N 96W,0,10,5,1,16
Hurricane,Rita,18,2005-09-22T03:00:00Z,25.5N  90.5W,43,0,0,0,43
Hurricane,Rita,18,2005-09-22T03:00:00Z,FREEPORT TX,0,3,13,3,19
Hurricane,Rita,18,2005-09-22T03:00:00Z,26.3N  92.4W,20,9,1,0,30
Hurricane,Rita,18,2005-09-22T03:00:00Z,PORT O CONNOR TX,0,3,12,4,19
Hurricane,Rita,18,2005-09-22T03:00:00Z,27.5N  94.2W,1,17,5,1,24
Hurricane,Rita,18,2005-09-22T03:00:00Z,CORPUSCHRISTI TX,0,1,11,4,16
Hurricane,Rita,18,2005-09-22T03:00:00Z,MMSO 238N 982W,0,0,1,3,4
Hurricane,Rita,18,2005-09-22T03:00:00Z,BROWNSVILLE TX,0,2,8,3,13
Hurricane,Rita,18,2005-09-22T03:00:00Z,PENSACOLA FL,0,0,0,3,3
Hurricane,Rita,18,2005-09-22T03:00:00Z,GULF 29N 87W,0,1,0,3,4
Hurricane,Rita,18,2005-09-22T03:00:00Z,MOBILE AL,0,0,1,4,5
Hurricane,Rita,18,2005-09-22T03:00:00Z,GULF 28N 89W,7,5,1,1,14
Hurricane,Rita,18,2005-09-22T03:00:00Z,GULFPORT MS,0,0,2,5,7
Hurricane,Rita,18,2005-09-22T03:00:00Z,GULF 28N 91W,7,12,1,1,21
Hurricane,Rita,18,2005-09-22T03:00:00Z,BURAS LA,0,3,5,3,11
Hurricane,Rita,18,2005-09-22T03:00:00Z,GULF 28N 93W,2,17,3,1,23
Hurricane,Rita,18,2005-09-22T03:00:00Z,NEW ORLEANS LA,0,2,4,5,11
Hurricane,Rita,18,2005-09-22T03:00:00Z,GULF 28N 95W,0,11,9,2,22
Hurricane,Rita,18,2005-09-22T03:00:00Z,NEW IBERIA LA,0,2,8,5,15
Hurricane,Rita,18,2005-09-22T03:00:00Z,GULF 27N 96W,0,9,9,2,20
Hurricane,Rita,18,2005-09-22T03:00:00Z,PORT ARTHUR TX,0,2,10,5,17
Hurricane,Rita,18,2005-09-22T03:00:00Z,GULF 25N 96W,0,7,5,2,14
Hurricane,Rita,18,2005-09-22T03:00:00Z,GALVESTON TX,0,3,12,4,19
Hurricane,Rita,19,2005-09-22T09:00:00Z,26.1N  91.1W,42,0,0,0,42
Hurricane,Rita,19,2005-09-22T09:00:00Z,FREEPORT TX,0,10,10,2,22
Hurricane,Rita,19,2005-09-22T09:00:00Z,27.2N  92.8W,19,10,0,0,29
Hurricane,Rita,19,2005-09-22T09:00:00Z,PORT O CONNOR TX,0,8,10,2,20
Hurricane,Rita,19,2005-09-22T09:00:00Z,28.8N  94.3W,0,16,7,1,24
Hurricane,Rita,19,2005-09-22T09:00:00Z,CORPUSCHRISTI TX,0,4,9,2,15
Hurricane,Rita,19,2005-09-22T09:00:00Z,PENSACOLA FL,0,0,1,3,4
Hurricane,Rita,19,2005-09-22T09:00:00Z,BROWNSVILLE TX,0,3,4,2,9
Hurricane,Rita,19,2005-09-22T09:00:00Z,MOBILE AL,0,0,2,4,6
Hurricane,Rita,19,2005-09-22T09:00:00Z,GULF 29N 87W,0,1,1,2,4
Hurricane,Rita,19,2005-09-22T09:00:00Z,GULFPORT MS,0,1,4,4,9
Hurricane,Rita,19,2005-09-22T09:00:00Z,GULF 28N 89W,11,3,1,1,16
Hurricane,Rita,19,2005-09-22T09:00:00Z,BURAS LA,1,6,4,2,13
Hurricane,Rita,19,2005-09-22T09:00:00Z,GULF 28N 91W,17,6,1,0,24
Hurricane,Rita,19,2005-09-22T09:00:00Z,NEW ORLEANS LA,0,4,7,2,13
Hurricane,Rita,19,2005-09-22T09:00:00Z,GULF 28N 93W,8,17,1,0,26
Hurricane,Rita,19,2005-09-22T09:00:00Z,NEW IBERIA LA,0,7,8,3,18
Hurricane,Rita,19,2005-09-22T09:00:00Z,GULF 28N 95W,1,17,4,1,23
Hurricane,Rita,19,2005-09-22T09:00:00Z,PORT ARTHUR TX,0,7,11,3,21
Hurricane,Rita,19,2005-09-22T09:00:00Z,GULF 27N 96W,0,13,4,1,18
Hurricane,Rita,19,2005-09-22T09:00:00Z,GALVESTON TX,0,11,9,2,22
Hurricane,Rita,19,2005-09-22T09:00:00Z,GULF 25N 96W,0,5,2,2,9
Hurricane,Rita,20,2005-09-22T15:00:00Z,26.9N  91.6W,40,0,0,0,40
Hurricane,Rita,20,2005-09-22T15:00:00Z,FREEPORT TX,2,16,4,1,23
Hurricane,Rita,20,2005-09-22T15:00:00Z,28.2N  93.0W,19,8,0,0,27
Hurricane,Rita,20,2005-09-22T15:00:00Z,PORT O CONNOR TX,1,12,5,1,19
Hurricane,Rita,20,2005-09-22T15:00:00Z,30.0N  94.5W,1,14,8,1,24
Hurricane,Rita,20,2005-09-22T15:00:00Z,CORPUSCHRISTI TX,0,6,5,2,13
Hurricane,Rita,20,2005-09-22T15:00:00Z,PANAMA CITY FL,0,0,0,2,2
Hurricane,Rita,20,2005-09-22T15:00:00Z,BROWNSVILLE TX,0,2,1,2,5
Hurricane,Rita,20,2005-09-22T15:00:00Z,PENSACOLA FL,0,0,1,3,4
Hurricane,Rita,20,2005-09-22T15:00:00Z,GULF 29N 87W,0,2,1,1,4
Hurricane,Rita,20,2005-09-22T15:00:00Z,MOBILE AL,0,1,3,3,7
Hurricane,Rita,20,2005-09-22T15:00:00Z,GULF 28N 89W,17,1,0,1,19
Hurricane,Rita,20,2005-09-22T15:00:00Z,GULFPORT MS,0,3,5,2,10
Hurricane,Rita,20,2005-09-22T15:00:00Z,GULF 28N 91W,26,2,0,0,28
Hurricane,Rita,20,2005-09-22T15:00:00Z,BURAS LA,4,7,2,2,15
Hurricane,Rita,20,2005-09-22T15:00:00Z,GULF 28N 93W,21,6,1,0,28
Hurricane,Rita,20,2005-09-22T15:00:00Z,NEW ORLEANS LA,2,8,4,2,16
Hurricane,Rita,20,2005-09-22T15:00:00Z,GULF 28N 95W,6,14,2,0,22
Hurricane,Rita,20,2005-09-22T15:00:00Z,NEW IBERIA LA,2,13,5,1,21
Hurricane,Rita,20,2005-09-22T15:00:00Z,GULF 27N 96W,3,9,2,1,15
Hurricane,Rita,20,2005-09-22T15:00:00Z,PORT ARTHUR TX,1,15,7,1,24
Hurricane,Rita,20,2005-09-22T15:00:00Z,GULF 25N 96W,1,1,0,1,3
Hurricane,Rita,20,2005-09-22T15:00:00Z,GALVESTON TX,2,17,5,0,24
Hurricane,Rita,21,2005-09-22T21:00:00Z,27.8N  92.4W,40,0,0,0,40
Hurricane,Rita,21,2005-09-22T21:00:00Z,GALVESTON TX,8,17,1,0,26
Hurricane,Rita,21,2005-09-22T21:00:00Z,29.2N  93.8W,14,14,0,1,29
Hurricane,Rita,21,2005-09-22T21:00:00Z,FREEPORT TX,7,16,1,0,24
Hurricane,Rita,21,2005-09-22T21:00:00Z,30.5N  94.5W,1,19,3,1,24
Hurricane,Rita,21,2005-09-22T21:00:00Z,PORT O CONNOR TX,4,11,2,1,18
Hurricane,Rita,21,2005-09-22T21:00:00Z,PANAMA CITY FL,0,0,0,2,2
Hurricane,Rita,21,2005-09-22T21:00:00Z,CORPUSCHRISTI TX,1,5,1,2,9
Hurricane,Rita,21,2005-09-22T21:00:00Z,PENSACOLA FL,0,0,1,3,4
Hurricane,Rita,21,2005-09-22T21:00:00Z,BROWNSVILLE TX,0,0,0,2,2
Hurricane,Rita,21,2005-09-22T21:00:00Z,MOBILE AL,0,1,2,4,7
Hurricane,Rita,21,2005-09-22T21:00:00Z,GULF 29N 87W,0,1,0,2,3
Hurricane,Rita,21,2005-09-22T21:00:00Z,GULFPORT MS,0,3,3,3,9
Hurricane,Rita,21,2005-09-22T21:00:00Z,GULF 28N 89W,18,1,0,0,19
Hurricane,Rita,21,2005-09-22T21:00:00Z,BURAS LA,5,6,1,2,14
Hurricane,Rita,21,2005-09-22T21:00:00Z,GULF 28N 91W,39,0,0,0,39
Hurricane,Rita,21,2005-09-22T21:00:00Z,NEW ORLEANS LA,3,8,2,2,15
Hurricane,Rita,21,2005-09-22T21:00:00Z,GULF 28N 93W,33,0,0,1,34
Hurricane,Rita,21,2005-09-22T21:00:00Z,NEW IBERIA LA,6,13,1,1,21
Hurricane,Rita,21,2005-09-22T21:00:00Z,GULF 28N 95W,15,7,1,0,23
Hurricane,Rita,21,2005-09-22T21:00:00Z,PORT ARTHUR TX,4,20,1,1,26
Hurricane,Rita,21,2005-09-22T21:00:00Z,GULF 27N 96W,4,5,1,1,11
Hurricane,Rita,22,2005-09-23T03:00:00Z,28.4N  93.0W,41,0,0,0,41
Hurricane,Rita,22,2005-09-23T03:00:00Z,FREEPORT TX,15,9,1,0,25
Hurricane,Rita,22,2005-09-23T03:00:00Z,29.8N  94.2W,19,10,0,1,30
Hurricane,Rita,22,2005-09-23T03:00:00Z,PORT O CONNOR TX,6,8,2,2,18
Hurricane,Rita,22,2005-09-23T03:00:00Z,31.1N  94.7W,4,18,2,1,25
Hurricane,Rita,22,2005-09-23T03:00:00Z,CORPUSCHRISTI TX,1,4,2,3,10
Hurricane,Rita,22,2005-09-23T03:00:00Z,PENSACOLA FL,0,0,0,3,3
Hurricane,Rita,22,2005-09-23T03:00:00Z,BROWNSVILLE TX,0,0,1,2,3
Hurricane,Rita,22,2005-09-23T03:00:00Z,MOBILE AL,0,1,1,4,6
Hurricane,Rita,22,2005-09-23T03:00:00Z,GULF 29N 87W,0,0,1,2,3
Hurricane,Rita,22,2005-09-23T03:00:00Z,GULFPORT MS,1,2,2,4,9
Hurricane,Rita,22,2005-09-23T03:00:00Z,GULF 28N 89W,8,2,0,1,11
Hurricane,Rita,22,2005-09-23T03:00:00Z,BURAS LA,5,4,2,1,12
Hurricane,Rita,22,2005-09-23T03:00:00Z,GULF 28N 91W,46,0,0,0,46
Hurricane,Rita,22,2005-09-23T03:00:00Z,NEW ORLEANS LA,5,6,2,2,15
Hurricane,Rita,22,2005-09-23T03:00:00Z,GULF 28N 93W,44,0,0,0,44
Hurricane,Rita,22,2005-09-23T03:00:00Z,NEW IBERIA LA,15,6,1,1,23
Hurricane,Rita,22,2005-09-23T03:00:00Z,GULF 28N 95W,19,3,1,0,23
Hurricane,Rita,22,2005-09-23T03:00:00Z,PORT ARTHUR TX,17,11,1,0,29
Hurricane,Rita,22,2005-09-23T03:00:00Z,GULF 27N 96W,4,4,2,2,12
Hurricane,Rita,22,2005-09-23T03:00:00Z,GALVESTON TX,20,7,1,1,29
Hurricane,Rita,22,2005-09-23T03:00:00Z,GULF 25N 96W,0,0,1,2,3
Hurricane,Rita,23,2005-09-23T09:00:00Z,28.9N  93.6W,39,0,0,0,39
Hurricane,Rita,23,2005-09-23T09:00:00Z,FREEPORT TX,24,2,0,1,27
Hurricane,Rita,23,2005-09-23T09:00:00Z,30.4N  94.6W,22,7,0,1,30
Hurricane,Rita,23,2005-09-23T09:00:00Z,PORT O CONNOR TX,12,3,1,1,17
Hurricane,Rita,23,2005-09-23T09:00:00Z,31.5N  95.0W,7,17,1,1,26
Hurricane,Rita,23,2005-09-23T09:00:00Z,CORPUSCHRISTI TX,2,3,1,2,8
Hurricane,Rita,23,2005-09-23T09:00:00Z,PENSACOLA FL,0,0,0,3,3
Hurricane,Rita,23,2005-09-23T09:00:00Z,BROWNSVILLE TX,0,0,0,2,2
Hurricane,Rita,23,2005-09-23T09:00:00Z,MOBILE AL,0,0,1,4,5
Hurricane,Rita,23,2005-09-23T09:00:00Z,GULF 29N 87W,0,0,0,2,2
Hurricane,Rita,23,2005-09-23T09:00:00Z,GULFPORT MS,0,2,2,3,7
Hurricane,Rita,23,2005-09-23T09:00:00Z,GULF 28N 89W,3,1,1,1,6
Hurricane,Rita,23,2005-09-23T09:00:00Z,BURAS LA,4,2,2,2,10
Hurricane,Rita,23,2005-09-23T09:00:00Z,GULF 28N 91W,53,0,0,0,53
Hurricane,Rita,23,2005-09-23T09:00:00Z,NEW ORLEANS LA,5,4,2,2,13
Hurricane,Rita,23,2005-09-23T09:00:00Z,GULF 28N 93W,51,0,0,0,51
Hurricane,Rita,23,2005-09-23T09:00:00Z,NEW IBERIA LA,19,2,1,0,22
Hurricane,Rita,23,2005-09-23T09:00:00Z,GULF 28N 95W,23,1,0,0,24
Hurricane,Rita,23,2005-09-23T09:00:00Z,PORT ARTHUR TX,28,2,0,1,31
Hurricane,Rita,23,2005-09-23T09:00:00Z,GULF 27N 96W,4,3,0,2,9
Hurricane,Rita,23,2005-09-23T09:00:00Z,GALVESTON TX,30,0,1,0,31
Hurricane,Rita,24,2005-09-23T15:00:00Z,30.0N  94.2W,36,0,0,0,36
Hurricane,Rita,24,2005-09-23T15:00:00Z,GALVESTON TX,37,0,0,0,37
Hurricane,Rita,24,2005-09-23T15:00:00Z,31.5N  95.0W,18,10,0,1,29
Hurricane,Rita,24,2005-09-23T15:00:00Z,FREEPORT TX,29,0,0,0,29
Hurricane,Rita,24,2005-09-23T15:00:00Z,33.0N  94.5W,2,17,3,2,24
Hurricane,Rita,24,2005-09-23T15:00:00Z,PORT O CONNOR TX,11,0,0,1,12
Hurricane,Rita,24,2005-09-23T15:00:00Z,PENSACOLA FL,0,0,0,3,3
Hurricane,Rita,24,2005-09-23T15:00:00Z,CORPUSCHRISTI TX,1,0,0,2,3
Hurricane,Rita,24,2005-09-23T15:00:00Z,MOBILE AL,0,0,2,4,6
Hurricane,Rita,24,2005-09-23T15:00:00Z,GULF 29N 87W,0,0,0,2,2
Hurricane,Rita,24,2005-09-23T15:00:00Z,GULFPORT MS,1,1,2,3,7
Hurricane,Rita,24,2005-09-23T15:00:00Z,GULF 28N 89W,0,1,0,2,3
Hurricane,Rita,24,2005-09-23T15:00:00Z,BURAS LA,3,2,1,2,8
Hurricane,Rita,24,2005-09-23T15:00:00Z,GULF 28N 91W,99,0,0,0,99
Hurricane,Rita,24,2005-09-23T15:00:00Z,NEW ORLEANS LA,6,3,1,2,12
Hurricane,Rita,24,2005-09-23T15:00:00Z,GULF 28N 93W,74,0,0,0,74
Hurricane,Rita,24,2005-09-23T15:00:00Z,NEW IBERIA LA,22,1,1,0,24
Hurricane,Rita,24,2005-09-23T15:00:00Z,GULF 28N 95W,24,0,0,0,24
Hurricane,Rita,24,2005-09-23T15:00:00Z,PORT ARTHUR TX,36,1,0,0,37
Hurricane,Rita,24,2005-09-23T15:00:00Z,GULF 27N 96W,1,0,0,2,3
Hurricane,Rita,25,2005-09-23T21:00:00Z,30.8N  94.5W,38,0,0,0,38
Hurricane,Rita,25,2005-09-23T21:00:00Z,GALVESTON TX,48,0,0,0,48
Hurricane,Rita,25,2005-09-23T21:00:00Z,32.5N  94.5W,16,14,0,1,31
Hurricane,Rita,25,2005-09-23T21:00:00Z,FREEPORT TX,33,0,0,0,33
Hurricane,Rita,25,2005-09-23T21:00:00Z,33.5N  94.5W,5,20,1,1,27
Hurricane,Rita,25,2005-09-23T21:00:00Z,PORT O CONNOR TX,11,1,0,1,13
Hurricane,Rita,25,2005-09-23T21:00:00Z,PENSACOLA FL,0,0,0,3,3
Hurricane,Rita,25,2005-09-23T21:00:00Z,CORPUSCHRISTI TX,1,0,0,3,4
Hurricane,Rita,25,2005-09-23T21:00:00Z,MOBILE AL,0,0,1,4,5
Hurricane,Rita,25,2005-09-23T21:00:00Z,GULF 29N 87W,0,0,0,2,2
Hurricane,Rita,25,2005-09-23T21:00:00Z,GULFPORT MS,0,1,2,3,6
Hurricane,Rita,25,2005-09-23T21:00:00Z,GULF 28N 89W,0,0,0,3,3
Hurricane,Rita,25,2005-09-23T21:00:00Z,BURAS LA,1,1,1,3,6
Hurricane,Rita,25,2005-09-23T21:00:00Z,GULF 28N 91W,57,0,0,0,57
Hurricane,Rita,25,2005-09-23T21:00:00Z,NEW ORLEANS LA,3,4,1,3,11
Hurricane,Rita,25,2005-09-23T21:00:00Z,GULF 28N 93W,99,0,0,0,99
Hurricane,Rita,25,2005-09-23T21:00:00Z,NEW IBERIA LA,29,1,0,0,30
Hurricane,Rita,25,2005-09-23T21:00:00Z,GULF 28N 95W,33,0,0,0,33
Hurricane,Rita,25,2005-09-23T21:00:00Z,PORT ARTHUR TX,53,0,0,0,53
Hurricane,Rita,25,2005-09-23T21:00:00Z,GULF 27N 96W,2,1,0,1,4
Hurricane,Rita,26,2005-09-24T03:00:00Z,31.4N  94.5W,48,0,0,0,48
Hurricane,Rita,26,2005-09-24T03:00:00Z,GALVESTON TX,64,0,0,0,64
Hurricane,Rita,26,2005-09-24T03:00:00Z,32.8N  94.5W,25,3,1,0,29
Hurricane,Rita,26,2005-09-24T03:00:00Z,FREEPORT TX,37,0,0,0,37
Hurricane,Rita,26,2005-09-24T03:00:00Z,33.5N  94.5W,17,8,1,1,27
Hurricane,Rita,26,2005-09-24T03:00:00Z,PORT O CONNOR TX,5,1,1,2,9
Hurricane,Rita,26,2005-09-24T03:00:00Z,PENSACOLA FL,0,0,0,2,2
Hurricane,Rita,26,2005-09-24T03:00:00Z,CORPUSCHRISTI TX,0,0,1,3,4
Hurricane,Rita,26,2005-09-24T03:00:00Z,MOBILE AL,0,0,1,3,4
Hurricane,Rita,26,2005-09-24T03:00:00Z,GULF 28N 89W,0,0,0,2,2
Hurricane,Rita,26,2005-09-24T03:00:00Z,GULFPORT MS,0,0,1,4,5
Hurricane,Rita,26,2005-09-24T03:00:00Z,GULF 28N 91W,1,1,0,3,5
Hurricane,Rita,26,2005-09-24T03:00:00Z,BURAS LA,0,1,0,4,5
Hurricane,Rita,26,2005-09-24T03:00:00Z,GULF 28N 93W,99,0,0,0,99
Hurricane,Rita,26,2005-09-24T03:00:00Z,NEW ORLEANS LA,1,2,1,4,8
Hurricane,Rita,26,2005-09-24T03:00:00Z,GULF 28N 95W,8,1,0,2,11
Hurricane,Rita,26,2005-09-24T03:00:00Z,NEW IBERIA LA,46,0,0,0,46
Hurricane,Rita,26,2005-09-24T03:00:00Z,GULF 27N 96W,0,0,1,3,4
Hurricane,Rita,26,2005-09-24T03:00:00Z,PORT ARTHUR TX,86,0,0,0,86
Hurricane,Rita,27,2005-09-24T09:00:00Z,32.3N  94.5W,40,0,0,0,40
Hurricane,Rita,27,2005-09-24T09:00:00Z,PORT ARTHUR TX,99,0,0,0,99
Hurricane,Rita,27,2005-09-24T09:00:00Z,33.0N  94.0W,27,2,0,1,30
Hurricane,Rita,27,2005-09-24T09:00:00Z,GALVESTON TX,99,0,0,0,99
Hurricane,Rita,27,2005-09-24T09:00:00Z,33.5N  93.5W,18,3,2,2,25
Hurricane,Rita,27,2005-09-24T09:00:00Z,FREEPORT TX,17,0,1,0,18
Hurricane,Rita,27,2005-09-24T09:00:00Z,APALACHICOLA FL,0,0,0,2,2
Hurricane,Rita,27,2005-09-24T09:00:00Z,PORT O CONNOR TX,0,0,1,3,4
Hurricane,Rita,27,2005-09-24T09:00:00Z,PANAMA CITY FL,0,0,0,2,2
Hurricane,Rita,27,2005-09-24T09:00:00Z,CORPUSCHRISTI TX,0,0,0,2,2
Hurricane,Rita,27,2005-09-24T09:00:00Z,PENSACOLA FL,0,0,1,4,5
Hurricane,Rita,27,2005-09-24T09:00:00Z,GULF 29N 87W,0,0,1,3,4
Hurricane,Rita,27,2005-09-24T09:00:00Z,MOBILE AL,0,1,2,5,8
Hurricane,Rita,27,2005-09-24T09:00:00Z,GULF 28N 89W,0,0,2,3,5
Hurricane,Rita,27,2005-09-24T09:00:00Z,GULFPORT MS,0,2,4,4,10
Hurricane,Rita,27,2005-09-24T09:00:00Z,GULF 28N 91W,0,2,2,3,7
Hurricane,Rita,27,2005-09-24T09:00:00Z,BURAS LA,0,2,4,4,10
Hurricane,Rita,27,2005-09-24T09:00:00Z,GULF 28N 93W,0,2,2,3,7
Hurricane,Rita,27,2005-09-24T09:00:00Z,NEW ORLEANS LA,1,4,4,4,13
Hurricane,Rita,27,2005-09-24T09:00:00Z,GULF 28N 95W,0,1,0,3,4
Hurricane,Rita,27,2005-09-24T09:00:00Z,NEW IBERIA LA,59,0,0,0,59
Hurricane,Rita,27,2005-09-24T09:00:00Z,GULF 27N 96W,0,0,0,2,2
Hurricane,Rita,28,2005-09-24T15:00:00Z,34.0N  93.5W,46,0,0,0,46
Hurricane,Rita,28,2005-09-24T15:00:00Z,NEW ORLEANS LA,0,1,4,4,9
Hurricane,Rita,28,2005-09-24T15:00:00Z,34.5N  92.0W,22,3,1,1,27
Hurricane,Rita,28,2005-09-24T15:00:00Z,NEW IBERIA LA,0,3,3,4,10
Hurricane,Rita,28,2005-09-24T15:00:00Z,34.5N  91.5W,15,7,1,1,24
Hurricane,Rita,28,2005-09-24T15:00:00Z,PORT ARTHUR TX,99,0,0,0,99
Hurricane,Rita,28,2005-09-24T15:00:00Z,JACKSONVILLE FL,0,0,0,2,2
Hurricane,Rita,28,2005-09-24T15:00:00Z,GALVESTON TX,12,0,0,1,13
Hurricane,Rita,28,2005-09-24T15:00:00Z,SAVANNAH GA,0,0,0,2,2
Hurricane,Rita,28,2005-09-24T15:00:00Z,FREEPORT TX,1,0,1,2,4
Hurricane,Rita,28,2005-09-24T15:00:00Z,CEDAR KEY FL,0,0,0,2,2
Hurricane,Rita,28,2005-09-24T15:00:00Z,PORT O CONNOR TX,0,0,1,1,2
Hurricane,Rita,28,2005-09-24T15:00:00Z,ST MARKS FL,0,0,0,4,4
Hurricane,Rita,28,2005-09-24T15:00:00Z,GULF 29N 85W,0,0,0,4,4
Hurricane,Rita,28,2005-09-24T15:00:00Z,APALACHICOLA FL,0,0,0,4,4
Hurricane,Rita,28,2005-09-24T15:00:00Z,GULF 29N 87W,0,0,1,4,5
Hurricane,Rita,28,2005-09-24T15:00:00Z,PANAMA CITY FL,0,0,1,4,5
Hurricane,Rita,28,2005-09-24T15:00:00Z,GULF 28N 89W,0,0,1,3,4
Hurricane,Rita,28,2005-09-24T15:00:00Z,PENSACOLA FL,0,0,2,6,8
Hurricane,Rita,28,2005-09-24T15:00:00Z,GULF 28N 91W,0,0,1,3,4
Hurricane,Rita,28,2005-09-24T15:00:00Z,MOBILE AL,0,1,3,5,9
Hurricane,Rita,28,2005-09-24T15:00:00Z,GULF 28N 93W,0,0,1,2,3
Hurricane,Rita,28,2005-09-24T15:00:00Z,GULFPORT MS,0,1,4,4,9
Hurricane,Rita,28,2005-09-24T15:00:00Z,GULF 28N 95W,0,0,1,1,2
Hurricane,Rita,28,2005-09-24T15:00:00Z,BURAS LA,0,0,3,4,7
Tropical Storm,Rita,29,2005-09-24T21:00:00Z,35.0N  93.0W,47,0,0,0,47
Tropical Storm,Rita,29,2005-09-24T21:00:00Z,PANAMA CITY FL,0,0,2,5,7
Tropical Storm,Rita,29,2005-09-24T21:00:00Z,35.0N  91.5W,30,0,1,0,31
Tropical Storm,Rita,29,2005-09-24T21:00:00Z,PENSACOLA FL,0,1,3,5,9
Tropical Storm,Rita,29,2005-09-24T21:00:00Z,35.0N  90.0W,11,5,2,2,20
Tropical Storm,Rita,29,2005-09-24T21:00:00Z,MOBILE AL,0,1,4,4,9
Tropical Storm,Rita,29,2005-09-24T21:00:00Z,COCOA BEACH FL,0,0,0,2,2
Tropical Storm,Rita,29,2005-09-24T21:00:00Z,GULFPORT MS,0,1,4,4,9
Tropical Storm,Rita,29,2005-09-24T21:00:00Z,DAYTONA BEACH FL,0,0,0,2,2
Tropical Storm,Rita,29,2005-09-24T21:00:00Z,BURAS LA,0,0,2,4,6
Tropical Storm,Rita,29,2005-09-24T21:00:00Z,JACKSONVILLE FL,0,0,0,3,3
Tropical Storm,Rita,29,2005-09-24T21:00:00Z,NEW ORLEANS LA,0,1,3,3,7
Tropical Storm,Rita,29,2005-09-24T21:00:00Z,SAVANNAH GA,0,0,0,3,3
Tropical Storm,Rita,29,2005-09-24T21:00:00Z,NEW IBERIA LA,0,1,2,3,6
Tropical Storm,Rita,29,2005-09-24T21:00:00Z,CHARLESTON SC,0,0,0,2,2
Tropical Storm,Rita,29,2005-09-24T21:00:00Z,PORT ARTHUR TX,1,1,1,1,4
Tropical Storm,Rita,29,2005-09-24T21:00:00Z,VENICE FL,0,0,0,2,2
Tropical Storm,Rita,29,2005-09-24T21:00:00Z,GALVESTON TX,0,0,0,2,2
Tropical Storm,Rita,29,2005-09-24T21:00:00Z,TAMPA FL,0,0,0,2,2
Tropical Storm,Rita,29,2005-09-24T21:00:00Z,GULF 29N 85W,0,0,1,4,5
Tropical Storm,Rita,29,2005-09-24T21:00:00Z,CEDAR KEY FL,0,0,0,4,4
Tropical Storm,Rita,29,2005-09-24T21:00:00Z,GULF 29N 87W,0,0,1,4,5
Tropical Storm,Rita,29,2005-09-24T21:00:00Z,ST MARKS FL,0,0,1,5,6
Tropical Storm,Rita,29,2005-09-24T21:00:00Z,GULF 28N 89W,0,0,1,2,3
Tropical Storm,Rita,29,2005-09-24T21:00:00Z,APALACHICOLA FL,0,0,1,5,6
Tropical Storm,Rita,29,2005-09-24T21:00:00Z,GULF 28N 91W,0,0,0,2,2
Tropical Depression,Rita,30,2005-09-25T03:00:00Z,35.4N  91.8W,32,0,0,0,32
Tropical Depression,Rita,30,2005-09-25T03:00:00Z,APALACHICOLA FL,0,1,1,0,2
Tropical Depression,Rita,30,2005-09-25T03:00:00Z,36.3N  89.8W,8,8,1,0,17
Tropical Depression,Rita,30,2005-09-25T03:00:00Z,PANAMA CITY FL,0,1,2,0,3
Tropical Depression,Rita,30,2005-09-25T03:00:00Z,37.0N  87.6W,0,9,4,0,13
Tropical Depression,Rita,30,2005-09-25T03:00:00Z,PENSACOLA FL,0,3,1,0,4
Tropical Depression,Rita,30,2005-09-25T03:00:00Z,JACKSONVILLE FL,0,0,2,0,2
Tropical Depression,Rita,30,2005-09-25T03:00:00Z,MOBILE AL,1,2,1,0,4
Tropical Depression,Rita,30,2005-09-25T03:00:00Z,SAVANNAH GA,0,0,2,0,2
Tropical Depression,Rita,30,2005-09-25T03:00:00Z,GULFPORT MS,0,2,1,0,3
Tropical Depression,Rita,30,2005-09-25T03:00:00Z,ST MARKS FL,0,1,2,0,3
Tropical Depression,Nineteen,1,2005-09-30T21:00:00Z,12.2N  33.6W,99,0,0,0,99
Tropical Depression,Nineteen,1,2005-09-30T21:00:00Z,14.7N  35.3W,14,12,1,1,28
Tropical Depression,Nineteen,1,2005-09-30T21:00:00Z,13.1N  34.4W,45,0,0,0,45
Tropical Depression,Nineteen,2,2005-10-01T03:00:00Z,13.0N  33.9W,72,0,0,0,72
Tropical Depression,Nineteen,2,2005-10-01T03:00:00Z,15.8N  35.2W,16,11,1,1,29
Tropical Depression,Nineteen,2,2005-10-01T03:00:00Z,14.2N  34.6W,42,0,0,0,42
Tropical Depression,Nineteen,3,2005-10-01T09:00:00Z,15.0N  35.0W,62,0,0,0,62
Tropical Depression,Nineteen,3,2005-10-01T09:00:00Z,17.5N  36.5W,8,14,4,1,27
Tropical Depression,Nineteen,3,2005-10-01T09:00:00Z,16.0N  35.5W,39,1,0,0,40
Tropical Depression,Nineteen,4,2005-10-01T15:00:00Z,16.4N  35.0W,53,0,0,0,53
Tropical Depression,Nineteen,4,2005-10-01T15:00:00Z,20.0N  36.7W,3,19,2,1,25
Tropical Depression,Nineteen,4,2005-10-01T15:00:00Z,18.2N  35.9W,25,7,1,0,33
Tropical Depression,Nineteen,5,2005-10-01T21:00:00Z,17.8N  35.7W,52,0,0,0,52
Tropical Depression,Nineteen,5,2005-10-01T21:00:00Z,21.2N  37.1W,2,15,2,2,21
Tropical Depression,Nineteen,5,2005-10-01T21:00:00Z,19.5N  36.5W,22,7,0,1,30
Tropical Depression,Nineteen,6,2005-10-02T03:00:00Z,18.2N  35.3W,53,0,0,0,53
Tropical Depression,Nineteen,6,2005-10-02T03:00:00Z,22.0N  36.4W,1,13,4,2,20
Tropical Depression,Nineteen,6,2005-10-02T03:00:00Z,19.9N  36.0W,27,3,0,1,31
Tropical Depression,Nineteen,7,2005-10-02T09:00:00Z,18.9N  36.0W,40,0,0,0,40
Tropical Depression,Nineteen,7,2005-10-02T09:00:00Z,22.3N  36.6W,2,12,3,2,19
Tropical Depression,Nineteen,7,2005-10-02T09:00:00Z,20.5N  36.4W,20,4,1,0,25
Tropical Depression,Nineteen,8,2005-10-02T15:00:00Z,20.0N  38.9W,57,0,0,0,57
Tropical Depression,Twenty,1,2005-10-01T15:00:00Z,20.8N  88.8W,41,0,0,0,41
Tropical Depression,Twenty,1,2005-10-01T15:00:00Z,NEW IBERIA LA,0,0,0,3,3
Tropical Depression,Twenty,1,2005-10-01T15:00:00Z,21.7N  90.7W,12,17,0,1,30
Tropical Depression,Twenty,1,2005-10-01T15:00:00Z,PORT ARTHUR TX,0,0,0,4,4
Tropical Depression,Twenty,1,2005-10-01T15:00:00Z,22.5N  92.5W,0,20,3,1,24
Tropical Depression,Twenty,1,2005-10-01T15:00:00Z,GALVESTON TX,0,0,0,6,6
Tropical Depression,Twenty,1,2005-10-01T15:00:00Z,MUAN 219N 850W,5,1,0,1,7
Tropical Depression,Twenty,1,2005-10-01T15:00:00Z,FREEPORT TX,0,0,0,7,7
Tropical Depression,Twenty,1,2005-10-01T15:00:00Z,MMCZ 205N 869W,58,0,0,0,58
Tropical Depression,Twenty,1,2005-10-01T15:00:00Z,PORT O CONNOR TX,0,0,1,8,9
Tropical Depression,Twenty,1,2005-10-01T15:00:00Z,MZBZ 175N 883W,0,0,1,1,2
Tropical Depression,Twenty,1,2005-10-01T15:00:00Z,CORPUSCHRISTI TX,0,0,1,8,9
Tropical Depression,Twenty,1,2005-10-01T15:00:00Z,MMSO 238N 982W,0,0,3,10,13
Tropical Depression,Twenty,1,2005-10-01T15:00:00Z,BROWNSVILLE TX,0,0,3,10,13
Tropical Depression,Twenty,1,2005-10-01T15:00:00Z,MMTM 222N 979W,0,0,3,9,12
Tropical Depression,Twenty,1,2005-10-01T15:00:00Z,GULF 28N 89W,0,0,0,3,3
Tropical Depression,Twenty,1,2005-10-01T15:00:00Z,MMTX 210N 974W,0,0,2,9,11
Tropical Depression,Twenty,1,2005-10-01T15:00:00Z,GULF 28N 91W,0,0,1,5,6
Tropical Depression,Twenty,1,2005-10-01T15:00:00Z,MMVR 192N 961W,0,0,1,7,8
Tropical Depression,Twenty,1,2005-10-01T15:00:00Z,GULF 28N 93W,0,0,2,7,9
Tropical Depression,Twenty,1,2005-10-01T15:00:00Z,MMFR 185N 926W,0,2,3,3,8
Tropical Depression,Twenty,1,2005-10-01T15:00:00Z,GULF 28N 95W,0,0,2,8,10
Tropical Depression,Twenty,1,2005-10-01T15:00:00Z,MMMD 210N 897W,32,2,0,0,34
Tropical Depression,Twenty,1,2005-10-01T15:00:00Z,GULF 27N 96W,0,0,3,9,12
Tropical Depression,Twenty,1,2005-10-01T15:00:00Z,BURAS LA,0,0,0,2,2
Tropical Depression,Twenty,1,2005-10-01T15:00:00Z,GULF 25N 96W,0,0,9,7,16
Tropical Depression,Twenty,1,2005-10-01T15:00:00Z,NEW ORLEANS LA,0,0,0,2,2
Tropical Depression,Twenty,2,2005-10-01T21:00:00Z,20.4N  89.8W,41,0,0,0,41
Tropical Depression,Twenty,2,2005-10-01T21:00:00Z,MMMD 210N 897W,36,1,0,0,37
Tropical Depression,Twenty,2,2005-10-01T21:00:00Z,21.0N  91.8W,16,13,1,0,30
Tropical Depression,Twenty,2,2005-10-01T21:00:00Z,FREEPORT TX,0,0,0,2,2
Tropical Depression,Twenty,2,2005-10-01T21:00:00Z,21.4N  93.6W,1,19,3,1,24
Tropical Depression,Twenty,2,2005-10-01T21:00:00Z,PORT O CONNOR TX,0,0,0,3,3
Tropical Depression,Twenty,2,2005-10-01T21:00:00Z,MMCZ 205N 869W,62,0,0,0,62
Tropical Depression,Twenty,2,2005-10-01T21:00:00Z,CORPUSCHRISTI TX,0,0,0,4,4
Tropical Depression,Twenty,2,2005-10-01T21:00:00Z,MZBZ 175N 883W,3,0,1,0,4
Tropical Depression,Twenty,2,2005-10-01T21:00:00Z,BROWNSVILLE TX,0,0,1,8,9
Tropical Depression,Twenty,2,2005-10-01T21:00:00Z,MMSO 238N 982W,0,0,4,9,13
Tropical Depression,Twenty,2,2005-10-01T21:00:00Z,GULF 28N 91W,0,0,0,2,2
Tropical Depression,Twenty,2,2005-10-01T21:00:00Z,MMTM 222N 979W,0,0,8,7,15
Tropical Depression,Twenty,2,2005-10-01T21:00:00Z,GULF 28N 93W,0,0,0,3,3
Tropical Depression,Twenty,2,2005-10-01T21:00:00Z,MMTX 210N 974W,0,1,8,6,15
Tropical Depression,Twenty,2,2005-10-01T21:00:00Z,GULF 28N 95W,0,0,0,3,3
Tropical Depression,Twenty,2,2005-10-01T21:00:00Z,MMVR 192N 961W,0,1,5,6,12
Tropical Depression,Twenty,2,2005-10-01T21:00:00Z,GULF 27N 96W,0,0,0,6,6
Tropical Depression,Twenty,2,2005-10-01T21:00:00Z,MMFR 185N 926W,3,6,2,2,13
Tropical Depression,Twenty,2,2005-10-01T21:00:00Z,GULF 25N 96W,0,0,4,8,12
Tropical Depression,Twenty,3,2005-10-02T03:00:00Z,20.3N  90.2W,42,0,0,0,42
Tropical Depression,Twenty,3,2005-10-02T03:00:00Z,MMFR 185N 926W,6,6,1,1,14
Tropical Depression,Twenty,3,2005-10-02T03:00:00Z,20.8N  92.0W,18,10,1,0,29
Tropical Depression,Twenty,3,2005-10-02T03:00:00Z,MMMD 210N 897W,39,0,0,0,39
Tropical Depression,Twenty,3,2005-10-02T03:00:00Z,21.0N  93.8W,1,19,3,1,24
Tropical Depression,Twenty,3,2005-10-02T03:00:00Z,CORPUSCHRISTI TX,0,0,0,2,2
Tropical Depression,Twenty,3,2005-10-02T03:00:00Z,MMCZ 205N 869W,63,0,0,0,63
Tropical Depression,Twenty,3,2005-10-02T03:00:00Z,BROWNSVILLE TX,0,0,0,6,6
Tropical Depression,Twenty,3,2005-10-02T03:00:00Z,MZBZ 175N 883W,4,1,0,0,5
Tropical Depression,Twenty,3,2005-10-02T03:00:00Z,GULF 28N 93W,0,0,0,2,2
Tropical Depression,Twenty,3,2005-10-02T03:00:00Z,MMSO 238N 982W,0,0,3,8,11
Tropical Depression,Twenty,3,2005-10-02T03:00:00Z,GULF 28N 95W,0,0,0,2,2
Tropical Depression,Twenty,3,2005-10-02T03:00:00Z,MMTM 222N 979W,0,0,8,7,15
Tropical Depression,Twenty,3,2005-10-02T03:00:00Z,GULF 27N 96W,0,0,0,4,4
Tropical Depression,Twenty,3,2005-10-02T03:00:00Z,MMTX 210N 974W,0,1,9,6,16
Tropical Depression,Twenty,3,2005-10-02T03:00:00Z,GULF 25N 96W,0,0,3,7,10
Tropical Depression,Twenty,3,2005-10-02T03:00:00Z,MMVR 192N 961W,0,2,7,5,14
Tropical Storm,Stan,4,2005-10-02T09:00:00Z,20.7N  90.9W,44,0,0,0,44
Tropical Storm,Stan,4,2005-10-02T09:00:00Z,MMFR 185N 926W,6,4,1,2,13
Tropical Storm,Stan,4,2005-10-02T09:00:00Z,21.0N  92.9W,17,13,1,0,31
Tropical Storm,Stan,4,2005-10-02T09:00:00Z,MMMD 210N 897W,50,0,0,0,50
Tropical Storm,Stan,4,2005-10-02T09:00:00Z,20.9N  94.5W,2,20,2,1,25
Tropical Storm,Stan,4,2005-10-02T09:00:00Z,PORT O CONNOR TX,0,0,0,2,2
Tropical Storm,Stan,4,2005-10-02T09:00:00Z,MMCZ 205N 869W,99,0,0,0,99
Tropical Storm,Stan,4,2005-10-02T09:00:00Z,CORPUSCHRISTI TX,0,0,0,3,3
Tropical Storm,Stan,4,2005-10-02T09:00:00Z,MZBZ 175N 883W,1,0,0,1,2
Tropical Storm,Stan,4,2005-10-02T09:00:00Z,BROWNSVILLE TX,0,0,1,6,7
Tropical Storm,Stan,4,2005-10-02T09:00:00Z,MMSO 238N 982W,0,0,5,7,12
Tropical Storm,Stan,4,2005-10-02T09:00:00Z,GULF 28N 93W,0,0,0,2,2
Tropical Storm,Stan,4,2005-10-02T09:00:00Z,MMTM 222N 979W,0,1,9,6,16
Tropical Storm,Stan,4,2005-10-02T09:00:00Z,GULF 28N 95W,0,0,0,3,3
Tropical Storm,Stan,4,2005-10-02T09:00:00Z,MMTX 210N 974W,0,3,10,5,18
Tropical Storm,Stan,4,2005-10-02T09:00:00Z,GULF 27N 96W,0,0,0,5,5
Tropical Storm,Stan,4,2005-10-02T09:00:00Z,MMVR 192N 961W,0,4,7,5,16
Tropical Storm,Stan,4,2005-10-02T09:00:00Z,GULF 25N 96W,0,0,4,7,11
Tropical Storm,Stan,5,2005-10-02T15:00:00Z,20.8N  91.4W,43,0,0,0,43
Tropical Storm,Stan,5,2005-10-02T15:00:00Z,MMFR 185N 926W,8,4,0,2,14
Tropical Storm,Stan,5,2005-10-02T15:00:00Z,21.0N  93.5W,16,14,1,0,31
Tropical Storm,Stan,5,2005-10-02T15:00:00Z,MMMD 210N 897W,55,0,0,0,55
Tropical Storm,Stan,5,2005-10-02T15:00:00Z,20.7N  95.2W,1,20,2,1,24
Tropical Storm,Stan,5,2005-10-02T15:00:00Z,CORPUSCHRISTI TX,0,0,0,2,2
Tropical Storm,Stan,5,2005-10-02T15:00:00Z,MMCZ 205N 869W,74,0,0,0,74
Tropical Storm,Stan,5,2005-10-02T15:00:00Z,BROWNSVILLE TX,0,0,0,6,6
Tropical Storm,Stan,5,2005-10-02T15:00:00Z,MMSO 238N 982W,0,0,5,7,12
Tropical Storm,Stan,5,2005-10-02T15:00:00Z,GULF 28N 95W,0,0,0,2,2
Tropical Storm,Stan,5,2005-10-02T15:00:00Z,MMTM 222N 979W,0,2,11,4,17
Tropical Storm,Stan,5,2005-10-02T15:00:00Z,GULF 27N 96W,0,0,0,3,3
Tropical Storm,Stan,5,2005-10-02T15:00:00Z,MMTX 210N 974W,0,6,10,4,20
Tropical Storm,Stan,5,2005-10-02T15:00:00Z,GULF 25N 96W,0,0,3,6,9
Tropical Storm,Stan,5,2005-10-02T15:00:00Z,MMVR 192N 961W,0,6,7,4,17
Tropical Storm,Stan,6,2005-10-02T21:00:00Z,21.3N  93.0W,44,0,0,0,44
Tropical Storm,Stan,6,2005-10-02T21:00:00Z,MMFR 185N 926W,3,2,1,2,8
Tropical Storm,Stan,6,2005-10-02T21:00:00Z,21.1N  94.9W,21,9,1,0,31
Tropical Storm,Stan,6,2005-10-02T21:00:00Z,MMMD 210N 897W,99,0,0,0,99
Tropical Storm,Stan,6,2005-10-02T21:00:00Z,21.0N  96.1W,5,19,1,1,26
Tropical Storm,Stan,6,2005-10-02T21:00:00Z,CORPUSCHRISTI TX,0,0,0,2,2
Tropical Storm,Stan,6,2005-10-02T21:00:00Z,MMSO 238N 982W,0,2,7,5,14
Tropical Storm,Stan,6,2005-10-02T21:00:00Z,BROWNSVILLE TX,0,0,1,6,7
Tropical Storm,Stan,6,2005-10-02T21:00:00Z,MMTM 222N 979W,0,11,6,3,20
Tropical Storm,Stan,6,2005-10-02T21:00:00Z,GULF 27N 96W,0,0,0,3,3
Tropical Storm,Stan,6,2005-10-02T21:00:00Z,MMTX 210N 974W,1,15,3,3,22
Tropical Storm,Stan,6,2005-10-02T21:00:00Z,GULF 25N 96W,0,1,3,6,10
Tropical Storm,Stan,6,2005-10-02T21:00:00Z,MMVR 192N 961W,2,8,3,3,16
Tropical Depression,Stan,7,2005-10-03T03:00:00Z,21.0N  93.3W,45,0,0,0,45
Tropical Depression,Stan,7,2005-10-03T03:00:00Z,MMFR 185N 926W,5,1,3,3,12
Tropical Depression,Stan,7,2005-10-03T03:00:00Z,20.7N  94.7W,27,2,1,0,30
Tropical Depression,Stan,7,2005-10-03T03:00:00Z,MMMD 210N 897W,99,0,0,0,99
Tropical Depression,Stan,7,2005-10-03T03:00:00Z,20.4N  95.8W,12,11,1,2,26
Tropical Depression,Stan,7,2005-10-03T03:00:00Z,CORPUSCHRISTI TX,0,0,0,2,2
Tropical Depression,Stan,7,2005-10-03T03:00:00Z,MMSO 238N 982W,0,1,5,7,13
Tropical Depression,Stan,7,2005-10-03T03:00:00Z,BROWNSVILLE TX,0,0,1,5,6
Tropical Depression,Stan,7,2005-10-03T03:00:00Z,MMTM 222N 979W,0,6,8,4,18
Tropical Depression,Stan,7,2005-10-03T03:00:00Z,GULF 28N 95W,0,0,0,2,2
Tropical Depression,Stan,7,2005-10-03T03:00:00Z,MMTX 210N 974W,0,14,4,3,21
Tropical Depression,Stan,7,2005-10-03T03:00:00Z,GULF 27N 96W,0,0,0,3,3
Tropical Depression,Stan,7,2005-10-03T03:00:00Z,MMVR 192N 961W,5,10,3,2,20
Tropical Depression,Stan,7,2005-10-03T03:00:00Z,GULF 25N 96W,0,0,3,6,9
Tropical Storm,Stan,8,2005-10-03T09:00:00Z,20.4N  94.2W,48,0,0,0,48
Tropical Storm,Stan,8,2005-10-03T09:00:00Z,MMFR 185N 926W,4,1,2,3,10
Tropical Storm,Stan,8,2005-10-03T09:00:00Z,20.2N  95.2W,31,1,0,0,32
Tropical Storm,Stan,8,2005-10-03T09:00:00Z,MMMD 210N 897W,7,0,1,0,8
Tropical Storm,Stan,8,2005-10-03T09:00:00Z,20.0N  96.3W,15,8,1,1,25
Tropical Storm,Stan,8,2005-10-03T09:00:00Z,CORPUSCHRISTI TX,0,0,0,2,2
Tropical Storm,Stan,8,2005-10-03T09:00:00Z,MMSO 238N 982W,0,0,5,7,12
Tropical Storm,Stan,8,2005-10-03T09:00:00Z,BROWNSVILLE TX,0,0,0,5,5
Tropical Storm,Stan,8,2005-10-03T09:00:00Z,MMTM 222N 979W,0,6,7,5,18
Tropical Storm,Stan,8,2005-10-03T09:00:00Z,GULF 27N 96W,0,0,0,2,2
Tropical Storm,Stan,8,2005-10-03T09:00:00Z,MMTX 210N 974W,1,14,4,3,22
Tropical Storm,Stan,8,2005-10-03T09:00:00Z,GULF 25N 96W,0,0,2,6,8
Tropical Storm,Stan,8,2005-10-03T09:00:00Z,MMVR 192N 961W,16,5,1,2,24
Tropical Storm,Stan,9,2005-10-03T15:00:00Z,20.0N  94.7W,52,1,0,0,53
Tropical Storm,Stan,9,2005-10-03T15:00:00Z,MMVR 192N 961W,23,2,1,1,27
Tropical Storm,Stan,9,2005-10-03T15:00:00Z,19.8N  95.5W,35,1,0,0,36
Tropical Storm,Stan,9,2005-10-03T15:00:00Z,MMFR 185N 926W,4,1,2,4,11
Tropical Storm,Stan,9,2005-10-03T15:00:00Z,19.5N  96.2W,23,2,1,1,27
Tropical Storm,Stan,9,2005-10-03T15:00:00Z,MMMD 210N 897W,0,0,0,3,3
Tropical Storm,Stan,9,2005-10-03T15:00:00Z,MMSO 238N 982W,0,0,3,7,10
Tropical Storm,Stan,9,2005-10-03T15:00:00Z,BROWNSVILLE TX,0,0,0,4,4
Tropical Storm,Stan,9,2005-10-03T15:00:00Z,MMTM 222N 979W,0,5,6,5,16
Tropical Storm,Stan,9,2005-10-03T15:00:00Z,GULF 27N 96W,0,0,0,2,2
Tropical Storm,Stan,9,2005-10-03T15:00:00Z,MMTX 210N 974W,2,12,4,3,21
Tropical Storm,Stan,9,2005-10-03T15:00:00Z,GULF 25N 96W,0,0,1,5,6
Tropical Storm,Stan,10,2005-10-03T21:00:00Z,19.4N  94.2W,57,0,0,0,57
Tropical Storm,Stan,10,2005-10-03T21:00:00Z,MMVR 192N 961W,16,6,2,1,25
Tropical Storm,Stan,10,2005-10-03T21:00:00Z,19.2N  95.0W,37,1,0,0,38
Tropical Storm,Stan,10,2005-10-03T21:00:00Z,MMFR 185N 926W,21,0,0,1,22
Tropical Storm,Stan,10,2005-10-03T21:00:00Z,19.1N  95.8W,21,3,1,1,26
Tropical Storm,Stan,10,2005-10-03T21:00:00Z,MMMD 210N 897W,0,0,1,2,3
Tropical Storm,Stan,10,2005-10-03T21:00:00Z,MMSO 238N 982W,0,0,2,7,9
Tropical Storm,Stan,10,2005-10-03T21:00:00Z,BROWNSVILLE TX,0,0,0,4,4
Tropical Storm,Stan,10,2005-10-03T21:00:00Z,MMTM 222N 979W,0,1,7,6,14
Tropical Storm,Stan,10,2005-10-03T21:00:00Z,GULF 27N 96W,0,0,0,2,2
Tropical Storm,Stan,10,2005-10-03T21:00:00Z,MMTX 210N 974W,0,8,6,4,18
Tropical Storm,Stan,10,2005-10-03T21:00:00Z,GULF 25N 96W,0,0,1,5,6
Tropical Storm,Stan,11,2005-10-04T03:00:00Z,19.4N  94.8W,57,0,0,0,57
Tropical Storm,Stan,11,2005-10-04T03:00:00Z,MMVR 192N 961W,27,1,1,0,29
Tropical Storm,Stan,11,2005-10-04T03:00:00Z,19.1N  95.5W,37,0,0,0,37
Tropical Storm,Stan,11,2005-10-04T03:00:00Z,MMFR 185N 926W,17,0,1,0,18
Tropical Storm,Stan,11,2005-10-04T03:00:00Z,18.9N  96.0W,27,1,1,1,30
Tropical Storm,Stan,11,2005-10-04T03:00:00Z,MMMD 210N 897W,0,0,0,3,3
Tropical Storm,Stan,11,2005-10-04T03:00:00Z,MMSO 238N 982W,0,0,1,7,8
Tropical Storm,Stan,11,2005-10-04T03:00:00Z,BROWNSVILLE TX,0,0,0,3,3
Tropical Storm,Stan,11,2005-10-04T03:00:00Z,MMTM 222N 979W,0,2,6,6,14
Tropical Storm,Stan,11,2005-10-04T03:00:00Z,GULF 27N 96W,0,0,0,2,2
Tropical Storm,Stan,11,2005-10-04T03:00:00Z,MMTX 210N 974W,2,9,4,4,19
Tropical Storm,Stan,11,2005-10-04T03:00:00Z,GULF 25N 96W,0,0,1,4,5
Tropical Storm,Stan,12,2005-10-04T06:00:00Z,18.9N  94.9W,73,0,0,0,73
Tropical Storm,Stan,12,2005-10-04T06:00:00Z,MMVR 192N 961W,36,0,1,0,37
Tropical Storm,Stan,12,2005-10-04T06:00:00Z,18.7N  95.2W,60,0,0,0,60
Tropical Storm,Stan,12,2005-10-04T06:00:00Z,MMFR 185N 926W,15,0,1,2,18
Tropical Storm,Stan,12,2005-10-04T06:00:00Z,18.5N  95.5W,48,0,0,0,48
Tropical Storm,Stan,12,2005-10-04T06:00:00Z,MMMD 210N 897W,0,0,0,3,3
Tropical Storm,Stan,12,2005-10-04T06:00:00Z,MMSO 238N 982W,0,0,1,6,7
Tropical Storm,Stan,12,2005-10-04T06:00:00Z,BROWNSVILLE TX,0,0,0,3,3
Tropical Storm,Stan,12,2005-10-04T06:00:00Z,MMTM 222N 979W,0,1,3,8,12
Tropical Storm,Stan,12,2005-10-04T06:00:00Z,GULF 27N 96W,0,0,0,2,2
Tropical Storm,Stan,12,2005-10-04T06:00:00Z,MMTX 210N 974W,1,6,5,4,16
Tropical Storm,Stan,12,2005-10-04T06:00:00Z,GULF 25N 96W,0,0,0,5,5
Hurricane,Stan,13,2005-10-04T09:00:00Z,18.2N  96.2W,55,0,0,0,55
Hurricane,Stan,13,2005-10-04T09:00:00Z,MMTX 210N 974W,6,0,0,0,6
Hurricane,Stan,13,2005-10-04T09:00:00Z,,99,0,0,0,99
Hurricane,Stan,13,2005-10-04T09:00:00Z,MMVR 192N 961W,59,0,0,0,59
Hurricane,Stan,13,2005-10-04T09:00:00Z,,99,0,0,0,99
Hurricane,Stan,14,2005-10-04T15:00:00Z,18.0N  96.2W,62,0,0,0,62
Hurricane,Stan,14,2005-10-04T15:00:00Z,MMTX 210N 974W,5,0,0,0,5
Hurricane,Stan,14,2005-10-04T15:00:00Z,,99,0,0,0,99
Hurricane,Stan,14,2005-10-04T15:00:00Z,MMVR 192N 961W,74,0,0,0,74
Hurricane,Stan,14,2005-10-04T15:00:00Z,,99,0,0,0,99
Tropical Storm,Stan,15,2005-10-04T21:00:00Z,,99,0,0,0,99
Tropical Storm,Stan,15,2005-10-04T21:00:00Z,,99,0,0,0,99
Tropical Storm,Stan,15,2005-10-04T21:00:00Z,,99,0,0,0,99
Tropical Storm,Stan,15,2005-10-04T21:00:00Z,MMVR 192N 961W,38,0,0,0,38
Tropical Depression,Stan,17,2005-10-05T09:00:00Z,,99,0,0,0,99
Tropical Depression,Stan,17,2005-10-05T09:00:00Z,,99,0,0,0,99
Tropical Depression,Stan,17,2005-10-05T09:00:00Z,,99,0,0,0,99
Tropical Storm,Tammy,1,2005-10-05T11:30:00Z,30.9N  82.4W,41,0,0,0,41
Tropical Storm,Tammy,1,2005-10-05T11:30:00Z,FT MYERS FL,39,0,0,0,39
Tropical Storm,Tammy,1,2005-10-05T11:30:00Z,31.9N  83.5W,28,3,0,0,31
Tropical Storm,Tammy,1,2005-10-05T11:30:00Z,VENICE FL,15,0,1,0,16
Tropical Storm,Tammy,1,2005-10-05T11:30:00Z,32.8N  84.4W,12,11,1,0,24
Tropical Storm,Tammy,1,2005-10-05T11:30:00Z,TAMPA FL,42,0,0,0,42
Tropical Storm,Tammy,1,2005-10-05T11:30:00Z,MYGF 266N 787W,15,0,1,0,16
Tropical Storm,Tammy,1,2005-10-05T11:30:00Z,CEDAR KEY FL,38,1,0,0,39
Tropical Storm,Tammy,1,2005-10-05T11:30:00Z,MIAMI FL,70,0,0,0,70
Tropical Storm,Tammy,1,2005-10-05T11:30:00Z,ST MARKS FL,25,1,1,0,27
Tropical Storm,Tammy,1,2005-10-05T11:30:00Z,W PALM BEACH FL,99,0,0,0,99
Tropical Storm,Tammy,1,2005-10-05T11:30:00Z,APALACHICOLA FL,11,5,1,0,17
Tropical Storm,Tammy,1,2005-10-05T11:30:00Z,FT PIERCE FL,99,0,0,0,99
Tropical Storm,Tammy,1,2005-10-05T11:30:00Z,PANAMA CITY FL,6,7,3,0,16
Tropical Storm,Tammy,1,2005-10-05T11:30:00Z,COCOA BEACH FL,99,0,0,0,99
Tropical Storm,Tammy,1,2005-10-05T11:30:00Z,PENSACOLA FL,0,6,4,0,10
Tropical Storm,Tammy,1,2005-10-05T11:30:00Z,DAYTONA BEACH FL,86,0,0,0,86
Tropical Storm,Tammy,1,2005-10-05T11:30:00Z,MOBILE AL,0,2,4,0,6
Tropical Storm,Tammy,1,2005-10-05T11:30:00Z,JACKSONVILLE FL,49,0,0,0,49
Tropical Storm,Tammy,1,2005-10-05T11:30:00Z,GULFPORT MS,0,0,3,0,3
Tropical Storm,Tammy,1,2005-10-05T11:30:00Z,SAVANNAH GA,17,2,1,0,20
Tropical Storm,Tammy,1,2005-10-05T11:30:00Z,GULF 29N 85W,6,5,2,0,13
Tropical Storm,Tammy,1,2005-10-05T11:30:00Z,CHARLESTON SC,2,2,2,0,6
Tropical Storm,Tammy,1,2005-10-05T11:30:00Z,GULF 29N 87W,0,2,3,0,5
Tropical Storm,Tammy,1,2005-10-05T11:30:00Z,MARCO ISLAND FL,19,0,0,0,19
Tropical Storm,Tammy,2,2005-10-05T15:00:00Z,31.4N  82.6W,42,1,0,0,43
Tropical Storm,Tammy,2,2005-10-05T15:00:00Z,TAMPA FL,0,2,0,0,2
Tropical Storm,Tammy,2,2005-10-05T15:00:00Z,32.3N  83.8W,24,3,0,0,27
Tropical Storm,Tammy,2,2005-10-05T15:00:00Z,CEDAR KEY FL,8,3,0,0,11
Tropical Storm,Tammy,2,2005-10-05T15:00:00Z,FT PIERCE FL,99,0,0,0,99
Tropical Storm,Tammy,2,2005-10-05T15:00:00Z,ST MARKS FL,18,2,0,0,20
Tropical Storm,Tammy,2,2005-10-05T15:00:00Z,COCOA BEACH FL,99,0,0,0,99
Tropical Storm,Tammy,2,2005-10-05T15:00:00Z,APALACHICOLA FL,5,5,0,0,10
Tropical Storm,Tammy,2,2005-10-05T15:00:00Z,DAYTONA BEACH FL,99,0,0,0,99
Tropical Storm,Tammy,2,2005-10-05T15:00:00Z,PANAMA CITY FL,4,6,0,0,10
Tropical Storm,Tammy,2,2005-10-05T15:00:00Z,JACKSONVILLE FL,68,0,0,0,68
Tropical Storm,Tammy,2,2005-10-05T15:00:00Z,PENSACOLA FL,1,4,0,0,5
Tropical Storm,Tammy,2,2005-10-05T15:00:00Z,SAVANNAH GA,21,1,0,0,22
Tropical Storm,Tammy,2,2005-10-05T15:00:00Z,MOBILE AL,0,2,0,0,2
Tropical Storm,Tammy,2,2005-10-05T15:00:00Z,CHARLESTON SC,3,2,0,0,5
Tropical Storm,Tammy,2,2005-10-05T15:00:00Z,GULF 29N 85W,1,3,0,0,4
Tropical Storm,Tammy,3,2005-10-05T21:00:00Z,32.2N  83.8W,38,0,0,0,38
Tropical Storm,Tammy,3,2005-10-05T21:00:00Z,CEDAR KEY FL,6,0,0,0,6
Tropical Storm,Tammy,3,2005-10-05T21:00:00Z,COCOA BEACH FL,2,0,0,0,2
Tropical Storm,Tammy,3,2005-10-05T21:00:00Z,ST MARKS FL,16,0,0,0,16
Tropical Storm,Tammy,3,2005-10-05T21:00:00Z,DAYTONA BEACH FL,99,0,0,0,99
Tropical Storm,Tammy,3,2005-10-05T21:00:00Z,APALACHICOLA FL,5,0,0,0,5
Tropical Storm,Tammy,3,2005-10-05T21:00:00Z,JACKSONVILLE FL,99,0,0,0,99
Tropical Storm,Tammy,3,2005-10-05T21:00:00Z,PANAMA CITY FL,6,0,0,0,6
Tropical Storm,Tammy,3,2005-10-05T21:00:00Z,SAVANNAH GA,36,0,0,0,36
Tropical Storm,Tammy,3,2005-10-05T21:00:00Z,PENSACOLA FL,3,0,0,0,3
Tropical Storm,Tammy,3,2005-10-05T21:00:00Z,CHARLESTON SC,5,0,0,0,5
Tropical Storm,Tammy,4,2005-10-06T03:00:00Z,33.0N  85.0W,45,0,0,0,45
Tropical Storm,Tammy,4,2005-10-06T03:00:00Z,SAVANNAH GA,94,0,0,0,94
Tropical Storm,Tammy,4,2005-10-06T03:00:00Z,DAYTONA BEACH FL,40,0,0,0,40
Tropical Storm,Tammy,4,2005-10-06T03:00:00Z,CEDAR KEY FL,8,0,0,0,8
Tropical Storm,Tammy,4,2005-10-06T03:00:00Z,JACKSONVILLE FL,99,0,0,0,99
Tropical Storm,Tammy,4,2005-10-06T03:00:00Z,ST MARKS FL,12,0,0,0,12
Subtropical Depression,Twenty-Two,1,2005-10-08T15:00:00Z,30.4N  63.4W,34,0,0,0,34
Subtropical Depression,Twenty-Two,1,2005-10-08T15:00:00Z,WILMINGTON NC,0,0,0,7,7
Subtropical Depression,Twenty-Two,1,2005-10-08T15:00:00Z,31.2N  66.4W,4,21,1,0,26
Subtropical Depression,Twenty-Two,1,2005-10-08T15:00:00Z,MOREHEAD CITY NC,0,0,0,9,9
Subtropical Depression,Twenty-Two,1,2005-10-08T15:00:00Z,32.3N  68.3W,0,15,5,2,22
Subtropical Depression,Twenty-Two,1,2005-10-08T15:00:00Z,CAPE HATTERAS NC,0,0,1,9,10
Subtropical Depression,Twenty-Two,1,2005-10-08T15:00:00Z,BERMUDA,3,16,1,1,21
Subtropical Depression,Twenty-Two,1,2005-10-08T15:00:00Z,NORFOLK VA,0,0,0,7,7
Subtropical Depression,Twenty-Two,1,2005-10-08T15:00:00Z,SAVANNAH GA,0,0,0,2,2
Subtropical Depression,Twenty-Two,1,2005-10-08T15:00:00Z,OCEAN CITY MD,0,0,0,6,6
Subtropical Depression,Twenty-Two,1,2005-10-08T15:00:00Z,CHARLESTON SC,0,0,0,3,3
Subtropical Depression,Twenty-Two,1,2005-10-08T15:00:00Z,ATLANTIC CITY NJ,0,0,0,4,4
Subtropical Depression,Twenty-Two,1,2005-10-08T15:00:00Z,MYRTLE BEACH SC,0,0,0,5,5
Subtropical Depression,Twenty-Two,1,2005-10-08T15:00:00Z,NEW YORK CITY NY,0,0,0,2,2
Subtropical Depression,Twenty-Two,2,2005-10-08T21:00:00Z,31.1N  65.5W,57,0,0,0,57
Subtropical Depression,Twenty-Two,2,2005-10-08T21:00:00Z,WILMINGTON NC,0,0,1,7,8
Subtropical Depression,Twenty-Two,2,2005-10-08T21:00:00Z,31.9N  67.9W,9,25,0,1,35
Subtropical Depression,Twenty-Two,2,2005-10-08T21:00:00Z,MOREHEAD CITY NC,0,0,1,8,9
Subtropical Depression,Twenty-Two,2,2005-10-08T21:00:00Z,33.0N  69.8W,0,18,4,1,23
Subtropical Depression,Twenty-Two,2,2005-10-08T21:00:00Z,CAPE HATTERAS NC,0,0,2,8,10
Subtropical Depression,Twenty-Two,2,2005-10-08T21:00:00Z,BERMUDA,37,1,0,0,38
Subtropical Depression,Twenty-Two,2,2005-10-08T21:00:00Z,NORFOLK VA,0,0,0,7,7
Subtropical Depression,Twenty-Two,2,2005-10-08T21:00:00Z,SAVANNAH GA,0,0,0,3,3
Subtropical Depression,Twenty-Two,2,2005-10-08T21:00:00Z,OCEAN CITY MD,0,0,0,5,5
Subtropical Depression,Twenty-Two,2,2005-10-08T21:00:00Z,CHARLESTON SC,0,0,0,4,4
Subtropical Depression,Twenty-Two,2,2005-10-08T21:00:00Z,ATLANTIC CITY NJ,0,0,0,3,3
Subtropical Depression,Twenty-Two,2,2005-10-08T21:00:00Z,MYRTLE BEACH SC,0,0,0,6,6
Subtropical Depression,Twenty-Two,2,2005-10-08T21:00:00Z,NEW YORK CITY NY,0,0,0,2,2
Subtropical Depression,Twenty-Two,3,2005-10-09T03:00:00Z,30.6N  67.4W,65,0,0,0,65
Subtropical Depression,Twenty-Two,3,2005-10-09T03:00:00Z,SAVANNAH GA,0,0,0,4,4
Subtropical Depression,Twenty-Two,3,2005-10-09T03:00:00Z,31.3N  69.5W,27,10,0,0,37
Subtropical Depression,Twenty-Two,3,2005-10-09T03:00:00Z,CHARLESTON SC,0,0,0,5,5
Subtropical Depression,Twenty-Two,3,2005-10-09T03:00:00Z,31.8N  71.3W,1,22,1,1,25
Subtropical Depression,Twenty-Two,3,2005-10-09T03:00:00Z,MYRTLE BEACH SC,0,0,0,6,6
Subtropical Depression,Twenty-Two,3,2005-10-09T03:00:00Z,MYGF 266N 787W,0,0,0,2,2
Subtropical Depression,Twenty-Two,3,2005-10-09T03:00:00Z,WILMINGTON NC,0,0,1,6,7
Subtropical Depression,Twenty-Two,3,2005-10-09T03:00:00Z,BERMUDA,3,2,0,2,7
Subtropical Depression,Twenty-Two,3,2005-10-09T03:00:00Z,MOREHEAD CITY NC,0,0,1,7,8
Subtropical Depression,Twenty-Two,3,2005-10-09T03:00:00Z,W PALM BEACH FL,0,0,0,2,2
Subtropical Depression,Twenty-Two,3,2005-10-09T03:00:00Z,CAPE HATTERAS NC,0,0,2,6,8
Subtropical Depression,Twenty-Two,3,2005-10-09T03:00:00Z,FT PIERCE FL,0,0,0,3,3
Subtropical Depression,Twenty-Two,3,2005-10-09T03:00:00Z,NORFOLK VA,0,0,0,4,4
Subtropical Depression,Twenty-Two,3,2005-10-09T03:00:00Z,COCOA BEACH FL,0,0,0,3,3
Subtropical Depression,Twenty-Two,3,2005-10-09T03:00:00Z,OCEAN CITY MD,0,0,0,2,2
Subtropical Depression,Twenty-Two,3,2005-10-09T03:00:00Z,DAYTONA BEACH FL,0,0,0,3,3
Subtropical Depression,Twenty-Two,3,2005-10-09T03:00:00Z,TAMPA FL,0,0,0,2,2
Subtropical Depression,Twenty-Two,3,2005-10-09T03:00:00Z,JACKSONVILLE FL,0,0,0,3,3
Subtropical Depression,Twenty-Two,3,2005-10-09T03:00:00Z,CEDAR KEY FL,0,0,0,2,2
Tropical Storm,Vince,1,2005-10-09T15:00:00Z,36.3N  16.1W,30,0,0,0,30
Tropical Storm,Vince,1,2005-10-09T15:00:00Z,39.1N  13.6W,4,13,0,0,17
Hurricane,Vince,2,2005-10-09T21:00:00Z,37.6N  14.5W,26,1,0,0,27
Hurricane,Vince,2,2005-10-09T21:00:00Z,40.5N  11.0W,2,14,0,0,16
Hurricane,Vince,3,2005-10-10T03:00:00Z,38.0N  12.0W,26,0,0,0,26
Hurricane,Vince,3,2005-10-10T03:00:00Z,40.0N   8.0W,6,10,0,0,16
Tropical Depression,Twenty-Four,1,2005-10-15T21:00:00Z,17.5N  80.0W,58,0,0,0,58
Tropical Depression,Twenty-Four,1,2005-10-15T21:00:00Z,MUHA 230N 824W,0,0,2,7,9
Tropical Depression,Twenty-Four,1,2005-10-15T21:00:00Z,17.5N  80.5W,43,0,0,0,43
Tropical Depression,Twenty-Four,1,2005-10-15T21:00:00Z,MUAN 219N 850W,0,0,2,9,11
Tropical Depression,Twenty-Four,1,2005-10-15T21:00:00Z,17.5N  81.0W,29,1,1,1,32
Tropical Depression,Twenty-Four,1,2005-10-15T21:00:00Z,MMCZ 205N 869W,0,0,1,8,9
Tropical Depression,Twenty-Four,1,2005-10-15T21:00:00Z,MKJP 179N 768W,0,2,3,6,11
Tropical Depression,Twenty-Four,1,2005-10-15T21:00:00Z,MZBZ 175N 883W,0,0,0,4,4
Tropical Depression,Twenty-Four,1,2005-10-15T21:00:00Z,MKJS 185N 779W,57,0,0,0,57
Tropical Depression,Twenty-Four,1,2005-10-15T21:00:00Z,MHNJ 165N 859W,0,0,2,7,9
Tropical Depression,Twenty-Four,1,2005-10-15T21:00:00Z,MWCG 193N 814W,14,6,2,3,25
Tropical Depression,Twenty-Four,1,2005-10-15T21:00:00Z,MNPC 141N 834W,0,1,1,5,7
Tropical Depression,Twenty-Four,1,2005-10-15T21:00:00Z,MUGM 200N 751W,0,0,0,3,3
Tropical Depression,Twenty-Four,1,2005-10-15T21:00:00Z,SKSP 126N 817W,0,0,0,3,3
Tropical Depression,Twenty-Four,1,2005-10-15T21:00:00Z,MUCM 214N 779W,1,2,2,4,9
Tropical Depression,Twenty-Four,1,2005-10-15T21:00:00Z,MMMD 210N 897W,0,0,0,2,2
Tropical Depression,Twenty-Four,1,2005-10-15T21:00:00Z,MUCF 221N 805W,0,3,4,5,12
Tropical Depression,Twenty-Four,1,2005-10-15T21:00:00Z,MARATHON FL,0,0,0,2,2
Tropical Depression,Twenty-Four,1,2005-10-15T21:00:00Z,MUSN 216N 826W,0,2,6,7,15
Tropical Depression,Twenty-Four,1,2005-10-15T21:00:00Z,KEY WEST FL,0,0,0,3,3
Tropical Depression,Twenty-Four,2,2005-10-16T03:00:00Z,16.6N  80.0W,99,0,0,0,99
Tropical Depression,Twenty-Four,2,2005-10-16T03:00:00Z,MUSN 216N 826W,0,1,3,8,12
Tropical Depression,Twenty-Four,2,2005-10-16T03:00:00Z,16.6N  80.4W,42,0,0,0,42
Tropical Depression,Twenty-Four,2,2005-10-16T03:00:00Z,MUHA 230N 824W,0,0,1,5,6
Tropical Depression,Twenty-Four,2,2005-10-16T03:00:00Z,16.8N  80.8W,34,1,0,0,35
Tropical Depression,Twenty-Four,2,2005-10-16T03:00:00Z,MUAN 219N 850W,0,0,1,7,8
Tropical Depression,Twenty-Four,2,2005-10-16T03:00:00Z,MTCA 183N 738W,0,0,0,3,3
Tropical Depression,Twenty-Four,2,2005-10-16T03:00:00Z,MMCZ 205N 869W,0,0,0,7,7
Tropical Depression,Twenty-Four,2,2005-10-16T03:00:00Z,MKJP 179N 768W,0,2,4,6,12
Tropical Depression,Twenty-Four,2,2005-10-16T03:00:00Z,MZBZ 175N 883W,0,0,0,4,4
Tropical Depression,Twenty-Four,2,2005-10-16T03:00:00Z,MKJS 185N 779W,5,4,4,4,17
Tropical Depression,Twenty-Four,2,2005-10-16T03:00:00Z,MGPB 157N 886W,0,0,0,2,2
Tropical Depression,Twenty-Four,2,2005-10-16T03:00:00Z,MWCG 193N 814W,9,6,4,4,23
Tropical Depression,Twenty-Four,2,2005-10-16T03:00:00Z,MHNJ 165N 859W,0,0,2,8,10
Tropical Depression,Twenty-Four,2,2005-10-16T03:00:00Z,MUGM 200N 751W,0,0,0,4,4
Tropical Depression,Twenty-Four,2,2005-10-16T03:00:00Z,MNPC 141N 834W,0,1,3,5,9
Tropical Depression,Twenty-Four,2,2005-10-16T03:00:00Z,MUCM 214N 779W,0,0,2,7,9
Tropical Depression,Twenty-Four,2,2005-10-16T03:00:00Z,SKSP 126N 817W,0,1,1,2,4
Tropical Depression,Twenty-Four,2,2005-10-16T03:00:00Z,MUCF 221N 805W,0,1,2,7,10
Tropical Depression,Twenty-Four,2,2005-10-16T03:00:00Z,KEY WEST FL,0,0,0,2,2
Tropical Depression,Twenty-Four,3,2005-10-16T09:00:00Z,16.9N  80.1W,99,0,0,0,99
Tropical Depression,Twenty-Four,3,2005-10-16T09:00:00Z,MUAN 219N 850W,0,0,2,10,12
Tropical Depression,Twenty-Four,3,2005-10-16T09:00:00Z,17.0N  80.5W,56,0,0,0,56
Tropical Depression,Twenty-Four,3,2005-10-16T09:00:00Z,MMCZ 205N 869W,0,0,1,10,11
Tropical Depression,Twenty-Four,3,2005-10-16T09:00:00Z,17.3N  81.2W,32,1,0,1,34
Tropical Depression,Twenty-Four,3,2005-10-16T09:00:00Z,MZBZ 175N 883W,0,0,0,5,5
Tropical Depression,Twenty-Four,3,2005-10-16T09:00:00Z,MKJP 179N 768W,0,2,2,5,9
Tropical Depression,Twenty-Four,3,2005-10-16T09:00:00Z,MGPB 157N 886W,0,0,0,2,2
Tropical Depression,Twenty-Four,3,2005-10-16T09:00:00Z,MKJS 185N 779W,4,4,4,3,15
Tropical Depression,Twenty-Four,3,2005-10-16T09:00:00Z,MHNJ 165N 859W,0,0,2,8,10
Tropical Depression,Twenty-Four,3,2005-10-16T09:00:00Z,MWCG 193N 814W,12,6,4,2,24
Tropical Depression,Twenty-Four,3,2005-10-16T09:00:00Z,MNPC 141N 834W,0,1,2,4,7
Tropical Depression,Twenty-Four,3,2005-10-16T09:00:00Z,MUCM 214N 779W,0,0,1,5,6
Tropical Depression,Twenty-Four,3,2005-10-16T09:00:00Z,SKSP 126N 817W,0,0,1,2,3
Tropical Depression,Twenty-Four,3,2005-10-16T09:00:00Z,MUCF 221N 805W,0,1,2,7,10
Tropical Depression,Twenty-Four,3,2005-10-16T09:00:00Z,MMMD 210N 897W,0,0,0,3,3
Tropical Depression,Twenty-Four,3,2005-10-16T09:00:00Z,MUSN 216N 826W,0,1,5,9,15
Tropical Depression,Twenty-Four,3,2005-10-16T09:00:00Z,MARATHON FL,0,0,0,2,2
Tropical Depression,Twenty-Four,3,2005-10-16T09:00:00Z,MUHA 230N 824W,0,0,1,7,8
Tropical Depression,Twenty-Four,3,2005-10-16T09:00:00Z,KEY WEST FL,0,0,0,3,3
Tropical Depression,Twenty-Four,4,2005-10-16T15:00:00Z,17.2N  80.0W,99,0,0,0,99
Tropical Depression,Twenty-Four,4,2005-10-16T15:00:00Z,MUAN 219N 850W,0,0,2,11,13
Tropical Depression,Twenty-Four,4,2005-10-16T15:00:00Z,17.3N  80.5W,61,0,0,0,61
Tropical Depression,Twenty-Four,4,2005-10-16T15:00:00Z,MMCZ 205N 869W,0,0,1,9,10
Tropical Depression,Twenty-Four,4,2005-10-16T15:00:00Z,17.7N  81.2W,36,1,0,1,38
Tropical Depression,Twenty-Four,4,2005-10-16T15:00:00Z,MZBZ 175N 883W,0,0,0,4,4
Tropical Depression,Twenty-Four,4,2005-10-16T15:00:00Z,MKJP 179N 768W,0,1,2,4,7
Tropical Depression,Twenty-Four,4,2005-10-16T15:00:00Z,MHNJ 165N 859W,0,0,2,7,9
Tropical Depression,Twenty-Four,4,2005-10-16T15:00:00Z,MKJS 185N 779W,8,2,2,3,15
Tropical Depression,Twenty-Four,4,2005-10-16T15:00:00Z,MNPC 141N 834W,0,0,2,4,6
Tropical Depression,Twenty-Four,4,2005-10-16T15:00:00Z,MWCG 193N 814W,15,7,2,2,26
Tropical Depression,Twenty-Four,4,2005-10-16T15:00:00Z,SKSP 126N 817W,0,0,0,2,2
Tropical Depression,Twenty-Four,4,2005-10-16T15:00:00Z,MUCM 214N 779W,0,0,1,6,7
Tropical Depression,Twenty-Four,4,2005-10-16T15:00:00Z,MMMD 210N 897W,0,0,0,3,3
Tropical Depression,Twenty-Four,4,2005-10-16T15:00:00Z,MUCF 221N 805W,0,1,3,8,12
Tropical Depression,Twenty-Four,4,2005-10-16T15:00:00Z,MARATHON FL,0,0,0,3,3
Tropical Depression,Twenty-Four,4,2005-10-16T15:00:00Z,MUSN 216N 826W,0,1,7,8,16
Tropical Depression,Twenty-Four,4,2005-10-16T15:00:00Z,KEY WEST FL,0,0,0,4,4
Tropical Depression,Twenty-Four,4,2005-10-16T15:00:00Z,MUHA 230N 824W,0,0,2,8,10
Tropical Depression,Twenty-Four,5,2005-10-16T21:00:00Z,17.9N  80.4W,99,0,0,0,99
Tropical Depression,Twenty-Four,5,2005-10-16T21:00:00Z,MMCZ 205N 869W,0,0,2,10,12
Tropical Depression,Twenty-Four,5,2005-10-16T21:00:00Z,18.1N  81.0W,54,0,0,0,54
Tropical Depression,Twenty-Four,5,2005-10-16T21:00:00Z,MZBZ 175N 883W,0,0,0,5,5
Tropical Depression,Twenty-Four,5,2005-10-16T21:00:00Z,18.4N  81.8W,32,1,1,0,34
Tropical Depression,Twenty-Four,5,2005-10-16T21:00:00Z,MGPB 157N 886W,0,0,0,2,2
Tropical Depression,Twenty-Four,5,2005-10-16T21:00:00Z,MKJP 179N 768W,0,0,1,2,3
Tropical Depression,Twenty-Four,5,2005-10-16T21:00:00Z,MHNJ 165N 859W,0,0,3,7,10
Tropical Depression,Twenty-Four,5,2005-10-16T21:00:00Z,MKJS 185N 779W,10,1,1,1,13
Tropical Depression,Twenty-Four,5,2005-10-16T21:00:00Z,MNPC 141N 834W,0,0,1,3,4
Tropical Depression,Twenty-Four,5,2005-10-16T21:00:00Z,MWCG 193N 814W,30,1,1,0,32
Tropical Depression,Twenty-Four,5,2005-10-16T21:00:00Z,MMMD 210N 897W,0,0,0,4,4
Tropical Depression,Twenty-Four,5,2005-10-16T21:00:00Z,MUCM 214N 779W,0,1,1,4,6
Tropical Depression,Twenty-Four,5,2005-10-16T21:00:00Z,MARATHON FL,0,0,0,5,5
Tropical Depression,Twenty-Four,5,2005-10-16T21:00:00Z,MUCF 221N 805W,0,4,4,5,13
Tropical Depression,Twenty-Four,5,2005-10-16T21:00:00Z,MIAMI FL,0,0,0,2,2
Tropical Depression,Twenty-Four,5,2005-10-16T21:00:00Z,MUSN 216N 826W,0,6,6,6,18
Tropical Depression,Twenty-Four,5,2005-10-16T21:00:00Z,KEY WEST FL,0,0,0,7,7
Tropical Depression,Twenty-Four,5,2005-10-16T21:00:00Z,MUHA 230N 824W,0,0,4,9,13
Tropical Depression,Twenty-Four,5,2005-10-16T21:00:00Z,MARCO ISLAND FL,0,0,0,3,3
Tropical Depression,Twenty-Four,5,2005-10-16T21:00:00Z,MUAN 219N 850W,0,0,5,10,15
Tropical Depression,Twenty-Four,5,2005-10-16T21:00:00Z,FT MYERS FL,0,0,0,2,2
Tropical Depression,Twenty-Four,6,2005-10-17T03:00:00Z,17.8N  80.9W,65,0,0,0,65
Tropical Depression,Twenty-Four,6,2005-10-17T03:00:00Z,MMCZ 205N 869W,0,0,7,10,17
Tropical Depression,Twenty-Four,6,2005-10-17T03:00:00Z,18.0N  81.9W,41,0,0,1,42
Tropical Depression,Twenty-Four,6,2005-10-17T03:00:00Z,MZBZ 175N 883W,0,0,1,8,9
Tropical Depression,Twenty-Four,6,2005-10-17T03:00:00Z,18.3N  83.0W,18,13,0,1,32
Tropical Depression,Twenty-Four,6,2005-10-17T03:00:00Z,MGPB 157N 886W,0,0,0,4,4
Tropical Depression,Twenty-Four,6,2005-10-17T03:00:00Z,MKJS 185N 779W,2,0,0,2,4
Tropical Depression,Twenty-Four,6,2005-10-17T03:00:00Z,MHNJ 165N 859W,0,1,6,7,14
Tropical Depression,Twenty-Four,6,2005-10-17T03:00:00Z,MWCG 193N 814W,35,0,0,0,35
Tropical Depression,Twenty-Four,6,2005-10-17T03:00:00Z,MNPC 141N 834W,0,1,2,3,6
Tropical Depression,Twenty-Four,6,2005-10-17T03:00:00Z,MUCF 221N 805W,0,3,2,4,9
Tropical Depression,Twenty-Four,6,2005-10-17T03:00:00Z,MMMD 210N 897W,0,0,0,8,8
Tropical Depression,Twenty-Four,6,2005-10-17T03:00:00Z,MUSN 216N 826W,1,8,5,4,18
Tropical Depression,Twenty-Four,6,2005-10-17T03:00:00Z,MARATHON FL,0,0,0,2,2
Tropical Depression,Twenty-Four,6,2005-10-17T03:00:00Z,MUHA 230N 824W,0,1,4,6,11
Tropical Depression,Twenty-Four,6,2005-10-17T03:00:00Z,KEY WEST FL,0,0,0,4,4
Tropical Depression,Twenty-Four,6,2005-10-17T03:00:00Z,MUAN 219N 850W,0,1,9,8,18
Tropical Storm,Wilma,7,2005-10-17T09:00:00Z,17.2N  81.1W,49,0,0,0,49
Tropical Storm,Wilma,7,2005-10-17T09:00:00Z,MUAN 219N 850W,0,0,7,9,16
Tropical Storm,Wilma,7,2005-10-17T09:00:00Z,17.4N  82.0W,32,0,1,0,33
Tropical Storm,Wilma,7,2005-10-17T09:00:00Z,MMCZ 205N 869W,0,0,6,11,17
Tropical Storm,Wilma,7,2005-10-17T09:00:00Z,17.8N  83.3W,10,11,3,1,25
Tropical Storm,Wilma,7,2005-10-17T09:00:00Z,MZBZ 175N 883W,0,0,2,9,11
Tropical Storm,Wilma,7,2005-10-17T09:00:00Z,MKJP 179N 768W,0,0,1,2,3
Tropical Storm,Wilma,7,2005-10-17T09:00:00Z,MGPB 157N 886W,0,0,0,5,5
Tropical Storm,Wilma,7,2005-10-17T09:00:00Z,MKJS 185N 779W,0,2,2,4,8
Tropical Storm,Wilma,7,2005-10-17T09:00:00Z,MHNJ 165N 859W,0,2,7,6,15
Tropical Storm,Wilma,7,2005-10-17T09:00:00Z,MWCG 193N 814W,21,2,2,1,26
Tropical Storm,Wilma,7,2005-10-17T09:00:00Z,MNPC 141N 834W,0,2,3,2,7
Tropical Storm,Wilma,7,2005-10-17T09:00:00Z,MUCM 214N 779W,0,0,1,3,4
Tropical Storm,Wilma,7,2005-10-17T09:00:00Z,MMFR 185N 926W,0,0,0,2,2
Tropical Storm,Wilma,7,2005-10-17T09:00:00Z,MUCF 221N 805W,0,2,3,4,9
Tropical Storm,Wilma,7,2005-10-17T09:00:00Z,MMMD 210N 897W,0,0,0,10,10
Tropical Storm,Wilma,7,2005-10-17T09:00:00Z,MUSN 216N 826W,0,5,6,5,16
Tropical Storm,Wilma,7,2005-10-17T09:00:00Z,MARATHON FL,0,0,0,2,2
Tropical Storm,Wilma,7,2005-10-17T09:00:00Z,MUHA 230N 824W,0,0,3,6,9
Tropical Storm,Wilma,7,2005-10-17T09:00:00Z,KEY WEST FL,0,0,0,3,3
Tropical Storm,Wilma,8,2005-10-17T15:00:00Z,16.3N  81.5W,53,0,0,0,53
Tropical Storm,Wilma,8,2005-10-17T15:00:00Z,MMCZ 205N 869W,0,0,8,9,17
Tropical Storm,Wilma,8,2005-10-17T15:00:00Z,16.5N  82.6W,32,1,0,1,34
Tropical Storm,Wilma,8,2005-10-17T15:00:00Z,MZBZ 175N 883W,0,0,4,9,13
Tropical Storm,Wilma,8,2005-10-17T15:00:00Z,17.0N  83.7W,12,13,2,1,28
Tropical Storm,Wilma,8,2005-10-17T15:00:00Z,MGPB 157N 886W,0,0,1,6,7
Tropical Storm,Wilma,8,2005-10-17T15:00:00Z,MKJP 179N 768W,0,0,0,2,2
Tropical Storm,Wilma,8,2005-10-17T15:00:00Z,MHNJ 165N 859W,0,5,9,4,18
Tropical Storm,Wilma,8,2005-10-17T15:00:00Z,MKJS 185N 779W,0,0,1,4,5
Tropical Storm,Wilma,8,2005-10-17T15:00:00Z,MNPC 141N 834W,3,7,2,2,14
Tropical Storm,Wilma,8,2005-10-17T15:00:00Z,MWCG 193N 814W,10,4,3,2,19
Tropical Storm,Wilma,8,2005-10-17T15:00:00Z,MNBL 120N 839W,0,0,1,1,2
Tropical Storm,Wilma,8,2005-10-17T15:00:00Z,MUCM 214N 779W,0,0,0,2,2
Tropical Storm,Wilma,8,2005-10-17T15:00:00Z,SKSP 126N 817W,0,2,1,1,4
Tropical Storm,Wilma,8,2005-10-17T15:00:00Z,MUCF 221N 805W,0,0,1,4,5
Tropical Storm,Wilma,8,2005-10-17T15:00:00Z,MMFR 185N 926W,0,0,0,3,3
Tropical Storm,Wilma,8,2005-10-17T15:00:00Z,MUSN 216N 826W,0,1,4,7,12
Tropical Storm,Wilma,8,2005-10-17T15:00:00Z,MMMD 210N 897W,0,0,0,11,11
Tropical Storm,Wilma,8,2005-10-17T15:00:00Z,MUHA 230N 824W,0,0,1,5,6
Tropical Storm,Wilma,8,2005-10-17T15:00:00Z,KEY WEST FL,0,0,0,2,2
Tropical Storm,Wilma,8,2005-10-17T15:00:00Z,MUAN 219N 850W,0,0,5,9,14
Tropical Storm,Wilma,9,2005-10-17T21:00:00Z,16.3N  81.8W,49,0,0,0,49
Tropical Storm,Wilma,9,2005-10-17T21:00:00Z,MMCZ 205N 869W,0,0,10,9,19
Tropical Storm,Wilma,9,2005-10-17T21:00:00Z,16.9N  82.8W,31,2,0,1,34
Tropical Storm,Wilma,9,2005-10-17T21:00:00Z,MZBZ 175N 883W,0,0,3,8,11
Tropical Storm,Wilma,9,2005-10-17T21:00:00Z,17.7N  84.0W,7,16,3,1,27
Tropical Storm,Wilma,9,2005-10-17T21:00:00Z,MGPB 157N 886W,0,0,1,3,4
Tropical Storm,Wilma,9,2005-10-17T21:00:00Z,MKJP 179N 768W,0,0,0,2,2
Tropical Storm,Wilma,9,2005-10-17T21:00:00Z,MHNJ 165N 859W,0,5,8,3,16
Tropical Storm,Wilma,9,2005-10-17T21:00:00Z,MKJS 185N 779W,0,0,1,4,5
Tropical Storm,Wilma,9,2005-10-17T21:00:00Z,MNPC 141N 834W,4,5,2,1,12
Tropical Storm,Wilma,9,2005-10-17T21:00:00Z,MWCG 193N 814W,9,6,2,3,20
Tropical Storm,Wilma,9,2005-10-17T21:00:00Z,SKSP 126N 817W,0,1,1,1,3
Tropical Storm,Wilma,9,2005-10-17T21:00:00Z,MUCM 214N 779W,0,0,0,3,3
Tropical Storm,Wilma,9,2005-10-17T21:00:00Z,MMFR 185N 926W,0,0,0,3,3
Tropical Storm,Wilma,9,2005-10-17T21:00:00Z,MUCF 221N 805W,0,0,1,7,8
Tropical Storm,Wilma,9,2005-10-17T21:00:00Z,MMMD 210N 897W,0,0,1,11,12
Tropical Storm,Wilma,9,2005-10-17T21:00:00Z,MUSN 216N 826W,0,2,6,7,15
Tropical Storm,Wilma,9,2005-10-17T21:00:00Z,MARATHON FL,0,0,0,2,2
Tropical Storm,Wilma,9,2005-10-17T21:00:00Z,MUHA 230N 824W,0,0,2,7,9
Tropical Storm,Wilma,9,2005-10-17T21:00:00Z,KEY WEST FL,0,0,0,3,3
Tropical Storm,Wilma,9,2005-10-17T21:00:00Z,MUAN 219N 850W,0,1,7,9,17
Tropical Storm,Wilma,10,2005-10-18T03:00:00Z,16.6N  81.7W,50,0,0,0,50
Tropical Storm,Wilma,10,2005-10-18T03:00:00Z,MZBZ 175N 883W,0,0,2,5,7
Tropical Storm,Wilma,10,2005-10-18T03:00:00Z,17.3N  82.8W,30,3,0,1,34
Tropical Storm,Wilma,10,2005-10-18T03:00:00Z,MGPB 157N 886W,0,0,0,2,2
Tropical Storm,Wilma,10,2005-10-18T03:00:00Z,18.2N  83.7W,7,20,1,1,29
Tropical Storm,Wilma,10,2005-10-18T03:00:00Z,MHNJ 165N 859W,0,6,5,3,14
Tropical Storm,Wilma,10,2005-10-18T03:00:00Z,MKJP 179N 768W,0,0,0,2,2
Tropical Storm,Wilma,10,2005-10-18T03:00:00Z,MNPC 141N 834W,4,4,1,2,11
Tropical Storm,Wilma,10,2005-10-18T03:00:00Z,MKJS 185N 779W,0,0,1,3,4
Tropical Storm,Wilma,10,2005-10-18T03:00:00Z,SKSP 126N 817W,0,0,1,1,2
Tropical Storm,Wilma,10,2005-10-18T03:00:00Z,MWCG 193N 814W,10,9,1,2,22
Tropical Storm,Wilma,10,2005-10-18T03:00:00Z,MMMD 210N 897W,0,0,0,9,9
Tropical Storm,Wilma,10,2005-10-18T03:00:00Z,MUCM 214N 779W,0,0,0,3,3
Tropical Storm,Wilma,10,2005-10-18T03:00:00Z,MARATHON FL,0,0,0,4,4
Tropical Storm,Wilma,10,2005-10-18T03:00:00Z,MUCF 221N 805W,0,1,2,6,9
Tropical Storm,Wilma,10,2005-10-18T03:00:00Z,KEY WEST FL,0,0,0,6,6
Tropical Storm,Wilma,10,2005-10-18T03:00:00Z,MUSN 216N 826W,0,4,8,6,18
Tropical Storm,Wilma,10,2005-10-18T03:00:00Z,MARCO ISLAND FL,0,0,0,2,2
Tropical Storm,Wilma,10,2005-10-18T03:00:00Z,MUHA 230N 824W,0,0,4,9,13
Tropical Storm,Wilma,10,2005-10-18T03:00:00Z,FT MYERS FL,0,0,0,2,2
Tropical Storm,Wilma,10,2005-10-18T03:00:00Z,MUAN 219N 850W,0,1,11,8,20
Tropical Storm,Wilma,10,2005-10-18T03:00:00Z,GULF 28N 89W,0,0,0,2,2
Tropical Storm,Wilma,10,2005-10-18T03:00:00Z,MMCZ 205N 869W,0,0,9,9,18
Tropical Storm,Wilma,11,2005-10-18T09:00:00Z,16.6N  81.4W,45,0,0,0,45
Tropical Storm,Wilma,11,2005-10-18T09:00:00Z,MHNJ 165N 859W,0,4,7,2,13
Tropical Storm,Wilma,11,2005-10-18T09:00:00Z,17.3N  82.4W,28,3,0,0,31
Tropical Storm,Wilma,11,2005-10-18T09:00:00Z,MNPC 141N 834W,3,2,2,1,8
Tropical Storm,Wilma,11,2005-10-18T09:00:00Z,18.6N  84.0W,1,18,8,1,28
Tropical Storm,Wilma,11,2005-10-18T09:00:00Z,MMMD 210N 897W,0,0,1,8,9
Tropical Storm,Wilma,11,2005-10-18T09:00:00Z,MKJS 185N 779W,1,1,1,2,5
Tropical Storm,Wilma,11,2005-10-18T09:00:00Z,MARATHON FL,0,0,0,5,5
Tropical Storm,Wilma,11,2005-10-18T09:00:00Z,MWCG 193N 814W,8,11,3,1,23
Tropical Storm,Wilma,11,2005-10-18T09:00:00Z,MIAMI FL,0,0,0,2,2
Tropical Storm,Wilma,11,2005-10-18T09:00:00Z,MUCM 214N 779W,0,0,0,3,3
Tropical Storm,Wilma,11,2005-10-18T09:00:00Z,KEY WEST FL,0,0,0,7,7
Tropical Storm,Wilma,11,2005-10-18T09:00:00Z,MUCF 221N 805W,0,1,3,6,10
Tropical Storm,Wilma,11,2005-10-18T09:00:00Z,MARCO ISLAND FL,0,0,0,3,3
Tropical Storm,Wilma,11,2005-10-18T09:00:00Z,MUSN 216N 826W,0,2,11,6,19
Tropical Storm,Wilma,11,2005-10-18T09:00:00Z,FT MYERS FL,0,0,0,3,3
Tropical Storm,Wilma,11,2005-10-18T09:00:00Z,MUHA 230N 824W,0,0,4,9,13
Tropical Storm,Wilma,11,2005-10-18T09:00:00Z,VENICE FL,0,0,0,2,2
Tropical Storm,Wilma,11,2005-10-18T09:00:00Z,MUAN 219N 850W,0,0,12,8,20
Tropical Storm,Wilma,11,2005-10-18T09:00:00Z,GULF 29N 87W,0,0,0,2,2
Tropical Storm,Wilma,11,2005-10-18T09:00:00Z,MMCZ 205N 869W,0,0,11,7,18
Tropical Storm,Wilma,11,2005-10-18T09:00:00Z,GULF 28N 89W,0,0,0,3,3
Tropical Storm,Wilma,11,2005-10-18T09:00:00Z,MZBZ 175N 883W,0,0,2,5,7
Tropical Storm,Wilma,11,2005-10-18T09:00:00Z,GULF 28N 91W,0,0,0,2,2
Tropical Storm,Wilma,11,2005-10-18T09:00:00Z,MGPB 157N 886W,0,0,0,2,2
Hurricane,Wilma,12,2005-10-18T15:00:00Z,17.7N  82.3W,53,0,0,0,53
Hurricane,Wilma,12,2005-10-18T15:00:00Z,MIAMI FL,0,0,0,2,2
Hurricane,Wilma,12,2005-10-18T15:00:00Z,18.5N  83.5W,30,6,0,0,36
Hurricane,Wilma,12,2005-10-18T15:00:00Z,KEY WEST FL,0,0,2,6,8
Hurricane,Wilma,12,2005-10-18T15:00:00Z,19.6N  84.5W,3,24,2,1,30
Hurricane,Wilma,12,2005-10-18T15:00:00Z,MARCO ISLAND FL,0,0,0,5,5
Hurricane,Wilma,12,2005-10-18T15:00:00Z,MWCG 193N 814W,26,1,0,0,27
Hurricane,Wilma,12,2005-10-18T15:00:00Z,FT MYERS FL,0,0,0,5,5
Hurricane,Wilma,12,2005-10-18T15:00:00Z,MUCF 221N 805W,0,1,3,3,7
Hurricane,Wilma,12,2005-10-18T15:00:00Z,VENICE FL,0,0,0,5,5
Hurricane,Wilma,12,2005-10-18T15:00:00Z,MUSN 216N 826W,0,11,5,3,19
Hurricane,Wilma,12,2005-10-18T15:00:00Z,TAMPA FL,0,0,0,3,3
Hurricane,Wilma,12,2005-10-18T15:00:00Z,MUHA 230N 824W,0,2,6,6,14
Hurricane,Wilma,12,2005-10-18T15:00:00Z,CEDAR KEY FL,0,0,0,2,2
Hurricane,Wilma,12,2005-10-18T15:00:00Z,MUAN 219N 850W,0,6,13,5,24
Hurricane,Wilma,12,2005-10-18T15:00:00Z,ST MARKS FL,0,0,0,2,2
Hurricane,Wilma,12,2005-10-18T15:00:00Z,MMCZ 205N 869W,0,3,12,6,21
Hurricane,Wilma,12,2005-10-18T15:00:00Z,APALACHICOLA FL,0,0,0,3,3
Hurricane,Wilma,12,2005-10-18T15:00:00Z,MZBZ 175N 883W,0,0,3,6,9
Hurricane,Wilma,12,2005-10-18T15:00:00Z,PANAMA CITY FL,0,0,0,2,2
Hurricane,Wilma,12,2005-10-18T15:00:00Z,MGPB 157N 886W,0,0,0,3,3
Hurricane,Wilma,12,2005-10-18T15:00:00Z,PENSACOLA FL,0,0,0,2,2
Hurricane,Wilma,12,2005-10-18T15:00:00Z,MHNJ 165N 859W,1,7,4,2,14
Hurricane,Wilma,12,2005-10-18T15:00:00Z,BURAS LA,0,0,0,2,2
Hurricane,Wilma,12,2005-10-18T15:00:00Z,MNPC 141N 834W,0,1,0,2,3
Hurricane,Wilma,12,2005-10-18T15:00:00Z,GULF 29N 85W,0,0,0,4,4
Hurricane,Wilma,12,2005-10-18T15:00:00Z,MMMD 210N 897W,0,0,1,8,9
Hurricane,Wilma,12,2005-10-18T15:00:00Z,GULF 29N 87W,0,0,0,4,4
Hurricane,Wilma,12,2005-10-18T15:00:00Z,MARATHON FL,0,0,1,5,6
Hurricane,Wilma,12,2005-10-18T15:00:00Z,GULF 28N 89W,0,0,0,4,4
Hurricane,Wilma,13,2005-10-18T21:00:00Z,18.2N  83.5W,46,0,0,0,46
Hurricane,Wilma,13,2005-10-18T21:00:00Z,FT MYERS FL,0,0,0,5,5
Hurricane,Wilma,13,2005-10-18T21:00:00Z,19.1N  84.5W,29,3,1,0,33
Hurricane,Wilma,13,2005-10-18T21:00:00Z,VENICE FL,0,0,0,5,5
Hurricane,Wilma,13,2005-10-18T21:00:00Z,20.2N  85.2W,8,18,1,1,28
Hurricane,Wilma,13,2005-10-18T21:00:00Z,TAMPA FL,0,0,0,4,4
Hurricane,Wilma,13,2005-10-18T21:00:00Z,MWCG 193N 814W,22,0,0,1,23
Hurricane,Wilma,13,2005-10-18T21:00:00Z,CEDAR KEY FL,0,0,0,2,2
Hurricane,Wilma,13,2005-10-18T21:00:00Z,MUCF 221N 805W,0,1,2,6,9
Hurricane,Wilma,13,2005-10-18T21:00:00Z,ST MARKS FL,0,0,0,2,2
Hurricane,Wilma,13,2005-10-18T21:00:00Z,MUSN 216N 826W,3,10,3,3,19
Hurricane,Wilma,13,2005-10-18T21:00:00Z,APALACHICOLA FL,0,0,0,3,3
Hurricane,Wilma,13,2005-10-18T21:00:00Z,MUHA 230N 824W,0,3,6,6,15
Hurricane,Wilma,13,2005-10-18T21:00:00Z,PANAMA CITY FL,0,0,0,3,3
Hurricane,Wilma,13,2005-10-18T21:00:00Z,MUAN 219N 850W,0,15,7,2,24
Hurricane,Wilma,13,2005-10-18T21:00:00Z,PENSACOLA FL,0,0,0,3,3
Hurricane,Wilma,13,2005-10-18T21:00:00Z,MMCZ 205N 869W,0,13,6,3,22
Hurricane,Wilma,13,2005-10-18T21:00:00Z,MOBILE AL,0,0,0,2,2
Hurricane,Wilma,13,2005-10-18T21:00:00Z,MZBZ 175N 883W,0,2,2,3,7
Hurricane,Wilma,13,2005-10-18T21:00:00Z,GULFPORT MS,0,0,0,2,2
Hurricane,Wilma,13,2005-10-18T21:00:00Z,MHNJ 165N 859W,6,4,1,2,13
Hurricane,Wilma,13,2005-10-18T21:00:00Z,BURAS LA,0,0,0,4,4
Hurricane,Wilma,13,2005-10-18T21:00:00Z,MMMD 210N 897W,0,0,3,6,9
Hurricane,Wilma,13,2005-10-18T21:00:00Z,NEW ORLEANS LA,0,0,0,2,2
Hurricane,Wilma,13,2005-10-18T21:00:00Z,MARATHON FL,0,0,1,6,7
Hurricane,Wilma,13,2005-10-18T21:00:00Z,GULF 29N 85W,0,0,0,5,5
Hurricane,Wilma,13,2005-10-18T21:00:00Z,MIAMI FL,0,0,0,3,3
Hurricane,Wilma,13,2005-10-18T21:00:00Z,GULF 29N 87W,0,0,0,6,6
Hurricane,Wilma,13,2005-10-18T21:00:00Z,W PALM BEACH FL,0,0,0,2,2
Hurricane,Wilma,13,2005-10-18T21:00:00Z,GULF 28N 89W,0,0,0,7,7
Hurricane,Wilma,13,2005-10-18T21:00:00Z,KEY WEST FL,0,0,2,8,10
Hurricane,Wilma,13,2005-10-18T21:00:00Z,GULF 28N 91W,0,0,0,4,4
Hurricane,Wilma,13,2005-10-18T21:00:00Z,MARCO ISLAND FL,0,0,0,6,6
Hurricane,Wilma,14,2005-10-19T03:00:00Z,18.1N  84.2W,43,0,0,0,43
Hurricane,Wilma,14,2005-10-19T03:00:00Z,MIAMI FL,0,0,0,4,4
Hurricane,Wilma,14,2005-10-19T03:00:00Z,19.2N  85.0W,18,9,0,1,28
Hurricane,Wilma,14,2005-10-19T03:00:00Z,W PALM BEACH FL,0,0,0,3,3
Hurricane,Wilma,14,2005-10-19T03:00:00Z,20.4N  85.5W,1,18,3,2,24
Hurricane,Wilma,14,2005-10-19T03:00:00Z,FT PIERCE FL,0,0,0,2,2
Hurricane,Wilma,14,2005-10-19T03:00:00Z,MWCG 193N 814W,8,2,2,2,14
Hurricane,Wilma,14,2005-10-19T03:00:00Z,COCOA BEACH FL,0,0,0,2,2
Hurricane,Wilma,14,2005-10-19T03:00:00Z,MUCM 214N 779W,0,0,0,2,2
Hurricane,Wilma,14,2005-10-19T03:00:00Z,KEY WEST FL,0,0,0,8,8
Hurricane,Wilma,14,2005-10-19T03:00:00Z,MUCF 221N 805W,0,0,2,6,8
Hurricane,Wilma,14,2005-10-19T03:00:00Z,MARCO ISLAND FL,0,0,0,5,5
Hurricane,Wilma,14,2005-10-19T03:00:00Z,MUSN 216N 826W,0,3,7,4,14
Hurricane,Wilma,14,2005-10-19T03:00:00Z,FT MYERS FL,0,0,0,5,5
Hurricane,Wilma,14,2005-10-19T03:00:00Z,MUHA 230N 824W,0,0,4,7,11
Hurricane,Wilma,14,2005-10-19T03:00:00Z,VENICE FL,0,0,0,4,4
Hurricane,Wilma,14,2005-10-19T03:00:00Z,MUAN 219N 850W,0,4,10,5,19
Hurricane,Wilma,14,2005-10-19T03:00:00Z,TAMPA FL,0,0,0,3,3
Hurricane,Wilma,14,2005-10-19T03:00:00Z,MMCZ 205N 869W,0,14,6,2,22
Hurricane,Wilma,14,2005-10-19T03:00:00Z,CEDAR KEY FL,0,0,0,2,2
Hurricane,Wilma,14,2005-10-19T03:00:00Z,MZBZ 175N 883W,1,6,2,2,11
Hurricane,Wilma,14,2005-10-19T03:00:00Z,APALACHICOLA FL,0,0,0,2,2
Hurricane,Wilma,14,2005-10-19T03:00:00Z,MGPB 157N 886W,0,0,1,1,2
Hurricane,Wilma,14,2005-10-19T03:00:00Z,PANAMA CITY FL,0,0,0,2,2
Hurricane,Wilma,14,2005-10-19T03:00:00Z,MHNJ 165N 859W,16,1,0,0,17
Hurricane,Wilma,14,2005-10-19T03:00:00Z,BURAS LA,0,0,0,2,2
Hurricane,Wilma,14,2005-10-19T03:00:00Z,MYAK 241N 776W,0,0,0,2,2
Hurricane,Wilma,14,2005-10-19T03:00:00Z,GULF 29N 85W,0,0,0,3,3
Hurricane,Wilma,14,2005-10-19T03:00:00Z,MYGF 266N 787W,0,0,0,2,2
Hurricane,Wilma,14,2005-10-19T03:00:00Z,GULF 29N 87W,0,0,0,3,3
Hurricane,Wilma,14,2005-10-19T03:00:00Z,MMFR 185N 926W,0,0,0,3,3
Hurricane,Wilma,14,2005-10-19T03:00:00Z,GULF 28N 89W,0,0,0,4,4
Hurricane,Wilma,14,2005-10-19T03:00:00Z,MMMD 210N 897W,0,1,8,5,14
Hurricane,Wilma,14,2005-10-19T03:00:00Z,GULF 28N 91W,0,0,0,3,3
Hurricane,Wilma,14,2005-10-19T03:00:00Z,MARATHON FL,0,0,0,6,6
Hurricane,Wilma,14,2005-10-19T03:00:00Z,GULF 28N 93W,0,0,0,2,2
Hurricane,Wilma,15,2005-10-19T05:00:00Z,18.1N  84.2W,43,0,0,0,43
Hurricane,Wilma,15,2005-10-19T05:00:00Z,MIAMI FL,0,0,0,4,4
Hurricane,Wilma,15,2005-10-19T05:00:00Z,19.2N  85.0W,17,9,1,0,27
Hurricane,Wilma,15,2005-10-19T05:00:00Z,W PALM BEACH FL,0,0,0,3,3
Hurricane,Wilma,15,2005-10-19T05:00:00Z,20.4N  85.5W,1,18,3,1,23
Hurricane,Wilma,15,2005-10-19T05:00:00Z,FT PIERCE FL,0,0,0,2,2
Hurricane,Wilma,15,2005-10-19T05:00:00Z,MWCG 193N 814W,8,2,2,2,14
Hurricane,Wilma,15,2005-10-19T05:00:00Z,COCOA BEACH FL,0,0,0,2,2
Hurricane,Wilma,15,2005-10-19T05:00:00Z,MUCM 214N 779W,0,0,0,2,2
Hurricane,Wilma,15,2005-10-19T05:00:00Z,KEY WEST FL,0,0,1,7,8
Hurricane,Wilma,15,2005-10-19T05:00:00Z,MUCF 221N 805W,0,0,2,6,8
Hurricane,Wilma,15,2005-10-19T05:00:00Z,MARCO ISLAND FL,0,0,0,5,5
Hurricane,Wilma,15,2005-10-19T05:00:00Z,MUSN 216N 826W,0,4,6,4,14
Hurricane,Wilma,15,2005-10-19T05:00:00Z,FT MYERS FL,0,0,0,5,5
Hurricane,Wilma,15,2005-10-19T05:00:00Z,MUHA 230N 824W,0,0,4,8,12
Hurricane,Wilma,15,2005-10-19T05:00:00Z,VENICE FL,0,0,0,5,5
Hurricane,Wilma,15,2005-10-19T05:00:00Z,MUAN 219N 850W,0,6,8,5,19
Hurricane,Wilma,15,2005-10-19T05:00:00Z,TAMPA FL,0,0,0,3,3
Hurricane,Wilma,15,2005-10-19T05:00:00Z,MMCZ 205N 869W,0,14,5,2,21
Hurricane,Wilma,15,2005-10-19T05:00:00Z,CEDAR KEY FL,0,0,0,2,2
Hurricane,Wilma,15,2005-10-19T05:00:00Z,MZBZ 175N 883W,1,7,2,2,12
Hurricane,Wilma,15,2005-10-19T05:00:00Z,APALACHICOLA FL,0,0,0,2,2
Hurricane,Wilma,15,2005-10-19T05:00:00Z,MGPB 157N 886W,0,1,0,2,3
Hurricane,Wilma,15,2005-10-19T05:00:00Z,PANAMA CITY FL,0,0,0,2,2
Hurricane,Wilma,15,2005-10-19T05:00:00Z,MHNJ 165N 859W,16,1,0,1,18
Hurricane,Wilma,15,2005-10-19T05:00:00Z,BURAS LA,0,0,0,2,2
Hurricane,Wilma,15,2005-10-19T05:00:00Z,MYAK 241N 776W,0,0,0,2,2
Hurricane,Wilma,15,2005-10-19T05:00:00Z,GULF 29N 85W,0,0,0,3,3
Hurricane,Wilma,15,2005-10-19T05:00:00Z,MYGF 266N 787W,0,0,0,2,2
Hurricane,Wilma,15,2005-10-19T05:00:00Z,GULF 29N 87W,0,0,0,3,3
Hurricane,Wilma,15,2005-10-19T05:00:00Z,MMFR 185N 926W,0,0,0,3,3
Hurricane,Wilma,15,2005-10-19T05:00:00Z,GULF 28N 89W,0,0,0,5,5
Hurricane,Wilma,15,2005-10-19T05:00:00Z,MMMD 210N 897W,0,1,8,5,14
Hurricane,Wilma,15,2005-10-19T05:00:00Z,GULF 28N 91W,0,0,0,3,3
Hurricane,Wilma,15,2005-10-19T05:00:00Z,MARATHON FL,0,0,0,6,6
Hurricane,Wilma,15,2005-10-19T05:00:00Z,GULF 28N 93W,0,0,0,2,2
Hurricane,Wilma,16,2005-10-19T09:00:00Z,18.5N  84.7W,43,0,0,0,43
Hurricane,Wilma,16,2005-10-19T09:00:00Z,W PALM BEACH FL,0,0,0,2,2
Hurricane,Wilma,16,2005-10-19T09:00:00Z,20.0N  85.5W,9,18,1,0,28
Hurricane,Wilma,16,2005-10-19T09:00:00Z,FT PIERCE FL,0,0,0,2,2
Hurricane,Wilma,16,2005-10-19T09:00:00Z,21.0N  85.7W,0,20,2,2,24
Hurricane,Wilma,16,2005-10-19T09:00:00Z,KEY WEST FL,0,0,1,7,8
Hurricane,Wilma,16,2005-10-19T09:00:00Z,MWCG 193N 814W,8,2,1,2,13
Hurricane,Wilma,16,2005-10-19T09:00:00Z,MARCO ISLAND FL,0,0,0,5,5
Hurricane,Wilma,16,2005-10-19T09:00:00Z,MUCM 214N 779W,0,0,0,2,2
Hurricane,Wilma,16,2005-10-19T09:00:00Z,FT MYERS FL,0,0,0,4,4
Hurricane,Wilma,16,2005-10-19T09:00:00Z,MUCF 221N 805W,0,0,2,5,7
Hurricane,Wilma,16,2005-10-19T09:00:00Z,VENICE FL,0,0,0,4,4
Hurricane,Wilma,16,2005-10-19T09:00:00Z,MUSN 216N 826W,0,6,5,4,15
Hurricane,Wilma,16,2005-10-19T09:00:00Z,TAMPA FL,0,0,0,3,3
Hurricane,Wilma,16,2005-10-19T09:00:00Z,MUHA 230N 824W,0,1,4,7,12
Hurricane,Wilma,16,2005-10-19T09:00:00Z,CEDAR KEY FL,0,0,0,2,2
Hurricane,Wilma,16,2005-10-19T09:00:00Z,MUAN 219N 850W,0,11,6,3,20
Hurricane,Wilma,16,2005-10-19T09:00:00Z,APALACHICOLA FL,0,0,0,2,2
Hurricane,Wilma,16,2005-10-19T09:00:00Z,MMCZ 205N 869W,0,20,2,2,24
Hurricane,Wilma,16,2005-10-19T09:00:00Z,PANAMA CITY FL,0,0,0,2,2
Hurricane,Wilma,16,2005-10-19T09:00:00Z,MZBZ 175N 883W,3,5,1,2,11
Hurricane,Wilma,16,2005-10-19T09:00:00Z,BURAS LA,0,0,0,2,2
Hurricane,Wilma,16,2005-10-19T09:00:00Z,MGPB 157N 886W,0,0,1,2,3
Hurricane,Wilma,16,2005-10-19T09:00:00Z,NEW ORLEANS LA,0,0,0,2,2
Hurricane,Wilma,16,2005-10-19T09:00:00Z,MHNJ 165N 859W,12,0,1,1,14
Hurricane,Wilma,16,2005-10-19T09:00:00Z,GULF 29N 85W,0,0,0,3,3
Hurricane,Wilma,16,2005-10-19T09:00:00Z,MMFR 185N 926W,0,0,0,3,3
Hurricane,Wilma,16,2005-10-19T09:00:00Z,GULF 29N 87W,0,0,0,3,3
Hurricane,Wilma,16,2005-10-19T09:00:00Z,MMMD 210N 897W,0,3,7,5,15
Hurricane,Wilma,16,2005-10-19T09:00:00Z,GULF 28N 89W,0,0,0,5,5
Hurricane,Wilma,16,2005-10-19T09:00:00Z,MARATHON FL,0,0,0,6,6
Hurricane,Wilma,16,2005-10-19T09:00:00Z,GULF 28N 91W,0,0,0,4,4
Hurricane,Wilma,16,2005-10-19T09:00:00Z,MIAMI FL,0,0,0,3,3
Hurricane,Wilma,16,2005-10-19T09:00:00Z,GULF 28N 93W,0,0,0,2,2
Hurricane,Wilma,17,2005-10-19T15:00:00Z,19.1N  85.1W,41,0,0,1,42
Hurricane,Wilma,17,2005-10-19T15:00:00Z,COCOA BEACH FL,0,0,0,3,3
Hurricane,Wilma,17,2005-10-19T15:00:00Z,20.4N  85.9W,13,13,1,1,28
Hurricane,Wilma,17,2005-10-19T15:00:00Z,DAYTONA BEACH FL,0,0,0,2,2
Hurricane,Wilma,17,2005-10-19T15:00:00Z,21.5N  86.2W,1,18,3,1,23
Hurricane,Wilma,17,2005-10-19T15:00:00Z,KEY WEST FL,0,0,1,8,9
Hurricane,Wilma,17,2005-10-19T15:00:00Z,MWCG 193N 814W,2,2,1,4,9
Hurricane,Wilma,17,2005-10-19T15:00:00Z,MARCO ISLAND FL,0,0,0,7,7
Hurricane,Wilma,17,2005-10-19T15:00:00Z,MUCM 214N 779W,0,0,0,2,2
Hurricane,Wilma,17,2005-10-19T15:00:00Z,FT MYERS FL,0,0,0,7,7
Hurricane,Wilma,17,2005-10-19T15:00:00Z,MUCF 221N 805W,0,0,2,6,8
Hurricane,Wilma,17,2005-10-19T15:00:00Z,VENICE FL,0,0,0,6,6
Hurricane,Wilma,17,2005-10-19T15:00:00Z,MUSN 216N 826W,1,5,4,4,14
Hurricane,Wilma,17,2005-10-19T15:00:00Z,TAMPA FL,0,0,0,5,5
Hurricane,Wilma,17,2005-10-19T15:00:00Z,MUHA 230N 824W,0,1,4,7,12
Hurricane,Wilma,17,2005-10-19T15:00:00Z,CEDAR KEY FL,0,0,0,4,4
Hurricane,Wilma,17,2005-10-19T15:00:00Z,MUAN 219N 850W,0,14,4,3,21
Hurricane,Wilma,17,2005-10-19T15:00:00Z,ST MARKS FL,0,0,0,3,3
Hurricane,Wilma,17,2005-10-19T15:00:00Z,MMCZ 205N 869W,4,20,1,1,26
Hurricane,Wilma,17,2005-10-19T15:00:00Z,APALACHICOLA FL,0,0,0,4,4
Hurricane,Wilma,17,2005-10-19T15:00:00Z,MZBZ 175N 883W,4,3,1,1,9
Hurricane,Wilma,17,2005-10-19T15:00:00Z,PANAMA CITY FL,0,0,0,3,3
Hurricane,Wilma,17,2005-10-19T15:00:00Z,MHNJ 165N 859W,8,0,1,1,10
Hurricane,Wilma,17,2005-10-19T15:00:00Z,PENSACOLA FL,0,0,0,2,2
Hurricane,Wilma,17,2005-10-19T15:00:00Z,MYAK 241N 776W,0,0,0,2,2
Hurricane,Wilma,17,2005-10-19T15:00:00Z,MOBILE AL,0,0,0,2,2
Hurricane,Wilma,17,2005-10-19T15:00:00Z,MYNN 251N 775W,0,0,0,2,2
Hurricane,Wilma,17,2005-10-19T15:00:00Z,GULFPORT MS,0,0,0,2,2
Hurricane,Wilma,17,2005-10-19T15:00:00Z,MYGF 266N 787W,0,0,0,2,2
Hurricane,Wilma,17,2005-10-19T15:00:00Z,BURAS LA,0,0,0,3,3
Hurricane,Wilma,17,2005-10-19T15:00:00Z,MMFR 185N 926W,0,0,0,2,2
Hurricane,Wilma,17,2005-10-19T15:00:00Z,NEW ORLEANS LA,0,0,0,2,2
Hurricane,Wilma,17,2005-10-19T15:00:00Z,MMMD 210N 897W,0,7,6,2,15
Hurricane,Wilma,17,2005-10-19T15:00:00Z,GULF 29N 85W,0,0,0,5,5
Hurricane,Wilma,17,2005-10-19T15:00:00Z,MARATHON FL,0,0,0,8,8
Hurricane,Wilma,17,2005-10-19T15:00:00Z,GULF 29N 87W,0,0,0,5,5
Hurricane,Wilma,17,2005-10-19T15:00:00Z,MIAMI FL,0,0,0,5,5
Hurricane,Wilma,17,2005-10-19T15:00:00Z,GULF 28N 89W,0,0,0,6,6
Hurricane,Wilma,17,2005-10-19T15:00:00Z,W PALM BEACH FL,0,0,0,4,4
Hurricane,Wilma,17,2005-10-19T15:00:00Z,GULF 28N 91W,0,0,0,5,5
Hurricane,Wilma,17,2005-10-19T15:00:00Z,FT PIERCE FL,0,0,0,3,3
Hurricane,Wilma,17,2005-10-19T15:00:00Z,GULF 28N 93W,0,0,0,2,2
Hurricane,Wilma,18,2005-10-19T21:00:00Z,19.2N  85.6W,42,0,0,0,42
Hurricane,Wilma,18,2005-10-19T21:00:00Z,COCOA BEACH FL,0,0,0,3,3
Hurricane,Wilma,18,2005-10-19T21:00:00Z,20.4N  86.2W,16,10,1,1,28
Hurricane,Wilma,18,2005-10-19T21:00:00Z,DAYTONA BEACH FL,0,0,0,2,2
Hurricane,Wilma,18,2005-10-19T21:00:00Z,21.6N  86.3W,1,17,3,2,23
Hurricane,Wilma,18,2005-10-19T21:00:00Z,KEY WEST FL,0,0,1,8,9
Hurricane,Wilma,18,2005-10-19T21:00:00Z,MWCG 193N 814W,0,1,2,4,7
Hurricane,Wilma,18,2005-10-19T21:00:00Z,MARCO ISLAND FL,0,0,0,7,7
Hurricane,Wilma,18,2005-10-19T21:00:00Z,MUCM 214N 779W,0,0,0,2,2
Hurricane,Wilma,18,2005-10-19T21:00:00Z,FT MYERS FL,0,0,0,7,7
Hurricane,Wilma,18,2005-10-19T21:00:00Z,MUCF 221N 805W,0,0,1,7,8
Hurricane,Wilma,18,2005-10-19T21:00:00Z,VENICE FL,0,0,0,7,7
Hurricane,Wilma,18,2005-10-19T21:00:00Z,MUSN 216N 826W,1,4,4,5,14
Hurricane,Wilma,18,2005-10-19T21:00:00Z,TAMPA FL,0,0,0,5,5
Hurricane,Wilma,18,2005-10-19T21:00:00Z,MUHA 230N 824W,0,1,4,7,12
Hurricane,Wilma,18,2005-10-19T21:00:00Z,CEDAR KEY FL,0,0,0,4,4
Hurricane,Wilma,18,2005-10-19T21:00:00Z,MUAN 219N 850W,1,13,4,3,21
Hurricane,Wilma,18,2005-10-19T21:00:00Z,ST MARKS FL,0,0,0,3,3
Hurricane,Wilma,18,2005-10-19T21:00:00Z,MMCZ 205N 869W,7,17,1,1,26
Hurricane,Wilma,18,2005-10-19T21:00:00Z,APALACHICOLA FL,0,0,0,4,4
Hurricane,Wilma,18,2005-10-19T21:00:00Z,MZBZ 175N 883W,7,2,1,1,11
Hurricane,Wilma,18,2005-10-19T21:00:00Z,PANAMA CITY FL,0,0,0,3,3
Hurricane,Wilma,18,2005-10-19T21:00:00Z,MHNJ 165N 859W,15,0,0,0,15
Hurricane,Wilma,18,2005-10-19T21:00:00Z,PENSACOLA FL,0,0,0,3,3
Hurricane,Wilma,18,2005-10-19T21:00:00Z,MYAK 241N 776W,0,0,0,2,2
Hurricane,Wilma,18,2005-10-19T21:00:00Z,MOBILE AL,0,0,0,2,2
Hurricane,Wilma,18,2005-10-19T21:00:00Z,MYNN 251N 775W,0,0,0,2,2
Hurricane,Wilma,18,2005-10-19T21:00:00Z,GULFPORT MS,0,0,0,2,2
Hurricane,Wilma,18,2005-10-19T21:00:00Z,MYGF 266N 787W,0,0,0,3,3
Hurricane,Wilma,18,2005-10-19T21:00:00Z,BURAS LA,0,0,0,3,3
Hurricane,Wilma,18,2005-10-19T21:00:00Z,MMFR 185N 926W,0,0,0,2,2
Hurricane,Wilma,18,2005-10-19T21:00:00Z,NEW ORLEANS LA,0,0,0,2,2
Hurricane,Wilma,18,2005-10-19T21:00:00Z,MMMD 210N 897W,0,7,6,3,16
Hurricane,Wilma,18,2005-10-19T21:00:00Z,GULF 29N 85W,0,0,0,5,5
Hurricane,Wilma,18,2005-10-19T21:00:00Z,MARATHON FL,0,0,0,8,8
Hurricane,Wilma,18,2005-10-19T21:00:00Z,GULF 29N 87W,0,0,0,5,5
Hurricane,Wilma,18,2005-10-19T21:00:00Z,MIAMI FL,0,0,0,5,5
Hurricane,Wilma,18,2005-10-19T21:00:00Z,GULF 28N 89W,0,0,0,6,6
Hurricane,Wilma,18,2005-10-19T21:00:00Z,W PALM BEACH FL,0,0,0,4,4
Hurricane,Wilma,18,2005-10-19T21:00:00Z,GULF 28N 91W,0,0,0,4,4
Hurricane,Wilma,18,2005-10-19T21:00:00Z,FT PIERCE FL,0,0,0,4,4
Hurricane,Wilma,18,2005-10-19T21:00:00Z,GULF 28N 93W,0,0,0,2,2
Hurricane,Wilma,19,2005-10-20T03:00:00Z,19.8N  86.0W,43,0,0,0,43
Hurricane,Wilma,19,2005-10-20T03:00:00Z,COCOA BEACH FL,0,0,0,3,3
Hurricane,Wilma,19,2005-10-20T03:00:00Z,20.8N  86.5W,20,6,1,0,27
Hurricane,Wilma,19,2005-10-20T03:00:00Z,DAYTONA BEACH FL,0,0,0,2,2
Hurricane,Wilma,19,2005-10-20T03:00:00Z,21.8N  86.6W,3,16,3,1,23
Hurricane,Wilma,19,2005-10-20T03:00:00Z,KEY WEST FL,0,0,1,8,9
Hurricane,Wilma,19,2005-10-20T03:00:00Z,MWCG 193N 814W,0,0,2,4,6
Hurricane,Wilma,19,2005-10-20T03:00:00Z,MARCO ISLAND FL,0,0,0,7,7
Hurricane,Wilma,19,2005-10-20T03:00:00Z,MUCM 214N 779W,0,0,0,2,2
Hurricane,Wilma,19,2005-10-20T03:00:00Z,FT MYERS FL,0,0,0,6,6
Hurricane,Wilma,19,2005-10-20T03:00:00Z,MUCF 221N 805W,0,0,1,6,7
Hurricane,Wilma,19,2005-10-20T03:00:00Z,VENICE FL,0,0,0,6,6
Hurricane,Wilma,19,2005-10-20T03:00:00Z,MUSN 216N 826W,1,3,4,5,13
Hurricane,Wilma,19,2005-10-20T03:00:00Z,TAMPA FL,0,0,0,5,5
Hurricane,Wilma,19,2005-10-20T03:00:00Z,MUHA 230N 824W,0,1,3,7,11
Hurricane,Wilma,19,2005-10-20T03:00:00Z,CEDAR KEY FL,0,0,0,4,4
Hurricane,Wilma,19,2005-10-20T03:00:00Z,MUAN 219N 850W,4,10,4,2,20
Hurricane,Wilma,19,2005-10-20T03:00:00Z,ST MARKS FL,0,0,0,2,2
Hurricane,Wilma,19,2005-10-20T03:00:00Z,MMCZ 205N 869W,23,4,1,0,28
Hurricane,Wilma,19,2005-10-20T03:00:00Z,APALACHICOLA FL,0,0,0,3,3
Hurricane,Wilma,19,2005-10-20T03:00:00Z,MZBZ 175N 883W,4,1,1,1,7
Hurricane,Wilma,19,2005-10-20T03:00:00Z,PANAMA CITY FL,0,0,0,3,3
Hurricane,Wilma,19,2005-10-20T03:00:00Z,MHNJ 165N 859W,4,0,0,2,6
Hurricane,Wilma,19,2005-10-20T03:00:00Z,PENSACOLA FL,0,0,0,2,2
Hurricane,Wilma,19,2005-10-20T03:00:00Z,MYAK 241N 776W,0,0,0,2,2
Hurricane,Wilma,19,2005-10-20T03:00:00Z,MOBILE AL,0,0,0,2,2
Hurricane,Wilma,19,2005-10-20T03:00:00Z,MYNN 251N 775W,0,0,0,2,2
Hurricane,Wilma,19,2005-10-20T03:00:00Z,GULFPORT MS,0,0,0,2,2
Hurricane,Wilma,19,2005-10-20T03:00:00Z,MYGF 266N 787W,0,0,0,2,2
Hurricane,Wilma,19,2005-10-20T03:00:00Z,BURAS LA,0,0,0,3,3
Hurricane,Wilma,19,2005-10-20T03:00:00Z,MMFR 185N 926W,0,0,0,2,2
Hurricane,Wilma,19,2005-10-20T03:00:00Z,NEW ORLEANS LA,0,0,0,2,2
Hurricane,Wilma,19,2005-10-20T03:00:00Z,MMMD 210N 897W,0,11,4,2,17
Hurricane,Wilma,19,2005-10-20T03:00:00Z,GULF 29N 85W,0,0,0,5,5
Hurricane,Wilma,19,2005-10-20T03:00:00Z,MARATHON FL,0,0,0,7,7
Hurricane,Wilma,19,2005-10-20T03:00:00Z,GULF 29N 87W,0,0,0,5,5
Hurricane,Wilma,19,2005-10-20T03:00:00Z,MIAMI FL,0,0,0,5,5
Hurricane,Wilma,19,2005-10-20T03:00:00Z,GULF 28N 89W,0,0,0,6,6
Hurricane,Wilma,19,2005-10-20T03:00:00Z,W PALM BEACH FL,0,0,0,4,4
Hurricane,Wilma,19,2005-10-20T03:00:00Z,GULF 28N 91W,0,0,0,5,5
Hurricane,Wilma,19,2005-10-20T03:00:00Z,FT PIERCE FL,0,0,0,3,3
Hurricane,Wilma,19,2005-10-20T03:00:00Z,GULF 28N 93W,0,0,0,2,2
Hurricane,Wilma,20,2005-10-20T09:00:00Z,20.0N  86.5W,42,0,0,0,42
Hurricane,Wilma,20,2005-10-20T09:00:00Z,DAYTONA BEACH FL,0,0,0,3,3
Hurricane,Wilma,20,2005-10-20T09:00:00Z,21.0N  87.0W,21,6,1,0,28
Hurricane,Wilma,20,2005-10-20T09:00:00Z,JACKSONVILLE FL,0,0,0,2,2
Hurricane,Wilma,20,2005-10-20T09:00:00Z,22.0N  86.5W,6,13,3,2,24
Hurricane,Wilma,20,2005-10-20T09:00:00Z,KEY WEST FL,0,0,1,8,9
Hurricane,Wilma,20,2005-10-20T09:00:00Z,MWCG 193N 814W,0,0,2,5,7
Hurricane,Wilma,20,2005-10-20T09:00:00Z,MARCO ISLAND FL,0,0,0,8,8
Hurricane,Wilma,20,2005-10-20T09:00:00Z,MUCM 214N 779W,0,0,0,2,2
Hurricane,Wilma,20,2005-10-20T09:00:00Z,FT MYERS FL,0,0,0,7,7
Hurricane,Wilma,20,2005-10-20T09:00:00Z,MUCF 221N 805W,0,0,1,6,7
Hurricane,Wilma,20,2005-10-20T09:00:00Z,VENICE FL,0,0,0,7,7
Hurricane,Wilma,20,2005-10-20T09:00:00Z,MUSN 216N 826W,0,3,4,6,13
Hurricane,Wilma,20,2005-10-20T09:00:00Z,TAMPA FL,0,0,0,6,6
Hurricane,Wilma,20,2005-10-20T09:00:00Z,MUHA 230N 824W,0,0,4,8,12
Hurricane,Wilma,20,2005-10-20T09:00:00Z,CEDAR KEY FL,0,0,0,4,4
Hurricane,Wilma,20,2005-10-20T09:00:00Z,MUAN 219N 850W,6,8,4,2,20
Hurricane,Wilma,20,2005-10-20T09:00:00Z,ST MARKS FL,0,0,0,3,3
Hurricane,Wilma,20,2005-10-20T09:00:00Z,MMCZ 205N 869W,31,0,1,0,32
Hurricane,Wilma,20,2005-10-20T09:00:00Z,APALACHICOLA FL,0,0,0,4,4
Hurricane,Wilma,20,2005-10-20T09:00:00Z,MZBZ 175N 883W,6,1,0,2,9
Hurricane,Wilma,20,2005-10-20T09:00:00Z,PANAMA CITY FL,0,0,0,4,4
Hurricane,Wilma,20,2005-10-20T09:00:00Z,MHNJ 165N 859W,4,0,1,1,6
Hurricane,Wilma,20,2005-10-20T09:00:00Z,PENSACOLA FL,0,0,0,3,3
Hurricane,Wilma,20,2005-10-20T09:00:00Z,MYAK 241N 776W,0,0,0,2,2
Hurricane,Wilma,20,2005-10-20T09:00:00Z,MOBILE AL,0,0,0,3,3
Hurricane,Wilma,20,2005-10-20T09:00:00Z,MYNN 251N 775W,0,0,0,2,2
Hurricane,Wilma,20,2005-10-20T09:00:00Z,GULFPORT MS,0,0,0,3,3
Hurricane,Wilma,20,2005-10-20T09:00:00Z,MYGF 266N 787W,0,0,0,3,3
Hurricane,Wilma,20,2005-10-20T09:00:00Z,BURAS LA,0,0,0,4,4
Hurricane,Wilma,20,2005-10-20T09:00:00Z,MMFR 185N 926W,0,0,0,2,2
Hurricane,Wilma,20,2005-10-20T09:00:00Z,NEW ORLEANS LA,0,0,0,3,3
Hurricane,Wilma,20,2005-10-20T09:00:00Z,MMMD 210N 897W,2,12,2,2,18
Hurricane,Wilma,20,2005-10-20T09:00:00Z,NEW IBERIA LA,0,0,0,2,2
Hurricane,Wilma,20,2005-10-20T09:00:00Z,MARATHON FL,0,0,0,8,8
Hurricane,Wilma,20,2005-10-20T09:00:00Z,GULF 29N 85W,0,0,0,6,6
Hurricane,Wilma,20,2005-10-20T09:00:00Z,MIAMI FL,0,0,0,5,5
Hurricane,Wilma,20,2005-10-20T09:00:00Z,GULF 29N 87W,0,0,0,6,6
Hurricane,Wilma,20,2005-10-20T09:00:00Z,W PALM BEACH FL,0,0,0,4,4
Hurricane,Wilma,20,2005-10-20T09:00:00Z,GULF 28N 89W,0,0,0,7,7
Hurricane,Wilma,20,2005-10-20T09:00:00Z,FT PIERCE FL,0,0,0,4,4
Hurricane,Wilma,20,2005-10-20T09:00:00Z,GULF 28N 91W,0,0,0,5,5
Hurricane,Wilma,20,2005-10-20T09:00:00Z,COCOA BEACH FL,0,0,0,3,3
Hurricane,Wilma,20,2005-10-20T09:00:00Z,GULF 28N 93W,0,0,0,2,2
Hurricane,Wilma,21,2005-10-20T15:00:00Z,20.3N  86.9W,41,0,0,0,41
Hurricane,Wilma,21,2005-10-20T15:00:00Z,DAYTONA BEACH FL,0,0,0,3,3
Hurricane,Wilma,21,2005-10-20T15:00:00Z,21.2N  87.0W,24,2,1,1,28
Hurricane,Wilma,21,2005-10-20T15:00:00Z,JACKSONVILLE FL,0,0,0,2,2
Hurricane,Wilma,21,2005-10-20T15:00:00Z,22.0N  86.2W,9,9,3,2,23
Hurricane,Wilma,21,2005-10-20T15:00:00Z,KEY WEST FL,0,0,1,9,10
Hurricane,Wilma,21,2005-10-20T15:00:00Z,MWCG 193N 814W,0,0,2,5,7
Hurricane,Wilma,21,2005-10-20T15:00:00Z,MARCO ISLAND FL,0,0,0,8,8
Hurricane,Wilma,21,2005-10-20T15:00:00Z,MUCM 214N 779W,0,0,0,3,3
Hurricane,Wilma,21,2005-10-20T15:00:00Z,FT MYERS FL,0,0,0,7,7
Hurricane,Wilma,21,2005-10-20T15:00:00Z,MUCF 221N 805W,0,0,1,7,8
Hurricane,Wilma,21,2005-10-20T15:00:00Z,VENICE FL,0,0,0,7,7
Hurricane,Wilma,21,2005-10-20T15:00:00Z,MUSN 216N 826W,0,2,5,7,14
Hurricane,Wilma,21,2005-10-20T15:00:00Z,TAMPA FL,0,0,0,6,6
Hurricane,Wilma,21,2005-10-20T15:00:00Z,MUHA 230N 824W,0,0,5,8,13
Hurricane,Wilma,21,2005-10-20T15:00:00Z,CEDAR KEY FL,0,0,0,4,4
Hurricane,Wilma,21,2005-10-20T15:00:00Z,MUAN 219N 850W,6,8,3,3,20
Hurricane,Wilma,21,2005-10-20T15:00:00Z,ST MARKS FL,0,0,0,3,3
Hurricane,Wilma,21,2005-10-20T15:00:00Z,MMCZ 205N 869W,38,0,0,0,38
Hurricane,Wilma,21,2005-10-20T15:00:00Z,APALACHICOLA FL,0,0,0,4,4
Hurricane,Wilma,21,2005-10-20T15:00:00Z,MZBZ 175N 883W,7,1,0,2,10
Hurricane,Wilma,21,2005-10-20T15:00:00Z,PANAMA CITY FL,0,0,0,4,4
Hurricane,Wilma,21,2005-10-20T15:00:00Z,MHNJ 165N 859W,2,0,1,2,5
Hurricane,Wilma,21,2005-10-20T15:00:00Z,PENSACOLA FL,0,0,0,3,3
Hurricane,Wilma,21,2005-10-20T15:00:00Z,MYAK 241N 776W,0,0,0,3,3
Hurricane,Wilma,21,2005-10-20T15:00:00Z,MOBILE AL,0,0,0,2,2
Hurricane,Wilma,21,2005-10-20T15:00:00Z,MYNN 251N 775W,0,0,0,2,2
Hurricane,Wilma,21,2005-10-20T15:00:00Z,GULFPORT MS,0,0,0,2,2
Hurricane,Wilma,21,2005-10-20T15:00:00Z,MYGF 266N 787W,0,0,0,3,3
Hurricane,Wilma,21,2005-10-20T15:00:00Z,BURAS LA,0,0,0,3,3
Hurricane,Wilma,21,2005-10-20T15:00:00Z,MMMD 210N 897W,6,9,2,1,18
Hurricane,Wilma,21,2005-10-20T15:00:00Z,NEW ORLEANS LA,0,0,0,2,2
Hurricane,Wilma,21,2005-10-20T15:00:00Z,MARATHON FL,0,0,0,8,8
Hurricane,Wilma,21,2005-10-20T15:00:00Z,GULF 29N 85W,0,0,0,5,5
Hurricane,Wilma,21,2005-10-20T15:00:00Z,MIAMI FL,0,0,0,6,6
Hurricane,Wilma,21,2005-10-20T15:00:00Z,GULF 29N 87W,0,0,0,6,6
Hurricane,Wilma,21,2005-10-20T15:00:00Z,W PALM BEACH FL,0,0,0,5,5
Hurricane,Wilma,21,2005-10-20T15:00:00Z,GULF 28N 89W,0,0,0,6,6
Hurricane,Wilma,21,2005-10-20T15:00:00Z,FT PIERCE FL,0,0,0,4,4
Hurricane,Wilma,21,2005-10-20T15:00:00Z,GULF 28N 91W,0,0,0,4,4
Hurricane,Wilma,21,2005-10-20T15:00:00Z,COCOA BEACH FL,0,0,0,4,4
Hurricane,Wilma,21,2005-10-20T15:00:00Z,GULF 28N 93W,0,0,0,2,2
Hurricane,Wilma,22,2005-10-20T21:00:00Z,20.4N  87.0W,46,0,0,0,46
Hurricane,Wilma,22,2005-10-20T21:00:00Z,MIAMI FL,0,0,0,4,4
Hurricane,Wilma,22,2005-10-20T21:00:00Z,21.1N  87.2W,30,1,1,0,32
Hurricane,Wilma,22,2005-10-20T21:00:00Z,W PALM BEACH FL,0,0,0,3,3
Hurricane,Wilma,22,2005-10-20T21:00:00Z,22.0N  87.0W,15,5,2,2,24
Hurricane,Wilma,22,2005-10-20T21:00:00Z,FT PIERCE FL,0,0,0,2,2
Hurricane,Wilma,22,2005-10-20T21:00:00Z,MWCG 193N 814W,0,0,1,4,5
Hurricane,Wilma,22,2005-10-20T21:00:00Z,COCOA BEACH FL,0,0,0,2,2
Hurricane,Wilma,22,2005-10-20T21:00:00Z,MUCM 214N 779W,0,0,0,2,2
Hurricane,Wilma,22,2005-10-20T21:00:00Z,KEY WEST FL,0,0,0,8,8
Hurricane,Wilma,22,2005-10-20T21:00:00Z,MUCF 221N 805W,0,0,0,6,6
Hurricane,Wilma,22,2005-10-20T21:00:00Z,MARCO ISLAND FL,0,0,0,6,6
Hurricane,Wilma,22,2005-10-20T21:00:00Z,MUSN 216N 826W,0,1,4,6,11
Hurricane,Wilma,22,2005-10-20T21:00:00Z,FT MYERS FL,0,0,0,5,5
Hurricane,Wilma,22,2005-10-20T21:00:00Z,MUHA 230N 824W,0,0,2,8,10
Hurricane,Wilma,22,2005-10-20T21:00:00Z,VENICE FL,0,0,0,5,5
Hurricane,Wilma,22,2005-10-20T21:00:00Z,MUAN 219N 850W,9,4,3,3,19
Hurricane,Wilma,22,2005-10-20T21:00:00Z,TAMPA FL,0,0,0,4,4
Hurricane,Wilma,22,2005-10-20T21:00:00Z,MMCZ 205N 869W,45,0,0,0,45
Hurricane,Wilma,22,2005-10-20T21:00:00Z,CEDAR KEY FL,0,0,0,2,2
Hurricane,Wilma,22,2005-10-20T21:00:00Z,MZBZ 175N 883W,3,1,0,2,6
Hurricane,Wilma,22,2005-10-20T21:00:00Z,APALACHICOLA FL,0,0,0,2,2
Hurricane,Wilma,22,2005-10-20T21:00:00Z,MHNJ 165N 859W,0,0,0,2,2
Hurricane,Wilma,22,2005-10-20T21:00:00Z,PANAMA CITY FL,0,0,0,2,2
Hurricane,Wilma,22,2005-10-20T21:00:00Z,MYAK 241N 776W,0,0,0,2,2
Hurricane,Wilma,22,2005-10-20T21:00:00Z,BURAS LA,0,0,0,2,2
Hurricane,Wilma,22,2005-10-20T21:00:00Z,MYNN 251N 775W,0,0,0,2,2
Hurricane,Wilma,22,2005-10-20T21:00:00Z,GULF 29N 85W,0,0,0,3,3
Hurricane,Wilma,22,2005-10-20T21:00:00Z,MYGF 266N 787W,0,0,0,2,2
Hurricane,Wilma,22,2005-10-20T21:00:00Z,GULF 29N 87W,0,0,0,4,4
Hurricane,Wilma,22,2005-10-20T21:00:00Z,MMFR 185N 926W,0,0,0,2,2
Hurricane,Wilma,22,2005-10-20T21:00:00Z,GULF 28N 89W,0,0,0,5,5
Hurricane,Wilma,22,2005-10-20T21:00:00Z,MMMD 210N 897W,8,7,2,2,19
Hurricane,Wilma,22,2005-10-20T21:00:00Z,GULF 28N 91W,0,0,0,4,4
Hurricane,Wilma,22,2005-10-20T21:00:00Z,MARATHON FL,0,0,0,6,6
Hurricane,Wilma,22,2005-10-20T21:00:00Z,GULF 28N 93W,0,0,0,2,2
Hurricane,Wilma,23,2005-10-21T03:00:00Z,20.8N  87.0W,44,0,0,0,44
Hurricane,Wilma,23,2005-10-21T03:00:00Z,FT PIERCE FL,0,0,0,2,2
Hurricane,Wilma,23,2005-10-21T03:00:00Z,21.5N  87.1W,31,0,1,0,32
Hurricane,Wilma,23,2005-10-21T03:00:00Z,COCOA BEACH FL,0,0,0,2,2
Hurricane,Wilma,23,2005-10-21T03:00:00Z,22.1N  86.7W,19,4,1,1,25
Hurricane,Wilma,23,2005-10-21T03:00:00Z,KEY WEST FL,0,0,0,8,8
Hurricane,Wilma,23,2005-10-21T03:00:00Z,MWCG 193N 814W,0,0,1,5,6
Hurricane,Wilma,23,2005-10-21T03:00:00Z,MARCO ISLAND FL,0,0,0,6,6
Hurricane,Wilma,23,2005-10-21T03:00:00Z,MUCM 214N 779W,0,0,0,2,2
Hurricane,Wilma,23,2005-10-21T03:00:00Z,FT MYERS FL,0,0,0,5,5
Hurricane,Wilma,23,2005-10-21T03:00:00Z,MUCF 221N 805W,0,0,0,7,7
Hurricane,Wilma,23,2005-10-21T03:00:00Z,VENICE FL,0,0,0,5,5
Hurricane,Wilma,23,2005-10-21T03:00:00Z,MUSN 216N 826W,0,2,3,7,12
Hurricane,Wilma,23,2005-10-21T03:00:00Z,TAMPA FL,0,0,0,4,4
Hurricane,Wilma,23,2005-10-21T03:00:00Z,MUHA 230N 824W,0,0,3,8,11
Hurricane,Wilma,23,2005-10-21T03:00:00Z,CEDAR KEY FL,0,0,0,2,2
Hurricane,Wilma,23,2005-10-21T03:00:00Z,MUAN 219N 850W,11,5,2,2,20
Hurricane,Wilma,23,2005-10-21T03:00:00Z,APALACHICOLA FL,0,0,0,2,2
Hurricane,Wilma,23,2005-10-21T03:00:00Z,MMCZ 205N 869W,51,0,0,0,51
Hurricane,Wilma,23,2005-10-21T03:00:00Z,PANAMA CITY FL,0,0,0,2,2
Hurricane,Wilma,23,2005-10-21T03:00:00Z,MZBZ 175N 883W,0,1,1,2,4
Hurricane,Wilma,23,2005-10-21T03:00:00Z,PENSACOLA FL,0,0,0,2,2
Hurricane,Wilma,23,2005-10-21T03:00:00Z,MHNJ 165N 859W,0,0,1,2,3
Hurricane,Wilma,23,2005-10-21T03:00:00Z,BURAS LA,0,0,0,3,3
Hurricane,Wilma,23,2005-10-21T03:00:00Z,MYAK 241N 776W,0,0,0,2,2
Hurricane,Wilma,23,2005-10-21T03:00:00Z,NEW ORLEANS LA,0,0,0,2,2
Hurricane,Wilma,23,2005-10-21T03:00:00Z,MYGF 266N 787W,0,0,0,2,2
Hurricane,Wilma,23,2005-10-21T03:00:00Z,GULF 29N 85W,0,0,0,3,3
Hurricane,Wilma,23,2005-10-21T03:00:00Z,MMMD 210N 897W,10,4,2,2,18
Hurricane,Wilma,23,2005-10-21T03:00:00Z,GULF 29N 87W,0,0,0,4,4
Hurricane,Wilma,23,2005-10-21T03:00:00Z,MARATHON FL,0,0,0,6,6
Hurricane,Wilma,23,2005-10-21T03:00:00Z,GULF 28N 89W,0,0,0,6,6
Hurricane,Wilma,23,2005-10-21T03:00:00Z,MIAMI FL,0,0,0,4,4
Hurricane,Wilma,23,2005-10-21T03:00:00Z,GULF 28N 91W,0,0,0,4,4
Hurricane,Wilma,23,2005-10-21T03:00:00Z,W PALM BEACH FL,0,0,0,3,3
Hurricane,Wilma,23,2005-10-21T03:00:00Z,GULF 28N 93W,0,0,0,2,2
Hurricane,Wilma,24,2005-10-21T09:00:00Z,21.2N  87.1W,44,0,1,0,45
Hurricane,Wilma,24,2005-10-21T09:00:00Z,COCOA BEACH FL,0,0,0,3,3
Hurricane,Wilma,24,2005-10-21T09:00:00Z,21.6N  87.5W,34,1,0,0,35
Hurricane,Wilma,24,2005-10-21T09:00:00Z,DAYTONA BEACH FL,0,0,0,2,2
Hurricane,Wilma,24,2005-10-21T09:00:00Z,22.0N  87.0W,27,1,1,1,30
Hurricane,Wilma,24,2005-10-21T09:00:00Z,KEY WEST FL,0,0,1,8,9
Hurricane,Wilma,24,2005-10-21T09:00:00Z,MWCG 193N 814W,0,0,0,5,5
Hurricane,Wilma,24,2005-10-21T09:00:00Z,MARCO ISLAND FL,0,0,0,7,7
Hurricane,Wilma,24,2005-10-21T09:00:00Z,MUCM 214N 779W,0,0,0,2,2
Hurricane,Wilma,24,2005-10-21T09:00:00Z,FT MYERS FL,0,0,0,7,7
Hurricane,Wilma,24,2005-10-21T09:00:00Z,MUCF 221N 805W,0,0,0,6,6
Hurricane,Wilma,24,2005-10-21T09:00:00Z,VENICE FL,0,0,0,7,7
Hurricane,Wilma,24,2005-10-21T09:00:00Z,MUSN 216N 826W,0,1,3,7,11
Hurricane,Wilma,24,2005-10-21T09:00:00Z,TAMPA FL,0,0,0,5,5
Hurricane,Wilma,24,2005-10-21T09:00:00Z,MUHA 230N 824W,0,0,2,9,11
Hurricane,Wilma,24,2005-10-21T09:00:00Z,CEDAR KEY FL,0,0,0,4,4
Hurricane,Wilma,24,2005-10-21T09:00:00Z,MUAN 219N 850W,13,3,2,3,21
Hurricane,Wilma,24,2005-10-21T09:00:00Z,ST MARKS FL,0,0,0,3,3
Hurricane,Wilma,24,2005-10-21T09:00:00Z,MMCZ 205N 869W,99,0,0,0,99
Hurricane,Wilma,24,2005-10-21T09:00:00Z,APALACHICOLA FL,0,0,0,4,4
Hurricane,Wilma,24,2005-10-21T09:00:00Z,MZBZ 175N 883W,0,0,3,4,7
Hurricane,Wilma,24,2005-10-21T09:00:00Z,PANAMA CITY FL,0,0,0,4,4
Hurricane,Wilma,24,2005-10-21T09:00:00Z,MGPB 157N 886W,0,0,0,2,2
Hurricane,Wilma,24,2005-10-21T09:00:00Z,PENSACOLA FL,0,0,0,3,3
Hurricane,Wilma,24,2005-10-21T09:00:00Z,MHNJ 165N 859W,0,0,1,3,4
Hurricane,Wilma,24,2005-10-21T09:00:00Z,MOBILE AL,0,0,0,2,2
Hurricane,Wilma,24,2005-10-21T09:00:00Z,MYAK 241N 776W,0,0,0,2,2
Hurricane,Wilma,24,2005-10-21T09:00:00Z,GULFPORT MS,0,0,0,2,2
Hurricane,Wilma,24,2005-10-21T09:00:00Z,MYNN 251N 775W,0,0,0,2,2
Hurricane,Wilma,24,2005-10-21T09:00:00Z,BURAS LA,0,0,0,4,4
Hurricane,Wilma,24,2005-10-21T09:00:00Z,MYGF 266N 787W,0,0,0,2,2
Hurricane,Wilma,24,2005-10-21T09:00:00Z,NEW ORLEANS LA,0,0,0,2,2
Hurricane,Wilma,24,2005-10-21T09:00:00Z,MMFR 185N 926W,0,0,0,2,2
Hurricane,Wilma,24,2005-10-21T09:00:00Z,GULF 29N 85W,0,0,0,5,5
Hurricane,Wilma,24,2005-10-21T09:00:00Z,MMMD 210N 897W,11,4,2,2,19
Hurricane,Wilma,24,2005-10-21T09:00:00Z,GULF 29N 87W,0,0,0,6,6
Hurricane,Wilma,24,2005-10-21T09:00:00Z,MARATHON FL,0,0,0,7,7
Hurricane,Wilma,24,2005-10-21T09:00:00Z,GULF 28N 89W,0,0,1,6,7
Hurricane,Wilma,24,2005-10-21T09:00:00Z,MIAMI FL,0,0,0,5,5
Hurricane,Wilma,24,2005-10-21T09:00:00Z,GULF 28N 91W,0,0,1,4,5
Hurricane,Wilma,24,2005-10-21T09:00:00Z,W PALM BEACH FL,0,0,0,4,4
Hurricane,Wilma,24,2005-10-21T09:00:00Z,GULF 28N 93W,0,0,0,2,2
Hurricane,Wilma,24,2005-10-21T09:00:00Z,FT PIERCE FL,0,0,0,3,3
Hurricane,Wilma,25,2005-10-21T15:00:00Z,21.3N  87.4W,52,0,0,0,52
Hurricane,Wilma,25,2005-10-21T15:00:00Z,DAYTONA BEACH FL,0,0,0,4,4
Hurricane,Wilma,25,2005-10-21T15:00:00Z,21.8N  87.4W,37,0,0,0,37
Hurricane,Wilma,25,2005-10-21T15:00:00Z,JACKSONVILLE FL,0,0,0,3,3
Hurricane,Wilma,25,2005-10-21T15:00:00Z,22.3N  86.9W,25,1,1,1,28
Hurricane,Wilma,25,2005-10-21T15:00:00Z,KEY WEST FL,0,0,1,9,10
Hurricane,Wilma,25,2005-10-21T15:00:00Z,MWCG 193N 814W,0,0,1,4,5
Hurricane,Wilma,25,2005-10-21T15:00:00Z,MARCO ISLAND FL,0,0,0,9,9
Hurricane,Wilma,25,2005-10-21T15:00:00Z,MUCM 214N 779W,0,0,0,2,2
Hurricane,Wilma,25,2005-10-21T15:00:00Z,FT MYERS FL,0,0,0,9,9
Hurricane,Wilma,25,2005-10-21T15:00:00Z,MUCF 221N 805W,0,0,0,7,7
Hurricane,Wilma,25,2005-10-21T15:00:00Z,VENICE FL,0,0,0,9,9
Hurricane,Wilma,25,2005-10-21T15:00:00Z,MUSN 216N 826W,0,2,3,6,11
Hurricane,Wilma,25,2005-10-21T15:00:00Z,TAMPA FL,0,0,0,8,8
Hurricane,Wilma,25,2005-10-21T15:00:00Z,MUHA 230N 824W,0,1,3,8,12
Hurricane,Wilma,25,2005-10-21T15:00:00Z,CEDAR KEY FL,0,0,0,6,6
Hurricane,Wilma,25,2005-10-21T15:00:00Z,MUAN 219N 850W,16,3,1,2,22
Hurricane,Wilma,25,2005-10-21T15:00:00Z,ST MARKS FL,0,0,0,5,5
Hurricane,Wilma,25,2005-10-21T15:00:00Z,MMCZ 205N 869W,99,0,0,0,99
Hurricane,Wilma,25,2005-10-21T15:00:00Z,APALACHICOLA FL,0,0,0,6,6
Hurricane,Wilma,25,2005-10-21T15:00:00Z,MZBZ 175N 883W,0,1,2,3,6
Hurricane,Wilma,25,2005-10-21T15:00:00Z,PANAMA CITY FL,0,0,0,5,5
Hurricane,Wilma,25,2005-10-21T15:00:00Z,MGPB 157N 886W,0,0,0,2,2
Hurricane,Wilma,25,2005-10-21T15:00:00Z,PENSACOLA FL,0,0,0,4,4
Hurricane,Wilma,25,2005-10-21T15:00:00Z,MHNJ 165N 859W,0,0,1,3,4
Hurricane,Wilma,25,2005-10-21T15:00:00Z,MOBILE AL,0,0,0,3,3
Hurricane,Wilma,25,2005-10-21T15:00:00Z,MYAK 241N 776W,0,0,0,3,3
Hurricane,Wilma,25,2005-10-21T15:00:00Z,GULFPORT MS,0,0,0,3,3
Hurricane,Wilma,25,2005-10-21T15:00:00Z,MYNN 251N 775W,0,0,0,3,3
Hurricane,Wilma,25,2005-10-21T15:00:00Z,BURAS LA,0,0,0,5,5
Hurricane,Wilma,25,2005-10-21T15:00:00Z,MYGF 266N 787W,0,0,0,4,4
Hurricane,Wilma,25,2005-10-21T15:00:00Z,NEW ORLEANS LA,0,0,0,3,3
Hurricane,Wilma,25,2005-10-21T15:00:00Z,MMFR 185N 926W,0,0,0,2,2
Hurricane,Wilma,25,2005-10-21T15:00:00Z,NEW IBERIA LA,0,0,0,2,2
Hurricane,Wilma,25,2005-10-21T15:00:00Z,MMMD 210N 897W,15,3,1,1,20
Hurricane,Wilma,25,2005-10-21T15:00:00Z,GULF 29N 85W,0,0,0,7,7
Hurricane,Wilma,25,2005-10-21T15:00:00Z,MARATHON FL,0,0,1,8,9
Hurricane,Wilma,25,2005-10-21T15:00:00Z,GULF 29N 87W,0,0,1,6,7
Hurricane,Wilma,25,2005-10-21T15:00:00Z,MIAMI FL,0,0,0,7,7
Hurricane,Wilma,25,2005-10-21T15:00:00Z,GULF 28N 89W,0,0,2,6,8
Hurricane,Wilma,25,2005-10-21T15:00:00Z,W PALM BEACH FL,0,0,0,6,6
Hurricane,Wilma,25,2005-10-21T15:00:00Z,GULF 28N 91W,0,0,1,4,5
Hurricane,Wilma,25,2005-10-21T15:00:00Z,FT PIERCE FL,0,0,0,6,6
Hurricane,Wilma,25,2005-10-21T15:00:00Z,GULF 28N 93W,0,0,0,2,2
Hurricane,Wilma,25,2005-10-21T15:00:00Z,COCOA BEACH FL,0,0,0,5,5
Hurricane,Wilma,26,2005-10-21T21:00:00Z,21.2N  87.5W,99,0,0,0,99
Hurricane,Wilma,26,2005-10-21T21:00:00Z,DAYTONA BEACH FL,0,0,0,6,6
Hurricane,Wilma,26,2005-10-21T21:00:00Z,21.8N  87.4W,44,0,0,0,44
Hurricane,Wilma,26,2005-10-21T21:00:00Z,JACKSONVILLE FL,0,0,0,4,4
Hurricane,Wilma,26,2005-10-21T21:00:00Z,22.7N  86.5W,15,4,2,2,23
Hurricane,Wilma,26,2005-10-21T21:00:00Z,KEY WEST FL,0,0,2,10,12
Hurricane,Wilma,26,2005-10-21T21:00:00Z,MWCG 193N 814W,0,0,1,4,5
Hurricane,Wilma,26,2005-10-21T21:00:00Z,MARCO ISLAND FL,0,0,0,11,11
Hurricane,Wilma,26,2005-10-21T21:00:00Z,MUCM 214N 779W,0,0,0,3,3
Hurricane,Wilma,26,2005-10-21T21:00:00Z,FT MYERS FL,0,0,0,10,10
Hurricane,Wilma,26,2005-10-21T21:00:00Z,MUCF 221N 805W,0,0,1,7,8
Hurricane,Wilma,26,2005-10-21T21:00:00Z,VENICE FL,0,0,0,10,10
Hurricane,Wilma,26,2005-10-21T21:00:00Z,MUSN 216N 826W,0,2,4,6,12
Hurricane,Wilma,26,2005-10-21T21:00:00Z,TAMPA FL,0,0,0,9,9
Hurricane,Wilma,26,2005-10-21T21:00:00Z,MUHA 230N 824W,0,1,4,8,13
Hurricane,Wilma,26,2005-10-21T21:00:00Z,CEDAR KEY FL,0,0,0,7,7
Hurricane,Wilma,26,2005-10-21T21:00:00Z,MUAN 219N 850W,11,4,3,2,20
Hurricane,Wilma,26,2005-10-21T21:00:00Z,ST MARKS FL,0,0,0,5,5
Hurricane,Wilma,26,2005-10-21T21:00:00Z,MMCZ 205N 869W,99,0,0,0,99
Hurricane,Wilma,26,2005-10-21T21:00:00Z,APALACHICOLA FL,0,0,0,6,6
Hurricane,Wilma,26,2005-10-21T21:00:00Z,MZBZ 175N 883W,0,1,1,1,3
Hurricane,Wilma,26,2005-10-21T21:00:00Z,PANAMA CITY FL,0,0,0,6,6
Hurricane,Wilma,26,2005-10-21T21:00:00Z,MYEG 235N 758W,0,0,0,2,2
Hurricane,Wilma,26,2005-10-21T21:00:00Z,PENSACOLA FL,0,0,0,4,4
Hurricane,Wilma,26,2005-10-21T21:00:00Z,MYAK 241N 776W,0,0,0,4,4
Hurricane,Wilma,26,2005-10-21T21:00:00Z,MOBILE AL,0,0,0,3,3
Hurricane,Wilma,26,2005-10-21T21:00:00Z,MYNN 251N 775W,0,0,0,4,4
Hurricane,Wilma,26,2005-10-21T21:00:00Z,GULFPORT MS,0,0,0,3,3
Hurricane,Wilma,26,2005-10-21T21:00:00Z,MYGF 266N 787W,0,0,0,6,6
Hurricane,Wilma,26,2005-10-21T21:00:00Z,BURAS LA,0,0,0,4,4
Hurricane,Wilma,26,2005-10-21T21:00:00Z,MMMD 210N 897W,16,3,1,0,20
Hurricane,Wilma,26,2005-10-21T21:00:00Z,NEW ORLEANS LA,0,0,0,3,3
Hurricane,Wilma,26,2005-10-21T21:00:00Z,MARATHON FL,0,0,1,10,11
Hurricane,Wilma,26,2005-10-21T21:00:00Z,GULF 29N 85W,0,0,0,8,8
Hurricane,Wilma,26,2005-10-21T21:00:00Z,MIAMI FL,0,0,0,9,9
Hurricane,Wilma,26,2005-10-21T21:00:00Z,GULF 29N 87W,0,0,0,7,7
Hurricane,Wilma,26,2005-10-21T21:00:00Z,W PALM BEACH FL,0,0,0,8,8
Hurricane,Wilma,26,2005-10-21T21:00:00Z,GULF 28N 89W,0,0,1,7,8
Hurricane,Wilma,26,2005-10-21T21:00:00Z,FT PIERCE FL,0,0,0,7,7
Hurricane,Wilma,26,2005-10-21T21:00:00Z,GULF 28N 91W,0,0,0,5,5
Hurricane,Wilma,26,2005-10-21T21:00:00Z,COCOA BEACH FL,0,0,0,7,7
Hurricane,Wilma,26,2005-10-21T21:00:00Z,GULF 28N 93W,0,0,0,2,2
Hurricane,Wilma,27,2005-10-22T03:00:00Z,21.7N  87.2W,99,0,0,0,99
Hurricane,Wilma,27,2005-10-22T03:00:00Z,JACKSONVILLE FL,0,0,0,9,9
Hurricane,Wilma,27,2005-10-22T03:00:00Z,22.3N  86.9W,31,1,0,1,33
Hurricane,Wilma,27,2005-10-22T03:00:00Z,SAVANNAH GA,0,0,0,6,6
Hurricane,Wilma,27,2005-10-22T03:00:00Z,23.5N  85.4W,3,10,8,1,22
Hurricane,Wilma,27,2005-10-22T03:00:00Z,CHARLESTON SC,0,0,0,4,4
Hurricane,Wilma,27,2005-10-22T03:00:00Z,MWCG 193N 814W,0,0,1,4,5
Hurricane,Wilma,27,2005-10-22T03:00:00Z,MYRTLE BEACH SC,0,0,0,2,2
Hurricane,Wilma,27,2005-10-22T03:00:00Z,MUCM 214N 779W,0,0,0,4,4
Hurricane,Wilma,27,2005-10-22T03:00:00Z,KEY WEST FL,0,0,4,11,15
Hurricane,Wilma,27,2005-10-22T03:00:00Z,MUCF 221N 805W,0,0,1,8,9
Hurricane,Wilma,27,2005-10-22T03:00:00Z,MARCO ISLAND FL,0,0,2,13,15
Hurricane,Wilma,27,2005-10-22T03:00:00Z,MUSN 216N 826W,0,2,6,5,13
Hurricane,Wilma,27,2005-10-22T03:00:00Z,FT MYERS FL,0,0,1,14,15
Hurricane,Wilma,27,2005-10-22T03:00:00Z,MUHA 230N 824W,0,1,7,7,15
Hurricane,Wilma,27,2005-10-22T03:00:00Z,VENICE FL,0,0,2,14,16
Hurricane,Wilma,27,2005-10-22T03:00:00Z,MUAN 219N 850W,14,3,3,1,21
Hurricane,Wilma,27,2005-10-22T03:00:00Z,TAMPA FL,0,0,1,13,14
Hurricane,Wilma,27,2005-10-22T03:00:00Z,MMCZ 205N 869W,99,0,0,0,99
Hurricane,Wilma,27,2005-10-22T03:00:00Z,CEDAR KEY FL,0,0,0,13,13
Hurricane,Wilma,27,2005-10-22T03:00:00Z,MYSM 241N 745W,0,0,0,2,2
Hurricane,Wilma,27,2005-10-22T03:00:00Z,ST MARKS FL,0,0,0,10,10
Hurricane,Wilma,27,2005-10-22T03:00:00Z,MYEG 235N 758W,0,0,0,3,3
Hurricane,Wilma,27,2005-10-22T03:00:00Z,APALACHICOLA FL,0,0,1,10,11
Hurricane,Wilma,27,2005-10-22T03:00:00Z,MYAK 241N 776W,0,0,0,7,7
Hurricane,Wilma,27,2005-10-22T03:00:00Z,PANAMA CITY FL,0,0,1,9,10
Hurricane,Wilma,27,2005-10-22T03:00:00Z,MYNN 251N 775W,0,0,0,8,8
Hurricane,Wilma,27,2005-10-22T03:00:00Z,PENSACOLA FL,0,0,0,7,7
Hurricane,Wilma,27,2005-10-22T03:00:00Z,MYGF 266N 787W,0,0,0,11,11
Hurricane,Wilma,27,2005-10-22T03:00:00Z,MOBILE AL,0,0,0,5,5
Hurricane,Wilma,27,2005-10-22T03:00:00Z,MMMD 210N 897W,9,3,1,0,13
Hurricane,Wilma,27,2005-10-22T03:00:00Z,GULFPORT MS,0,0,0,4,4
Hurricane,Wilma,27,2005-10-22T03:00:00Z,MARATHON FL,0,0,2,12,14
Hurricane,Wilma,27,2005-10-22T03:00:00Z,BURAS LA,0,0,1,4,5
Hurricane,Wilma,27,2005-10-22T03:00:00Z,MIAMI FL,0,0,0,13,13
Hurricane,Wilma,27,2005-10-22T03:00:00Z,NEW ORLEANS LA,0,0,0,3,3
Hurricane,Wilma,27,2005-10-22T03:00:00Z,W PALM BEACH FL,0,0,0,13,13
Hurricane,Wilma,27,2005-10-22T03:00:00Z,GULF 29N 85W,0,0,1,11,12
Hurricane,Wilma,27,2005-10-22T03:00:00Z,FT PIERCE FL,0,0,0,13,13
Hurricane,Wilma,27,2005-10-22T03:00:00Z,GULF 29N 87W,0,0,2,8,10
Hurricane,Wilma,27,2005-10-22T03:00:00Z,COCOA BEACH FL,0,0,0,13,13
Hurricane,Wilma,27,2005-10-22T03:00:00Z,GULF 28N 89W,0,0,4,5,9
Hurricane,Wilma,27,2005-10-22T03:00:00Z,DAYTONA BEACH FL,0,0,0,12,12
Hurricane,Wilma,27,2005-10-22T03:00:00Z,GULF 28N 91W,0,0,1,3,4
Hurricane,Wilma,28,2005-10-22T09:00:00Z,22.0N  87.0W,99,0,0,0,99
Hurricane,Wilma,28,2005-10-22T09:00:00Z,SAVANNAH GA,0,0,0,13,13
Hurricane,Wilma,28,2005-10-22T09:00:00Z,23.0N  86.0W,20,8,1,0,29
Hurricane,Wilma,28,2005-10-22T09:00:00Z,CHARLESTON SC,0,0,0,12,12
Hurricane,Wilma,28,2005-10-22T09:00:00Z,24.5N  83.5W,0,9,14,2,25
Hurricane,Wilma,28,2005-10-22T09:00:00Z,MYRTLE BEACH SC,0,0,0,11,11
Hurricane,Wilma,28,2005-10-22T09:00:00Z,MWCG 193N 814W,0,0,1,1,2
Hurricane,Wilma,28,2005-10-22T09:00:00Z,WILMINGTON NC,0,0,0,9,9
Hurricane,Wilma,28,2005-10-22T09:00:00Z,MUCM 214N 779W,0,0,0,2,2
Hurricane,Wilma,28,2005-10-22T09:00:00Z,MOREHEAD CITY NC,0,0,0,8,8
Hurricane,Wilma,28,2005-10-22T09:00:00Z,MUCF 221N 805W,0,0,4,7,11
Hurricane,Wilma,28,2005-10-22T09:00:00Z,CAPE HATTERAS NC,0,0,0,7,7
Hurricane,Wilma,28,2005-10-22T09:00:00Z,MUSN 216N 826W,0,4,9,2,15
Hurricane,Wilma,28,2005-10-22T09:00:00Z,NORFOLK VA,0,0,0,4,4
Hurricane,Wilma,28,2005-10-22T09:00:00Z,MUHA 230N 824W,0,4,13,3,20
Hurricane,Wilma,28,2005-10-22T09:00:00Z,OCEAN CITY MD,0,0,0,2,2
Hurricane,Wilma,28,2005-10-22T09:00:00Z,MUAN 219N 850W,16,6,2,0,24
Hurricane,Wilma,28,2005-10-22T09:00:00Z,KEY WEST FL,0,1,15,6,22
Hurricane,Wilma,28,2005-10-22T09:00:00Z,MMCZ 205N 869W,99,0,0,0,99
Hurricane,Wilma,28,2005-10-22T09:00:00Z,MARCO ISLAND FL,0,0,14,9,23
Hurricane,Wilma,28,2005-10-22T09:00:00Z,MYSM 241N 745W,0,0,0,3,3
Hurricane,Wilma,28,2005-10-22T09:00:00Z,FT MYERS FL,0,0,13,10,23
Hurricane,Wilma,28,2005-10-22T09:00:00Z,MYEG 235N 758W,0,0,0,4,4
Hurricane,Wilma,28,2005-10-22T09:00:00Z,VENICE FL,0,0,13,10,23
Hurricane,Wilma,28,2005-10-22T09:00:00Z,MYAK 241N 776W,0,0,0,10,10
Hurricane,Wilma,28,2005-10-22T09:00:00Z,TAMPA FL,0,0,9,12,21
Hurricane,Wilma,28,2005-10-22T09:00:00Z,MYNN 251N 775W,0,0,0,12,12
Hurricane,Wilma,28,2005-10-22T09:00:00Z,CEDAR KEY FL,0,0,5,13,18
Hurricane,Wilma,28,2005-10-22T09:00:00Z,MYGF 266N 787W,0,0,1,17,18
Hurricane,Wilma,28,2005-10-22T09:00:00Z,ST MARKS FL,0,0,2,11,13
Hurricane,Wilma,28,2005-10-22T09:00:00Z,MMMD 210N 897W,10,2,0,0,12
Hurricane,Wilma,28,2005-10-22T09:00:00Z,APALACHICOLA FL,0,0,3,10,13
Hurricane,Wilma,28,2005-10-22T09:00:00Z,MARATHON FL,0,0,12,8,20
Hurricane,Wilma,28,2005-10-22T09:00:00Z,PANAMA CITY FL,0,0,2,8,10
Hurricane,Wilma,28,2005-10-22T09:00:00Z,MIAMI FL,0,0,7,13,20
Hurricane,Wilma,28,2005-10-22T09:00:00Z,PENSACOLA FL,0,0,0,4,4
Hurricane,Wilma,28,2005-10-22T09:00:00Z,W PALM BEACH FL,0,0,5,16,21
Hurricane,Wilma,28,2005-10-22T09:00:00Z,MOBILE AL,0,0,0,2,2
Hurricane,Wilma,28,2005-10-22T09:00:00Z,FT PIERCE FL,0,0,4,17,21
Hurricane,Wilma,28,2005-10-22T09:00:00Z,GULF 29N 85W,0,0,5,10,15
Hurricane,Wilma,28,2005-10-22T09:00:00Z,COCOA BEACH FL,0,0,3,18,21
Hurricane,Wilma,28,2005-10-22T09:00:00Z,GULF 29N 87W,0,0,3,5,8
Hurricane,Wilma,28,2005-10-22T09:00:00Z,DAYTONA BEACH FL,0,0,2,17,19
Hurricane,Wilma,28,2005-10-22T09:00:00Z,GULF 28N 89W,0,0,2,1,3
Hurricane,Wilma,28,2005-10-22T09:00:00Z,JACKSONVILLE FL,0,0,1,15,16
Hurricane,Wilma,29,2005-10-22T15:00:00Z,22.5N  86.5W,40,0,0,0,40
Hurricane,Wilma,29,2005-10-22T15:00:00Z,SAVANNAH GA,0,0,1,13,14
Hurricane,Wilma,29,2005-10-22T15:00:00Z,23.8N  84.8W,9,20,1,0,30
Hurricane,Wilma,29,2005-10-22T15:00:00Z,CHARLESTON SC,0,0,0,13,13
Hurricane,Wilma,29,2005-10-22T15:00:00Z,25.6N  82.2W,0,4,18,3,25
Hurricane,Wilma,29,2005-10-22T15:00:00Z,MYRTLE BEACH SC,0,0,0,12,12
Hurricane,Wilma,29,2005-10-22T15:00:00Z,MUCM 214N 779W,0,0,0,2,2
Hurricane,Wilma,29,2005-10-22T15:00:00Z,WILMINGTON NC,0,0,0,12,12
Hurricane,Wilma,29,2005-10-22T15:00:00Z,MUCF 221N 805W,0,0,6,4,10
Hurricane,Wilma,29,2005-10-22T15:00:00Z,MOREHEAD CITY NC,0,0,0,11,11
Hurricane,Wilma,29,2005-10-22T15:00:00Z,MUSN 216N 826W,0,6,8,1,15
Hurricane,Wilma,29,2005-10-22T15:00:00Z,CAPE HATTERAS NC,0,0,0,10,10
Hurricane,Wilma,29,2005-10-22T15:00:00Z,MUHA 230N 824W,0,8,11,1,20
Hurricane,Wilma,29,2005-10-22T15:00:00Z,NORFOLK VA,0,0,0,6,6
Hurricane,Wilma,29,2005-10-22T15:00:00Z,MUAN 219N 850W,23,4,1,0,28
Hurricane,Wilma,29,2005-10-22T15:00:00Z,OCEAN CITY MD,0,0,0,4,4
Hurricane,Wilma,29,2005-10-22T15:00:00Z,MMCZ 205N 869W,99,0,0,0,99
Hurricane,Wilma,29,2005-10-22T15:00:00Z,ATLANTIC CITY NJ,0,0,0,2,2
Hurricane,Wilma,29,2005-10-22T15:00:00Z,MYSM 241N 745W,0,0,0,4,4
Hurricane,Wilma,29,2005-10-22T15:00:00Z,KEY WEST FL,0,4,16,3,23
Hurricane,Wilma,29,2005-10-22T15:00:00Z,MYEG 235N 758W,0,0,0,4,4
Hurricane,Wilma,29,2005-10-22T15:00:00Z,MARCO ISLAND FL,0,1,18,5,24
Hurricane,Wilma,29,2005-10-22T15:00:00Z,MYAK 241N 776W,0,0,1,8,9
Hurricane,Wilma,29,2005-10-22T15:00:00Z,FT MYERS FL,0,1,18,5,24
Hurricane,Wilma,29,2005-10-22T15:00:00Z,MYNN 251N 775W,0,0,1,11,12
Hurricane,Wilma,29,2005-10-22T15:00:00Z,VENICE FL,0,2,17,5,24
Hurricane,Wilma,29,2005-10-22T15:00:00Z,MYGF 266N 787W,0,0,3,16,19
Hurricane,Wilma,29,2005-10-22T15:00:00Z,TAMPA FL,0,1,14,7,22
Hurricane,Wilma,29,2005-10-22T15:00:00Z,MMMD 210N 897W,10,0,1,0,11
Hurricane,Wilma,29,2005-10-22T15:00:00Z,CEDAR KEY FL,0,0,10,9,19
Hurricane,Wilma,29,2005-10-22T15:00:00Z,MARATHON FL,0,1,15,5,21
Hurricane,Wilma,29,2005-10-22T15:00:00Z,ST MARKS FL,0,0,4,9,13
Hurricane,Wilma,29,2005-10-22T15:00:00Z,MIAMI FL,0,0,12,9,21
Hurricane,Wilma,29,2005-10-22T15:00:00Z,APALACHICOLA FL,0,0,5,7,12
Hurricane,Wilma,29,2005-10-22T15:00:00Z,W PALM BEACH FL,0,0,9,13,22
Hurricane,Wilma,29,2005-10-22T15:00:00Z,PANAMA CITY FL,0,0,3,5,8
Hurricane,Wilma,29,2005-10-22T15:00:00Z,FT PIERCE FL,0,0,9,13,22
Hurricane,Wilma,29,2005-10-22T15:00:00Z,PENSACOLA FL,0,0,1,1,2
Hurricane,Wilma,29,2005-10-22T15:00:00Z,COCOA BEACH FL,0,0,8,14,22
Hurricane,Wilma,29,2005-10-22T15:00:00Z,GULF 29N 85W,0,0,9,5,14
Hurricane,Wilma,29,2005-10-22T15:00:00Z,DAYTONA BEACH FL,0,0,6,15,21
Hurricane,Wilma,29,2005-10-22T15:00:00Z,GULF 29N 87W,0,0,3,3,6
Hurricane,Wilma,29,2005-10-22T15:00:00Z,JACKSONVILLE FL,0,0,3,14,17
Hurricane,Wilma,30,2005-10-22T21:00:00Z,23.1N  85.7W,47,0,0,0,47
Hurricane,Wilma,30,2005-10-22T21:00:00Z,MOREHEAD CITY NC,0,0,0,18,18
Hurricane,Wilma,30,2005-10-22T21:00:00Z,24.9N  83.5W,6,27,4,0,37
Hurricane,Wilma,30,2005-10-22T21:00:00Z,CAPE HATTERAS NC,0,0,0,17,17
Hurricane,Wilma,30,2005-10-22T21:00:00Z,27.8N  79.6W,0,1,24,4,29
Hurricane,Wilma,30,2005-10-22T21:00:00Z,NORFOLK VA,0,0,0,13,13
Hurricane,Wilma,30,2005-10-22T21:00:00Z,MUCF 221N 805W,0,0,3,0,3
Hurricane,Wilma,30,2005-10-22T21:00:00Z,OCEAN CITY MD,0,0,0,11,11
Hurricane,Wilma,30,2005-10-22T21:00:00Z,MUSN 216N 826W,1,5,3,0,9
Hurricane,Wilma,30,2005-10-22T21:00:00Z,ATLANTIC CITY NJ,0,0,0,9,9
Hurricane,Wilma,30,2005-10-22T21:00:00Z,MUHA 230N 824W,1,14,6,1,22
Hurricane,Wilma,30,2005-10-22T21:00:00Z,NEW YORK CITY NY,0,0,0,7,7
Hurricane,Wilma,30,2005-10-22T21:00:00Z,MUAN 219N 850W,35,1,0,0,36
Hurricane,Wilma,30,2005-10-22T21:00:00Z,MONTAUK POINT NY,0,0,0,6,6
Hurricane,Wilma,30,2005-10-22T21:00:00Z,MMCZ 205N 869W,99,0,0,0,99
Hurricane,Wilma,30,2005-10-22T21:00:00Z,PROVIDENCE RI,0,0,0,5,5
Hurricane,Wilma,30,2005-10-22T21:00:00Z,MYAK 241N 776W,0,0,2,2,4
Hurricane,Wilma,30,2005-10-22T21:00:00Z,NANTUCKET MA,0,0,0,5,5
Hurricane,Wilma,30,2005-10-22T21:00:00Z,MYNN 251N 775W,0,0,4,4,8
Hurricane,Wilma,30,2005-10-22T21:00:00Z,HYANNIS MA,0,0,0,5,5
Hurricane,Wilma,30,2005-10-22T21:00:00Z,MYGF 266N 787W,0,0,17,5,22
Hurricane,Wilma,30,2005-10-22T21:00:00Z,BOSTON MA,0,0,0,4,4
Hurricane,Wilma,30,2005-10-22T21:00:00Z,BERMUDA,0,0,0,2,2
Hurricane,Wilma,30,2005-10-22T21:00:00Z,PORTLAND ME,0,0,0,2,2
Hurricane,Wilma,30,2005-10-22T21:00:00Z,MARATHON FL,0,9,16,0,25
Hurricane,Wilma,30,2005-10-22T21:00:00Z,KEY WEST FL,0,16,12,0,28
Hurricane,Wilma,30,2005-10-22T21:00:00Z,MIAMI FL,0,4,22,1,27
Hurricane,Wilma,30,2005-10-22T21:00:00Z,MARCO ISLAND FL,0,15,18,1,34
Hurricane,Wilma,30,2005-10-22T21:00:00Z,W PALM BEACH FL,0,2,25,2,29
Hurricane,Wilma,30,2005-10-22T21:00:00Z,FT MYERS FL,0,15,19,0,34
Hurricane,Wilma,30,2005-10-22T21:00:00Z,FT PIERCE FL,0,2,26,3,31
Hurricane,Wilma,30,2005-10-22T21:00:00Z,VENICE FL,0,16,18,0,34
Hurricane,Wilma,30,2005-10-22T21:00:00Z,COCOA BEACH FL,0,2,26,3,31
Hurricane,Wilma,30,2005-10-22T21:00:00Z,TAMPA FL,0,8,21,1,30
Hurricane,Wilma,30,2005-10-22T21:00:00Z,DAYTONA BEACH FL,0,1,22,4,27
Hurricane,Wilma,30,2005-10-22T21:00:00Z,CEDAR KEY FL,0,3,17,2,22
Hurricane,Wilma,30,2005-10-22T21:00:00Z,JACKSONVILLE FL,0,0,12,8,20
Hurricane,Wilma,30,2005-10-22T21:00:00Z,ST MARKS FL,0,0,6,2,8
Hurricane,Wilma,30,2005-10-22T21:00:00Z,SAVANNAH GA,0,0,4,11,15
Hurricane,Wilma,30,2005-10-22T21:00:00Z,APALACHICOLA FL,0,1,4,1,6
Hurricane,Wilma,30,2005-10-22T21:00:00Z,CHARLESTON SC,0,0,2,14,16
Hurricane,Wilma,30,2005-10-22T21:00:00Z,PANAMA CITY FL,0,0,2,1,3
Hurricane,Wilma,30,2005-10-22T21:00:00Z,MYRTLE BEACH SC,0,0,1,16,17
Hurricane,Wilma,30,2005-10-22T21:00:00Z,GULF 29N 85W,0,2,7,1,10
Hurricane,Wilma,30,2005-10-22T21:00:00Z,WILMINGTON NC,0,0,0,17,17
Hurricane,Wilma,31,2005-10-23T03:00:00Z,24.0N  84.6W,50,3,0,0,53
Hurricane,Wilma,31,2005-10-23T03:00:00Z,OCEAN CITY MD,0,0,0,13,13
Hurricane,Wilma,31,2005-10-23T03:00:00Z,26.3N  81.5W,2,36,6,0,44
Hurricane,Wilma,31,2005-10-23T03:00:00Z,ATLANTIC CITY NJ,0,0,0,11,11
Hurricane,Wilma,31,2005-10-23T03:00:00Z,30.5N  77.0W,0,0,22,6,28
Hurricane,Wilma,31,2005-10-23T03:00:00Z,NEW YORK CITY NY,0,0,0,10,10
Hurricane,Wilma,31,2005-10-23T03:00:00Z,MUSN 216N 826W,1,2,0,0,3
Hurricane,Wilma,31,2005-10-23T03:00:00Z,MONTAUK POINT NY,0,0,0,11,11
Hurricane,Wilma,31,2005-10-23T03:00:00Z,MUHA 230N 824W,7,14,0,0,21
Hurricane,Wilma,31,2005-10-23T03:00:00Z,PROVIDENCE RI,0,0,0,10,10
Hurricane,Wilma,31,2005-10-23T03:00:00Z,MUAN 219N 850W,44,0,0,0,44
Hurricane,Wilma,31,2005-10-23T03:00:00Z,NANTUCKET MA,0,0,0,12,12
Hurricane,Wilma,31,2005-10-23T03:00:00Z,MMCZ 205N 869W,45,0,0,0,45
Hurricane,Wilma,31,2005-10-23T03:00:00Z,HYANNIS MA,0,0,0,11,11
Hurricane,Wilma,31,2005-10-23T03:00:00Z,MYNN 251N 775W,0,0,3,0,3
Hurricane,Wilma,31,2005-10-23T03:00:00Z,BOSTON MA,0,0,0,9,9
Hurricane,Wilma,31,2005-10-23T03:00:00Z,MYGF 266N 787W,0,4,18,0,22
Hurricane,Wilma,31,2005-10-23T03:00:00Z,PORTLAND ME,0,0,0,7,7
Hurricane,Wilma,31,2005-10-23T03:00:00Z,BERMUDA,0,0,0,2,2
Hurricane,Wilma,31,2005-10-23T03:00:00Z,BAR HARBOR ME,0,0,0,6,6
Hurricane,Wilma,31,2005-10-23T03:00:00Z,MARATHON FL,1,24,5,0,30
Hurricane,Wilma,31,2005-10-23T03:00:00Z,EASTPORT ME,0,0,0,5,5
Hurricane,Wilma,31,2005-10-23T03:00:00Z,MIAMI FL,0,21,11,1,33
Hurricane,Wilma,31,2005-10-23T03:00:00Z,ST JOHN NB,0,0,0,4,4
Hurricane,Wilma,31,2005-10-23T03:00:00Z,W PALM BEACH FL,0,20,17,0,37
Hurricane,Wilma,31,2005-10-23T03:00:00Z,MONCTON NB,0,0,0,2,2
Hurricane,Wilma,31,2005-10-23T03:00:00Z,FT PIERCE FL,0,20,20,0,40
Hurricane,Wilma,31,2005-10-23T03:00:00Z,YARMOUTH NS,0,0,0,6,6
Hurricane,Wilma,31,2005-10-23T03:00:00Z,COCOA BEACH FL,0,17,23,0,40
Hurricane,Wilma,31,2005-10-23T03:00:00Z,HALIFAX NS,0,0,0,3,3
Hurricane,Wilma,31,2005-10-23T03:00:00Z,DAYTONA BEACH FL,0,8,25,0,33
Hurricane,Wilma,31,2005-10-23T03:00:00Z,KEY WEST FL,6,27,2,0,35
Hurricane,Wilma,31,2005-10-23T03:00:00Z,JACKSONVILLE FL,0,1,14,1,16
Hurricane,Wilma,31,2005-10-23T03:00:00Z,MARCO ISLAND FL,3,37,4,0,44
Hurricane,Wilma,31,2005-10-23T03:00:00Z,SAVANNAH GA,0,0,8,1,9
Hurricane,Wilma,31,2005-10-23T03:00:00Z,FT MYERS FL,2,38,5,0,45
Hurricane,Wilma,31,2005-10-23T03:00:00Z,CHARLESTON SC,0,0,9,4,13
Hurricane,Wilma,31,2005-10-23T03:00:00Z,VENICE FL,2,35,5,0,42
Hurricane,Wilma,31,2005-10-23T03:00:00Z,MYRTLE BEACH SC,0,0,7,9,16
Hurricane,Wilma,31,2005-10-23T03:00:00Z,TAMPA FL,0,25,10,0,35
Hurricane,Wilma,31,2005-10-23T03:00:00Z,WILMINGTON NC,0,0,5,13,18
Hurricane,Wilma,31,2005-10-23T03:00:00Z,CEDAR KEY FL,0,7,9,0,16
Hurricane,Wilma,31,2005-10-23T03:00:00Z,MOREHEAD CITY NC,0,0,3,17,20
Hurricane,Wilma,31,2005-10-23T03:00:00Z,ST MARKS FL,0,0,2,0,2
Hurricane,Wilma,31,2005-10-23T03:00:00Z,CAPE HATTERAS NC,0,0,1,19,20
Hurricane,Wilma,31,2005-10-23T03:00:00Z,GULF 29N 85W,0,1,1,0,2
Hurricane,Wilma,31,2005-10-23T03:00:00Z,NORFOLK VA,0,0,0,14,14
Hurricane,Wilma,32,2005-10-23T09:00:00Z,24.7N  83.3W,41,3,0,0,44
Hurricane,Wilma,32,2005-10-23T09:00:00Z,OCEAN CITY MD,0,0,2,10,12
Hurricane,Wilma,32,2005-10-23T09:00:00Z,27.4N  79.5W,0,23,6,0,29
Hurricane,Wilma,32,2005-10-23T09:00:00Z,ATLANTIC CITY NJ,0,0,1,10,11
Hurricane,Wilma,32,2005-10-23T09:00:00Z,32.5N  74.5W,0,0,14,5,19
Hurricane,Wilma,32,2005-10-23T09:00:00Z,NEW YORK CITY NY,0,0,0,11,11
Hurricane,Wilma,32,2005-10-23T09:00:00Z,MUCF 221N 805W,2,4,0,0,6
Hurricane,Wilma,32,2005-10-23T09:00:00Z,MONTAUK POINT NY,0,0,0,12,12
Hurricane,Wilma,32,2005-10-23T09:00:00Z,MUSN 216N 826W,12,2,0,0,14
Hurricane,Wilma,32,2005-10-23T09:00:00Z,PROVIDENCE RI,0,0,0,12,12
Hurricane,Wilma,32,2005-10-23T09:00:00Z,MUHA 230N 824W,29,3,0,0,32
Hurricane,Wilma,32,2005-10-23T09:00:00Z,NANTUCKET MA,0,0,0,13,13
Hurricane,Wilma,32,2005-10-23T09:00:00Z,MUAN 219N 850W,59,0,0,0,59
Hurricane,Wilma,32,2005-10-23T09:00:00Z,HYANNIS MA,0,0,0,13,13
Hurricane,Wilma,32,2005-10-23T09:00:00Z,MMCZ 205N 869W,34,0,0,0,34
Hurricane,Wilma,32,2005-10-23T09:00:00Z,BOSTON MA,0,0,0,11,11
Hurricane,Wilma,32,2005-10-23T09:00:00Z,MYEG 235N 758W,0,1,1,0,2
Hurricane,Wilma,32,2005-10-23T09:00:00Z,PORTLAND ME,0,0,0,10,10
Hurricane,Wilma,32,2005-10-23T09:00:00Z,MYAK 241N 776W,0,5,2,0,7
Hurricane,Wilma,32,2005-10-23T09:00:00Z,BAR HARBOR ME,0,0,0,9,9
Hurricane,Wilma,32,2005-10-23T09:00:00Z,MYNN 251N 775W,0,7,5,0,12
Hurricane,Wilma,32,2005-10-23T09:00:00Z,EASTPORT ME,0,0,0,8,8
Hurricane,Wilma,32,2005-10-23T09:00:00Z,MYGF 266N 787W,0,19,6,0,25
Hurricane,Wilma,32,2005-10-23T09:00:00Z,ST JOHN NB,0,0,0,6,6
Hurricane,Wilma,32,2005-10-23T09:00:00Z,BERMUDA,0,0,0,2,2
Hurricane,Wilma,32,2005-10-23T09:00:00Z,MONCTON NB,0,0,0,5,5
Hurricane,Wilma,32,2005-10-23T09:00:00Z,MARATHON FL,11,20,0,0,31
Hurricane,Wilma,32,2005-10-23T09:00:00Z,YARMOUTH NS,0,0,0,8,8
Hurricane,Wilma,32,2005-10-23T09:00:00Z,MIAMI FL,2,27,1,0,30
Hurricane,Wilma,32,2005-10-23T09:00:00Z,HALIFAX NS,0,0,0,5,5
Hurricane,Wilma,32,2005-10-23T09:00:00Z,W PALM BEACH FL,0,27,3,0,30
Hurricane,Wilma,32,2005-10-23T09:00:00Z,SABLE ISLAND NS,0,0,0,2,2
Hurricane,Wilma,32,2005-10-23T09:00:00Z,FT PIERCE FL,0,26,4,0,30
Hurricane,Wilma,32,2005-10-23T09:00:00Z,EDDY POINT NS,0,0,0,2,2
Hurricane,Wilma,32,2005-10-23T09:00:00Z,COCOA BEACH FL,0,23,5,0,28
Hurricane,Wilma,32,2005-10-23T09:00:00Z,KEY WEST FL,23,12,0,0,35
Hurricane,Wilma,32,2005-10-23T09:00:00Z,DAYTONA BEACH FL,0,16,7,0,23
Hurricane,Wilma,32,2005-10-23T09:00:00Z,MARCO ISLAND FL,8,26,1,0,35
Hurricane,Wilma,32,2005-10-23T09:00:00Z,JACKSONVILLE FL,0,6,7,0,13
Hurricane,Wilma,32,2005-10-23T09:00:00Z,FT MYERS FL,5,28,0,0,33
Hurricane,Wilma,32,2005-10-23T09:00:00Z,SAVANNAH GA,0,2,6,0,8
Hurricane,Wilma,32,2005-10-23T09:00:00Z,VENICE FL,4,25,1,0,30
Hurricane,Wilma,32,2005-10-23T09:00:00Z,CHARLESTON SC,0,1,8,2,11
Hurricane,Wilma,32,2005-10-23T09:00:00Z,TAMPA FL,1,22,2,0,25
Hurricane,Wilma,32,2005-10-23T09:00:00Z,MYRTLE BEACH SC,0,0,10,2,12
Hurricane,Wilma,32,2005-10-23T09:00:00Z,CEDAR KEY FL,0,12,2,0,14
Hurricane,Wilma,32,2005-10-23T09:00:00Z,WILMINGTON NC,0,0,10,4,14
Hurricane,Wilma,32,2005-10-23T09:00:00Z,ST MARKS FL,0,3,1,0,4
Hurricane,Wilma,32,2005-10-23T09:00:00Z,MOREHEAD CITY NC,0,0,10,6,16
Hurricane,Wilma,32,2005-10-23T09:00:00Z,APALACHICOLA FL,0,2,1,0,3
Hurricane,Wilma,32,2005-10-23T09:00:00Z,CAPE HATTERAS NC,0,0,9,7,16
Hurricane,Wilma,32,2005-10-23T09:00:00Z,GULF 29N 85W,0,4,0,0,4
Hurricane,Wilma,32,2005-10-23T09:00:00Z,NORFOLK VA,0,0,4,9,13
Hurricane,Wilma,33,2005-10-23T15:00:00Z,25.8N  81.5W,42,6,0,0,48
Hurricane,Wilma,33,2005-10-23T15:00:00Z,ATLANTIC CITY NJ,0,0,4,7,11
Hurricane,Wilma,33,2005-10-23T15:00:00Z,29.5N  77.3W,0,24,6,0,30
Hurricane,Wilma,33,2005-10-23T15:00:00Z,NEW YORK CITY NY,0,0,2,8,10
Hurricane,Wilma,33,2005-10-23T15:00:00Z,35.1N  72.4W,0,0,14,4,18
Hurricane,Wilma,33,2005-10-23T15:00:00Z,MONTAUK POINT NY,0,0,1,11,12
Hurricane,Wilma,33,2005-10-23T15:00:00Z,MUSN 216N 826W,3,0,0,0,3
Hurricane,Wilma,33,2005-10-23T15:00:00Z,PROVIDENCE RI,0,0,1,11,12
Hurricane,Wilma,33,2005-10-23T15:00:00Z,MUHA 230N 824W,29,0,0,0,29
Hurricane,Wilma,33,2005-10-23T15:00:00Z,NANTUCKET MA,0,0,0,13,13
Hurricane,Wilma,33,2005-10-23T15:00:00Z,MUAN 219N 850W,74,0,0,0,74
Hurricane,Wilma,33,2005-10-23T15:00:00Z,HYANNIS MA,0,0,0,12,12
Hurricane,Wilma,33,2005-10-23T15:00:00Z,MYAK 241N 776W,0,3,0,0,3
Hurricane,Wilma,33,2005-10-23T15:00:00Z,BOSTON MA,0,0,0,11,11
Hurricane,Wilma,33,2005-10-23T15:00:00Z,MYNN 251N 775W,0,9,0,0,9
Hurricane,Wilma,33,2005-10-23T15:00:00Z,PORTLAND ME,0,0,0,10,10
Hurricane,Wilma,33,2005-10-23T15:00:00Z,MYGF 266N 787W,5,27,0,0,32
Hurricane,Wilma,33,2005-10-23T15:00:00Z,BAR HARBOR ME,0,0,0,10,10
Hurricane,Wilma,33,2005-10-23T15:00:00Z,BERMUDA,0,0,0,2,2
Hurricane,Wilma,33,2005-10-23T15:00:00Z,EASTPORT ME,0,0,0,10,10
Hurricane,Wilma,33,2005-10-23T15:00:00Z,MARATHON FL,35,4,0,0,39
Hurricane,Wilma,33,2005-10-23T15:00:00Z,ST JOHN NB,0,0,0,9,9
Hurricane,Wilma,33,2005-10-23T15:00:00Z,MIAMI FL,26,14,0,0,40
Hurricane,Wilma,33,2005-10-23T15:00:00Z,MONCTON NB,0,0,0,8,8
Hurricane,Wilma,33,2005-10-23T15:00:00Z,W PALM BEACH FL,20,22,0,0,42
Hurricane,Wilma,33,2005-10-23T15:00:00Z,YARMOUTH NS,0,0,0,10,10
Hurricane,Wilma,33,2005-10-23T15:00:00Z,FT PIERCE FL,14,26,0,0,40
Hurricane,Wilma,33,2005-10-23T15:00:00Z,HALIFAX NS,0,0,0,8,8
Hurricane,Wilma,33,2005-10-23T15:00:00Z,COCOA BEACH FL,8,27,1,0,36
Hurricane,Wilma,33,2005-10-23T15:00:00Z,SABLE ISLAND NS,0,0,0,4,4
Hurricane,Wilma,33,2005-10-23T15:00:00Z,DAYTONA BEACH FL,2,21,0,0,23
Hurricane,Wilma,33,2005-10-23T15:00:00Z,SYDNEY NS,0,0,0,4,4
Hurricane,Wilma,33,2005-10-23T15:00:00Z,JACKSONVILLE FL,0,7,1,0,8
Hurricane,Wilma,33,2005-10-23T15:00:00Z,EDDY POINT NS,0,0,0,6,6
Hurricane,Wilma,33,2005-10-23T15:00:00Z,SAVANNAH GA,0,4,0,0,4
Hurricane,Wilma,33,2005-10-23T15:00:00Z,PTX BASQUES NFLD,0,0,0,3,3
Hurricane,Wilma,33,2005-10-23T15:00:00Z,CHARLESTON SC,0,4,3,0,7
Hurricane,Wilma,33,2005-10-23T15:00:00Z,BURGEO NFLD,0,0,0,2,2
Hurricane,Wilma,33,2005-10-23T15:00:00Z,MYRTLE BEACH SC,0,3,6,0,9
Hurricane,Wilma,33,2005-10-23T15:00:00Z,KEY WEST FL,43,2,0,0,45
Hurricane,Wilma,33,2005-10-23T15:00:00Z,WILMINGTON NC,0,1,10,0,11
Hurricane,Wilma,33,2005-10-23T15:00:00Z,MARCO ISLAND FL,43,5,0,0,48
Hurricane,Wilma,33,2005-10-23T15:00:00Z,MOREHEAD CITY NC,0,1,13,1,15
Hurricane,Wilma,33,2005-10-23T15:00:00Z,FT MYERS FL,36,8,0,0,44
Hurricane,Wilma,33,2005-10-23T15:00:00Z,CAPE HATTERAS NC,0,0,15,2,17
Hurricane,Wilma,33,2005-10-23T15:00:00Z,VENICE FL,25,9,0,0,34
Hurricane,Wilma,33,2005-10-23T15:00:00Z,NORFOLK VA,0,0,9,2,11
Hurricane,Wilma,33,2005-10-23T15:00:00Z,TAMPA FL,9,12,0,0,21
Hurricane,Wilma,33,2005-10-23T15:00:00Z,OCEAN CITY MD,0,0,7,5,12
Hurricane,Wilma,33,2005-10-23T15:00:00Z,CEDAR KEY FL,1,5,0,0,6
Hurricane,Wilma,34,2005-10-23T21:00:00Z,27.6N  79.3W,34,3,0,0,37
Hurricane,Wilma,34,2005-10-23T21:00:00Z,MONTAUK POINT NY,0,0,4,1,5
Hurricane,Wilma,34,2005-10-23T21:00:00Z,32.2N  74.5W,0,16,4,0,20
Hurricane,Wilma,34,2005-10-23T21:00:00Z,PROVIDENCE RI,0,0,4,2,6
Hurricane,Wilma,34,2005-10-23T21:00:00Z,38.5N  68.5W,0,0,9,3,12
Hurricane,Wilma,34,2005-10-23T21:00:00Z,NANTUCKET MA,0,0,6,2,8
Hurricane,Wilma,34,2005-10-23T21:00:00Z,MUHA 230N 824W,26,0,0,0,26
Hurricane,Wilma,34,2005-10-23T21:00:00Z,HYANNIS MA,0,0,5,3,8
Hurricane,Wilma,34,2005-10-23T21:00:00Z,MUAN 219N 850W,52,0,0,0,52
Hurricane,Wilma,34,2005-10-23T21:00:00Z,BOSTON MA,0,0,3,3,6
Hurricane,Wilma,34,2005-10-23T21:00:00Z,MYAK 241N 776W,4,2,0,0,6
Hurricane,Wilma,34,2005-10-23T21:00:00Z,PORTLAND ME,0,0,2,4,6
Hurricane,Wilma,34,2005-10-23T21:00:00Z,MYNN 251N 775W,9,5,0,0,14
Hurricane,Wilma,34,2005-10-23T21:00:00Z,BAR HARBOR ME,0,0,2,6,8
Hurricane,Wilma,34,2005-10-23T21:00:00Z,MYGF 266N 787W,33,3,0,0,36
Hurricane,Wilma,34,2005-10-23T21:00:00Z,EASTPORT ME,0,0,2,7,9
Hurricane,Wilma,34,2005-10-23T21:00:00Z,BERMUDA,0,0,1,1,2
Hurricane,Wilma,34,2005-10-23T21:00:00Z,ST JOHN NB,0,0,1,9,10
Hurricane,Wilma,34,2005-10-23T21:00:00Z,MARATHON FL,52,0,0,0,52
Hurricane,Wilma,34,2005-10-23T21:00:00Z,MONCTON NB,0,0,1,9,10
Hurricane,Wilma,34,2005-10-23T21:00:00Z,MIAMI FL,49,0,0,0,49
Hurricane,Wilma,34,2005-10-23T21:00:00Z,YARMOUTH NS,0,0,2,8,10
Hurricane,Wilma,34,2005-10-23T21:00:00Z,W PALM BEACH FL,45,1,0,0,46
Hurricane,Wilma,34,2005-10-23T21:00:00Z,HALIFAX NS,0,0,1,9,10
Hurricane,Wilma,34,2005-10-23T21:00:00Z,FT PIERCE FL,38,1,0,0,39
Hurricane,Wilma,34,2005-10-23T21:00:00Z,SABLE ISLAND NS,0,0,0,8,8
Hurricane,Wilma,34,2005-10-23T21:00:00Z,COCOA BEACH FL,26,3,0,0,29
Hurricane,Wilma,34,2005-10-23T21:00:00Z,SYDNEY NS,0,0,0,8,8
Hurricane,Wilma,34,2005-10-23T21:00:00Z,DAYTONA BEACH FL,10,2,0,0,12
Hurricane,Wilma,34,2005-10-23T21:00:00Z,EDDY POINT NS,0,0,0,9,9
Hurricane,Wilma,34,2005-10-23T21:00:00Z,JACKSONVILLE FL,1,1,0,0,2
Hurricane,Wilma,34,2005-10-23T21:00:00Z,PTX BASQUES NFLD,0,0,0,7,7
Hurricane,Wilma,34,2005-10-23T21:00:00Z,CHARLESTON SC,0,2,0,0,2
Hurricane,Wilma,34,2005-10-23T21:00:00Z,BURGEO NFLD,0,0,0,6,6
Hurricane,Wilma,34,2005-10-23T21:00:00Z,MYRTLE BEACH SC,0,3,0,0,3
Hurricane,Wilma,34,2005-10-23T21:00:00Z,ILE ST PIERRE,0,0,0,5,5
Hurricane,Wilma,34,2005-10-23T21:00:00Z,WILMINGTON NC,0,4,0,0,4
Hurricane,Wilma,34,2005-10-23T21:00:00Z,CAPE RACE NFLD,0,0,0,2,2
Hurricane,Wilma,34,2005-10-23T21:00:00Z,MOREHEAD CITY NC,0,6,1,0,7
Hurricane,Wilma,34,2005-10-23T21:00:00Z,KEY WEST FL,62,0,0,0,62
Hurricane,Wilma,34,2005-10-23T21:00:00Z,CAPE HATTERAS NC,0,6,2,0,8
Hurricane,Wilma,34,2005-10-23T21:00:00Z,MARCO ISLAND FL,57,0,0,0,57
Hurricane,Wilma,34,2005-10-23T21:00:00Z,NORFOLK VA,0,2,1,0,3
Hurricane,Wilma,34,2005-10-23T21:00:00Z,FT MYERS FL,46,0,0,0,46
Hurricane,Wilma,34,2005-10-23T21:00:00Z,OCEAN CITY MD,0,1,2,0,3
Hurricane,Wilma,34,2005-10-23T21:00:00Z,VENICE FL,27,0,0,0,27
Hurricane,Wilma,34,2005-10-23T21:00:00Z,ATLANTIC CITY NJ,0,0,2,0,2
Hurricane,Wilma,34,2005-10-23T21:00:00Z,TAMPA FL,11,0,0,0,11
Hurricane,Wilma,34,2005-10-23T21:00:00Z,NEW YORK CITY NY,0,0,2,1,3
Hurricane,Wilma,34,2005-10-23T21:00:00Z,CEDAR KEY FL,2,0,0,0,2
Hurricane,Wilma,35,2005-10-24T03:00:00Z,30.2N  76.3W,27,3,0,0,30
Hurricane,Wilma,35,2005-10-24T03:00:00Z,NANTUCKET MA,0,3,7,0,10
Hurricane,Wilma,35,2005-10-24T03:00:00Z,36.5N  69.9W,0,15,3,1,19
Hurricane,Wilma,35,2005-10-24T03:00:00Z,HYANNIS MA,0,3,5,1,9
Hurricane,Wilma,35,2005-10-24T03:00:00Z,42.9N  64.7W,0,0,11,2,13
Hurricane,Wilma,35,2005-10-24T03:00:00Z,BOSTON MA,0,2,4,0,6
Hurricane,Wilma,35,2005-10-24T03:00:00Z,MUHA 230N 824W,8,0,0,0,8
Hurricane,Wilma,35,2005-10-24T03:00:00Z,PORTLAND ME,0,1,4,1,6
Hurricane,Wilma,35,2005-10-24T03:00:00Z,MYNN 251N 775W,5,0,0,0,5
Hurricane,Wilma,35,2005-10-24T03:00:00Z,BAR HARBOR ME,0,0,7,2,9
Hurricane,Wilma,35,2005-10-24T03:00:00Z,MYGF 266N 787W,37,0,0,0,37
Hurricane,Wilma,35,2005-10-24T03:00:00Z,EASTPORT ME,0,0,8,3,11
Hurricane,Wilma,35,2005-10-24T03:00:00Z,BERMUDA,0,1,1,0,2
Hurricane,Wilma,35,2005-10-24T03:00:00Z,ST JOHN NB,0,0,8,3,11
Hurricane,Wilma,35,2005-10-24T03:00:00Z,MARATHON FL,48,0,0,0,48
Hurricane,Wilma,35,2005-10-24T03:00:00Z,MONCTON NB,0,0,7,5,12
Hurricane,Wilma,35,2005-10-24T03:00:00Z,MIAMI FL,55,0,0,0,55
Hurricane,Wilma,35,2005-10-24T03:00:00Z,YARMOUTH NS,0,0,10,2,12
Hurricane,Wilma,35,2005-10-24T03:00:00Z,W PALM BEACH FL,55,0,0,0,55
Hurricane,Wilma,35,2005-10-24T03:00:00Z,HALIFAX NS,0,0,8,5,13
Hurricane,Wilma,35,2005-10-24T03:00:00Z,FT PIERCE FL,50,0,0,0,50
Hurricane,Wilma,35,2005-10-24T03:00:00Z,SABLE ISLAND NS,0,0,4,7,11
Hurricane,Wilma,35,2005-10-24T03:00:00Z,COCOA BEACH FL,33,0,0,0,33
Hurricane,Wilma,35,2005-10-24T03:00:00Z,SYDNEY NS,0,0,3,8,11
Hurricane,Wilma,35,2005-10-24T03:00:00Z,DAYTONA BEACH FL,10,0,0,0,10
Hurricane,Wilma,35,2005-10-24T03:00:00Z,EDDY POINT NS,0,0,5,7,12
Hurricane,Wilma,35,2005-10-24T03:00:00Z,MYRTLE BEACH SC,2,0,0,0,2
Hurricane,Wilma,35,2005-10-24T03:00:00Z,PTX BASQUES NFLD,0,0,2,8,10
Hurricane,Wilma,35,2005-10-24T03:00:00Z,WILMINGTON NC,2,2,0,0,4
Hurricane,Wilma,35,2005-10-24T03:00:00Z,BURGEO NFLD,0,0,1,8,9
Hurricane,Wilma,35,2005-10-24T03:00:00Z,MOREHEAD CITY NC,2,4,1,0,7
Hurricane,Wilma,35,2005-10-24T03:00:00Z,ILE ST PIERRE,0,0,1,7,8
Hurricane,Wilma,35,2005-10-24T03:00:00Z,CAPE HATTERAS NC,1,7,0,0,8
Hurricane,Wilma,35,2005-10-24T03:00:00Z,CAPE RACE NFLD,0,0,0,5,5
Hurricane,Wilma,35,2005-10-24T03:00:00Z,NORFOLK VA,0,3,0,0,3
Hurricane,Wilma,35,2005-10-24T03:00:00Z,KEY WEST FL,64,0,0,0,64
Hurricane,Wilma,35,2005-10-24T03:00:00Z,OCEAN CITY MD,0,3,0,0,3
Hurricane,Wilma,35,2005-10-24T03:00:00Z,MARCO ISLAND FL,70,0,0,0,70
Hurricane,Wilma,35,2005-10-24T03:00:00Z,ATLANTIC CITY NJ,0,2,0,0,2
Hurricane,Wilma,35,2005-10-24T03:00:00Z,FT MYERS FL,53,0,0,0,53
Hurricane,Wilma,35,2005-10-24T03:00:00Z,NEW YORK CITY NY,0,2,1,0,3
Hurricane,Wilma,35,2005-10-24T03:00:00Z,VENICE FL,20,0,0,0,20
Hurricane,Wilma,35,2005-10-24T03:00:00Z,MONTAUK POINT NY,0,3,3,0,6
Hurricane,Wilma,35,2005-10-24T03:00:00Z,TAMPA FL,6,0,0,0,6
Hurricane,Wilma,35,2005-10-24T03:00:00Z,PROVIDENCE RI,0,2,4,0,6
Hurricane,Wilma,36,2005-10-24T09:00:00Z,32.9N  73.1W,22,9,0,0,31
Hurricane,Wilma,36,2005-10-24T09:00:00Z,BAR HARBOR ME,0,1,2,0,3
Hurricane,Wilma,36,2005-10-24T09:00:00Z,39.0N  66.5W,0,15,7,0,22
Hurricane,Wilma,36,2005-10-24T09:00:00Z,EASTPORT ME,0,1,4,0,5
Hurricane,Wilma,36,2005-10-24T09:00:00Z,44.0N  60.0W,0,0,12,2,14
Hurricane,Wilma,36,2005-10-24T09:00:00Z,ST JOHN NB,0,0,6,1,7
Hurricane,Wilma,36,2005-10-24T09:00:00Z,MYGF 266N 787W,49,0,0,0,49
Hurricane,Wilma,36,2005-10-24T09:00:00Z,MONCTON NB,0,0,6,1,7
Hurricane,Wilma,36,2005-10-24T09:00:00Z,MARATHON FL,55,0,0,0,55
Hurricane,Wilma,36,2005-10-24T09:00:00Z,YARMOUTH NS,0,2,8,0,10
Hurricane,Wilma,36,2005-10-24T09:00:00Z,MIAMI FL,75,0,0,0,75
Hurricane,Wilma,36,2005-10-24T09:00:00Z,HALIFAX NS,0,1,11,1,13
Hurricane,Wilma,36,2005-10-24T09:00:00Z,W PALM BEACH FL,81,0,0,0,81
Hurricane,Wilma,36,2005-10-24T09:00:00Z,SABLE ISLAND NS,0,0,12,2,14
Hurricane,Wilma,36,2005-10-24T09:00:00Z,FT PIERCE FL,68,0,0,0,68
Hurricane,Wilma,36,2005-10-24T09:00:00Z,SYDNEY NS,0,0,8,4,12
Hurricane,Wilma,36,2005-10-24T09:00:00Z,COCOA BEACH FL,36,0,0,0,36
Hurricane,Wilma,36,2005-10-24T09:00:00Z,EDDY POINT NS,0,0,10,3,13
Hurricane,Wilma,36,2005-10-24T09:00:00Z,DAYTONA BEACH FL,5,0,0,0,5
Hurricane,Wilma,36,2005-10-24T09:00:00Z,PTX BASQUES NFLD,0,0,5,6,11
Hurricane,Wilma,36,2005-10-24T09:00:00Z,WILMINGTON NC,1,1,0,0,2
Hurricane,Wilma,36,2005-10-24T09:00:00Z,BURGEO NFLD,0,0,4,7,11
Hurricane,Wilma,36,2005-10-24T09:00:00Z,MOREHEAD CITY NC,3,1,0,0,4
Hurricane,Wilma,36,2005-10-24T09:00:00Z,ILE ST PIERRE,0,0,3,9,12
Hurricane,Wilma,36,2005-10-24T09:00:00Z,CAPE HATTERAS NC,3,3,0,0,6
Hurricane,Wilma,36,2005-10-24T09:00:00Z,CAPE RACE NFLD,0,0,1,9,10
Hurricane,Wilma,36,2005-10-24T09:00:00Z,MONTAUK POINT NY,0,2,0,0,2
Hurricane,Wilma,36,2005-10-24T09:00:00Z,HIBERNIA OILFLD,0,0,0,6,6
Hurricane,Wilma,36,2005-10-24T09:00:00Z,PROVIDENCE RI,0,2,0,0,2
Hurricane,Wilma,36,2005-10-24T09:00:00Z,KEY WEST FL,81,0,0,0,81
Hurricane,Wilma,36,2005-10-24T09:00:00Z,NANTUCKET MA,0,4,2,0,6
Hurricane,Wilma,36,2005-10-24T09:00:00Z,MARCO ISLAND FL,99,0,0,0,99
Hurricane,Wilma,36,2005-10-24T09:00:00Z,HYANNIS MA,0,3,1,0,4
Hurricane,Wilma,36,2005-10-24T09:00:00Z,FT MYERS FL,71,0,0,0,71
Hurricane,Wilma,36,2005-10-24T09:00:00Z,BOSTON MA,0,1,1,0,2
Hurricane,Wilma,36,2005-10-24T09:00:00Z,VENICE FL,18,0,0,0,18
Hurricane,Wilma,36,2005-10-24T09:00:00Z,PORTLAND ME,0,1,0,1,2
Hurricane,Wilma,36,2005-10-24T09:00:00Z,TAMPA FL,2,0,0,0,2
Hurricane,Wilma,37,2005-10-24T15:00:00Z,36.1N  68.9W,22,10,0,0,32
Hurricane,Wilma,37,2005-10-24T15:00:00Z,MONCTON NB,0,2,3,0,5
Hurricane,Wilma,37,2005-10-24T15:00:00Z,42.1N  61.6W,0,16,6,1,23
Hurricane,Wilma,37,2005-10-24T15:00:00Z,YARMOUTH NS,0,5,2,1,8
Hurricane,Wilma,37,2005-10-24T15:00:00Z,44.9N  55.7W,0,1,13,2,16
Hurricane,Wilma,37,2005-10-24T15:00:00Z,HALIFAX NS,0,7,6,0,13
Hurricane,Wilma,37,2005-10-24T15:00:00Z,MYGF 266N 787W,72,0,0,0,72
Hurricane,Wilma,37,2005-10-24T15:00:00Z,SABLE ISLAND NS,0,8,11,0,19
Hurricane,Wilma,37,2005-10-24T15:00:00Z,MARATHON FL,9,0,0,0,9
Hurricane,Wilma,37,2005-10-24T15:00:00Z,SYDNEY NS,0,2,11,1,14
Hurricane,Wilma,37,2005-10-24T15:00:00Z,MIAMI FL,99,0,0,0,99
Hurricane,Wilma,37,2005-10-24T15:00:00Z,EDDY POINT NS,0,4,10,1,15
Hurricane,Wilma,37,2005-10-24T15:00:00Z,W PALM BEACH FL,99,0,0,0,99
Hurricane,Wilma,37,2005-10-24T15:00:00Z,PTX BASQUES NFLD,0,1,9,1,11
Hurricane,Wilma,37,2005-10-24T15:00:00Z,FT PIERCE FL,99,0,0,0,99
Hurricane,Wilma,37,2005-10-24T15:00:00Z,BURGEO NFLD,0,0,10,3,13
Hurricane,Wilma,37,2005-10-24T15:00:00Z,COCOA BEACH FL,15,0,0,0,15
Hurricane,Wilma,37,2005-10-24T15:00:00Z,ILE ST PIERRE,0,0,12,3,15
Hurricane,Wilma,37,2005-10-24T15:00:00Z,CAPE HATTERAS NC,2,0,0,0,2
Hurricane,Wilma,37,2005-10-24T15:00:00Z,CAPE RACE NFLD,0,0,7,7,14
Hurricane,Wilma,37,2005-10-24T15:00:00Z,NANTUCKET MA,0,3,0,0,3
Hurricane,Wilma,37,2005-10-24T15:00:00Z,HIBERNIA OILFLD,0,0,1,10,11
Hurricane,Wilma,37,2005-10-24T15:00:00Z,HYANNIS MA,0,2,0,0,2
Hurricane,Wilma,37,2005-10-24T15:00:00Z,MARCO ISLAND FL,99,0,0,0,99
Hurricane,Wilma,37,2005-10-24T15:00:00Z,EASTPORT ME,0,2,1,0,3
Hurricane,Wilma,37,2005-10-24T15:00:00Z,FT MYERS FL,99,0,0,0,99
Hurricane,Wilma,37,2005-10-24T15:00:00Z,ST JOHN NB,0,2,2,0,4
Hurricane,Wilma,38,2005-10-24T18:30:00Z,36.1N  68.9W,20,9,0,0,29
Hurricane,Wilma,38,2005-10-24T18:30:00Z,MONCTON NB,0,2,3,0,5
Hurricane,Wilma,38,2005-10-24T18:30:00Z,42.1N  61.6W,0,16,7,0,23
Hurricane,Wilma,38,2005-10-24T18:30:00Z,YARMOUTH NS,0,6,1,1,8
Hurricane,Wilma,38,2005-10-24T18:30:00Z,44.9N  55.7W,0,0,13,3,16
Hurricane,Wilma,38,2005-10-24T18:30:00Z,HALIFAX NS,0,7,6,0,13
Hurricane,Wilma,38,2005-10-24T18:30:00Z,MYGF 266N 787W,68,0,0,0,68
Hurricane,Wilma,38,2005-10-24T18:30:00Z,SABLE ISLAND NS,0,7,12,0,19
Hurricane,Wilma,38,2005-10-24T18:30:00Z,MARATHON FL,8,0,0,0,8
Hurricane,Wilma,38,2005-10-24T18:30:00Z,SYDNEY NS,0,2,11,1,14
Hurricane,Wilma,38,2005-10-24T18:30:00Z,MIAMI FL,99,0,0,0,99
Hurricane,Wilma,38,2005-10-24T18:30:00Z,EDDY POINT NS,0,4,10,0,14
Hurricane,Wilma,38,2005-10-24T18:30:00Z,W PALM BEACH FL,99,0,0,0,99
Hurricane,Wilma,38,2005-10-24T18:30:00Z,PTX BASQUES NFLD,0,0,9,2,11
Hurricane,Wilma,38,2005-10-24T18:30:00Z,FT PIERCE FL,99,0,0,0,99
Hurricane,Wilma,38,2005-10-24T18:30:00Z,BURGEO NFLD,0,0,10,2,12
Hurricane,Wilma,38,2005-10-24T18:30:00Z,COCOA BEACH FL,16,0,0,0,16
Hurricane,Wilma,38,2005-10-24T18:30:00Z,ILE ST PIERRE,0,0,11,3,14
Hurricane,Wilma,38,2005-10-24T18:30:00Z,CAPE HATTERAS NC,2,0,0,0,2
Hurricane,Wilma,38,2005-10-24T18:30:00Z,CAPE RACE NFLD,0,0,6,7,13
Hurricane,Wilma,38,2005-10-24T18:30:00Z,NANTUCKET MA,0,3,0,0,3
Hurricane,Wilma,38,2005-10-24T18:30:00Z,HIBERNIA OILFLD,0,0,1,9,10
Hurricane,Wilma,38,2005-10-24T18:30:00Z,HYANNIS MA,0,2,0,0,2
Hurricane,Wilma,38,2005-10-24T18:30:00Z,MARCO ISLAND FL,99,0,0,0,99
Hurricane,Wilma,38,2005-10-24T18:30:00Z,EASTPORT ME,0,2,1,0,3
Hurricane,Wilma,38,2005-10-24T18:30:00Z,FT MYERS FL,99,0,0,0,99
Hurricane,Wilma,38,2005-10-24T18:30:00Z,ST JOHN NB,0,2,2,0,4
Hurricane,Wilma,39,2005-10-24T21:00:00Z,39.4N  65.2W,24,10,0,0,34
Hurricane,Wilma,39,2005-10-24T21:00:00Z,SABLE ISLAND NS,0,18,2,0,20
Hurricane,Wilma,39,2005-10-24T21:00:00Z,43.1N  58.2W,0,19,3,0,22
Hurricane,Wilma,39,2005-10-24T21:00:00Z,SYDNEY NS,0,6,4,0,10
Hurricane,Wilma,39,2005-10-24T21:00:00Z,45.0N  53.0W,0,2,12,2,16
Hurricane,Wilma,39,2005-10-24T21:00:00Z,EDDY POINT NS,0,8,2,1,11
Hurricane,Wilma,39,2005-10-24T21:00:00Z,MYGF 266N 787W,30,0,0,0,30
Hurricane,Wilma,39,2005-10-24T21:00:00Z,PTX BASQUES NFLD,0,2,5,0,7
Hurricane,Wilma,39,2005-10-24T21:00:00Z,W PALM BEACH FL,6,0,0,0,6
Hurricane,Wilma,39,2005-10-24T21:00:00Z,BURGEO NFLD,0,2,7,1,10
Hurricane,Wilma,39,2005-10-24T21:00:00Z,FT PIERCE FL,25,0,0,0,25
Hurricane,Wilma,39,2005-10-24T21:00:00Z,ILE ST PIERRE,0,4,9,1,14
Hurricane,Wilma,39,2005-10-24T21:00:00Z,MONCTON NB,0,1,1,0,2
Hurricane,Wilma,39,2005-10-24T21:00:00Z,CAPE RACE NFLD,0,1,12,2,15
Hurricane,Wilma,39,2005-10-24T21:00:00Z,YARMOUTH NS,1,3,0,0,4
Hurricane,Wilma,39,2005-10-24T21:00:00Z,HIBERNIA OILFLD,0,0,5,7,12
Hurricane,Wilma,39,2005-10-24T21:00:00Z,HALIFAX NS,0,7,1,0,8
Hurricane,Wilma,40,2005-10-25T03:00:00Z,41.2N  61.3W,27,8,0,0,35
Hurricane,Wilma,40,2005-10-25T03:00:00Z,EDDY POINT NS,1,7,2,0,10
Hurricane,Wilma,40,2005-10-25T03:00:00Z,44.0N  56.0W,0,19,3,0,22
Hurricane,Wilma,40,2005-10-25T03:00:00Z,PTX BASQUES NFLD,0,3,4,0,7
Hurricane,Wilma,40,2005-10-25T03:00:00Z,46.1N  51.2W,0,2,12,2,16
Hurricane,Wilma,40,2005-10-25T03:00:00Z,BURGEO NFLD,0,4,6,1,11
Hurricane,Wilma,40,2005-10-25T03:00:00Z,HALIFAX NS,1,4,1,0,6
Hurricane,Wilma,40,2005-10-25T03:00:00Z,ILE ST PIERRE,0,8,7,1,16
Hurricane,Wilma,40,2005-10-25T03:00:00Z,SABLE ISLAND NS,4,18,0,0,22
Hurricane,Wilma,40,2005-10-25T03:00:00Z,CAPE RACE NFLD,0,4,12,1,17
Hurricane,Wilma,40,2005-10-25T03:00:00Z,SYDNEY NS,0,8,2,1,11
Hurricane,Wilma,40,2005-10-25T03:00:00Z,HIBERNIA OILFLD,0,0,7,6,13
Hurricane,Wilma,41,2005-10-25T09:00:00Z,43.0N  57.0W,18,6,1,0,25
Hurricane,Wilma,41,2005-10-25T09:00:00Z,EDDY POINT NS,4,1,0,0,5
Hurricane,Wilma,41,2005-10-25T09:00:00Z,45.0N  51.0W,0,14,3,0,17
Hurricane,Wilma,41,2005-10-25T09:00:00Z,PTX BASQUES NFLD,1,3,1,0,5
Hurricane,Wilma,41,2005-10-25T09:00:00Z,46.0N  45.0W,0,1,9,3,13
Hurricane,Wilma,41,2005-10-25T09:00:00Z,BURGEO NFLD,1,6,1,1,9
Hurricane,Wilma,41,2005-10-25T09:00:00Z,HALIFAX NS,2,0,0,0,2
Hurricane,Wilma,41,2005-10-25T09:00:00Z,ILE ST PIERRE,2,11,1,0,14
Hurricane,Wilma,41,2005-10-25T09:00:00Z,SABLE ISLAND NS,16,2,0,1,19
Hurricane,Wilma,41,2005-10-25T09:00:00Z,CAPE RACE NFLD,0,14,2,0,16
Hurricane,Wilma,41,2005-10-25T09:00:00Z,SYDNEY NS,3,3,0,0,6
Hurricane,Wilma,41,2005-10-25T09:00:00Z,HIBERNIA OILFLD,0,4,8,2,14
Hurricane,Wilma,42,2005-10-25T15:00:00Z,44.9N  54.3W,21,3,0,0,24
Hurricane,Wilma,42,2005-10-25T15:00:00Z,PTX BASQUES NFLD,2,0,0,0,2
Hurricane,Wilma,42,2005-10-25T15:00:00Z,46.0N  47.8W,0,13,2,0,15
Hurricane,Wilma,42,2005-10-25T15:00:00Z,BURGEO NFLD,6,2,0,0,8
Hurricane,Wilma,42,2005-10-25T15:00:00Z,46.0N  40.9W,0,1,8,3,12
Hurricane,Wilma,42,2005-10-25T15:00:00Z,ILE ST PIERRE,16,2,0,0,18
Hurricane,Wilma,42,2005-10-25T15:00:00Z,SABLE ISLAND NS,19,0,0,0,19
Hurricane,Wilma,42,2005-10-25T15:00:00Z,CAPE RACE NFLD,11,9,0,0,20
Hurricane,Wilma,42,2005-10-25T15:00:00Z,SYDNEY NS,2,1,0,0,3
Hurricane,Wilma,42,2005-10-25T15:00:00Z,HIBERNIA OILFLD,0,14,1,1,16
Hurricane,Wilma,43,2005-10-25T21:00:00Z,46.0N  50.5W,30,3,0,0,33
Hurricane,Wilma,43,2005-10-25T21:00:00Z,PTX BASQUES NFLD,6,0,0,0,6
Hurricane,Wilma,43,2005-10-25T21:00:00Z,46.0N  42.0W,0,13,2,1,16
Hurricane,Wilma,43,2005-10-25T21:00:00Z,BURGEO NFLD,14,0,0,0,14
Hurricane,Wilma,43,2005-10-25T21:00:00Z,46.0N  34.5W,0,1,7,3,11
Hurricane,Wilma,43,2005-10-25T21:00:00Z,ILE ST PIERRE,31,1,0,0,32
Hurricane,Wilma,43,2005-10-25T21:00:00Z,SABLE ISLAND NS,47,0,0,0,47
Hurricane,Wilma,43,2005-10-25T21:00:00Z,CAPE RACE NFLD,35,0,0,0,35
Hurricane,Wilma,43,2005-10-25T21:00:00Z,SYDNEY NS,12,0,0,0,12
Hurricane,Wilma,43,2005-10-25T21:00:00Z,HIBERNIA OILFLD,18,9,0,0,27
Hurricane,Wilma,43,2005-10-25T21:00:00Z,EDDY POINT NS,9,0,0,0,9
Tropical Depression,Twenty-Five,1,2005-10-22T15:00:00Z,18.2N  71.4W,50,0,0,0,50
Tropical Depression,Twenty-Five,1,2005-10-22T15:00:00Z,MBJT 215N 712W,2,24,7,0,33
Tropical Depression,Twenty-Five,1,2005-10-22T15:00:00Z,20.6N  72.8W,4,36,2,0,42
Tropical Depression,Twenty-Five,1,2005-10-22T15:00:00Z,MYMM 224N 730W,0,25,15,0,40
Tropical Depression,Twenty-Five,1,2005-10-22T15:00:00Z,24.9N  72.3W,0,1,32,3,36
Tropical Depression,Twenty-Five,1,2005-10-22T15:00:00Z,MYSM 241N 745W,0,3,29,0,32
Tropical Depression,Twenty-Five,1,2005-10-22T15:00:00Z,MDSD 185N 697W,48,0,0,0,48
Tropical Depression,Twenty-Five,1,2005-10-22T15:00:00Z,MYEG 235N 758W,0,2,18,1,21
Tropical Depression,Twenty-Five,1,2005-10-22T15:00:00Z,MDCB 176N 714W,49,0,0,0,49
Tropical Depression,Twenty-Five,1,2005-10-22T15:00:00Z,MYAK 241N 776W,0,0,3,0,3
Tropical Depression,Twenty-Five,1,2005-10-22T15:00:00Z,MTPP 186N 724W,37,6,0,0,43
Tropical Depression,Twenty-Five,1,2005-10-22T15:00:00Z,MYNN 251N 775W,0,0,3,1,4
Tropical Depression,Twenty-Five,1,2005-10-22T15:00:00Z,MTCA 183N 738W,10,17,0,0,27
Tropical Depression,Twenty-Five,1,2005-10-22T15:00:00Z,BERMUDA,0,0,0,21,21
Tropical Depression,Twenty-Five,1,2005-10-22T15:00:00Z,MUGM 200N 751W,0,19,4,0,23
Tropical Depression,Twenty-Five,1,2005-10-22T15:00:00Z,NANTUCKET MA,0,0,0,2,2
Tropical Depression,Twenty-Five,1,2005-10-22T15:00:00Z,MDPP 198N 707W,29,7,0,0,36
Tropical Depression,Twenty-Five,1,2005-10-22T15:00:00Z,HYANNIS MA,0,0,0,2,2
Tropical Storm,Alpha,2,2005-10-22T21:00:00Z,20.8N  71.8W,57,0,0,0,57
Tropical Storm,Alpha,2,2005-10-22T21:00:00Z,MYMM 224N 730W,21,20,0,0,41
Tropical Storm,Alpha,2,2005-10-22T21:00:00Z,23.6N  71.9W,5,33,4,0,42
Tropical Storm,Alpha,2,2005-10-22T21:00:00Z,MYSM 241N 745W,0,19,5,0,24
Tropical Storm,Alpha,2,2005-10-22T21:00:00Z,28.5N  70.5W,0,0,27,3,30
Tropical Storm,Alpha,2,2005-10-22T21:00:00Z,MYEG 235N 758W,0,5,1,0,6
Tropical Storm,Alpha,2,2005-10-22T21:00:00Z,MDSD 185N 697W,86,0,0,0,86
Tropical Storm,Alpha,2,2005-10-22T21:00:00Z,BERMUDA,0,0,0,20,20
Tropical Storm,Alpha,2,2005-10-22T21:00:00Z,MDCB 176N 714W,43,0,0,0,43
Tropical Storm,Alpha,2,2005-10-22T21:00:00Z,NANTUCKET MA,0,0,0,3,3
Tropical Storm,Alpha,2,2005-10-22T21:00:00Z,MTPP 186N 724W,36,1,0,0,37
Tropical Storm,Alpha,2,2005-10-22T21:00:00Z,HYANNIS MA,0,0,0,2,2
Tropical Storm,Alpha,2,2005-10-22T21:00:00Z,MTCA 183N 738W,3,1,0,0,4
Tropical Storm,Alpha,2,2005-10-22T21:00:00Z,YARMOUTH NS,0,0,0,2,2
Tropical Storm,Alpha,2,2005-10-22T21:00:00Z,MUGM 200N 751W,1,2,0,0,3
Tropical Storm,Alpha,2,2005-10-22T21:00:00Z,HALIFAX NS,0,0,0,2,2
Tropical Storm,Alpha,2,2005-10-22T21:00:00Z,MDPP 198N 707W,69,0,0,0,69
Tropical Storm,Alpha,2,2005-10-22T21:00:00Z,SABLE ISLAND NS,0,0,0,2,2
Tropical Storm,Alpha,2,2005-10-22T21:00:00Z,MBJT 215N 712W,44,3,0,0,47
Tropical Storm,Alpha,3,2005-10-23T03:00:00Z,22.0N  72.5W,58,2,0,0,60
Tropical Storm,Alpha,3,2005-10-23T03:00:00Z,MUGM 200N 751W,2,0,0,0,2
Tropical Storm,Alpha,3,2005-10-23T03:00:00Z,26.0N  73.0W,0,46,0,0,46
Tropical Storm,Alpha,3,2005-10-23T03:00:00Z,MDPP 198N 707W,68,0,0,0,68
Tropical Storm,Alpha,3,2005-10-23T03:00:00Z,MDSD 185N 697W,99,0,0,0,99
Tropical Storm,Alpha,3,2005-10-23T03:00:00Z,MBJT 215N 712W,52,1,0,0,53
Tropical Storm,Alpha,3,2005-10-23T03:00:00Z,MDCB 176N 714W,77,0,0,0,77
Tropical Storm,Alpha,3,2005-10-23T03:00:00Z,MYMM 224N 730W,51,6,0,0,57
Tropical Storm,Alpha,3,2005-10-23T03:00:00Z,MTPP 186N 724W,63,0,0,0,63
Tropical Storm,Alpha,3,2005-10-23T03:00:00Z,MYSM 241N 745W,4,34,0,0,38
Tropical Storm,Alpha,3,2005-10-23T03:00:00Z,MTCA 183N 738W,3,0,0,0,3
Tropical Storm,Alpha,3,2005-10-23T03:00:00Z,MYEG 235N 758W,1,8,0,0,9
Tropical Storm,Alpha,4,2005-10-23T09:00:00Z,23.3N  73.5W,56,5,0,0,61
Tropical Storm,Alpha,4,2005-10-23T09:00:00Z,MDPP 198N 707W,74,0,0,0,74
Tropical Storm,Alpha,4,2005-10-23T09:00:00Z,28.0N  73.5W,0,38,0,0,38
Tropical Storm,Alpha,4,2005-10-23T09:00:00Z,MBJT 215N 712W,41,0,0,0,41
Tropical Storm,Alpha,4,2005-10-23T09:00:00Z,MDSD 185N 697W,99,0,0,0,99
Tropical Storm,Alpha,4,2005-10-23T09:00:00Z,MYMM 224N 730W,64,1,0,0,65
Tropical Storm,Alpha,4,2005-10-23T09:00:00Z,MDCB 176N 714W,99,0,0,0,99
Tropical Storm,Alpha,4,2005-10-23T09:00:00Z,MYSM 241N 745W,38,15,0,0,53
Tropical Storm,Alpha,4,2005-10-23T09:00:00Z,MTPP 186N 724W,80,0,0,0,80
Tropical Storm,Alpha,4,2005-10-23T09:00:00Z,MYEG 235N 758W,14,11,0,0,25
Tropical Storm,Alpha,4,2005-10-23T09:00:00Z,MTCA 183N 738W,8,0,0,0,8
Tropical Storm,Alpha,4,2005-10-23T09:00:00Z,MYNN 251N 775W,0,3,0,0,3
Tropical Storm,Alpha,4,2005-10-23T09:00:00Z,MUGM 200N 751W,8,0,0,0,8
Tropical Depression,Alpha,5,2005-10-23T15:00:00Z,24.0N  74.0W,51,7,0,0,58
Tropical Depression,Alpha,5,2005-10-23T15:00:00Z,MBJT 215N 712W,7,0,0,0,7
Tropical Depression,Alpha,5,2005-10-23T15:00:00Z,29.0N  73.5W,0,31,0,0,31
Tropical Depression,Alpha,5,2005-10-23T15:00:00Z,MYMM 224N 730W,62,0,0,0,62
Tropical Depression,Alpha,5,2005-10-23T15:00:00Z,MDCB 176N 714W,36,0,0,0,36
Tropical Depression,Alpha,5,2005-10-23T15:00:00Z,MYSM 241N 745W,49,8,0,0,57
Tropical Depression,Alpha,5,2005-10-23T15:00:00Z,MTPP 186N 724W,99,0,0,0,99
Tropical Depression,Alpha,5,2005-10-23T15:00:00Z,MYEG 235N 758W,33,7,0,0,40
Tropical Depression,Alpha,5,2005-10-23T15:00:00Z,MTCA 183N 738W,19,0,0,0,19
Tropical Depression,Alpha,5,2005-10-23T15:00:00Z,MYAK 241N 776W,1,3,0,0,4
Tropical Depression,Alpha,5,2005-10-23T15:00:00Z,MUGM 200N 751W,38,0,0,0,38
Tropical Depression,Alpha,5,2005-10-23T15:00:00Z,MYNN 251N 775W,1,5,0,0,6
Tropical Depression,Alpha,6,2005-10-23T21:00:00Z,26.0N  73.5W,43,5,0,0,48
Tropical Depression,Alpha,6,2005-10-23T21:00:00Z,MYMM 224N 730W,80,0,0,0,80
Tropical Depression,Alpha,6,2005-10-23T21:00:00Z,31.5N  71.0W,0,20,0,0,20
Tropical Depression,Alpha,6,2005-10-23T21:00:00Z,MYSM 241N 745W,53,0,0,0,53
Tropical Depression,Alpha,6,2005-10-23T21:00:00Z,MTPP 186N 724W,43,0,0,0,43
Tropical Depression,Alpha,6,2005-10-23T21:00:00Z,MYEG 235N 758W,28,0,0,0,28
Tropical Depression,Alpha,6,2005-10-23T21:00:00Z,MUGM 200N 751W,4,0,0,0,4
Tropical Depression,Alpha,6,2005-10-23T21:00:00Z,MYAK 241N 776W,2,1,0,0,3
Tropical Depression,Alpha,6,2005-10-23T21:00:00Z,MBJT 215N 712W,18,0,0,0,18
Tropical Depression,Alpha,6,2005-10-23T21:00:00Z,MYNN 251N 775W,3,1,0,0,4
Tropical Depression,Alpha,7,2005-10-24T03:00:00Z,29.4N  70.9W,27,0,0,0,27
Tropical Depression,Alpha,7,2005-10-24T03:00:00Z,MYMM 224N 730W,99,0,0,0,99
Tropical Depression,Alpha,7,2005-10-24T03:00:00Z,MBJT 215N 712W,29,0,0,0,29
Tropical Depression,Alpha,7,2005-10-24T03:00:00Z,MYSM 241N 745W,19,0,0,0,19
Tropical Depression,Alpha,8,2005-10-24T09:00:00Z,34.7N  70.4W,23,0,0,0,23
Tropical Depression,Alpha,8,2005-10-24T09:00:00Z,MYSM 241N 745W,13,0,0,0,13
Tropical Depression,Alpha,8,2005-10-24T09:00:00Z,MYMM 224N 730W,55,0,0,0,55
Tropical Depression,Twenty-Six,1,2005-10-27T03:00:00Z,12.5N  82.5W,47,0,0,0,47
Tropical Depression,Twenty-Six,1,2005-10-27T03:00:00Z,MHNJ 165N 859W,0,1,8,8,17
Tropical Depression,Twenty-Six,1,2005-10-27T03:00:00Z,13.0N  83.0W,35,0,0,1,36
Tropical Depression,Twenty-Six,1,2005-10-27T03:00:00Z,MNPC 141N 834W,15,8,2,1,26
Tropical Depression,Twenty-Six,1,2005-10-27T03:00:00Z,13.0N  84.0W,23,2,1,2,28
Tropical Depression,Twenty-Six,1,2005-10-27T03:00:00Z,MNBL 120N 839W,27,0,1,1,29
Tropical Depression,Twenty-Six,1,2005-10-27T03:00:00Z,MWCG 193N 814W,0,0,0,3,3
Tropical Depression,Twenty-Six,1,2005-10-27T03:00:00Z,SKSP 126N 817W,47,0,0,0,47
Tropical Depression,Twenty-Six,1,2005-10-27T03:00:00Z,MUAN 219N 850W,0,0,0,2,2
Tropical Depression,Twenty-Six,1,2005-10-27T03:00:00Z,MRLM 100N 831W,7,1,1,4,13
Tropical Depression,Twenty-Six,1,2005-10-27T03:00:00Z,MMCZ 205N 869W,0,0,0,5,5
Tropical Depression,Twenty-Six,1,2005-10-27T03:00:00Z,MPCO 093N 799W,0,0,0,2,2
Tropical Depression,Twenty-Six,1,2005-10-27T03:00:00Z,MZBZ 175N 883W,0,0,1,9,10
Tropical Depression,Twenty-Six,1,2005-10-27T03:00:00Z,MMMD 210N 897W,0,0,0,2,2
Tropical Depression,Twenty-Six,1,2005-10-27T03:00:00Z,MGPB 157N 886W,0,0,2,10,12
Tropical Storm,Beta,2,2005-10-27T09:00:00Z,12.5N  82.6W,54,0,0,0,54
Tropical Storm,Beta,2,2005-10-27T09:00:00Z,MGPB 157N 886W,0,0,2,9,11
Tropical Storm,Beta,2,2005-10-27T09:00:00Z,12.8N  83.0W,40,0,0,1,41
Tropical Storm,Beta,2,2005-10-27T09:00:00Z,MHNJ 165N 859W,0,2,8,7,17
Tropical Storm,Beta,2,2005-10-27T09:00:00Z,13.0N  83.6W,30,1,0,1,32
Tropical Storm,Beta,2,2005-10-27T09:00:00Z,MNPC 141N 834W,18,6,1,2,27
Tropical Storm,Beta,2,2005-10-27T09:00:00Z,MWCG 193N 814W,0,0,0,3,3
Tropical Storm,Beta,2,2005-10-27T09:00:00Z,MNBL 120N 839W,26,1,1,1,29
Tropical Storm,Beta,2,2005-10-27T09:00:00Z,MUAN 219N 850W,0,0,0,2,2
Tropical Storm,Beta,2,2005-10-27T09:00:00Z,SKSP 126N 817W,55,0,0,0,55
Tropical Storm,Beta,2,2005-10-27T09:00:00Z,MMCZ 205N 869W,0,0,0,5,5
Tropical Storm,Beta,2,2005-10-27T09:00:00Z,MRLM 100N 831W,3,2,2,6,13
Tropical Storm,Beta,2,2005-10-27T09:00:00Z,MZBZ 175N 883W,0,0,1,8,9
Tropical Storm,Beta,2,2005-10-27T09:00:00Z,MPCO 093N 799W,0,0,1,2,3
Tropical Storm,Beta,3,2005-10-27T15:00:00Z,12.4N  81.4W,99,0,0,0,99
Tropical Storm,Beta,3,2005-10-27T15:00:00Z,MGPB 157N 886W,0,0,0,5,5
Tropical Storm,Beta,3,2005-10-27T15:00:00Z,12.9N  81.7W,49,0,0,0,49
Tropical Storm,Beta,3,2005-10-27T15:00:00Z,MHNJ 165N 859W,0,0,3,10,13
Tropical Storm,Beta,3,2005-10-27T15:00:00Z,13.3N  82.1W,35,1,0,0,36
Tropical Storm,Beta,3,2005-10-27T15:00:00Z,MNPC 141N 834W,10,12,2,2,26
Tropical Storm,Beta,3,2005-10-27T15:00:00Z,MKJP 179N 768W,0,0,0,2,2
Tropical Storm,Beta,3,2005-10-27T15:00:00Z,MNBL 120N 839W,9,6,3,3,21
Tropical Storm,Beta,3,2005-10-27T15:00:00Z,MKJS 185N 779W,0,0,0,4,4
Tropical Storm,Beta,3,2005-10-27T15:00:00Z,SKSP 126N 817W,61,0,0,0,61
Tropical Storm,Beta,3,2005-10-27T15:00:00Z,MWCG 193N 814W,0,0,0,8,8
Tropical Storm,Beta,3,2005-10-27T15:00:00Z,MRLM 100N 831W,1,1,3,5,10
Tropical Storm,Beta,3,2005-10-27T15:00:00Z,MUSN 216N 826W,0,0,0,2,2
Tropical Storm,Beta,3,2005-10-27T15:00:00Z,MPCO 093N 799W,0,0,1,1,2
Tropical Storm,Beta,3,2005-10-27T15:00:00Z,MZBZ 175N 883W,0,0,0,3,3
Tropical Storm,Beta,4,2005-10-27T21:00:00Z,12.6N  81.6W,99,0,0,0,99
Tropical Storm,Beta,4,2005-10-27T21:00:00Z,MHNJ 165N 859W,0,0,5,9,14
Tropical Storm,Beta,4,2005-10-27T21:00:00Z,13.0N  82.0W,49,0,0,1,50
Tropical Storm,Beta,4,2005-10-27T21:00:00Z,MNPC 141N 834W,14,9,2,2,27
Tropical Storm,Beta,4,2005-10-27T21:00:00Z,13.3N  82.5W,36,0,1,0,37
Tropical Storm,Beta,4,2005-10-27T21:00:00Z,MNBL 120N 839W,13,4,2,3,22
Tropical Storm,Beta,4,2005-10-27T21:00:00Z,MKJS 185N 779W,0,0,0,2,2
Tropical Storm,Beta,4,2005-10-27T21:00:00Z,SKSP 126N 817W,99,0,0,0,99
Tropical Storm,Beta,4,2005-10-27T21:00:00Z,MWCG 193N 814W,0,0,0,6,6
Tropical Storm,Beta,4,2005-10-27T21:00:00Z,MRLM 100N 831W,1,2,2,5,10
Tropical Storm,Beta,4,2005-10-27T21:00:00Z,MZBZ 175N 883W,0,0,0,4,4
Tropical Storm,Beta,4,2005-10-27T21:00:00Z,MPCO 093N 799W,0,0,0,2,2
Tropical Storm,Beta,4,2005-10-27T21:00:00Z,MGPB 157N 886W,0,0,0,6,6
Tropical Storm,Beta,5,2005-10-28T03:00:00Z,13.0N  81.8W,99,0,0,0,99
Tropical Storm,Beta,5,2005-10-28T03:00:00Z,MZBZ 175N 883W,0,0,1,8,9
Tropical Storm,Beta,5,2005-10-28T03:00:00Z,13.5N  82.5W,33,1,0,0,34
Tropical Storm,Beta,5,2005-10-28T03:00:00Z,MGPB 157N 886W,0,0,1,9,10
Tropical Storm,Beta,5,2005-10-28T03:00:00Z,13.5N  83.5W,21,3,2,1,27
Tropical Storm,Beta,5,2005-10-28T03:00:00Z,MHNJ 165N 859W,0,2,8,8,18
Tropical Storm,Beta,5,2005-10-28T03:00:00Z,MWCG 193N 814W,0,0,1,6,7
Tropical Storm,Beta,5,2005-10-28T03:00:00Z,MNPC 141N 834W,18,7,1,2,28
Tropical Storm,Beta,5,2005-10-28T03:00:00Z,MUSN 216N 826W,0,0,0,3,3
Tropical Storm,Beta,5,2005-10-28T03:00:00Z,MNBL 120N 839W,10,4,3,4,21
Tropical Storm,Beta,5,2005-10-28T03:00:00Z,MUAN 219N 850W,0,0,0,3,3
Tropical Storm,Beta,5,2005-10-28T03:00:00Z,SKSP 126N 817W,99,0,0,0,99
Tropical Storm,Beta,5,2005-10-28T03:00:00Z,MMCZ 205N 869W,0,0,0,5,5
Tropical Storm,Beta,5,2005-10-28T03:00:00Z,MRLM 100N 831W,0,1,4,6,11
Tropical Storm,Beta,6,2005-10-28T09:00:00Z,13.4N  81.8W,67,0,0,0,67
Tropical Storm,Beta,6,2005-10-28T09:00:00Z,MZBZ 175N 883W,0,0,0,9,9
Tropical Storm,Beta,6,2005-10-28T09:00:00Z,13.8N  82.4W,45,0,0,0,45
Tropical Storm,Beta,6,2005-10-28T09:00:00Z,MGPB 157N 886W,0,0,1,10,11
Tropical Storm,Beta,6,2005-10-28T09:00:00Z,14.1N  83.1W,31,2,0,1,34
Tropical Storm,Beta,6,2005-10-28T09:00:00Z,MHNJ 165N 859W,0,2,8,8,18
Tropical Storm,Beta,6,2005-10-28T09:00:00Z,MWCG 193N 814W,0,0,1,7,8
Tropical Storm,Beta,6,2005-10-28T09:00:00Z,MNPC 141N 834W,26,3,1,1,31
Tropical Storm,Beta,6,2005-10-28T09:00:00Z,MUSN 216N 826W,0,0,0,3,3
Tropical Storm,Beta,6,2005-10-28T09:00:00Z,MNBL 120N 839W,7,4,3,3,17
Tropical Storm,Beta,6,2005-10-28T09:00:00Z,MUAN 219N 850W,0,0,0,3,3
Tropical Storm,Beta,6,2005-10-28T09:00:00Z,SKSP 126N 817W,99,0,0,0,99
Tropical Storm,Beta,6,2005-10-28T09:00:00Z,MMCZ 205N 869W,0,0,0,5,5
Tropical Storm,Beta,6,2005-10-28T09:00:00Z,MRLM 100N 831W,0,0,1,4,5
Tropical Storm,Beta,7,2005-10-28T15:00:00Z,13.9N  81.8W,67,0,0,0,67
Tropical Storm,Beta,7,2005-10-28T15:00:00Z,MZBZ 175N 883W,0,0,1,11,12
Tropical Storm,Beta,7,2005-10-28T15:00:00Z,14.2N  82.6W,45,0,1,0,46
Tropical Storm,Beta,7,2005-10-28T15:00:00Z,MGPB 157N 886W,0,0,2,11,13
Tropical Storm,Beta,7,2005-10-28T15:00:00Z,14.6N  83.6W,24,8,1,0,33
Tropical Storm,Beta,7,2005-10-28T15:00:00Z,MHNJ 165N 859W,0,4,11,6,21
Tropical Storm,Beta,7,2005-10-28T15:00:00Z,MWCG 193N 814W,0,0,2,6,8
Tropical Storm,Beta,7,2005-10-28T15:00:00Z,MNPC 141N 834W,29,3,1,0,33
Tropical Storm,Beta,7,2005-10-28T15:00:00Z,MUCF 221N 805W,0,0,0,2,2
Tropical Storm,Beta,7,2005-10-28T15:00:00Z,MNBL 120N 839W,3,5,3,3,14
Tropical Storm,Beta,7,2005-10-28T15:00:00Z,MUSN 216N 826W,0,0,0,4,4
Tropical Storm,Beta,7,2005-10-28T15:00:00Z,SKSP 126N 817W,99,0,0,0,99
Tropical Storm,Beta,7,2005-10-28T15:00:00Z,MUHA 230N 824W,0,0,0,2,2
Tropical Storm,Beta,7,2005-10-28T15:00:00Z,MRLM 100N 831W,0,0,0,2,2
Tropical Storm,Beta,7,2005-10-28T15:00:00Z,MUAN 219N 850W,0,0,0,4,4
Tropical Storm,Beta,7,2005-10-28T15:00:00Z,MMMD 210N 897W,0,0,0,2,2
Tropical Storm,Beta,7,2005-10-28T15:00:00Z,MMCZ 205N 869W,0,0,0,7,7
Tropical Storm,Beta,8,2005-10-28T21:00:00Z,14.3N  82.0W,66,0,0,0,66
Tropical Storm,Beta,8,2005-10-28T21:00:00Z,MGPB 157N 886W,0,0,4,10,14
Tropical Storm,Beta,8,2005-10-28T21:00:00Z,14.6N  82.9W,43,0,0,0,43
Tropical Storm,Beta,8,2005-10-28T21:00:00Z,MHNJ 165N 859W,0,8,9,5,22
Tropical Storm,Beta,8,2005-10-28T21:00:00Z,14.8N  83.9W,23,7,0,1,31
Tropical Storm,Beta,8,2005-10-28T21:00:00Z,MNPC 141N 834W,31,1,0,1,33
Tropical Storm,Beta,8,2005-10-28T21:00:00Z,MWCG 193N 814W,0,0,2,4,6
Tropical Storm,Beta,8,2005-10-28T21:00:00Z,MNBL 120N 839W,2,4,3,3,12
Tropical Storm,Beta,8,2005-10-28T21:00:00Z,MUSN 216N 826W,0,0,0,2,2
Tropical Storm,Beta,8,2005-10-28T21:00:00Z,SKSP 126N 817W,99,0,0,0,99
Tropical Storm,Beta,8,2005-10-28T21:00:00Z,MUAN 219N 850W,0,0,0,4,4
Tropical Storm,Beta,8,2005-10-28T21:00:00Z,MRLM 100N 831W,0,0,0,2,2
Tropical Storm,Beta,8,2005-10-28T21:00:00Z,MMCZ 205N 869W,0,0,0,8,8
Tropical Storm,Beta,8,2005-10-28T21:00:00Z,MMMD 210N 897W,0,0,0,3,3
Tropical Storm,Beta,8,2005-10-28T21:00:00Z,MZBZ 175N 883W,0,0,3,11,14
Tropical Storm,Beta,9,2005-10-29T03:00:00Z,14.5N  82.5W,60,0,0,0,60
Tropical Storm,Beta,9,2005-10-29T03:00:00Z,MGPB 157N 886W,0,0,5,11,16
Tropical Storm,Beta,9,2005-10-29T03:00:00Z,14.5N  83.5W,36,0,1,0,37
Tropical Storm,Beta,9,2005-10-29T03:00:00Z,MHNJ 165N 859W,0,11,8,4,23
Tropical Storm,Beta,9,2005-10-29T03:00:00Z,14.5N  84.5W,20,7,2,1,30
Tropical Storm,Beta,9,2005-10-29T03:00:00Z,MNPC 141N 834W,34,1,0,0,35
Tropical Storm,Beta,9,2005-10-29T03:00:00Z,MWCG 193N 814W,0,0,2,2,4
Tropical Storm,Beta,9,2005-10-29T03:00:00Z,MNBL 120N 839W,2,5,4,4,15
Tropical Storm,Beta,9,2005-10-29T03:00:00Z,MUSN 216N 826W,0,0,0,2,2
Tropical Storm,Beta,9,2005-10-29T03:00:00Z,SKSP 126N 817W,99,0,0,0,99
Tropical Storm,Beta,9,2005-10-29T03:00:00Z,MUAN 219N 850W,0,0,0,4,4
Tropical Storm,Beta,9,2005-10-29T03:00:00Z,MRLM 100N 831W,0,0,1,3,4
Tropical Storm,Beta,9,2005-10-29T03:00:00Z,MMCZ 205N 869W,0,0,1,8,9
Tropical Storm,Beta,9,2005-10-29T03:00:00Z,MMMD 210N 897W,0,0,0,4,4
Tropical Storm,Beta,9,2005-10-29T03:00:00Z,MZBZ 175N 883W,0,0,4,11,15
Hurricane,Beta,10,2005-10-29T09:00:00Z,14.3N  83.0W,50,0,0,1,51
Hurricane,Beta,10,2005-10-29T09:00:00Z,MHNJ 165N 859W,1,12,6,4,23
Hurricane,Beta,10,2005-10-29T09:00:00Z,14.4N  83.9W,35,0,0,1,36
Hurricane,Beta,10,2005-10-29T09:00:00Z,MNPC 141N 834W,40,0,0,0,40
Hurricane,Beta,10,2005-10-29T09:00:00Z,14.4N  84.9W,20,4,2,1,27
Hurricane,Beta,10,2005-10-29T09:00:00Z,MNBL 120N 839W,6,4,3,4,17
Hurricane,Beta,10,2005-10-29T09:00:00Z,MWCG 193N 814W,0,1,1,2,4
Hurricane,Beta,10,2005-10-29T09:00:00Z,SKSP 126N 817W,99,0,0,0,99
Hurricane,Beta,10,2005-10-29T09:00:00Z,MUAN 219N 850W,0,0,0,4,4
Hurricane,Beta,10,2005-10-29T09:00:00Z,MRLM 100N 831W,0,0,1,5,6
Hurricane,Beta,10,2005-10-29T09:00:00Z,MMCZ 205N 869W,0,0,2,8,10
Hurricane,Beta,10,2005-10-29T09:00:00Z,MMFR 185N 926W,0,0,0,3,3
Hurricane,Beta,10,2005-10-29T09:00:00Z,MZBZ 175N 883W,0,0,6,10,16
Hurricane,Beta,10,2005-10-29T09:00:00Z,MMMD 210N 897W,0,0,0,7,7
Hurricane,Beta,10,2005-10-29T09:00:00Z,MGPB 157N 886W,0,1,5,10,16
Hurricane,Beta,11,2005-10-29T15:00:00Z,14.4N  83.3W,55,0,0,0,55
Hurricane,Beta,11,2005-10-29T15:00:00Z,MHNJ 165N 859W,1,15,7,2,25
Hurricane,Beta,11,2005-10-29T15:00:00Z,14.4N  84.4W,34,0,1,0,35
Hurricane,Beta,11,2005-10-29T15:00:00Z,MNPC 141N 834W,49,0,0,0,49
Hurricane,Beta,11,2005-10-29T15:00:00Z,14.4N  85.7W,14,10,2,1,27
Hurricane,Beta,11,2005-10-29T15:00:00Z,MNBL 120N 839W,2,5,3,3,13
Hurricane,Beta,11,2005-10-29T15:00:00Z,MWCG 193N 814W,0,0,1,1,2
Hurricane,Beta,11,2005-10-29T15:00:00Z,SKSP 126N 817W,1,1,1,2,5
Hurricane,Beta,11,2005-10-29T15:00:00Z,MUAN 219N 850W,0,0,0,3,3
Hurricane,Beta,11,2005-10-29T15:00:00Z,MRLM 100N 831W,0,0,0,3,3
Hurricane,Beta,11,2005-10-29T15:00:00Z,MMCZ 205N 869W,0,0,2,7,9
Hurricane,Beta,11,2005-10-29T15:00:00Z,MMFR 185N 926W,0,0,0,5,5
Hurricane,Beta,11,2005-10-29T15:00:00Z,MZBZ 175N 883W,0,0,9,9,18
Hurricane,Beta,11,2005-10-29T15:00:00Z,MMMD 210N 897W,0,0,0,6,6
Hurricane,Beta,11,2005-10-29T15:00:00Z,MGPB 157N 886W,0,1,10,8,19
Hurricane,Beta,12,2005-10-29T21:00:00Z,14.0N  84.1W,50,0,0,0,50
Hurricane,Beta,12,2005-10-29T21:00:00Z,MHNJ 165N 859W,0,9,5,4,18
Hurricane,Beta,12,2005-10-29T21:00:00Z,14.0N  85.3W,28,2,0,0,30
Hurricane,Beta,12,2005-10-29T21:00:00Z,MNPC 141N 834W,74,0,0,0,74
Hurricane,Beta,12,2005-10-29T21:00:00Z,14.2N  86.4W,9,14,1,1,25
Hurricane,Beta,12,2005-10-29T21:00:00Z,MNBL 120N 839W,11,1,1,2,15
Hurricane,Beta,12,2005-10-29T21:00:00Z,MWCG 193N 814W,0,0,0,2,2
Hurricane,Beta,12,2005-10-29T21:00:00Z,SKSP 126N 817W,24,0,0,0,24
Hurricane,Beta,12,2005-10-29T21:00:00Z,MUAN 219N 850W,0,0,0,2,2
Hurricane,Beta,12,2005-10-29T21:00:00Z,MRLM 100N 831W,0,0,0,3,3
Hurricane,Beta,12,2005-10-29T21:00:00Z,MMCZ 205N 869W,0,0,0,5,5
Hurricane,Beta,12,2005-10-29T21:00:00Z,MMFR 185N 926W,0,0,0,6,6
Hurricane,Beta,12,2005-10-29T21:00:00Z,MZBZ 175N 883W,0,0,6,8,14
Hurricane,Beta,12,2005-10-29T21:00:00Z,MMMD 210N 897W,0,0,0,4,4
Hurricane,Beta,12,2005-10-29T21:00:00Z,MGPB 157N 886W,0,3,10,5,18
Hurricane,Beta,13,2005-10-30T03:00:00Z,13.7N  84.7W,48,0,0,0,48
Hurricane,Beta,13,2005-10-30T03:00:00Z,MHNJ 165N 859W,2,10,3,3,18
Hurricane,Beta,13,2005-10-30T03:00:00Z,13.7N  86.0W,23,5,0,1,29
Hurricane,Beta,13,2005-10-30T03:00:00Z,MNPC 141N 834W,99,0,0,0,99
Hurricane,Beta,13,2005-10-30T03:00:00Z,13.7N  87.0W,5,18,1,2,26
Hurricane,Beta,13,2005-10-30T03:00:00Z,MNBL 120N 839W,21,1,0,0,22
Hurricane,Beta,13,2005-10-30T03:00:00Z,MWCG 193N 814W,0,0,0,2,2
Hurricane,Beta,13,2005-10-30T03:00:00Z,SKSP 126N 817W,8,0,0,1,9
Hurricane,Beta,13,2005-10-30T03:00:00Z,MMCZ 205N 869W,0,0,0,4,4
Hurricane,Beta,13,2005-10-30T03:00:00Z,MRLM 100N 831W,0,0,0,3,3
Hurricane,Beta,13,2005-10-30T03:00:00Z,MZBZ 175N 883W,0,1,5,7,13
Hurricane,Beta,13,2005-10-30T03:00:00Z,MMFR 185N 926W,0,0,0,5,5
Hurricane,Beta,13,2005-10-30T03:00:00Z,MGPB 157N 886W,0,4,9,5,18
Hurricane,Beta,13,2005-10-30T03:00:00Z,MMMD 210N 897W,0,0,0,3,3
Hurricane,Beta,14,2005-10-30T09:00:00Z,12.5N  85.6W,46,0,0,0,46
Hurricane,Beta,14,2005-10-30T09:00:00Z,MHNJ 165N 859W,1,4,0,0,5
Hurricane,Beta,14,2005-10-30T09:00:00Z,12.4N  86.8W,25,3,0,0,28
Hurricane,Beta,14,2005-10-30T09:00:00Z,MNPC 141N 834W,99,0,0,0,99
Hurricane,Beta,14,2005-10-30T09:00:00Z,MGPB 157N 886W,0,3,0,0,3
Hurricane,Beta,14,2005-10-30T09:00:00Z,MNBL 120N 839W,51,0,0,0,51
Hurricane,Beta,15,2005-10-30T15:00:00Z,12.2N  86.5W,43,0,0,0,43
Hurricane,Beta,15,2005-10-30T15:00:00Z,MNBL 120N 839W,99,0,0,0,99
Hurricane,Beta,15,2005-10-30T15:00:00Z,MNPC 141N 834W,64,0,0,0,64
Tropical Depression,Twenty-Seven,1,2005-11-14T03:00:00Z,15.3N  65.7W,49,0,0,0,49
Tropical Depression,Twenty-Seven,1,2005-11-14T03:00:00Z,MDCB 176N 714W,0,1,10,7,18
Tropical Depression,Twenty-Seven,1,2005-11-14T03:00:00Z,15.9N  67.2W,23,8,1,0,32
Tropical Depression,Twenty-Seven,1,2005-11-14T03:00:00Z,MTPP 186N 724W,0,0,4,11,15
Tropical Depression,Twenty-Seven,1,2005-11-14T03:00:00Z,16.1N  68.8W,2,18,3,2,25
Tropical Depression,Twenty-Seven,1,2005-11-14T03:00:00Z,MTCA 183N 738W,0,0,1,13,14
Tropical Depression,Twenty-Seven,1,2005-11-14T03:00:00Z,SKPG 125N 717W,0,0,3,8,11
Tropical Depression,Twenty-Seven,1,2005-11-14T03:00:00Z,MKJP 179N 768W,0,0,0,8,8
Tropical Depression,Twenty-Seven,1,2005-11-14T03:00:00Z,TNCC 122N 690W,0,3,5,3,11
Tropical Depression,Twenty-Seven,1,2005-11-14T03:00:00Z,MKJS 185N 779W,0,0,0,5,5
Tropical Depression,Twenty-Seven,1,2005-11-14T03:00:00Z,SVMG 110N 640W,1,0,0,1,2
Tropical Depression,Twenty-Seven,1,2005-11-14T03:00:00Z,MUGM 200N 751W,0,0,0,9,9
Tropical Depression,Twenty-Seven,1,2005-11-14T03:00:00Z,TGPY 120N 618W,18,0,0,0,18
Tropical Depression,Twenty-Seven,1,2005-11-14T03:00:00Z,MUCM 214N 779W,0,0,0,3,3
Tropical Depression,Twenty-Seven,1,2005-11-14T03:00:00Z,TVSV 131N 612W,54,0,0,0,54
Tropical Depression,Twenty-Seven,1,2005-11-14T03:00:00Z,TJSJ 184N 661W,9,8,2,0,19
Tropical Depression,Twenty-Seven,1,2005-11-14T03:00:00Z,TLPL 138N 610W,21,0,0,0,21
Tropical Depression,Twenty-Seven,1,2005-11-14T03:00:00Z,MDPP 198N 707W,0,0,7,7,14
Tropical Depression,Twenty-Seven,1,2005-11-14T03:00:00Z,TFFF 146N 610W,2,0,0,0,2
Tropical Depression,Twenty-Seven,1,2005-11-14T03:00:00Z,MBJT 215N 712W,0,0,1,7,8
Tropical Depression,Twenty-Seven,1,2005-11-14T03:00:00Z,80400 157N 636W,49,0,0,0,49
Tropical Depression,Twenty-Seven,1,2005-11-14T03:00:00Z,MYMM 224N 730W,0,0,0,5,5
Tropical Depression,Twenty-Seven,1,2005-11-14T03:00:00Z,TKPK 173N 627W,2,2,0,0,4
Tropical Depression,Twenty-Seven,1,2005-11-14T03:00:00Z,MYEG 235N 758W,0,0,0,2,2
Tropical Depression,Twenty-Seven,1,2005-11-14T03:00:00Z,TNCM 181N 631W,1,2,1,0,4
Tropical Depression,Twenty-Seven,1,2005-11-14T03:00:00Z,ST CROIX VI,16,3,0,0,19
Tropical Depression,Twenty-Seven,1,2005-11-14T03:00:00Z,TISX 177N 648W,16,3,0,0,19
Tropical Depression,Twenty-Seven,1,2005-11-14T03:00:00Z,ST THOMAS VI,8,6,1,1,16
Tropical Depression,Twenty-Seven,1,2005-11-14T03:00:00Z,TIST 183N 650W,8,6,1,1,16
Tropical Depression,Twenty-Seven,1,2005-11-14T03:00:00Z,SAN JUAN PR,9,8,2,0,19
Tropical Depression,Twenty-Seven,1,2005-11-14T03:00:00Z,TJPS 180N 666W,12,9,1,1,23
Tropical Depression,Twenty-Seven,1,2005-11-14T03:00:00Z,PONCE PR,12,9,1,1,23
Tropical Depression,Twenty-Seven,1,2005-11-14T03:00:00Z,MDSD 185N 697W,0,5,10,4,19
Tropical Depression,Twenty-Seven,2,2005-11-14T09:00:00Z,15.1N  66.2W,52,0,0,0,52
Tropical Depression,Twenty-Seven,2,2005-11-14T09:00:00Z,MKJP 179N 768W,0,0,0,11,11
Tropical Depression,Twenty-Seven,2,2005-11-14T09:00:00Z,15.9N  67.8W,24,10,1,0,35
Tropical Depression,Twenty-Seven,2,2005-11-14T09:00:00Z,MKJS 185N 779W,0,0,0,7,7
Tropical Depression,Twenty-Seven,2,2005-11-14T09:00:00Z,16.0N  69.7W,1,19,6,1,27
Tropical Depression,Twenty-Seven,2,2005-11-14T09:00:00Z,MUGM 200N 751W,0,0,0,11,11
Tropical Depression,Twenty-Seven,2,2005-11-14T09:00:00Z,SKPG 125N 717W,0,0,4,7,11
Tropical Depression,Twenty-Seven,2,2005-11-14T09:00:00Z,MUCM 214N 779W,0,0,0,3,3
Tropical Depression,Twenty-Seven,2,2005-11-14T09:00:00Z,TNCC 122N 690W,0,3,4,2,9
Tropical Depression,Twenty-Seven,2,2005-11-14T09:00:00Z,TJSJ 184N 661W,6,7,1,1,15
Tropical Depression,Twenty-Seven,2,2005-11-14T09:00:00Z,80400 157N 636W,50,0,0,0,50
Tropical Depression,Twenty-Seven,2,2005-11-14T09:00:00Z,MDPP 198N 707W,0,1,9,5,15
Tropical Depression,Twenty-Seven,2,2005-11-14T09:00:00Z,TISX 177N 648W,8,3,1,0,12
Tropical Depression,Twenty-Seven,2,2005-11-14T09:00:00Z,MBJT 215N 712W,0,0,2,6,8
Tropical Depression,Twenty-Seven,2,2005-11-14T09:00:00Z,TIST 183N 650W,3,4,1,0,8
Tropical Depression,Twenty-Seven,2,2005-11-14T09:00:00Z,MYMM 224N 730W,0,0,0,5,5
Tropical Depression,Twenty-Seven,2,2005-11-14T09:00:00Z,TJPS 180N 666W,11,9,0,1,21
Tropical Depression,Twenty-Seven,2,2005-11-14T09:00:00Z,MYEG 235N 758W,0,0,0,2,2
Tropical Depression,Twenty-Seven,2,2005-11-14T09:00:00Z,MDSD 185N 697W,0,11,8,2,21
Tropical Depression,Twenty-Seven,2,2005-11-14T09:00:00Z,ST CROIX VI,8,3,1,0,12
Tropical Depression,Twenty-Seven,2,2005-11-14T09:00:00Z,MDCB 176N 714W,0,3,15,4,22
Tropical Depression,Twenty-Seven,2,2005-11-14T09:00:00Z,ST THOMAS VI,3,4,1,0,8
Tropical Depression,Twenty-Seven,2,2005-11-14T09:00:00Z,MTPP 186N 724W,0,0,10,8,18
Tropical Depression,Twenty-Seven,2,2005-11-14T09:00:00Z,SAN JUAN PR,6,7,1,1,15
Tropical Depression,Twenty-Seven,2,2005-11-14T09:00:00Z,MTCA 183N 738W,0,0,4,13,17
Tropical Depression,Twenty-Seven,2,2005-11-14T09:00:00Z,PONCE PR,11,9,0,1,21
Tropical Depression,Twenty-Seven,3,2005-11-14T15:00:00Z,15.1N  66.6W,52,0,0,0,52
Tropical Depression,Twenty-Seven,3,2005-11-14T15:00:00Z,MKJP 179N 768W,0,0,0,12,12
Tropical Depression,Twenty-Seven,3,2005-11-14T15:00:00Z,15.4N  68.4W,20,14,0,0,34
Tropical Depression,Twenty-Seven,3,2005-11-14T15:00:00Z,MKJS 185N 779W,0,0,0,9,9
Tropical Depression,Twenty-Seven,3,2005-11-14T15:00:00Z,15.4N  70.4W,0,20,7,1,28
Tropical Depression,Twenty-Seven,3,2005-11-14T15:00:00Z,MWCG 193N 814W,0,0,0,2,2
Tropical Depression,Twenty-Seven,3,2005-11-14T15:00:00Z,SKPG 125N 717W,0,1,8,5,14
Tropical Depression,Twenty-Seven,3,2005-11-14T15:00:00Z,MUGM 200N 751W,0,0,0,9,9
Tropical Depression,Twenty-Seven,3,2005-11-14T15:00:00Z,TNCC 122N 690W,0,8,4,1,13
Tropical Depression,Twenty-Seven,3,2005-11-14T15:00:00Z,MUCM 214N 779W,0,0,0,4,4
Tropical Depression,Twenty-Seven,3,2005-11-14T15:00:00Z,80400 157N 636W,53,0,0,0,53
Tropical Depression,Twenty-Seven,3,2005-11-14T15:00:00Z,TJSJ 184N 661W,5,4,0,1,10
Tropical Depression,Twenty-Seven,3,2005-11-14T15:00:00Z,TISX 177N 648W,5,2,0,1,8
Tropical Depression,Twenty-Seven,3,2005-11-14T15:00:00Z,MDPP 198N 707W,0,1,5,4,10
Tropical Depression,Twenty-Seven,3,2005-11-14T15:00:00Z,TIST 183N 650W,2,2,0,0,4
Tropical Depression,Twenty-Seven,3,2005-11-14T15:00:00Z,MBJT 215N 712W,0,0,0,3,3
Tropical Depression,Twenty-Seven,3,2005-11-14T15:00:00Z,TJPS 180N 666W,11,5,0,0,16
Tropical Depression,Twenty-Seven,3,2005-11-14T15:00:00Z,MYMM 224N 730W,0,0,0,2,2
Tropical Depression,Twenty-Seven,3,2005-11-14T15:00:00Z,MDSD 185N 697W,0,9,6,2,17
Tropical Depression,Twenty-Seven,3,2005-11-14T15:00:00Z,ST CROIX VI,5,2,0,1,8
Tropical Depression,Twenty-Seven,3,2005-11-14T15:00:00Z,MDCB 176N 714W,0,5,13,3,21
Tropical Depression,Twenty-Seven,3,2005-11-14T15:00:00Z,ST THOMAS VI,2,2,0,0,4
Tropical Depression,Twenty-Seven,3,2005-11-14T15:00:00Z,MTPP 186N 724W,0,1,8,7,16
Tropical Depression,Twenty-Seven,3,2005-11-14T15:00:00Z,SAN JUAN PR,5,4,0,1,10
Tropical Depression,Twenty-Seven,3,2005-11-14T15:00:00Z,MTCA 183N 738W,0,0,5,11,16
Tropical Depression,Twenty-Seven,3,2005-11-14T15:00:00Z,PONCE PR,11,5,0,0,16
Tropical Depression,Twenty-Seven,4,2005-11-14T21:00:00Z,15.1N  67.5W,49,0,0,0,49
Tropical Depression,Twenty-Seven,4,2005-11-14T21:00:00Z,MKJS 185N 779W,0,0,0,12,12
Tropical Depression,Twenty-Seven,4,2005-11-14T21:00:00Z,15.4N  69.4W,18,17,1,0,36
Tropical Depression,Twenty-Seven,4,2005-11-14T21:00:00Z,MWCG 193N 814W,0,0,0,2,2
Tropical Depression,Twenty-Seven,4,2005-11-14T21:00:00Z,15.5N  71.3W,0,21,6,1,28
Tropical Depression,Twenty-Seven,4,2005-11-14T21:00:00Z,MUGM 200N 751W,0,0,2,12,14
Tropical Depression,Twenty-Seven,4,2005-11-14T21:00:00Z,SKPG 125N 717W,0,2,6,6,14
Tropical Depression,Twenty-Seven,4,2005-11-14T21:00:00Z,MUCM 214N 779W,0,0,0,7,7
Tropical Depression,Twenty-Seven,4,2005-11-14T21:00:00Z,TNCC 122N 690W,1,4,3,1,9
Tropical Depression,Twenty-Seven,4,2005-11-14T21:00:00Z,MUCF 221N 805W,0,0,0,2,2
Tropical Depression,Twenty-Seven,4,2005-11-14T21:00:00Z,80400 157N 636W,12,0,0,0,12
Tropical Depression,Twenty-Seven,4,2005-11-14T21:00:00Z,TJSJ 184N 661W,2,3,0,0,5
Tropical Depression,Twenty-Seven,4,2005-11-14T21:00:00Z,TISX 177N 648W,2,0,0,0,2
Tropical Depression,Twenty-Seven,4,2005-11-14T21:00:00Z,MDPP 198N 707W,0,2,8,2,12
Tropical Depression,Twenty-Seven,4,2005-11-14T21:00:00Z,TJPS 180N 666W,7,5,0,1,13
Tropical Depression,Twenty-Seven,4,2005-11-14T21:00:00Z,MBJT 215N 712W,0,0,1,4,5
Tropical Depression,Twenty-Seven,4,2005-11-14T21:00:00Z,MDSD 185N 697W,0,14,4,1,19
Tropical Depression,Twenty-Seven,4,2005-11-14T21:00:00Z,MYMM 224N 730W,0,0,0,4,4
Tropical Depression,Twenty-Seven,4,2005-11-14T21:00:00Z,MDCB 176N 714W,0,14,10,1,25
Tropical Depression,Twenty-Seven,4,2005-11-14T21:00:00Z,MYEG 235N 758W,0,0,0,3,3
Tropical Depression,Twenty-Seven,4,2005-11-14T21:00:00Z,MTPP 186N 724W,0,2,15,3,20
Tropical Depression,Twenty-Seven,4,2005-11-14T21:00:00Z,ST CROIX VI,2,0,0,0,2
Tropical Depression,Twenty-Seven,4,2005-11-14T21:00:00Z,MTCA 183N 738W,0,0,12,8,20
Tropical Depression,Twenty-Seven,4,2005-11-14T21:00:00Z,SAN JUAN PR,2,3,0,0,5
Tropical Depression,Twenty-Seven,4,2005-11-14T21:00:00Z,MKJP 179N 768W,0,0,1,14,15
Tropical Depression,Twenty-Seven,4,2005-11-14T21:00:00Z,PONCE PR,7,5,0,1,13
Tropical Depression,Twenty-Seven,5,2005-11-15T03:00:00Z,15.3N  68.3W,49,0,0,0,49
Tropical Depression,Twenty-Seven,5,2005-11-15T03:00:00Z,MKJS 185N 779W,0,0,1,14,15
Tropical Depression,Twenty-Seven,5,2005-11-15T03:00:00Z,15.5N  70.5W,16,21,0,0,37
Tropical Depression,Twenty-Seven,5,2005-11-15T03:00:00Z,MWCG 193N 814W,0,0,0,4,4
Tropical Depression,Twenty-Seven,5,2005-11-15T03:00:00Z,15.5N  72.7W,0,18,10,1,29
Tropical Depression,Twenty-Seven,5,2005-11-15T03:00:00Z,MUGM 200N 751W,0,0,4,9,13
Tropical Depression,Twenty-Seven,5,2005-11-15T03:00:00Z,SKPG 125N 717W,0,3,4,3,10
Tropical Depression,Twenty-Seven,5,2005-11-15T03:00:00Z,MUCM 214N 779W,0,0,0,7,7
Tropical Depression,Twenty-Seven,5,2005-11-15T03:00:00Z,TNCC 122N 690W,1,1,1,0,3
Tropical Depression,Twenty-Seven,5,2005-11-15T03:00:00Z,MUCF 221N 805W,0,0,0,2,2
Tropical Depression,Twenty-Seven,5,2005-11-15T03:00:00Z,TJPS 180N 666W,9,1,0,0,10
Tropical Depression,Twenty-Seven,5,2005-11-15T03:00:00Z,TJSJ 184N 661W,2,0,0,0,2
Tropical Depression,Twenty-Seven,5,2005-11-15T03:00:00Z,MDSD 185N 697W,2,15,1,0,18
Tropical Depression,Twenty-Seven,5,2005-11-15T03:00:00Z,MDPP 198N 707W,0,3,5,1,9
Tropical Depression,Twenty-Seven,5,2005-11-15T03:00:00Z,MDCB 176N 714W,0,25,3,0,28
Tropical Depression,Twenty-Seven,5,2005-11-15T03:00:00Z,MBJT 215N 712W,0,0,1,1,2
Tropical Depression,Twenty-Seven,5,2005-11-15T03:00:00Z,MTPP 186N 724W,0,7,12,1,20
Tropical Depression,Twenty-Seven,5,2005-11-15T03:00:00Z,MYMM 224N 730W,0,0,0,2,2
Tropical Depression,Twenty-Seven,5,2005-11-15T03:00:00Z,MTCA 183N 738W,0,2,16,4,22
Tropical Depression,Twenty-Seven,5,2005-11-15T03:00:00Z,SAN JUAN PR,2,0,0,0,2
Tropical Depression,Twenty-Seven,5,2005-11-15T03:00:00Z,MKJP 179N 768W,0,0,4,14,18
Tropical Depression,Twenty-Seven,5,2005-11-15T03:00:00Z,PONCE PR,9,1,0,0,10
Tropical Depression,Twenty-Seven,6,2005-11-15T09:00:00Z,15.0N  69.8W,46,0,0,0,46
Tropical Depression,Twenty-Seven,6,2005-11-15T09:00:00Z,MWCG 193N 814W,0,0,0,10,10
Tropical Depression,Twenty-Seven,6,2005-11-15T09:00:00Z,15.2N  71.8W,16,16,1,0,33
Tropical Depression,Twenty-Seven,6,2005-11-15T09:00:00Z,MUGM 200N 751W,0,0,8,6,14
Tropical Depression,Twenty-Seven,6,2005-11-15T09:00:00Z,15.3N  74.0W,0,15,11,1,27
Tropical Depression,Twenty-Seven,6,2005-11-15T09:00:00Z,MUCM 214N 779W,0,0,0,9,9
Tropical Depression,Twenty-Seven,6,2005-11-15T09:00:00Z,SKPG 125N 717W,2,9,2,2,15
Tropical Depression,Twenty-Seven,6,2005-11-15T09:00:00Z,MUCF 221N 805W,0,0,0,6,6
Tropical Depression,Twenty-Seven,6,2005-11-15T09:00:00Z,TNCC 122N 690W,1,1,1,1,4
Tropical Depression,Twenty-Seven,6,2005-11-15T09:00:00Z,MUSN 216N 826W,0,0,0,5,5
Tropical Depression,Twenty-Seven,6,2005-11-15T09:00:00Z,MDSD 185N 697W,3,8,1,0,12
Tropical Depression,Twenty-Seven,6,2005-11-15T09:00:00Z,MUHA 230N 824W,0,0,0,3,3
Tropical Depression,Twenty-Seven,6,2005-11-15T09:00:00Z,MDCB 176N 714W,3,20,1,0,24
Tropical Depression,Twenty-Seven,6,2005-11-15T09:00:00Z,MUAN 219N 850W,0,0,0,2,2
Tropical Depression,Twenty-Seven,6,2005-11-15T09:00:00Z,MTPP 186N 724W,0,12,6,1,19
Tropical Depression,Twenty-Seven,6,2005-11-15T09:00:00Z,MNPC 141N 834W,0,0,0,2,2
Tropical Depression,Twenty-Seven,6,2005-11-15T09:00:00Z,MTCA 183N 738W,0,7,13,1,21
Tropical Depression,Twenty-Seven,6,2005-11-15T09:00:00Z,SKSP 126N 817W,0,0,0,3,3
Tropical Depression,Twenty-Seven,6,2005-11-15T09:00:00Z,MKJP 179N 768W,0,0,10,10,20
Tropical Depression,Twenty-Seven,6,2005-11-15T09:00:00Z,MDPP 198N 707W,0,3,3,0,6
Tropical Depression,Twenty-Seven,6,2005-11-15T09:00:00Z,MKJS 185N 779W,0,0,4,14,18
Tropical Depression,Twenty-Seven,7,2005-11-15T15:00:00Z,14.5N  71.1W,45,0,0,0,45
Tropical Depression,Twenty-Seven,7,2005-11-15T15:00:00Z,MWCG 193N 814W,0,0,0,11,11
Tropical Depression,Twenty-Seven,7,2005-11-15T15:00:00Z,14.7N  73.2W,12,20,1,0,33
Tropical Depression,Twenty-Seven,7,2005-11-15T15:00:00Z,MUGM 200N 751W,0,0,5,4,9
Tropical Depression,Twenty-Seven,7,2005-11-15T15:00:00Z,14.8N  75.3W,0,17,9,1,27
Tropical Depression,Twenty-Seven,7,2005-11-15T15:00:00Z,MUCM 214N 779W,0,0,0,6,6
Tropical Depression,Twenty-Seven,7,2005-11-15T15:00:00Z,SKPG 125N 717W,13,3,0,1,17
Tropical Depression,Twenty-Seven,7,2005-11-15T15:00:00Z,MUCF 221N 805W,0,0,0,4,4
Tropical Depression,Twenty-Seven,7,2005-11-15T15:00:00Z,MDSD 185N 697W,1,1,0,0,2
Tropical Depression,Twenty-Seven,7,2005-11-15T15:00:00Z,MUSN 216N 826W,0,0,0,4,4
Tropical Depression,Twenty-Seven,7,2005-11-15T15:00:00Z,MDCB 176N 714W,5,11,0,0,16
Tropical Depression,Twenty-Seven,7,2005-11-15T15:00:00Z,MUHA 230N 824W,0,0,0,2,2
Tropical Depression,Twenty-Seven,7,2005-11-15T15:00:00Z,MTPP 186N 724W,0,8,2,1,11
Tropical Depression,Twenty-Seven,7,2005-11-15T15:00:00Z,MHNJ 165N 859W,0,0,0,2,2
Tropical Depression,Twenty-Seven,7,2005-11-15T15:00:00Z,MTCA 183N 738W,0,9,6,2,17
Tropical Depression,Twenty-Seven,7,2005-11-15T15:00:00Z,MNPC 141N 834W,0,0,0,5,5
Tropical Depression,Twenty-Seven,7,2005-11-15T15:00:00Z,MKJP 179N 768W,0,1,14,5,20
Tropical Depression,Twenty-Seven,7,2005-11-15T15:00:00Z,SKSP 126N 817W,0,0,0,6,6
Tropical Depression,Twenty-Seven,7,2005-11-15T15:00:00Z,MKJS 185N 779W,0,0,8,9,17
Tropical Depression,Twenty-Seven,8,2005-11-15T21:00:00Z,15.0N  73.0W,44,0,0,0,44
Tropical Depression,Twenty-Seven,8,2005-11-15T21:00:00Z,MUCM 214N 779W,0,0,2,4,6
Tropical Depression,Twenty-Seven,8,2005-11-15T21:00:00Z,15.2N  75.2W,12,20,0,0,32
Tropical Depression,Twenty-Seven,8,2005-11-15T21:00:00Z,MUCF 221N 805W,0,0,0,5,5
Tropical Depression,Twenty-Seven,8,2005-11-15T21:00:00Z,15.4N  77.5W,0,15,11,1,27
Tropical Depression,Twenty-Seven,8,2005-11-15T21:00:00Z,MUSN 216N 826W,0,0,0,7,7
Tropical Depression,Twenty-Seven,8,2005-11-15T21:00:00Z,MDCB 176N 714W,15,1,0,0,16
Tropical Depression,Twenty-Seven,8,2005-11-15T21:00:00Z,MUHA 230N 824W,0,0,0,3,3
Tropical Depression,Twenty-Seven,8,2005-11-15T21:00:00Z,MTPP 186N 724W,3,5,0,1,9
Tropical Depression,Twenty-Seven,8,2005-11-15T21:00:00Z,MUAN 219N 850W,0,0,0,3,3
Tropical Depression,Twenty-Seven,8,2005-11-15T21:00:00Z,MTCA 183N 738W,2,13,1,0,16
Tropical Depression,Twenty-Seven,8,2005-11-15T21:00:00Z,MMCZ 205N 869W,0,0,0,3,3
Tropical Depression,Twenty-Seven,8,2005-11-15T21:00:00Z,MKJP 179N 768W,0,11,12,1,24
Tropical Depression,Twenty-Seven,8,2005-11-15T21:00:00Z,MHNJ 165N 859W,0,0,0,6,6
Tropical Depression,Twenty-Seven,8,2005-11-15T21:00:00Z,MKJS 185N 779W,0,2,15,3,20
Tropical Depression,Twenty-Seven,8,2005-11-15T21:00:00Z,MNPC 141N 834W,0,0,0,10,10
Tropical Depression,Twenty-Seven,8,2005-11-15T21:00:00Z,MWCG 193N 814W,0,0,2,13,15
Tropical Depression,Twenty-Seven,8,2005-11-15T21:00:00Z,MNBL 120N 839W,0,0,0,3,3
Tropical Depression,Twenty-Seven,8,2005-11-15T21:00:00Z,MUGM 200N 751W,0,2,4,1,7
Tropical Depression,Twenty-Seven,8,2005-11-15T21:00:00Z,SKSP 126N 817W,0,0,1,8,9
Tropical Depression,Twenty-Seven,9,2005-11-16T03:00:00Z,15.1N  74.2W,44,0,0,0,44
Tropical Depression,Twenty-Seven,9,2005-11-16T03:00:00Z,MUCF 221N 805W,0,0,0,4,4
Tropical Depression,Twenty-Seven,9,2005-11-16T03:00:00Z,15.3N  76.5W,11,21,0,0,32
Tropical Depression,Twenty-Seven,9,2005-11-16T03:00:00Z,MUSN 216N 826W,0,0,0,6,6
Tropical Depression,Twenty-Seven,9,2005-11-16T03:00:00Z,15.5N  78.5W,0,18,7,1,26
Tropical Depression,Twenty-Seven,9,2005-11-16T03:00:00Z,MUHA 230N 824W,0,0,0,2,2
Tropical Depression,Twenty-Seven,9,2005-11-16T03:00:00Z,MDCB 176N 714W,7,0,0,0,7
Tropical Depression,Twenty-Seven,9,2005-11-16T03:00:00Z,MUAN 219N 850W,0,0,0,3,3
Tropical Depression,Twenty-Seven,9,2005-11-16T03:00:00Z,MTPP 186N 724W,2,1,1,0,4
Tropical Depression,Twenty-Seven,9,2005-11-16T03:00:00Z,MMCZ 205N 869W,0,0,0,3,3
Tropical Depression,Twenty-Seven,9,2005-11-16T03:00:00Z,MTCA 183N 738W,6,7,0,0,13
Tropical Depression,Twenty-Seven,9,2005-11-16T03:00:00Z,MZBZ 175N 883W,0,0,0,2,2
Tropical Depression,Twenty-Seven,9,2005-11-16T03:00:00Z,MKJP 179N 768W,0,16,5,1,22
Tropical Depression,Twenty-Seven,9,2005-11-16T03:00:00Z,MHNJ 165N 859W,0,0,0,7,7
Tropical Depression,Twenty-Seven,9,2005-11-16T03:00:00Z,MKJS 185N 779W,0,5,11,3,19
Tropical Depression,Twenty-Seven,9,2005-11-16T03:00:00Z,MNPC 141N 834W,0,0,1,10,11
Tropical Depression,Twenty-Seven,9,2005-11-16T03:00:00Z,MWCG 193N 814W,0,0,3,11,14
Tropical Depression,Twenty-Seven,9,2005-11-16T03:00:00Z,MNBL 120N 839W,0,0,0,4,4
Tropical Depression,Twenty-Seven,9,2005-11-16T03:00:00Z,MUGM 200N 751W,0,1,2,2,5
Tropical Depression,Twenty-Seven,9,2005-11-16T03:00:00Z,SKSP 126N 817W,0,0,2,8,10
Tropical Depression,Twenty-Seven,9,2005-11-16T03:00:00Z,MUCM 214N 779W,0,0,1,3,4
Tropical Depression,Twenty-Seven,10,2005-11-16T09:00:00Z,14.8N  75.2W,44,0,0,0,44
Tropical Depression,Twenty-Seven,10,2005-11-16T09:00:00Z,MTCA 183N 738W,4,0,0,0,4
Tropical Storm,Gamma,12,2005-11-18T21:00:00Z,17.3N  86.8W,45,0,0,0,45
Tropical Storm,Gamma,12,2005-11-18T21:00:00Z,W PALM BEACH FL,0,0,0,8,8
Tropical Storm,Gamma,12,2005-11-18T21:00:00Z,18.2N  87.1W,28,2,0,0,30
Tropical Storm,Gamma,12,2005-11-18T21:00:00Z,FT PIERCE FL,0,0,0,7,7
Tropical Storm,Gamma,12,2005-11-18T21:00:00Z,20.0N  86.5W,6,11,5,1,23
Tropical Storm,Gamma,12,2005-11-18T21:00:00Z,COCOA BEACH FL,0,0,0,6,6
Tropical Storm,Gamma,12,2005-11-18T21:00:00Z,MKJS 185N 779W,0,0,0,2,2
Tropical Storm,Gamma,12,2005-11-18T21:00:00Z,DAYTONA BEACH FL,0,0,0,5,5
Tropical Storm,Gamma,12,2005-11-18T21:00:00Z,MWCG 193N 814W,0,0,3,6,9
Tropical Storm,Gamma,12,2005-11-18T21:00:00Z,JACKSONVILLE FL,0,0,0,3,3
Tropical Storm,Gamma,12,2005-11-18T21:00:00Z,MUCM 214N 779W,0,0,0,4,4
Tropical Storm,Gamma,12,2005-11-18T21:00:00Z,KEY WEST FL,0,0,0,12,12
Tropical Storm,Gamma,12,2005-11-18T21:00:00Z,MUCF 221N 805W,0,0,0,10,10
Tropical Storm,Gamma,12,2005-11-18T21:00:00Z,MARCO ISLAND FL,0,0,0,10,10
Tropical Storm,Gamma,12,2005-11-18T21:00:00Z,MUSN 216N 826W,0,0,4,10,14
Tropical Storm,Gamma,12,2005-11-18T21:00:00Z,FT MYERS FL,0,0,0,10,10
Tropical Storm,Gamma,12,2005-11-18T21:00:00Z,MUHA 230N 824W,0,0,1,12,13
Tropical Storm,Gamma,12,2005-11-18T21:00:00Z,VENICE FL,0,0,0,10,10
Tropical Storm,Gamma,12,2005-11-18T21:00:00Z,MUAN 219N 850W,0,1,11,6,18
Tropical Storm,Gamma,12,2005-11-18T21:00:00Z,TAMPA FL,0,0,0,8,8
Tropical Storm,Gamma,12,2005-11-18T21:00:00Z,MMCZ 205N 869W,2,12,7,2,23
Tropical Storm,Gamma,12,2005-11-18T21:00:00Z,CEDAR KEY FL,0,0,0,6,6
Tropical Storm,Gamma,12,2005-11-18T21:00:00Z,MZBZ 175N 883W,21,3,0,1,25
Tropical Storm,Gamma,12,2005-11-18T21:00:00Z,ST MARKS FL,0,0,0,4,4
Tropical Storm,Gamma,12,2005-11-18T21:00:00Z,MGPB 157N 886W,11,2,1,0,14
Tropical Storm,Gamma,12,2005-11-18T21:00:00Z,APALACHICOLA FL,0,0,0,5,5
Tropical Storm,Gamma,12,2005-11-18T21:00:00Z,MHNJ 165N 859W,99,0,0,0,99
Tropical Storm,Gamma,12,2005-11-18T21:00:00Z,PANAMA CITY FL,0,0,0,4,4
Tropical Storm,Gamma,12,2005-11-18T21:00:00Z,MNPC 141N 834W,0,1,0,1,2
Tropical Storm,Gamma,12,2005-11-18T21:00:00Z,PENSACOLA FL,0,0,0,3,3
Tropical Storm,Gamma,12,2005-11-18T21:00:00Z,MYEG 235N 758W,0,0,0,2,2
Tropical Storm,Gamma,12,2005-11-18T21:00:00Z,MOBILE AL,0,0,0,2,2
Tropical Storm,Gamma,12,2005-11-18T21:00:00Z,MYAK 241N 776W,0,0,0,5,5
Tropical Storm,Gamma,12,2005-11-18T21:00:00Z,GULFPORT MS,0,0,0,2,2
Tropical Storm,Gamma,12,2005-11-18T21:00:00Z,MYNN 251N 775W,0,0,0,5,5
Tropical Storm,Gamma,12,2005-11-18T21:00:00Z,BURAS LA,0,0,0,3,3
Tropical Storm,Gamma,12,2005-11-18T21:00:00Z,MYGF 266N 787W,0,0,0,6,6
Tropical Storm,Gamma,12,2005-11-18T21:00:00Z,GULF 29N 85W,0,0,0,6,6
Tropical Storm,Gamma,12,2005-11-18T21:00:00Z,MMFR 185N 926W,0,1,1,1,3
Tropical Storm,Gamma,12,2005-11-18T21:00:00Z,GULF 29N 87W,0,0,0,5,5
Tropical Storm,Gamma,12,2005-11-18T21:00:00Z,MMMD 210N 897W,0,7,8,2,17
Tropical Storm,Gamma,12,2005-11-18T21:00:00Z,GULF 28N 89W,0,0,0,5,5
Tropical Storm,Gamma,12,2005-11-18T21:00:00Z,MARATHON FL,0,0,0,11,11
Tropical Storm,Gamma,12,2005-11-18T21:00:00Z,GULF 28N 91W,0,0,0,3,3
Tropical Storm,Gamma,12,2005-11-18T21:00:00Z,MIAMI FL,0,0,0,9,9
Tropical Storm,Gamma,13,2005-11-19T03:00:00Z,17.4N  86.9W,47,0,0,0,47
Tropical Storm,Gamma,13,2005-11-19T03:00:00Z,FT PIERCE FL,0,0,0,9,9
Tropical Storm,Gamma,13,2005-11-19T03:00:00Z,18.8N  87.0W,21,6,1,0,28
Tropical Storm,Gamma,13,2005-11-19T03:00:00Z,COCOA BEACH FL,0,0,0,8,8
Tropical Storm,Gamma,13,2005-11-19T03:00:00Z,20.8N  85.6W,1,9,12,1,23
Tropical Storm,Gamma,13,2005-11-19T03:00:00Z,DAYTONA BEACH FL,0,0,0,6,6
Tropical Storm,Gamma,13,2005-11-19T03:00:00Z,MKJS 185N 779W,0,0,0,3,3
Tropical Storm,Gamma,13,2005-11-19T03:00:00Z,JACKSONVILLE FL,0,0,0,4,4
Tropical Storm,Gamma,13,2005-11-19T03:00:00Z,MWCG 193N 814W,0,0,4,6,10
Tropical Storm,Gamma,13,2005-11-19T03:00:00Z,SAVANNAH GA,0,0,0,2,2
Tropical Storm,Gamma,13,2005-11-19T03:00:00Z,MUCM 214N 779W,0,0,0,6,6
Tropical Storm,Gamma,13,2005-11-19T03:00:00Z,KEY WEST FL,0,0,1,13,14
Tropical Storm,Gamma,13,2005-11-19T03:00:00Z,MUCF 221N 805W,0,0,1,11,12
Tropical Storm,Gamma,13,2005-11-19T03:00:00Z,MARCO ISLAND FL,0,0,0,12,12
Tropical Storm,Gamma,13,2005-11-19T03:00:00Z,MUSN 216N 826W,0,0,7,9,16
Tropical Storm,Gamma,13,2005-11-19T03:00:00Z,FT MYERS FL,0,0,0,12,12
Tropical Storm,Gamma,13,2005-11-19T03:00:00Z,MUHA 230N 824W,0,0,3,13,16
Tropical Storm,Gamma,13,2005-11-19T03:00:00Z,VENICE FL,0,0,0,11,11
Tropical Storm,Gamma,13,2005-11-19T03:00:00Z,MUAN 219N 850W,0,2,15,3,20
Tropical Storm,Gamma,13,2005-11-19T03:00:00Z,TAMPA FL,0,0,0,10,10
Tropical Storm,Gamma,13,2005-11-19T03:00:00Z,MMCZ 205N 869W,2,16,6,1,25
Tropical Storm,Gamma,13,2005-11-19T03:00:00Z,CEDAR KEY FL,0,0,0,7,7
Tropical Storm,Gamma,13,2005-11-19T03:00:00Z,MZBZ 175N 883W,25,1,1,0,27
Tropical Storm,Gamma,13,2005-11-19T03:00:00Z,ST MARKS FL,0,0,0,5,5
Tropical Storm,Gamma,13,2005-11-19T03:00:00Z,MGPB 157N 886W,14,1,1,0,16
Tropical Storm,Gamma,13,2005-11-19T03:00:00Z,APALACHICOLA FL,0,0,0,6,6
Tropical Storm,Gamma,13,2005-11-19T03:00:00Z,MHNJ 165N 859W,99,0,0,0,99
Tropical Storm,Gamma,13,2005-11-19T03:00:00Z,PANAMA CITY FL,0,0,0,5,5
Tropical Storm,Gamma,13,2005-11-19T03:00:00Z,MYSM 241N 745W,0,0,0,2,2
Tropical Storm,Gamma,13,2005-11-19T03:00:00Z,PENSACOLA FL,0,0,0,3,3
Tropical Storm,Gamma,13,2005-11-19T03:00:00Z,MYEG 235N 758W,0,0,0,4,4
Tropical Storm,Gamma,13,2005-11-19T03:00:00Z,MOBILE AL,0,0,0,2,2
Tropical Storm,Gamma,13,2005-11-19T03:00:00Z,MYAK 241N 776W,0,0,0,7,7
Tropical Storm,Gamma,13,2005-11-19T03:00:00Z,GULFPORT MS,0,0,0,2,2
Tropical Storm,Gamma,13,2005-11-19T03:00:00Z,MYNN 251N 775W,0,0,0,7,7
Tropical Storm,Gamma,13,2005-11-19T03:00:00Z,BURAS LA,0,0,0,2,2
Tropical Storm,Gamma,13,2005-11-19T03:00:00Z,MYGF 266N 787W,0,0,0,8,8
Tropical Storm,Gamma,13,2005-11-19T03:00:00Z,GULF 29N 85W,0,0,0,7,7
Tropical Storm,Gamma,13,2005-11-19T03:00:00Z,MMMD 210N 897W,0,9,6,1,16
Tropical Storm,Gamma,13,2005-11-19T03:00:00Z,GULF 29N 87W,0,0,0,6,6
Tropical Storm,Gamma,13,2005-11-19T03:00:00Z,MARATHON FL,0,0,0,13,13
Tropical Storm,Gamma,13,2005-11-19T03:00:00Z,GULF 28N 89W,0,0,0,5,5
Tropical Storm,Gamma,13,2005-11-19T03:00:00Z,MIAMI FL,0,0,0,11,11
Tropical Storm,Gamma,13,2005-11-19T03:00:00Z,GULF 28N 91W,0,0,0,2,2
Tropical Storm,Gamma,13,2005-11-19T03:00:00Z,W PALM BEACH FL,0,0,0,10,10
Tropical Storm,Gamma,14,2005-11-19T09:00:00Z,18.4N  86.8W,47,1,0,0,48
Tropical Storm,Gamma,14,2005-11-19T09:00:00Z,MIAMI FL,0,0,0,13,13
Tropical Storm,Gamma,14,2005-11-19T09:00:00Z,20.0N  86.3W,12,15,2,0,29
Tropical Storm,Gamma,14,2005-11-19T09:00:00Z,W PALM BEACH FL,0,0,0,12,12
Tropical Storm,Gamma,14,2005-11-19T09:00:00Z,22.0N  84.3W,0,3,17,2,22
Tropical Storm,Gamma,14,2005-11-19T09:00:00Z,FT PIERCE FL,0,0,0,11,11
Tropical Storm,Gamma,14,2005-11-19T09:00:00Z,MKJS 185N 779W,0,0,0,3,3
Tropical Storm,Gamma,14,2005-11-19T09:00:00Z,COCOA BEACH FL,0,0,0,10,10
Tropical Storm,Gamma,14,2005-11-19T09:00:00Z,MWCG 193N 814W,0,0,5,5,10
Tropical Storm,Gamma,14,2005-11-19T09:00:00Z,DAYTONA BEACH FL,0,0,0,9,9
Tropical Storm,Gamma,14,2005-11-19T09:00:00Z,MUGM 200N 751W,0,0,0,2,2
Tropical Storm,Gamma,14,2005-11-19T09:00:00Z,JACKSONVILLE FL,0,0,0,6,6
Tropical Storm,Gamma,14,2005-11-19T09:00:00Z,MUCM 214N 779W,0,0,0,7,7
Tropical Storm,Gamma,14,2005-11-19T09:00:00Z,SAVANNAH GA,0,0,0,3,3
Tropical Storm,Gamma,14,2005-11-19T09:00:00Z,MUCF 221N 805W,0,0,2,11,13
Tropical Storm,Gamma,14,2005-11-19T09:00:00Z,KEY WEST FL,0,0,3,13,16
Tropical Storm,Gamma,14,2005-11-19T09:00:00Z,MUSN 216N 826W,0,0,12,6,18
Tropical Storm,Gamma,14,2005-11-19T09:00:00Z,MARCO ISLAND FL,0,0,1,14,15
Tropical Storm,Gamma,14,2005-11-19T09:00:00Z,MUHA 230N 824W,0,0,8,10,18
Tropical Storm,Gamma,14,2005-11-19T09:00:00Z,FT MYERS FL,0,0,1,13,14
Tropical Storm,Gamma,14,2005-11-19T09:00:00Z,MUAN 219N 850W,0,6,17,1,24
Tropical Storm,Gamma,14,2005-11-19T09:00:00Z,VENICE FL,0,0,0,13,13
Tropical Storm,Gamma,14,2005-11-19T09:00:00Z,MMCZ 205N 869W,9,18,2,0,29
Tropical Storm,Gamma,14,2005-11-19T09:00:00Z,TAMPA FL,0,0,0,11,11
Tropical Storm,Gamma,14,2005-11-19T09:00:00Z,MZBZ 175N 883W,28,1,0,0,29
Tropical Storm,Gamma,14,2005-11-19T09:00:00Z,CEDAR KEY FL,0,0,0,9,9
Tropical Storm,Gamma,14,2005-11-19T09:00:00Z,MGPB 157N 886W,7,0,0,0,7
Tropical Storm,Gamma,14,2005-11-19T09:00:00Z,ST MARKS FL,0,0,0,6,6
Tropical Storm,Gamma,14,2005-11-19T09:00:00Z,MHNJ 165N 859W,99,0,0,0,99
Tropical Storm,Gamma,14,2005-11-19T09:00:00Z,APALACHICOLA FL,0,0,0,6,6
Tropical Storm,Gamma,14,2005-11-19T09:00:00Z,MYSM 241N 745W,0,0,0,4,4
Tropical Storm,Gamma,14,2005-11-19T09:00:00Z,PANAMA CITY FL,0,0,0,5,5
Tropical Storm,Gamma,14,2005-11-19T09:00:00Z,MYEG 235N 758W,0,0,0,6,6
Tropical Storm,Gamma,14,2005-11-19T09:00:00Z,PENSACOLA FL,0,0,0,3,3
Tropical Storm,Gamma,14,2005-11-19T09:00:00Z,MYAK 241N 776W,0,0,0,10,10
Tropical Storm,Gamma,14,2005-11-19T09:00:00Z,MOBILE AL,0,0,0,2,2
Tropical Storm,Gamma,14,2005-11-19T09:00:00Z,MYNN 251N 775W,0,0,0,10,10
Tropical Storm,Gamma,14,2005-11-19T09:00:00Z,BURAS LA,0,0,0,2,2
Tropical Storm,Gamma,14,2005-11-19T09:00:00Z,MYGF 266N 787W,0,0,0,11,11
Tropical Storm,Gamma,14,2005-11-19T09:00:00Z,GULF 29N 85W,0,0,0,8,8
Tropical Storm,Gamma,14,2005-11-19T09:00:00Z,MMMD 210N 897W,2,12,2,0,16
Tropical Storm,Gamma,14,2005-11-19T09:00:00Z,GULF 29N 87W,0,0,0,6,6
Tropical Storm,Gamma,14,2005-11-19T09:00:00Z,MARATHON FL,0,0,1,14,15
Tropical Storm,Gamma,14,2005-11-19T09:00:00Z,GULF 28N 89W,0,0,0,4,4
Tropical Storm,Gamma,15,2005-11-19T15:00:00Z,18.7N  86.4W,56,0,0,0,56
Tropical Storm,Gamma,15,2005-11-19T15:00:00Z,MIAMI FL,0,0,1,17,18
Tropical Storm,Gamma,15,2005-11-19T15:00:00Z,20.0N  85.8W,23,5,0,1,29
Tropical Storm,Gamma,15,2005-11-19T15:00:00Z,W PALM BEACH FL,0,0,0,17,17
Tropical Storm,Gamma,15,2005-11-19T15:00:00Z,21.9N  84.0W,0,10,13,1,24
Tropical Storm,Gamma,15,2005-11-19T15:00:00Z,FT PIERCE FL,0,0,0,16,16
Tropical Storm,Gamma,15,2005-11-19T15:00:00Z,MKJS 185N 779W,0,0,0,2,2
Tropical Storm,Gamma,15,2005-11-19T15:00:00Z,COCOA BEACH FL,0,0,0,15,15
Tropical Storm,Gamma,15,2005-11-19T15:00:00Z,MWCG 193N 814W,0,1,4,6,11
Tropical Storm,Gamma,15,2005-11-19T15:00:00Z,DAYTONA BEACH FL,0,0,0,12,12
Tropical Storm,Gamma,15,2005-11-19T15:00:00Z,MUGM 200N 751W,0,0,0,2,2
Tropical Storm,Gamma,15,2005-11-19T15:00:00Z,JACKSONVILLE FL,0,0,0,9,9
Tropical Storm,Gamma,15,2005-11-19T15:00:00Z,MUCM 214N 779W,0,0,0,9,9
Tropical Storm,Gamma,15,2005-11-19T15:00:00Z,SAVANNAH GA,0,0,0,5,5
Tropical Storm,Gamma,15,2005-11-19T15:00:00Z,MUCF 221N 805W,0,0,3,13,16
Tropical Storm,Gamma,15,2005-11-19T15:00:00Z,CHARLESTON SC,0,0,0,4,4
Tropical Storm,Gamma,15,2005-11-19T15:00:00Z,MUSN 216N 826W,0,3,13,5,21
Tropical Storm,Gamma,15,2005-11-19T15:00:00Z,MYRTLE BEACH SC,0,0,0,3,3
Tropical Storm,Gamma,15,2005-11-19T15:00:00Z,MUHA 230N 824W,0,1,12,8,21
Tropical Storm,Gamma,15,2005-11-19T15:00:00Z,WILMINGTON NC,0,0,0,2,2
Tropical Storm,Gamma,15,2005-11-19T15:00:00Z,MUAN 219N 850W,1,15,10,0,26
Tropical Storm,Gamma,15,2005-11-19T15:00:00Z,KEY WEST FL,0,0,6,14,20
Tropical Storm,Gamma,15,2005-11-19T15:00:00Z,MMCZ 205N 869W,16,11,1,0,28
Tropical Storm,Gamma,15,2005-11-19T15:00:00Z,MARCO ISLAND FL,0,0,2,17,19
Tropical Storm,Gamma,15,2005-11-19T15:00:00Z,MZBZ 175N 883W,24,1,0,0,25
Tropical Storm,Gamma,15,2005-11-19T15:00:00Z,FT MYERS FL,0,0,2,16,18
Tropical Storm,Gamma,15,2005-11-19T15:00:00Z,MGPB 157N 886W,6,1,0,0,7
Tropical Storm,Gamma,15,2005-11-19T15:00:00Z,VENICE FL,0,0,2,15,17
Tropical Storm,Gamma,15,2005-11-19T15:00:00Z,MHNJ 165N 859W,99,0,0,0,99
Tropical Storm,Gamma,15,2005-11-19T15:00:00Z,TAMPA FL,0,0,1,14,15
Tropical Storm,Gamma,15,2005-11-19T15:00:00Z,MYMM 224N 730W,0,0,0,3,3
Tropical Storm,Gamma,15,2005-11-19T15:00:00Z,CEDAR KEY FL,0,0,0,11,11
Tropical Storm,Gamma,15,2005-11-19T15:00:00Z,MYSM 241N 745W,0,0,0,7,7
Tropical Storm,Gamma,15,2005-11-19T15:00:00Z,ST MARKS FL,0,0,0,7,7
Tropical Storm,Gamma,15,2005-11-19T15:00:00Z,MYEG 235N 758W,0,0,0,9,9
Tropical Storm,Gamma,15,2005-11-19T15:00:00Z,APALACHICOLA FL,0,0,0,7,7
Tropical Storm,Gamma,15,2005-11-19T15:00:00Z,MYAK 241N 776W,0,0,0,13,13
Tropical Storm,Gamma,15,2005-11-19T15:00:00Z,PANAMA CITY FL,0,0,0,5,5
Tropical Storm,Gamma,15,2005-11-19T15:00:00Z,MYNN 251N 775W,0,0,0,14,14
Tropical Storm,Gamma,15,2005-11-19T15:00:00Z,PENSACOLA FL,0,0,0,2,2
Tropical Storm,Gamma,15,2005-11-19T15:00:00Z,MYGF 266N 787W,0,0,0,15,15
Tropical Storm,Gamma,15,2005-11-19T15:00:00Z,GULF 29N 85W,0,0,0,9,9
Tropical Storm,Gamma,15,2005-11-19T15:00:00Z,MMMD 210N 897W,1,6,3,1,11
Tropical Storm,Gamma,15,2005-11-19T15:00:00Z,GULF 29N 87W,0,0,0,4,4
Tropical Storm,Gamma,15,2005-11-19T15:00:00Z,MARATHON FL,0,0,3,16,19
Tropical Storm,Gamma,15,2005-11-19T15:00:00Z,GULF 28N 89W,0,0,0,2,2
Tropical Storm,Gamma,16,2005-11-19T21:00:00Z,17.8N  85.1W,55,0,0,0,55
Tropical Storm,Gamma,16,2005-11-19T21:00:00Z,MYMM 224N 730W,0,0,0,6,6
Tropical Storm,Gamma,16,2005-11-19T21:00:00Z,18.9N  84.8W,30,1,1,0,32
Tropical Storm,Gamma,16,2005-11-19T21:00:00Z,MYSM 241N 745W,0,0,0,9,9
Tropical Storm,Gamma,16,2005-11-19T21:00:00Z,20.7N  83.2W,1,12,10,2,25
Tropical Storm,Gamma,16,2005-11-19T21:00:00Z,MYEG 235N 758W,0,0,0,11,11
Tropical Storm,Gamma,16,2005-11-19T21:00:00Z,MTPP 186N 724W,0,0,0,3,3
Tropical Storm,Gamma,16,2005-11-19T21:00:00Z,MYAK 241N 776W,0,0,0,13,13
Tropical Storm,Gamma,16,2005-11-19T21:00:00Z,MTCA 183N 738W,0,0,0,3,3
Tropical Storm,Gamma,16,2005-11-19T21:00:00Z,MYNN 251N 775W,0,0,0,12,12
Tropical Storm,Gamma,16,2005-11-19T21:00:00Z,MKJP 179N 768W,0,0,0,6,6
Tropical Storm,Gamma,16,2005-11-19T21:00:00Z,MYGF 266N 787W,0,0,0,10,10
Tropical Storm,Gamma,16,2005-11-19T21:00:00Z,MKJS 185N 779W,0,0,0,9,9
Tropical Storm,Gamma,16,2005-11-19T21:00:00Z,MMMD 210N 897W,0,0,2,1,3
Tropical Storm,Gamma,16,2005-11-19T21:00:00Z,MWCG 193N 814W,0,3,9,4,16
Tropical Storm,Gamma,16,2005-11-19T21:00:00Z,MARATHON FL,0,0,4,12,16
Tropical Storm,Gamma,16,2005-11-19T21:00:00Z,MUGM 200N 751W,0,0,0,8,8
Tropical Storm,Gamma,16,2005-11-19T21:00:00Z,MIAMI FL,0,0,1,12,13
Tropical Storm,Gamma,16,2005-11-19T21:00:00Z,MUCM 214N 779W,0,0,1,13,14
Tropical Storm,Gamma,16,2005-11-19T21:00:00Z,W PALM BEACH FL,0,0,0,11,11
Tropical Storm,Gamma,16,2005-11-19T21:00:00Z,MUCF 221N 805W,0,0,8,10,18
Tropical Storm,Gamma,16,2005-11-19T21:00:00Z,FT PIERCE FL,0,0,0,8,8
Tropical Storm,Gamma,16,2005-11-19T21:00:00Z,MUSN 216N 826W,0,6,14,2,22
Tropical Storm,Gamma,16,2005-11-19T21:00:00Z,COCOA BEACH FL,0,0,0,6,6
Tropical Storm,Gamma,16,2005-11-19T21:00:00Z,MUHA 230N 824W,0,1,14,5,20
Tropical Storm,Gamma,16,2005-11-19T21:00:00Z,DAYTONA BEACH FL,0,0,0,4,4
Tropical Storm,Gamma,16,2005-11-19T21:00:00Z,MUAN 219N 850W,1,12,10,1,24
Tropical Storm,Gamma,16,2005-11-19T21:00:00Z,KEY WEST FL,0,0,7,9,16
Tropical Storm,Gamma,16,2005-11-19T21:00:00Z,MMCZ 205N 869W,4,11,4,1,20
Tropical Storm,Gamma,16,2005-11-19T21:00:00Z,MARCO ISLAND FL,0,0,2,10,12
Tropical Storm,Gamma,16,2005-11-19T21:00:00Z,MZBZ 175N 883W,2,4,2,0,8
Tropical Storm,Gamma,16,2005-11-19T21:00:00Z,FT MYERS FL,0,0,1,9,10
Tropical Storm,Gamma,16,2005-11-19T21:00:00Z,MGPB 157N 886W,0,1,1,0,2
Tropical Storm,Gamma,16,2005-11-19T21:00:00Z,VENICE FL,0,0,1,8,9
Tropical Storm,Gamma,16,2005-11-19T21:00:00Z,MHNJ 165N 859W,99,0,0,0,99
Tropical Storm,Gamma,16,2005-11-19T21:00:00Z,TAMPA FL,0,0,0,6,6
Tropical Storm,Gamma,16,2005-11-19T21:00:00Z,MNPC 141N 834W,1,1,0,1,3
Tropical Storm,Gamma,16,2005-11-19T21:00:00Z,CEDAR KEY FL,0,0,0,3,3
Tropical Storm,Gamma,16,2005-11-19T21:00:00Z,MDPP 198N 707W,0,0,0,2,2
Tropical Storm,Gamma,16,2005-11-19T21:00:00Z,GULF 29N 85W,0,0,0,2,2
Tropical Storm,Gamma,16,2005-11-19T21:00:00Z,MBJT 215N 712W,0,0,0,3,3
Tropical Storm,Gamma,17,2005-11-20T03:00:00Z,18.4N  84.1W,56,0,0,0,56
Tropical Storm,Gamma,17,2005-11-20T03:00:00Z,MBJT 215N 712W,0,0,0,6,6
Tropical Storm,Gamma,17,2005-11-20T03:00:00Z,19.5N  83.1W,32,1,0,0,33
Tropical Storm,Gamma,17,2005-11-20T03:00:00Z,MYMM 224N 730W,0,0,0,9,9
Tropical Storm,Gamma,17,2005-11-20T03:00:00Z,20.7N  80.6W,1,8,11,1,21
Tropical Storm,Gamma,17,2005-11-20T03:00:00Z,MYSM 241N 745W,0,0,0,10,10
Tropical Storm,Gamma,17,2005-11-20T03:00:00Z,MDSD 185N 697W,0,0,0,3,3
Tropical Storm,Gamma,17,2005-11-20T03:00:00Z,MYEG 235N 758W,0,0,0,12,12
Tropical Storm,Gamma,17,2005-11-20T03:00:00Z,MDCB 176N 714W,0,0,0,5,5
Tropical Storm,Gamma,17,2005-11-20T03:00:00Z,MYAK 241N 776W,0,0,2,11,13
Tropical Storm,Gamma,17,2005-11-20T03:00:00Z,MTPP 186N 724W,0,0,0,7,7
Tropical Storm,Gamma,17,2005-11-20T03:00:00Z,MYNN 251N 775W,0,0,1,10,11
Tropical Storm,Gamma,17,2005-11-20T03:00:00Z,MTCA 183N 738W,0,0,0,8,8
Tropical Storm,Gamma,17,2005-11-20T03:00:00Z,MYGF 266N 787W,0,0,1,7,8
Tropical Storm,Gamma,17,2005-11-20T03:00:00Z,MKJP 179N 768W,0,0,1,10,11
Tropical Storm,Gamma,17,2005-11-20T03:00:00Z,MARATHON FL,0,1,7,5,13
Tropical Storm,Gamma,17,2005-11-20T03:00:00Z,MKJS 185N 779W,0,0,3,10,13
Tropical Storm,Gamma,17,2005-11-20T03:00:00Z,MIAMI FL,0,0,3,7,10
Tropical Storm,Gamma,17,2005-11-20T03:00:00Z,MWCG 193N 814W,8,7,6,1,22
Tropical Storm,Gamma,17,2005-11-20T03:00:00Z,W PALM BEACH FL,0,0,1,7,8
Tropical Storm,Gamma,17,2005-11-20T03:00:00Z,MUGM 200N 751W,0,0,0,12,12
Tropical Storm,Gamma,17,2005-11-20T03:00:00Z,FT PIERCE FL,0,0,0,5,5
Tropical Storm,Gamma,17,2005-11-20T03:00:00Z,MUCM 214N 779W,0,0,5,11,16
Tropical Storm,Gamma,17,2005-11-20T03:00:00Z,COCOA BEACH FL,0,0,0,4,4
Tropical Storm,Gamma,17,2005-11-20T03:00:00Z,MUCF 221N 805W,0,5,13,2,20
Tropical Storm,Gamma,17,2005-11-20T03:00:00Z,DAYTONA BEACH FL,0,0,0,2,2
Tropical Storm,Gamma,17,2005-11-20T03:00:00Z,MUSN 216N 826W,8,11,5,0,24
Tropical Storm,Gamma,17,2005-11-20T03:00:00Z,KEY WEST FL,0,1,9,3,13
Tropical Storm,Gamma,17,2005-11-20T03:00:00Z,MUHA 230N 824W,1,8,9,1,19
Tropical Storm,Gamma,17,2005-11-20T03:00:00Z,MARCO ISLAND FL,0,0,3,5,8
Tropical Storm,Gamma,17,2005-11-20T03:00:00Z,MUAN 219N 850W,1,11,4,0,16
Tropical Storm,Gamma,17,2005-11-20T03:00:00Z,FT MYERS FL,0,0,2,4,6
Tropical Storm,Gamma,17,2005-11-20T03:00:00Z,MMCZ 205N 869W,0,4,3,0,7
Tropical Storm,Gamma,17,2005-11-20T03:00:00Z,VENICE FL,0,0,1,3,4
Tropical Storm,Gamma,17,2005-11-20T03:00:00Z,MHNJ 165N 859W,19,1,0,0,20
Tropical Storm,Gamma,17,2005-11-20T03:00:00Z,TAMPA FL,0,0,0,2,2
Tropical Storm,Gamma,17,2005-11-20T03:00:00Z,MDPP 198N 707W,0,0,0,5,5
Tropical Storm,Gamma,18,2005-11-20T09:00:00Z,17.5N  85.0W,99,0,0,0,99
Tropical Storm,Gamma,18,2005-11-20T09:00:00Z,MUHA 230N 824W,0,0,3,5,8
Tropical Storm,Gamma,18,2005-11-20T09:00:00Z,17.9N  84.0W,46,0,0,0,46
Tropical Storm,Gamma,18,2005-11-20T09:00:00Z,MUAN 219N 850W,0,5,5,2,12
Tropical Storm,Gamma,18,2005-11-20T09:00:00Z,18.0N  82.2W,3,9,8,2,22
Tropical Storm,Gamma,18,2005-11-20T09:00:00Z,MMCZ 205N 869W,3,7,2,1,13
Tropical Storm,Gamma,18,2005-11-20T09:00:00Z,MDCB 176N 714W,0,0,0,2,2
Tropical Storm,Gamma,18,2005-11-20T09:00:00Z,MZBZ 175N 883W,4,3,1,1,9
Tropical Storm,Gamma,18,2005-11-20T09:00:00Z,MTPP 186N 724W,0,0,0,3,3
Tropical Storm,Gamma,18,2005-11-20T09:00:00Z,MGPB 157N 886W,1,1,1,1,4
Tropical Storm,Gamma,18,2005-11-20T09:00:00Z,MTCA 183N 738W,0,0,0,4,4
Tropical Storm,Gamma,18,2005-11-20T09:00:00Z,MHNJ 165N 859W,99,0,0,0,99
Tropical Storm,Gamma,18,2005-11-20T09:00:00Z,MKJP 179N 768W,0,0,0,10,10
Tropical Storm,Gamma,18,2005-11-20T09:00:00Z,MNPC 141N 834W,4,5,3,2,14
Tropical Storm,Gamma,18,2005-11-20T09:00:00Z,MKJS 185N 779W,0,0,1,10,11
Tropical Storm,Gamma,18,2005-11-20T09:00:00Z,MNBL 120N 839W,0,1,1,3,5
Tropical Storm,Gamma,18,2005-11-20T09:00:00Z,MWCG 193N 814W,0,3,11,4,18
Tropical Storm,Gamma,18,2005-11-20T09:00:00Z,SKSP 126N 817W,0,0,3,4,7
Tropical Storm,Gamma,18,2005-11-20T09:00:00Z,MUGM 200N 751W,0,0,0,5,5
Tropical Storm,Gamma,18,2005-11-20T09:00:00Z,MYEG 235N 758W,0,0,0,2,2
Tropical Storm,Gamma,18,2005-11-20T09:00:00Z,MUCM 214N 779W,0,0,0,8,8
Tropical Storm,Gamma,18,2005-11-20T09:00:00Z,MYAK 241N 776W,0,0,0,2,2
Tropical Storm,Gamma,18,2005-11-20T09:00:00Z,MUCF 221N 805W,0,0,2,7,9
Tropical Storm,Gamma,18,2005-11-20T09:00:00Z,MARATHON FL,0,0,0,3,3
Tropical Storm,Gamma,18,2005-11-20T09:00:00Z,MUSN 216N 826W,0,2,7,4,13
Tropical Storm,Gamma,18,2005-11-20T09:00:00Z,KEY WEST FL,0,0,0,3,3
Tropical Depression,Gamma,19,2005-11-20T15:00:00Z,17.5N  84.4W,85,0,0,0,85
Tropical Depression,Gamma,19,2005-11-20T15:00:00Z,MUHA 230N 824W,0,1,4,0,5
Tropical Depression,Gamma,19,2005-11-20T15:00:00Z,17.7N  83.0W,24,5,1,0,30
Tropical Depression,Gamma,19,2005-11-20T15:00:00Z,MUAN 219N 850W,0,2,3,0,5
Tropical Depression,Gamma,19,2005-11-20T15:00:00Z,17.7N  81.1W,1,11,8,0,20
Tropical Depression,Gamma,19,2005-11-20T15:00:00Z,MMCZ 205N 869W,0,2,1,0,3
Tropical Depression,Gamma,19,2005-11-20T15:00:00Z,MKJS 185N 779W,0,0,4,0,4
Tropical Depression,Gamma,19,2005-11-20T15:00:00Z,MZBZ 175N 883W,2,1,0,0,3
Tropical Depression,Gamma,19,2005-11-20T15:00:00Z,MWCG 193N 814W,0,13,8,0,21
Tropical Depression,Gamma,19,2005-11-20T15:00:00Z,MHNJ 165N 859W,99,0,0,0,99
Tropical Depression,Gamma,19,2005-11-20T15:00:00Z,MUCM 214N 779W,0,0,2,0,2
Tropical Depression,Gamma,19,2005-11-20T15:00:00Z,MNPC 141N 834W,0,4,6,0,10
Tropical Depression,Gamma,19,2005-11-20T15:00:00Z,MUCF 221N 805W,0,1,7,0,8
Tropical Depression,Gamma,19,2005-11-20T15:00:00Z,SKSP 126N 817W,0,0,2,0,2
Tropical Depression,Gamma,19,2005-11-20T15:00:00Z,MUSN 216N 826W,0,5,7,0,12
Tropical Depression,Gamma,20,2005-11-20T21:00:00Z,17.5N  85.0W,99,0,0,0,99
Tropical Depression,Gamma,20,2005-11-20T21:00:00Z,MMCZ 205N 869W,3,5,0,0,8
Tropical Depression,Gamma,20,2005-11-20T21:00:00Z,17.6N  83.0W,8,17,0,0,25
Tropical Depression,Gamma,20,2005-11-20T21:00:00Z,MZBZ 175N 883W,7,1,0,0,8
Tropical Depression,Gamma,20,2005-11-20T21:00:00Z,MWCG 193N 814W,0,9,0,0,9
Tropical Depression,Gamma,20,2005-11-20T21:00:00Z,MHNJ 165N 859W,99,0,0,0,99
Tropical Depression,Gamma,20,2005-11-20T21:00:00Z,MUSN 216N 826W,0,3,0,0,3
Tropical Depression,Gamma,20,2005-11-20T21:00:00Z,MNPC 141N 834W,2,7,0,0,9
Tropical Depression,Gamma,20,2005-11-20T21:00:00Z,MUAN 219N 850W,0,4,0,0,4
Tropical Depression,Gamma,21,2005-11-21T03:00:00Z,17.5N  84.0W,42,0,0,0,42
Tropical Depression,Gamma,21,2005-11-21T03:00:00Z,MUSN 216N 826W,0,4,0,0,4
Tropical Depression,Gamma,21,2005-11-21T03:00:00Z,17.5N  82.0W,5,25,0,0,30
Tropical Depression,Gamma,21,2005-11-21T03:00:00Z,MHNJ 165N 859W,99,0,0,0,99
Tropical Depression,Gamma,21,2005-11-21T03:00:00Z,MWCG 193N 814W,1,22,0,0,23
Tropical Depression,Gamma,21,2005-11-21T03:00:00Z,MNPC 141N 834W,1,4,0,0,5
Tropical Storm,Delta,1,2005-11-23T21:00:00Z,24.7N  39.7W,48,0,0,0,48
Tropical Storm,Delta,1,2005-11-23T21:00:00Z,26.0N  39.5W,99,0,0,0,99
Tropical Storm,Delta,1,2005-11-23T21:00:00Z,25.0N  39.4W,31,1,0,0,32
Tropical Storm,Delta,2,2005-11-24T03:00:00Z,24.2N  39.5W,54,0,0,0,54
Tropical Storm,Delta,2,2005-11-24T03:00:00Z,26.0N  39.6W,99,0,0,0,99
Tropical Storm,Delta,2,2005-11-24T03:00:00Z,25.0N  39.5W,99,0,0,0,99
Tropical Storm,Delta,3,2005-11-24T09:00:00Z,23.9N  39.4W,99,0,0,0,99
Tropical Storm,Delta,3,2005-11-24T09:00:00Z,24.9N  39.4W,99,0,0,0,99
Tropical Storm,Delta,3,2005-11-24T09:00:00Z,24.2N  39.3W,99,0,0,0,99
Tropical Storm,Delta,4,2005-11-24T15:00:00Z,25.3N  38.5W,99,0,0,0,99
Tropical Storm,Delta,4,2005-11-24T15:00:00Z,26.6N  38.7W,19,3,1,1,24
Tropical Storm,Delta,4,2005-11-24T15:00:00Z,25.9N  38.6W,29,0,1,0,30
Tropical Storm,Delta,5,2005-11-24T21:00:00Z,25.5N  38.8W,99,0,0,0,99
Tropical Storm,Delta,5,2005-11-24T21:00:00Z,27.1N  39.0W,14,4,1,2,21
Tropical Storm,Delta,5,2005-11-24T21:00:00Z,26.2N  38.9W,25,1,1,1,28
Tropical Storm,Delta,6,2005-11-25T03:00:00Z,23.7N  39.0W,99,0,0,0,99
Tropical Storm,Delta,6,2005-11-25T03:00:00Z,26.1N  38.5W,13,4,3,1,21
Tropical Storm,Delta,6,2005-11-25T03:00:00Z,24.5N  38.8W,99,0,0,0,99
Tropical Storm,Delta,7,2005-11-25T09:00:00Z,24.0N  39.0W,99,0,0,0,99
Tropical Storm,Delta,7,2005-11-25T09:00:00Z,26.8N  37.1W,2,9,4,3,18
Tropical Storm,Delta,7,2005-11-25T09:00:00Z,25.0N  38.3W,49,0,0,0,49
Tropical Storm,Delta,8,2005-11-25T15:00:00Z,24.0N  38.9W,99,0,0,0,99
Tropical Storm,Delta,8,2005-11-25T15:00:00Z,27.1N  36.9W,2,10,4,3,19
Tropical Storm,Delta,8,2005-11-25T15:00:00Z,25.5N  38.0W,16,4,2,1,23
Tropical Storm,Delta,9,2005-11-25T21:00:00Z,24.3N  38.9W,33,1,0,0,34
Tropical Storm,Delta,9,2005-11-25T21:00:00Z,27.3N  36.8W,3,9,4,3,19
Tropical Storm,Delta,9,2005-11-25T21:00:00Z,25.5N  38.0W,18,3,1,1,23
Tropical Storm,Delta,10,2005-11-26T03:00:00Z,23.8N  38.1W,35,0,0,0,35
Tropical Storm,Delta,10,2005-11-26T03:00:00Z,28.2N  33.3W,0,5,11,2,18
Tropical Storm,Delta,10,2005-11-26T03:00:00Z,25.7N  36.1W,6,14,2,0,22
Tropical Storm,Delta,11,2005-11-26T09:00:00Z,24.4N  36.3W,38,0,1,0,39
Tropical Storm,Delta,11,2005-11-26T09:00:00Z,28.3N  30.2W,0,9,10,2,21
Tropical Storm,Delta,11,2005-11-26T09:00:00Z,26.7N  33.5W,2,22,1,0,25
Tropical Storm,Delta,12,2005-11-26T15:00:00Z,25.5N  34.5W,30,1,0,0,31
Tropical Storm,Delta,12,2005-11-26T15:00:00Z,29.0N  27.0W,0,5,10,1,16
Tropical Storm,Delta,12,2005-11-26T15:00:00Z,27.5N  31.0W,2,19,1,0,22
Tropical Storm,Delta,13,2005-11-26T21:00:00Z,27.0N  31.5W,34,2,0,0,36
Tropical Storm,Delta,13,2005-11-26T21:00:00Z,28.5N  20.0W,0,2,13,0,15
Tropical Storm,Delta,13,2005-11-26T21:00:00Z,28.5N  26.0W,0,20,2,0,22
Tropical Storm,Delta,14,2005-11-27T03:00:00Z,27.8N  27.7W,34,0,0,0,34
Tropical Storm,Delta,14,2005-11-27T03:00:00Z,28.5N  15.5W,0,2,13,0,15
Tropical Storm,Delta,14,2005-11-27T03:00:00Z,28.5N  22.4W,3,18,2,0,23
Tropical Storm,Delta,15,2005-11-27T09:00:00Z,28.8N  24.0W,34,2,0,0,36
Tropical Storm,Delta,15,2005-11-27T09:00:00Z,28.8N  11.5W,0,2,12,0,14
Tropical Storm,Delta,15,2005-11-27T09:00:00Z,28.8N  17.5W,0,19,2,0,21
Tropical Storm,Delta,16,2005-11-27T15:00:00Z,29.5N  21.5W,37,2,0,0,39
Tropical Storm,Delta,16,2005-11-27T15:00:00Z,29.0N  10.0W,0,3,12,0,15
Tropical Storm,Delta,16,2005-11-27T15:00:00Z,29.5N  15.5W,1,20,2,0,23
Tropical Storm,Delta,17,2005-11-27T21:00:00Z,30.0N  19.5W,35,1,0,0,36
Tropical Storm,Delta,17,2005-11-27T21:00:00Z,29.3N   9.0W,0,4,11,0,15
Tropical Storm,Delta,17,2005-11-27T21:00:00Z,29.7N  14.0W,1,19,2,0,22
Tropical Storm,Delta,18,2005-11-28T03:00:00Z,30.0N  16.4W,34,1,0,0,35
Tropical Storm,Delta,18,2005-11-28T03:00:00Z,29.0N   5.4W,0,5,10,0,15
Tropical Storm,Delta,18,2005-11-28T03:00:00Z,29.5N  10.5W,1,19,2,0,22
Tropical Storm,Delta,19,2005-11-28T09:00:00Z,30.3N  13.0W,31,2,0,0,33
Tropical Storm,Delta,19,2005-11-28T09:00:00Z,30.0N   2.5W,0,4,8,0,12
Tropical Storm,Delta,19,2005-11-28T09:00:00Z,30.3N   7.2W,1,16,1,0,18
Tropical Storm,Delta,20,2005-11-28T15:00:00Z,30.5N   9.7W,31,3,0,0,34
Tropical Storm,Delta,20,2005-11-28T15:00:00Z,30.7N   3.3W,0,16,0,0,16
Tropical Storm,Epsilon,1,2005-11-29T15:00:00Z,31.8N  53.4W,42,0,0,0,42
Tropical Storm,Epsilon,1,2005-11-29T15:00:00Z,32.7N  53.7W,35,1,0,0,36
Tropical Storm,Epsilon,1,2005-11-29T15:00:00Z,32.0N  54.3W,32,0,0,0,32
Tropical Storm,Epsilon,1,2005-11-29T15:00:00Z,BERMUDA,0,0,1,2,3
Tropical Storm,Epsilon,2,2005-11-29T21:00:00Z,31.7N  53.1W,67,0,0,0,67
Tropical Storm,Epsilon,2,2005-11-29T21:00:00Z,32.8N  52.2W,59,0,0,0,59
Tropical Storm,Epsilon,2,2005-11-29T21:00:00Z,32.4N  53.1W,60,0,0,0,60
Tropical Storm,Epsilon,2,2005-11-29T21:00:00Z,BERMUDA,0,0,0,2,2
Tropical Storm,Epsilon,3,2005-11-30T03:00:00Z,31.6N  53.9W,60,0,0,0,60
Tropical Storm,Epsilon,3,2005-11-30T03:00:00Z,32.8N  53.0W,50,0,0,0,50
Tropical Storm,Epsilon,3,2005-11-30T03:00:00Z,32.0N  53.9W,60,0,0,0,60
Tropical Storm,Epsilon,3,2005-11-30T03:00:00Z,BERMUDA,0,0,1,1,2
Tropical Storm,Epsilon,4,2005-11-30T09:00:00Z,31.5N  54.0W,75,0,0,0,75
Tropical Storm,Epsilon,4,2005-11-30T09:00:00Z,33.0N  51.0W,8,7,3,1,19
Tropical Storm,Epsilon,4,2005-11-30T09:00:00Z,32.5N  53.0W,50,0,0,1,51
Tropical Storm,Epsilon,5,2005-11-30T15:00:00Z,31.6N  54.0W,99,0,0,0,99
Tropical Storm,Epsilon,5,2005-11-30T15:00:00Z,33.5N  51.0W,3,11,3,2,19
Tropical Storm,Epsilon,5,2005-11-30T15:00:00Z,32.4N  52.8W,23,2,0,1,26
Tropical Storm,Epsilon,6,2005-11-30T21:00:00Z,31.1N  53.5W,52,0,0,0,52
Tropical Storm,Epsilon,6,2005-11-30T21:00:00Z,33.2N  50.0W,1,10,4,2,17
Tropical Storm,Epsilon,6,2005-11-30T21:00:00Z,32.1N  51.8W,16,6,1,0,23
Tropical Storm,Epsilon,7,2005-12-01T03:00:00Z,30.9N  51.5W,28,1,0,0,29
Tropical Storm,Epsilon,7,2005-12-01T03:00:00Z,33.0N  48.0W,3,9,3,2,17
Tropical Storm,Epsilon,7,2005-12-01T03:00:00Z,32.0N  49.8W,14,4,2,1,21
Tropical Storm,Epsilon,8,2005-12-01T09:00:00Z,32.0N  49.2W,23,1,1,0,25
Tropical Storm,Epsilon,8,2005-12-01T09:00:00Z,34.0N  45.5W,1,7,4,2,14
Tropical Storm,Epsilon,8,2005-12-01T09:00:00Z,33.1N  47.5W,10,5,2,1,18
Tropical Storm,Epsilon,9,2005-12-01T15:00:00Z,33.4N  48.5W,22,1,0,0,23
Tropical Storm,Epsilon,9,2005-12-01T15:00:00Z,35.6N  45.1W,3,8,3,2,16
Tropical Storm,Epsilon,9,2005-12-01T15:00:00Z,34.7N  46.7W,11,4,1,1,17
Tropical Storm,Epsilon,10,2005-12-01T21:00:00Z,34.1N  48.0W,21,1,0,0,22
Tropical Storm,Epsilon,10,2005-12-01T21:00:00Z,36.4N  44.6W,4,6,2,3,15
Tropical Storm,Epsilon,10,2005-12-01T21:00:00Z,35.3N  46.3W,11,3,1,2,17
Tropical Storm,Epsilon,11,2005-12-02T03:00:00Z,34.6N  47.0W,23,1,1,0,25
Tropical Storm,Epsilon,11,2005-12-02T03:00:00Z,36.9N  43.1W,2,8,3,2,15
Tropical Storm,Epsilon,11,2005-12-02T03:00:00Z,35.8N  45.2W,12,4,1,1,18
Tropical Storm,Epsilon,12,2005-12-02T09:00:00Z,35.2N  46.1W,24,1,0,0,25
Tropical Storm,Epsilon,12,2005-12-02T09:00:00Z,37.8N  42.2W,1,9,3,2,15
Tropical Storm,Epsilon,12,2005-12-02T09:00:00Z,36.5N  44.2W,11,4,2,1,18
Hurricane,Epsilon,13,2005-12-02T15:00:00Z,35.8N  45.0W,25,0,1,0,26
Hurricane,Epsilon,13,2005-12-02T15:00:00Z,38.3N  40.7W,1,9,3,2,15
Hurricane,Epsilon,13,2005-12-02T15:00:00Z,37.0N  43.0W,11,5,2,0,18
Hurricane,Epsilon,14,2005-12-02T21:00:00Z,36.1N  43.9W,23,1,0,1,25
Hurricane,Epsilon,14,2005-12-02T21:00:00Z,38.4N  39.3W,0,8,4,2,14
Hurricane,Epsilon,14,2005-12-02T21:00:00Z,37.2N  41.7W,9,6,1,1,17
Hurricane,Epsilon,15,2005-12-03T03:00:00Z,36.1N  42.8W,26,0,1,0,27
Hurricane,Epsilon,15,2005-12-03T03:00:00Z,37.5N  38.2W,2,9,2,2,15
Hurricane,Epsilon,15,2005-12-03T03:00:00Z,36.9N  40.5W,12,4,1,1,18
Hurricane,Epsilon,16,2005-12-03T09:00:00Z,35.4N  41.4W,22,1,0,1,24
Hurricane,Epsilon,16,2005-12-03T09:00:00Z,35.9N  36.2W,1,9,3,2,15
Hurricane,Epsilon,16,2005-12-03T09:00:00Z,35.7N  38.8W,10,5,1,1,17
Hurricane,Epsilon,17,2005-12-03T15:00:00Z,34.5N  40.0W,28,0,0,0,28
Hurricane,Epsilon,17,2005-12-03T15:00:00Z,34.5N  35.0W,3,10,3,1,17
Hurricane,Epsilon,17,2005-12-03T15:00:00Z,34.5N  37.5W,15,4,1,0,20
Hurricane,Epsilon,18,2005-12-03T21:00:00Z,34.5N  38.5W,28,0,0,1,29
Hurricane,Epsilon,18,2005-12-03T21:00:00Z,34.0N  34.5W,8,7,2,1,18
Hurricane,Epsilon,18,2005-12-03T21:00:00Z,34.5N  36.5W,18,2,1,0,21
Hurricane,Epsilon,19,2005-12-04T03:00:00Z,34.1N  37.4W,28,0,0,1,29
Hurricane,Epsilon,19,2005-12-04T03:00:00Z,33.3N  33.5W,8,7,2,2,19
Hurricane,Epsilon,19,2005-12-04T03:00:00Z,33.8N  35.3W,17,3,1,1,22
Tropical Storm,Epsilon,20,2005-12-04T09:00:00Z,34.2N  36.3W,29,1,0,0,30
Tropical Storm,Epsilon,20,2005-12-04T09:00:00Z,33.0N  33.0W,10,5,2,1,18
Tropical Storm,Epsilon,20,2005-12-04T09:00:00Z,34.0N  34.4W,17,2,1,1,21
Hurricane,Epsilon,21,2005-12-04T15:00:00Z,34.0N  35.0W,30,0,0,0,30
Hurricane,Epsilon,21,2005-12-04T15:00:00Z,32.0N  33.5W,16,3,1,1,21
Hurricane,Epsilon,21,2005-12-04T15:00:00Z,33.5N  33.5W,21,1,1,0,23
Hurricane,Epsilon,22,2005-12-04T21:00:00Z,34.0N  34.5W,33,1,0,0,34
Hurricane,Epsilon,22,2005-12-04T21:00:00Z,32.0N  34.0W,19,2,1,0,22
Hurricane,Epsilon,22,2005-12-04T21:00:00Z,33.0N  33.5W,24,1,0,1,26
Hurricane,Epsilon,23,2005-12-05T03:00:00Z,33.4N  34.3W,34,0,0,0,34
Hurricane,Epsilon,23,2005-12-05T03:00:00Z,31.2N  34.9W,16,3,1,1,21
Hurricane,Epsilon,23,2005-12-05T03:00:00Z,32.5N  34.0W,26,1,0,1,28
Hurricane,Epsilon,24,2005-12-05T09:00:00Z,32.7N  34.2W,36,1,0,0,37
Hurricane,Epsilon,24,2005-12-05T09:00:00Z,29.8N  36.1W,6,6,2,2,16
Hurricane,Epsilon,24,2005-12-05T09:00:00Z,31.3N  34.6W,20,2,0,1,23
Hurricane,Epsilon,25,2005-12-05T15:00:00Z,32.0N  34.0W,29,1,0,0,30
Hurricane,Epsilon,25,2005-12-05T15:00:00Z,29.0N  37.0W,2,9,3,2,16
Hurricane,Epsilon,25,2005-12-05T15:00:00Z,30.5N  35.5W,14,3,1,1,19
Hurricane,Epsilon,26,2005-12-05T21:00:00Z,32.0N  34.5W,28,0,0,1,29
Hurricane,Epsilon,26,2005-12-05T21:00:00Z,29.0N  36.5W,3,9,3,2,17
Hurricane,Epsilon,26,2005-12-05T21:00:00Z,30.5N  35.5W,14,3,2,1,20
Hurricane,Epsilon,27,2005-12-06T03:00:00Z,30.7N  34.5W,28,1,0,0,29
Hurricane,Epsilon,27,2005-12-06T03:00:00Z,27.8N  37.0W,2,9,3,2,16
Hurricane,Epsilon,27,2005-12-06T03:00:00Z,29.3N  35.7W,14,3,2,1,20
Hurricane,Epsilon,28,2005-12-06T09:00:00Z,30.5N  35.0W,29,1,0,0,30
Hurricane,Epsilon,28,2005-12-06T09:00:00Z,28.0N  37.5W,6,8,2,2,18
Hurricane,Epsilon,28,2005-12-06T09:00:00Z,29.0N  36.5W,15,3,1,1,20
Hurricane,Epsilon,29,2005-12-06T15:00:00Z,28.9N  36.5W,29,0,1,0,30
Hurricane,Epsilon,29,2005-12-06T15:00:00Z,26.4N  39.0W,4,8,3,2,17
Hurricane,Epsilon,29,2005-12-06T15:00:00Z,27.6N  37.9W,14,4,1,1,20
Hurricane,Epsilon,30,2005-12-06T21:00:00Z,28.4N  37.0W,29,1,0,0,30
Hurricane,Epsilon,30,2005-12-06T21:00:00Z,26.5N  38.7W,11,5,2,1,19
Hurricane,Epsilon,30,2005-12-06T21:00:00Z,27.1N  38.2W,17,2,1,1,21
Hurricane,Epsilon,31,2005-12-07T03:00:00Z,27.5N  37.5W,29,0,1,0,30
Hurricane,Epsilon,31,2005-12-07T03:00:00Z,26.0N  38.5W,15,3,1,0,19
Hurricane,Epsilon,31,2005-12-07T03:00:00Z,26.5N  38.4W,19,2,0,0,21
Hurricane,Epsilon,32,2005-12-07T09:00:00Z,27.7N  38.5W,31,0,0,0,31
Hurricane,Epsilon,32,2005-12-07T09:00:00Z,26.0N  40.0W,12,4,2,0,18
Hurricane,Epsilon,32,2005-12-07T09:00:00Z,26.5N  39.5W,17,2,1,0,20
Hurricane,Epsilon,33,2005-12-07T15:00:00Z,26.4N  39.7W,47,0,0,0,47
Hurricane,Epsilon,33,2005-12-07T15:00:00Z,24.6N  40.4W,15,8,2,0,25
Hurricane,Epsilon,33,2005-12-07T15:00:00Z,25.3N  40.3W,28,2,1,0,31
Hurricane,Epsilon,34,2005-12-07T21:00:00Z,25.4N  39.8W,45,0,0,0,45
Hurricane,Epsilon,34,2005-12-07T21:00:00Z,23.6N  40.1W,14,8,2,0,24
Hurricane,Epsilon,34,2005-12-07T21:00:00Z,24.5N  40.0W,30,2,0,0,32
Tropical Storm,Epsilon,35,2005-12-08T03:00:00Z,26.7N  39.8W,66,0,0,0,66
Tropical Storm,Epsilon,36,2005-12-08T09:00:00Z,26.7N  38.9W,99,0,0,0,99
Tropical Depression,Epsilon,37,2005-12-08T15:00:00Z,25.5N  42.0W,59,0,0,0,59
Tropical Storm,Zeta,1,2005-12-30T17:00:00Z,26.0N  38.5W,36,0,0,0,36
Tropical Storm,Zeta,1,2005-12-30T17:00:00Z,26.0N  42.0W,4,8,3,0,15
Tropical Storm,Zeta,1,2005-12-30T17:00:00Z,26.0N  40.0W,18,2,2,0,22
Tropical Storm,Zeta,2,2005-12-30T21:00:00Z,25.8N  39.0W,42,0,0,0,42
Tropical Storm,Zeta,2,2005-12-30T21:00:00Z,26.0N  42.0W,6,8,3,0,17
Tropical Storm,Zeta,2,2005-12-30T21:00:00Z,26.0N  40.4W,19,3,1,0,23
Tropical Storm,Zeta,3,2005-12-31T03:00:00Z,26.2N  39.1W,46,0,0,0,46
Tropical Storm,Zeta,3,2005-12-31T03:00:00Z,26.3N  41.6W,10,5,3,0,18
Tropical Storm,Zeta,3,2005-12-31T03:00:00Z,26.2N  40.3W,22,2,1,0,25
Tropical Storm,Zeta,4,2005-12-31T09:00:00Z,26.5N  39.4W,36,0,0,0,36
Tropical Storm,Zeta,4,2005-12-31T09:00:00Z,26.6N  41.7W,11,5,2,2,20
Tropical Storm,Zeta,4,2005-12-31T09:00:00Z,26.6N  40.5W,22,2,0,1,25
Tropical Storm,Zeta,5,2005-12-31T15:00:00Z,26.0N  40.0W,45,0,0,0,45
Tropical Storm,Zeta,5,2005-12-31T15:00:00Z,26.3N  42.0W,19,2,2,1,24
Tropical Storm,Zeta,5,2005-12-31T15:00:00Z,26.0N  41.1W,27,1,1,0,29
Tropical Storm,Zeta,6,2005-12-31T21:00:00Z,25.7N  39.7W,44,0,0,0,44
Tropical Storm,Zeta,6,2005-12-31T21:00:00Z,26.0N  41.5W,17,3,1,0,21
Tropical Storm,Zeta,6,2005-12-31T21:00:00Z,25.7N  40.7W,26,1,1,0,28
Tropical Storm,Zeta,7,2006-01-01T03:00:00Z,25.4N  40.0W,57,0,0,0,57
Tropical Storm,Zeta,7,2006-01-01T03:00:00Z,25.6N  41.9W,30,3,1,0,34
Tropical Storm,Zeta,7,2006-01-01T03:00:00Z,25.4N  40.9W,41,1,0,0,42
Tropical Storm,Zeta,8,2006-01-01T09:00:00Z,25.5N  40.2W,57,0,0,0,57
Tropical Storm,Zeta,8,2006-01-01T09:00:00Z,25.8N  42.2W,30,3,1,0,34
Tropical Storm,Zeta,8,2006-01-01T09:00:00Z,25.5N  41.2W,41,0,0,0,41
Tropical Storm,Zeta,9,2006-01-01T15:00:00Z,24.8N  40.4W,59,0,0,0,59
Tropical Storm,Zeta,9,2006-01-01T15:00:00Z,25.0N  42.5W,29,4,0,0,33
Tropical Storm,Zeta,9,2006-01-01T15:00:00Z,24.9N  41.5W,41,0,1,0,42
Tropical Storm,Zeta,10,2006-01-01T21:00:00Z,24.5N  40.3W,54,0,0,0,54
Tropical Storm,Zeta,10,2006-01-01T21:00:00Z,24.4N  42.4W,27,4,1,0,32
Tropical Storm,Zeta,10,2006-01-01T21:00:00Z,24.4N  41.4W,40,0,0,0,40
Tropical Storm,Zeta,11,2006-01-02T03:00:00Z,24.0N  40.0W,47,0,0,0,47
Tropical Storm,Zeta,11,2006-01-02T03:00:00Z,24.0N  43.0W,14,13,2,0,29
Tropical Storm,Zeta,11,2006-01-02T03:00:00Z,24.0N  41.5W,37,1,0,0,38
Tropical Storm,Zeta,12,2006-01-02T09:00:00Z,24.3N  41.5W,59,0,0,0,59
Tropical Storm,Zeta,12,2006-01-02T09:00:00Z,24.2N  44.6W,10,15,2,0,27
Tropical Storm,Zeta,12,2006-01-02T09:00:00Z,24.2N  42.8W,37,1,0,0,38
Tropical Storm,Zeta,13,2006-01-02T15:00:00Z,23.0N  42.5W,51,0,0,0,51
Tropical Storm,Zeta,13,2006-01-02T15:00:00Z,23.0N  45.0W,23,7,1,0,31
Tropical Storm,Zeta,13,2006-01-02T15:00:00Z,23.0N  43.8W,39,0,0,0,39
Tropical Storm,Zeta,14,2006-01-02T21:00:00Z,23.0N  43.1W,54,0,0,0,54
Tropical Storm,Zeta,14,2006-01-02T21:00:00Z,23.0N  45.5W,21,8,1,0,30
Tropical Storm,Zeta,14,2006-01-02T21:00:00Z,23.0N  44.3W,38,0,0,0,38
Tropical Storm,Zeta,15,2006-01-03T03:00:00Z,23.3N  42.7W,61,0,0,0,61
Tropical Storm,Zeta,15,2006-01-03T03:00:00Z,23.5N  45.0W,25,6,1,0,32
Tropical Storm,Zeta,15,2006-01-03T03:00:00Z,23.2N  43.8W,39,1,0,0,40
Tropical Storm,Zeta,16,2006-01-03T09:00:00Z,23.3N  42.9W,55,0,0,0,55
Tropical Storm,Zeta,16,2006-01-03T09:00:00Z,24.3N  44.8W,34,2,0,1,37
Tropical Storm,Zeta,16,2006-01-03T09:00:00Z,23.5N  43.9W,43,0,0,0,43
Tropical Storm,Zeta,17,2006-01-03T15:00:00Z,23.0N  43.8W,57,0,0,0,57
Tropical Storm,Zeta,17,2006-01-03T15:00:00Z,24.5N  45.5W,34,1,0,1,36
Tropical Storm,Zeta,17,2006-01-03T15:00:00Z,23.4N  44.8W,46,0,0,0,46
Tropical Storm,Zeta,18,2006-01-03T21:00:00Z,23.4N  44.4W,60,0,0,0,60
Tropical Storm,Zeta,18,2006-01-03T21:00:00Z,25.3N  46.5W,23,9,0,1,33
Tropical Storm,Zeta,18,2006-01-03T21:00:00Z,24.2N  45.6W,41,1,0,0,42
Tropical Storm,Zeta,19,2006-01-04T03:00:00Z,22.7N  44.5W,59,0,0,0,59
Tropical Storm,Zeta,19,2006-01-04T03:00:00Z,25.5N  46.5W,16,13,1,1,31
Tropical Storm,Zeta,19,2006-01-04T03:00:00Z,24.0N  46.0W,38,1,1,0,40
Tropical Storm,Zeta,20,2006-01-04T09:00:00Z,22.4N  45.2W,54,0,0,0,54
Tropical Storm,Zeta,20,2006-01-04T09:00:00Z,25.5N  46.9W,12,14,2,1,29
Tropical Storm,Zeta,20,2006-01-04T09:00:00Z,23.9N  46.3W,36,2,0,0,38
Tropical Storm,Zeta,21,2006-01-04T15:00:00Z,23.0N  46.0W,57,0,0,0,57
Tropical Storm,Zeta,21,2006-01-04T15:00:00Z,26.0N  48.0W,12,17,1,0,30
Tropical Storm,Zeta,21,2006-01-04T15:00:00Z,24.5N  47.0W,37,2,0,0,39
Tropical Storm,Zeta,22,2006-01-04T21:00:00Z,23.5N  47.5W,53,0,0,0,53
Tropical Storm,Zeta,22,2006-01-04T21:00:00Z,26.0N  50.0W,11,18,1,1,31
Tropical Storm,Zeta,22,2006-01-04T21:00:00Z,25.0N  48.5W,36,3,0,0,39
Tropical Storm,Zeta,23,2006-01-05T03:00:00Z,23.9N  48.3W,58,0,0,0,58
Tropical Storm,Zeta,23,2006-01-05T03:00:00Z,26.2N  51.2W,0,18,8,0,26
Tropical Storm,Zeta,23,2006-01-05T03:00:00Z,25.2N  49.5W,14,21,0,0,35
Tropical Depression,Zeta,24,2006-01-05T09:00:00Z,24.3N  49.3W,57,0,0,0,57
Tropical Depression,Zeta,24,2006-01-05T09:00:00Z,26.4N  52.5W,0,20,6,1,27
Tropical Depression,Zeta,24,2006-01-05T09:00:00Z,25.4N  50.8W,15,20,1,0,36
Tropical Storm,Zeta,25,2006-01-05T15:00:00Z,24.3N  49.7W,56,0,0,0,56
Tropical Storm,Zeta,25,2006-01-05T15:00:00Z,26.3N  53.6W,0,13,19,0,32
Tropical Storm,Zeta,25,2006-01-05T15:00:00Z,25.3N  51.1W,21,15,0,0,36
Tropical Storm,Zeta,26,2006-01-05T21:00:00Z,24.7N  50.5W,55,0,0,1,56
Tropical Storm,Zeta,26,2006-01-05T21:00:00Z,27.0N  55.0W,0,14,14,0,28
Tropical Storm,Zeta,26,2006-01-05T21:00:00Z,25.7N  52.8W,8,28,1,0,37
Tropical Storm,Zeta,27,2006-01-06T03:00:00Z,24.6N  51.6W,53,0,0,0,53
Tropical Storm,Zeta,27,2006-01-06T03:00:00Z,27.0N  56.0W,0,15,15,0,30
Tropical Storm,Zeta,27,2006-01-06T03:00:00Z,25.4N  54.0W,7,30,0,0,37
Tropical Storm,Zeta,27,2006-01-06T03:00:00Z,BERMUDA,0,0,0,2,2
Tropical Storm,Zeta,28,2006-01-06T09:00:00Z,24.6N  52.8W,58,0,1,0,59
Tropical Storm,Zeta,28,2006-01-06T09:00:00Z,28.5N  57.0W,0,7,27,1,35
Tropical Storm,Zeta,28,2006-01-06T09:00:00Z,26.0N  55.5W,0,42,0,0,42
Tropical Storm,Zeta,28,2006-01-06T09:00:00Z,BERMUDA,0,0,0,2,2
Tropical Depression,Zeta,29,2006-01-06T15:00:00Z,24.5N  54.4W,55,0,0,0,55
Tropical Depression,Zeta,29,2006-01-06T15:00:00Z,29.0N  58.0W,0,10,22,0,32
Tropical Depression,Zeta,29,2006-01-06T15:00:00Z,26.4N  56.7W,1,38,0,0,39
Tropical Depression,Zeta,29,2006-01-06T15:00:00Z,BERMUDA,0,0,0,3,3
Tropical Depression,Zeta,30,2006-01-06T21:00:00Z,25.4N  54.8W,55,0,1,0,56
Tropical Depression,Zeta,30,2006-01-06T21:00:00Z,30.2N  57.0W,0,17,13,0,30
Tropical Depression,Zeta,30,2006-01-06T21:00:00Z,27.8N  56.8W,0,40,0,0,40
